Monetary,Frequency,Recency,monetary_score,frequency_score,recency_score,rfm_score,cust_no
50024.17,2.0,206,2,3,1,6,0xb2d283b6
420114.56,7.0,0,4,4,4,12,0xb2d62fab
67007.14,2.0,6,3,3,3,9,0xb2d69cdb
610.81,1.0,0,1,2,4,7,0xb2d942e8
4781.4,1.0,9,2,2,3,7,0xb2d9156f
164.95,1.0,63,1,2,2,5,0xb2d50930
96718.8,1.0,6,3,2,3,8,0xb2d6c8b9
926237.19,5.0,47,4,4,2,10,0xb2d1fa70
40101.52,2.0,188,2,3,1,6,0xb2d6495c
213226.5,5.0,0,3,4,4,11,0x3b9b184d
5406.65,1.0,15,2,2,3,7,0xb2d6b17a
8648.34,1.0,15,2,2,3,7,0xb2d8c84c
5.29,1.0,0,1,2,4,7,0xb2d423f0
6496.69,1.0,0,2,2,4,8,0xb2d32a4f
3261.09,1.0,14,2,2,3,7,0xb2d3198c
170224.72,5.0,3,3,4,4,11,0xb2d22bde
320010.35,4.0,101,4,4,1,9,0xb2d7bdca
70000.95,3.0,82,3,4,1,8,0xb2d933f7
10988.86,1.0,0,2,2,4,8,0xb2d6b9bc
16376.77,1.0,92,2,2,1,5,0xb2d33a9c
500783.77,4.0,3,4,4,4,12,0xb2d6db1f
258085.98,2.0,199,3,3,1,7,0xb2d1a5b2
10042.28,1.0,184,2,2,1,5,0xb2d3eb30
250000.0,2.0,27,3,3,2,8,0xb2d94475
60016.19,2.0,140,3,3,1,7,0xb2d48ba2
958520.51,20.0,25,4,4,2,10,0xb2d1d70d
833956.43,4.0,5,4,4,3,11,0xb2d1aed7
130000.0,9.0,5,3,4,3,10,0xb2d22815
500065.58,2.0,228,4,3,1,8,0xb2d1f44f
14.94,1.0,42,1,2,2,5,0xb2d16237
3350016.63,7.0,18,4,4,2,10,0xb2d1c0af
14744.06,1.0,9,2,2,3,7,0xb2d32cbb
1161.42,1.0,93,1,2,1,4,0xb2d37ccc
925.31,1.0,4,1,2,4,7,0xb2d1df8c
307668.72,3.0,47,4,4,2,10,0xb2d231ea
50576.06,2.0,165,2,3,1,6,0xb2d0ffa3
1112059.62,7.0,21,4,4,2,10,0xb2d5b112
2176.59,1.0,3,1,2,4,7,0xb2d0bb38
193.26,1.0,167,1,2,1,4,0xb2d6a93e
450021.67,7.0,7,4,4,3,11,0xb2d3251f
3010.58,1.0,10,2,2,3,7,0xb2d4ddaa
101021.07,2.0,73,3,3,1,7,0xb2d1172c
650085.12,3.0,35,4,4,2,10,0xb2d2d537
113223.2,2.0,0,3,3,4,10,0xb2d4cb9f
1587.64,1.0,100,1,2,1,4,0xb2d40ec8
100078.24,3.0,11,3,4,3,10,0xb2d17791
56.84,1.0,45,1,2,2,5,0xb2d6df27
526297.78,6.0,13,4,4,3,11,0xb2d10bc8
6.02,1.0,80,1,2,1,4,0xb2d94328
250888.02,2.0,30,3,3,2,8,0xb2d9c393
380004.22,3.0,1,4,4,4,12,0xb2da41eb
1360263.5,5.0,3,4,4,4,12,0xb2d10b07
377000.0,9.0,0,4,4,4,12,0xb2d40fda
762.53,2.0,3,1,3,4,8,0xb2d54b94
10126.82,1.0,4,2,2,4,8,0xb2d95413
70075.83,4.0,4,3,4,4,11,0xb2d6aa09
626524.71,4.0,4,4,4,4,12,0xb2d229dd
10365.36,1.0,5,2,2,3,7,0xb2d6c28c
507466.27,4.0,10,4,4,3,11,0xb2d0a1e8
2206.51,1.0,92,1,2,1,4,0xb2d2a36f
87769.07,3.0,0,3,4,4,11,0xb2d27a33
635523.74,2.0,18,4,3,2,9,0xb2d3accc
250256.52,4.0,7,3,4,3,10,0xb2d41034
687000.07,9.0,0,4,4,4,12,0xb2d65a3b
393477.46,4.0,0,4,4,4,12,0xb2d0eda4
3657.52,1.0,4,2,2,4,8,0xb2d23a1b
7.6,1.0,3,1,2,4,7,0xb2d35cf1
198013.24,5.0,19,3,4,2,9,0xb2d13124
470027.28,3.0,4,4,4,4,12,0xb2d913cc
2.92,1.0,20,1,2,2,5,0xb2d5c225
240034.1,11.0,1,3,4,4,11,0xb2d687b5
379069.23,2.0,76,4,3,1,8,0xb2d62231
45799.07,1.0,6,2,2,3,7,0xb2d51f24
19210.4,1.0,0,2,2,4,8,0xb2d8e7da
343030.14,3.0,15,4,4,3,11,0xb2d5ce0a
858810.5,2.0,76,4,3,1,8,0xb2d1c033
871537.59,3.0,6,4,4,3,11,0xb2d38fd1
15.59,1.0,21,1,2,2,5,0xb2d39de9
1113468.19,13.0,0,4,4,4,12,0x3b9b1810
2848.1,1.0,92,1,2,1,4,0xb2d18d87
21487.79,2.0,0,2,3,4,9,0xb2d064a1
2350.81,1.0,2,1,2,4,7,0xb2d43997
471258.71,5.0,76,4,4,1,9,0xb2d0f793
1162.23,1.0,92,1,2,1,4,0xb2d488da
530060.3,3.0,4,4,4,4,12,0xb2d28425
10820.93,1.0,19,2,2,2,6,0xb2d6b084
51128.62,2.0,32,2,3,2,7,0xb2d435a1
19366.33,1.0,169,2,2,1,5,0xb2d5c5cf
4704.69,1.0,113,2,2,1,5,0xb2d0e8ed
30340.96,2.0,62,2,3,2,7,0xb2d36515
110701.43,1.0,1,3,2,4,9,0xb2d30d9c
234.19,2.0,18,1,3,2,6,0xb2d4fab2
280009.22,6.0,10,3,4,3,10,0xb2d6f587
1186.07,1.0,184,1,2,1,4,0xb2d14fa3
138027.67,2.0,93,3,3,1,7,0xb2d4c1a7
500001.0,2.0,2,4,3,4,11,0xb2d92b06
1770012.24,5.0,0,4,4,4,12,0xb2d0940d
197121.34,2.0,0,3,3,4,10,0xb2d2dfea
102204.73,3.0,32,3,4,2,9,0xb2d621b3
379042.52,4.0,80,4,4,1,9,0xb2d5a79d
1340028.31,6.0,0,4,4,4,12,0xb2d14825
100048.58,1.0,1,3,2,4,9,0xb2d85706
100000.0,2.0,0,3,3,4,10,0xb2d97c7b
5631.47,1.0,50,2,2,2,6,0xb2d95283
5051.04,1.0,92,2,2,1,5,0xb2d281c3
200009.5,3.0,76,3,4,1,8,0xb2d991eb
404844.05,1.0,0,4,2,4,10,0xb2d4f97f
557000.23,4.0,0,4,4,4,12,0xb2d1be58
30001.27,2.0,49,2,3,2,7,0xb2d5fe4c
10484.95,1.0,5,2,2,3,7,0xb2d1bf9c
109105.22,2.0,32,3,3,2,8,0xb2d2b6ba
263837.19,3.0,3,3,4,4,11,0xb2d0d6cf
6030.96,1.0,9,2,2,3,7,0xb2d60fb8
100001.06,2.0,42,3,3,2,8,0xb2d3b097
302167.73,2.0,76,4,3,1,8,0xb2d99d9e
1210.16,1.0,55,1,2,2,5,0xb2d6d5bf
132.17,1.0,4,1,2,4,7,0xb2d64db7
10403.4,1.0,92,2,2,1,5,0xb2d28c67
217927.26,3.0,67,3,4,1,8,0xb2d4643e
204069.92,2.0,0,3,3,4,10,0xb2d40e29
336669.67,3.0,29,4,4,2,10,0xb2d63761
200000.0,2.0,12,3,3,3,9,0xb2d81200
499345.05,7.0,0,4,4,4,12,0xb2d59567
55275.82,1.0,31,3,2,2,7,0xb2d2a968
1003925.27,50.0,18,4,4,2,10,0xb2d2cee3
364.26,1.0,20,1,2,2,5,0xb2d5c85b
95.19,1.0,24,1,2,2,5,0xb2d1e782
200036.58,5.0,89,3,4,1,8,0xb2d746b2
90569.73,1.0,0,3,2,4,9,0xb2d3762f
327785.01,3.0,3,4,4,4,12,0xb2d138c1
10203.34,1.0,281,2,2,1,5,0xb2d5e3cb
1450000.0,12.0,8,4,4,3,11,0xb2d069fe
669.73,1.0,46,1,2,2,5,0xb2d2076d
439334.7,3.0,33,4,4,2,10,0xb2d072af
217561.4,5.0,62,3,4,2,9,0xb2d1390b
2125.67,1.0,92,1,2,1,4,0xb2d2be33
1507.34,1.0,9,1,2,3,6,0xb2d38643
20711.06,2.0,0,2,3,4,9,0xb2d62527
19086.87,1.0,1,2,2,4,8,0xb2d275a3
120002.86,3.0,39,3,4,2,9,0xb2d9ec82
320066.63,3.0,12,4,4,3,11,0xb2d7869d
500078.38,3.0,171,4,4,1,9,0xb2d1fec1
23860.32,1.0,14,2,2,3,7,0xb2d69bd9
104825.76,2.0,182,3,3,1,7,0xb2d17bbb
100000.0,1.0,5,3,2,3,8,0xb2d922ff
250888.02,2.0,32,3,3,2,8,0xb2da06c3
19245.85,4.0,0,2,4,4,10,0x3b9b484e
348.57,1.0,24,1,2,2,5,0xb2d25d1b
26.78,1.0,59,1,2,2,5,0xb2d38acd
170000.0,5.0,1,3,4,4,11,0xb2d8e479
7506.88,1.0,13,2,2,3,7,0xb2d30948
8100.94,2.0,0,2,3,4,9,0xb2d54e24
40119.61,1.0,92,2,2,1,5,0xb2d613f5
12500.48,1.0,10,2,2,3,7,0xb2d6c986
1415.95,1.0,193,1,2,1,4,0xb2d4d411
2025.06,1.0,184,1,2,1,4,0xb2d23302
10082.21,1.0,184,2,2,1,5,0xb2d38b56
150721.0,2.0,28,3,3,2,8,0xb2d90773
827297.24,10.0,1,4,4,4,12,0x3b9af0f2
279.9,1.0,2,1,2,4,7,0xb2d18724
65473.51,1.0,116,3,2,1,6,0xb2d3297d
500005.29,2.0,158,4,3,1,8,0xb2d8f1dd
2046.64,1.0,10,1,2,3,6,0xb2d3af05
14417.41,1.0,12,2,2,3,7,0xb2d76955
968.52,1.0,10,1,2,3,6,0xb2d51c7f
120452.19,2.0,1,3,3,4,10,0xb2d7becf
841503.15,3.0,20,4,4,2,10,0xb2d40b32
1224.62,1.0,17,1,2,2,5,0xb2d5c89b
921171.05,1.0,4,4,2,4,10,0xb2d58134
1429.14,1.0,2,1,2,4,7,0xb2d4b2c0
2077.33,1.0,7,1,2,3,6,0xb2d29760
1834577.48,28.0,4,4,4,4,12,0x3b9b386a
290010.79,7.0,21,3,4,2,9,0xb2d13794
2381.82,1.0,8,1,2,3,6,0xb2d929fc
1326.94,1.0,184,1,2,1,4,0xb2d241d5
440888.68,3.0,15,4,4,3,11,0xb2d62726
445905.4,1.0,0,4,2,4,10,0xb2d269df
1524272.06,7.0,11,4,4,3,11,0xb2d5b0f2
180065.96,3.0,56,3,4,2,9,0xb2d5f18d
450000.78,3.0,3,4,4,4,12,0xb2d74348
94469.08,3.0,38,3,4,2,9,0xb2d2be04
128371.6,2.0,21,3,3,2,8,0xb2d2d7de
11823000.0,8.0,0,4,4,4,12,0xb2d3e260
584259.05,3.0,48,4,4,2,10,0xb2d63fe4
661.17,1.0,11,1,2,3,6,0xb2d9f0e6
300018.27,2.0,7,3,3,3,9,0xb2d6d293
2018256.97,8.0,8,4,4,3,11,0xb2d3cbc5
120092.51,2.0,74,3,3,1,7,0xb2d8d7de
66.39,1.0,27,1,2,2,5,0xb2d683a1
40050.17,1.0,127,2,2,1,5,0xb2d581cb
2769.23,1.0,6,1,2,3,6,0xb2d353f6
119641.85,3.0,8,3,4,3,10,0xb2d12a43
38.17,1.0,59,1,2,2,5,0xb2d2ef2c
58.83,1.0,92,1,2,1,4,0xb2d0bf22
10014.23,1.0,174,2,2,1,5,0xb2d50311
1335.27,1.0,40,1,2,2,5,0xb2d3bb7e
250218.61,4.0,0,3,4,4,11,0xb2d0a5e2
200072.58,2.0,54,3,3,2,8,0xb2d63895
4.32,1.0,20,1,2,2,5,0xb2d2b8cd
152089.03,4.0,4,3,4,4,11,0xb2d64b7b
160000.0,2.0,6,3,3,3,9,0xb2d69a75
100003.75,2.0,92,3,3,1,7,0xb2d17ed3
25000.79,2.0,60,2,3,2,7,0xb2d9ba9d
1005.11,1.0,178,1,2,1,4,0xb2d78d93
12264.96,1.0,92,2,2,1,5,0xb2d3b7da
7381.09,1.0,2,2,2,4,8,0xb2d30149
502143.98,2.0,8,4,3,3,10,0xb2d98358
5001.11,1.0,30,2,2,2,6,0xb2d93e58
50939.4,2.0,143,2,3,1,6,0xb2d61496
811150.3,4.0,22,4,4,2,10,0xb2d6abdc
18.91,1.0,10,1,2,3,6,0xb2d29a9d
1653626.45,6.0,13,4,4,3,11,0xb2d645f6
36.74,1.0,35,1,2,2,5,0xb2d9a64c
1031.73,1.0,305,1,2,1,4,0xb2d264a2
95714.85,1.0,0,3,2,4,9,0xb2d0c410
37598.4,1.0,105,2,2,1,5,0xb2d6a061
173641.73,2.0,0,3,3,4,10,0xb2d2431f
17.46,1.0,19,1,2,2,5,0xb2d62de3
17401.4,1.0,17,2,2,2,6,0xb2d2674d
500000.31,3.0,6,4,4,3,11,0xb2d973be
133640.53,4.0,1,3,4,4,11,0xb2d31921
706839.24,7.0,0,4,4,4,12,0xb2d620f9
318.48,1.0,88,1,2,1,4,0xb2d593cc
2022.99,2.0,92,1,3,1,5,0xb2d06af0
500000.5,2.0,5,4,3,3,10,0xb2d957a8
10005.28,1.0,48,2,2,2,6,0xb2d8f11b
108501.87,2.0,139,3,3,1,7,0xb2d3304c
285008.8,10.0,24,3,4,2,9,0x3b9af1f2
162096.78,2.0,136,3,3,1,7,0xb2d367e1
101530.42,2.0,101,3,3,1,7,0xb2d58dd8
429826.91,7.0,0,4,4,4,12,0xb2d59a77
20488.31,2.0,24,2,3,2,7,0xb2d5b5bb
276951.74,3.0,11,3,4,3,10,0xb2d93f6c
205.97,1.0,26,1,2,2,5,0xb2d232ba
4919.64,1.0,208,2,2,1,5,0xb2d2fd1a
1020000.38,4.0,8,4,4,3,11,0xb2d8ef4c
2008.78,1.0,92,1,2,1,4,0xb2d32d74
508850.74,1.0,188,4,2,1,7,0xb2d5e9e9
170395.41,2.0,0,3,3,4,10,0xb2d38d95
106.79,2.0,0,1,3,4,8,0xb2d38030
53108.03,1.0,9,3,2,3,8,0xb2d6c9f2
71373.13,2.0,95,3,3,1,7,0xb2d41146
233914.55,2.0,0,3,3,4,10,0xb2d603f5
2940.47,1.0,88,2,2,1,5,0xb2d5ad6b
3.47,1.0,12,1,2,3,6,0xb2d26666
202843.27,2.0,17,3,3,2,8,0xb2d6e51d
1.71,1.0,17,1,2,2,5,0xb2d6b47e
470037.98,5.0,16,4,4,2,10,0xb2d0e3d4
902.17,1.0,0,1,2,4,7,0xb2d20328
1700326.22,3.0,27,4,4,2,10,0xb2d63f35
317612.42,2.0,49,4,3,2,9,0xb2d3c0c8
0.98,1.0,21,1,2,2,5,0xb2d62a00
1228687.15,4.0,11,4,4,3,11,0xb2d6381d
51934.77,2.0,136,2,3,1,6,0xb2d51626
194.93,1.0,2,1,2,4,7,0xb2d37878
103060.23,2.0,7,3,3,3,9,0xb2d5e72c
54.35,1.0,0,1,2,4,7,0xb2d086b2
16000.04,1.0,5,2,2,3,7,0xb2da3024
268272.44,4.0,1,3,4,4,11,0xb2d20136
120391.06,4.0,12,3,4,3,10,0xb2d57e2f
1800038.03,3.0,95,4,4,1,9,0xb2d922af
200009.01,3.0,63,3,4,2,9,0xb2d1b16e
183658.73,1.0,0,3,2,4,9,0xb2d9b6e3
299.14,1.0,13,1,2,3,6,0xb2d997c8
14766.6,1.0,1,2,2,4,8,0xb2d967e7
20134.07,2.0,0,2,3,4,9,0xb2d6a7be
329.74,1.0,11,1,2,3,6,0xb2d88c67
4838.41,1.0,9,2,2,3,7,0xb2d34163
353123.57,6.0,7,4,4,3,11,0xb2d69c3b
63.41,2.0,76,1,3,1,5,0xb2d5eec0
103000.71,2.0,214,3,3,1,7,0xb2d41dfe
250545.13,4.0,0,3,4,4,11,0xb2d2d1b6
3.0,1.0,0,1,2,4,7,0xb2da550b
1613.93,1.0,10,1,2,3,6,0xb2d1cae6
21.11,1.0,59,1,2,2,5,0xb2d8eefa
26131.95,1.0,19,2,2,2,6,0xb2d6a119
505624.92,2.0,41,4,3,2,9,0xb2d6e4db
2460001.48,9.0,2,4,4,4,12,0xb2d242f3
5.65,1.0,9,1,2,3,6,0xb2d68f2c
684992.76,22.0,7,4,4,3,11,0xb2d2bc31
693043.79,2.0,0,4,3,4,11,0xb2d2b84b
29800.55,1.0,259,2,2,1,5,0xb2d684c6
196491.77,1.0,16,3,2,2,7,0xb2d280e8
200000.0,2.0,184,3,3,1,7,0xb2d68137
5229.07,1.0,2,2,2,4,8,0xb2d226f9
1498935.96,4.0,7,4,4,3,11,0xb2d329ad
7721.26,1.0,10,2,2,3,7,0xb2da2251
2942.82,1.0,5,2,2,3,7,0xb2d1e693
110102.19,1.0,5,3,2,3,8,0xb2d361c2
630024.58,4.0,3,4,4,4,12,0xb2d2ba1b
1608.65,1.0,93,1,2,1,4,0xb2d63008
130036.62,3.0,0,3,4,4,11,0xb2d58b41
100090.12,2.0,104,3,3,1,7,0xb2d2793c
4.75,1.0,1,1,2,4,7,0xb2d94793
216007.63,3.0,81,3,4,1,8,0xb2d4ac4b
32007.04,1.0,25,2,2,2,6,0xb2d81615
270934.08,3.0,19,3,4,2,9,0xb2d410a8
944.33,1.0,20,1,2,2,5,0xb2d35894
81214.47,1.0,3,3,2,4,9,0xb2d3ec0f
242023.51,1.0,9,3,2,3,8,0xb2d4368b
200098.43,2.0,11,3,3,3,9,0xb2d9e2f7
1844.2,1.0,0,1,2,4,7,0xb2d15bfe
1143.01,1.0,3,1,2,4,7,0xb2d2b5c6
691549.93,7.0,9,4,4,3,11,0xb2d1b32c
0.0,1.0,1,1,2,4,7,0xb2d33d9f
11.9,1.0,167,1,2,1,4,0xb2d5dbe9
319013.5,2.0,129,4,3,1,8,0xb2d0e656
290068.55,2.0,132,3,3,1,7,0xb2d16a5b
36.02,1.0,17,1,2,2,5,0xb2d30cb6
10000.32,2.0,73,2,3,1,6,0xb2d8dfdf
550037.33,6.0,4,4,4,4,12,0xb2d657bc
6592.65,1.0,14,2,2,3,7,0xb2d920cb
152.13,1.0,2,1,2,4,7,0xb2d1ec3c
21371.76,2.0,42,2,3,2,7,0xb2d58575
1537876.78,6.0,1,4,4,4,12,0xb2d08ba1
100033.41,2.0,201,3,3,1,7,0xb2d1fc4b
51024.49,1.0,8,2,2,3,7,0xb2d5acc2
18255.54,1.0,230,2,2,1,5,0xb2d5ec50
5261.4,1.0,16,2,2,2,6,0xb2d90a6f
400735.79,3.0,53,4,4,2,10,0xb2d65d53
28220.69,1.0,1,2,2,4,8,0xb2d6cf39
860247.39,6.0,1,4,4,4,12,0xb2d63c05
306641.75,13.0,0,4,4,4,12,0xb2d210dc
0.0,1.0,9,1,2,3,6,0xb2d982d5
30000.63,2.0,92,2,3,1,6,0xb2d13ebd
330070.42,2.0,5,4,3,3,10,0xb2d9b9ee
100002.12,2.0,192,3,3,1,7,0xb2d6a2fa
201421.15,2.0,17,3,3,2,8,0xb2d998fe
51002.07,2.0,193,2,3,1,6,0xb2d743bd
561068.31,4.0,0,4,4,4,12,0xb2d3d3f3
160056.13,3.0,80,3,4,1,8,0xb2d5a583
13822.7,1.0,92,2,2,1,5,0xb2d26c03
150001.58,2.0,235,3,3,1,7,0xb2d6eb01
6631.77,2.0,184,2,3,1,6,0xb2d41016
56059.78,4.0,154,3,4,1,8,0xb2d071ce
728581.02,1.0,0,4,2,4,10,0xb2d90366
2151.12,1.0,0,1,2,4,7,0xb2d2f861
590008.09,4.0,11,4,4,3,11,0xb2d43050
180064.09,4.0,18,3,4,2,9,0xb2d5f9a5
710651.1,5.0,98,4,4,1,9,0xb2d1f3d7
401322.5,4.0,1,4,4,4,12,0xb2d94c28
628262.29,5.0,1,4,4,4,12,0xb2d656d0
2600959.83,4.0,0,4,4,4,12,0xb2d099fe
50009.73,2.0,6,2,3,3,8,0xb2d699c8
50011.43,2.0,175,2,3,1,6,0xb2d0bea7
10005.06,2.0,139,2,3,1,6,0xb2d91588
701281.64,4.0,42,4,4,2,10,0xb2d0638d
4533.8,1.0,9,2,2,3,7,0xb2d372fd
50001.58,2.0,213,2,3,1,6,0xb2d6837a
2651.61,1.0,10,1,2,3,6,0xb2d3c7ee
1017284.84,14.0,3,4,4,4,12,0xb2d3ad10
22634.47,1.0,19,2,2,2,6,0xb2d9ded5
523288.83,8.0,11,4,4,3,11,0xb2d2410a
3.59,1.0,0,1,2,4,7,0xb2d28cf7
6.07,1.0,6,1,2,3,6,0xb2d6f5f4
110003.17,3.0,55,3,4,2,9,0xb2d6a0ca
41035.6,2.0,7,2,3,3,8,0xb2d5818b
0.0,1.0,7,1,2,3,6,0xb2d651be
15166.09,1.0,3,2,2,4,8,0xb2d2f413
200028.94,2.0,8,3,3,3,9,0xb2d26df7
101.19,1.0,37,1,2,2,5,0xb2d2cfbd
2212.41,1.0,10,1,2,3,6,0xb2d70157
153467.21,1.0,67,3,2,1,6,0xb2d1e14b
1480711.65,1.0,2,4,2,4,10,0xb2d4dbab
200000.0,2.0,0,3,3,4,10,0xb2da6b6e
20006.03,1.0,1,2,2,4,8,0xb2d6d5b5
58981.0,2.0,192,3,3,1,7,0xb2d0ce74
270310.91,1.0,8,3,2,3,8,0xb2d43c26
203136.31,2.0,11,3,3,3,9,0xb2d6e045
100009.58,3.0,92,3,4,1,8,0x3b9acc87
115037.25,2.0,107,3,3,1,7,0xb2d57a28
3880.59,1.0,147,2,2,1,5,0xb2d5dfc8
117.18,1.0,1,1,2,4,7,0xb2d42372
142388.12,1.0,0,3,2,4,9,0xb2d23b6b
200722.25,2.0,0,3,3,4,10,0xb2d6c6a5
4965.98,1.0,28,2,2,2,6,0xb2d20858
440453.97,5.0,95,4,4,1,9,0xb2d60625
703067.61,9.0,0,4,4,4,12,0xb2d9316f
2493.87,1.0,92,1,2,1,4,0xb2d272c9
873076.49,6.0,3,4,4,4,12,0xb2d57579
50046.07,3.0,47,2,4,2,8,0x3b9b49f9
152832.67,4.0,21,3,4,2,9,0xb2d6f016
1.95,1.0,11,1,2,3,6,0xb2d9649a
10000.11,2.0,45,2,3,2,7,0xb2d91b56
13820.55,1.0,21,2,2,2,6,0xb2d305d8
81504.14,9.0,1,3,4,4,11,0xb2d68022
138301.43,1.0,184,3,2,1,6,0xb2d0ec34
8838.83,1.0,11,2,2,3,7,0xb2d8b1be
0.0,2.0,6,1,3,3,7,0xb2da4bef
6458.35,1.0,9,2,2,3,7,0xb2d4cf85
420155.38,2.0,20,4,3,2,9,0xb2d62c2a
5719.2,1.0,0,2,2,4,8,0xb2d3e91e
102000.0,4.0,0,3,4,4,11,0xb2d0d3c7
1800404.83,13.0,4,4,4,4,12,0xb2d65007
160014.15,3.0,48,3,4,2,9,0xb2d8edfd
80009.81,3.0,22,3,4,2,9,0xb2d96bd8
300000.0,2.0,5,3,3,3,9,0xb2da5ce9
225038.7,2.0,26,3,3,2,8,0xb2d196f9
254442.59,2.0,153,3,3,1,7,0xb2d8fdbc
421.06,1.0,9,1,2,3,6,0xb2d561a6
320048.66,4.0,18,4,4,2,10,0xb2d52f28
250212.2,4.0,4,3,4,4,11,0xb2d1c496
257.12,1.0,56,1,2,2,5,0xb2d1af95
5303.66,1.0,92,2,2,1,5,0xb2d3a2ca
2950240.57,7.0,14,4,4,3,11,0xb2d1c9ef
380010.38,2.0,29,4,3,2,9,0xb2d747bc
124087.11,4.0,63,3,4,2,9,0xb2d5a54e
287.96,1.0,8,1,2,3,6,0xb2d278b8
799496.56,8.0,0,4,4,4,12,0xb2d41547
5272.4,1.0,6,2,2,3,7,0xb2d6c275
692.68,1.0,8,1,2,3,6,0xb2d97b0a
343198.93,3.0,1,4,4,4,12,0xb2d0c81c
1000474.57,2.0,231,4,3,1,8,0xb2d4a382
5133.81,1.0,184,2,2,1,5,0xb2d25894
11.98,1.0,47,1,2,2,5,0xb2d85afe
51058.6,2.0,4,2,3,4,9,0xb2d6ab1f
10011753.7,5.0,6,4,4,3,11,0xb2d6e016
470039.24,2.0,13,4,3,3,10,0xb2d99cfb
2252187.81,5.0,27,4,4,2,10,0xb2d9788f
10123.26,1.0,27,2,2,2,6,0xb2d5cf11
5644.59,1.0,2,2,2,4,8,0xb2d2e771
150006.43,1.0,0,3,2,4,9,0xb2d635d8
200042.7,2.0,18,3,3,2,8,0xb2d0cef4
200000.0,2.0,21,3,3,2,8,0xb2da25d4
44007.36,2.0,12,2,3,3,8,0xb2d6d093
55003.48,2.0,231,3,3,1,7,0xb2d56d9c
724.47,1.0,5,1,2,3,6,0xb2d207d4
750013.59,9.0,18,4,4,2,10,0xb2d3627b
455190.96,11.0,0,4,4,4,12,0x3b9b1803
522.08,1.0,19,1,2,2,5,0xb2d6c02e
648.7,1.0,1,1,2,4,7,0xb2d654a1
376.9,1.0,0,1,2,4,7,0xb2d1fdf6
892027.26,6.0,6,4,4,3,11,0xb2d1ea14
23051.78,1.0,28,2,2,2,6,0xb2d93b67
5225.13,1.0,184,2,2,1,5,0xb2d2331e
10000.53,2.0,10,2,3,3,8,0xb2da0617
296385.66,1.0,5,3,2,3,8,0xb2d0e3bc
428.2,1.0,7,1,2,3,6,0xb2d29fd1
208632.71,1.0,67,3,2,1,6,0xb2d591f6
244115.62,2.0,39,3,3,2,8,0xb2d6f495
20000.74,2.0,11,2,3,3,8,0xb2da0e03
4885.87,1.0,3,2,2,4,8,0xb2d9da48
157984.26,2.0,1,3,3,4,10,0xb2d3823d
220045.37,4.0,8,3,4,3,10,0xb2d24ccb
260020.16,4.0,22,3,4,2,9,0xb2d1afab
1188.64,1.0,184,1,2,1,4,0xb2d21790
80000.0,2.0,3,3,3,4,10,0xb2d9749d
7200.01,2.0,11,2,3,3,8,0xb2da4653
6720.73,1.0,0,2,2,4,8,0xb2d0c9af
100008.34,2.0,3,3,3,4,10,0xb2d92e39
220016.77,4.0,7,3,4,3,10,0xb2d58968
640.42,2.0,0,1,3,4,8,0x3b9af1e7
2006.13,1.0,3,1,2,4,7,0xb2d19d4f
860009.08,4.0,27,4,4,2,10,0xb2d8d835
600.0,1.0,0,1,2,4,7,0xb2d92ba0
2189.53,1.0,92,1,2,1,4,0xb2d0bee0
593103.44,5.0,60,4,4,2,10,0xb2d43644
70042.43,5.0,80,3,4,1,8,0xb2d5a4a8
1505427.0,8.0,4,4,4,4,12,0xb2d07499
2526.96,1.0,258,1,2,1,4,0xb2d5355c
208082.99,1.0,12,3,2,3,8,0xb2d6448a
500012.12,2.0,20,4,3,2,9,0xb2d98dec
216049.88,3.0,53,3,4,2,9,0xb2d479c2
15269.62,1.0,3,2,2,4,8,0xb2d30d0f
200003.44,1.0,1,3,2,4,9,0xb2d95cab
208.98,1.0,2,1,2,4,7,0xb2d22f11
147694.86,6.0,0,3,4,4,11,0xb2d0f4fb
519573.88,3.0,24,4,4,2,10,0xb2d062f1
233311.49,4.0,87,3,4,1,8,0xb2d2e7ea
3091.82,2.0,66,2,3,2,7,0xb2d45996
1384.01,1.0,0,1,2,4,7,0xb2d4cdc6
2874.75,1.0,1,1,2,4,7,0xb2d940fd
5061.25,1.0,184,2,2,1,5,0xb2d2a613
307.67,1.0,15,1,2,3,6,0xb2d6d509
1005301.77,13.0,24,4,4,2,10,0xb2d068b7
500000.0,2.0,18,4,3,2,9,0xb2da32da
300059.76,2.0,18,3,3,2,8,0xb2d1a50e
289812.82,2.0,63,3,3,2,8,0xb2d1e99d
496013.09,3.0,108,4,4,1,9,0xb2d1d281
731905.94,7.0,31,4,4,2,10,0xb2d51c62
29400.03,1.0,5,2,2,3,7,0xb2d63901
12293.81,1.0,0,2,2,4,8,0xb2d6159d
109026.33,3.0,7,3,4,3,10,0xb2d4e2ae
183477.94,1.0,184,3,2,1,6,0xb2d3e6d0
150024.84,2.0,59,3,3,2,8,0xb2d22e4c
273000.0,6.0,6,3,4,3,10,0xb2d47270
16143.36,1.0,4,2,2,4,8,0xb2d5b8bd
215011.2,4.0,55,3,4,2,9,0xb2d9b2b5
16816.5,1.0,1,2,2,4,8,0xb2d3a111
1984.92,1.0,0,1,2,4,7,0xb2d6b8e5
500023.69,3.0,0,4,4,4,12,0xb2d58f4e
71036.21,6.0,0,3,4,4,11,0x3b9b1c0a
1430.4,1.0,35,1,2,2,5,0xb2d6ce3a
350581.55,3.0,0,4,4,4,12,0xb2d4f5f4
600000.0,3.0,5,4,4,3,11,0xb2d9e868
21376.28,3.0,0,2,4,4,10,0xb2d0a0de
51106.2,4.0,2,2,4,4,10,0xb2d25ea6
91.46,1.0,14,1,2,3,6,0xb2d2deb2
107655.02,3.0,208,3,4,1,8,0xb2d1ae02
11.53,1.0,7,1,2,3,6,0xb2d6fc43
669254.73,4.0,30,4,4,2,10,0xb2d172ea
60002.53,2.0,42,3,3,2,8,0xb2d40183
500057.4,2.0,0,4,3,4,11,0xb2d9b5bc
64.72,1.0,25,1,2,2,5,0xb2d1c688
150619.24,2.0,73,3,3,1,7,0xb2d5bd6f
1579.67,1.0,21,1,2,2,5,0xb2d2e1e2
300006.33,3.0,18,3,4,2,9,0xb2d9c65d
124649.03,2.0,62,3,3,2,8,0xb2d170d9
10903.11,1.0,3,2,2,4,8,0xb2d43bc5
2758.97,1.0,60,1,2,2,5,0xb2d210fc
81.31,1.0,68,1,2,1,4,0xb2d5689a
220002.97,7.0,10,3,4,3,10,0xb2d18237
22000.0,2.0,6,2,3,3,8,0xb2d9701d
111586.77,3.0,0,3,4,4,11,0xb2d59eeb
696140.8,7.0,8,4,4,3,11,0xb2d6c606
300328.41,2.0,3,4,3,4,11,0xb2d6d993
200119.39,3.0,10,3,4,3,10,0xb2d27647
5738.83,1.0,21,2,2,2,6,0xb2d33fb7
180505.13,4.0,5,3,4,3,10,0xb2d921bf
846324.27,14.0,0,4,4,4,12,0xb2d22352
337215.02,17.0,18,4,4,2,10,0xb2d0b459
75672.83,1.0,1,3,2,4,9,0xb2d45e5d
93687.45,2.0,11,3,3,3,9,0xb2d0e779
0.0,1.0,6,1,2,3,6,0xb2d3c951
2841.51,1.0,184,1,2,1,4,0xb2d4f69f
232920.07,5.0,0,3,4,4,11,0xb2d1526b
2.04,1.0,90,1,2,1,4,0xb2d7699a
155849.64,3.0,14,3,4,3,10,0xb2d9a157
1066851.32,8.0,31,4,4,2,10,0xb2d06baf
201163.03,4.0,32,3,4,2,9,0xb2d9155f
100340.55,5.0,0,3,4,4,11,0xb2d93440
1.67,1.0,21,1,2,2,5,0xb2d96091
846013.24,7.0,0,4,4,4,12,0xb2d58e39
60.27,1.0,13,1,2,3,6,0xb2d20e4b
2331.66,1.0,45,1,2,2,5,0xb2d8fb5b
74.41,1.0,6,1,2,3,6,0xb2d1aa33
403823.25,2.0,4,4,3,4,11,0xb2d69a26
400.01,1.0,18,1,2,2,5,0xb2d2f461
110763.81,3.0,21,3,4,2,9,0xb2d64adf
862708.46,3.0,2,4,4,4,12,0xb2d635ee
2674.43,1.0,16,1,2,2,5,0xb2d2ff7f
1606.53,1.0,1,1,2,4,7,0xb2d33d97
84021.88,3.0,18,3,4,2,9,0xb2d7d1c7
432956.96,11.0,0,4,4,4,12,0x3b9ae4ab
2466.15,1.0,2,1,2,4,7,0xb2d2b5cb
193.93,1.0,42,1,2,2,5,0xb2d98073
12.68,1.0,12,1,2,3,6,0xb2d2c791
704162.4,3.0,0,4,4,4,12,0x3b9b2fa0
541425.2,1.0,6,4,2,3,9,0xb2d4606a
3910251.0,3.0,22,4,4,2,10,0xb2d95397
1104.47,2.0,73,1,3,1,5,0xb2d51290
73000.0,5.0,2,3,4,4,11,0xb2d984d4
60000.0,2.0,3,3,3,4,10,0xb2d97957
34.23,1.0,37,1,2,2,5,0xb2d64980
331012.88,4.0,63,4,4,2,10,0xb2d230e5
1129136.84,12.0,4,4,4,4,12,0xb2d16848
48.35,1.0,8,1,2,3,6,0xb2d3b3b4
165371.15,4.0,0,3,4,4,11,0xb2d34d55
300003.17,3.0,10,3,4,3,10,0xb2d960c8
15064.35,2.0,0,2,3,4,9,0xb2d548d9
829232.48,8.0,62,4,4,2,10,0xb2d3790b
2574.72,1.0,11,1,2,3,6,0xb2d6aaf5
95.06,1.0,2,1,2,4,7,0xb2d34839
53014.55,1.0,36,3,2,2,7,0xb2d9fa3b
11047.59,1.0,184,2,2,1,5,0xb2d5d973
6834.05,1.0,184,2,2,1,5,0xb2d2e124
27111.25,1.0,0,2,2,4,8,0xb2d520ff
280000.0,3.0,0,3,4,4,11,0xb2d52da3
968.71,1.0,18,1,2,2,5,0xb2d55220
760000.94,3.0,22,4,4,2,10,0xb2d90c5f
55280.72,2.0,136,3,3,1,7,0xb2d227e0
42.62,1.0,28,1,2,2,5,0xb2d2bd80
0.0,1.0,3,1,2,4,7,0xb2d6b368
63.81,1.0,184,1,2,1,4,0xb2d2fca2
930059.85,5.0,33,4,4,2,10,0xb2d34d01
5313.24,1.0,10,2,2,3,7,0xb2d6efd4
476.26,1.0,11,1,2,3,6,0xb2d247be
2480.53,1.0,83,1,2,1,4,0xb2d61ebd
1603.58,1.0,28,1,2,2,5,0xb2d6c4f9
1980.84,1.0,184,1,2,1,4,0xb2d06b96
1642.37,1.0,6,1,2,3,6,0xb2d44147
301266.4,2.0,0,4,3,4,11,0xb2d169a8
63439.45,1.0,15,3,2,3,8,0xb2d28373
405686.95,2.0,147,4,3,1,8,0xb2d906ef
8754.91,1.0,10,2,2,3,7,0xb2d92c33
801566.72,8.0,48,4,4,2,10,0xb2d5de78
380668.27,2.0,0,4,3,4,11,0xb2d28fe4
50.82,1.0,53,1,2,2,5,0xb2d52438
100000.0,2.0,3,3,3,4,10,0xb2d974b0
50001.53,2.0,140,2,3,1,6,0xb2d6424d
97378.23,3.0,13,3,4,3,10,0xb2d957e3
2015688.72,6.0,0,4,4,4,12,0xb2d5bda1
2486.31,1.0,235,1,2,1,4,0xb2d43828
40011.21,2.0,4,2,3,4,9,0xb2d0f816
310009.82,2.0,95,4,3,1,8,0xb2d971f3
410440.43,3.0,39,4,4,2,10,0xb2d1a9cf
4807.37,1.0,2,2,2,4,8,0xb2d9369f
23.83,1.0,92,1,2,1,4,0xb2d4de96
406239.08,7.0,14,4,4,3,11,0xb2d0bd48
52074.33,2.0,167,2,3,1,6,0xb2d43531
5334.56,1.0,63,2,2,2,6,0xb2d44680
3663.94,1.0,88,2,2,1,5,0xb2d62ab3
200140.3,2.0,11,3,3,3,9,0xb2da0f85
501166.02,3.0,11,4,4,3,11,0xb2d93257
3893.97,1.0,0,2,2,4,8,0xb2d5e53b
818109.37,7.0,70,4,4,1,9,0x3b9adb40
811.51,1.0,12,1,2,3,6,0xb2d19665
100077.23,3.0,60,3,4,2,9,0xb2d1a917
40017.21,1.0,1,2,2,4,8,0xb2d6908c
650006.33,4.0,24,4,4,2,10,0xb2d94504
600000.0,2.0,0,4,3,4,11,0xb2d97e2c
55012.76,2.0,45,3,3,2,8,0xb2d251c9
310014.82,6.0,27,4,4,2,10,0xb2d33d38
200156.29,3.0,18,3,4,2,9,0xb2d0a2b6
1.8,1.0,25,1,2,2,5,0xb2d4f15a
113252.47,1.0,0,3,2,4,9,0xb2d9c9dc
250007.94,2.0,256,3,3,1,7,0xb2d6c8e0
4190.98,1.0,16,2,2,2,6,0xb2d8c5d2
779017.66,10.0,1,4,4,4,12,0xb2d1c43d
3384.57,1.0,13,2,2,3,7,0xb2d2e75e
1498261.48,5.0,35,4,4,2,10,0xb2d277f7
18465.19,1.0,4,2,2,4,8,0xb2d6f345
150050.22,11.0,18,3,4,2,9,0xb2d3bc76
781.24,2.0,12,1,3,3,7,0xb2d09fc0
403554.86,3.0,0,4,4,4,12,0xb2d6988b
33118.19,1.0,184,2,2,1,5,0xb2d61621
704571.68,2.0,0,4,3,4,11,0xb2d4042d
840592.85,7.0,52,4,4,2,10,0xb2d1963f
0.0,1.0,4,1,2,4,7,0xb2d33462
20277.21,1.0,299,2,2,1,5,0xb2d60df5
10043.97,1.0,29,2,2,2,6,0xb2d91bda
1862.56,1.0,1,1,2,4,7,0xb2d12ccf
1537.88,1.0,1,1,2,4,7,0xb2d91a47
460008.88,2.0,25,4,3,2,9,0xb2d7877a
60055.88,3.0,11,3,4,3,10,0xb2d78af6
140597.72,5.0,45,3,4,2,9,0xb2d682dd
1948.2,1.0,48,1,2,2,5,0xb2d15ef7
625.64,1.0,13,1,2,3,6,0xb2d8de16
30150.47,2.0,26,2,3,2,7,0xb2d20059
10013.73,1.0,6,2,2,3,7,0xb2d64d22
453031.32,4.0,20,4,4,2,10,0xb2d9527a
950000.26,11.0,5,4,4,3,11,0xb2d62458
41002.13,2.0,7,2,3,3,8,0xb2d960af
364703.98,4.0,42,4,4,2,10,0xb2d27361
915785.13,3.0,54,4,4,2,10,0xb2d3c9e9
8865.13,1.0,3,2,2,4,8,0xb2d3f2e9
125000.0,2.0,1,3,3,4,10,0xb2d93016
236001.46,2.0,5,3,3,3,9,0xb2d650c3
162.43,1.0,19,1,2,2,5,0xb2d9672c
9.82,1.0,7,1,2,3,6,0xb2d6eb47
465281.64,20.0,1,4,4,4,12,0xb2d6e13a
1000065.74,3.0,92,4,4,1,9,0xb2d503b8
51231.16,2.0,60,2,3,2,7,0xb2d6983b
382910.94,10.0,0,4,4,4,12,0x3b9b26dc
12497.33,1.0,14,2,2,3,7,0xb2d9c993
40726.89,1.0,184,2,2,1,5,0xb2d2c136
5009484.16,1.0,162,4,2,1,7,0xb2d6f097
4328.95,1.0,11,2,2,3,7,0xb2d99a5c
750105.0,8.0,0,4,4,4,12,0xb2d67d66
956849.55,8.0,0,4,4,4,12,0xb2d51287
479834.09,9.0,0,4,4,4,12,0x3b9af171
287.96,1.0,13,1,2,3,6,0xb2d26498
109404.73,3.0,0,3,4,4,11,0xb2d171a3
3516153.86,7.0,18,4,4,2,10,0xb2d23e5e
6627.03,1.0,0,2,2,4,8,0xb2d3bc5b
910761.84,4.0,0,4,4,4,12,0xb2d330c5
10.74,1.0,60,1,2,2,5,0xb2d129d7
8250.98,1.0,0,2,2,4,8,0xb2d6b8db
950000.0,12.0,1,4,4,4,12,0xb2d5923c
150000.0,2.0,3,3,3,4,10,0xb2d6176d
34150.64,1.0,92,2,2,1,5,0xb2d52527
10111.83,3.0,92,2,4,1,7,0xb2d18361
170589.92,5.0,0,3,4,4,11,0xb2d54f60
25003.59,2.0,108,2,3,1,6,0xb2d56fce
200013.68,4.0,47,3,4,2,9,0xb2d564e0
62547.07,2.0,4,3,3,4,10,0xb2d065ea
10123.97,1.0,7,2,2,3,7,0xb2d6bb6b
0.0,1.0,4,1,2,4,7,0xb2d92e68
51016.26,1.0,92,2,2,1,5,0xb2d5902f
120001.27,2.0,21,3,3,2,8,0xb2da1a10
157690.55,2.0,1,3,3,4,10,0xb2d28abe
102642.56,1.0,1,3,2,4,9,0xb2d3316a
30000.23,2.0,1,2,3,4,9,0xb2da1e3b
8315.49,1.0,0,2,2,4,8,0xb2d906b3
368614.32,1.0,2,4,2,4,10,0xb2d6ed25
291372.28,4.0,3,3,4,4,11,0xb2d21139
1002104.64,9.0,18,4,4,2,10,0xb2d1a46a
2000000.0,1.0,0,4,2,4,10,0xb2da6922
41476.34,1.0,11,2,2,3,7,0xb2d2a3e5
1609.75,1.0,92,1,2,1,4,0x3b9b3427
178008.9,4.0,15,3,4,3,10,0xb2d16a27
2005.91,1.0,57,1,2,2,5,0xb2d5cf4b
50046.12,2.0,76,2,3,1,6,0xb2d155c7
50001.06,2.0,199,2,3,1,6,0xb2d69945
115594.08,3.0,171,3,4,1,8,0xb2d323e6
724503.92,4.0,47,4,4,2,10,0xb2d44289
4095.85,1.0,92,2,2,1,5,0xb2d3925f
500193.23,2.0,62,4,3,2,9,0xb2d176f9
48.67,1.0,42,1,2,2,5,0xb2d63822
15000209.56,4.0,11,4,4,3,11,0xb2da2f32
140470.53,2.0,25,3,3,2,8,0xb2d86814
3039.42,1.0,9,2,2,3,7,0xb2d2c3ee
52000.93,3.0,48,2,4,2,8,0xb2d910d3
1750257.17,15.0,10,4,4,3,11,0x3b9b1811
3775.99,1.0,18,2,2,2,6,0xb2d60b86
203062.71,2.0,103,3,3,1,7,0xb2d6370f
28.59,1.0,155,1,2,1,4,0xb2d279eb
160457.79,2.0,92,3,3,1,7,0xb2d98068
5776.46,1.0,16,2,2,2,6,0xb2d0b4d5
606754.59,3.0,189,4,4,1,9,0xb2d1b76d
24421.93,1.0,0,2,2,4,8,0xb2d8eacc
2130000.0,1.0,1,4,2,4,10,0xb2da5de8
1760.41,1.0,9,1,2,3,6,0xb2d2e61d
30890.61,2.0,0,2,3,4,9,0xb2d38e65
55648.61,2.0,11,3,3,3,9,0xb2d0f744
276106.88,5.0,130,3,4,1,8,0xb2d4232c
200710.43,2.0,41,3,3,2,8,0xb2d9f01e
20.32,1.0,2,1,2,4,7,0xb2d91cf1
50070.97,2.0,69,2,3,1,6,0xb2d6895e
50007.29,2.0,80,2,3,1,6,0xb2d08fab
10000.11,2.0,66,2,3,2,7,0xb2d8f2f8
240860.22,2.0,50,3,3,2,8,0xb2d3d592
455000.83,3.0,15,4,4,3,11,0xb2d90bd7
103000.0,2.0,1,3,3,4,10,0xb2d5a95a
224.44,1.0,30,1,2,2,5,0xb2d251d2
155.84,1.0,3,1,2,4,7,0xb2d4f742
0.22,1.0,67,1,2,1,4,0xb2d52911
1043258.44,2.0,7,4,3,3,10,0xb2d0cb5e
337040.05,2.0,58,4,3,2,9,0xb2d783dc
2627.06,1.0,92,1,2,1,4,0xb2d38ad5
151005.53,2.0,4,3,3,4,10,0xb2d6ac3c
150002.49,2.0,6,3,3,3,9,0xb2d966bf
2300180.18,2.0,108,4,3,1,8,0xb2d48082
4951.06,1.0,1,2,2,4,8,0xb2d6cb03
1351.25,1.0,184,1,2,1,4,0xb2d270a3
487261.77,3.0,0,4,4,4,12,0xb2d0857e
106198.37,1.0,7,3,2,3,8,0xb2d4d039
120000.0,1.0,0,3,2,4,9,0xb2da6a64
1.54,1.0,10,1,2,3,6,0xb2d354a1
44.31,1.0,75,1,2,1,4,0xb2d43840
3201.89,1.0,21,2,2,2,6,0xb2d91345
24.87,1.0,34,1,2,2,5,0xb2d977ed
466.6,1.0,12,1,2,3,6,0xb2d237b0
360017.46,9.0,6,4,4,3,11,0xb2d07689
159003.75,5.0,11,3,4,3,10,0xb2d9ba33
1785624.58,6.0,0,4,4,4,12,0xb2d18589
450024.81,3.0,62,4,4,2,10,0xb2d9afd2
27099.32,1.0,20,2,2,2,6,0xb2d60993
583032.72,6.0,1,4,4,4,12,0xb2d5987a
330061.74,2.0,98,4,3,1,8,0xb2d1b1af
307903.73,4.0,80,4,4,1,9,0xb2d0d2c1
32749.99,1.0,0,2,2,4,8,0xb2d6d5a3
11205.34,1.0,29,2,2,2,6,0xb2d6b7c3
290068.26,5.0,77,3,4,1,8,0xb2d3a44a
1703.9,1.0,265,1,2,1,4,0xb2d6b99a
107640.24,2.0,167,3,3,1,7,0xb2d34f08
377135.01,1.0,4,4,2,4,10,0xb2d3451a
160011.14,3.0,5,3,4,3,10,0xb2d57398
2936.73,1.0,13,2,2,3,7,0xb2d261e5
420477.01,2.0,5,4,3,3,10,0xb2d96ffc
422.62,1.0,20,1,2,2,5,0xb2d55443
121894.6,2.0,0,3,3,4,10,0xb2d0cdbb
506.75,1.0,0,1,2,4,7,0xb2d5c869
504976.72,3.0,0,4,4,4,12,0xb2d1e0fd
420729.99,6.0,18,4,4,2,10,0xb2d62865
460627.54,3.0,39,4,4,2,10,0xb2d33b8d
1150000.39,6.0,6,4,4,3,11,0xb2d64741
56021.38,1.0,4,3,2,4,9,0xb2d975d6
301624.9,3.0,22,4,4,2,10,0xb2d6cbc5
21490.41,2.0,0,2,3,4,9,0xb2d0cb9b
527226.07,7.0,1,4,4,4,12,0xb2d11d98
956754.84,2.0,8,4,3,3,10,0xb2d3f968
5.57,1.0,93,1,2,1,4,0xb2d6094d
303197.78,2.0,34,4,3,2,9,0xb2d8a654
1152481.35,11.0,8,4,4,3,11,0xb2d48b5e
4985.08,1.0,6,2,2,3,7,0xb2d2a9bd
62708.06,2.0,82,3,3,1,7,0xb2d63d1f
6854.04,1.0,92,2,2,1,5,0xb2d1717e
92466.67,3.0,42,3,4,2,9,0xb2d51c92
36669.97,1.0,20,2,2,2,6,0xb2d12c8a
40686.25,1.0,14,2,2,3,7,0xb2d919c4
140016.01,2.0,5,3,3,3,9,0x3b9b4118
214239.3,2.0,214,3,3,1,7,0xb2d23bd0
777604.26,4.0,32,4,4,2,10,0xb2d57399
172548.46,3.0,27,3,4,2,9,0xb2d6a4f4
262098.74,9.0,0,3,4,4,11,0xb2d065fb
212596.19,2.0,9,3,3,3,9,0xb2d31605
904727.89,4.0,3,4,4,4,12,0xb2d2d2b3
102104.78,2.0,59,3,3,2,8,0xb2d56076
540.43,1.0,6,1,2,3,6,0xb2d2771c
480066.35,8.0,0,4,4,4,12,0xb2d17bc5
74149.51,2.0,87,3,3,1,7,0xb2d390f8
500052.79,2.0,14,4,3,3,10,0xb2d7c83b
458269.82,3.0,18,4,4,2,10,0x3b9b4293
220001.05,3.0,10,3,4,3,10,0xb2d925bf
557263.74,5.0,31,4,4,2,10,0xb2d5d5c6
192.14,1.0,37,1,2,2,5,0xb2d7f002
200008.44,2.0,83,3,3,1,7,0xb2d8ce49
50000.53,2.0,49,2,3,2,7,0xb2d9d5f2
628164.53,13.0,8,4,4,3,11,0xb2d49fa4
3286.0,1.0,113,2,2,1,5,0xb2d0fb8b
12560.24,1.0,4,2,2,4,8,0xb2d801e3
11154.73,1.0,6,2,2,3,7,0xb2d382ad
65000.0,2.0,0,3,3,4,10,0xb2d1ba25
62470.54,2.0,228,3,3,1,7,0xb2d2c54e
1109.16,1.0,92,1,2,1,4,0xb2d1a60e
770.6,1.0,0,1,2,4,7,0xb2d2ad05
129539.7,8.0,0,3,4,4,11,0xb2d1e71f
53706.02,2.0,154,3,3,1,7,0xb2d0e622
158066.92,6.0,55,3,4,2,9,0xb2d14a26
300049.76,2.0,3,3,3,4,10,0xb2d415a2
161002.02,6.0,60,3,4,2,9,0xb2d51932
320000.0,2.0,10,4,3,3,10,0xb2da0a50
4325.21,1.0,6,2,2,3,7,0xb2d4fd6f
300016.83,2.0,32,3,3,2,8,0xb2d27aa5
563.32,1.0,82,1,2,1,4,0xb2d16e8d
467512.68,2.0,5,4,3,3,10,0xb2d31459
490029.09,2.0,92,4,3,1,8,0xb2d6438b
102946.67,2.0,87,3,3,1,7,0xb2d5dcd1
1050023.46,5.0,10,4,4,3,11,0xb2d5018d
320869.93,5.0,6,4,4,3,11,0xb2d4e714
150006.62,2.0,122,3,3,1,7,0xb2d6482c
872088.47,6.0,32,4,4,2,10,0xb2d5a575
6609.91,1.0,5,2,2,3,7,0xb2d2a8ce
349007.11,3.0,90,4,4,1,9,0xb2d594fe
0.08,4.0,67,1,4,1,6,0x3b9b1a2f
1490011.83,10.0,14,4,4,3,11,0xb2d40b2e
250023.75,2.0,83,3,3,1,7,0xb2d5a291
1650.79,1.0,10,1,2,3,6,0xb2d24062
174547.13,6.0,0,3,4,4,11,0xb2d2da33
258017.79,11.0,10,3,4,3,10,0xb2d26bfd
1403000.0,6.0,0,4,4,4,12,0xb2d33e52
120027.12,3.0,32,3,4,2,9,0xb2d5bced
586196.67,16.0,0,4,4,4,12,0x3b9af108
1100010.97,13.0,1,4,4,4,12,0xb2d500fc
561162.02,4.0,0,4,4,4,12,0xb2d51f28
1174.14,1.0,184,1,2,1,4,0xb2d2344d
1506.95,1.0,3,1,2,4,7,0xb2d3194f
1976154.08,4.0,10,4,4,3,11,0xb2d524f3
530000.0,2.0,15,4,3,3,10,0xb2d9ddfe
804650.93,8.0,1,4,4,4,12,0xb2d1f50c
1467297.28,5.0,130,4,4,1,9,0xb2d0bd79
152385.82,2.0,87,3,3,1,7,0xb2d650e1
1135155.89,1.0,1,4,2,4,10,0xb2d1e126
795.43,1.0,0,1,2,4,7,0xb2d6f343
147941.71,7.0,1,3,4,4,11,0xb2d1291e
50058.99,2.0,213,2,3,1,6,0xb2d24d02
2704.31,1.0,7,1,2,3,6,0xb2d23880
26.39,1.0,1,1,2,4,7,0xb2d6b084d
750026.53,3.0,4,4,4,4,12,0xb2d94498
82915.54,1.0,0,3,2,4,9,0xb2d3db8c
725005.1,11.0,21,4,4,2,10,0xb2d0eb19
350007.39,1.0,11,4,2,3,9,0xb2d9672cd
2042.17,1.0,92,1,2,1,4,0xb2d30e17
620000.0,4.0,1,4,4,4,12,0xb2da5fd2
3577.11,1.0,184,2,2,1,5,0xb2d276d9
29.59,1.0,22,1,2,2,5,0xb2d3087a
400077.37,3.0,13,4,4,3,11,0xb2d61cc4
23738.56,1.0,11,2,2,3,7,0xb2d5e5bb
37.28,1.0,0,1,2,4,7,0xb2d8d28b
48287.42,1.0,0,2,2,4,8,0xb2d465a6
390889.58,3.0,8,4,4,3,11,0xb2d9db3e
157.47,1.0,16,1,2,2,5,0xb2d9e415
2553.99,1.0,13,1,2,3,6,0xb2d6195c
15032.77,1.0,0,2,2,4,8,0xb2d54c1d
6565.31,1.0,14,2,2,3,7,0xb2d9de32
8578814.07,20.0,0,4,4,4,12,0xb2d653bb
69.65,1.0,9,1,2,3,6,0xb2d43c44
1915.83,1.0,0,1,2,4,7,0xb2d1c994
210002.22,5.0,21,3,4,2,9,0xb2d9c61a
703.21,2.0,22,1,3,2,6,0xb2d2e1c4
5476.66,1.0,28,2,2,2,6,0xb2d25086
533000.0,6.0,1,4,4,4,12,0xb2d3e41d
60048.03,2.0,110,3,3,1,7,0xb2d59cab
321432.69,2.0,48,4,3,2,9,0xb2d0c63a
1807.46,1.0,92,1,2,1,4,0xb2d14cc4
30.16,1.0,33,1,2,2,5,0xb2d31f49
300003.17,2.0,52,3,3,2,8,0xb2d90c51
366.85,1.0,7,1,2,3,6,0xb2d69b74
224799.71,3.0,3,3,4,4,11,0xb2d617a0
0.0,1.0,6,1,2,3,6,0xb2d3f812
2434.74,1.0,27,1,2,2,5,0xb2d5d83d
134.08,1.0,0,1,2,4,7,0xb2d743bb
16.42,1.0,101,1,2,1,4,0xb2d0b213
2550.49,1.0,184,1,2,1,4,0xb2d35a50
86.66,1.0,75,1,2,1,4,0xb2d8db3e
16999.73,3.0,0,2,4,4,10,0xb2d2a9c8
85003.01,2.0,93,3,3,1,7,0xb2d95144
158752.71,2.0,18,3,3,2,8,0xb2d18691
359963.37,3.0,83,4,4,1,9,0xb2d5cf05
222633.79,4.0,4,3,4,4,11,0xb2d76440
30005.23,2.0,3,2,3,4,9,0xb2d467fc
56695.16,2.0,104,3,3,1,7,0xb2d25bec
11540.59,1.0,12,2,2,3,7,0xb2d6d2cf
2098375.19,5.0,0,4,4,4,12,0xb2d4154d
526913.18,18.0,0,4,4,4,12,0xb2d0d514
50306.64,2.0,143,2,3,1,6,0xb2d54a8f
6168.5,6.0,0,2,4,4,10,0x3b9b4267
78.94,1.0,45,1,2,2,5,0xb2d4f943
3917.06,1.0,19,2,2,2,6,0xb2d60aca
233.91,1.0,0,1,2,4,7,0xb2d0ad2d
127008.4,4.0,10,3,4,3,10,0xb2d43a6e
86530.89,1.0,20,3,2,2,7,0xb2d6bb3e
1759.81,2.0,120,1,3,1,5,0x3b9adbba
38667.73,2.0,0,2,3,4,9,0xb2d15456
100.59,1.0,257,1,2,1,4,0xb2d395b2
1000000.0,2.0,3,4,3,4,11,0xb2d97857
267208.81,2.0,40,3,3,2,8,0x3b9b2f2e
321170.51,3.0,19,4,4,2,10,0xb2d4c158
1184.25,1.0,9,1,2,3,6,0xb2d4ed3a
1873.25,1.0,0,1,2,4,7,0xb2d62d25
251326.25,6.0,39,3,4,2,9,0xb2d65884
342899.89,2.0,38,4,3,2,9,0xb2d6033b
10137.96,1.0,92,2,2,1,5,0xb2d115f7
21779.39,1.0,9,2,2,3,7,0xb2d5898e
13003.33,1.0,0,2,2,4,8,0xb2d6a51c
853279.99,6.0,60,4,4,2,10,0x3b9b124c
910903.47,11.0,25,4,4,2,10,0xb2d3a7fc
180326.69,3.0,0,3,4,4,11,0xb2d40521
49.18,1.0,58,1,2,2,5,0xb2d30497
173875.24,2.0,5,3,3,3,9,0xb2d580cf
331065.63,3.0,6,4,4,3,11,0xb2d58e16
626.62,1.0,4,1,2,4,7,0xb2d5851b
195688.37,3.0,10,3,4,3,10,0xb2d6322e
21081.5,3.0,109,2,4,1,7,0xb2d6276e
445246.13,5.0,0,4,4,4,12,0xb2d4f35c
723107.29,6.0,7,4,4,3,11,0xb2d5b064
339725.0,4.0,0,4,4,4,12,0xb2d58b34
1382991.27,14.0,8,4,4,3,11,0xb2d5d385
80093.64,2.0,11,3,3,3,9,0xb2d91916
3032.13,1.0,9,2,2,3,7,0xb2d93117
109.55,1.0,59,1,2,2,5,0xb2d565b1
315848.93,3.0,0,4,4,4,12,0xb2d2d066
50634.12,1.0,4,2,2,4,8,0xb2d9551a
61564.34,1.0,184,3,2,1,6,0xb2d40f6b
3370.55,1.0,213,2,2,1,5,0xb2d3b77a
300772.39,2.0,3,4,3,4,11,0xb2d9eae0
1517.91,2.0,184,1,3,1,5,0xb2d16463
300000.0,2.0,4,3,3,4,10,0xb2d9cc24
13583.82,1.0,0,2,2,4,8,0xb2d68055
500033.28,4.0,52,4,4,2,10,0xb2d0f93b
446543.03,1.0,0,4,2,4,10,0xb2d125c7
901097.06,3.0,132,4,4,1,9,0xb2d16f93
1035.72,1.0,8,1,2,3,6,0xb2d8dda8
4810.03,1.0,0,2,2,4,8,0xb2d6ac8a
1700000.0,6.0,7,4,4,3,11,0xb2d689f7
10290.2,1.0,7,2,2,3,7,0xb2d64dc8
1951.33,1.0,92,1,2,1,4,0xb2d2e503
350040.78,2.0,143,4,3,1,8,0xb2d612c0
88321.81,2.0,125,3,3,1,7,0xb2d27800
1389.21,2.0,92,1,3,1,5,0x3b9b4678
101915.7,2.0,184,3,3,1,7,0x3b9b25ee
60978.91,2.0,6,3,3,3,9,0xb2d24e99
1277.86,1.0,92,1,2,1,4,0xb2d59df4
220783.83,4.0,11,3,4,3,10,0x3b9b145e
2201.48,1.0,1,1,2,4,7,0xb2d200c1
2498.41,1.0,2,1,2,4,7,0xb2d9021b
308575.16,1.0,0,4,2,4,10,0xb2d51ea9
578057.18,1.0,0,4,2,4,10,0xb2d6dc1b
1371.43,1.0,16,1,2,2,5,0xb2d37c60
615011.71,5.0,3,4,4,4,12,0xb2d1b9a9
156590.82,3.0,6,3,4,3,10,0xb2d1c136
218098.83,10.0,0,3,4,4,11,0xb2d0d77b
6038.97,1.0,6,2,2,3,7,0xb2d48c26
280317.62,5.0,48,3,4,2,9,0xb2d5b658
322331.81,2.0,41,4,3,2,9,0xb2d1e5b1
4102.7,1.0,12,2,2,3,7,0xb2d63b5b
662201.63,3.0,14,4,4,3,11,0xb2d278be
10195.0,2.0,184,2,3,1,6,0xb2d5c1e2
920065.42,5.0,20,4,4,2,10,0xb2d2a983
307847.88,3.0,14,4,4,3,11,0xb2d0d2c1d
6.02,1.0,18,1,2,2,5,0xb2d6d5b5d
6669.53,1.0,20,2,2,2,6,0xb2d5fb1d
99042.31,3.0,24,3,4,2,9,0xb2d54ec3
1.0,1.0,92,1,2,1,4,0xb2d29f0c
3141.68,1.0,184,2,2,1,5,0x3b9b1350
779.0,2.0,6,1,3,3,7,0xb2d46862
69962.88,7.0,1,3,4,4,11,0xb2d3f488
0.01,7.0,0,1,4,4,9,0xb2d09eb3
107687.97,3.0,4,3,4,4,11,0xb2d31d21
220781.47,2.0,41,3,3,2,8,0xb2d9f0ad
62973.27,4.0,0,3,4,4,11,0xb2d374bf
59126.5,4.0,4,3,4,4,11,0xb2d6ac3e
1721.28,1.0,92,1,2,1,4,0xb2d1fb10
223940.65,2.0,116,3,3,1,7,0xb2d2e3c2
1749.19,2.0,184,1,3,1,5,0xb2d07fbd
52486.6,2.0,4,3,3,4,10,0xb2d5e8e6
10024.83,1.0,92,2,2,1,5,0xb2d6527f
300091.97,4.0,5,3,4,3,10,0xb2d0e9c9
400010.47,3.0,4,4,4,4,12,0xb2d9cc7d
20115.23,2.0,32,2,3,2,7,0xb2d92830
50040.75,2.0,3,2,3,4,9,0xb2d5ffc7
120001.26,3.0,48,3,4,2,9,0xb2d98e84
14.55,1.0,6,1,2,3,6,0xb2d593b9
300013.58,2.0,92,3,3,1,7,0xb2d132b8
8278.62,1.0,92,2,2,1,5,0xb2d28cd1
1482.67,1.0,92,1,2,1,4,0xb2d23160
139.87,1.0,9,1,2,3,6,0xb2d39509
51461.58,2.0,3,2,3,4,9,0xb2d23795
942.1,1.0,9,1,2,3,6,0xb2d2c375
2253.67,1.0,29,1,2,2,5,0xb2d43006
5315.03,1.0,15,2,2,3,7,0xb2d64abf
168.0,1.0,34,1,2,2,5,0xb2d4b355
639475.46,4.0,34,4,4,2,10,0xb2d4355a
0.0,1.0,0,1,2,4,7,0xb2d38097
268111.88,5.0,80,3,4,1,8,0xb2d39ae0
10009.71,1.0,86,2,2,1,5,0xb2d1a31c
500058.66,2.0,2,4,3,4,11,0xb2d1207b
12073.29,1.0,217,2,2,1,5,0xb2d1d295
16319.6,1.0,11,2,2,3,7,0xb2d39560
37953.37,1.0,12,2,2,3,7,0xb2d61bf6
14198.53,1.0,9,2,2,3,7,0xb2d57acd
500076.04,2.0,8,4,3,3,10,0xb2d9f6a9
183.82,1.0,11,1,2,3,6,0xb2d488a9
52676.03,10.0,0,3,4,4,11,0xb2d270dd
500059.53,4.0,16,4,4,2,10,0xb2d5b6e7
1770.0,2.0,267,1,3,1,5,0xb2d224bc
559412.23,6.0,1,4,4,4,12,0xb2d49295
96.31,1.0,19,1,2,2,5,0xb2d2fca4
1886.38,1.0,9,1,2,3,6,0xb2d24722
1316.58,3.0,92,1,4,1,6,0x3b9ae425
55120.85,2.0,231,3,3,1,7,0xb2d41d7d
325423.82,2.0,231,4,3,1,8,0xb2d609b9
120007.74,2.0,27,3,3,2,8,0xb2d3ecdd
6642.56,1.0,0,2,2,4,8,0xb2d5ee6c
100078.74,3.0,31,3,4,2,9,0xb2d06fcd
155246.41,3.0,18,3,4,2,9,0xb2d0ee98
400070.68,3.0,8,4,4,3,11,0xb2d92b3c
18.01,2.0,6,1,3,3,7,0x3b9af19a
2133.64,1.0,173,1,2,1,4,0xb2d3b9ca
32469.45,1.0,10,2,2,3,7,0xb2d9af89
953033.78,2.0,2,4,3,4,11,0xb2d9f689
122001.29,2.0,48,3,3,2,8,0xb2d91271
681102.36,3.0,92,4,4,1,9,0xb2d3d380
23.07,39.0,13,1,4,3,8,0xb2d0fe25
120766.32,4.0,32,3,4,2,9,0xb2d8cca5
3566.7,1.0,145,2,2,1,5,0xb2d61a7c
71046.44,2.0,0,3,3,4,10,0xb2d69b51
6781.24,1.0,7,2,2,3,7,0xb2d3cfdd
10364.93,1.0,96,2,2,1,5,0xb2d6283f
94082.67,1.0,6,3,2,3,8,0x3b9ad0b0
1671.87,1.0,175,1,2,1,4,0xb2d2dc76
71060.69,3.0,4,3,4,4,11,0xb2d8fd92
15741.98,1.0,45,2,2,2,6,0xb2d27fc1
7587.12,1.0,0,2,2,4,8,0xb2d918ba
2950098.0,7.0,0,4,4,4,12,0xb2d9451c
512262.17,11.0,0,4,4,4,12,0xb2d0ca09
83.2,1.0,58,1,2,2,5,0xb2d2f0af
500163.75,1.0,3,4,2,4,10,0xb2d32751
48.09,1.0,6,1,2,3,6,0xb2d5dd96
3360199.65,4.0,0,4,4,4,12,0xb2d072e2
10043.13,1.0,92,2,2,1,5,0xb2d53d35
200027.56,2.0,139,3,3,1,7,0xb2d19fb4
5020.23,2.0,184,2,3,1,6,0x3b9b159f
25044.39,2.0,106,2,3,1,6,0xb2d68eab
220021.86,4.0,6,3,4,3,10,0xb2d19ead
1624.65,1.0,184,1,2,1,4,0xb2d561b8
417143.1,7.0,20,4,4,2,10,0x3b9af26b
53001.12,2.0,101,3,3,1,7,0xb2d80e50
2066.22,1.0,1,1,2,4,7,0xb2d5dbbd
500006.04,2.0,20,4,3,2,9,0xb2d9d632
295.44,1.0,92,1,2,1,4,0xb2d29bf5
2162.21,1.0,50,1,2,2,5,0xb2d19e75
3103.2,1.0,184,2,2,1,5,0xb2d1a48c
3960.21,1.0,1,2,2,4,8,0xb2d30a70
354580.66,3.0,18,4,4,2,10,0xb2d9358c
157069.81,7.0,21,3,4,2,9,0x3b9b3cf6
750006.25,46.0,0,4,4,4,12,0xb2d0b6ca
77915.46,4.0,0,3,4,4,11,0xb2d31549
0.53,1.0,25,1,2,2,5,0xb2d948a2
242.58,1.0,4,1,2,4,7,0xb2d21a95
77.67,3.0,13,1,4,3,8,0xb2d317cd
200000.0,2.0,1,3,3,4,10,0xb2da6906
50649.14,3.0,0,2,4,4,10,0xb2d15e11
133416.99,6.0,18,3,4,2,9,0xb2d460e8
102139.94,1.0,1,3,2,4,9,0xb2d17d6b
2723.78,1.0,0,1,2,4,7,0xb2d61779
120426.35,2.0,133,3,3,1,7,0xb2d58a5d
150045.98,2.0,80,3,3,1,7,0xb2d605d9
4.89,1.0,26,1,2,2,5,0xb2d6f1fa
472889.72,5.0,0,4,4,4,12,0xb2d5b0a9
0.67,1.0,75,1,2,1,4,0xb2d78b7f
2561.71,1.0,19,1,2,2,5,0xb2d1f257
4355.46,1.0,3,2,2,4,8,0xb2d90807
108.53,1.0,6,1,2,3,6,0xb2d55823
100053.3,4.0,39,3,4,2,9,0xb2d0a7ff
344.38,1.0,24,1,2,2,5,0xb2d2b296
34803.01,4.0,5,2,4,3,9,0x3b9ad078
1258.56,1.0,7,1,2,3,6,0xb2d9d6f1
8367.71,1.0,22,2,2,2,6,0xb2d6a7d8
1017773.86,2.0,83,4,3,1,8,0xb2d8d406
1548.62,1.0,3,1,2,4,7,0xb2d0da46
124908.8,2.0,77,3,3,1,7,0xb2d5e649
30038.77,2.0,129,2,3,1,6,0xb2d695fa
7.45,1.0,138,1,2,1,4,0xb2d5dfbb
232968.23,5.0,6,3,4,3,10,0xb2d4d984
6283.63,1.0,1,2,2,4,8,0xb2d8d633
111186.09,2.0,158,3,3,1,7,0xb2d6c679
47.97,2.0,75,1,3,1,5,0xb2d54ad9
818244.42,3.0,25,4,4,2,10,0xb2d15034
2311942.39,4.0,0,4,4,4,12,0xb2d3671a
38539.22,1.0,10,2,2,3,7,0xb2d34bbf
42988.77,1.0,92,2,2,1,5,0xb2d5e836
220025.42,2.0,129,3,3,1,7,0xb2d4141f
3242.67,1.0,0,2,2,4,8,0xb2d3f5d1
1014.29,1.0,92,1,2,1,4,0xb2d15965
68342.38,1.0,10,3,2,3,8,0xb2d5a093
754010.65,4.0,0,4,4,4,12,0xb2d574bb
39495.07,1.0,9,2,2,3,7,0xb2d2e3a3
31721.99,1.0,18,2,2,2,6,0xb2d6a354
370027.78,2.0,0,4,3,4,11,0xb2d22d73
120016.61,2.0,256,3,3,1,7,0xb2d23599
51286.45,2.0,12,2,3,3,8,0xb2d1f9d3
1290.34,4.0,1,1,4,4,9,0xb2d6085e
3116.61,1.0,0,2,2,4,8,0xb2d30b8f
865.78,1.0,13,1,2,3,6,0xb2d2703f
46912.93,1.0,0,2,2,4,8,0xb2d3a415
180763.11,9.0,1,3,4,4,11,0xb2d8e0f2
320028.43,3.0,2,4,4,4,12,0xb2d6db84
7659.65,1.0,5,2,2,3,7,0xb2d2e26c
1939102.61,4.0,39,4,4,2,10,0xb2d23b4a
50574.61,4.0,63,2,4,2,8,0xb2d67e38
95.18,1.0,12,1,2,3,6,0xb2d488c6
1621.5,3.0,92,1,4,1,6,0xb2d276a4
7883339.42,2.0,41,4,3,2,9,0xb2d2b757
136.19,1.0,13,1,2,3,6,0xb2d0c728
311905.27,1.0,10,4,2,3,9,0xb2d6111a
50585.64,2.0,32,2,3,2,7,0xb2d45afe
2257611.69,11.0,4,4,4,4,12,0xb2d1c70c
87.86,1.0,15,1,2,3,6,0xb2d0fb8bd
5071.15,1.0,92,2,2,1,5,0xb2d15e3a
4010606.71,5.0,29,4,4,2,10,0xb2d9400b
1477.04,3.0,0,1,4,4,9,0x3b9b45d9
1120000.0,5.0,82,4,4,1,9,0xb2d403b5
3401.11,1.0,209,2,2,1,5,0xb2d4e7f2
410066.37,2.0,139,4,3,1,8,0xb2d24d98
537.85,1.0,96,1,2,1,4,0xb2d87901
19709.5,1.0,158,2,2,1,5,0xb2d40659
484057.97,5.0,7,4,4,3,11,0xb2d389d2
645.32,3.0,0,1,4,4,9,0xb2d19263
261301.86,2.0,97,3,3,1,7,0xb2d4f29a
300090.97,2.0,22,3,3,2,8,0xb2d68e27
54000.0,2.0,4,3,3,4,10,0xb2da5984
419.72,1.0,16,1,2,2,5,0xb2d28d6b
50076.09,2.0,0,2,3,4,9,0xb2d15cf9
100760.3,1.0,0,3,2,4,9,0xb2d9575b
200041.73,2.0,26,3,3,2,8,0xb2d6df97
972303.96,5.0,27,4,4,2,10,0xb2d63672
140867.94,4.0,4,3,4,4,11,0xb2d14674
380018.03,7.0,52,4,4,2,10,0xb2d6404c
1285.84,1.0,0,1,2,4,7,0xb2d96264
94305.17,2.0,2,3,3,4,10,0xb2d82674
900025.33,6.0,46,4,4,2,10,0xb2d12df7
100078.47,1.0,24,3,2,2,7,0xb2d34088
9.53,1.0,0,1,2,4,7,0xb2d6e206
2.53,1.0,2,1,2,4,7,0xb2d2f59a
500009.75,4.0,7,4,4,3,11,0xb2d65888
39686.81,1.0,92,2,2,1,5,0xb2d3dbc7
370080.95,9.0,41,4,4,2,10,0xb2d08614
53121.26,1.0,36,3,2,2,7,0xb2d4466d
20.37,1.0,0,1,2,4,7,0xb2d49e58
668.44,1.0,74,1,2,1,4,0xb2d763a7
2064029.88,2.0,132,4,3,1,8,0xb2d6a57b
20084.03,2.0,174,2,3,1,6,0xb2d5cb7b
100001.79,2.0,158,3,3,1,7,0xb2d6bd6c
341066.51,1.0,12,4,2,3,9,0xb2d369b2
3128.83,1.0,92,2,2,1,5,0xb2d099d4
1225.17,1.0,10,1,2,3,6,0xb2d5b945
200000.0,3.0,7,3,4,3,10,0xb2d60162
4942.18,1.0,11,2,2,3,7,0xb2d34d8a
10233.2,1.0,9,2,2,3,7,0xb2d6edf0
2024.15,1.0,184,1,2,1,4,0xb2d0e210
10270.43,2.0,3,2,3,4,9,0xb2d53052
780001.78,8.0,4,4,4,4,12,0xb2d1a937
7.93,1.0,6,1,2,3,6,0xb2d64b62
380727.51,7.0,97,4,4,1,9,0xb2d514c4
16833.58,1.0,92,2,2,1,5,0xb2d2106f
17306.95,1.0,5,2,2,3,7,0xb2d69b5f
10073.68,2.0,143,2,3,1,6,0xb2d5e5b4
150482.61,4.0,47,3,4,2,9,0xb2d68aca
822104.45,1.0,246,4,2,1,7,0xb2d5909c
100882.8,2.0,164,3,3,1,7,0xb2d4175b
314103.39,2.0,76,4,3,1,8,0xb2d8dcb2
406753.71,6.0,6,4,4,3,11,0xb2d5a1a5
2019.91,1.0,92,1,2,1,4,0xb2d29f75
590008.57,2.0,27,4,3,2,9,0xb2d0f282
500972.39,3.0,14,4,4,3,11,0xb2d3467e
783.64,1.0,0,1,2,4,7,0xb2d62a0f
138.98,1.0,1,1,2,4,7,0xb2d55005
820720.49,7.0,17,4,4,2,10,0xb2d7881f
24609.57,1.0,1,2,2,4,8,0xb2d23c08
1200000.0,1.0,0,4,2,4,10,0xb2d98065
8006.16,1.0,83,2,2,1,5,0xb2d964c1
444834.29,11.0,0,4,4,4,12,0xb2d2b26d
326564.97,2.0,143,4,3,1,8,0xb2d17784
250763.44,1.0,11,3,2,3,8,0xb2d4116f
500888.11,3.0,20,4,4,2,10,0xb2d9d644
5163.06,20.0,7,2,4,3,9,0xb2d5137e
37467.25,1.0,184,2,2,1,5,0xb2d43c04
131016.3,3.0,11,3,4,3,10,0x3b9b2c1e
298249.48,2.0,125,3,3,1,7,0xb2d6de1f
9696.52,1.0,267,2,2,1,5,0xb2d5bbc6
264874.64,5.0,1,3,4,4,11,0x3b9af17a
1054.25,1.0,184,1,2,1,4,0xb2d34224
1508.79,1.0,6,1,2,3,6,0xb2d20e6c
10809.72,1.0,0,2,2,4,8,0xb2d593ce
140017.53,4.0,83,3,4,1,8,0xb2d39aa6
2472.86,1.0,92,1,2,1,4,0xb2d1ac22
615.59,1.0,11,1,2,3,6,0xb2d9ef1b
12265.82,1.0,16,2,2,2,6,0xb2d5a750
7779.82,1.0,1,2,2,4,8,0xb2d966ef
30400.5,3.0,55,2,4,2,8,0xb2d69c8b
2301611.68,2.0,1,4,3,4,11,0xb2d4cab3
331.5,1.0,101,1,2,1,4,0xb2d6827f
2568.13,1.0,15,1,2,3,6,0xb2d26150
1105015.63,2.0,0,4,3,4,11,0xb2d92604
1036794.6,13.0,0,4,4,4,12,0x3b9af228
143168.7,4.0,10,3,4,3,10,0xb2d33f49
14.15,1.0,19,1,2,2,5,0xb2d92836
400006.65,2.0,18,4,3,2,9,0xb2d94453
554028.7,3.0,69,4,4,1,9,0xb2d68222
0.0,1.0,1,1,2,4,7,0xb2d3f50f
8074.0,1.0,11,2,2,3,7,0xb2d35249
50003.4,2.0,77,2,3,1,6,0xb2d3acba
1400014.79,3.0,158,4,4,1,9,0xb2d89034
10.11,1.0,50,1,2,2,5,0xb2d58c13
250800.43,5.0,9,3,4,3,10,0xb2d565c7
127.96,1.0,20,1,2,2,5,0xb2d580d3
3061.32,1.0,9,2,2,3,7,0xb2d2dc07
530093.02,3.0,4,4,4,4,12,0xb2d95b6c
300000.13,2.0,3,3,3,4,10,0xb2d629fc
1000.92,1.0,96,1,2,1,4,0xb2d805d2
5888.42,1.0,4,2,2,4,8,0x3b9b35a4
20552.87,1.0,92,2,2,1,5,0xb2d0ec60
5.86,1.0,11,1,2,3,6,0xb2d5c31d
250076.75,3.0,28,3,4,2,9,0xb2d56888
43422.69,1.0,0,2,2,4,8,0xb2d1a653
292.9,1.0,76,1,2,1,4,0xb2d64dc8d
1748.6,1.0,138,1,2,1,4,0xb2d634a6
503552.6,2.0,69,4,3,1,8,0xb2d9acad
10.56,1.0,33,1,2,2,5,0xb2d9fab9
621.85,1.0,4,1,2,4,7,0xb2d906ab
130500.09,3.0,4,3,4,4,11,0xb2d0ee9e
430000.32,2.0,14,4,3,3,10,0xb2d629f0
2917.59,1.0,9,2,2,3,7,0xb2d2bd0d
102.72,1.0,10,1,2,3,6,0xb2d6c17c
503552.32,6.0,28,4,4,2,10,0x3b9b4469
551954.0,2.0,57,4,3,2,9,0xb2d9c667
1314.25,1.0,184,1,2,1,4,0xb2d290de
1410089.03,2.0,1,4,3,4,11,0xb2d4b63c
25010.26,2.0,31,2,3,2,7,0xb2d93994
1278.45,1.0,163,1,2,1,4,0xb2d4bef7
3477.36,1.0,9,2,2,3,7,0xb2d6ecd0
42926.87,1.0,0,2,2,4,8,0xb2d41d88
500075.94,10.0,3,4,4,4,12,0xb2d19656
1.72,1.0,25,1,2,2,5,0xb2d52e10
1273880.64,6.0,0,4,4,4,12,0xb2d33334
2711.62,1.0,92,1,2,1,4,0xb2d50ed1
300003.24,2.0,13,3,3,3,9,0xb2d80cfa
2366403.8,3.0,97,4,4,1,9,0xb2d08ed2
616129.71,3.0,5,4,4,3,11,0xb2d56812
90020.08,2.0,144,3,3,1,7,0xb2d16890
8710.15,1.0,104,2,2,1,5,0xb2d4e888
491532.49,4.0,18,4,4,2,10,0xb2d1ec89
239189.4,5.0,69,3,4,1,8,0xb2d1af4f
1867.31,1.0,69,1,2,1,4,0xb2d59d9a
120024.52,3.0,25,3,4,2,9,0xb2d5cb47
392.83,1.0,62,1,2,2,5,0xb2d1c049
159.79,1.0,60,1,2,2,5,0xb2d6104f
400002.12,3.0,15,4,4,3,11,0xb2d2c496
695000.0,2.0,15,4,3,3,10,0xb2d91b58
20001.06,2.0,56,2,3,2,7,0xb2d9b567
1081.38,1.0,1,1,2,4,7,0xb2d57bb7
164015.55,3.0,0,3,4,4,11,0xb2d074b8
155229.96,1.0,10,3,2,3,8,0xb2d2e847
30020.53,2.0,164,2,3,1,6,0xb2d141d5
326359.51,5.0,25,4,4,2,10,0xb2d54883
169085.25,3.0,168,3,4,1,8,0xb2d484f4
50051.54,3.0,20,2,4,2,8,0xb2d786cf
566156.56,2.0,143,4,3,1,8,0xb2d32b87
238.93,3.0,18,1,4,2,7,0x3b9b288d
0.0,2.0,9,1,3,3,7,0xb2d0e7a7
1009.18,1.0,184,1,2,1,4,0xb2d2901b
681809.78,8.0,26,4,4,2,10,0xb2d69897
2753.58,1.0,18,1,2,2,5,0xb2d2db29
220514.43,5.0,34,3,4,2,9,0xb2d38085
248037.26,5.0,66,3,4,2,9,0xb2d41034d
175004.77,3.0,82,3,4,1,8,0xb2d30455
10350.9,1.0,291,2,2,1,5,0xb2d456ea
50058.23,2.0,92,2,3,1,6,0xb2d40934
501776.15,2.0,46,4,3,2,9,0xb2d9e5c8
420075.52,8.0,14,4,4,3,11,0xb2d1910e
32.63,1.0,92,1,2,1,4,0xb2d2566c
416662.06,3.0,22,4,4,2,10,0xb2d4ebd0
102235.66,3.0,49,3,4,2,9,0xb2d5fcb2
112866.14,2.0,8,3,3,3,9,0xb2d6a7a8
8966.4,1.0,10,2,2,3,7,0xb2d5f890
600002.11,3.0,10,4,4,3,11,0xb2d95d61
320047.92,4.0,168,4,4,1,9,0xb2d23286
30000.53,3.0,21,2,4,2,8,0xb2da171e
1289.85,1.0,205,1,2,1,4,0xb2d64a66
738709.82,14.0,0,4,4,4,12,0xb2d0dbee
1.33,1.0,27,1,2,2,5,0xb2d68337
690210.31,4.0,0,4,4,4,12,0xb2d60bc6
102092.97,4.0,0,3,4,4,11,0xb2d63917
255332.94,2.0,19,3,3,2,8,0xb2d6960e
2502014.01,1.0,5,4,2,3,9,0xb2d8c81d
17935.31,1.0,6,2,2,3,7,0xb2d3ef83
630006.06,12.0,11,4,4,3,11,0xb2d33295
15627.24,2.0,92,2,3,1,6,0xb2d16859
50042.88,2.0,104,2,3,1,6,0xb2d58b6b
75.46,1.0,9,1,2,3,6,0xb2d36d32
2339901.46,5.0,139,4,4,1,9,0xb2d1269f
30.08,1.0,61,1,2,2,5,0xb2d8d4a7
1009.63,1.0,230,1,2,1,4,0xb2d642ec
109187.67,1.0,14,3,2,3,8,0xb2d21e45
86.65,1.0,0,1,2,4,7,0xb2d600b8
19145.14,1.0,116,2,2,1,5,0xb2d4fc02
260086.18,2.0,89,3,3,1,7,0xb2d22035
500000.0,2.0,1,4,3,4,11,0xb2d9818a
570087.23,3.0,144,4,4,1,9,0xb2d36dec
151642.29,2.0,30,3,3,2,8,0xb2d8d0af
102944.01,2.0,92,3,3,1,7,0xb2d36096
36.63,1.0,68,1,2,1,4,0xb2d2f84b
8226.31,1.0,1,2,2,4,8,0xb2d6c265
692602.32,3.0,19,4,4,2,10,0xb2d6a566
147112.85,1.0,7,3,2,3,8,0xb2d17878
4.26,1.0,67,1,2,1,4,0xb2d61b34
4403.63,1.0,10,2,2,3,7,0xb2d90a4e
81312.22,2.0,122,3,3,1,7,0xb2d765c0
60002.74,2.0,108,3,3,1,7,0xb2d6f1da
19609.02,1.0,240,2,2,1,5,0xb2d16de8
200866.86,2.0,0,3,3,4,10,0xb2d0e734
47838.92,1.0,11,2,2,3,7,0xb2d5b0a1
1.27,1.0,12,1,2,3,6,0xb2d95d45
10001.11,2.0,3,2,3,4,9,0xb2d9a050
59892.5,1.0,1,3,2,4,9,0xb2d55823d
772799.73,3.0,6,4,4,3,11,0xb2d1c57d
299.63,1.0,69,1,2,1,4,0xb2d758c6
85.51,2.0,63,1,3,2,6,0xb2d43c8d
10043.83,1.0,184,2,2,1,5,0xb2d43ee7
5049.76,1.0,184,2,2,1,5,0xb2d5a199
283435.94,2.0,43,3,3,2,8,0xb2d5ac0a
1019.31,1.0,92,1,2,1,4,0xb2d07c24
90000.95,2.0,77,3,3,1,7,0xb2d996fd
952490.83,5.0,3,4,4,4,12,0x3b9af130
170006.13,3.0,35,3,4,2,9,0xb2d6d9db
50000.18,2.0,4,2,3,4,9,0xb2d6495cd
795.6,1.0,0,1,2,4,7,0xb2d6b496
174117.78,5.0,10,3,4,3,10,0xb2d3bf47
11658.12,1.0,92,2,2,1,5,0xb2d352f1
602928.96,4.0,4,4,4,4,12,0xb2d766f9
17403.71,1.0,3,2,2,4,8,0xb2d2d5c4
150008.52,2.0,196,3,3,1,7,0xb2d57b6f
0.0,1.0,2,1,2,4,7,0xb2d12a00
202842.83,2.0,123,3,3,1,7,0xb2d93ef0
770567.51,4.0,21,4,4,2,10,0xb2d5ad2f
50007.71,2.0,158,2,3,1,6,0xb2d235c9
271918.4,2.0,68,3,3,1,7,0xb2d8f0ee
503552.79,2.0,75,4,3,1,8,0xb2d99ffd
273708.04,4.0,18,3,4,2,9,0xb2d9077b
100001.58,3.0,4,3,4,4,11,0xb2d992ca
2843.13,1.0,185,1,2,1,4,0xb2d2f7fe
649048.91,11.0,3,4,4,4,12,0xb2d0b390
30313.65,2.0,60,2,3,2,7,0xb2d292ba
25022.01,1.0,0,2,2,4,8,0xb2d3969b
129.2,1.0,6,1,2,3,6,0xb2d6a1e7
10000.21,2.0,18,2,3,2,7,0xb2da2a53
59951.95,4.0,0,3,4,4,11,0x3b9b4841
40004.35,3.0,34,2,4,2,8,0xb2d3edb6
610167.46,2.0,3,4,3,4,11,0xb2d58251
20000.63,2.0,59,2,3,2,7,0xb2d8f9f4
41.43,1.0,42,1,2,2,5,0xb2d329c4
10043.46,1.0,184,2,2,1,5,0xb2d5dab8
7380.33,1.0,184,2,2,1,5,0xb2d55ade
33682.19,1.0,7,2,2,3,7,0xb2d6b5b5
2.04,1.0,27,1,2,2,5,0xb2d4c67a
483049.66,16.0,4,4,4,4,12,0xb2d0d514d
2984.95,1.0,0,2,2,4,8,0xb2d3aaf9
500000.0,2.0,14,4,3,3,10,0xb2da31fb
12769.02,1.0,0,2,2,4,8,0xb2d1523a
10130.89,2.0,27,2,3,2,7,0xb2d6b4e6
2556.5,1.0,1,1,2,4,7,0xb2d1d360
1360871.06,8.0,4,4,4,4,12,0xb2d2e787
114567.08,1.0,0,3,2,4,9,0xb2d2b406
99.2,1.0,10,1,2,3,6,0xb2d43214
1853.98,1.0,184,1,2,1,4,0xb2d2512e
167.96,1.0,2,1,2,4,7,0xb2d32961
3741.73,1.0,73,2,2,1,5,0xb2d32e4c
4520.0,4.0,6,2,4,3,9,0xb2d0e391
264691.04,6.0,0,3,4,4,11,0xb2d109b5
36.95,1.0,47,1,2,2,5,0xb2d9b69b
1496994.41,6.0,16,4,4,2,10,0xb2d5f6b3
698.98,1.0,0,1,2,4,7,0xb2d99e51
10708.4,1.0,92,2,2,1,5,0x3b9b195b
44901.75,1.0,0,2,2,4,8,0xb2d3307f
1019.0,1.0,92,1,2,1,4,0xb2d3310b
13.09,1.0,20,1,2,2,5,0xb2d94d95
100028.27,5.0,32,3,4,2,9,0x3b9b428d
2238.04,8.0,0,1,4,4,9,0x3b9b3670
150001.58,2.0,105,3,3,1,7,0xb2d95d7b
152002.34,8.0,12,3,4,3,10,0xb2d0da4c
64527.59,1.0,39,3,2,2,7,0xb2d1794f
1271.08,1.0,134,1,2,1,4,0xb2d3e783
30004.65,2.0,17,2,3,2,7,0xb2d6694c
2842.67,1.0,1,1,2,4,7,0xb2d441b1
173.62,1.0,26,1,2,2,5,0xb2d6f951
600129.4,4.0,11,4,4,3,11,0xb2d152e9
90109.53,5.0,165,3,4,1,8,0xb2d235e9
0.42,1.0,11,1,2,3,6,0xb2da392f
682373.22,3.0,0,4,4,4,12,0xb2d6eac3
2.15,1.0,36,1,2,2,5,0xb2d6b700
163.42,1.0,18,1,2,2,5,0xb2d6225d
78.6,1.0,40,1,2,2,5,0xb2d4227c
144346.01,7.0,0,3,4,4,11,0xb2d307bc
70508.79,12.0,0,3,4,4,11,0xb2d11eda
600000.25,4.0,5,4,4,3,11,0xb2d93068
9665.18,1.0,10,2,2,3,7,0xb2d45f05
15000.48,2.0,2,2,3,4,9,0xb2d95ffc
9235.7,1.0,29,2,2,2,6,0xb2d91bb4
10442.53,2.0,132,2,3,1,6,0xb2d69cc0
68.55,1.0,1,1,2,4,7,0xb2d2b380
320152.42,1.0,5,4,2,3,9,0xb2d9e1f3
54.76,1.0,13,1,2,3,6,0xb2d6c353
964907.59,5.0,5,4,4,3,11,0xb2d2b5a1
1013158.59,4.0,49,4,4,2,10,0xb2d6fb36
1225.21,1.0,0,1,2,4,7,0xb2d691e5
3162.15,1.0,2,2,2,4,8,0xb2d438c5
235791.72,3.0,0,3,4,4,11,0xb2d3083d
150000.0,1.0,0,3,2,4,9,0xb2da6be2
924823.68,14.0,14,4,4,3,11,0xb2d2d14d
400044.02,3.0,0,4,4,4,12,0xb2d94a8b
200754.4,2.0,158,3,3,1,7,0x3b9b39d5
2.93,1.0,0,1,2,4,7,0xb2d9e766
606044.47,1.0,0,4,2,4,10,0xb2d94d1c
0.02,1.0,41,1,2,2,5,0xb2d5be09
11015.16,1.0,119,2,2,1,5,0xb2d68c66
302000.0,5.0,3,4,4,4,12,0xb2d5ba3f
2.41,1.0,7,1,2,3,6,0xb2d6a016
29.28,1.0,60,1,2,2,5,0xb2d20fe3
200721.03,2.0,5,3,3,3,9,0xb2d8f555
200000.0,2.0,21,3,3,2,8,0xb2da26bf
0.5,1.0,1,1,2,4,7,0xb2d2e6ff
3400.98,1.0,1,2,2,4,8,0xb2d2bb81
554.95,11.0,12,1,4,3,8,0xb2d6888c
464028.14,4.0,53,4,4,2,10,0xb2d3c7f5
5.04,1.0,9,1,2,3,6,0xb2d3814e
10000.32,2.0,25,2,3,2,7,0xb2da0d35
20.41,1.0,30,1,2,2,5,0xb2d1a396
111883.72,2.0,266,3,3,1,7,0xb2d5f38b
20357.65,1.0,18,2,2,2,6,0xb2d65b1a
46210.24,1.0,106,2,2,1,5,0xb2d19bdd
319.85,1.0,0,1,2,4,7,0xb2d1bdf5
3453.08,1.0,135,2,2,1,5,0xb2d6dadd
593012.32,20.0,20,4,4,2,10,0xb2d0de6d
10000.0,1.0,2,2,2,4,8,0xb2d950d5
1680.89,1.0,19,1,2,2,5,0xb2d7ecbc
188089.64,4.0,0,3,4,4,11,0xb2d10b87
1242.53,1.0,184,1,2,1,4,0xb2d57fd2
100002.12,3.0,192,3,4,1,8,0xb2d63b52
180.41,1.0,16,1,2,2,5,0xb2d6ae02
232007.26,5.0,27,3,4,2,9,0xb2d6fa31
14.77,1.0,50,1,2,2,5,0xb2d67d8c
760002.98,4.0,1,4,4,4,12,0xb2d7846b
360798.26,8.0,29,4,4,2,10,0xb2d207cd
415107.13,5.0,0,4,4,4,12,0xb2d61a79
801313.58,2.0,14,4,3,3,10,0xb2d1626f
14463.5,1.0,20,2,2,2,6,0xb2d6b70d
4.45,1.0,8,1,2,3,6,0xb2d6e8a7
45503.12,1.0,12,2,2,3,7,0xb2d25df1
2104017.08,8.0,1,4,4,4,12,0xb2d62fb6
450773.48,5.0,11,4,4,3,11,0xb2d28923
200095.78,2.0,209,3,3,1,7,0xb2d60608
1215214.12,4.0,1,4,4,4,12,0xb2d5ebf0
240006.54,5.0,20,3,4,2,9,0xb2d867f6
35495.45,1.0,19,2,2,2,6,0xb2d59a81
1016.53,2.0,19,1,3,2,6,0x3b9b1713
1003.2,1.0,3,1,2,4,7,0xb2d81535
610000.0,3.0,5,4,4,3,11,0xb2d97939
20943.15,3.0,93,2,4,1,7,0xb2d0dd89
184064.64,1.0,1,3,2,4,9,0xb2d1450d
500000.37,2.0,5,4,3,3,10,0xb2d6e5fc
50014.07,2.0,47,2,3,2,7,0xb2d8e0f2d
96007.72,7.0,1,3,4,4,11,0xb2d6f1ad
1003554.6,3.0,31,4,4,2,10,0xb2d2406f
748000.2,13.0,0,4,4,4,12,0xb2d3a002
1326.73,1.0,184,1,2,1,4,0x3b9b3606
9.19,1.0,58,1,2,2,5,0xb2d36d0c
3226.67,1.0,24,2,2,2,6,0xb2d6dc7b
1000005.36,3.0,0,4,4,4,12,0xb2d59a75
20001784.44,6.0,76,4,4,1,9,0xb2d0f404
1067951.63,4.0,18,4,4,2,10,0x3b9b312f
2450.36,1.0,184,1,2,1,4,0xb2d10c87
351206.41,4.0,31,4,4,2,10,0x3b9aced9
107006.05,2.0,169,3,3,1,7,0xb2d24c5d
281301.16,1.0,132,3,2,1,6,0xb2d24014
9.26,1.0,71,1,2,1,4,0xb2d67d7f
61098.69,1.0,1,3,2,4,9,0xb2d3883f
24433.38,5.0,0,2,4,4,10,0x3b9b0e73
12433.99,1.0,10,2,2,3,7,0xb2d5f219
124682.39,4.0,0,3,4,4,11,0x3b9af2b6
53866.47,2.0,228,3,3,1,7,0xb2d38588
279.99,1.0,13,1,2,3,6,0xb2d3a5ec
331000.0,4.0,0,4,4,4,12,0xb2d4ec45
4360.12,1.0,69,2,2,1,5,0xb2d52003
501882.04,2.0,39,4,3,2,9,0xb2d6ce7d
504442.14,2.0,34,4,3,2,9,0xb2d7006e
100.99,1.0,15,1,2,3,6,0xb2d576db
93.33,1.0,60,1,2,2,5,0xb2d55788
1044.39,1.0,92,1,2,1,4,0xb2d1b1ac
12623.52,2.0,0,2,3,4,9,0xb2d557ca
621436.57,17.0,7,4,4,3,11,0x3b9ae469
11177.85,1.0,184,2,2,1,5,0xb2d3af2d
10000.42,2.0,245,2,3,1,6,0xb2d6ce03
101083.37,3.0,24,3,4,2,9,0xb2d65736
100573.68,2.0,153,3,3,1,7,0xb2d61b46
3819.78,1.0,12,2,2,3,7,0xb2d1a4fd
327576.48,3.0,123,4,4,1,9,0xb2d58a32
1600016.89,2.0,42,4,3,2,9,0xb2d9e7f2
61749.84,2.0,92,3,3,1,7,0xb2d65343
758.35,1.0,0,1,2,4,7,0xb2d4a73b
1430359.02,5.0,6,4,4,3,11,0xb2d401cd
2972.78,1.0,0,2,2,4,8,0xb2d4cb73
16.14,1.0,74,1,2,1,4,0xb2d40f5b
157151.12,5.0,1,3,4,4,11,0xb2d1b074
110552.33,4.0,103,3,4,1,8,0xb2d1a67a
938341.54,3.0,6,4,4,3,11,0xb2d31d9d
100052.65,2.0,0,3,3,4,10,0xb2d3804a
1076.96,1.0,92,1,2,1,4,0xb2d1af7f
618550.1,2.0,33,4,3,2,9,0xb2d1d987
150.18,1.0,18,1,2,2,5,0xb2d16eeb
11195.05,1.0,0,2,2,4,8,0xb2d64eb0
251676.79,1.0,7,3,2,3,8,0xb2d6b3ed
200006.23,3.0,95,3,4,1,8,0xb2d97327
2713920.51,13.0,19,4,4,2,10,0xb2d943a2
81050.75,2.0,21,3,3,2,8,0xb2d0ed93
666.59,1.0,0,1,2,4,7,0xb2d34317
200270.78,2.0,3,3,3,4,10,0xb2d79106
21048.96,1.0,20,2,2,2,6,0xb2d55370
222000.0,4.0,4,3,4,4,11,0xb2d284f7
27201.01,1.0,8,2,2,3,7,0xb2d6da8b
47.69,2.0,8,1,3,3,7,0x3b9af10f
624.22,2.0,0,1,3,4,8,0xb2d29bab
106203.45,2.0,53,3,3,2,8,0xb2d30808
2315947.45,9.0,29,4,4,2,10,0xb2d0c450
16832.76,1.0,9,2,2,3,7,0xb2d644ce
491.97,1.0,39,1,2,2,5,0xb2d1f396
2347.03,1.0,69,1,2,1,4,0xb2d3c625
67544.6,1.0,8,3,2,3,8,0xb2d8d1b4
634581.38,7.0,92,4,4,1,9,0x3b9b36d9
70067.23,3.0,5,3,4,3,10,0xb2da1e3a
802429.05,5.0,17,4,4,2,10,0xb2d4c81b
15000.0,1.0,7,2,2,3,7,0xb2d9ab81
305.23,1.0,19,1,2,2,5,0xb2d0a1ff
7972.92,2.0,4,2,3,4,9,0x3b9b46cd
3067.85,1.0,0,2,2,4,8,0xb2d16d62
4155.18,2.0,184,2,3,1,6,0xb2d08244
143.95,1.0,10,1,2,3,6,0xb2d58a57
100439.84,2.0,1,3,3,4,10,0xb2d6a742
182170.51,4.0,245,3,4,1,8,0xb2d0d402
272878.37,2.0,110,3,3,1,7,0xb2d959d0
8704.33,1.0,53,2,2,2,6,0xb2d4b529
270000.55,3.0,0,3,4,4,11,0xb2d33c32
791134.37,15.0,0,4,4,4,12,0xb2d083e7
13984.67,1.0,0,2,2,4,8,0xb2d68cd1
1092.19,1.0,9,1,2,3,6,0xb2d5bb5d
4937044.92,7.0,0,4,4,4,12,0xb2d24dc2
10224.04,1.0,43,2,2,2,6,0xb2d6f895
663064.83,1.0,24,4,2,2,8,0xb2d36f25
150344.85,3.0,39,3,4,2,9,0xb2d69d48
290413.83,2.0,200,3,3,1,7,0xb2d1193c
123593.51,5.0,27,3,4,2,9,0xb2d62760
12086.62,1.0,0,2,2,4,8,0xb2d0aa4f
72312.78,2.0,202,3,3,1,7,0xb2d50cb8
549943.98,1.0,2,4,2,4,10,0xb2d590d9
163576.06,1.0,19,3,2,2,7,0xb2d606d0
9400.74,1.0,265,2,2,1,5,0xb2d2fa92
50657.58,1.0,10,2,2,3,7,0xb2d6e30a
10000.11,2.0,27,2,3,2,7,0xb2d9424e
150019.56,3.0,132,3,4,1,8,0xb2d2a608
431.08,1.0,7,1,2,3,6,0xb2d2faaa
2084.02,1.0,184,1,2,1,4,0xb2d1f44e
91700.18,2.0,202,3,3,1,7,0xb2d501b0
300066.96,2.0,21,3,3,2,8,0xb2d618d9
757.07,1.0,6,1,2,3,6,0xb2d9c668
100040.9,2.0,8,3,3,3,9,0xb2d3a243
465189.65,5.0,12,4,4,3,11,0xb2d680f7
20079.13,3.0,90,2,4,1,7,0xb2d6983a
521080.96,4.0,4,4,4,4,12,0xb2d781e0
250092.22,2.0,22,3,3,2,8,0xb2d988ac
202425.66,2.0,46,3,3,2,8,0xb2d3659a
81521.26,3.0,67,3,4,1,8,0xb2d226c4
211.99,1.0,14,1,2,3,6,0xb2d4772f
2192.14,1.0,2,1,2,4,7,0xb2d4f354
200008.46,2.0,193,3,3,1,7,0xb2d7eddf
153042.76,4.0,18,3,4,2,9,0xb2d1008d
279.56,1.0,12,1,2,3,6,0xb2d2beaa
146.65,1.0,6,1,2,3,6,0xb2d37c46
200102.9,6.0,56,3,4,2,9,0xb2d6fdfd
2400050.0,3.0,1,4,4,4,12,0xb2d97c62
200008.79,3.0,62,3,4,2,9,0xb2d26c53
110010.9,3.0,18,3,4,2,9,0xb2d417d6
351399.57,3.0,6,4,4,3,11,0xb2d163f0
390012.3,6.0,17,4,4,2,10,0xb2d23bb9
250001.09,1.0,5,3,2,3,8,0xb2d6e77d
2000.84,1.0,0,1,2,4,7,0xb2d7688d
30000.32,2.0,80,2,3,1,6,0xb2d98ea9
107301.6,1.0,4,3,2,4,9,0xb2d4d17e
80525.21,3.0,11,3,4,3,10,0xb2d0e86e
160064.26,3.0,24,3,4,2,9,0xb2d1d316
293414.28,2.0,0,3,3,4,10,0xb2d2112b
1050060.28,3.0,20,4,4,2,10,0xb2d26e97
42747.08,10.0,1,2,4,4,10,0xb2d0b887
110255.77,5.0,1,3,4,4,11,0xb2d233fb
20858.5,1.0,1,2,2,4,8,0xb2d35a30
61156.17,1.0,0,3,2,4,9,0xb2d41fec
550302.96,1.0,25,4,2,2,8,0xb2d9f953
500228.22,2.0,14,4,3,3,10,0xb2d961fb
100929.46,2.0,94,3,3,1,7,0xb2d6945d
1.82,1.0,67,1,2,1,4,0xb2d40114
500000.0,3.0,1,4,4,4,12,0xb2d9823c
220332.19,3.0,11,3,4,3,10,0xb2d53636
1571.31,1.0,2,1,2,4,7,0xb2d6c3a2
175036.98,2.0,130,3,3,1,7,0xb2d1035e
1650334.09,3.0,18,4,4,2,10,0xb2d1b41e
3724.02,3.0,0,2,4,4,10,0x3b9af2a4
25258.22,10.0,0,2,4,4,10,0xb2d27b61
288094.22,3.0,17,3,4,2,9,0xb2d3d986
3599.48,1.0,18,2,2,2,6,0xb2d34f7c
50002.11,2.0,92,2,3,1,6,0xb2d65d7a
22531.02,1.0,12,2,2,3,7,0xb2d9518d
563.56,1.0,10,1,2,3,6,0xb2d3162d
216731.94,3.0,27,3,4,2,9,0xb2d09925
56.27,1.0,10,1,2,3,6,0xb2da0051
1954.11,1.0,92,1,2,1,4,0xb2d2d9cc
486195.21,14.0,1,4,4,4,12,0xb2d1fc85
485007.94,13.0,42,4,4,2,10,0xb2d56580
104824.32,2.0,101,3,3,1,7,0xb2d509da
567664.34,2.0,108,4,3,1,8,0xb2d26c46
8533.15,1.0,163,2,2,1,5,0xb2d5e58b
3701.19,1.0,3,2,2,4,8,0xb2d91f58
46.14,1.0,15,1,2,3,6,0xb2d35398
604767.65,4.0,31,4,4,2,10,0xb2d60650
69.69,1.0,42,1,2,2,5,0xb2d37c8d
10953.38,1.0,42,2,2,2,6,0xb2d553ca
976084.18,5.0,8,4,4,3,11,0xb2d3c76b
2149.65,1.0,0,1,2,4,7,0xb2d15dc5
69979.68,1.0,95,3,2,1,6,0xb2d1b86c
167382.0,2.0,10,3,3,3,9,0xb2d5adfd
224693.3,2.0,101,3,3,1,7,0xb2d0c38f
51420433.89,5.0,38,4,4,2,10,0xb2d6ccd5
2638.02,1.0,9,1,2,3,6,0xb2d8f74f
100394.98,2.0,13,3,3,3,9,0xb2d3edc7
6411205.03,6.0,0,4,4,4,12,0xb2d529ac
28002539.67,3.0,5,4,4,3,11,0xb2d6cdf3
50057.12,2.0,0,2,3,4,9,0xb2d40934d
500090.02,2.0,3,4,3,4,11,0xb2d3d50d
375543.09,4.0,0,4,4,4,12,0xb2d08bfe
782.87,4.0,15,1,4,3,8,0xb2d923b9
300003.17,2.0,69,3,3,1,7,0xb2d8e9c4
37047.67,1.0,0,2,2,4,8,0xb2d51e77
0.0,1.0,1,1,2,4,7,0xb2da6443
400715.85,3.0,17,4,4,2,10,0xb2d4c7fa
167029.73,2.0,153,3,3,1,7,0xb2d2274e
225654.4,6.0,20,3,4,2,9,0xb2d62054
540.46,1.0,14,1,2,3,6,0xb2d3efdc
51306.3,1.0,1,2,2,4,8,0xb2d2c627
10661.29,3.0,8,2,4,3,9,0xb2d21127
6796.55,1.0,2,2,2,4,8,0xb2d9d610
86044.59,4.0,0,3,4,4,11,0xb2d6d108
325003.2,12.0,1,4,4,4,12,0xb2d1af3f
261004.6,2.0,97,3,3,1,7,0xb2d0c931
1.29,1.0,9,1,2,3,6,0xb2d679f2
207416.52,6.0,0,3,4,4,11,0xb2d1f68f
85902.32,3.0,92,3,4,1,8,0xb2d17434
52.59,1.0,5,1,2,3,6,0xb2d210ef
112000.64,2.0,0,3,3,4,10,0xb2d0c419
670028.53,4.0,25,4,4,2,10,0xb2d38b93
50000.53,2.0,97,2,3,1,6,0xb2d8571b
3.01,1.0,0,1,2,4,7,0xb2d21815
100000.0,2.0,1,3,3,4,10,0xb2da63ff
0.33,1.0,0,1,2,4,7,0xb2d22bec
30101.54,2.0,9,2,3,3,8,0xb2d64846
30239.24,2.0,0,2,3,4,9,0x3b9b184e
3875.95,2.0,1,2,3,4,9,0xb2d2fcc9
5253.7,1.0,12,2,2,3,7,0xb2d9a615
102742.17,3.0,139,3,4,1,8,0xb2d3a86b
254832.51,8.0,34,3,4,2,9,0xb2d5998f
6721.4,1.0,0,2,2,4,8,0xb2d34797
460131.0,5.0,95,4,4,1,9,0xb2d6ed1b
234272.52,6.0,1,3,4,4,11,0xb2d68500
1356034.74,6.0,24,4,4,2,10,0xb2d1beda
288986.97,3.0,0,3,4,4,11,0xb2d177b4
4030452.04,23.0,0,4,4,4,12,0xb2d0d962
66.83,1.0,0,1,2,4,7,0xb2d4baf0
39466.47,1.0,92,2,2,1,5,0xb2d41bc9
215770.54,2.0,18,3,3,2,8,0xb2d1b6d1
187.36,1.0,2,1,2,4,7,0xb2d15625
17312.83,1.0,49,2,2,2,6,0xb2d3905c
26024.87,1.0,53,2,2,2,6,0xb2d3b344
10004.1,2.0,1,2,3,4,9,0xb2d5e67a
8078.47,1.0,4,2,2,4,8,0xb2d820ab
390433.9,6.0,27,4,4,2,10,0xb2d0abf2
250888.02,2.0,5,3,3,3,9,0xb2d9323f
1014044.78,5.0,0,4,4,4,12,0xb2d14b47
210000.86,2.0,23,3,3,2,8,0xb2d99c84
106.15,1.0,0,1,2,4,7,0xb2d81dc7
11476.73,1.0,124,2,2,1,5,0xb2d27816
500054.74,2.0,2,4,3,4,11,0xb2d62b60
15.41,1.0,31,1,2,2,5,0xb2d9b5c1
150006.94,3.0,111,3,4,1,8,0xb2d5c62e
783748.53,5.0,18,4,4,2,10,0xb2d1492d
29.57,1.0,53,1,2,2,5,0xb2d223b3
500051.41,2.0,46,4,3,2,9,0xb2d9b3f0
64657.79,1.0,0,3,2,4,9,0xb2d3b5d8
2380.01,3.0,96,1,4,1,6,0xb2d6f7a7
5365.19,1.0,21,2,2,2,6,0xb2d2e5d1
19026.37,2.0,15,2,3,3,8,0xb2d993fd
120720.89,6.0,0,3,4,4,11,0xb2d0a45a
1061.85,1.0,184,1,2,1,4,0xb2d34ba8
55190.63,1.0,7,3,2,3,8,0xb2d5e5dd
903387.15,3.0,139,4,4,1,9,0xb2d38000
500027.79,2.0,221,4,3,1,8,0xb2d5f208
530043.33,6.0,87,4,4,1,9,0xb2d6d0de
217000.0,3.0,28,3,4,2,9,0xb2d07958
2610281.54,13.0,5,4,4,3,11,0xb2d19208
0.01,2.0,4,1,3,4,8,0xb2d06863
680954.73,2.0,0,4,3,4,11,0xb2d6583c
728062.87,6.0,31,4,4,2,10,0xb2d25b86
2009.84,1.0,184,1,2,1,4,0xb2d33da6
200710.47,2.0,47,3,3,2,8,0xb2d918b9
24.47,1.0,69,1,2,1,4,0xb2d410c8
12577.24,1.0,15,2,2,3,7,0xb2d483dc
459637.93,2.0,24,4,3,2,9,0xb2d28830
1440.76,1.0,148,1,2,1,4,0xb2d219a3
900096.43,7.0,11,4,4,3,11,0xb2d23d61
20260.44,2.0,92,2,3,1,6,0xb2d59f67
200011.32,3.0,66,3,4,2,9,0xb2d510bb
1837.52,1.0,0,1,2,4,7,0xb2d56bb1
7.27,2.0,6,1,3,3,7,0xb2d8df33
409.59,1.0,0,1,2,4,7,0xb2d1d4dc
100.43,1.0,184,1,2,1,4,0xb2d28ffc
70126.13,6.0,3,3,4,4,11,0xb2d4bd21
18520.36,1.0,38,2,2,2,6,0xb2d2e4b1
35.97,1.0,18,1,2,2,5,0xb2d6c2b9
350013.64,4.0,63,4,4,2,10,0xb2d33366
298.63,1.0,21,1,2,2,5,0xb2d5b03c
1.58,1.0,138,1,2,1,4,0xb2d919d3
1690.59,1.0,92,1,2,1,4,0xb2d2cdc4
17505.57,2.0,1,2,3,4,9,0xb2d61750
410612.34,3.0,185,4,4,1,9,0xb2d5e5f3
150008.27,4.0,18,3,4,2,9,0xb2d104d1
58274.62,1.0,28,3,2,2,7,0xb2d5c8e7
200000.0,2.0,0,3,3,4,10,0xb2d982da
2500009.7,5.0,0,4,4,4,12,0xb2d5d7fc
3105.31,1.0,10,2,2,3,7,0xb2d6bf0e
3887.15,1.0,92,2,2,1,5,0xb2d65a6a
94.46,1.0,11,1,2,3,6,0xb2d11ee9
74505.39,2.0,6,3,3,3,9,0xb2d4051d
326785.04,14.0,1,4,4,4,12,0xb2d65021
100075.26,2.0,182,3,3,1,7,0xb2d50cd4
520090.6,3.0,165,4,4,1,9,0xb2d6bb50
76717.59,3.0,1,3,4,4,11,0xb2d427f4
980001.69,4.0,4,4,4,4,12,0xb2d3d3ce
1.58,1.0,116,1,2,1,4,0xb2d78680
1432815.09,3.0,5,4,4,3,11,0xb2d0f07b
500036.94,2.0,11,4,3,3,10,0xb2d8e755
947877.56,8.0,1,4,4,4,12,0xb2d5ddb2
505.42,1.0,28,1,2,2,5,0xb2d8d550
104696.72,2.0,1,3,3,4,10,0xb2d7821f
653683.66,6.0,0,4,4,4,12,0xb2d50b06
75365.06,3.0,0,3,4,4,11,0xb2d1f415
20216.8,3.0,25,2,4,2,8,0xb2da176b
502310.34,2.0,33,4,3,2,9,0xb2d2cdc8
90024.64,6.0,46,3,4,2,9,0xb2d68a6e
1091987.75,1.0,25,4,2,2,8,0xb2d46743
28280.0,2.0,0,2,3,4,9,0xb2d514ae
745940.88,3.0,76,4,4,1,9,0xb2d49d5c
510046.4,7.0,41,4,4,2,10,0xb2d17258
290.2,1.0,4,1,2,4,7,0xb2d64e2c
6687.58,1.0,0,2,2,4,8,0xb2d6aab3
2032.06,2.0,216,1,3,1,5,0xb2d39651
50001.58,3.0,24,2,4,2,8,0xb2d946bc
1003.83,1.0,92,1,2,1,4,0xb2d5291b
12014.29,1.0,165,2,2,1,5,0xb2d3fb6a
300000.6,2.0,1,3,3,4,10,0xb2d3f5a9
0.0,1.0,0,1,2,4,7,0xb2d0ee2e
41832.38,3.0,14,2,4,3,9,0xb2d86c10
700944.57,4.0,0,4,4,4,12,0xb2d433e2
4704.62,1.0,92,2,2,1,5,0xb2d35f2b
126232.38,4.0,11,3,4,3,10,0x3b9b38b2
1518.81,1.0,92,1,2,1,4,0xb2d222ae
10000.28,2.0,25,2,3,2,7,0xb2d53a5a
60565.06,1.0,0,3,2,4,9,0xb2d0d928
10574.0,1.0,17,2,2,2,6,0xb2d6c3ec
30001.27,2.0,90,2,3,1,6,0xb2d8a397
300006.35,2.0,200,3,3,1,7,0xb2d695bb
1567.46,1.0,170,1,2,1,4,0xb2d27d7b
793012.79,9.0,0,4,4,4,12,0xb2d20f9f
512249.26,4.0,62,4,4,2,10,0xb2d6c5bf
296005.34,9.0,21,3,4,2,9,0xb2d52103
20845.75,2.0,3,2,3,4,9,0xb2d5a733
50004.81,1.0,1,2,2,4,8,0xb2d6b459
457674.46,5.0,27,4,4,2,10,0xb2d5f378
58003.06,6.0,4,3,4,4,11,0xb2d0c1ea
95073.99,5.0,40,3,4,2,9,0xb2d63723
561.08,1.0,9,1,2,3,6,0xb2d7c145
80000.0,9.0,0,3,4,4,11,0xb2d576f0
5872.46,1.0,11,2,2,3,7,0xb2d99d34
0.0,3.0,2,1,4,4,9,0xb2d10f85
170669.68,3.0,54,3,4,2,9,0xb2d6cb34
212148.83,2.0,55,3,3,2,8,0xb2d1c6f2
34360.49,1.0,4,2,2,4,8,0xb2d12116
1011.25,1.0,184,1,2,1,4,0xb2d3eb06
4156.63,1.0,97,2,2,1,5,0xb2d589ad
4829.67,1.0,10,2,2,3,7,0xb2d8fb16
2280309.26,5.0,132,4,4,1,9,0xb2d064b6
280036.16,5.0,19,3,4,2,9,0xb2d5edfc
734024.56,5.0,4,4,4,4,12,0xb2d5cc82
30903.86,2.0,8,2,3,3,8,0xb2d5c081
1.76,1.0,40,1,2,2,5,0xb2d9b7ad
8595.95,1.0,15,2,2,3,7,0xb2d7180d
11.63,1.0,184,1,2,1,4,0xb2d29432
125.05,1.0,75,1,2,1,4,0xb2d323ff
1785.36,1.0,5,1,2,3,6,0xb2d5c769
27.82,1.0,80,1,2,1,4,0xb2d23336
623.41,1.0,4,1,2,4,7,0xb2d6a088
300236.54,2.0,15,4,3,3,10,0xb2d8d505
838011.63,8.0,31,4,4,2,10,0xb2d1a847
55002.43,2.0,7,3,3,3,9,0xb2da00a2
8.55,1.0,6,1,2,3,6,0xb2d92122
5161.67,1.0,30,2,2,2,6,0xb2d61bed
702771.08,2.0,25,4,3,2,9,0xb2d6838a
51708.86,1.0,92,2,2,1,5,0xb2d0894f
508895.47,2.0,181,4,3,1,8,0xb2d150dc
0.4,2.0,35,1,3,2,6,0xb2d2d85c
1115.75,1.0,10,1,2,3,6,0xb2d96263
40.12,1.0,28,1,2,2,5,0xb2d6c5eb
710000.89,4.0,1,4,4,4,12,0xb2d5deef
351616.32,3.0,26,4,4,2,10,0xb2d238dd
38.64,1.0,3,1,2,4,7,0xb2d5b893
526.97,1.0,3,1,2,4,7,0xb2d9925f
2329.62,1.0,4,1,2,4,7,0xb2d8a185
1016.78,1.0,184,1,2,1,4,0xb2d0c8ac
492453.91,11.0,0,4,4,4,12,0xb2d2c6ec
61015.11,2.0,189,3,3,1,7,0xb2d5cf64
303374.75,1.0,0,4,2,4,10,0xb2d0deb4
19845.35,1.0,2,2,2,4,8,0xb2d138a8
6488978.62,5.0,18,4,4,2,10,0xb2d308f3
351260.77,2.0,55,4,3,2,9,0xb2d7856d
8842.57,1.0,31,2,2,2,6,0xb2d3f3ad
501776.05,3.0,8,4,4,3,11,0xb2d92432
2301252.36,3.0,0,4,4,4,12,0xb2d56e46
152063.95,1.0,12,3,2,3,8,0xb2d60ef5
425.05,1.0,18,1,2,2,5,0xb2d07815
140021.45,9.0,4,3,4,4,11,0xb2d08b20
1335.58,1.0,184,1,2,1,4,0xb2d346f7
1586330.98,2.0,28,4,3,2,9,0xb2d3c3b5
637996.34,4.0,122,4,4,1,9,0xb2d0e719
50016.59,2.0,74,2,3,1,6,0xb2d46575
606000.03,8.0,3,4,4,4,12,0xb2d626b1
5406.51,1.0,9,2,2,3,7,0xb2d4316b
27683.43,1.0,305,2,2,1,5,0xb2d2b173
280063.48,3.0,31,3,4,2,9,0xb2d2f191
946516.26,2.0,10,4,3,3,10,0xb2d3ad7b
5554.86,1.0,59,2,2,2,6,0xb2d40655
2.11,1.0,18,1,2,2,5,0xb2d95890
364.23,1.0,82,1,2,1,4,0xb2d593ced
208.58,1.0,4,1,2,4,7,0xb2da3819
204722.35,4.0,1,3,4,4,11,0xb2d64281
647.73,1.0,10,1,2,3,6,0xb2d53ef8
6260.89,1.0,92,2,2,1,5,0xb2d0d8fb
8.0,1.0,32,1,2,2,5,0xb2d2954a
11181.32,1.0,15,2,2,3,7,0xb2d9c455
6362.43,1.0,0,2,2,4,8,0xb2d786a4
3520336.4,132.0,14,4,4,3,11,0xb2d0f1b5
319000.0,17.0,2,4,4,4,12,0xb2d12a07
1.39,1.0,17,1,2,2,5,0xb2d2194d
100083.57,2.0,221,3,3,1,7,0xb2d63654
796.85,3.0,83,1,4,1,6,0xb2d2ca5f
161981.06,1.0,92,3,2,1,6,0xb2d0e7bf
280029.56,1.0,20,3,2,2,7,0xb2da2ae1
2080.33,1.0,282,1,2,1,4,0xb2d2e29b
2.11,1.0,25,1,2,2,5,0xb2d179d9
83856.82,2.0,101,3,3,1,7,0xb2d50f2d
79978.24,5.0,0,3,4,4,11,0x3b9af2c5
3001.0,2.0,68,2,3,1,6,0xb2d9b00c
190023.03,2.0,1,3,3,4,10,0xb2d106b3
334771.45,6.0,24,4,4,2,10,0xb2d384e4
304113.17,2.0,0,4,3,4,11,0xb2d10877
569.71,1.0,1,1,2,4,7,0xb2d5e071
171124.11,3.0,132,3,4,1,8,0xb2d2d307
12749.24,1.0,10,2,2,3,7,0xb2d52ae8
200000.0,2.0,6,3,3,3,9,0xb2d96f04
158.97,1.0,22,1,2,2,5,0xb2d52ba2
32059.19,1.0,4,2,2,4,8,0xb2d62b19
2950097.76,7.0,74,4,4,1,9,0xb2d3bbbe
130012.26,4.0,41,3,4,2,9,0xb2d54f56
2134.16,1.0,92,1,2,1,4,0x3b9adcb5
200041.37,2.0,26,3,3,2,8,0xb2d2e1b5
20574.07,2.0,70,2,3,1,6,0xb2d68000
6411.43,1.0,184,2,2,1,5,0xb2d21ad2
261.11,1.0,21,1,2,2,5,0xb2d2bd28
250711.85,4.0,8,3,4,3,10,0xb2d52c84
94000.33,3.0,0,3,4,4,11,0xb2d116e6
1253.64,1.0,184,1,2,1,4,0xb2d266f9
3.33,2.0,1,1,3,4,8,0xb2da4f0a
50670.78,1.0,91,2,2,1,5,0xb2d15766
22377.18,1.0,1,2,2,4,8,0xb2d99f42
97.74,1.0,30,1,2,2,5,0xb2d6c244
10000.42,2.0,195,2,3,1,6,0xb2d69d83
102983.83,1.0,184,3,2,1,6,0xb2d0cc5e
201.62,1.0,17,1,2,2,5,0xb2d91d60
186325.87,1.0,6,3,2,3,8,0xb2d5ebc9
1602.45,1.0,10,1,2,3,6,0xb2d97c42
400000.0,2.0,8,4,3,3,10,0xb2da4eed
73799.29,6.0,0,3,4,4,11,0xb2d20b97
439.64,1.0,23,1,2,2,5,0xb2d2047a
3020.31,1.0,7,2,2,3,7,0xb2d15c10
4300.0,1.0,0,2,2,4,8,0xb2d36a60
0.64,1.0,22,1,2,2,5,0xb2d2244d
20000.21,2.0,69,2,3,1,6,0xb2d8e9ab
105064.52,5.0,3,3,4,4,11,0xb2d62381
38250.4,1.0,19,2,2,2,6,0xb2d68c3e
452574.76,5.0,3,4,4,4,12,0xb2d50b75
202245.13,2.0,32,3,3,2,8,0xb2d92149
306425.39,4.0,33,4,4,2,10,0xb2d6ef04
80082.3,2.0,154,3,3,1,7,0xb2d2c2d0
59.51,3.0,208,1,4,1,6,0xb2d39274
650.82,3.0,0,1,4,4,9,0x3b9af28b
855413.61,9.0,0,4,4,4,12,0xb2d59a5e
350007.92,3.0,46,4,4,2,10,0xb2d91516
150001.58,2.0,83,3,3,1,7,0xb2d98633
4002.58,1.0,8,2,2,3,7,0xb2d1f523
8.72,1.0,1,1,2,4,7,0xb2d6220b
1166.08,1.0,90,1,2,1,4,0xb2d78979
1.0,1.0,184,1,2,1,4,0xb2d2958e
477655.93,4.0,14,4,4,3,11,0xb2d9169d
1100.77,1.0,0,1,2,4,7,0xb2d90e3c
1829.77,1.0,9,1,2,3,6,0x3b9b42ac
13000.27,2.0,24,2,3,2,7,0xb2d9496b
234214.54,1.0,9,3,2,3,8,0xb2d2ed4f
2355655.88,2.0,0,4,3,4,11,0xb2d1a9ba
41763.04,3.0,39,2,4,2,8,0xb2d635a7
1108.59,3.0,0,1,4,4,9,0x3b9af0d5
100083.43,4.0,29,3,4,2,9,0xb2d6b85a
2676015.86,2.0,179,4,3,1,8,0xb2d25685
4868.82,1.0,8,2,2,3,7,0xb2d90ca9
3817.65,1.0,5,2,2,3,7,0xb2d94ca6
6300.42,1.0,11,2,2,3,7,0xb2d429c0
677.22,1.0,0,1,2,4,7,0xb2d3eca1
121354.21,4.0,5,3,4,3,10,0xb2d3b5e6
286.39,1.0,8,1,2,3,6,0xb2d24cc7
386.31,2.0,49,1,3,2,6,0xb2d8818f
13000.64,2.0,87,2,3,1,6,0xb2d8ccaa
20223.25,1.0,283,2,2,1,5,0xb2d6181b
362182.56,3.0,1,4,4,4,12,0xb2d126db
177307.99,3.0,6,3,4,3,10,0xb2da0aa3
0.77,1.0,0,1,2,4,7,0xb2d98aac
152.16,2.0,3,1,3,4,8,0xb2d424ac
135173.85,6.0,13,3,4,3,10,0xb2d56c66
150002.09,5.0,84,3,4,1,8,0xb2d59e6e
100002.11,2.0,53,3,3,2,8,0xb2d9cd15
505484.25,3.0,0,4,4,4,12,0xb2d55590
488.05,1.0,0,1,2,4,7,0xb2d6d9ad
200052.52,2.0,6,3,3,3,9,0xb2d38b62
7.63,1.0,11,1,2,3,6,0xb2d5d16e
4603789.5,8.0,1,4,4,4,12,0xb2d1b72e
579000.0,4.0,2,4,4,4,12,0xb2d4102e
31343.96,2.0,263,2,3,1,6,0xb2d5fe38
4610722.29,4.0,11,4,4,3,11,0xb2d3cf3e
39.06,1.0,5,1,2,3,6,0xb2d9b5d5
319.35,1.0,0,1,2,4,7,0xb2d97e04
1445.67,1.0,10,1,2,3,6,0xb2d43253
4399.27,1.0,12,2,2,3,7,0xb2d34a41
203555.09,2.0,91,3,3,1,7,0xb2d8c42c
97336.52,4.0,0,3,4,4,11,0x3b9af28f
50008.33,2.0,39,2,3,2,7,0xb2d5cf25
303423.62,2.0,0,4,3,4,11,0xb2d3704a
3542.66,1.0,20,2,2,2,6,0xb2d93f74
20000.85,3.0,20,2,4,2,8,0xb2d9fd3b
296015.8,8.0,13,3,4,3,10,0xb2d56315
868759.96,5.0,0,4,4,4,12,0xb2d4a58c
17.76,1.0,35,1,2,2,5,0xb2d572a9
10162.11,2.0,59,2,3,2,7,0xb2d65820
4140.0,1.0,26,2,2,2,6,0xb2d33c91
11851.25,1.0,10,2,2,3,7,0xb2d596e4
21002.24,2.0,20,2,3,2,7,0xb2d5bf86
20000.21,2.0,231,2,3,1,6,0xb2d6f047
20653.99,1.0,10,2,2,3,7,0xb2d5cef0
4634.32,1.0,4,2,2,4,8,0xb2d693fb
270000.0,3.0,0,3,4,4,11,0xb2da5919
206105.9,2.0,16,3,3,2,8,0xb2d5d3b1
701085.68,5.0,9,4,4,3,11,0xb2d62349
0.85,1.0,8,1,2,3,6,0xb2d5ea63
6830000.0,5.0,1,4,4,4,12,0xb2d5002e
1057.17,1.0,0,1,2,4,7,0xb2d22d50
125310.73,1.0,21,3,2,2,7,0xb2d53594
1630.41,1.0,9,1,2,3,6,0xb2d23ac7
6664.22,1.0,92,2,2,1,5,0x3b9adb56
6.13,1.0,19,1,2,2,5,0xb2d6bb7d
11801.01,1.0,184,2,2,1,5,0xb2d1ec1a
558003.2,5.0,81,4,4,1,9,0xb2d659b6
40687.81,1.0,92,2,2,1,5,0xb2d2c136d
1020.17,1.0,92,1,2,1,4,0xb2d422ae
1158363.71,13.0,0,4,4,4,12,0xb2d1bfce
483.76,1.0,9,1,2,3,6,0xb2d95c02
305.04,1.0,77,1,2,1,4,0xb2d42aae
120026.24,2.0,100,3,3,1,7,0xb2d69c75
218983.18,2.0,3,3,3,4,10,0xb2d68075
1657.55,2.0,27,1,3,2,6,0xb2d12abf
260833.82,4.0,6,3,4,3,10,0xb2d0f4b4
965.7,2.0,0,1,3,4,8,0x3b9b1857
938344.37,11.0,7,4,4,3,11,0xb2d69222
7671.36,1.0,19,2,2,2,6,0xb2d21ad8
30000.95,2.0,92,2,3,1,6,0xb2d56f66
460008.24,2.0,1,4,3,4,11,0xb2d78c11
40003.2,2.0,129,2,3,1,6,0xb2d6417d
655.31,1.0,0,1,2,4,7,0xb2d38ebf
70000.74,2.0,66,3,3,2,8,0xb2d8f200
7.6,1.0,81,1,2,1,4,0xb2d8d105
356.76,1.0,75,1,2,1,4,0xb2d4528c
280168.49,8.0,3,3,4,4,11,0xb2d331c0
3192.39,1.0,0,2,2,4,8,0xb2d2abae
128281.72,3.0,49,3,4,2,9,0xb2d426ce
35002.21,2.0,3,2,3,4,9,0xb2d5a984
372.98,1.0,7,1,2,3,6,0xb2d27fe1
320088.06,4.0,32,4,4,2,10,0xb2d6022f
135477.15,2.0,20,3,3,2,8,0xb2d91b7f
1000097.76,2.0,179,4,3,1,8,0xb2d51e40
250018.73,2.0,42,3,3,2,8,0xb2d106b3d
44754.46,1.0,92,2,2,1,5,0xb2d338c5
200021.78,2.0,3,3,3,4,10,0xb2d17026
124151.83,4.0,147,3,4,1,8,0xb2d0b18e
311684.28,3.0,3,4,4,4,12,0xb2d6d1a9
160001.69,2.0,39,3,3,2,8,0xb2d9f394
200000.0,2.0,8,3,3,3,9,0xb2da4f25
693.92,1.0,7,1,2,3,6,0xb2d6bdb6
830305.58,2.0,127,4,3,1,8,0xb2d65168
66000.0,5.0,0,3,4,4,11,0xb2d6d13e
642.62,2.0,4,1,3,4,8,0xb2d13cad
0.63,1.0,4,1,2,4,7,0xb2da4939
2509.3,2.0,92,1,3,1,5,0xb2d10169
1000004.03,4.0,4,4,4,4,12,0xb2d154e6
2450033.46,12.0,1,4,4,4,12,0xb2d12578
520095.53,7.0,22,4,4,2,10,0xb2d112cd
53.9,1.0,9,1,2,3,6,0xb2d54de4
158024.0,9.0,0,3,4,4,11,0xb2d5b0d2
50033.62,2.0,165,2,3,1,6,0xb2d5941e
2838136.98,9.0,36,4,4,2,10,0xb2d79299
1697.25,1.0,184,1,2,1,4,0xb2d221ac
1610000.4,3.0,13,4,4,3,11,0xb2d90119
0.44,1.0,1,1,2,4,7,0xb2d3d0a9
74.79,1.0,5,1,2,3,6,0xb2d6e103
1060.5,1.0,2,1,2,4,7,0xb2d27eca
6171.89,1.0,95,2,2,1,5,0xb2d5a91f
151.01,1.0,13,1,2,3,6,0xb2d4c65f
581943.09,3.0,0,4,4,4,12,0xb2d3ae06
400720.93,3.0,15,4,4,3,11,0xb2d9b645
101208.15,2.0,18,3,3,2,8,0xb2d62464
50332.63,3.0,18,2,4,2,8,0xb2d60305
90001.9,2.0,235,3,3,1,7,0xb2d6e897
373174.93,2.0,143,4,3,1,8,0xb2d12025
12608.86,1.0,9,2,2,3,7,0xb2d2b440
50003.09,2.0,231,2,3,1,6,0xb2d57ba3
554944.14,1.0,13,4,2,3,9,0xb2d414ce
16.1,1.0,3,1,2,4,7,0xb2d6a7e4
186.83,3.0,9,1,4,3,8,0x3b9b25f4
147.78,1.0,60,1,2,2,5,0xb2d6abbe
8997.45,1.0,0,2,2,4,8,0xb2d5268a
395.43,1.0,34,1,2,2,5,0xb2d3e84c
36.12,1.0,184,1,2,1,4,0xb2d25099
10143.93,2.0,27,2,3,2,7,0xb2d59885
11136.29,1.0,0,2,2,4,8,0xb2d1ea87
103647.26,2.0,1,3,3,4,10,0xb2d6e65c
1760.01,1.0,2,1,2,4,7,0xb2d4ec0e
53154.82,2.0,110,3,3,1,7,0xb2d4a704
550689.89,4.0,34,4,4,2,10,0xb2d260f7
70001.79,3.0,119,3,4,1,8,0xb2d8f3c6
250109.75,5.0,1,3,4,4,11,0xb2d2dd53
5933.46,1.0,0,2,2,4,8,0xb2d2fbbf
900069.88,3.0,129,4,4,1,9,0xb2d17bce
603595.77,4.0,58,4,4,2,10,0xb2d415aa
1002664.46,5.0,28,4,4,2,10,0xb2d814d4
378017.67,5.0,60,4,4,2,10,0xb2d2360b
307.05,1.0,7,1,2,3,6,0xb2d64a8a
23000.0,2.0,9,2,3,3,8,0xb2d68df8
51441.73,1.0,9,2,2,3,7,0xb2d383ed
145445.67,4.0,0,3,4,4,11,0xb2d0685b
340001.22,4.0,165,4,4,1,9,0xb2d16cc6
22627.74,3.0,28,2,4,2,8,0xb2d2bc1e
73294.45,5.0,8,3,4,3,10,0xb2d25653
30288.77,1.0,184,2,2,1,5,0xb2d2bf2b
197481.28,5.0,7,3,4,3,10,0xb2d1290e
1042581.83,4.0,83,4,4,1,9,0xb2d11f8d
0.0,1.0,5,1,2,3,6,0xb2d405d7
5070203.75,3.0,55,4,4,2,10,0xb2d4e936
2938.24,1.0,63,2,2,2,6,0xb2d1ecc4
820247.78,4.0,14,4,4,3,11,0xb2d62953
261154.0,5.0,14,3,4,3,10,0xb2d447b0
45.82,1.0,0,1,2,4,7,0xb2d34c20
201726.5,1.0,19,3,2,2,7,0xb2d64f33
100098.45,3.0,59,3,4,2,9,0xb2d35391
303.28,1.0,184,1,2,1,4,0xb2d27cb1
66.3,1.0,77,1,2,1,4,0xb2d1a496
605028.11,5.0,81,4,4,1,9,0xb2d0dcd2
2062.92,1.0,184,1,2,1,4,0xb2d619b2
342.06,1.0,0,1,2,4,7,0xb2d69442
200000.0,2.0,7,3,3,3,9,0xb2d97092
104171.4,3.0,52,3,4,2,9,0xb2d45552
0.61,1.0,0,1,2,4,7,0xb2d2f231
32510.67,1.0,116,2,2,1,5,0xb2d315d3
5271.71,1.0,0,2,2,4,8,0xb2d790d6
1812.02,1.0,102,1,2,1,4,0xb2d46d3b
27.25,1.0,0,1,2,4,7,0xb2d42e7d
470005.07,3.0,9,4,4,3,11,0xb2d781e0d
696.33,1.0,2,1,2,4,7,0xb2d921df
100781.97,3.0,217,3,4,1,8,0xb2d17e06
267035.36,2.0,6,3,3,3,9,0xb2d93f6cd
299111.81,5.0,11,3,4,3,10,0xb2d1b962
649.25,1.0,0,1,2,4,7,0xb2d6de98
220004.65,4.0,59,3,4,2,9,0xb2d180b4
10600.36,1.0,7,2,2,3,7,0xb2d5b661
41546.06,2.0,231,2,3,1,6,0xb2d5376d
2498.18,1.0,3,1,2,4,7,0xb2d222ee
90009.48,4.0,2,3,4,4,11,0xb2d93f57
2321.14,1.0,92,1,2,1,4,0x3b9b1872
100015.51,1.0,14,3,2,3,8,0xb2d99c49
1546.13,1.0,154,1,2,1,4,0xb2d6a475
81.21,5.0,10,1,4,3,8,0xb2d4a69f
61139.24,3.0,12,3,4,3,10,0xb2d65229
511921.92,1.0,35,4,2,2,8,0xb2d6e277
15464698.68,2.0,8,4,3,3,10,0x3b9af39d
160007.29,2.0,214,3,3,1,7,0xb2d65d46
91241.37,2.0,157,3,3,1,7,0xb2d52e20
200003.9,3.0,87,3,4,1,8,0xb2d33bfa
331547.43,2.0,20,4,3,2,9,0xb2d5fba8
629.56,1.0,9,1,2,3,6,0xb2d2e364
70855.28,3.0,3,3,4,4,11,0xb2d2a237
3316.04,1.0,20,2,2,2,6,0xb2d6380c
2862.06,1.0,11,1,2,3,6,0xb2d2fe8f
81892.78,1.0,2,3,2,4,9,0xb2d18065
50247.72,2.0,0,2,3,4,9,0xb2d0e64d
100873.6,2.0,52,3,3,2,8,0xb2d6d016
309240.79,4.0,40,4,4,2,10,0xb2d0940c
420000.0,3.0,4,4,4,4,12,0xb2d594f0
0.63,1.0,2,1,2,4,7,0xb2d49d71
200095.69,2.0,117,3,3,1,7,0xb2d60608d
1.0,1.0,5,1,2,3,6,0xb2d50dcf
2217.43,1.0,9,1,2,3,6,0xb2d44c09
2389.55,1.0,0,1,2,4,7,0xb2d4ace8
18926.5,1.0,9,2,2,3,7,0xb2d45c2d
84659.4,1.0,11,3,2,3,8,0xb2d37f15
902179.93,3.0,29,4,4,2,10,0xb2d9e455
1250097.22,2.0,173,4,3,1,8,0xb2d470d9
545.18,1.0,16,1,2,2,5,0xb2d5c8f4
8304.3,8.0,43,2,4,2,8,0xb2d81652
3267.87,2.0,35,2,3,2,7,0xb2d0763e
1000052.68,2.0,4,4,3,4,11,0xb2d90339
10194.78,1.0,1,2,2,4,8,0xb2d9a8d5
39131.53,1.0,33,2,2,2,6,0xb2da020a
100007.62,2.0,25,3,3,2,8,0xb2da0bbc
71508.85,2.0,5,3,3,3,9,0xb2d52ffa
800000.53,3.0,15,4,4,3,11,0xb2da3743
30001.27,2.0,209,2,3,1,6,0xb2d68939
500000.0,1.0,3,4,2,4,10,0xb2d67f49
271.57,2.0,2,1,3,4,8,0xb2d63aac
800000.0,3.0,9,4,4,3,11,0xb2d929ae
35.36,1.0,87,1,2,1,4,0xb2d85831
3168.36,1.0,4,2,2,4,8,0xb2d37b85
15.07,1.0,33,1,2,2,5,0xb2d55789
54609.41,1.0,1,3,2,4,9,0xb2d10036
5006.6,1.0,36,2,2,2,6,0xb2d9218b
939.24,1.0,4,1,2,4,7,0xb2d21d1d
342009.67,5.0,111,4,4,1,9,0xb2d21d13
647897.52,8.0,4,4,4,4,12,0xb2d5eb8c
100288.97,3.0,6,3,4,3,10,0xb2d281e0
3522.32,1.0,139,2,2,1,5,0xb2d3f902
2956.74,1.0,1,2,2,4,8,0xb2d9179d
70065.95,7.0,1,3,4,4,11,0xb2d31845
550658.83,1.0,10,4,2,3,9,0xb2d1fda2
11.4,1.0,6,1,2,3,6,0xb2d8d630
1605.11,1.0,44,1,2,2,5,0xb2d2cea1
17573.99,1.0,0,2,2,4,8,0xb2d0d698
402131.99,3.0,21,4,4,2,10,0xb2d80e5d
300418.58,5.0,92,4,4,1,9,0xb2d0b367
4422.02,1.0,7,2,2,3,7,0xb2d2500f
442842.68,3.0,74,4,4,1,9,0xb2d99607
310000.0,2.0,11,4,3,3,10,0xb2d966b5
20097.3,1.0,184,2,2,1,5,0xb2d31f05
330013.93,2.0,53,4,3,2,9,0xb2d9c54b
726.82,1.0,67,1,2,1,4,0xb2d6c21c
84.74,1.0,0,1,2,4,7,0xb2d918de
3196484.81,10.0,0,4,4,4,12,0x3b9b45ba
66720.03,1.0,13,3,2,3,8,0xb2d2cecd
195305.19,2.0,27,3,3,2,8,0xb2d63771
7763.8,1.0,10,2,2,3,7,0xb2d388c8
2230021.5,8.0,3,4,4,4,12,0xb2d074b9
27424.64,1.0,25,2,2,2,6,0xb2d7c05e
6844.04,1.0,6,2,2,3,7,0xb2d2a9bdd
530472.05,6.0,50,4,4,2,10,0x3b9af281
82119.73,4.0,11,3,4,3,10,0xb2d2bb09
11105.08,1.0,0,2,2,4,8,0xb2d1a548
6943.57,1.0,9,2,2,3,7,0xb2d60ed3
823366.03,6.0,27,4,4,2,10,0xb2d14c9c
152035.46,2.0,167,3,3,1,7,0xb2d5e23a
10466.58,1.0,0,2,2,4,8,0xb2d6bb22
10.33,1.0,22,1,2,2,5,0xb2d716fe
1400004.22,4.0,14,4,4,3,11,0xb2da23f8
1985.83,1.0,195,1,2,1,4,0xb2d53f8a
210044.95,5.0,1,3,4,4,11,0xb2d5705a
23571.64,1.0,0,2,2,4,8,0xb2d26aee
461660.79,3.0,14,4,4,3,11,0xb2d8e661
4601.86,1.0,58,2,2,2,6,0xb2d5a58d
59718.28,2.0,0,3,3,4,10,0xb2d10050
12.91,1.0,66,1,2,2,5,0xb2d8d158
12379.61,1.0,10,2,2,3,7,0xb2d2ac03
56198.0,1.0,9,3,2,3,8,0xb2d487b8
11.87,1.0,9,1,2,3,6,0xb2d8cb82
5.34,1.0,76,1,2,1,4,0xb2d8dbcf
311.81,1.0,26,1,2,2,5,0xb2d1d590
10793.51,1.0,13,2,2,3,7,0xb2d6a4ec
38476.12,4.0,92,2,4,1,7,0x3b9b14f2
500000.0,2.0,22,4,3,2,9,0xb2d8a0d5
776072.2,16.0,10,4,4,3,11,0xb2d1bd40
246504.45,5.0,5,3,4,3,10,0xb2d539f9
0.53,1.0,110,1,2,1,4,0xb2d956e2
10916.03,1.0,184,2,2,1,5,0x3b9b2489
3248.03,1.0,78,2,2,1,5,0xb2d6ecc6
8363.78,1.0,2,2,2,4,8,0xb2d83952
29114.6,1.0,9,2,2,3,7,0xb2d4888b
48.03,1.0,33,1,2,2,5,0xb2d9b271
153510.79,6.0,3,3,4,4,11,0xb2d0ea8f
11.48,1.0,71,1,2,1,4,0xb2d2aae8
64371.16,2.0,95,3,3,1,7,0xb2d3eae4
400050.76,3.0,116,4,4,1,9,0xb2d56e45
0.83,1.0,12,1,2,3,6,0xb2d1fb74
706949.61,6.0,3,4,4,4,12,0xb2d49187
3257.26,1.0,92,2,2,1,5,0x3b9b2bbe
708126.02,5.0,20,4,4,2,10,0xb2d08842
95000.0,2.0,8,3,3,3,9,0xb2d63f0f
3001953.72,9.0,1,4,4,4,12,0xb2d4d0eb
3338.28,6.0,0,2,4,4,10,0xb2d08dce
172854.32,4.0,0,3,4,4,11,0xb2d1724b
3000012.94,11.0,0,4,4,4,12,0xb2d16781
202178.24,2.0,9,3,3,3,9,0xb2d67f37
451927.37,4.0,63,4,4,2,10,0x3b9b33ca
45694.65,1.0,0,2,2,4,8,0xb2d3cc80
50006.92,1.0,4,2,2,4,8,0xb2d88b8c
302250.95,4.0,143,4,4,1,9,0xb2d12065
700004.19,3.0,22,4,4,2,10,0xb2d8d014
11520.27,1.0,6,2,2,3,7,0xb2d30efd
80001.69,2.0,6,3,3,3,9,0xb2d966da
180000.0,1.0,7,3,2,3,8,0xb2d47bce
508886.06,2.0,11,4,3,3,10,0xb2d6d014
147024.76,1.0,0,3,2,4,9,0xb2d22426
400066.6,3.0,0,4,4,4,12,0xb2d6d621
5623.77,1.0,3,2,2,4,8,0xb2d2ef4b
160.52,1.0,60,1,2,2,5,0xb2d312ae
3.9,1.0,2,1,2,4,7,0xb2d2a1df
1018.63,1.0,196,1,2,1,4,0xb2d586aa
261103.91,6.0,4,3,4,4,11,0xb2d485d4
31309.6,1.0,36,2,2,2,6,0xb2d9ef72
120006.35,2.0,209,3,3,1,7,0xb2d6872a
105046.92,1.0,22,3,2,2,7,0xb2d95853
1943.24,1.0,184,1,2,1,4,0xb2d2b116
304.5,1.0,12,1,2,3,6,0xb2d3385e
524076.98,4.0,5,4,4,3,11,0xb2d67e76
200002.69,2.0,0,3,3,4,10,0xb2d398f8
1583.14,1.0,92,1,2,1,4,0xb2d1caa2
551786.19,3.0,32,4,4,2,10,0xb2d62a44
800106.15,4.0,5,4,4,3,11,0xb2d5a0a2
500152.14,2.0,22,4,3,2,9,0xb2d989ff
4472.78,1.0,10,2,2,3,7,0xb2d8ea2a
260000.84,3.0,0,3,4,4,11,0xb2d2da23
1000001.25,4.0,1,4,4,4,12,0xb2d99d17
200063.75,2.0,38,3,3,2,8,0xb2d1ac43
150003.17,2.0,18,3,3,2,8,0xb2da2a0e
62780.99,2.0,92,3,3,1,7,0xb2d3bc53
2472.68,1.0,0,1,2,4,7,0xb2d2fdb2
132233.82,2.0,231,3,3,1,7,0xb2d62b16
1889.17,1.0,16,1,2,2,5,0xb2d9907f
200705.45,7.0,34,3,4,2,9,0xb2d2a5fc
200032.13,2.0,74,3,3,1,7,0xb2d787d2
7711.59,1.0,7,2,2,3,7,0xb2d9703e
275189.32,3.0,27,3,4,2,9,0xb2d1a7f1
220008.57,2.0,143,3,3,1,7,0xb2d4b65c
537078.75,8.0,87,4,4,1,9,0xb2d07b4d
195.77,1.0,46,1,2,2,5,0xb2d26b98
334543.0,2.0,3,4,3,4,11,0xb2d0729c
201744.91,2.0,11,3,3,3,9,0xb2d94102
572911.72,6.0,14,4,4,3,11,0xb2d5f0b4
14469.73,1.0,1,2,2,4,8,0xb2d382bc
50001.06,2.0,199,2,3,1,6,0xb2d69900
40000.42,2.0,133,2,3,1,6,0xb2d921c8
1014.62,1.0,184,1,2,1,4,0xb2d186cd
150710.29,3.0,3,3,4,4,11,0xb2d5788f
380055.33,14.0,0,4,4,4,12,0xb2d3d893
204115.17,3.0,54,3,4,2,9,0xb2d61769
10.23,1.0,157,1,2,1,4,0xb2d4278c
100006.12,3.0,11,3,4,3,10,0xb2d408cb
500113.94,2.0,184,4,3,1,8,0xb2d143dc
103009.8,2.0,0,3,3,4,10,0xb2d1b8f4
250307.33,3.0,25,3,4,2,9,0xb2d0b84c
101003.86,3.0,1,3,4,4,11,0xb2d470b8
2941.29,1.0,10,2,2,3,7,0xb2d42ef6
200000.01,2.0,1,3,3,4,10,0xb2d9b62a
140005.93,2.0,202,3,3,1,7,0xb2d64261
500161.67,2.0,22,4,3,2,9,0xb2d788fc
321111.4,8.0,1,4,4,4,12,0xb2d16e19
400000.0,2.0,6,4,3,3,10,0xb2da5b87
829.19,1.0,86,1,2,1,4,0xb2d53381
4069.94,2.0,52,2,3,2,7,0xb2d2bdea
121.36,1.0,11,1,2,3,6,0xb2d5c79f
42400.77,1.0,0,2,2,4,8,0xb2d3341f
80820.26,1.0,0,3,2,4,9,0xb2d52e35
100.01,5.0,35,1,4,2,7,0x3b9b4380
2266.28,1.0,7,1,2,3,6,0xb2d2f58a
315788.65,1.0,10,4,2,3,9,0xb2d91077
346181.97,5.0,92,4,4,1,9,0xb2d23c7f
400013.5,2.0,39,4,3,2,9,0xb2d5b976
50003.47,2.0,224,2,3,1,6,0xb2d17239
100001.06,2.0,69,3,3,1,7,0xb2d8e9a3
4.0,1.0,39,1,2,2,5,0xb2d32a3e
220083.68,7.0,48,3,4,2,9,0xb2d574c7
20083.11,1.0,184,2,2,1,5,0xb2d44223
5072.49,1.0,0,2,2,4,8,0xb2d8585b
40.98,1.0,36,1,2,2,5,0xb2d38db2
3058.52,1.0,2,2,2,4,8,0xb2d2de12
420000.0,2.0,21,4,3,2,9,0xb2da24b7
500032.44,2.0,5,4,3,3,10,0xb2d681eb
5544.06,1.0,3,2,2,4,8,0xb2d7fcc5
100007.89,4.0,76,3,4,1,8,0xb2d63724
490.97,1.0,41,1,2,2,5,0xb2d6b957
168.19,1.0,0,1,2,4,7,0xb2d77f8f
57379.05,6.0,0,3,4,4,11,0x3b9b3734
253022.86,4.0,116,3,4,1,8,0xb2d4a567
150046.5,4.0,11,3,4,3,10,0xb2d937d9
500006.04,2.0,6,4,3,3,10,0xb2d9fab8
53385.67,1.0,43,3,2,2,7,0xb2d23a9e
25994.09,2.0,0,2,3,4,9,0xb2d6a04f
15000.16,2.0,94,2,3,1,6,0xb2d88be8
14289.99,1.0,0,2,2,4,8,0xb2d3e8ed
648782.34,6.0,6,4,4,3,11,0x3b9b47b8
158980.84,4.0,133,3,4,1,8,0xb2d126a0
600000.0,4.0,4,4,4,4,12,0xb2d92125
202289.09,2.0,0,3,3,4,10,0xb2da0a17
0.0,2.0,49,1,3,2,6,0xb2d52e2c
2.93,1.0,103,1,2,1,4,0xb2d14f58
1200531.7,5.0,11,4,4,3,11,0xb2d9ad9b
7629.34,1.0,92,2,2,1,5,0xb2d301e4
20.9,1.0,15,1,2,3,6,0xb2d93f58
226893.39,3.0,165,3,4,1,8,0xb2d61952
41.92,1.0,70,1,2,1,4,0xb2d8a58a
580024.15,4.0,18,4,4,2,10,0xb2d4d036
2963.87,1.0,92,2,2,1,5,0xb2d2ea43
1091.38,1.0,92,1,2,1,4,0xb2d3490b
205000.83,5.0,1,3,4,4,11,0xb2d0d8da
750065.56,4.0,6,4,4,3,11,0xb2d3e859
340.85,1.0,1,1,2,4,7,0xb2d54c1dd
9.52,1.0,34,1,2,2,5,0xb2d7006d
151866.57,2.0,116,3,3,1,7,0xb2d6d3c7
218.39,2.0,28,1,3,2,6,0xb2d2e15e
760000.36,3.0,3,4,4,4,12,0xb2d12961
6509.01,1.0,7,2,2,3,7,0xb2d910cc
80003.98,4.0,42,3,4,2,9,0xb2d8ce30
756956.43,7.0,5,4,4,3,11,0xb2d09748
90736.82,3.0,5,3,4,3,10,0xb2d4cadb
248192.96,4.0,6,3,4,3,10,0xb2d167ad
101690.34,2.0,3,3,3,4,10,0xb2d1647d
170015.46,4.0,19,3,4,2,9,0xb2d68977
777.32,1.0,0,1,2,4,7,0xb2d38fb4
50003.69,2.0,53,2,3,2,7,0xb2d311d4
717727.52,4.0,5,4,4,3,11,0xb2d3389d
4014.93,1.0,96,2,2,1,5,0xb2d1bf81
4.85,1.0,1,1,2,4,7,0xb2d78d4a
400008.75,3.0,15,4,4,3,11,0xb2d38bb1
530807.7,1.0,35,4,2,2,8,0xb2d36620
148.65,1.0,13,1,2,3,6,0xb2d30de3
1218.59,1.0,0,1,2,4,7,0xb2d3465a
208069.02,7.0,4,3,4,4,11,0xb2d2e492
240350.64,5.0,0,3,4,4,11,0xb2d5ce18
43788.24,2.0,4,2,3,4,9,0xb2d1fa19
2.69,1.0,41,1,2,2,5,0xb2d22d43
2942897.77,14.0,0,4,4,4,12,0xb2d40a01
176317.67,1.0,11,3,2,3,8,0xb2d10004
53.3,1.0,147,1,2,1,4,0xb2d69eac
1461.76,1.0,1,1,2,4,7,0xb2d701a8
335154.3,5.0,0,4,4,4,12,0xb2d2997e
212410.03,3.0,160,3,4,1,8,0xb2d2bf67
205814.44,1.0,28,3,2,2,7,0xb2d6e3e0
565011.4,7.0,21,4,4,2,10,0xb2d28cfa
1788.16,1.0,9,1,2,3,6,0xb2d55abf
2000002.95,2.0,1,4,3,4,11,0xb2d649d1
74.22,1.0,50,1,2,2,5,0xb2d60d58
570121.25,5.0,20,4,4,2,10,0x3b9b343b
78651.62,2.0,80,3,3,1,7,0xb2d411b7
66.89,1.0,3,1,2,4,7,0xb2d60bf5
1911872.56,7.0,15,4,4,3,11,0xb2d9c2a3
140.22,1.0,28,1,2,2,5,0xb2d9a795
6066.2,1.0,10,2,2,3,7,0xb2d9913f
3080.23,1.0,0,2,2,4,8,0xb2d79155
3100000.91,4.0,6,4,4,3,11,0xb2d22963
29138.25,1.0,92,2,2,1,5,0xb2d14bfd
50000.53,2.0,52,2,3,2,7,0xb2d90c9d
750064.07,3.0,24,4,4,2,10,0xb2d9070e
120007.67,5.0,24,3,4,2,9,0xb2d3e7df
81071.96,2.0,136,3,3,1,7,0xb2d56e5a
1500000.0,2.0,0,4,3,4,11,0xb2d9e4de
3112868.5,9.0,47,4,4,2,10,0xb2d16e9d
389779.12,7.0,12,4,4,3,11,0xb2d1ffd7
50001.58,2.0,31,2,3,2,7,0xb2d59ac4
5230.23,1.0,0,2,2,4,8,0xb2d33dc1
3287.35,1.0,0,2,2,4,8,0xb2d28617
2042.19,1.0,92,1,2,1,4,0xb2d3f950
4038.84,1.0,48,2,2,2,6,0xb2d5b33d
0.0,1.0,5,1,2,3,6,0xb2d3aa8d
601136.74,3.0,20,4,4,2,10,0xb2d9d5dd
50606.22,2.0,66,2,3,2,7,0xb2d6c16a
20070.3,1.0,6,2,2,3,7,0xb2d6bf7b
205901.73,2.0,56,3,3,2,8,0xb2d36311
2928.34,1.0,92,2,2,1,5,0xb2d2a50e
632.01,2.0,0,1,3,4,8,0x3b9b3c2c
3272.1,1.0,29,2,2,2,6,0xb2d35fba
30007.94,1.0,1,2,2,4,8,0xb2d6cc3e
41.75,1.0,35,1,2,2,5,0xb2d11bab
244.76,1.0,0,1,2,4,7,0xb2d6d575
12500000.0,2.0,26,4,3,2,9,0xb2da12d1
3447.15,2.0,64,2,3,2,7,0xb2d4815e
455028.06,9.0,11,4,4,3,11,0xb2d58103
200001.82,2.0,7,3,3,3,9,0xb2d9c0f1
221563.21,2.0,43,3,3,2,8,0xb2d7096a
20000.21,2.0,266,2,3,1,6,0xb2d6baa8
2562.86,2.0,272,1,3,1,5,0xb2d13670
80531.89,1.0,11,3,2,3,8,0xb2d60aeb
409.23,1.0,7,1,2,3,6,0xb2d20676
50055.38,2.0,129,2,3,1,6,0xb2d2edd7
2065.09,1.0,92,1,2,1,4,0x3b9b3713
1432.84,1.0,92,1,2,1,4,0xb2d2c5af
3202.11,1.0,260,2,2,1,5,0xb2d2d3ac
26793.3,4.0,0,2,4,4,10,0xb2d09271
1890.43,1.0,0,1,2,4,7,0xb2d96846
1.12,1.0,4,1,2,4,7,0xb2d68f2a
44.57,1.0,82,1,2,1,4,0xb2d8a072
713.72,1.0,8,1,2,3,6,0xb2d214eb
1953.25,2.0,92,1,3,1,5,0xb2d3937e
77.76,1.0,4,1,2,4,7,0xb2d1cf9f
1398.27,2.0,51,1,3,2,6,0xb2d0b43b
20000.21,2.0,217,2,3,1,6,0xb2d74724
11902.4,1.0,10,2,2,3,7,0xb2d2bc9b
2944.22,1.0,0,2,2,4,8,0xb2d3b9d9
15727.05,1.0,3,2,2,4,8,0xb2d63f12
825761.88,6.0,3,4,4,4,12,0xb2d1b782
393.03,1.0,26,1,2,2,5,0xb2d452f3
1024082.06,4.0,15,4,4,3,11,0xb2d69b4b
201421.1,2.0,43,3,3,2,8,0xb2d8e661d
748259.46,5.0,0,4,4,4,12,0xb2d5f58b
365.47,2.0,92,1,3,1,5,0x3b9ade5e
11941.43,1.0,0,2,2,4,8,0xb2d6c1b7
365.84,1.0,18,1,2,2,5,0xb2d2777d
370105.18,2.0,0,4,3,4,11,0xb2d5f348
73700.78,2.0,6,3,3,3,9,0xb2d96ced
35.5,1.0,1,1,2,4,7,0xb2d6c3e6
323.81,1.0,6,1,2,3,6,0xb2d27fe1d
400000.37,2.0,15,4,3,3,10,0xb2d579a9
45219.46,2.0,20,2,3,2,7,0xb2d55eb0
437995.11,4.0,4,4,4,4,12,0xb2d4f0bb
7828.47,1.0,187,2,2,1,5,0xb2d5f41b
700000.0,2.0,11,4,3,3,10,0xb2da49fa
102214.81,2.0,104,3,3,1,7,0xb2d34c13
1080.37,1.0,184,1,2,1,4,0xb2d19d08
501391.89,4.0,15,4,4,3,11,0xb2d55150
500061.62,8.0,4,4,4,4,12,0xb2d12d18
1491313.85,4.0,48,4,4,2,10,0xb2d23751
0.85,1.0,4,1,2,4,7,0xb2d96943
30851.62,1.0,209,2,2,1,5,0xb2d51ad0
120002.53,2.0,8,3,3,3,9,0xb2da47b5
552065.08,8.0,39,4,4,2,10,0xb2d3d86b
2.26,2.0,46,1,3,2,6,0xb2d4e3d5
91533.45,2.0,20,3,3,2,8,0xb2d1f9ba
101179.21,2.0,111,3,3,1,7,0xb2d633a9
720023.88,3.0,55,4,4,2,10,0xb2d86c50
3319.23,1.0,112,2,2,1,5,0xb2d6380cd
286687.33,4.0,42,3,4,2,9,0xb2d1033f
205300.63,2.0,0,3,3,4,10,0xb2d6e470
243728.18,1.0,4,3,2,4,9,0xb2d5b99c
213190.8,2.0,54,3,3,2,8,0xb2d1de4f
205157.7,4.0,9,3,4,3,10,0xb2d5050a
143984.65,2.0,1,3,3,4,10,0xb2d26efb
11031757.98,1.0,18,4,2,2,8,0xb2d6d303
527806.26,6.0,4,4,4,4,12,0xb2d167d0
71716.32,4.0,1,3,4,4,11,0xb2d61983
500010.7,2.0,6,4,3,3,10,0xb2d38b30
1010.8,1.0,184,1,2,1,4,0xb2d1ee18
260022.79,3.0,3,3,4,4,11,0xb2d6860b
12632.73,1.0,0,2,2,4,8,0xb2d27c55
384.6,1.0,4,1,2,4,7,0xb2d1e281
711805.36,5.0,21,4,4,2,10,0xb2d19b3c
606425.33,2.0,91,4,3,1,8,0xb2d5e7a5
371086.34,6.0,3,4,4,4,12,0xb2d43584
1102.53,1.0,82,1,2,1,4,0xb2d521ce
2.49,1.0,2,1,2,4,7,0xb2d80390
450006.33,4.0,0,4,4,4,12,0xb2d8cdb4
500016.04,2.0,2,4,3,4,11,0xb2d86dca
247106.48,2.0,8,3,3,3,9,0xb2d41f4c
230817.03,2.0,16,3,3,2,8,0xb2d91b45
3024.18,1.0,18,2,2,2,6,0xb2d5de69
113047.15,5.0,0,3,4,4,11,0xb2d1bf08
20002.04,10.0,12,2,4,3,9,0xb2d2a23e
1421.94,1.0,184,1,2,1,4,0xb2d1a2f7
4.86,1.0,67,1,2,1,4,0xb2d8f1a6
245342.65,3.0,0,3,4,4,11,0xb2d3f561
511572.57,3.0,16,4,4,2,10,0xb2d68795
2021587.1,2.0,99,4,3,1,8,0xb2d27829
5.11,1.0,112,1,2,1,4,0xb2d5e8e3
53296.1,6.0,60,3,4,2,9,0xb2d3969a
1081.57,1.0,1,1,2,4,7,0xb2d2ad2a
200000.0,2.0,4,3,3,4,10,0xb2d61b82
0.0,2.0,67,1,3,1,5,0xb2d515c4
1545.96,1.0,252,1,2,1,4,0xb2d5614b
391556.59,1.0,0,4,2,4,10,0xb2d87fe7
796618.5,7.0,6,4,4,3,11,0xb2d5c46f
160006.97,3.0,28,3,4,2,9,0xb2d9a1e2
136590.68,1.0,0,3,2,4,9,0xb2d5990e
100004.26,3.0,63,3,4,2,9,0xb2d5b606
135011.45,3.0,4,3,4,4,11,0xb2d58c7f
7345.9,1.0,0,2,2,4,8,0xb2d26c9d
697816.82,1.0,6,4,2,3,9,0xb2d11ae9
310000.45,2.0,13,4,3,3,10,0xb2d962e4
2563228.82,57.0,0,4,4,4,12,0xb2d0b943
80097.73,2.0,24,3,3,2,8,0xb2d9555c
978967.74,12.0,6,4,4,3,11,0xb2d5fb2d
5397.36,1.0,184,2,2,1,5,0xb2d1d592
687.79,1.0,5,1,2,3,6,0xb2d788ac
153009.37,2.0,174,3,3,1,7,0xb2d50f3a
1288.1,1.0,0,1,2,4,7,0xb2d4ac76
1227514.22,5.0,1,4,4,4,12,0xb2d5589a
1230041.47,7.0,18,4,4,2,10,0xb2d13747
129236.1,4.0,3,3,4,4,11,0xb2d6a3ea
50000.53,2.0,1,2,3,4,9,0xb2da4b5c
469028.64,4.0,38,4,4,2,10,0xb2d1ce07
150189.81,2.0,147,3,3,1,7,0xb2d449bc
121015.28,3.0,143,3,4,1,8,0xb2d11227
1633.77,1.0,10,1,2,3,6,0xb2d2f9c8
17825.16,1.0,0,2,2,4,8,0xb2d69113
23986.56,2.0,12,2,3,3,8,0xb2d1961d
330.19,1.0,9,1,2,3,6,0xb2d7bc96
21738.87,1.0,18,2,2,2,6,0xb2d43826
83088.96,2.0,224,3,3,1,7,0xb2d54f6f
35.5,1.0,34,1,2,2,5,0xb2d921bc
30053.45,3.0,42,2,4,2,8,0xb2d5868d
301456.68,4.0,35,4,4,2,10,0xb2d5fbc5
422.38,1.0,14,1,2,3,6,0xb2d2c33b
1506.84,1.0,92,1,2,1,4,0xb2d1f956
180214.74,1.0,123,3,2,1,6,0xb2d12517
6788.26,2.0,3,2,3,4,9,0xb2d0db17
1155.09,1.0,14,1,2,3,6,0xb2d282cd
300000.0,2.0,0,3,3,4,10,0xb2d96380
1000005.45,3.0,15,4,4,3,11,0xb2d8de4a
300001.11,2.0,12,3,3,3,9,0xb2d90340
250025.77,5.0,0,3,4,4,11,0xb2d35e67
3549.06,1.0,184,2,2,1,5,0xb2d0fbfd
93.39,1.0,28,1,2,2,5,0xb2d25da4
400073.0,3.0,15,4,4,3,11,0xb2d6c5cf
468.84,1.0,10,1,2,3,6,0xb2d8d2cc
502139.22,3.0,80,4,4,1,9,0xb2d8d4bf
310000.0,2.0,3,4,3,4,11,0xb2d97c59
626472.22,2.0,0,4,3,4,11,0xb2d1ae9d
1428.89,2.0,0,1,3,4,8,0x3b9b3a21
400001.06,3.0,22,4,4,2,10,0xb2da1e42
9047.86,1.0,1,2,2,4,8,0xb2d67dd2
1569000.0,15.0,3,4,4,4,12,0xb2d534be
2179.66,1.0,133,1,2,1,4,0xb2d19835
33078.07,1.0,9,2,2,3,7,0xb2d689ae
1056647.49,7.0,2,4,4,4,12,0xb2d5e06b
60000.63,2.0,69,3,3,1,7,0xb2d8e9cd
1370147.58,10.0,0,4,4,4,12,0xb2d0687a
475479.94,1.0,60,4,2,2,8,0xb2d14049
104590.98,2.0,6,3,3,3,9,0xb2d28202
1390019.79,4.0,8,4,4,3,11,0xb2d9f9af
4015.57,1.0,92,2,2,1,5,0xb2d5ce1d
418860.18,4.0,1,4,4,4,12,0xb2d51f7a
57.12,2.0,56,1,3,2,6,0xb2d4a367
200069.34,4.0,18,3,4,2,9,0xb2d53f44
31125.78,1.0,5,2,2,3,7,0xb2d2ebd6
2500000.0,1.0,0,4,2,4,10,0xb2d97622
11494.51,1.0,5,2,2,3,7,0xb2d7068b
510003.72,3.0,7,4,4,3,11,0xb2d6cc98
236068.22,2.0,21,3,3,2,8,0xb2d6e792
73077.61,2.0,60,3,3,2,8,0xb2d0f667
144.92,1.0,6,1,2,3,6,0xb2d91c12
504394.61,3.0,182,4,4,1,9,0xb2d126f1
9338.99,1.0,27,2,2,2,6,0xb2d2978b
100015.38,2.0,105,3,3,1,7,0xb2d2443a
112238.73,3.0,95,3,4,1,8,0xb2d3bb32
25846.6,1.0,18,2,2,2,6,0xb2d62b72
14160.78,1.0,0,2,2,4,8,0xb2d787bf
189482.02,3.0,70,3,4,1,8,0xb2d08287
100011.14,3.0,10,3,4,3,10,0x3b9b2cc1
4141.75,1.0,184,2,2,1,5,0x3b9b1348
1020007.85,17.0,3,4,4,4,12,0x3b9b405f
382261.07,4.0,57,4,4,2,10,0xb2d6b3bf
20194.86,1.0,92,2,2,1,5,0xb2d25f10
901993.68,5.0,14,4,4,3,11,0xb2d20ba6
247878.25,2.0,56,3,3,2,8,0xb2d652ec
0.65,1.0,80,1,2,1,4,0xb2d60cf5
40.71,2.0,86,1,3,1,5,0xb2d8c35b
6695.03,1.0,92,2,2,1,5,0xb2d1537d
222209.12,2.0,3,3,3,4,10,0xb2d1c1f9
4.23,3.0,75,1,4,1,6,0xb2d23b8f
20000.63,2.0,38,2,3,2,7,0xb2d925da
52414.42,2.0,136,3,3,1,7,0xb2d4be40
215623.27,3.0,1,3,4,4,11,0xb2d24e88
280063.09,3.0,24,3,4,2,9,0xb2d637ed
1605.74,1.0,8,1,2,3,6,0xb2d27fcf
1873.17,1.0,0,1,2,4,7,0xb2d48f59
120025.14,5.0,39,3,4,2,9,0xb2d64984
311.37,1.0,3,1,2,4,7,0xb2d5827d
52177.52,1.0,92,3,2,1,6,0xb2d3516b
5000265.79,3.0,0,4,4,4,12,0xb2d22369
100009.11,3.0,40,3,4,2,9,0xb2d11d97
430014.06,3.0,12,4,4,3,11,0xb2d97a30
12141.4,1.0,3,2,2,4,8,0xb2d5e79e
19272.14,1.0,161,2,2,1,5,0xb2d2cee5
74.53,2.0,42,1,3,2,6,0xb2d610bf
55360.58,3.0,28,3,4,2,9,0xb2d2b66b
17.11,1.0,92,1,2,1,4,0xb2d1d84e
117532.44,3.0,4,3,4,4,11,0xb2d69d08
21603.51,2.0,24,2,3,2,7,0xb2d60bc0
583185.93,4.0,14,4,4,3,11,0xb2d2d200
124170.4,2.0,4,3,3,4,10,0xb2d60983
785753.83,4.0,59,4,4,2,10,0xb2d31f6f
1153467.73,7.0,12,4,4,3,11,0xb2d1ab1c
500000.46,3.0,0,4,4,4,12,0xb2d59def
100134.57,2.0,69,3,3,1,7,0xb2d43435
36.88,1.0,4,1,2,4,7,0xb2d53ad6
19151.47,1.0,0,2,2,4,8,0xb2d1f71e
100002.11,2.0,83,3,3,1,7,0xb2d98556
1000067.51,8.0,129,4,4,1,9,0xb2d41a9a
230007.28,3.0,10,3,4,3,10,0xb2d6fcd5
103128.22,2.0,74,3,3,1,7,0xb2d1aa97
199903.18,2.0,0,3,3,4,10,0xb2d555a1
500312.01,8.0,83,4,4,1,9,0xb2d8d995
70424.4,3.0,1,3,4,4,11,0xb2d5df82
730013.39,7.0,42,4,4,2,10,0xb2d5d087
200005.29,3.0,6,3,4,3,10,0xb2d20269
254005.37,2.0,185,3,3,1,7,0xb2d6aaae
400036.02,3.0,13,4,4,3,11,0xb2d62bba
176856.24,3.0,108,3,4,1,8,0xb2d42b0c
950018.29,6.0,0,4,4,4,12,0xb2d5efef
0.0,1.0,4,1,2,4,7,0xb2d5680a
10000.11,2.0,168,2,3,1,6,0xb2d8dcb8
500005.28,2.0,74,4,3,1,8,0xb2d99f6d
200752.43,2.0,35,3,3,2,8,0xb2d8ea6f
3903831.75,4.0,16,4,4,2,10,0xb2d5edad
18180.25,1.0,168,2,2,1,5,0xb2d2e75f
201095.52,3.0,90,3,4,1,8,0xb2d193ce
105025.34,3.0,104,3,4,1,8,0xb2d441bc
202001.48,6.0,2,3,4,4,11,0xb2d59cbc
8132.44,1.0,8,2,2,3,7,0xb2d5e690
8360.22,1.0,92,2,2,1,5,0xb2d305cb
1068.66,1.0,10,1,2,3,6,0xb2d5a593
100005.7,2.0,168,3,3,1,7,0xb2d41340
375260.09,2.0,18,4,3,2,9,0xb2d6ef43
840398.94,12.0,53,4,4,2,10,0xb2d0f329
27508.27,1.0,20,2,2,2,6,0xb2d8d354
9966.23,1.0,1,2,2,4,8,0xb2d3ae86
84.44,1.0,35,1,2,2,5,0xb2d9dd73
398.89,1.0,10,1,2,3,6,0xb2d57a73
400020.05,3.0,28,4,4,2,10,0xb2d9af6d
2275111.87,7.0,20,4,4,2,10,0xb2d072dd
400019.48,1.0,3,4,2,4,10,0xb2d52dcd
7579.48,1.0,46,2,2,2,6,0xb2d243b3
1000000.0,2.0,6,4,3,3,10,0xb2da5946
70009.87,2.0,60,3,3,2,8,0xb2d22d70
160001.69,2.0,13,3,3,3,9,0xb2d95df9
5654.87,1.0,4,2,2,4,8,0xb2d5ab8c
811035.6,26.0,4,4,4,4,12,0xb2d60570
10064.26,2.0,31,2,3,2,7,0xb2d5e6a0
85005.16,2.0,19,3,3,2,8,0xb2d1151b
1087.3,1.0,10,1,2,3,6,0xb2d34dc1
922017.42,6.0,0,4,4,4,12,0xb2d646d5
30123.63,1.0,5,2,2,3,7,0xb2d6e69b
2817.67,1.0,4,1,2,4,7,0xb2d6deeb
10300.0,1.0,5,2,2,3,7,0xb2d36805
10439.39,1.0,1,2,2,4,8,0xb2d6e937
360165.31,2.0,52,4,3,2,9,0xb2d2f64e
14702.55,1.0,4,2,2,4,8,0xb2d3f591
0.41,2.0,72,1,3,1,5,0x3b9af184
10063.97,2.0,119,2,3,1,6,0xb2d5ef60
1006831.87,5.0,1,4,4,4,12,0xb2d311b9
635.41,1.0,10,1,2,3,6,0xb2d6e491
16681.17,1.0,6,2,2,3,7,0xb2d3f696
30005.26,2.0,4,2,3,4,9,0xb2d68925
2106.78,1.0,10,1,2,3,6,0xb2d44943
50001.58,2.0,122,2,3,1,6,0xb2d6d286
1000026.71,2.0,8,4,3,3,10,0xb2d6faed
21127.04,1.0,13,2,2,3,7,0xb2d685b9
103.34,1.0,62,1,2,2,5,0xb2d8eaca
3363.41,1.0,11,2,2,3,7,0xb2d1d50b
20.36,1.0,0,1,2,4,7,0xb2d2c200
20.58,1.0,4,1,2,4,7,0xb2d9f98b
18933.77,1.0,69,2,2,1,5,0xb2d50fb6
2818.08,1.0,4,1,2,4,7,0xb2d22f2f
120459.49,3.0,119,3,4,1,8,0xb2d5e576
305000.0,7.0,4,4,4,4,12,0xb2d6abad
27856.88,1.0,0,2,2,4,8,0xb2d43a62
50005.28,2.0,60,2,3,2,7,0xb2d9ab8d
1115438.06,20.0,0,4,4,4,12,0xb2d27fcc
111998.51,3.0,0,3,4,4,11,0xb2d940ee
319127.63,2.0,8,4,3,3,10,0xb2d8e033
711511.73,5.0,61,4,4,2,10,0xb2d1ac79
701238.77,4.0,2,4,4,4,12,0xb2d671f4
139.63,1.0,111,1,2,1,4,0xb2d4f7bc
160056.21,3.0,0,3,4,4,11,0xb2d55740
200009.51,3.0,168,3,4,1,8,0xb2d1b93d
822947.47,1.0,0,4,2,4,10,0xb2d5ee28
787401.99,3.0,3,4,4,4,12,0xb2d10543
201678.8,4.0,18,3,4,2,9,0xb2d13040
166735.86,4.0,0,3,4,4,11,0xb2d3963e
883.85,1.0,3,1,2,4,7,0xb2d6a1a3
148004.81,6.0,14,3,4,3,10,0xb2d64afe
1596.53,1.0,286,1,2,1,4,0xb2d1d69c
25.19,1.0,33,1,2,2,5,0xb2d40020
88021.28,1.0,13,3,2,3,8,0xb2d32122
20000.42,2.0,31,2,3,2,7,0xb2d93568
15.24,1.0,20,1,2,2,5,0xb2d57e42
86184.44,3.0,0,3,4,4,11,0xb2d06913
270031.02,3.0,49,3,4,2,9,0xb2d3efb6
16695.98,1.0,4,2,2,4,8,0xb2d0d9cf
7133.34,1.0,7,2,2,3,7,0xb2d921b5
230902.76,3.0,55,3,4,2,9,0xb2d2825f
10009.63,2.0,200,2,3,1,6,0xb2d65a7d
280015.13,2.0,18,3,3,2,8,0xb2d1a5b2d
10.06,1.0,167,1,2,1,4,0xb2d5c309
6719.34,1.0,11,2,2,3,7,0xb2da26f0
961741.58,6.0,0,4,4,4,12,0xb2d55b06
226380.57,2.0,28,3,3,2,8,0xb2d633c8
500000.0,2.0,13,4,3,3,10,0xb2d1683e
38122.41,1.0,19,2,2,2,6,0xb2d24a21
843820.11,3.0,172,4,4,1,9,0xb2d1a8a2
478900.79,1.0,0,4,2,4,10,0xb2d964a7
7786.8,1.0,14,2,2,3,7,0xb2d8d518
655898.78,10.0,1,4,4,4,12,0x3b9b2e07
1086.89,1.0,92,1,2,1,4,0xb2d2091f
191552.36,2.0,119,3,3,1,7,0xb2d282f0
80006.58,2.0,200,3,3,1,7,0xb2d3e9d8
200085.02,3.0,63,3,4,2,9,0xb2d225c7
250037.23,4.0,31,3,4,2,9,0xb2d10c41
52281.07,2.0,0,3,3,4,10,0xb2d630aa
2458.72,1.0,92,1,2,1,4,0xb2d2d6bd
420097.65,3.0,27,4,4,2,10,0x3b9b495a
150003.17,2.0,45,3,3,2,8,0xb2d9185a
5907.3,1.0,0,2,2,4,8,0xb2d6512f
1797.78,1.0,190,1,2,1,4,0xb2d3ea20
96.51,1.0,6,1,2,3,6,0xb2d6b4a8
19998.0,1.0,6,2,2,3,7,0xb2d96f19
45000.95,2.0,80,2,3,1,6,0xb2d8d53b
8655.41,1.0,0,2,2,4,8,0xb2d2d04f
370000.0,9.0,0,4,4,4,12,0xb2d5f213
330179.16,2.0,245,4,3,1,8,0xb2d2568e
2365.73,3.0,21,1,4,2,7,0xb2d4dc75
76357.43,4.0,4,3,4,4,11,0xb2d592d8
703009.91,1.0,3,4,2,4,10,0xb2d99fc6
50000.53,2.0,92,2,3,1,6,0xb2d637c5
57.01,1.0,75,1,2,1,4,0xb2d58109
30000.32,2.0,32,2,3,2,7,0xb2da032c
2723.68,1.0,308,1,2,1,4,0xb2d32248
723826.53,6.0,11,4,4,3,11,0xb2d291e0
163.83,1.0,13,1,2,3,6,0xb2d21824
76.6,1.0,12,1,2,3,6,0xb2d2dd7b
63081.22,3.0,0,3,4,4,11,0x3b9ae180
200006.44,2.0,87,3,3,1,7,0xb2d59ce8
4011.17,1.0,92,2,2,1,5,0xb2d401d7
24543.15,2.0,0,2,3,4,9,0xb2d2bc7f
4316271.84,8.0,3,4,4,4,12,0xb2d6b2a9
203652.18,3.0,0,3,4,4,11,0xb2d17e75
5403.67,1.0,0,2,2,4,8,0xb2d5dc3d
1032.03,1.0,184,1,2,1,4,0xb2d34536
157569.51,1.0,33,3,2,2,7,0xb2d23a49
1556.47,1.0,184,1,2,1,4,0xb2d32626
15787.73,1.0,1,2,2,4,8,0xb2d5cf03
153606.66,2.0,123,3,3,1,7,0xb2d2e3a9
996.54,1.0,8,1,2,3,6,0xb2d9e9bb
2386.29,1.0,11,1,2,3,6,0xb2d78bf0
1003.42,1.0,184,1,2,1,4,0xb2d65571
50267.41,4.0,0,2,4,4,10,0xb2d656e7
41.18,1.0,8,1,2,3,6,0xb2d9432d
782861.93,8.0,2,4,4,4,12,0xb2d07135
2910.83,2.0,184,2,3,1,6,0x3b9b2396
3850.64,1.0,242,2,2,1,5,0xb2d2ae63
273123.41,2.0,0,3,3,4,10,0xb2d23754
312529.81,5.0,1,4,4,4,12,0xb2d23a22
1019.95,1.0,184,1,2,1,4,0xb2d0e0af
619633.69,3.0,33,4,4,2,10,0xb2d63ef8
547205.03,3.0,0,4,4,4,12,0xb2d49554
323837.25,3.0,18,4,4,2,10,0xb2d65d7b
18449.59,1.0,3,2,2,4,8,0xb2d9cbe5
500186.65,7.0,7,4,4,3,11,0xb2d10b48
30000.63,2.0,6,2,3,3,8,0xb2d967cf
1353000.24,14.0,0,4,4,4,12,0xb2d4c5f5
1094.36,1.0,0,1,2,4,7,0xb2d65e6e
546023.03,4.0,3,4,4,4,12,0xb2d37486
509512.96,3.0,20,4,4,2,10,0xb2d3f455
3235.43,1.0,184,2,2,1,5,0xb2d1f9c1
523.51,1.0,60,1,2,2,5,0xb2d8ee12
99.36,1.0,7,1,2,3,6,0xb2d24e5c
10.35,1.0,225,1,2,1,4,0xb2d0d2ea
6176.47,1.0,11,2,2,3,7,0xb2d2bb90
3500.72,1.0,9,2,2,3,7,0xb2d6c573
103274.88,2.0,213,3,3,1,7,0xb2d30808d
300032.32,2.0,18,3,3,2,8,0xb2d6941e
2874.93,1.0,5,1,2,3,6,0xb2d2c73c
22599.25,1.0,10,2,2,3,7,0xb2d342d6
19237.92,1.0,49,2,2,2,6,0xb2d392c3
810.83,1.0,0,1,2,4,7,0xb2d110b4
4276.13,1.0,213,2,2,1,5,0xb2d24dbc
317992.64,3.0,0,4,4,4,12,0xb2d321bd
251290.01,6.0,45,3,4,2,9,0xb2d0ca81
82541.69,5.0,50,3,4,2,9,0xb2d99bf9
600006.34,2.0,139,4,3,1,8,0xb2d6eefd
11.16,1.0,77,1,2,1,4,0xb2d56114
197316.27,1.0,6,3,2,3,8,0xb2d26f02
230537.43,2.0,173,3,3,1,7,0xb2d88b72
120584.9,3.0,80,3,4,1,8,0xb2d69af8
4433.98,1.0,29,2,2,2,6,0xb2d69f5d
22.49,1.0,28,1,2,2,5,0xb2d3ea08
43.63,1.0,86,1,2,1,4,0xb2d2eb07
10360.18,2.0,53,2,3,2,7,0xb2d62c3e
4515.07,1.0,0,2,2,4,8,0xb2d30b72
1600078.23,2.0,3,4,3,4,11,0x3b9b491d
4691.91,2.0,48,2,3,2,7,0xb2d0af82
42187.52,1.0,10,2,2,3,7,0xb2d3762fd
700000.0,2.0,21,4,3,2,9,0xb2d9482c
27401.34,1.0,173,2,2,1,5,0xb2d2d818
319.08,1.0,0,1,2,4,7,0xb2d272f4
1681.89,1.0,8,1,2,3,6,0xb2d51c4a
220225.51,8.0,0,3,4,4,11,0x3b9b45f1
100805.19,2.0,11,3,3,3,9,0xb2d151e7
486034.79,4.0,55,4,4,2,10,0xb2d59c41
50001.58,2.0,53,2,3,2,7,0xb2d9ca06
110053.98,2.0,143,3,3,1,7,0xb2d3f613
5.19,3.0,12,1,4,3,8,0xb2d4649e
101138.06,1.0,10,3,2,3,8,0xb2d3eb65
2.85,1.0,19,1,2,2,5,0xb2d9e4c3
4128.92,1.0,184,2,2,1,5,0xb2d406ca
715690.18,4.0,27,4,4,2,10,0xb2d58def
3089.52,1.0,0,2,2,4,8,0xb2d97987
3047.26,1.0,1,2,2,4,8,0xb2d59eb6
1979.76,1.0,0,1,2,4,7,0xb2d6c3d8
122613.17,2.0,209,3,3,1,7,0xb2d0bece
300448.42,2.0,167,4,3,1,8,0xb2d2ac4f
1075.15,1.0,10,1,2,3,6,0xb2d3d258
19577.28,1.0,45,2,2,2,6,0xb2d6803b
7163.81,1.0,1,2,2,4,8,0xb2d55428
574978.05,5.0,24,4,4,2,10,0xb2d3ae16
6.74,1.0,77,1,2,1,4,0xb2d1c6ce
23183.86,1.0,15,2,2,3,7,0xb2d414df
83.73,1.0,19,1,2,2,5,0xb2d1e9a9
1709.69,1.0,172,1,2,1,4,0xb2d2cb2b
1826.66,1.0,10,1,2,3,6,0xb2d47112
60003.7,2.0,92,3,3,1,7,0xb2d42a6c
93441.52,1.0,11,3,2,3,8,0xb2d33c00
8678.02,2.0,184,2,3,1,6,0x3b9b15d5
15000.63,2.0,69,2,3,1,6,0xb2d8e882
1001346.71,4.0,0,4,4,4,12,0xb2d6e3ec
426728.71,6.0,7,4,4,3,11,0x3b9b34b7
3.31,1.0,30,1,2,2,5,0xb2d786c7
100001.06,2.0,95,3,3,1,7,0xb2d975a4
393424.26,2.0,39,4,3,2,9,0xb2d0737d
201514.66,2.0,1,3,3,4,10,0xb2d93888
9000.66,1.0,9,2,2,3,7,0xb2d2c95f
444927.54,6.0,1,4,4,4,12,0xb2d2035d
1958.6,1.0,8,1,2,3,6,0xb2d950f5
267000.73,2.0,5,3,3,3,9,0xb2d6a485
78.83,1.0,27,1,2,2,5,0xb2d438a9
61127.26,2.0,143,3,3,1,7,0xb2d614c0
70.25,1.0,23,1,2,2,5,0xb2d257ba
1017.49,1.0,92,1,2,1,4,0xb2d2c50b
6468.83,1.0,181,2,2,1,5,0xb2d2ad2e
4261.76,2.0,24,2,3,2,7,0x3b9b46cf
21498.7,1.0,0,2,2,4,8,0xb2d24e03
72690.4,2.0,25,3,3,2,8,0xb2d5c7cc
500137.0,2.0,6,4,3,3,10,0xb2d5bcd6
0.0,1.0,2,1,2,4,7,0xb2d1a199
104004.03,2.0,31,3,3,2,8,0xb2d5c62a
90000.95,2.0,18,3,3,2,8,0xb2d95380
500000.0,2.0,1,4,3,4,11,0xb2da6684
731.11,1.0,18,1,2,2,5,0xb2d34983
184648.78,3.0,67,3,4,1,8,0xb2d43c14
211.11,1.0,84,1,2,1,4,0xb2d98402
16820.44,1.0,3,2,2,4,8,0xb2d48bf3
2183096.65,12.0,25,4,4,2,10,0xb2d3b56d
10000.32,2.0,80,2,3,1,6,0xb2d8d2e2
763086.79,4.0,30,4,4,2,10,0xb2d8ef11
143728.32,1.0,20,3,2,2,7,0xb2d2fcc8
2023.47,1.0,184,1,2,1,4,0xb2d1c685
1300000.0,1.0,0,4,2,4,10,0xb2da6c96
50006.3,2.0,90,2,3,1,6,0xb2d557aa
91.72,12.0,31,1,4,2,7,0xb2d15ea9
0.0,1.0,1,1,2,4,7,0xb2d1c3a2
4009.26,1.0,92,2,2,1,5,0xb2d1d853
610956.11,5.0,19,4,4,2,10,0xb2d110e1
1678.28,5.0,114,1,4,1,6,0xb2d18aaa
158193.18,1.0,9,3,2,3,8,0xb2d3c3f0
100089.97,2.0,182,3,3,1,7,0xb2d188e0
900008.99,5.0,14,4,4,3,11,0xb2d5c8b5
369917.18,6.0,18,4,4,2,10,0xb2d26c09
19885.3,1.0,3,2,2,4,8,0x3b9b3290
259325.47,2.0,99,3,3,1,7,0xb2d64fe8
53334.53,1.0,6,3,2,3,8,0xb2d62610
10087.92,1.0,92,2,2,1,5,0xb2d29a57
4530.81,1.0,0,2,2,4,8,0xb2d67de3
7541.19,1.0,211,2,2,1,5,0xb2d6b789
111745.17,4.0,0,3,4,4,11,0xb2d64f9b
930060.21,4.0,27,4,4,2,10,0xb2d12682
1163590.5,8.0,28,4,4,2,10,0xb2d23925
551.23,1.0,10,1,2,3,6,0xb2d1d0f1
1758944.54,26.0,15,4,4,3,11,0xb2d5a907
2799.82,4.0,0,1,4,4,9,0x3b9b46c2
204265.84,2.0,190,3,3,1,7,0xb2d834ba
2600.18,1.0,26,1,2,2,5,0xb2d29637
70651.01,3.0,31,3,4,2,9,0x3b9b2a35
300661.36,2.0,5,4,3,3,10,0xb2d16b59
23467.89,1.0,9,2,2,3,7,0xb2d32459
472635.07,3.0,35,4,4,2,10,0xb2d5e978
1050041.22,4.0,0,4,4,4,12,0xb2d3a642
365009.62,6.0,36,4,4,2,10,0xb2d5c73e
46001.96,5.0,11,2,4,3,9,0xb2d972f8
201420.99,4.0,30,3,4,2,9,0xb2d8ff31
1326.52,2.0,184,1,3,1,5,0xb2d0b37c
4056.77,1.0,40,2,2,2,6,0xb2d39634
212248.44,3.0,104,3,4,1,8,0xb2d17aaa
102428.76,1.0,119,3,2,1,6,0xb2d41595
405015.98,3.0,47,4,4,2,10,0xb2d175c7
16.4,1.0,184,1,2,1,4,0xb2d1e9c6
201421.04,2.0,37,3,3,2,8,0xb2d8eb39
91071.04,2.0,165,3,3,1,7,0xb2d6b8ed
4065.7,1.0,8,2,2,3,7,0x3b9b31d3
31742.38,1.0,0,2,2,4,8,0xb2d2047ad
828.99,1.0,124,1,2,1,4,0xb2d28996
953.38,1.0,6,1,2,3,6,0xb2d108a8
51003.29,3.0,165,2,4,1,7,0xb2d5aa84
100004.36,3.0,46,3,4,2,9,0xb2d0cb75
110003.59,3.0,14,3,4,3,10,0xb2d9c674
110529.08,7.0,9,3,4,3,10,0xb2d4319a
271988.12,5.0,18,3,4,2,9,0xb2d07da4
300000.0,1.0,0,3,2,4,9,0xb2d2cf51
300199.57,2.0,6,4,3,3,10,0xb2d7819f
2090343.15,2.0,21,4,3,2,9,0xb2d0d211
6804.68,1.0,0,2,2,4,8,0xb2d6a774
260026.6,3.0,28,3,4,2,9,0xb2d18ebe
6691.71,1.0,5,2,2,3,7,0xb2d4cb07
26675.78,1.0,1,2,2,4,8,0xb2d96b06
210016.26,3.0,94,3,4,1,8,0xb2d14041
536.66,2.0,3,1,3,4,8,0xb2d59f7d
441356.56,6.0,4,4,4,4,12,0xb2d1c83c
260419.93,4.0,77,3,4,1,8,0xb2d48dea
1911.53,1.0,244,1,2,1,4,0xb2d5dd0c
56883.56,4.0,90,3,4,1,8,0xb2d0c5b6
167675.91,2.0,0,3,3,4,10,0xb2d4194c
1690.23,1.0,154,1,2,1,4,0xb2d4c288
1303565.88,5.0,13,4,4,3,11,0xb2d9dd4b
2152.07,1.0,1,1,2,4,7,0xb2d3d93e
1313.07,1.0,20,1,2,2,5,0xb2d2d74e
42.94,1.0,39,1,2,2,5,0xb2d153ec
15237.86,1.0,1,2,2,4,8,0xb2d4dc66
150001.58,2.0,38,3,3,2,8,0xb2d92ba9
500010.56,2.0,48,4,3,2,9,0xb2d9d74a
218008.6,2.0,108,3,3,1,7,0xb2d5c1e3
1630221.56,3.0,74,4,4,1,9,0xb2d39cd8
350000.0,1.0,0,4,2,4,10,0xb2da6286
200198.02,2.0,12,3,3,3,9,0xb2da109f
266000.86,26.0,59,3,4,2,9,0xb2d1236c
4284.49,1.0,0,2,2,4,8,0xb2d8daa3
40002.55,2.0,77,2,3,1,6,0xb2d65d3c
924.07,1.0,1,1,2,4,7,0xb2d17c20
400000.43,3.0,14,4,4,3,11,0xb2d9e615
3657.56,1.0,11,2,2,3,7,0xb2d193f7
450016.77,3.0,73,4,4,1,9,0xb2d504e9
30000.32,2.0,55,2,3,2,7,0xb2d903d6
500094.79,1.0,1,4,2,4,10,0xb2da6706
2.58,7.0,35,1,4,2,7,0xb2d07b80
376288.31,3.0,11,4,4,3,11,0xb2d6122d
1818.8,1.0,98,1,2,1,4,0xb2d3721d
1009.85,1.0,184,1,2,1,4,0xb2d2bcea
45078.69,2.0,31,2,3,2,7,0xb2d604c6
183601.88,4.0,0,3,4,4,11,0xb2d3ef0e
2256.13,1.0,26,1,2,2,5,0xb2d350e8
164624.64,7.0,0,3,4,4,11,0x3b9af0e6
5199.56,1.0,19,2,2,2,6,0xb2d5b5f8
7559.86,1.0,29,2,2,2,6,0xb2d335e9
4154.73,1.0,1,2,2,4,8,0xb2d8d05c
11443.89,1.0,0,2,2,4,8,0xb2d5090f
205215.66,2.0,78,3,3,1,7,0xb2d5d2d1
50412.1,1.0,92,2,2,1,5,0xb2d2e39c
466.14,1.0,6,1,2,3,6,0xb2da11ab
303204.72,6.0,0,4,4,4,12,0xb2d4187e
1.64,1.0,5,1,2,3,6,0xb2d1ff51
56.34,2.0,34,1,3,2,6,0xb2d20662
387252.32,2.0,37,4,3,2,9,0xb2d3c55e
200000.0,2.0,16,3,3,2,8,0xb2d995fd
71057.0,3.0,48,3,4,2,9,0xb2d62f4c
1100000.19,2.0,18,4,3,2,9,0xb2d9d543
200000.0,2.0,21,3,3,2,8,0xb2da1566
41001.02,3.0,13,2,4,3,9,0xb2da15ca
1600397.02,6.0,62,4,4,2,10,0xb2d57a71
12455.41,2.0,133,2,3,1,6,0xb2d51160
31431.63,1.0,184,2,2,1,5,0xb2d3a413
2417072.41,3.0,56,4,4,2,10,0xb2d64d7c
158480.19,2.0,74,3,3,1,7,0xb2d39bf0
804844.55,4.0,79,4,4,1,9,0xb2d407a7
291748.82,3.0,61,3,4,2,9,0xb2d4fdd9
58.5,1.0,25,1,2,2,5,0xb2d9b4d4
65.77,1.0,15,1,2,3,6,0xb2d52df5
3064.8,1.0,0,2,2,4,8,0xb2d6bb2e
463531.99,4.0,6,4,4,3,11,0xb2d5920a
138723.71,1.0,92,3,2,1,6,0xb2d42138
200004.22,2.0,39,3,3,2,8,0xb2d9eefc
50000.53,2.0,34,2,3,2,7,0xb2d9328d
62483.24,2.0,2,3,3,4,10,0xb2d065ead
180966.99,1.0,10,3,2,3,8,0xb2d611c3
1500021.15,3.0,18,4,4,2,10,0xb2d9de9f
210746.02,2.0,50,3,3,2,8,0xb2d9d87f
1349.95,1.0,92,1,2,1,4,0xb2d270a3d
720114.59,5.0,0,4,4,4,12,0xb2d9d0b5
6066.01,1.0,184,2,2,1,5,0xb2d28e99
894057.28,7.0,26,4,4,2,10,0xb2d068c0
9377.12,1.0,3,2,2,4,8,0xb2d6e7c0
500054.0,3.0,15,4,4,3,11,0xb2d1a63e
306182.88,2.0,196,4,3,1,8,0xb2d251dd
11096.38,1.0,10,2,2,3,7,0xb2d44dfe
2600.75,4.0,9,1,4,3,8,0xb2d26827
136001.46,2.0,6,3,3,3,9,0xb2d6a312
340001.22,4.0,73,4,4,1,9,0xb2d16cc6d
782108.58,4.0,6,4,4,3,11,0xb2d1706f
0.05,1.0,2,1,2,4,7,0xb2d3c9d8
1196.22,1.0,0,1,2,4,7,0xb2d0d9f1
6068507.06,4.0,32,4,4,2,10,0xb2d46d82
260886.04,2.0,0,3,3,4,10,0xb2d8f44d
1206016.98,7.0,0,4,4,4,12,0xb2d6401e
13.93,1.0,2,1,2,4,7,0xb2d91bf8
10055.98,1.0,92,2,2,1,5,0xb2d20ef4
9764.92,1.0,12,2,2,3,7,0xb2d68f96
2.96,2.0,36,1,3,2,6,0xb2d168f6
340012.85,2.0,14,4,3,3,10,0xb2d0f1f4
226038.35,2.0,150,3,3,1,7,0xb2d6c27e
170048.51,2.0,53,3,3,2,8,0xb2d36b72
10000.42,2.0,181,2,3,1,6,0xb2d6b24c
300000.0,2.0,18,3,3,2,8,0xb2da3562
50082.22,2.0,98,2,3,1,6,0xb2d56374
60001.9,2.0,228,3,3,1,7,0xb2d6f2a0
111.56,1.0,2,1,2,4,7,0xb2d2abc6
130028.4,1.0,25,3,2,2,7,0xb2d6908b
10108.68,1.0,3,2,2,4,8,0xb2d8478c
341475.08,3.0,6,4,4,3,11,0xb2d4365b
730000.0,2.0,1,4,3,4,11,0xb2d9815a
0.0,1.0,1,1,2,4,7,0xb2d86373
50015.9,2.0,140,2,3,1,6,0xb2d6dd6a
450138.42,2.0,10,4,3,3,10,0xb2d0b9e6
2000122.59,6.0,5,4,4,3,11,0xb2d111bc
503204.28,2.0,10,4,3,3,10,0xb2d9e7a9
2894.2,1.0,0,2,2,4,8,0xb2d6aaf3
1156.83,1.0,0,1,2,4,7,0xb2d2b7a7
30000.79,2.0,41,2,3,2,7,0xb2d6add6
160825.51,3.0,0,3,4,4,11,0xb2d50426
3797.73,1.0,184,2,2,1,5,0xb2d2b300
492655.67,3.0,13,4,4,3,11,0xb2d3d4f4
901281.55,3.0,52,4,4,2,10,0xb2d6470d
12.11,5.0,27,1,4,2,7,0xb2d10c34
350000.94,2.0,22,4,3,2,9,0xb2d90df7
6792.29,1.0,34,2,2,2,6,0xb2d8239c
1712.15,1.0,2,1,2,4,7,0xb2d6c01c
9778.8,1.0,24,2,2,2,6,0xb2d188af
92047.65,9.0,9,3,4,3,10,0xb2d12592
456458.42,3.0,18,4,4,2,10,0xb2d2c779
19000.21,2.0,18,2,3,2,7,0xb2d9400a
350737.67,3.0,11,4,4,3,11,0xb2d292c9
400052.73,6.0,92,4,4,1,9,0xb2d1a0b1
10662.28,1.0,5,2,2,3,7,0xb2d788ed
218084.49,2.0,122,3,3,1,7,0xb2d365ab
371500.0,1.0,5,4,2,3,9,0xb2da5b4d
26.83,1.0,55,1,2,2,5,0xb2d5ce64
661811.96,5.0,5,4,4,3,11,0xb2d17536
504.14,1.0,9,1,2,3,6,0xb2d6b89e
446854.61,1.0,26,4,2,2,8,0x3b9b2c5e
405938.11,3.0,34,4,4,2,10,0xb2d61e82
4.19,1.0,184,1,2,1,4,0xb2d191bf
90003.17,7.0,6,3,4,3,10,0xb2d8c59b
15990.92,1.0,21,2,2,2,6,0xb2d96572
95.9,1.0,21,1,2,2,5,0xb2d6dcf4
141508.49,3.0,39,3,4,2,9,0xb2d574ae
0.43,1.0,82,1,2,1,4,0xb2d8caa9
82255.52,4.0,0,3,4,4,11,0xb2d4b96e
7.16,1.0,62,1,2,2,5,0xb2d200e5
1.39,1.0,20,1,2,2,5,0xb2d8ee09
1965.35,1.0,184,1,2,1,4,0xb2d31003
650020.58,2.0,80,4,3,1,8,0xb2d8c9b5
2071.43,1.0,5,1,2,3,6,0xb2d33839
2.36,1.0,11,1,2,3,6,0xb2d31bf1
12317.85,1.0,24,2,2,2,6,0xb2d5cf96
2095.37,1.0,92,1,2,1,4,0xb2d0e183
34911.41,1.0,1,2,2,4,8,0xb2d655b8
301095.65,2.0,19,4,3,2,9,0xb2d6a2d5
50012.9,2.0,175,2,3,1,6,0xb2d12574
715.73,1.0,75,1,2,1,4,0xb2d6a09e
204120.87,3.0,0,3,4,4,11,0xb2d629be
262.85,1.0,0,1,2,4,7,0xb2d21570
40734.47,2.0,29,2,3,2,7,0xb2d297f7
20289.81,2.0,191,2,3,1,6,0xb2d772e8
1026.48,1.0,92,1,2,1,4,0xb2d26edd
246978.18,5.0,27,3,4,2,9,0xb2d3f703
124390.9,2.0,3,3,3,4,10,0xb2d533c3
600076.74,3.0,83,4,4,1,9,0xb2d61c43
100467.29,2.0,18,3,3,2,8,0xb2d9a63b
345.42,2.0,15,1,3,3,7,0xb2d49f9e
9.33,1.0,71,1,2,1,4,0xb2d643e0
100062.07,2.0,13,3,3,3,9,0xb2d5e037
1637.26,1.0,9,1,2,3,6,0xb2d6cf3f
17082.82,1.0,5,2,2,3,7,0xb2d1c022
3681.82,3.0,8,2,4,3,9,0x3b9b25d9
1800004.22,4.0,0,4,4,4,12,0xb2da43c3
100078.82,3.0,123,3,4,1,8,0xb2d06fcdd
844.52,1.0,24,1,2,2,5,0xb2d30817
5.91,1.0,15,1,2,3,6,0xb2d78f1d
92.28,1.0,55,1,2,2,5,0xb2d8d6c7
2795.62,1.0,9,1,2,3,6,0xb2d390b6
3.17,1.0,48,1,2,2,5,0xb2d91260
5690.32,1.0,15,2,2,3,7,0xb2d6e804
145.25,1.0,17,1,2,2,5,0xb2d56fd4
132725.06,1.0,11,3,2,3,8,0xb2d53d8a
0.0,1.0,0,1,2,4,7,0xb2d3ac39
1907.49,1.0,92,1,2,1,4,0xb2d4408c
200284.2,2.0,60,3,3,2,8,0xb2d129bf
251757.1,2.0,95,3,3,1,7,0xb2d5a581
675.52,4.0,1,1,4,4,9,0x3b9b46c7
250000.51,3.0,100,3,4,1,8,0xb2d56888d
906.96,1.0,53,1,2,2,5,0xb2d9c2b7
393909.52,4.0,4,4,4,4,12,0xb2d41963
3068.18,1.0,42,2,2,2,6,0xb2d23935
39.43,1.0,15,1,2,3,6,0xb2d609b0
4871.42,1.0,194,2,2,1,5,0xb2d1b157
102719.4,3.0,97,3,4,1,8,0xb2d6f698
0.0,1.0,7,1,2,3,6,0xb2d0aca1
15586.65,1.0,4,2,2,4,8,0xb2d995ec
8081.16,1.0,0,2,2,4,8,0xb2d55d7e
487241.74,11.0,1,4,4,4,12,0xb2d0f774
600000.7,2.0,20,4,3,2,9,0xb2d78bff
70205.33,6.0,27,3,4,2,9,0xb2d7c756
108968.35,6.0,0,3,4,4,11,0xb2d0d5be
1503.51,1.0,9,1,2,3,6,0xb2d463ed
48072.39,3.0,83,2,4,1,7,0xb2d06915
1002042.35,2.0,182,4,3,1,8,0xb2d2803e
372171.54,4.0,10,4,4,3,11,0xb2d4f186
41167.26,1.0,13,2,2,3,7,0xb2d3a19c
14.62,1.0,7,1,2,3,6,0xb2d29d7d
406456.2,7.0,0,4,4,4,12,0xb2d281ab
500000.0,3.0,4,4,4,4,12,0xb2d8d069
50.74,1.0,3,1,2,4,7,0xb2d0f512
120002.53,2.0,92,3,3,1,7,0xb2d65b72
334066.4,2.0,23,4,3,2,9,0xb2d5fba8d
116.94,1.0,6,1,2,3,6,0xb2d32e37
371.33,1.0,22,1,2,2,5,0xb2d20dea
556072.68,13.0,4,4,4,4,12,0xb2d956b9
3845.01,1.0,68,2,2,1,5,0xb2d3f33f
185.16,1.0,8,1,2,3,6,0xb2d21895
100387.47,2.0,15,3,3,3,9,0xb2d42d60
0.0,1.0,1,1,2,4,7,0xb2d47932
530001.73,3.0,27,4,4,2,10,0xb2d21172
107306.45,2.0,0,3,3,4,10,0xb2d60085
414539.06,2.0,95,4,3,1,8,0xb2d62108
1.92,2.0,31,1,3,2,6,0xb2d24992
1509.54,1.0,92,1,2,1,4,0xb2d63624
171920.79,3.0,17,3,4,2,9,0xb2d65a50
213515.09,2.0,76,3,3,1,7,0xb2d3c4b0
1003.31,1.0,131,1,2,1,4,0xb2d6e3be
31.99,1.0,62,1,2,2,5,0xb2d620e8
1291.17,1.0,20,1,2,2,5,0xb2d2bb1c
476.9,2.0,5,1,3,3,7,0xb2d94776
403.79,1.0,70,1,2,1,4,0xb2d6ad56
400052.81,2.0,12,4,3,3,10,0xb2d698b3
400038.84,5.0,0,4,4,4,12,0xb2d2a2a0
269053.56,2.0,8,3,3,3,9,0xb2d62324
5524.2,1.0,17,2,2,2,6,0xb2d62646
207.89,1.0,8,1,2,3,6,0xb2d912ef
2533.69,1.0,92,1,2,1,4,0xb2d132b4
9241.35,1.0,0,2,2,4,8,0xb2d261b2
1538.49,1.0,184,1,2,1,4,0xb2d418ce
890600.0,7.0,0,4,4,4,12,0x3b9b17f6
50000.0,1.0,1,2,2,4,8,0xb2da668f
30048.18,1.0,4,2,2,4,8,0xb2d4254a
0.0,1.0,1,1,2,4,7,0xb2d4f62b
15131.93,3.0,0,2,4,4,10,0xb2d09c8a
191012.59,8.0,69,3,4,1,8,0xb2d5ea5a
6116.59,1.0,92,2,2,1,5,0xb2d6be73
493.75,1.0,75,1,2,1,4,0xb2d21988
320011.23,2.0,16,4,3,2,9,0xb2da0065
34039.79,2.0,38,2,3,2,7,0xb2d66a12
0.78,1.0,4,1,2,4,7,0xb2d64582
70462.95,1.0,7,3,2,3,8,0xb2d35398d
1621879.69,14.0,5,4,4,3,11,0x3b9b2b7d
1433.33,1.0,9,1,2,3,6,0xb2d7fc65
4235.57,1.0,92,2,2,1,5,0xb2d311e5
332114.53,3.0,130,4,4,1,9,0xb2d5ede6
1746.79,1.0,146,1,2,1,4,0xb2d626ca
1015.48,1.0,184,1,2,1,4,0xb2d105c1
321824.68,3.0,29,4,4,2,10,0xb2d24333
274065.8,4.0,123,3,4,1,8,0xb2d610c7
530.98,1.0,67,1,2,1,4,0xb2d5679a
60002.53,2.0,27,3,3,2,8,0xb2d93bcb
150001.58,2.0,18,3,3,2,8,0xb2da2fe9
1259.02,1.0,92,1,2,1,4,0xb2d22501
1028549.52,4.0,0,4,4,4,12,0xb2d48fcd
16734.37,1.0,8,2,2,3,7,0xb2d6dea5
5097.8,3.0,118,2,4,1,7,0xb2d43179
200020.8,2.0,18,3,3,2,8,0xb2d4cdba
317526.94,1.0,184,4,2,1,7,0xb2d3c76c
2.18,5.0,26,1,4,2,7,0xb2d19731
300893.49,3.0,0,4,4,4,12,0xb2d39f98
8432.06,1.0,21,2,2,2,6,0xb2d6d270
707.52,1.0,9,1,2,3,6,0xb2d6ebc9
250989.36,2.0,0,3,3,4,10,0xb2d5981f
80837.55,3.0,4,3,4,4,11,0xb2d959a3
51227.21,1.0,92,2,2,1,5,0xb2d2fb1f
13312.05,1.0,0,2,2,4,8,0xb2d548af
2607.9,1.0,0,1,2,4,7,0xb2d88bff
742250.29,4.0,0,4,4,4,12,0xb2d23d6d
572.1,1.0,0,1,2,4,7,0xb2d781b8
207001.54,4.0,29,3,4,2,9,0xb2d58b89
17872.47,1.0,10,2,2,3,7,0xb2d86e17
153073.18,4.0,14,3,4,3,10,0xb2d5e53d
3908.89,1.0,6,2,2,3,7,0xb2d945cb
886134.67,2.0,92,4,3,1,8,0xb2d20614
110026.55,3.0,70,3,4,1,8,0xb2d22d3e
72127.28,3.0,19,3,4,2,9,0xb2d4d40c
1951218.73,7.0,0,4,4,4,12,0xb2d0dfb6
670000.0,9.0,4,4,4,4,12,0xb2d24b09
409184.7,3.0,128,4,4,1,9,0xb2d5ee21
62723.35,5.0,4,3,4,4,11,0xb2d5141a
53042.5,2.0,0,3,3,4,10,0xb2d910d3d
7.96,1.0,18,1,2,2,5,0xb2d54dfc
25.51,1.0,0,1,2,4,7,0xb2d2502d
52.62,2.0,53,1,3,2,6,0xb2d0649f
417873.65,7.0,3,4,4,4,12,0xb2d30414
17.58,1.0,4,1,2,4,7,0xb2d390dd
2005.93,1.0,291,1,2,1,4,0xb2d69c2f
811.71,1.0,0,1,2,4,7,0xb2d0b7e0
528.59,1.0,0,1,2,4,7,0xb2d68e89
463726.1,4.0,66,4,4,2,10,0xb2d21bdf
600000.0,3.0,4,4,4,4,12,0xb2da610e
300001.06,3.0,18,3,4,2,9,0xb2d5d807
318052.23,5.0,49,4,4,2,10,0x3b9b32cf
100047.89,2.0,43,3,3,2,8,0xb2d90cdf
4775.51,1.0,19,2,2,2,6,0xb2d900f4
3.97,1.0,6,1,2,3,6,0xb2d8c628
1203721.23,4.0,1,4,4,4,12,0xb2d5005f
659.23,1.0,1,1,2,4,7,0xb2d964e2
1123725.92,9.0,3,4,4,4,12,0xb2d48b5ed
544.65,1.0,3,1,2,4,7,0xb2d60ec6
2472.04,1.0,184,1,2,1,4,0xb2d2fc1a
12.42,1.0,0,1,2,4,7,0xb2d5f0c3
4333.47,5.0,102,2,4,1,7,0x3b9b3e5d
1268.36,1.0,17,1,2,2,5,0xb2d2cd96
1339.65,1.0,184,1,2,1,4,0xb2d42db8
43097.35,1.0,10,2,2,3,7,0xb2d29243
24305.96,3.0,137,2,4,1,7,0xb2d0958d
1584.48,1.0,0,1,2,4,7,0xb2d4e014
32084.23,4.0,1,2,4,4,10,0xb2d2bd9e
394833.04,2.0,92,4,3,1,8,0xb2d44d77
426073.43,4.0,13,4,4,3,11,0xb2d1b16a
287524.57,7.0,90,3,4,1,8,0xb2d06a3d
55873.25,1.0,3,3,2,4,9,0xb2d25f21
1016.87,1.0,184,1,2,1,4,0xb2d0dd40
702486.46,2.0,33,4,3,2,9,0xb2d938d8
588388.83,1.0,9,4,2,3,9,0xb2d4ea5a
816154.3,2.0,19,4,3,2,9,0xb2d8da93
13.88,1.0,46,1,2,2,5,0xb2d1bdbb
17337.91,1.0,25,2,2,2,6,0xb2d6c2c4
200050.3,3.0,154,3,4,1,8,0xb2d6a88b
109144.76,1.0,4,3,2,4,9,0xb2d58708
10591.39,2.0,92,2,3,1,6,0xb2d290ea
139.46,1.0,5,1,2,3,6,0xb2d593bd
30000003.0,2.0,184,4,3,1,8,0xb2d55225
9.93,1.0,25,1,2,2,5,0xb2d6d764
281003.01,8.0,1,3,4,4,11,0xb2d74b22
200001.9,3.0,5,3,4,3,10,0xb2d96b57
6064.27,1.0,184,2,2,1,5,0xb2d29065
163.45,1.0,27,1,2,2,5,0xb2d6e7ae
200000.0,3.0,4,3,4,4,11,0xb2d230ae
20001.84,2.0,28,2,3,2,7,0xb2da0664
5953.37,1.0,0,2,2,4,8,0xb2d53a2b
118153.61,4.0,47,3,4,2,9,0xb2d3e4e3
1020.68,1.0,53,1,2,2,5,0xb2d6d1f3
664.4,1.0,8,1,2,3,6,0xb2d340fd
1780000.0,6.0,4,4,4,4,12,0xb2d59497
1059009.34,18.0,25,4,4,2,10,0xb2d17962
0.15,1.0,1,1,2,4,7,0xb2d9166c
40226.26,3.0,27,2,4,2,8,0xb2d71a78
102007.63,2.0,80,3,3,1,7,0xb2d2ec88
350882.33,2.0,122,4,3,1,8,0xb2d3bf36
680009.43,6.0,1,4,4,4,12,0xb2d245f2
5.58,1.0,92,1,2,1,4,0xb2d3992f
253029.3,2.0,52,3,3,2,8,0xb2d6d70f
60072.84,1.0,0,3,2,4,9,0xb2da67f0
460001.75,4.0,21,4,4,2,10,0xb2d2ea35
50.99,1.0,20,1,2,2,5,0xb2d93f02
200117.01,2.0,69,3,3,1,7,0xb2d8ffa4
204275.07,2.0,19,3,3,2,8,0xb2d17e1a
25.16,1.0,0,1,2,4,7,0xb2d1e840
161835.1,3.0,27,3,4,2,9,0xb2d28464
798.55,1.0,16,1,2,2,5,0xb2d5ec00
90188.64,2.0,7,3,3,3,9,0xb2d8f9d1
20000.63,2.0,98,2,3,1,6,0xb2d96d97
169665.03,4.0,77,3,4,1,8,0xb2d20ec6
50311.73,2.0,56,2,3,2,7,0xb2d660a7
260025.22,5.0,132,3,4,1,8,0xb2d2d21c
53039.93,2.0,0,3,3,4,10,0xb2d267b2
378021.07,6.0,4,4,4,4,12,0xb2d31a0e
350063.33,7.0,12,4,4,3,11,0xb2d5e230
21557.19,1.0,3,2,2,4,8,0xb2d6b69e
809.7,1.0,0,1,2,4,7,0xb2d96727
103104.32,4.0,41,3,4,2,9,0xb2d6222d
41775.24,2.0,162,2,3,1,6,0xb2d4db32
50001.06,2.0,14,2,3,3,8,0xb2da2cbf
35061.2,1.0,0,2,2,4,8,0xb2d3ee7d
1004960.61,5.0,27,4,4,2,10,0xb2d78b82
72815.6,4.0,56,3,4,2,9,0xb2d22ba4
150004.85,4.0,42,3,4,2,9,0xb2d9861f
3346070.55,10.0,5,4,4,3,11,0x3b9b2d30
700.28,1.0,13,1,2,3,6,0xb2d233a0
1058.53,1.0,0,1,2,4,7,0xb2d6c828
0.0,1.0,3,1,2,4,7,0xb2d3b95d
700011.18,12.0,27,4,4,2,10,0xb2d6e0ec
5281.78,1.0,92,2,2,1,5,0xb2d3c071
14030.04,2.0,11,2,3,3,8,0xb2d6e1b2
1280.27,1.0,92,1,2,1,4,0xb2d17ed5
356233.13,5.0,4,4,4,4,12,0xb2d6b20d
354506.51,4.0,13,4,4,3,11,0xb2d1bdaf
335098.77,2.0,31,4,3,2,9,0xb2d0b708
30594.71,1.0,2,2,2,4,8,0xb2d2452f
17007.17,2.0,98,2,3,1,6,0xb2d20a6d
5584.08,1.0,8,2,2,3,7,0xb2d577cd
170023.83,2.0,235,3,3,1,7,0xb2d4c092
13978.97,1.0,33,2,2,2,6,0xb2d57d05
937.97,1.0,0,1,2,4,7,0xb2d912f9
3190000.0,17.0,2,4,4,4,12,0xb2d0e682
101.27,1.0,0,1,2,4,7,0xb2d1e7e7
507107.17,2.0,33,4,3,2,9,0xb2d76480
471690.59,3.0,56,4,4,2,10,0xb2d78312
3256.21,1.0,184,2,2,1,5,0xb2d18abc
5145.08,1.0,25,2,2,2,6,0xb2d2b6be
58.34,1.0,40,1,2,2,5,0xb2d06efe
900456.87,3.0,7,4,4,3,11,0xb2d1534e
10.1,1.0,28,1,2,2,5,0xb2d3bead
10.55,1.0,98,1,2,1,4,0xb2d969a8
654900.24,4.0,1,4,4,4,12,0xb2d0f905
682445.96,7.0,0,4,4,4,12,0xb2d16c2c
311115.65,3.0,27,4,4,2,10,0xb2d0f999
200000.0,1.0,0,3,2,4,9,0xb2da6c1b
1895.11,1.0,10,1,2,3,6,0xb2d57aff
501776.34,2.0,40,4,3,2,9,0xb2d67f3f
200047.61,2.0,18,3,3,2,8,0xb2d12e0d
40669.91,14.0,0,2,4,4,10,0x3b9b4638
109964.88,1.0,0,3,2,4,9,0xb2d4be77
30005.28,3.0,185,2,4,1,7,0xb2d5e404
5364.26,2.0,22,2,3,2,7,0xb2d31651
6694.87,1.0,18,2,2,2,6,0xb2d3984d
21191.54,1.0,92,2,2,1,5,0xb2d2f764
5.28,1.0,88,1,2,1,4,0xb2d6bada
120734.6,3.0,66,3,4,2,9,0xb2d5db4a
550105.48,10.0,2,4,4,4,12,0xb2d3625b
97237.34,1.0,14,3,2,3,8,0xb2d3921f
250797.68,5.0,0,3,4,4,11,0xb2d41e2b
5275.47,1.0,0,2,2,4,8,0xb2d3ed2a
950040.11,2.0,45,4,3,2,9,0xb2d91489
600000.0,3.0,7,4,4,3,11,0xb2da51bc
4789.03,1.0,90,2,2,1,5,0xb2d41e80
58739.22,5.0,0,3,4,4,11,0x3b9b4269
279.39,1.0,5,1,2,3,6,0xb2d4f740
90847.26,9.0,8,3,4,3,10,0xb2d6a9ee
105743.74,1.0,49,3,2,2,7,0xb2d3904e
753385.37,4.0,36,4,4,2,10,0xb2d97b15
559078.62,2.0,181,4,3,1,8,0xb2d181fa
16380.88,1.0,3,2,2,4,8,0xb2d3743e
0.0,1.0,5,1,2,3,6,0xb2d236b5
1292251.84,10.0,6,4,4,3,11,0xb2d50007
780077.83,7.0,95,4,4,1,9,0xb2d1a082
535094.95,4.0,1,4,4,4,12,0xb2d49be5
782002.48,7.0,20,4,4,2,10,0xb2d60eca
551983.31,2.0,5,4,3,3,10,0xb2d46e67
1190217.21,6.0,0,4,4,4,12,0xb2d3474e
406356.85,2.0,1,4,3,4,11,0xb2d69411
400000.0,3.0,5,4,4,3,11,0xb2d96b84
256560.72,3.0,4,3,4,4,11,0xb2d60f3a
7732.62,1.0,15,2,2,3,7,0xb2d93ee8
750048.94,6.0,0,4,4,4,12,0xb2d503ae
580864.76,1.0,92,4,2,1,7,0xb2d313fc
437.57,1.0,13,1,2,3,6,0xb2d59337
620060.16,6.0,17,4,4,2,10,0xb2d41029
49935.15,2.0,3,2,3,4,9,0xb2d7b017
830.93,2.0,0,1,3,4,8,0xb2d6a10c
480715.15,5.0,60,4,4,2,10,0xb2d57072
103047.11,4.0,0,3,4,4,11,0xb2d0f495
128707.53,1.0,31,3,2,2,7,0xb2d5e861
3628943.81,1.0,184,4,2,1,7,0xb2d100c6
103.58,1.0,60,1,2,2,5,0xb2d9aa02
640001.43,3.0,0,4,4,4,12,0xb2d94b33
450023.76,2.0,12,4,3,3,10,0xb2d42442
2079.96,1.0,5,1,2,3,6,0xb2d34542
605000.03,4.0,0,4,4,4,12,0xb2d120f3
781455.0,5.0,0,4,4,4,12,0xb2d5315d
14451.68,1.0,9,2,2,3,7,0xb2d3b411
1889.8,1.0,25,1,2,2,5,0xb2d390b0
685.78,1.0,20,1,2,2,5,0xb2d2f18b
430000.0,2.0,27,4,3,2,9,0xb2d2a9f2
753348.63,6.0,0,4,4,4,12,0xb2d34cf7
236055.46,4.0,18,3,4,2,9,0xb2d6048b
3442.46,1.0,92,2,2,1,5,0x3b9b4227
12481.72,1.0,6,2,2,3,7,0xb2d79055
1492.92,1.0,184,1,2,1,4,0x3b9b3840
670094.17,6.0,3,4,4,4,12,0xb2d0aa65
201670.31,2.0,0,3,3,4,10,0xb2d65570
5126.07,1.0,8,2,2,3,7,0xb2d40604
100182.98,1.0,14,3,2,3,8,0xb2d6b192
10.51,1.0,21,1,2,2,5,0xb2da1b86
269338.01,2.0,30,3,3,2,8,0xb2d3668f
2.17,1.0,77,1,2,1,4,0xb2d8691b
10074.1,1.0,286,2,2,1,5,0xb2d1040e
15000.0,2.0,92,2,3,1,6,0xb2d5f976
100001.06,2.0,62,3,3,2,8,0xb2d8ea25
833754.94,6.0,33,4,4,2,10,0xb2d4969c
1229580.88,7.0,0,4,4,4,12,0xb2d283ea
2.17,1.0,81,1,2,1,4,0xb2d78825
3444.98,1.0,184,2,2,1,5,0xb2d3b7bf
300006.25,3.0,7,3,4,3,10,0xb2d62865d
6000.48,1.0,0,2,2,4,8,0xb2d6bb5d
20000.33,3.0,45,2,4,2,8,0xb2d57c57
1013.75,1.0,184,1,2,1,4,0xb2d34575
757.39,1.0,0,1,2,4,7,0xb2d5c598
251119.89,4.0,25,3,4,2,9,0xb2d3a94d
8120.08,1.0,210,2,2,1,5,0xb2d4543f
218.68,1.0,13,1,2,3,6,0xb2d31e7c
1735.92,2.0,9,1,3,3,7,0xb2d21c41
10121.44,2.0,52,2,3,2,7,0xb2d6d2ae
1404293.35,23.0,0,4,4,4,12,0x3b9b0e1f
10737.6,1.0,10,2,2,3,7,0xb2d1a77b
406684.18,7.0,0,4,4,4,12,0x3b9b3c59
200817.86,1.0,23,3,2,2,7,0xb2d2d39e
201556.22,2.0,60,3,3,2,8,0xb2d8f761
642.32,1.0,10,1,2,3,6,0xb2d3941d
1280187.34,6.0,2,4,4,4,12,0xb2d59463
48617.49,2.0,20,2,3,2,7,0xb2d62943
194439.24,3.0,97,3,4,1,8,0xb2d1d99f
350000.22,7.0,0,4,4,4,12,0xb2d153f4
50053.81,2.0,105,2,3,1,6,0xb2d5726d
1870441.84,9.0,1,4,4,4,12,0xb2d1f508
40339.04,2.0,7,2,3,3,8,0xb2d58237
99.23,1.0,37,1,2,2,5,0xb2d9c79c
120363.11,6.0,0,3,4,4,11,0x3b9ae040
131.54,1.0,8,1,2,3,6,0xb2d8c656
81.03,1.0,21,1,2,2,5,0xb2d57bb1
168.41,1.0,0,1,2,4,7,0xb2d29f44
348017.15,9.0,55,4,4,2,10,0xb2d0eb04
1506.63,1.0,9,1,2,3,6,0xb2d4186c
5842.57,1.0,92,2,2,1,5,0xb2d300f2
190103.23,3.0,126,3,4,1,8,0xb2d24a73
949.24,1.0,2,1,2,4,7,0xb2d53e47
700002.11,5.0,4,4,4,4,12,0xb2da4714
24865.77,2.0,0,2,3,4,9,0xb2d53786
0.14,1.0,81,1,2,1,4,0xb2d635a0
2114.55,6.0,0,1,4,4,9,0xb2d098e0
960060.95,5.0,1,4,4,4,12,0xb2d34190
410087.85,6.0,60,4,4,2,10,0xb2d445a5
3600.66,1.0,0,2,2,4,8,0xb2d3c879
15.25,1.0,112,1,2,1,4,0xb2d57e42d
66702.93,1.0,9,3,2,3,8,0xb2d307fb
3720039.31,2.0,119,4,3,1,8,0xb2d94127
369.99,1.0,0,1,2,4,7,0xb2d3f2c0
300003.17,2.0,20,3,3,2,8,0xb2d950c7
127051.62,2.0,10,3,3,3,9,0xb2d946d5
301931.89,4.0,62,4,4,2,10,0xb2d60e95
51007.97,2.0,77,2,3,1,6,0xb2d958e9
213967.8,4.0,0,3,4,4,11,0xb2d6877b
3130.67,1.0,92,2,2,1,5,0xb2d3263f
163895.27,1.0,92,3,2,1,6,0xb2d0c62a
700007.39,2.0,18,4,3,2,9,0xb2d957e5
1023.14,1.0,184,1,2,1,4,0xb2d1b647
1300.8,1.0,33,1,2,2,5,0xb2d76a31
400773.09,3.0,21,4,4,2,10,0xb2d92e83
532069.92,1.0,1,4,2,4,10,0xb2d69f3d
295.03,1.0,20,1,2,2,5,0xb2d9843f
124879.63,4.0,27,3,4,2,9,0xb2d2e675
79633.64,2.0,91,3,3,1,7,0xb2d5b449
400008.44,2.0,60,4,3,2,9,0xb2d9b60d
776.69,1.0,6,1,2,3,6,0xb2d30c7a
19380.88,1.0,0,2,2,4,8,0xb2d68b1e
50001.58,2.0,136,2,3,1,6,0xb2d6f2be
1951.59,1.0,15,1,2,3,6,0xb2d60b42
8003.97,1.0,56,2,2,2,6,0xb2d8d5a7
102515.42,1.0,2,3,2,4,9,0xb2d3f63d
50000.53,2.0,32,2,3,2,7,0xb2da055d
200002.11,2.0,21,3,3,2,8,0xb2da221c
236584.43,2.0,211,3,3,1,7,0xb2d56152
17036.56,1.0,55,2,2,2,6,0xb2d279b8
1535.79,1.0,213,1,2,1,4,0xb2d43dcc
1470310.91,4.0,8,4,4,3,11,0xb2d1117e
124813.02,2.0,8,3,3,3,9,0xb2d5dccc
16000.17,2.0,41,2,3,2,7,0xb2d9236d
14189.71,1.0,14,2,2,3,7,0xb2d6edf2
519012.49,4.0,67,4,4,1,9,0xb2d24e91
936.98,1.0,34,1,2,2,5,0xb2d58122
207125.56,6.0,35,3,4,2,9,0xb2d64b60
30098.41,2.0,95,2,3,1,6,0xb2d970e5
1052.92,1.0,2,1,2,4,7,0xb2d1e620
111389.2,2.0,3,3,3,4,10,0xb2d36138
27449.39,1.0,10,2,2,3,7,0xb2d3bc81
500711.05,3.0,13,4,4,3,11,0xb2d6dd35
878336.92,4.0,0,4,4,4,12,0xb2d3b631
2.23,1.0,19,1,2,2,5,0xb2d40e0f
8074.23,1.0,2,2,2,4,8,0xb2d6f63a
70196.53,5.0,252,3,4,1,8,0xb2d2ecfa
200102.33,2.0,143,3,3,1,7,0xb2d615aa
460002.0,2.0,21,4,3,2,9,0xb2d954d1
221000.02,3.0,5,3,4,3,10,0xb2d12441
23757.68,1.0,10,2,2,3,7,0xb2d68fca
80075.03,2.0,3,3,3,4,10,0xb2d189cf
116.07,1.0,9,1,2,3,6,0xb2d36d4c
706.6,1.0,6,1,2,3,6,0xb2d371fd
311428.79,2.0,6,4,3,3,10,0xb2d274ff
25017.37,1.0,30,2,2,2,6,0xb2d97461
2395.85,1.0,103,1,2,1,4,0xb2d55166
598.71,1.0,9,1,2,3,6,0xb2d471a4
3000.97,3.0,0,2,4,4,10,0xb2d17dc8
50695.35,2.0,6,2,3,3,8,0xb2d68ae4
59893.72,1.0,92,3,2,1,6,0xb2d18d9f
1573.98,7.0,0,1,4,4,9,0xb2d256b3
6068.75,1.0,2,2,2,4,8,0xb2d2a1f0
1019696.19,4.0,18,4,4,2,10,0xb2d38744
1049.54,6.0,18,1,4,2,7,0xb2d21630
947.6,1.0,0,1,2,4,7,0xb2d69c73
503554.32,2.0,55,4,3,2,9,0xb2d91d0c
23570.27,1.0,92,2,2,1,5,0xb2d61382
996.26,4.0,92,1,4,1,6,0x3b9ade68
6236.61,1.0,184,2,2,1,5,0xb2d36cfd
430809.63,6.0,208,4,4,1,9,0xb2d643db
210224.23,3.0,4,3,4,4,11,0xb2d6155c
3266.93,1.0,184,2,2,1,5,0xb2d3e6db
1967.41,1.0,82,1,2,1,4,0xb2d6ad14
14319.04,1.0,2,2,2,4,8,0xb2d2e26cd
202633.63,2.0,36,3,3,2,8,0xb2d3c051
1099.54,1.0,4,1,2,4,7,0xb2d5ad6bd
278465.22,3.0,6,3,4,3,10,0xb2d1987a
26744.43,1.0,5,2,2,3,7,0xb2d6bf67
453417.56,3.0,28,4,4,2,10,0xb2d6d920
1220127.18,7.0,11,4,4,3,11,0xb2d15459
3178.84,1.0,92,2,2,1,5,0xb2d285d5
750106.97,2.0,49,4,3,2,9,0xb2d14f8f
962.8,5.0,0,1,4,4,9,0x3b9b4602
219644.32,2.0,82,3,3,1,7,0xb2d10589
150630.69,4.0,6,3,4,3,10,0xb2d4f935
52230.35,2.0,6,3,3,3,9,0xb2d176ac
460023.78,3.0,1,4,4,4,12,0xb2d1b5e2
2683.3,1.0,9,1,2,3,6,0xb2d7169d
107983.15,1.0,19,3,2,2,7,0xb2d4a98f
1637760.0,12.0,4,4,4,4,12,0xb2d20b11
430000.01,3.0,14,4,4,3,11,0xb2d90147
7.54,1.0,27,1,2,2,5,0xb2d67d8b
150026.04,3.0,63,3,4,2,9,0xb2d2cc04
14793.43,1.0,19,2,2,2,6,0xb2d2d62e
0.97,1.0,3,1,2,4,7,0xb2d94bd3
100955.36,2.0,76,3,3,1,7,0xb2d086b6
9032.2,5.0,0,2,4,4,10,0xb2d6b2c1
11510.55,2.0,1,2,3,4,9,0xb2d68201
172.9,1.0,60,1,2,2,5,0xb2d3dc0d
200053.35,2.0,6,3,3,3,9,0xb2d6150d
1000000.0,2.0,193,4,3,1,8,0xb2d07bb2
696.58,1.0,116,1,2,1,4,0xb2d5912c
200000.84,2.0,14,3,3,3,9,0xb2da391d
2248.3,1.0,186,1,2,1,4,0xb2d36a4c
50005.94,2.0,4,2,3,4,9,0xb2d9a2b1
2340.62,2.0,184,1,3,1,5,0xb2d3bc03
25717.0,2.0,18,2,3,2,7,0xb2d2435a
162628.83,3.0,3,3,4,4,11,0xb2d63aa6
4750050.14,4.0,10,4,4,3,11,0xb2d8f5b5
599.82,3.0,0,1,4,4,9,0xb2d2afa5
820274.88,6.0,6,4,4,3,11,0xb2d35605
20090.96,2.0,2,2,3,4,9,0xb2d49698
561880.92,4.0,32,4,4,2,10,0xb2d6043d
5136.18,2.0,92,2,3,1,6,0xb2d1b0c2
331080.85,6.0,4,4,4,4,12,0xb2d4b2c7
102801.07,3.0,1,3,4,4,11,0xb2d59f15
844321.56,5.0,73,4,4,1,9,0xb2d56491
7415.2,1.0,0,2,2,4,8,0xb2d52535
19.0,1.0,28,1,2,2,5,0xb2d65ebc
2963.25,1.0,49,2,2,2,6,0xb2d3e48d
458.76,1.0,10,1,2,3,6,0xb2d6df6d
1004170.57,4.0,2,4,4,4,12,0xb2d439fc
1391.7,1.0,0,1,2,4,7,0xb2d9366f
5671.59,2.0,15,2,3,3,8,0xb2d5e0be
532922.44,10.0,0,4,4,4,12,0xb2d55258
845052.37,10.0,9,4,4,3,11,0x3b9b3097
3503.03,1.0,92,2,2,1,5,0xb2d984b8
70296.03,1.0,176,3,2,1,6,0xb2d5f6ee
500021.11,2.0,11,4,3,3,10,0xb2da3a5c
32.06,1.0,6,1,2,3,6,0xb2d51f65
1217.94,1.0,26,1,2,2,5,0xb2d74b01
984.2,1.0,17,1,2,2,5,0xb2d335d1
521490.2,4.0,29,4,4,2,10,0xb2d6aee4
800034.87,5.0,7,4,4,3,11,0xb2d60960
101970.29,4.0,0,3,4,4,11,0xb2da0304
206695.4,3.0,0,3,4,4,11,0xb2d1b49f
10.97,1.0,24,1,2,2,5,0xb2d6e531
155109.23,3.0,13,3,4,3,10,0xb2d2a698
308702.69,2.0,3,4,3,4,11,0xb2d64f84
54.65,1.0,43,1,2,2,5,0xb2d42461
1272.84,1.0,92,1,2,1,4,0xb2d273e2
48377.51,1.0,0,2,2,4,8,0xb2d26787
1453.92,1.0,97,1,2,1,4,0xb2d64d0d
8885622.33,1.0,1,4,2,4,10,0xb2d34615
301012.24,3.0,179,4,4,1,9,0x3b9b3c5c
17856.19,1.0,0,2,2,4,8,0xb2d91e96
20000.21,2.0,181,2,3,1,6,0xb2d6b30d
2192.47,1.0,7,1,2,3,6,0xb2d29a09
410000.0,3.0,0,4,4,4,12,0xb2d9446b
3284.96,1.0,1,2,2,4,8,0xb2d69d02
6400.95,1.0,184,2,2,1,5,0xb2d0ee9b
1066.45,1.0,184,1,2,1,4,0xb2d1a069
50560.36,2.0,38,2,3,2,7,0xb2d6ef13
4921125.89,7.0,44,4,4,2,10,0xb2d61a4e
301331.92,4.0,5,4,4,3,11,0xb2d07497
50000.53,2.0,13,2,3,3,8,0xb2d95d38
39966.81,1.0,0,2,2,4,8,0xb2d31f11
953.59,1.0,15,1,2,3,6,0xb2d20a0a
30559.44,1.0,28,2,2,2,6,0xb2d87d2c
350002.11,3.0,8,4,4,3,11,0xb2d8dda1
70639.84,3.0,0,3,4,4,11,0xb2d437eb
120205.08,3.0,21,3,4,2,9,0xb2d400c5
23098.49,1.0,2,2,2,4,8,0xb2da4486
130293.4,2.0,0,3,3,4,10,0xb2d34c13d
51488.3,2.0,25,2,3,2,7,0xb2d0ea7f
380019.57,3.0,0,4,4,4,12,0xb2d928b7
12.12,1.0,65,1,2,2,5,0xb2d9ae93
636.15,1.0,62,1,2,2,5,0xb2d2e2e1
1.07,1.0,11,1,2,3,6,0xb2d4099e
61958.71,1.0,22,3,2,2,7,0xb2d691dd
39.49,1.0,77,1,2,1,4,0xb2d41b9b
692941.73,8.0,0,4,4,4,12,0xb2d54b32
20036.0,1.0,0,2,2,4,8,0xb2d37b36
200010.12,2.0,2,3,3,4,10,0xb2d238f8
60006.71,3.0,185,3,4,1,8,0xb2d5e75e
2869.46,1.0,0,1,2,4,7,0xb2d9d97d
20000.42,2.0,206,2,3,1,6,0xb2d68df9
823067.67,5.0,27,4,4,2,10,0xb2d19a58
266089.3,3.0,47,3,4,2,9,0xb2d1a682
601561.02,3.0,17,4,4,2,10,0xb2d507fa
1875.46,1.0,12,1,2,3,6,0xb2d23842
7851.05,1.0,6,2,2,3,7,0xb2d6c1c9
602551.43,10.0,0,4,4,4,12,0xb2d1e48e
174175.37,3.0,13,3,4,3,10,0xb2d2a568
289.54,1.0,7,1,2,3,6,0xb2d21930
302410.33,3.0,80,4,4,1,9,0xb2d31a01
7397.47,1.0,5,2,2,3,7,0xb2d9d190
106459.2,3.0,4,3,4,4,11,0xb2d0706a
56.89,1.0,19,1,2,2,5,0xb2d9a60e
505600.55,29.0,0,4,4,4,12,0x3b9af25f
54216.63,1.0,12,3,2,3,8,0xb2d386e4
400710.42,3.0,4,4,4,4,12,0xb2d74aca
13976.33,1.0,0,2,2,4,8,0xb2d5eab4
100004.22,2.0,55,3,3,2,8,0xb2d900c1
191742.84,4.0,203,3,4,1,8,0xb2d07855
500196.26,5.0,70,4,4,1,9,0xb2d278c9
100610.23,3.0,40,3,4,2,9,0x3b9b2d23
257067.82,4.0,32,3,4,2,9,0xb2d15c4f
5.35,1.0,0,1,2,4,7,0xb2d3119e
68000.72,2.0,38,3,3,2,8,0xb2d9280a
305017.14,2.0,17,4,3,2,9,0xb2d79002
12653.31,1.0,0,2,2,4,8,0xb2d986b2
1.83,1.0,36,1,2,2,5,0xb2d0c534
639125.24,4.0,42,4,4,2,10,0xb2d39ff6
200080.89,4.0,0,3,4,4,11,0x3b9b265c
510207.35,5.0,112,4,4,1,9,0xb2d91529
10240.07,1.0,1,2,2,4,8,0xb2d39f3d
3.46,1.0,18,1,2,2,5,0xb2d953a4
211484.96,8.0,0,3,4,4,11,0xb2d0a43b
2740.82,1.0,0,1,2,4,7,0xb2d65e09
40000.84,3.0,74,2,4,1,7,0xb2d52f13
27865.37,1.0,15,2,2,3,7,0xb2d6e90c
656.32,1.0,9,1,2,3,6,0xb2d23dc6
65.56,1.0,10,1,2,3,6,0xb2d4dbe9
1200051.05,2.0,66,4,3,2,9,0xb2d1aca4
4472.56,1.0,0,2,2,4,8,0xb2d41416
500396.96,6.0,0,4,4,4,12,0xb2d52913
770323.94,8.0,11,4,4,3,11,0xb2d069e9
5051.71,1.0,5,2,2,3,7,0xb2d48c2f
154354.52,3.0,3,3,4,4,11,0xb2d64d90
18030.54,1.0,0,2,2,4,8,0xb2d6b635
9096.82,10.0,0,2,4,4,10,0x3b9b258f
3550.24,2.0,6,2,3,3,8,0x3b9ad34a
10033.06,1.0,92,2,2,1,5,0xb2d2d795
543672.14,6.0,6,4,4,3,11,0xb2d0b36b
13710.73,1.0,138,2,2,1,5,0xb2d2c5d4
4060.55,1.0,1,2,2,4,8,0xb2d6f0f4
100001.06,2.0,24,3,3,2,8,0xb2d63e6f
401826.81,2.0,29,4,3,2,9,0xb2d6b1d8
5700145.67,3.0,49,4,4,2,10,0xb2d9b640
993.7,1.0,208,1,2,1,4,0xb2d239ba
7344.61,1.0,0,2,2,4,8,0xb2d6b815
1.08,3.0,14,1,4,3,8,0xb2d0798d
450.68,1.0,13,1,2,3,6,0xb2d60026
130010.09,2.0,41,3,3,2,8,0xb2d4a2cf
171.17,2.0,23,1,3,2,6,0x3b9b178a
87.52,1.0,6,1,2,3,6,0xb2d688c8
1194.73,1.0,92,1,2,1,4,0xb2d2ae45
664.86,2.0,0,1,3,4,8,0x3b9b2ee0
40768.98,12.0,0,2,4,4,10,0xb2d0f338
51738.96,6.0,0,2,4,4,10,0x3b9af2c9
10119.84,1.0,4,2,2,4,8,0xb2d29c75
60353.61,3.0,6,3,4,3,10,0xb2d61e71
353456.18,2.0,0,4,3,4,11,0xb2d69dd2
8748.88,1.0,18,2,2,2,6,0xb2d705f1
200057.27,5.0,39,3,4,2,9,0xb2d228d3
66000.4,2.0,7,3,3,3,9,0xb2d23dc0
71001.11,6.0,20,3,4,2,9,0xb2d5e9e6
481.75,1.0,10,1,2,3,6,0xb2d5dd03
11570.23,1.0,10,2,2,3,7,0xb2d316ca
1014.59,1.0,92,1,2,1,4,0xb2d1446f
22605.14,1.0,0,2,2,4,8,0xb2d2959c
400000.0,2.0,6,4,3,3,10,0xb2d26f57
4257.74,1.0,12,2,2,3,7,0xb2d8c398
200832.82,2.0,49,3,3,2,8,0xb2d10612
671948.24,14.0,0,4,4,4,12,0xb2d0b357
2729468.84,52.0,7,4,4,3,11,0xb2d228ad
30012.59,3.0,119,2,4,1,7,0xb2d504bb
16466.69,1.0,92,2,2,1,5,0xb2d24420
10409.48,1.0,14,2,2,3,7,0xb2d6be71
1152.26,1.0,184,1,2,1,4,0x3b9b3c56
304.22,1.0,4,1,2,4,7,0xb2d2f9b6
37507.82,1.0,1,2,2,4,8,0xb2d6cc6d
100001.59,3.0,20,3,4,2,9,0xb2d9489f
239.33,1.0,34,1,2,2,5,0xb2d55b0f
750072.86,6.0,18,4,4,2,10,0xb2d6838b
321176.76,9.0,4,4,4,4,12,0xb2d6d876
15000.48,1.0,3,2,2,4,8,0xb2d8f001
10983.17,1.0,284,2,2,1,5,0xb2d3a19e
170010.46,3.0,74,3,4,1,8,0xb2d8d53d
250560.42,4.0,4,3,4,4,11,0xb2d65228
101081.52,2.0,3,3,3,4,10,0xb2d60ab3
300006.34,2.0,108,3,3,1,7,0xb2d78ff6
140052.78,1.0,0,3,2,4,9,0xb2d612c7
100104.35,2.0,118,3,3,1,7,0xb2d78063
1000080.76,7.0,3,4,4,4,12,0xb2d1dff9
90.36,1.0,13,1,2,3,6,0xb2d9de9a
2687.48,1.0,150,1,2,1,4,0xb2d3afcc
200004.89,4.0,10,3,4,3,10,0xb2d63a9e
26936.12,1.0,6,2,2,3,7,0xb2d2a8b1
9428.29,1.0,1,2,2,4,8,0xb2d327fb
615.55,4.0,0,1,4,4,9,0x3b9b48d0
624130.69,6.0,14,4,4,3,11,0xb2d93d6c
130006.89,2.0,188,3,3,1,7,0xb2d55715
1729.75,1.0,20,1,2,2,5,0xb2d3a6eb
70092.37,2.0,34,3,3,2,8,0xb2d688cb
1394276.0,6.0,0,4,4,4,12,0xb2d5fb62
37648.58,2.0,92,2,3,1,6,0xb2d16bdc
259799.36,1.0,11,3,2,3,8,0xb2d396f8
580000.21,3.0,4,4,4,4,12,0xb2d5d990
370979.69,3.0,0,4,4,4,12,0xb2d5e1c1
530857.42,3.0,25,4,4,2,10,0xb2d60460
639.3,1.0,0,1,2,4,7,0xb2d4d898
50091.35,2.0,82,2,3,1,6,0xb2d78938
11822.57,1.0,28,2,2,2,6,0xb2d6c9ea
120165.31,2.0,196,3,3,1,7,0xb2d0e1c1
61939.52,1.0,14,3,2,3,8,0xb2d6a1a1
3.17,1.0,21,1,2,2,5,0xb2d3e84e
23086.47,1.0,0,2,2,4,8,0xb2d60a9f
10153.38,1.0,125,2,2,1,5,0xb2d53816
10.43,1.0,116,1,2,1,4,0xb2d28846
110002.43,3.0,69,3,4,1,8,0xb2d78d77
582.47,1.0,0,1,2,4,7,0xb2d32fa4
200000.0,2.0,12,3,3,3,9,0xb2da4458
3401.65,1.0,32,2,2,2,6,0xb2d3e65d
2.01,1.0,54,1,2,2,5,0xb2d3c9a0
332002.25,6.0,10,4,4,3,11,0xb2d5ad5c
135090.68,3.0,4,3,4,4,11,0xb2d4e483
50001.58,2.0,92,2,3,1,6,0xb2d905ef
283325.82,4.0,3,3,4,4,11,0xb2d24397
95121.02,2.0,143,3,3,1,7,0xb2d3fe0c
120382.66,3.0,104,3,4,1,8,0xb2d65814
801507.04,3.0,25,4,4,2,10,0xb2d6e452
211339.19,2.0,87,3,3,1,7,0xb2d33b85
518477.02,5.0,87,4,4,1,9,0x3b9ae51f
33288.57,1.0,117,2,2,1,5,0xb2d3b91e
240136.4,3.0,3,3,4,4,11,0xb2d1092a
15000.16,2.0,45,2,3,2,7,0xb2d91d20
2374.94,1.0,0,1,2,4,7,0xb2d636c4
920022.7,8.0,6,4,4,3,11,0xb2d52399
10100.61,1.0,92,2,2,1,5,0xb2d28b2e
288281.96,3.0,0,3,4,4,11,0xb2d06838
30000.95,2.0,256,2,3,1,6,0xb2d5cc25
191.76,1.0,4,1,2,4,7,0xb2d216f9
68.72,1.0,67,1,2,1,4,0xb2d9552c
30603.61,2.0,0,2,3,4,9,0xb2d97642
100093.78,2.0,245,3,3,1,7,0xb2d287ae
430.26,4.0,0,1,4,4,9,0x3b9b46a6
3951.05,1.0,62,2,2,2,6,0xb2d4f8fd
374951.55,3.0,34,4,4,2,10,0xb2d243a3
50001.06,2.0,18,2,3,2,7,0xb2da2a52
505042.29,3.0,8,4,4,3,11,0xb2d78300
56825.76,1.0,40,3,2,2,7,0xb2d1e944
50045.06,2.0,111,2,3,1,6,0xb2d20d3f
8.89,1.0,52,1,2,2,5,0xb2d3c7ed
1601685.56,6.0,8,4,4,3,11,0xb2d7b111
1.51,1.0,10,1,2,3,6,0xb2d78397
178291.49,1.0,5,3,2,3,8,0xb2d4739b
1370998.97,9.0,1,4,4,4,12,0xb2d19468
340019.75,4.0,97,4,4,1,9,0xb2d1ac3a
707.33,2.0,92,1,3,1,5,0xb2d22137
200000.0,2.0,5,3,3,3,9,0xb2d9fb0a
8.11,1.0,18,1,2,2,5,0xb2d112aa
1606.11,1.0,184,1,2,1,4,0xb2d62ab8
107255.71,2.0,66,3,3,2,8,0xb2d36cb0
1936.01,1.0,184,1,2,1,4,0xb2d2a89f
111151.65,3.0,92,3,4,1,8,0x3b9b1598
159511.58,1.0,4,3,2,4,9,0xb2d9fe2a
200101.88,2.0,42,3,3,2,8,0xb2d24511
400004.3,3.0,32,4,4,2,10,0xb2d9ec87
46.61,1.0,11,1,2,3,6,0xb2d27c44
315014.35,2.0,124,4,3,1,8,0xb2d37644
1305.07,1.0,0,1,2,4,7,0xb2d8ec1d
0.86,1.0,20,1,2,2,5,0xb2d85aa8
64006.73,1.0,20,3,2,2,7,0xb2d31098
107442.15,1.0,0,3,2,4,9,0xb2d2bf4c
90.64,1.0,15,1,2,3,6,0xb2d68248
2230.85,2.0,92,1,3,1,5,0xb2d1f7a4
120081.46,7.0,38,3,4,2,9,0xb2d53c7d
2414.55,1.0,3,1,2,4,7,0xb2d2fd90
34.18,1.0,32,1,2,2,5,0xb2d5112a
78627.57,3.0,0,3,4,4,11,0xb2d5b7db
23733.03,1.0,46,2,2,2,6,0xb2d688ce
975063.49,10.0,7,4,4,3,11,0xb2d11c95
2931.15,1.0,184,2,2,1,5,0xb2d2a50ed
201689.35,5.0,0,3,4,4,11,0xb2d06d8f
30001.05,4.0,14,2,4,3,9,0xb2d591c6
123185.98,2.0,1,3,3,4,10,0xb2d212e2
726010.6,4.0,23,4,4,2,10,0xb2d9d32b
8317.61,1.0,6,2,2,3,7,0xb2d698fb
19927.52,1.0,141,2,2,1,5,0xb2d91375
200004.22,3.0,40,3,4,2,9,0xb2d91573
1220072.0,4.0,20,4,4,2,10,0xb2d78beb
4079131.25,8.0,5,4,4,3,11,0xb2d221e8
1305.7,1.0,184,1,2,1,4,0xb2d3d460
1103000.0,3.0,6,4,4,3,11,0xb2d335e1
129.22,1.0,25,1,2,2,5,0xb2d97022
209.58,1.0,12,1,2,3,6,0xb2d6b3c9
600058.98,2.0,139,4,3,1,8,0xb2d1bec9
46132.96,1.0,17,2,2,2,6,0xb2d907ad
214849.78,3.0,10,3,4,3,10,0xb2d31669
200010.96,2.0,14,3,3,3,9,0xb2d959b9
1463.26,1.0,189,1,2,1,4,0xb2d5d48a
50003.07,2.0,172,2,3,1,6,0xb2d347ec
6525.99,1.0,4,2,2,4,8,0xb2d1b308
151787.52,1.0,184,3,2,1,6,0xb2d3bbc7
13548.23,2.0,168,2,3,1,6,0xb2d6b6b8
312544.84,7.0,67,4,4,1,9,0xb2d1abc6
35677.28,1.0,14,2,2,3,7,0xb2d6097a
9537.11,1.0,173,2,2,1,5,0xb2d3f891
26373.36,1.0,0,2,2,4,8,0xb2d6b4dd
322918.92,3.0,13,4,4,3,11,0xb2d23a79
390026.48,4.0,157,4,4,1,9,0xb2d61125
0.33,1.0,10,1,2,3,6,0xb2d4ea24
304254.47,1.0,49,4,2,2,8,0xb2d13aec
230037.85,3.0,73,3,4,1,8,0xb2d3039a
89845.25,2.0,15,3,3,3,9,0xb2d2d1bb
207000.75,12.0,0,3,4,4,11,0xb2d7893e
3.33,1.0,75,1,2,1,4,0xb2d98d0d
47793.39,1.0,3,2,2,4,8,0xb2d54abe
14.92,1.0,27,1,2,2,5,0xb2d39d15
80103.51,4.0,26,3,4,2,9,0xb2d6fb3b
3021.02,1.0,174,2,2,1,5,0xb2d3e4b6
216108.71,2.0,175,3,3,1,7,0xb2d3c750
9338.91,1.0,184,2,2,1,5,0xb2d22fca
1000481.39,2.0,56,4,3,2,9,0xb2d2aeca
794035.84,6.0,101,4,4,1,9,0xb2d28215
10000.0,2.0,7,2,3,3,8,0xb2d90fe3
22228.13,1.0,20,2,2,2,6,0xb2d54e74
4316.98,1.0,184,2,2,1,5,0xb2d3f935
116042.71,3.0,13,3,4,3,10,0xb2d25239
180009.52,3.0,245,3,4,1,8,0xb2d1af9f
8418.4,1.0,1,2,2,4,8,0xb2d189db
30066.81,1.0,15,2,2,3,7,0xb2d5b206
264012.12,4.0,66,3,4,2,9,0xb2d438cf
306591.87,2.0,0,4,3,4,11,0xb2d25694
10001.29,2.0,13,2,3,3,8,0xb2d78f21
5.79,1.0,6,1,2,3,6,0xb2d6b520
41094.5,1.0,9,2,2,3,7,0xb2d6bbc9
458002.74,8.0,11,4,4,3,11,0xb2d19efe
38046.11,1.0,15,2,2,3,7,0xb2d37cd5
404265.42,3.0,77,4,4,1,9,0xb2d935b2
201421.23,2.0,82,3,3,1,7,0xb2d8d4a8
221.88,1.0,92,1,2,1,4,0xb2d2d41a
118867.78,5.0,92,3,4,1,8,0x3b9af62d
155004.72,6.0,0,3,4,4,11,0xb2d56c66d
107.65,1.0,9,1,2,3,6,0xb2d20326
3674.5,1.0,10,2,2,3,7,0xb2d307f6
46523.97,1.0,5,2,2,3,7,0xb2d33a02
368040.98,14.0,1,4,4,4,12,0xb2d456f7
193887.03,10.0,0,3,4,4,11,0xb2d07ac8
30354.55,1.0,10,2,2,3,7,0xb2d68c74
305101.79,5.0,97,4,4,1,9,0xb2d25909
252026.25,6.0,32,3,4,2,9,0xb2d6cbcb
210751.52,2.0,25,3,3,2,8,0xb2d8c376
200061.92,3.0,13,3,4,3,10,0xb2d3b9d2
54262.26,8.0,1,3,4,4,11,0xb2d07296
203218.82,2.0,59,3,3,2,8,0xb2d2b019
1101.82,1.0,26,1,2,2,5,0xb2d37c10
6754.06,1.0,23,2,2,2,6,0xb2d304c3
72.34,1.0,92,1,2,1,4,0xb2d2f6a4
215107.67,4.0,21,3,4,2,9,0xb2d1b3fb
919836.15,7.0,57,4,4,2,10,0xb2d1bc36
68003.17,2.0,68,3,3,1,7,0xb2d6a98c
3.08,1.0,5,1,2,3,6,0xb2d60a54
7226.0,1.0,0,2,2,4,8,0xb2d8fecf
200000.44,2.0,0,3,3,4,10,0xb2d656ba
387049.2,5.0,53,4,4,2,10,0xb2d103cf
2367.07,1.0,133,1,2,1,4,0xb2d4bb3a
301856.55,3.0,136,4,4,1,9,0xb2d17f42
1501.11,1.0,73,1,2,1,4,0xb2d1b82c
848914.06,7.0,8,4,4,3,11,0xb2d584aa
37.0,1.0,31,1,2,2,5,0xb2d951bf
544177.95,7.0,3,4,4,4,12,0xb2d1f6ea
208213.87,2.0,19,3,3,2,8,0xb2d59e0a
477.93,1.0,18,1,2,2,5,0xb2d2d591
7346.16,2.0,184,2,3,1,6,0x3b9b292d
4990.03,1.0,108,2,2,1,5,0xb2d18476
26.72,1.0,1,1,2,4,7,0xb2d50d38
618.9,1.0,24,1,2,2,5,0xb2d2f1a6
9209.51,1.0,11,2,2,3,7,0xb2d91704
176699.98,3.0,7,3,4,3,10,0xb2d38bb0
3350393.74,7.0,5,4,4,3,11,0x3b9b2905
880484.22,2.0,5,4,3,3,10,0xb2d92466
4168.93,1.0,92,2,2,1,5,0xb2d0afb1
990.35,1.0,17,1,2,2,5,0xb2d5ef06
340022.55,3.0,10,4,4,3,11,0xb2d0ebd6
2.22,1.0,67,1,2,1,4,0xb2d65b2d
51581.63,1.0,214,2,2,1,5,0xb2d4e139
393.0,2.0,51,1,3,2,6,0xb2d0cda7
381400.0,2.0,28,4,3,2,9,0xb2d8a48e
7626.09,1.0,7,2,2,3,7,0xb2d1e915
900651.87,9.0,1,4,4,4,12,0xb2d11558
7448.39,1.0,184,2,2,1,5,0xb2d17d25
11.77,1.0,9,1,2,3,6,0xb2d69076
310152.55,2.0,31,4,3,2,9,0xb2d6d419
23.22,1.0,66,1,2,2,5,0xb2d78fe9
12184.77,1.0,18,2,2,2,6,0xb2d5efb6
1309.08,1.0,171,1,2,1,4,0xb2d588c4
39333.28,2.0,92,2,3,1,6,0x3b9b40dc
31.68,1.0,15,1,2,3,6,0xb2d68b0b
60002.53,4.0,13,3,4,3,10,0xb2d60343
0.0,1.0,3,1,2,4,7,0xb2d6156e
1750050.14,3.0,31,4,4,2,10,0xb2d92fcf
190002.01,2.0,80,3,3,1,7,0xb2d9907c
240830.6,4.0,3,3,4,4,11,0xb2d622ba
631860.75,9.0,4,4,4,4,12,0xb2d2a0a0
3822.73,1.0,5,2,2,3,7,0xb2d2efce
229072.32,4.0,11,3,4,3,10,0xb2d128c6
2092.45,2.0,92,1,3,1,5,0xb2d06e05
1310000.74,6.0,1,4,4,4,12,0xb2d59876
2.22,1.0,61,1,2,2,5,0xb2d98e65
500000.36,2.0,12,4,3,3,10,0xb2d6c446
72748.22,3.0,0,3,4,4,11,0xb2d4027f
9914.41,1.0,19,2,2,2,6,0xb2d512e3
7490.65,1.0,10,2,2,3,7,0xb2d90dac
2000032.38,2.0,3,4,3,4,11,0xb2d939f5
4.87,1.0,1,1,2,4,7,0xb2d616a8
823.33,1.0,5,1,2,3,6,0xb2d50dc3
103013.18,3.0,161,3,4,1,8,0xb2d3bcda
320000.63,3.0,10,4,4,3,11,0xb2d95eee
11.71,1.0,88,1,2,1,4,0xb2d3a2cd
56147.32,12.0,92,3,4,1,8,0xb2d0bab0
100003.17,2.0,235,3,3,1,7,0xb2d6e1b9
717978.4,4.0,0,4,4,4,12,0xb2d3d57c
140022.92,2.0,10,3,3,3,9,0xb2d40cf4
3359.29,1.0,71,2,2,1,5,0xb2d5ac4b
37160.25,1.0,21,2,2,2,6,0xb2da081b
0.0,1.0,5,1,2,3,6,0xb2d6a414
15350.91,1.0,184,2,2,1,5,0xb2d12e72
1935.67,1.0,92,1,2,1,4,0xb2d1abfc
73.74,1.0,0,1,2,4,7,0xb2d6e1f1
1018.3,1.0,54,1,2,2,5,0xb2d6b6ff
10003.72,2.0,11,2,3,3,8,0xb2d589da
710787.06,20.0,1,4,4,4,12,0xb2d2554a
527652.01,8.0,31,4,4,2,10,0xb2d0d4ba
263126.31,12.0,0,3,4,4,11,0xb2d5a7ab
53675.4,2.0,29,3,3,2,8,0xb2d5b0bf
17685.69,1.0,13,2,2,3,7,0xb2d34830
36121.57,3.0,0,2,4,4,10,0xb2d51f27
18896.89,2.0,1,2,3,4,9,0xb2d10c70
46635.61,1.0,17,2,2,2,6,0xb2d2f40d
1.83,1.0,76,1,2,1,4,0xb2d8db99
152.04,1.0,7,1,2,3,6,0xb2d2e071
67297.24,2.0,3,3,3,4,10,0xb2d65d92
103005.1,3.0,31,3,4,2,9,0xb2d4971d
0.0,1.0,5,1,2,3,6,0xb2d9227b
81239.92,3.0,1,3,4,4,11,0xb2d436d4
715162.91,3.0,101,4,4,1,9,0xb2d316ae
25180.1,2.0,111,2,3,1,6,0xb2d6afeb
200006.94,2.0,10,3,3,3,9,0xb2d6178a
105094.03,3.0,87,3,4,1,8,0xb2d2256a
350803.77,3.0,22,4,4,2,10,0xb2d6b3bd
24093.59,1.0,14,2,2,3,7,0xb2d3a5f4
760026.56,3.0,1,4,4,4,12,0xb2d8f75d
680008.34,3.0,11,4,4,3,11,0xb2d550f9
1053731.45,2.0,28,4,3,2,9,0xb2d21b3a
36857.51,1.0,0,2,2,4,8,0xb2da579f
2436.72,1.0,10,1,2,3,6,0xb2d787eb
380743.07,2.0,70,4,3,1,8,0xb2d07fd7
860862.1,11.0,4,4,4,4,12,0xb2d56d12
300712.66,4.0,17,4,4,2,10,0xb2d5e0e7
1203.84,1.0,92,1,2,1,4,0xb2d0ce23
200000.0,2.0,27,3,3,2,8,0xb2d9f7c5
1507.64,1.0,0,1,2,4,7,0xb2d6ef36
1401.06,1.0,17,1,2,2,5,0xb2d26b7f
217841.5,1.0,10,3,2,3,8,0xb2d35704
27402.35,1.0,20,2,2,2,6,0xb2d38cb4
72764.84,2.0,92,3,3,1,7,0xb2d1a1e5
110037.26,2.0,87,3,3,1,7,0xb2d56634
1391675.26,10.0,0,4,4,4,12,0xb2d0ca84
1843.32,1.0,92,1,2,1,4,0xb2d34668
9469.18,1.0,24,2,2,2,6,0xb2d215f9
103990.33,2.0,0,3,3,4,10,0xb2d3befc
70015.69,2.0,92,3,3,1,7,0xb2d25958
16.66,1.0,92,1,2,1,4,0xb2d25bc2
1928.57,1.0,184,1,2,1,4,0xb2d16c4d
51264.29,2.0,13,2,3,3,8,0xb2d8db8a
1.82,1.0,5,1,2,3,6,0xb2d6922d
128.98,1.0,192,1,2,1,4,0xb2d4e302
105567.84,6.0,0,3,4,4,11,0xb2d0eb62
63.99,1.0,9,1,2,3,6,0xb2d6d6ed
237002.76,3.0,32,3,4,2,9,0xb2d9ac63
20032.85,2.0,8,2,3,3,8,0xb2d9099b
11840.14,1.0,10,2,2,3,7,0xb2d2ad91
50201.73,2.0,73,2,3,1,6,0xb2d8db84
260076.19,3.0,196,3,4,1,8,0xb2d578de
13794.25,1.0,92,2,2,1,5,0xb2d10137
101.33,1.0,57,1,2,2,5,0xb2d9bfc5
519.51,1.0,12,1,2,3,6,0xb2d86917
1008.08,1.0,184,1,2,1,4,0xb2d39f9e
630000.0,4.0,0,4,4,4,12,0xb2d972ff
4977.14,1.0,0,2,2,4,8,0xb2d7fe6f
61285.83,2.0,53,3,3,2,8,0xb2d6c3e4
327142.6,2.0,6,4,3,3,10,0xb2d210fd
20015.45,3.0,102,2,4,1,7,0xb2d7825b
1872.92,1.0,4,1,2,4,7,0xb2d69360
100206.14,1.0,116,3,2,1,6,0xb2d0eb54
9693.04,1.0,0,2,2,4,8,0xb2d32204
76.23,1.0,53,1,2,2,5,0xb2d7ad61
96078.2,1.0,0,3,2,4,9,0xb2d9a754
80085.6,3.0,144,3,4,1,8,0xb2d59124
318794.75,12.0,0,4,4,4,12,0x3b9af0ec
273035.44,2.0,1,3,3,4,10,0xb2d48768
20545.82,1.0,5,2,2,3,7,0xb2d5d506
7920.88,1.0,184,2,2,1,5,0xb2d60e3d
300358.79,7.0,25,4,4,2,10,0xb2d56a2b
106020.73,4.0,143,3,4,1,8,0xb2d32ee4
989000.0,7.0,0,4,4,4,12,0xb2d2e861
811147.95,14.0,28,4,4,2,10,0xb2d1928a
498.7,1.0,0,1,2,4,7,0xb2d8112f
604200.28,3.0,6,4,4,3,11,0xb2d641c5
534707.57,3.0,5,4,4,3,11,0xb2d21466
580098.39,6.0,66,4,4,2,10,0xb2d4f761
20000.21,2.0,90,2,3,1,6,0xb2d8c38a
27797.59,1.0,5,2,2,3,7,0xb2d1f931
1846.83,1.0,33,1,2,2,5,0xb2d913cd
83000.88,2.0,39,3,3,2,8,0xb2d9ef7e
470000.0,6.0,99,4,4,1,9,0xb2d59c9b
46453.52,1.0,3,2,2,4,8,0xb2d5ee0e
3307.72,1.0,1,2,2,4,8,0xb2d65034
786534.14,5.0,6,4,4,3,11,0xb2d1d493
696128.01,5.0,0,4,4,4,12,0xb2d069c6
0.0,2.0,0,1,3,4,8,0xb2d07eda
50001.58,2.0,59,2,3,2,7,0xb2d8fb24
309.45,1.0,70,1,2,1,4,0xb2d5f17a
5868.99,1.0,7,2,2,3,7,0xb2d64cd3
280994.58,2.0,8,3,3,3,9,0xb2d90d26
2467.12,1.0,82,1,2,1,4,0xb2d6824d
240067.02,3.0,34,3,4,2,9,0xb2d24aa3
239285.72,2.0,39,3,3,2,8,0xb2d6b018
500000.42,3.0,1,4,4,4,12,0xb2d6af2e
300050.06,4.0,48,3,4,2,9,0xb2d5e695
1730.12,1.0,92,1,2,1,4,0xb2d3a1a2
350921.46,4.0,0,4,4,4,12,0xb2d3e41dd
504088.62,4.0,0,4,4,4,12,0xb2d5793f
190439.94,2.0,147,3,3,1,7,0xb2d24e00
305533.52,2.0,11,4,3,3,10,0xb2d6b064
13.68,1.0,82,1,2,1,4,0xb2d57197
545409.23,9.0,0,4,4,4,12,0xb2d24d58
2738.45,1.0,0,1,2,4,7,0xb2da075d
430016.25,3.0,2,4,4,4,12,0xb2d8d784
9000095.0,2.0,10,4,3,3,10,0xb2d95bc4
323693.79,1.0,2,4,2,4,10,0xb2d23535
25.33,1.0,13,1,2,3,6,0xb2d9e3ea
203055.28,6.0,11,3,4,3,10,0xb2d5b5c6
218276.78,2.0,5,3,3,3,9,0xb2d1ea67
2240.33,1.0,0,1,2,4,7,0xb2d6f4d4
503002.0,6.0,0,4,4,4,12,0xb2d75ae8
351038.95,9.0,1,4,4,4,12,0xb2d665b1
601260.63,4.0,0,4,4,4,12,0xb2d627ef
150.24,1.0,1,1,2,4,7,0xb2d54f18
8138.56,1.0,21,2,2,2,6,0xb2d37c6e
990002.84,14.0,0,4,4,4,12,0xb2d53a78
68.03,2.0,170,1,3,1,5,0xb2d32f3a
55000.0,3.0,42,3,4,2,9,0xb2d9d277
4.04,1.0,12,1,2,3,6,0xb2d6b73d
5145112.77,4.0,76,4,4,1,9,0xb2d2660e
3340.41,1.0,46,2,2,2,6,0xb2d8d5fe
61.9,1.0,21,1,2,2,5,0xb2d4a59e
1364574.33,6.0,6,4,4,3,11,0xb2d51625
2.15,1.0,4,1,2,4,7,0xb2d32fa4d
26891.01,1.0,1,2,2,4,8,0xb2d1f612
83247.26,3.0,94,3,4,1,8,0xb2d2e55d
170006.13,6.0,1,3,4,4,11,0xb2d94051
3000045.33,2.0,12,4,3,3,10,0xb2d6c223
550784.16,2.0,0,4,3,4,11,0xb2d2909f
200000.84,2.0,16,3,3,2,8,0xb2d78f09
3.57,1.0,10,1,2,3,6,0xb2d6f557
650001.46,5.0,3,4,4,4,12,0xb2d11876
3194.56,1.0,92,2,2,1,5,0xb2d15ddb
1372294.4,1.0,27,4,2,2,8,0xb2d3aa8dd
355471.93,3.0,17,4,4,2,10,0xb2d612c4
98000000.0,5.0,41,4,4,2,10,0xb2d451d5
13795.06,1.0,2,2,2,4,8,0xb2d329e0
150033.77,4.0,24,3,4,2,9,0xb2d06520
429001.52,5.0,8,4,4,3,11,0xb2d12373
34.58,1.0,20,1,2,2,5,0xb2d38e6a
3123.55,1.0,4,2,2,4,8,0xb2d6a372
150025.4,2.0,193,3,3,1,7,0xb2d5fcd9
501793.36,2.0,50,4,3,2,9,0xb2d8d3aa
118615.01,2.0,228,3,3,1,7,0xb2d489e5
1864619.66,4.0,0,4,4,4,12,0xb2d12c05
865.02,1.0,68,1,2,1,4,0xb2d55f4e
98000000.0,5.0,133,4,4,1,9,0xb2d451d5d
500002.16,2.0,16,4,3,2,9,0xb2d8d9b0
2939821.08,4.0,6,4,4,3,11,0xb2d5d084
453614.21,3.0,57,4,4,2,10,0xb2d2de7a
1676.49,1.0,181,1,2,1,4,0xb2d6525f
1535.29,1.0,184,1,2,1,4,0x3b9b22f2
1030229.54,1.0,20,4,2,2,8,0xb2d156f7
2.6,1.0,75,1,2,1,4,0xb2d55501
6307.89,4.0,110,2,4,1,7,0x3b9b15f5
60000.63,2.0,21,3,3,2,8,0xb2da1458
100510.46,7.0,0,3,4,4,11,0x3b9af1e0
4372.9,1.0,36,2,2,2,6,0xb2d560dc
29747.18,1.0,24,2,2,2,6,0xb2d32b44
0.51,1.0,105,1,2,1,4,0xb2d57e2a
120725.34,7.0,10,3,4,3,10,0xb2d659c5
101297.82,2.0,4,3,3,4,10,0xb2d0cb10
65689.69,2.0,55,3,3,2,8,0xb2d0fd2d
3205.83,5.0,92,2,4,1,7,0x3b9b135e
2595.39,1.0,2,1,2,4,7,0xb2d392d1
185.56,1.0,11,1,2,3,6,0xb2d50fe9
18.71,4.0,48,1,4,2,7,0xb2d6c1ae
500000.0,2.0,16,4,3,2,9,0xb2d99a17
7740.06,2.0,66,2,3,2,7,0xb2d3f894
20191.91,1.0,92,2,2,1,5,0xb2d107b1
968.91,1.0,2,1,2,4,7,0xb2d601be
138.88,3.0,0,1,4,4,9,0x3b9b45b4
67189.58,3.0,3,3,4,4,11,0xb2d233fbd
267042.67,2.0,55,3,3,2,8,0xb2d24f36
2162.34,1.0,184,1,2,1,4,0xb2d36384
710721.86,4.0,3,4,4,4,12,0xb2d1c169
400884.69,3.0,0,4,4,4,12,0x3b9b30f4
265667.5,2.0,0,3,3,4,10,0xb2d37bb0
1632.56,1.0,9,1,2,3,6,0xb2d2cd72
580012.45,5.0,21,4,4,2,10,0xb2d9d7c0
3616.92,1.0,2,2,2,4,8,0xb2d60a74
22089.04,1.0,6,2,2,3,7,0xb2d56605
200001.26,2.0,17,3,3,2,8,0xb2d792b2
30117.33,1.0,184,2,2,1,5,0xb2d618a8
300046.48,2.0,41,3,3,2,8,0xb2d2e3bd
174.08,1.0,9,1,2,3,6,0xb2d2fb7e
5003.8,1.0,5,2,2,3,7,0xb2d9aa26
602.22,1.0,0,1,2,4,7,0xb2d29890
259.62,1.0,9,1,2,3,6,0xb2d3bee8
77820.95,1.0,0,3,2,4,9,0xb2d930ba
1000000.04,3.0,0,4,4,4,12,0xb2d938a1
20000.05,2.0,4,2,3,4,9,0xb2da4965
138003.45,4.0,42,3,4,2,9,0xb2d6eab7
9273.72,2.0,0,2,3,4,9,0xb2d21244
285896.71,1.0,1,3,2,4,9,0xb2d16574
3043.14,4.0,92,2,4,1,7,0x3b9b3576
2016.89,3.0,92,1,4,1,6,0xb2d14ee9
324110.6,2.0,126,4,3,1,8,0xb2d24e9d
100011.61,2.0,74,3,3,1,7,0xb2d94d15
410033.12,2.0,144,4,3,1,8,0xb2d4ea2d
109220.0,2.0,2,3,3,4,10,0xb2d973a6
41.59,1.0,3,1,2,4,7,0xb2d8ec1c
200010.0,2.0,0,3,3,4,10,0xb2d97e8b
50708.74,1.0,184,2,2,1,5,0xb2d13303
10042.66,2.0,62,2,3,2,7,0xb2d5b54d
1890.79,1.0,46,1,2,2,5,0xb2d2e6e9
1718.25,1.0,92,1,2,1,4,0xb2d23877
50001.82,2.0,206,2,3,1,6,0xb2d51081
120007.39,2.0,47,3,3,2,8,0xb2d85777
46083.52,1.0,18,2,2,2,6,0xb2d5d813
251256.52,2.0,7,3,3,3,9,0xb2d1db2c
3352.7,1.0,4,2,2,4,8,0xb2d50dfd
120019.62,1.0,1,3,2,4,9,0xb2d61df5
30000.95,2.0,11,2,3,3,8,0xb2da3c56
501896.07,4.0,0,4,4,4,12,0x3b9af135
213731.2,3.0,11,3,4,3,10,0xb2d681f0
130036.28,4.0,0,3,4,4,11,0xb2d655b6
10163.77,1.0,92,2,2,1,5,0xb2d1bddc
701877.36,8.0,21,4,4,2,10,0xb2d6aab0
30000.32,2.0,24,2,3,2,7,0xb2d94bc4
102591.11,1.0,256,3,2,1,6,0xb2d35e94
5000000.0,3.0,25,4,4,2,10,0xb2da126d
2328691.93,2.0,1,4,3,4,11,0xb2d6b604
23154.39,1.0,4,2,2,4,8,0xb2d6893b
205238.74,3.0,48,3,4,2,9,0xb2d1b26e
0.0,1.0,68,1,2,1,4,0xb2d62d55
50006.57,2.0,206,2,3,1,6,0xb2d5c789
80242.72,2.0,129,3,3,1,7,0xb2d6389a
790001.99,6.0,4,4,4,4,12,0xb2d5b064d
1371.9,5.0,0,1,4,4,9,0xb2d51f50
1045.34,1.0,184,1,2,1,4,0xb2d1ab6d
130004.07,3.0,129,3,4,1,8,0xb2d3fcff
63285.92,2.0,67,3,3,1,7,0xb2d0f4b2
5342.62,1.0,8,2,2,3,7,0xb2d41c86
30046.07,2.0,0,2,3,4,9,0xb2d62316
42014.92,2.0,83,2,3,1,6,0xb2d3bb73
179547.77,1.0,54,3,2,2,7,0xb2d24836
16440.14,1.0,0,2,2,4,8,0xb2d9789b
200000.0,2.0,29,3,3,2,8,0xb2da0a39
602131.43,2.0,18,4,3,2,9,0xb2d91525
200003.38,2.0,21,3,3,2,8,0xb2d17ec5
110002.32,2.0,31,3,3,2,8,0xb2d939e9
212180.17,2.0,112,3,3,1,7,0xb2d254fb
31368.56,2.0,0,2,3,4,9,0xb2d2a514
60602.57,2.0,12,3,3,3,9,0xb2da34e7
4.57,1.0,18,1,2,2,5,0xb2d69280
67400.85,3.0,1,3,4,4,11,0xb2d17de6
10124.94,1.0,25,2,2,2,6,0xb2d6911c
850072.85,4.0,221,4,4,1,9,0xb2d3534b
210597.31,5.0,5,3,4,3,10,0xb2d3a0f1
283827.82,3.0,25,3,4,2,9,0xb2d52158
312319.78,1.0,1,4,2,4,10,0xb2d3ffef
135300.1,4.0,9,3,4,3,10,0xb2d1daf3
19978.07,4.0,272,2,4,1,7,0xb2d64bcc
400066.18,10.0,1,4,4,4,12,0x3b9ad54f
50986.54,2.0,0,2,3,4,9,0xb2d59876d
303386.01,3.0,108,4,4,1,9,0xb2d5117e
352205.13,3.0,90,4,4,1,9,0xb2d4125c
445.62,1.0,22,1,2,2,5,0xb2d2040c
379077.81,3.0,10,4,4,3,11,0xb2d96c48
0.0,1.0,4,1,2,4,7,0xb2d5fd22
12088.35,5.0,20,2,4,2,8,0xb2d19f41
381401.9,5.0,5,4,4,3,11,0xb2d3ea87
55007.19,2.0,20,3,3,2,8,0xb2d2b66bd
611118.82,6.0,20,4,4,2,10,0xb2d32383
123341.32,3.0,0,3,4,4,11,0xb2d24beb
13987.61,1.0,77,2,2,1,5,0xb2d2978e
60005.78,2.0,18,3,3,2,8,0xb2da29ed
240286.72,4.0,26,3,4,2,9,0xb2d90e2e
100006.72,2.0,18,3,3,2,8,0xb2d230aed
8858.9,1.0,0,2,2,4,8,0xb2d4fe10
500000.0,2.0,4,4,3,4,11,0xb2d18167
503.01,1.0,2,1,2,4,7,0xb2d538c2
11.52,1.0,7,1,2,3,6,0xb2d83b1f
72223.82,1.0,20,3,2,2,7,0xb2d3e2d9
550120.12,4.0,208,4,4,1,9,0xb2d186b2
50052.49,2.0,18,2,3,2,7,0xb2da1b98
253527.4,10.0,46,3,4,2,9,0xb2d59f4a
646.07,1.0,1,1,2,4,7,0xb2d91374
79.02,1.0,13,1,2,3,6,0xb2d58088
20000.42,2.0,31,2,3,2,7,0xb2d9fe3c
110843.47,3.0,13,3,4,3,10,0xb2d6211f
2637.15,1.0,3,1,2,4,7,0xb2d2be0f
30003.52,2.0,206,2,3,1,6,0xb2d5cb20
500062.82,2.0,14,4,3,3,10,0xb2d78e68
9995.44,5.0,184,2,4,1,7,0xb2d3784e
155.68,1.0,6,1,2,3,6,0xb2d95670
90859.94,1.0,11,3,2,3,8,0xb2d637ae
3.52,1.0,34,1,2,2,5,0xb2d9e48f
280018.43,4.0,80,3,4,1,8,0xb2d1b282
363.65,1.0,14,1,2,3,6,0xb2d1bc8d
1920.83,1.0,184,1,2,1,4,0xb2d31f64
39.07,1.0,68,1,2,1,4,0xb2d5c8ec
220796.7,2.0,30,3,3,2,8,0xb2d4b8e3
2272.88,1.0,69,1,2,1,4,0xb2d21164
120.65,1.0,34,1,2,2,5,0xb2d10b64
660287.45,3.0,6,4,4,3,11,0xb2d56069
41096.66,4.0,55,2,4,2,8,0xb2d560d7
300011.72,2.0,7,3,3,3,9,0xb2d94258
50000.74,2.0,10,2,3,3,8,0xb2d965c2
470102.96,2.0,5,4,3,3,10,0xb2da205a
9896.99,1.0,118,2,2,1,5,0xb2d1f343
24776.47,1.0,32,2,2,2,6,0xb2d43a06
22002.51,2.0,53,2,3,2,7,0xb2d9c710
350664.43,3.0,74,4,4,1,9,0xb2d1a0bd
50004.75,1.0,0,2,2,4,8,0xb2d8f959
9176.95,1.0,92,2,2,1,5,0xb2d180c3
2734.74,1.0,184,1,2,1,4,0xb2d0d674
82321.97,2.0,3,3,3,4,10,0xb2d64dd0
8762.68,1.0,15,2,2,3,7,0xb2d9ad0e
19413.29,1.0,20,2,2,2,6,0xb2d535a1
1266.86,1.0,4,1,2,4,7,0xb2d6c002
161.96,1.0,82,1,2,1,4,0xb2d59e2d
1403552.62,10.0,6,4,4,3,11,0xb2d41aab
17730.44,1.0,18,2,2,2,6,0xb2d906a1
204979.07,4.0,80,3,4,1,8,0xb2d3ca56
81650.66,3.0,60,3,4,2,9,0xb2d2a7d5
15621.51,1.0,4,2,2,4,8,0xb2d60b7c
317749.39,6.0,108,4,4,1,9,0xb2d17f29
503588.51,2.0,14,4,3,3,10,0xb2d66788
271529.78,3.0,1,3,4,4,11,0xb2d42341
503490.53,2.0,31,4,3,2,9,0xb2d6545d
60000.63,2.0,21,3,3,2,8,0xb2da1fe2
703558.95,3.0,53,4,4,2,10,0xb2d9a989
300598.96,3.0,31,4,4,2,10,0xb2d4734a
1007104.99,3.0,62,4,4,2,10,0xb2d9b641
2029.95,1.0,184,1,2,1,4,0xb2d408de
865959.23,1.0,11,4,2,3,9,0xb2d1f776
1536.42,4.0,0,1,4,4,9,0xb2d09c88
112718.45,2.0,26,3,3,2,8,0xb2d10582
154.7,1.0,11,1,2,3,6,0xb2d11cb8
100452.52,4.0,108,3,4,1,8,0xb2d68a59
40073.83,3.0,102,2,4,1,7,0xb2d57294
270048.77,2.0,195,3,3,1,7,0xb2d16ece
202843.03,2.0,132,3,3,1,7,0xb2d92631
47.56,1.0,10,1,2,3,6,0xb2d21d42
370.62,1.0,1,1,2,4,7,0xb2d83cb7
255034.14,2.0,24,3,3,2,8,0xb2d4372e
3900092.78,1.0,0,4,2,4,10,0xb2da0648
220048.51,3.0,203,3,4,1,8,0xb2d36e88
850012.01,7.0,1,4,4,4,12,0xb2d25b4b
238422.96,2.0,125,3,3,1,7,0x3b9b3666
201643.8,1.0,9,3,2,3,8,0xb2d563ac
460330.69,5.0,108,4,4,1,9,0xb2d29801
9.4,1.0,77,1,2,1,4,0xb2d69a37
30012.48,2.0,40,2,3,2,7,0xb2d5f10d
3371340.54,15.0,0,4,4,4,12,0xb2d5858f
520426.63,2.0,18,4,3,2,9,0xb2d50f7a
15983.35,1.0,0,2,2,4,8,0xb2d57480
899802.87,1.0,25,4,2,2,8,0xb2d93575
58.54,1.0,10,1,2,3,6,0xb2d9ecde
604940.24,4.0,5,4,4,3,11,0xb2d611cd
23735.28,1.0,62,2,2,2,6,0xb2d3ef0a
199898.01,3.0,16,3,4,2,9,0xb2d24dfb
11696.67,1.0,5,2,2,3,7,0xb2d6e1b5
71101.99,1.0,21,3,2,2,7,0xb2d1b45c
690191.01,3.0,92,4,4,1,9,0xb2d588f1
550400.96,3.0,18,4,4,2,10,0xb2d1ae94
9400.93,1.0,9,2,2,3,7,0xb2d36512
96.15,1.0,35,1,2,2,5,0xb2d0f5d6
786621.69,4.0,1,4,4,4,12,0xb2d4a271
500341.81,2.0,7,4,3,3,10,0xb2d6cac3
2521067.85,20.0,0,4,4,4,12,0xb2d0879d
267896.86,6.0,4,3,4,4,11,0x3b9adfa9
60.74,1.0,10,1,2,3,6,0xb2d37807
105.45,1.0,2,1,2,4,7,0xb2d1400a
2725.64,1.0,5,1,2,3,6,0xb2d97ca4
343972.63,1.0,3,4,2,4,10,0xb2d2f9cd
120060.45,2.0,24,3,3,2,8,0xb2d631c4
14000.3,2.0,97,2,3,1,6,0xb2d7ee3d
657502.3,6.0,4,4,4,4,12,0xb2d249fa
250006.46,4.0,14,3,4,3,10,0x3b9b32ad
305331.53,2.0,101,4,3,1,8,0xb2d8e9eb
60000.0,1.0,4,3,2,4,9,0xb2d35a6a
3814.94,3.0,92,2,4,1,7,0x3b9b0eed
20005.31,2.0,70,2,3,1,6,0xb2d5fb7f
14856.94,1.0,17,2,2,2,6,0xb2d6adac
2365.62,1.0,0,1,2,4,7,0xb2d3481d
2601.63,1.0,1,1,2,4,7,0xb2d55227
525720.08,1.0,0,4,2,4,10,0xb2d2f701
13323.94,4.0,26,2,4,2,8,0xb2d22f85
923689.86,6.0,4,4,4,4,12,0xb2d177ef
4045.78,1.0,7,2,2,3,7,0xb2d6ce95
101119.02,2.0,27,3,3,2,8,0xb2d57347
51526.46,2.0,94,2,3,1,6,0xb2d5a98d
740043.14,6.0,10,4,4,3,11,0xb2d789e9
3.89,2.0,51,1,3,2,6,0xb2d0711e
250.7,1.0,3,1,2,4,7,0xb2d4e56f
10.89,1.0,54,1,2,2,5,0xb2d26317
490674.8,1.0,1,4,2,4,10,0xb2d60c8d
59.8,2.0,18,1,3,2,6,0xb2d06470
200710.43,2.0,42,3,3,2,8,0xb2d9eabd
120007.28,4.0,13,3,4,3,10,0xb2d53d7a
1215.97,1.0,171,1,2,1,4,0xb2d63f1e
677.33,1.0,0,1,2,4,7,0xb2d901f7
8937.51,1.0,0,2,2,4,8,0xb2d2fc6c
39639.55,1.0,184,2,2,1,5,0xb2d34c09
48.37,1.0,0,1,2,4,7,0xb2d35d61
52000.0,2.0,92,2,3,1,6,0xb2d45492
66302.83,9.0,3,3,4,4,11,0xb2d0b163
4557956.84,2.0,45,4,3,2,9,0xb2d2ea84
300182.58,2.0,15,4,3,3,10,0xb2da3067
254782.07,4.0,132,3,4,1,8,0xb2d5b862
316732.23,6.0,0,4,4,4,12,0xb2d5fe53
250005.28,2.0,60,3,3,2,8,0xb2d9bc42
302131.87,2.0,23,4,3,2,9,0xb2d987a9
10082.52,2.0,179,2,3,1,6,0xb2d59f5a
1294.62,1.0,184,1,2,1,4,0xb2d0e3ba
675027.38,6.0,1,4,4,4,12,0xb2d082d3
905.81,1.0,17,1,2,2,5,0xb2d2be81
2494188.16,1.0,0,4,2,4,10,0xb2d23574
15068.78,2.0,5,2,3,3,8,0xb2d9c4c4
255625.08,3.0,36,3,4,2,9,0xb2d278c8
1603.87,1.0,3,1,2,4,7,0xb2d5d295
6.12,1.0,19,1,2,2,5,0xb2d3fe4a
250014.79,2.0,0,3,3,4,10,0xb2d93b51
10290.43,1.0,16,2,2,2,6,0xb2d2d975
52003.57,5.0,13,2,4,3,9,0xb2d63caa
815705.64,8.0,25,4,4,2,10,0xb2d3418c
500028.22,2.0,23,4,3,2,9,0xb2d6f55b
1061718.26,8.0,1,4,4,4,12,0xb2d0cc53
2518.77,1.0,9,1,2,3,6,0xb2d4ed9e
155264.36,3.0,0,3,4,4,11,0xb2d3a595
62.98,1.0,12,1,2,3,6,0xb2d22a23
706495.95,30.0,1,4,4,4,12,0xb2d36337
2081254.81,3.0,25,4,4,2,10,0xb2d460d9
61215.91,4.0,4,3,4,4,11,0xb2d2afd5
2045049.55,5.0,46,4,4,2,10,0xb2d5bfe3
1337.82,1.0,10,1,2,3,6,0xb2d310fc
700933.37,4.0,17,4,4,2,10,0xb2d98fa7
10499.79,2.0,0,2,3,4,9,0xb2d61542
600086.44,2.0,3,4,3,4,11,0xb2d5e917
373.78,1.0,9,1,2,3,6,0xb2d305c5
146650.58,1.0,10,3,2,3,8,0xb2d94a59
1007.17,1.0,184,1,2,1,4,0xb2d3e3cf
5536.75,1.0,4,2,2,4,8,0xb2d6b978
210004.43,2.0,38,3,3,2,8,0xb2d92848
10032.75,1.0,92,2,2,1,5,0xb2d5c676
3051.44,1.0,82,2,2,1,5,0xb2d2d700
8157.35,2.0,92,2,3,1,6,0x3b9b17f0
72322.77,1.0,69,3,2,1,6,0xb2d6cbfc
20186.93,3.0,118,2,4,1,7,0xb2d54980
127096.6,1.0,4,3,2,4,9,0xb2d40991
6224.62,1.0,257,2,2,1,5,0xb2d12379
1020000.0,1.0,0,4,2,4,10,0xb2da5ce3
100001.06,2.0,38,3,3,2,8,0xb2d92bc6
3.38,1.0,28,1,2,2,5,0xb2d79080
415098.77,2.0,16,4,3,2,9,0xb2d161ab
20000.63,2.0,53,2,3,2,7,0xb2d9c90e
450000.0,2.0,5,4,3,3,10,0xb2d85b5b
255004.52,3.0,4,3,4,4,11,0xb2d10f1c
170393.6,1.0,10,3,2,3,8,0xb2d8d4e6
60001.62,3.0,87,3,4,1,8,0xb2d570a1
114401.82,3.0,122,3,4,1,8,0xb2d130ea
38285.07,1.0,2,2,2,4,8,0xb2d6a97c
520018.54,2.0,0,4,3,4,11,0xb2d9c9e1
152287.16,3.0,7,3,4,3,10,0xb2d29bf2
955050.51,3.0,17,4,4,2,10,0xb2d9a008
610017.84,3.0,55,4,4,2,10,0xb2d89f3f
210025.33,2.0,0,3,3,4,10,0xb2d0d770
10199.05,1.0,184,2,2,1,5,0xb2d08512
9592.41,1.0,0,2,2,4,8,0xb2d5d3be
120005.74,3.0,167,3,4,1,8,0xb2d1d6b2
200065.15,2.0,2,3,3,4,10,0xb2d65516
43582.21,1.0,0,2,2,4,8,0xb2d6fd03
280689.78,1.0,1,3,2,4,9,0xb2d2c37c
6867.46,1.0,9,2,2,3,7,0xb2d7770e
117.18,1.0,9,1,2,3,6,0xb2d2728b
151.88,1.0,67,1,2,1,4,0xb2d68ef6
97040.32,2.0,0,3,3,4,10,0xb2d625e5
7.78,1.0,3,1,2,4,7,0xb2d95aef
3708.03,1.0,2,2,2,4,8,0xb2d43440
8678.5,1.0,184,2,2,1,5,0xb2d16402
173263.58,3.0,4,3,4,4,11,0xb2d6a8a7
251403.88,4.0,13,3,4,3,10,0xb2d24caf
1511.05,1.0,92,1,2,1,4,0xb2d5f01e
104933.18,2.0,97,3,3,1,7,0xb2d4f8bf
932169.48,5.0,5,4,4,3,11,0xb2d85ad7
9687.21,1.0,175,2,2,1,5,0xb2d5bbc6d
50053.06,1.0,97,2,2,1,5,0xb2d43a80
238022.81,5.0,60,3,4,2,9,0xb2d1f430
15161.13,1.0,19,2,2,2,6,0xb2d41b8c
433.79,1.0,17,1,2,2,5,0xb2d249b7
360007.53,4.0,5,4,4,3,11,0xb2d81e6e
670000.45,6.0,0,4,4,4,12,0xb2d60f85
58.32,1.0,208,1,2,1,4,0xb2d25ce5
3470.13,1.0,184,2,2,1,5,0xb2d41b04
984168.18,4.0,0,4,4,4,12,0xb2d14e94
410774.85,4.0,10,4,4,3,11,0xb2d19c80
7.25,1.0,184,1,2,1,4,0xb2d2b0ad
34010.91,2.0,119,2,3,1,6,0xb2d6322c
161.98,1.0,8,1,2,3,6,0xb2d2d225
178.1,1.0,5,1,2,3,6,0xb2d960d7
105247.41,2.0,228,3,3,1,7,0xb2d346eb
200048.03,4.0,63,3,4,2,9,0xb2d43a7a
19571042.86,3.0,73,4,4,1,9,0xb2d65834
5630.59,1.0,1,2,2,4,8,0xb2d699e2
101.75,2.0,20,1,3,2,6,0xb2d10ccf
584.06,1.0,39,1,2,2,5,0xb2d587d4
10000000.0,2.0,0,4,3,4,11,0xb2d98251
50101.61,2.0,32,2,3,2,7,0xb2d9fc46
883.22,1.0,56,1,2,2,5,0xb2d3668b
20.54,1.0,76,1,2,1,4,0xb2d974ba
1865.48,1.0,184,1,2,1,4,0xb2d262df
1036.8,1.0,184,1,2,1,4,0xb2d0f62e
100428.65,2.0,214,3,3,1,7,0xb2d140f3
20000.56,2.0,18,2,3,2,7,0xb2d5abf4
93729.17,1.0,5,3,2,3,8,0xb2d36b16
230007.34,2.0,95,3,3,1,7,0xb2d5edcc
2274.34,1.0,2,1,2,4,7,0xb2d6b8dbd
1801.82,1.0,143,1,2,1,4,0xb2d6026d
1375.21,1.0,6,1,2,3,6,0xb2d995e9
260095.72,3.0,19,3,4,2,9,0xb2d141cb
30576.32,3.0,19,2,4,2,8,0xb2d0a389
58648.91,2.0,9,3,3,3,9,0xb2d9b992
200042.58,2.0,7,3,3,3,9,0xb2d902a9
100004.64,3.0,14,3,4,3,10,0xb2d758c1
28.34,1.0,28,1,2,2,5,0xb2d9daa6
710090.63,2.0,27,4,3,2,9,0xb2d482bd
2074.54,1.0,184,1,2,1,4,0xb2d13598
24.16,1.0,27,1,2,2,5,0xb2d52933
1470023.75,2.0,0,4,3,4,11,0xb2d9ed68
100005.28,2.0,33,3,3,2,8,0xb2d9286d
549065.7,7.0,55,4,4,2,10,0xb2d19313
19723.9,1.0,1,2,2,4,8,0xb2d44419
10170.2,1.0,36,2,2,2,6,0xb2d694ed
750011.7,3.0,1,4,4,4,12,0xb2d9b30b
245.26,1.0,4,1,2,4,7,0xb2d3e818
1228162.28,22.0,0,4,4,4,12,0x3b9b1833
450112.57,3.0,0,4,4,4,12,0xb2d31ce8
581.9,1.0,4,1,2,4,7,0xb2d0c381
285.0,1.0,83,1,2,1,4,0xb2d981c5
169016.46,8.0,10,3,4,3,10,0xb2d443e1
208013.04,4.0,11,3,4,3,10,0xb2d51fea
26.79,1.0,7,1,2,3,6,0xb2d4db80
134.29,3.0,104,1,4,1,6,0xb2d23245
4216.04,1.0,11,2,2,3,7,0xb2d8578c
170102.78,3.0,154,3,4,1,8,0xb2d6e881
99.54,1.0,7,1,2,3,6,0xb2d4d394
528005.99,3.0,6,4,4,3,11,0xb2d696c2
3.98,1.0,89,1,2,1,4,0xb2d3bd86
230008.76,5.0,35,3,4,2,9,0xb2d8fcd8
496881.56,5.0,11,4,4,3,11,0xb2d1facf
2182.45,1.0,0,1,2,4,7,0xb2d48c55
118614.42,2.0,136,3,3,1,7,0xb2d489e5d
508886.92,2.0,83,4,3,1,8,0xb2d8d56b
19.35,1.0,15,1,2,3,6,0xb2d2f4c8
501779.07,2.0,0,4,3,4,11,0xb2d8fed3
3951.86,1.0,4,2,2,4,8,0xb2d5cb19
109.57,1.0,5,1,2,3,6,0xb2d2806f
150133.7,2.0,14,3,3,3,9,0xb2d62640
1495.84,1.0,184,1,2,1,4,0xb2d17379
501782.07,2.0,53,4,3,2,9,0xb2d904aa
10.51,2.0,23,1,3,2,6,0xb2d8db30
3458.93,1.0,24,2,2,2,6,0xb2d7ee95
500000.42,3.0,7,4,4,3,11,0xb2d92e2a
155012.35,3.0,13,3,4,3,10,0xb2d2d28b
15198.25,1.0,11,2,2,3,7,0xb2d2b5df
1153.52,1.0,2,1,2,4,7,0xb2d30a98
12153.91,1.0,52,2,2,2,6,0xb2d1fc29
3.67,1.0,12,1,2,3,6,0xb2d6b517
100097.92,3.0,55,3,4,2,9,0xb2d54e5e
208.75,1.0,28,1,2,2,5,0xb2d5af96
131.31,1.0,29,1,2,2,5,0xb2d2ffbf
150037.23,2.0,6,3,3,3,9,0xb2d2f0c8
5160.1,1.0,0,2,2,4,8,0xb2d69f54
79909.27,1.0,92,3,2,1,6,0xb2d2aa5e
2160978.54,8.0,0,4,4,4,12,0x3b9b1813
4471582.71,2.0,214,4,3,1,8,0xb2d06884
12000.13,2.0,49,2,3,2,7,0xb2d17ebb
5.61,1.0,87,1,2,1,4,0xb2d42600
319014.53,4.0,125,4,4,1,9,0xb2d4140d
649718.33,21.0,0,4,4,4,12,0x3b9adfa6
375216.24,12.0,12,4,4,3,11,0xb2d0df7a
5759.83,2.0,92,2,3,1,6,0xb2d42f33
890.72,1.0,53,1,2,2,5,0xb2d39e83
41111.57,1.0,1,2,2,4,8,0xb2d22c7c
8600076.02,12.0,0,4,4,4,12,0xb2d17275
34784.35,1.0,10,2,2,3,7,0xb2d2b7ad
9.5,1.0,30,1,2,2,5,0xb2d2a552
2.21,1.0,53,1,2,2,5,0xb2d43077
46723.53,1.0,0,2,2,4,8,0xb2d55a43
54127.34,2.0,52,3,3,2,8,0xb2d45487
35136.16,1.0,184,2,2,1,5,0xb2d61c8f
259705.46,7.0,9,3,4,3,10,0xb2d14b78
780179.6,3.0,10,4,4,3,11,0xb2d422e0
5.49,1.0,31,1,2,2,5,0xb2d9fdf5
671.02,1.0,24,1,2,2,5,0xb2d1d18d
70111.22,3.0,47,3,4,2,9,0xb2d62cbe
2.0,2.0,9,1,3,3,7,0xb2d98308
103.89,1.0,13,1,2,3,6,0xb2d5f6e8
400062.1,12.0,5,4,4,3,11,0xb2d1dd43
5.95,1.0,13,1,2,3,6,0xb2d88c43
914.69,1.0,25,1,2,2,5,0xb2d0afcc
355104.52,5.0,11,4,4,3,11,0xb2d084ec
100001.59,3.0,27,3,4,2,9,0xb2d921a8
67927.31,1.0,12,3,2,3,8,0xb2d5f8c6
51.88,4.0,11,1,4,3,8,0xb2d1dcc9
30004.01,2.0,21,2,3,2,7,0xb2d956a9
195340.42,6.0,1,3,4,4,11,0xb2d86a8a
16177.2,1.0,184,2,2,1,5,0xb2d28642
35.84,1.0,11,1,2,3,6,0xb2d8039f
10001.06,2.0,45,2,3,2,7,0xb2d161c5
1419958.41,5.0,81,4,4,1,9,0xb2d3a658
10404.1,1.0,92,2,2,1,5,0xb2d42792
54.08,1.0,18,1,2,2,5,0xb2d903a5
12940.53,1.0,0,2,2,4,8,0xb2d34c21
140003.03,3.0,59,3,4,2,9,0xb2d3984f
140050.18,3.0,39,3,4,2,9,0xb2d5ad24
849.71,1.0,28,1,2,2,5,0xb2d0a873
4294.16,1.0,184,2,2,1,5,0xb2d12761
50110.88,2.0,0,2,3,4,9,0xb2d37c7c
300532.68,5.0,1,4,4,4,12,0xb2d0b689
103003.71,2.0,32,3,3,2,8,0xb2d2778b
1.5,1.0,80,1,2,1,4,0xb2d67395
61107.52,1.0,41,3,2,2,7,0xb2d7ad14
6009.95,1.0,8,2,2,3,7,0xb2d2e73b
505821.7,4.0,2,4,4,4,12,0xb2d19fe6
632407.95,4.0,53,4,4,2,10,0xb2d1c3a9
8013.69,1.0,5,2,2,3,7,0xb2d5d5e6
61053.04,2.0,213,3,3,1,7,0xb2d34772
2612.49,1.0,8,1,2,3,6,0xb2d79048
1630.56,1.0,127,1,2,1,4,0xb2d6585b
90006.98,2.0,39,3,3,2,8,0xb2d18b59
297133.87,2.0,37,3,3,2,8,0xb2d86851
10864.27,1.0,30,2,2,2,6,0xb2d37c04
327507.52,3.0,123,4,4,1,9,0xb2d4fd0b
10893.18,1.0,9,2,2,3,7,0xb2d5b0c8
70007.73,3.0,6,3,4,3,10,0xb2d5dcbe
15147.57,1.0,92,2,2,1,5,0xb2d5c9b0
150002.64,3.0,34,3,4,2,9,0xb2d90ad0
1774.69,1.0,0,1,2,4,7,0xb2d93695
1052762.49,5.0,0,4,4,4,12,0xb2d23414
4103.32,5.0,5,2,4,3,9,0x3b9af467
12.5,1.0,57,1,2,2,5,0xb2d7f52d
500000.0,4.0,7,4,4,3,11,0xb2d587c0
260071.71,3.0,50,3,4,2,9,0xb2d5f168
495.44,1.0,8,1,2,3,6,0xb2d2c758
4482.54,1.0,0,2,2,4,8,0xb2d68749
1.26,1.0,31,1,2,2,5,0xb2d96f60
220111.26,4.0,31,3,4,2,9,0xb2d3995f
350097.47,2.0,92,4,3,1,8,0xb2d3cc04
244705.39,3.0,0,3,4,4,11,0xb2d6e67a
2942.23,1.0,10,2,2,3,7,0xb2d78a99
236550.01,2.0,111,3,3,1,7,0xb2d6b866
276002.56,6.0,76,3,4,1,8,0xb2d1390a
352773.8,2.0,53,4,3,2,9,0xb2d2ff72
53.73,1.0,5,1,2,3,6,0xb2d6ca2c
58573.45,1.0,2,3,2,4,9,0xb2d69118
260000.0,2.0,1,3,3,4,10,0xb2d97c60
381008.06,2.0,221,4,3,1,8,0xb2d6ea1a
600000.59,4.0,5,4,4,3,11,0xb2d69c55
50596.43,2.0,11,2,3,3,8,0xb2d4c14b
32949.89,2.0,54,2,3,2,7,0xb2d32619
350000.94,4.0,3,4,4,4,12,0xb2d393c1
190451.62,3.0,1,3,4,4,11,0xb2d5c62b
21431.12,3.0,4,2,4,4,10,0x3b9ada91
50192.92,1.0,184,2,2,1,5,0xb2d5ecd8
6975.54,1.0,1,2,2,4,8,0xb2d3ac35
36074.8,2.0,111,2,3,1,6,0xb2d64a32
470000.0,4.0,6,4,4,3,11,0xb2d95458
501481.23,4.0,18,4,4,2,10,0xb2d2e6f1
126520.45,2.0,56,3,3,2,8,0xb2d0e34a
1365370.81,8.0,5,4,4,3,11,0x3b9b49b6
64008.05,1.0,2,3,2,4,9,0xb2d2ca9b
4082.45,1.0,0,2,2,4,8,0xb2d5948a
1010116.94,3.0,57,4,4,2,10,0xb2d38c44
490000.0,5.0,3,4,4,4,12,0xb2d17257
1585007.71,15.0,0,4,4,4,12,0x3b9ad55e
63007.09,1.0,6,3,2,3,8,0xb2d6b812
393.45,1.0,49,1,2,2,5,0xb2d62fd6
738.04,1.0,40,1,2,2,5,0xb2d5b680
908.44,1.0,2,1,2,4,7,0xb2d36dde
5711.32,1.0,92,2,2,1,5,0xb2d2de16
240008.03,7.0,24,3,4,2,9,0xb2d0e639
56000.59,2.0,28,3,3,2,8,0xb2da09da
710288.0,7.0,1,4,4,4,12,0xb2d23d55
401045.43,4.0,60,4,4,2,10,0xb2d4e9a1
40002.65,2.0,62,2,3,2,7,0xb2d63315
482054.38,3.0,12,4,4,3,11,0xb2d3dba1
104003.92,2.0,0,3,3,4,10,0xb2d8dea7
207957.99,2.0,42,3,3,2,8,0xb2d5fa74
2102011.29,3.0,186,4,4,1,9,0xb2d7fd69
100018.73,3.0,1,3,4,4,11,0xb2d3ae38
1.01,1.0,72,1,2,1,4,0xb2d6431d
243428.42,5.0,11,3,4,3,10,0xb2d67d6c
50190.34,2.0,142,2,3,1,6,0xb2d2ae28
562.85,1.0,1,1,2,4,7,0xb2d3f4e2
50002.64,2.0,216,2,3,1,6,0xb2d67f11
30075.79,3.0,76,2,4,1,7,0xb2d7440b
210747.29,2.0,29,3,3,2,8,0xb2d77fa0
170315.42,2.0,189,3,3,1,7,0xb2d40fa0
500000.0,2.0,0,4,3,4,11,0xb2d7840c
3408.27,1.0,13,2,2,3,7,0xb2d90862
200000.0,3.0,0,3,4,4,11,0xb2d1b90a
5.41,1.0,18,1,2,2,5,0xb2d9d0db
0.0,1.0,92,1,2,1,4,0xb2d3c1f5
155794.96,2.0,208,3,3,1,7,0xb2d56800
3062258.25,4.0,35,4,4,2,10,0xb2d624e0
238135.73,4.0,3,3,4,4,11,0xb2d8ce37
1318001.86,8.0,4,4,4,4,12,0xb2d28946
100000.12,3.0,9,3,4,3,10,0xb2d29f9c
500000.76,3.0,10,4,4,3,11,0xb2d6c4f5
100060.68,2.0,95,3,3,1,7,0xb2d606e3
10588.22,1.0,184,2,2,1,5,0xb2d231cb
483410.97,2.0,23,4,3,2,9,0xb2d98adc
100005.28,2.0,48,3,3,2,8,0xb2d9cd89
10020.15,1.0,2,2,2,4,8,0xb2d0f3d2
20382.46,2.0,94,2,3,1,6,0xb2d64ac1
81.9,1.0,4,1,2,4,7,0xb2d1186d
1369.43,1.0,101,1,2,1,4,0xb2d34b3f
40002.77,3.0,18,2,4,2,8,0xb2d5f357
33820.84,2.0,10,2,3,3,8,0xb2d5300c
3000044.41,4.0,7,4,4,3,11,0xb2d434c7
608010.07,8.0,1,4,4,4,12,0xb2d361fe
311921.71,3.0,7,4,4,3,11,0xb2d350f2
200000.42,2.0,24,3,3,2,8,0xb2d907dd
230085.76,2.0,20,3,3,2,8,0xb2d8d506
200093.07,3.0,129,3,4,1,8,0xb2d43a7e
8469.09,1.0,14,2,2,3,7,0xb2d32c35
201450.14,3.0,15,3,4,3,10,0xb2d1ae20
1386.89,1.0,0,1,2,4,7,0xb2d53f45
50120.48,2.0,214,2,3,1,6,0xb2d63b33
10366.92,2.0,104,2,3,1,6,0xb2d55981
242.05,1.0,36,1,2,2,5,0xb2d9f26e
50144.94,7.0,0,2,4,4,10,0xb2d1dfe7
598753.29,4.0,175,4,4,1,9,0xb2d5ffc5
22962.97,1.0,1,2,2,4,8,0xb2d320f7
40477.38,1.0,2,2,2,4,8,0xb2d51ed8
888151.52,5.0,27,4,4,2,10,0xb2d60cc8
476864.92,14.0,21,4,4,2,10,0xb2d62dc8
135899.01,1.0,3,3,2,4,9,0xb2d60caa
2142.09,1.0,12,1,2,3,6,0xb2d31486
67008.23,2.0,193,3,3,1,7,0xb2d2aeae
2.33,1.0,0,1,2,4,7,0xb2d69218
7787.29,1.0,8,2,2,3,7,0xb2d922d0
300101.97,2.0,8,4,3,3,10,0xb2d6364a
2122.63,1.0,92,1,2,1,4,0xb2d24ec7
30000.0,1.0,8,2,2,3,7,0xb2d50642
100007.96,2.0,167,3,3,1,7,0xb2d24477
107064.59,2.0,217,3,3,1,7,0xb2d1f871
66001.39,2.0,31,3,3,2,8,0xb2d93adb
6.65,1.0,48,1,2,2,5,0xb2d8d115
130.98,1.0,20,1,2,2,5,0xb2d2b693
758.36,1.0,10,1,2,3,6,0xb2d107b5
50051.7,2.0,13,2,3,3,8,0xb2d93201
6304.67,1.0,18,2,2,2,6,0xb2d9c452
582.61,2.0,4,1,3,4,8,0xb2d98115
0.0,1.0,11,1,2,3,6,0xb2d548d5
4611.4,1.0,7,2,2,3,7,0xb2d9cf39
1000006.24,2.0,7,4,3,3,10,0xb2d972b1
2250.59,1.0,184,1,2,1,4,0x3b9b3a8c
1602481.17,7.0,0,4,4,4,12,0xb2d5f856
55972.59,1.0,24,3,2,2,7,0xb2d19c44
666.07,1.0,0,1,2,4,7,0xb2d9684e
337422.66,3.0,81,4,4,1,9,0xb2d7825f
377036.28,6.0,10,4,4,3,11,0xb2d11071
935795.5,7.0,0,4,4,4,12,0xb2d3a457
100011.36,2.0,83,3,3,1,7,0xb2d2462d
15399.74,1.0,15,2,2,3,7,0xb2d31de7
61018.63,1.0,13,3,2,3,8,0xb2d6ab9d
195002.06,2.0,80,3,3,1,7,0xb2d98e79
50000.01,2.0,6,2,3,3,8,0xb2d96cf1
505083.9,2.0,6,4,3,3,10,0xb2d98076
10.94,1.0,45,1,2,2,5,0xb2d3162e
218.09,1.0,7,1,2,3,6,0xb2d6f3ca
568772.41,4.0,31,4,4,2,10,0xb2d5a818
24194.79,1.0,0,2,2,4,8,0xb2d447c1
29.97,1.0,6,1,2,3,6,0xb2d1fcb8
1015.78,1.0,184,1,2,1,4,0xb2d10086
600000.84,4.0,7,4,4,3,11,0xb2d791bf
26100.38,3.0,92,2,4,1,7,0xb2d0fac1
253.33,1.0,29,1,2,2,5,0xb2d9e40c
67.52,1.0,26,1,2,2,5,0xb2d431b5
2073086.51,6.0,4,4,4,4,12,0xb2d19a8c
10847.36,1.0,133,2,2,1,5,0xb2d28a24
34974.01,1.0,3,2,2,4,8,0xb2d1f6ad
10004.54,1.0,52,2,2,2,6,0xb2d866db
616.01,1.0,0,1,2,4,7,0xb2d26655
5.81,1.0,81,1,2,1,4,0xb2d8d439
403904.35,2.0,96,4,3,1,8,0xb2d12936
500949.32,5.0,0,4,4,4,12,0xb2d56457
45.08,1.0,18,1,2,2,5,0xb2d2bd80d
702486.75,3.0,50,4,4,2,10,0xb2d97dbf
8370.38,6.0,92,2,4,1,7,0x3b9b32cc
22000.24,3.0,80,2,4,1,7,0xb2d642af
543.21,1.0,35,1,2,2,5,0xb2d37bca
54198.81,2.0,2,3,3,4,10,0xb2d9ab57
926686.18,8.0,18,4,4,2,10,0xb2d43663
0.0,1.0,7,1,2,3,6,0xb2d69227
3836.55,1.0,1,2,2,4,8,0xb2d35781
1.91,1.0,19,1,2,2,5,0xb2d29e6c
280004.31,8.0,21,3,4,2,9,0x3b9b2529
3957.76,3.0,217,2,4,1,7,0xb2d5c1a1
250026.25,4.0,18,3,4,2,9,0xb2d2751e
210000.0,2.0,12,3,3,3,9,0xb2d96401
32400.26,2.0,8,2,3,3,8,0xb2d6e45e
1256.51,1.0,3,1,2,4,7,0xb2d6deb8
17906.77,1.0,0,2,2,4,8,0xb2d78262
765.01,1.0,9,1,2,3,6,0xb2d2d5f8
400002.5,16.0,0,4,4,4,12,0xb2d6268f
430051.67,3.0,24,4,4,2,10,0xb2d9ba53
10983.94,1.0,10,2,2,3,7,0xb2d5db21
102000.0,4.0,1,3,4,4,11,0xb2d0d3c7d
557.22,1.0,23,1,2,2,5,0xb2d8d023
51095.26,4.0,4,2,4,4,10,0xb2d21bc4
1420.58,1.0,92,1,2,1,4,0xb2d1a2f7d
22.42,1.0,27,1,2,2,5,0xb2d62a7a
530526.53,4.0,11,4,4,3,11,0xb2d1f534
1.36,1.0,18,1,2,2,5,0xb2da06d8
200004.34,2.0,34,3,3,2,8,0xb2d6e6b5
17887.18,1.0,5,2,2,3,7,0xb2d28a15
6437.52,1.0,18,2,2,2,6,0xb2d0d4d3
30355.43,2.0,165,2,3,1,6,0xb2d5d20f
1500614.74,1.0,6,4,2,3,9,0xb2d5e4bc
24999.42,1.0,0,2,2,4,8,0xb2d2c80d
207114.24,2.0,129,3,3,1,7,0xb2d6820a
3018.0,1.0,7,2,2,3,7,0xb2d58e7e
194252.41,4.0,1,3,4,4,11,0xb2d6967c
90012.67,3.0,24,3,4,2,9,0xb2d92b8e
314.43,3.0,2,1,4,4,9,0xb2d069d7
160324.28,5.0,104,3,4,1,8,0xb2d07050
47229.25,1.0,8,2,2,3,7,0xb2d936fc
4671363.88,5.0,11,4,4,3,11,0xb2d632a7
3265.0,1.0,3,2,2,4,8,0xb2d6e7a3
15647.04,1.0,1,2,2,4,8,0xb2d6c19c
4277.54,1.0,0,2,2,4,8,0xb2d17655
1408.96,1.0,25,1,2,2,5,0xb2d69860
525785.92,5.0,30,4,4,2,10,0xb2d247b7
160294.54,4.0,73,3,4,1,8,0xb2d32195
74140.84,1.0,8,3,2,3,8,0xb2d2d75d
4638.66,1.0,92,2,2,1,5,0xb2d2fafe
20406.89,3.0,17,2,4,2,8,0xb2d38fce
50002.85,2.0,147,2,3,1,6,0xb2d683a7
4.03,3.0,54,1,4,2,7,0xb2d5587a
111.85,1.0,30,1,2,2,5,0xb2d3aaf7
53.59,3.0,0,1,4,4,9,0xb2d210c3
163306.53,3.0,92,3,4,1,8,0xb2d09666
506204.63,2.0,8,4,3,3,10,0xb2d70182
24337.07,1.0,92,2,2,1,5,0xb2d3b3e6
6361.37,1.0,0,2,2,4,8,0xb2d6b84d
126570.04,2.0,263,3,3,1,7,0xb2d12079
463.29,1.0,0,1,2,4,7,0xb2d17c90
579385.99,5.0,96,4,4,1,9,0xb2d5aa1c
100001.06,2.0,25,3,3,2,8,0xb2da1511
119.92,1.0,4,1,2,4,7,0xb2d2ae92
100.63,1.0,8,1,2,3,6,0xb2d42d36
79514.36,3.0,111,3,4,1,8,0xb2d0ce9b
4316.69,1.0,32,2,2,2,6,0xb2d67d8d
2210308.37,2.0,26,4,3,2,9,0xb2d6560c
1599.41,1.0,184,1,2,1,4,0xb2d3292e
270001.27,3.0,18,3,4,2,9,0xb2d94d22
15111.05,1.0,92,2,2,1,5,0xb2d59764
631.48,1.0,0,1,2,4,7,0xb2d65017
105829.97,2.0,32,3,3,2,8,0xb2d1c05a
1899979.51,10.0,6,4,4,3,11,0xb2d473d8
1426.79,1.0,1,1,2,4,7,0xb2d5edab
4650.16,1.0,27,2,2,2,6,0xb2d62042
53018.34,2.0,192,3,3,1,7,0xb2d2d513
3213.49,1.0,7,2,2,3,7,0xb2d3e970
410.62,1.0,1,1,2,4,7,0xb2d44b1d
8082.54,1.0,235,2,2,1,5,0xb2d30fc7
2017.94,1.0,10,1,2,3,6,0xb2d78191
435.36,1.0,9,1,2,3,6,0xb2d2eea3
2239055.3,4.0,13,4,4,3,11,0xb2d51f35
2347.18,1.0,14,1,2,3,6,0xb2d8f23d
5649.01,1.0,1,2,2,4,8,0xb2d3bd7e
80541.91,3.0,18,3,4,2,9,0xb2d2959e
3946.97,3.0,21,2,4,2,8,0x3b9ae85a
10575.18,1.0,65,2,2,2,6,0xb2d6ada0
4.88,1.0,82,1,2,1,4,0xb2d1b50f
3.46,1.0,66,1,2,2,5,0xb2d8d066
15407.75,1.0,7,2,2,3,7,0xb2d2c19d
354608.95,9.0,19,4,4,2,10,0xb2d4f800
1053.06,1.0,184,1,2,1,4,0xb2d203c2
514924.4,4.0,69,4,4,1,9,0xb2d2213e
645313.12,8.0,0,4,4,4,12,0xb2d5df75
115004.07,4.0,48,3,4,2,9,0xb2d351d0
50521.14,1.0,1,2,2,4,8,0xb2d9bf54
301017.82,3.0,21,4,4,2,10,0xb2d17f63
180015.53,4.0,3,3,4,4,11,0xb2d68c32
206746.79,1.0,22,3,2,2,7,0xb2d06d49
2623172.74,5.0,25,4,4,2,10,0xb2d12c88
69797.27,1.0,184,3,2,1,6,0xb2d32295
110028.64,4.0,203,3,4,1,8,0xb2d61e27
223909.89,2.0,135,3,3,1,7,0xb2d8e6e1
77.29,1.0,18,1,2,2,5,0xb2d268d8
638337.99,2.0,11,4,3,3,10,0xb2d30196
203558.8,2.0,8,3,3,3,9,0xb2d6d3e6
183464.03,5.0,0,3,4,4,11,0xb2d1f68fd
8061.96,1.0,235,2,2,1,5,0xb2d68233
5351.78,8.0,66,2,4,2,8,0xb2d087ed
151046.71,9.0,5,3,4,3,10,0xb2d1e340
73345.62,2.0,179,3,3,1,7,0xb2d45e5dd
220434.37,5.0,14,3,4,3,10,0xb2d61e6e
14039.36,1.0,184,2,2,1,5,0xb2d53489
10000.11,2.0,55,2,3,2,7,0xb2d903a0
1951.2,1.0,4,1,2,4,7,0xb2d912fd
205013.05,2.0,1,3,3,4,10,0xb2d5ebee
82.63,1.0,0,1,2,4,7,0xb2d64bf8
87.95,2.0,0,1,3,4,8,0xb2d09101
8736.72,1.0,3,2,2,4,8,0xb2d39556
1354.72,1.0,129,1,2,1,4,0xb2d5da0f
10927.15,1.0,4,2,2,4,8,0xb2d233f5
1662.36,1.0,94,1,2,1,4,0xb2d3292c
2900000.0,3.0,0,4,4,4,12,0xb2d239ea
60.79,1.0,92,1,2,1,4,0xb2d2cada
13194.86,2.0,0,2,3,4,9,0xb2d2b016
201717.89,2.0,62,3,3,2,8,0xb2d615d4
101132.36,1.0,3,3,2,4,9,0xb2d78f44
2000000.0,2.0,67,4,3,1,8,0xb2d9b26d
70066.79,2.0,98,3,3,1,7,0xb2d15cfd
0.0,1.0,0,1,2,4,7,0xb2da57a9
2354.24,1.0,0,1,2,4,7,0xb2d3ea45
51245.78,1.0,3,2,2,4,8,0xb2d25ed6
922357.85,3.0,0,4,4,4,12,0xb2d2675a
343013.73,3.0,74,4,4,1,9,0xb2d16c68
8303.04,1.0,4,2,2,4,8,0xb2d91e6d
50044.65,2.0,136,2,3,1,6,0xb2d3e067
50061.03,2.0,179,2,3,1,6,0xb2d0f87f
22038.05,1.0,10,2,2,3,7,0xb2d917c7
8368.22,1.0,0,2,2,4,8,0xb2d6bf75
170196.18,1.0,1,3,2,4,9,0xb2d109b6
11937.17,1.0,0,2,2,4,8,0xb2d70152
38.88,1.0,67,1,2,1,4,0xb2d641b9
295505.01,3.0,171,3,4,1,8,0xb2d13f71
100966.65,1.0,137,3,2,1,6,0xb2d62528
60396.68,2.0,0,3,3,4,10,0xb2d39854
3435014.86,10.0,1,4,4,4,12,0xb2d2277b
990017.15,3.0,102,4,4,1,9,0xb2d14fa6
1159.58,2.0,184,1,3,1,5,0xb2d11ee7
13120.32,2.0,104,2,3,1,6,0xb2d2e5d2
500000.0,4.0,2,4,4,4,12,0xb2d989de
433970.74,5.0,58,4,4,2,10,0xb2d5d901
101514.82,1.0,0,3,2,4,9,0xb2d5d39a
52061.23,2.0,80,2,3,1,6,0xb2d4fc34
40672.98,2.0,54,2,3,2,7,0xb2d570f3
12953.05,1.0,184,2,2,1,5,0x3b9b2ea6
208000.0,12.0,0,3,4,4,11,0xb2d6550b
130000.0,2.0,1,3,3,4,10,0xb2d61b11
401085.67,3.0,0,4,4,4,12,0xb2d62949
46430.3,1.0,10,2,2,3,7,0xb2d2977c
1500085.09,5.0,0,4,4,4,12,0xb2d96407
717.51,1.0,10,1,2,3,6,0xb2d9b9f8
1105.82,1.0,10,1,2,3,6,0xb2d68aa6
228545.73,1.0,4,3,2,4,9,0xb2d548ae
700006.7,4.0,0,4,4,4,12,0xb2d33576
1400.76,2.0,184,1,3,1,5,0xb2d0b346
0.84,1.0,75,1,2,1,4,0xb2d98110
0.0,1.0,7,1,2,3,6,0xb2d97441
10097.77,1.0,14,2,2,3,7,0xb2d6bd4b
1407581.95,29.0,6,4,4,3,11,0xb2d0f1bd
162062.26,2.0,18,3,3,2,8,0xb2d36e3a
3181.41,1.0,15,2,2,3,7,0xb2d94615
607.13,1.0,23,1,2,2,5,0xb2d297fa
30036.37,2.0,26,2,3,2,7,0xb2d5933d
30000316.7,3.0,24,4,4,2,10,0xb2d6a689
83541.84,2.0,0,3,3,4,10,0xb2d0a317
459059.06,4.0,3,4,4,4,12,0xb2d1a2ab
116166.56,4.0,95,3,4,1,8,0xb2d604b3
727656.78,2.0,33,4,3,2,9,0xb2d189c5
152000.7,3.0,34,3,4,2,9,0xb2d2ee87
100003.17,2.0,94,3,3,1,7,0xb2d8693a
110285.25,6.0,1,3,4,4,11,0xb2d5d1f4
54009.82,2.0,46,3,3,2,8,0xb2d903bb
23072.19,1.0,9,2,2,3,7,0xb2d2c3f6
50000.53,2.0,35,2,3,2,7,0xb2d9fb24
457356.72,3.0,24,4,4,2,10,0xb2d68e3b
100103.39,2.0,213,3,3,1,7,0xb2d683c1
401000.34,4.0,0,4,4,4,12,0xb2d0e63b
74891.32,1.0,4,3,2,4,9,0xb2d87f39
100016.95,2.0,41,3,3,2,8,0xb2d1cc3f
220013.66,3.0,77,3,4,1,8,0xb2d2c354
200006.33,2.0,39,3,3,2,8,0xb2d9ebaa
602131.38,2.0,16,4,3,2,9,0xb2d91ca6
250.45,1.0,9,1,2,3,6,0xb2d5abc2
27022.36,2.0,37,2,3,2,7,0xb2d6afbd
82442.12,1.0,62,3,2,2,7,0xb2d1238b
1000170.86,4.0,13,4,4,3,11,0xb2d11d91
15312.32,1.0,21,2,2,2,6,0xb2d229dc
35.21,1.0,5,1,2,3,6,0xb2d40b85
403148.12,3.0,4,4,4,4,12,0xb2d5b5a9
65840.3,2.0,118,3,3,1,7,0xb2d288d4
116.62,1.0,2,1,2,4,7,0xb2d8104d
4470.36,2.0,184,2,3,1,6,0x3b9b32d1
68.52,1.0,8,1,2,3,6,0xb2d9631e
40449.8,1.0,116,2,2,1,5,0xb2d69a86
234001.42,3.0,7,3,4,3,10,0xb2d91d25
2650182.61,5.0,8,4,4,3,11,0xb2d9f7e3
8000.0,1.0,3,2,2,4,8,0xb2d53c2e
1314361.89,8.0,14,4,4,3,11,0xb2d308ef
20.59,1.0,24,1,2,2,5,0xb2d8cfa9
601868.86,8.0,30,4,4,2,10,0x3b9af267
846017.03,11.0,3,4,4,4,12,0xb2d0b3f7
2076084.0,5.0,175,4,4,1,9,0xb2d414d7
170183.91,3.0,188,3,4,1,8,0xb2d140b6
1603072.12,10.0,4,4,4,4,12,0xb2d117fd
115.91,1.0,26,1,2,2,5,0xb2d6b193
567892.95,2.0,116,4,3,1,8,0xb2d28d3d
15922.52,1.0,92,2,2,1,5,0xb2d100ed
186699.9,3.0,18,3,4,2,9,0xb2d16c10
205690.91,2.0,91,3,3,1,7,0xb2d6b4c3
5011.83,1.0,13,2,2,3,7,0xb2d3653b
150001.58,2.0,108,3,3,1,7,0xb2d7b0a2
71267.96,2.0,92,3,3,1,7,0xb2d359fc
28992.46,1.0,8,2,2,3,7,0xb2d92ee2
4411.3,1.0,10,2,2,3,7,0xb2d6f619
336427.69,4.0,2,4,4,4,12,0x3b9b4859
50211.72,1.0,26,2,2,2,6,0xb2d1dc7c
190.02,2.0,39,1,3,2,6,0xb2d6ecf3
1932684.7,5.0,78,4,4,1,9,0xb2d2fb43
42626.8,1.0,8,2,2,3,7,0xb2d207bd
251776.4,2.0,75,3,3,1,7,0xb2d8e0b7
111097.21,4.0,0,3,4,4,11,0xb2d0694e
163.73,1.0,27,1,2,2,5,0xb2d37c4c
110000.0,2.0,3,3,3,4,10,0xb2d5b13a
1558.69,1.0,9,1,2,3,6,0xb2d568dc
652317.64,4.0,3,4,4,4,12,0xb2d78bdd
50013.24,17.0,92,2,4,1,7,0x3b9b2912
16326.15,1.0,2,2,2,4,8,0xb2d3f696d
332003.35,5.0,20,4,4,2,10,0xb2d1f0e3
50005.96,2.0,92,2,3,1,6,0xb2d58750
130075.37,2.0,1,3,3,4,10,0xb2d95110
431209.03,6.0,97,4,4,1,9,0xb2d1b262
5106.73,1.0,9,2,2,3,7,0xb2d6520f
37613.14,1.0,4,2,2,4,8,0xb2d97eee
88005.05,4.0,18,3,4,2,9,0xb2d1b3d5
600935.01,3.0,60,4,4,2,10,0xb2d3e486
623.99,1.0,157,1,2,1,4,0xb2d5abd3
51883.81,1.0,92,2,2,1,5,0xb2d610d6
832977.44,2.0,143,4,3,1,8,0xb2d1f7a2
220000.0,6.0,0,3,4,4,11,0xb2d53ad4
685723.4,4.0,0,4,4,4,12,0xb2d54bec
428346.26,9.0,39,4,4,2,10,0xb2d18dca
1502.55,1.0,165,1,2,1,4,0xb2d1b82cd
89661.5,1.0,184,3,2,1,6,0xb2d3c81f
281713.06,4.0,29,3,4,2,9,0xb2d61434
300143.05,2.0,182,4,3,1,8,0xb2d10d38
343256.87,4.0,1,4,4,4,12,0xb2d53f00
10000.0,1.0,184,2,2,1,5,0xb2d29d05
5.36,1.0,33,1,2,2,5,0xb2d6ddab
469028.67,4.0,130,4,4,1,9,0xb2d1ce07d
17195.34,1.0,21,2,2,2,6,0xb2d964c2
517604.84,4.0,22,4,4,2,10,0xb2d65933
130000.79,2.0,5,3,3,3,9,0xb2d682db
85.05,1.0,66,1,2,2,5,0xb2d441be
1516.83,1.0,10,1,2,3,6,0xb2d92225
350659.24,3.0,12,4,4,3,11,0xb2d65bc9
7500.58,1.0,70,2,2,1,5,0xb2d352de
217.46,1.0,4,1,2,4,7,0xb2d2e178
253193.35,2.0,1,3,3,4,10,0xb2d5eece
1491887.45,5.0,22,4,4,2,10,0xb2d68f0e
2204.27,1.0,11,1,2,3,6,0xb2d25f0a
200710.42,2.0,40,3,3,2,8,0xb2d928ca
291359.32,15.0,0,3,4,4,11,0xb2d62dea
19019.51,2.0,3,2,3,4,9,0xb2d8dd24
216.47,1.0,2,1,2,4,7,0xb2d31c22
8960.55,1.0,0,2,2,4,8,0xb2d38297
30.11,2.0,0,1,3,4,8,0xb2d96076
22177.79,1.0,8,2,2,3,7,0xb2d2da10
548000.0,10.0,0,4,4,4,12,0xb2d25324
1424.57,1.0,24,1,2,2,5,0xb2d3c835
52029.58,1.0,18,2,2,2,6,0xb2d5d481
69070.75,2.0,115,3,3,1,7,0xb2d78100
400552.39,3.0,14,4,4,3,11,0xb2d9602d
200000.0,2.0,26,3,3,2,8,0xb2da14da
1271.34,1.0,11,1,2,3,6,0xb2d65990
1073.24,1.0,184,1,2,1,4,0xb2d53fd3
43.61,1.0,18,1,2,2,5,0xb2d8d11d
270010.27,7.0,19,3,4,2,9,0xb2d07c6d
30103.65,2.0,0,2,3,4,9,0xb2d93299
13538.22,1.0,0,2,2,4,8,0xb2d5d313
1462.73,1.0,11,1,2,3,6,0xb2d2bbd9
91951.54,3.0,59,3,4,2,9,0xb2d5d52a
779.61,1.0,9,1,2,3,6,0xb2d375cb
1090.99,1.0,0,1,2,4,7,0xb2d3490a
17123.54,2.0,19,2,3,2,7,0xb2d90bd3
1874.73,1.0,144,1,2,1,4,0xb2d8d8ec
21569.65,1.0,1,2,2,4,8,0xb2d52b8d
2.11,1.0,34,1,2,2,5,0xb2d92f08
170898.15,3.0,66,3,4,2,9,0xb2d129e3
100001.62,4.0,39,3,4,2,9,0xb2d90a26
1381109.3,2.0,0,4,3,4,11,0xb2d2de3d
62.68,1.0,9,1,2,3,6,0xb2d50c89
2616068.97,3.0,5,4,4,3,11,0xb2d406cb
230000.06,3.0,1,3,4,4,11,0xb2d23a55
5075.67,2.0,0,2,3,4,9,0x3b9af1aa
6.27,1.0,0,1,2,4,7,0xb2d91353
111.2,1.0,18,1,2,2,5,0xb2d99f88
3982.18,1.0,176,2,2,1,5,0xb2d33d33
163690.7,2.0,83,3,3,1,7,0xb2d3b62b
100093.94,1.0,98,3,2,1,6,0xb2d85b6b
78.91,1.0,231,1,2,1,4,0xb2d60144
650592.02,7.0,2,4,4,4,12,0xb2d700b0
400083.53,2.0,0,4,3,4,11,0xb2d93b87
200710.52,2.0,34,3,3,2,8,0xb2d8d9d3
610000.0,4.0,88,4,4,1,9,0xb2d378c8
521.97,1.0,70,1,2,1,4,0xb2d6ca4e
760095.73,5.0,3,4,4,4,12,0xb2d88bfe
56688.25,7.0,4,3,4,4,11,0x3b9af1ab
67322.95,1.0,92,3,2,1,6,0xb2d288f7
2929.03,1.0,1,2,2,4,8,0xb2d653c7
1965782.08,8.0,0,4,4,4,12,0xb2d55249
3748.21,2.0,184,2,3,1,6,0xb2d22a84
1607196.2,9.0,1,4,4,4,12,0xb2d5e2cb
20262.8,3.0,53,2,4,2,8,0xb2d574cb
2.74,1.0,52,1,2,2,5,0xb2d99de0
318573.99,4.0,1,4,4,4,12,0xb2d3bd30
350000.0,1.0,0,4,2,4,10,0xb2d4535c
19120.96,3.0,2,2,4,4,10,0xb2d4027fd
82874.15,1.0,49,3,2,2,7,0xb2d37c48
32373.69,2.0,0,2,3,4,9,0x3b9b1a1a
80004.22,2.0,98,3,3,1,7,0xb2d966dad
24603.17,1.0,1,2,2,4,8,0xb2d5d783
370080.44,6.0,48,4,4,2,10,0xb2d16b37
330027.15,2.0,10,4,3,3,10,0xb2d96bdd
0.74,1.0,7,1,2,3,6,0xb2da17e8
450000.0,2.0,26,4,3,2,9,0xb2da166a
130029.35,2.0,13,3,3,3,9,0xb2d2b3d0
190004.22,3.0,6,3,4,3,10,0xb2d6a54a
10449.17,2.0,3,2,3,4,9,0xb2d62fcb
22077.26,1.0,5,2,2,3,7,0xb2d2d306
12728.38,1.0,10,2,2,3,7,0xb2d5cf74
15500.0,1.0,5,2,2,3,7,0xb2d92437
423993.57,7.0,2,4,4,4,12,0xb2d0e3e9
900072.46,7.0,0,4,4,4,12,0xb2d4519a
8191.06,1.0,8,2,2,3,7,0xb2da05fe
2139.78,1.0,92,1,2,1,4,0xb2d2b017
972961.39,7.0,0,4,4,4,12,0xb2d0b44b
1227480.79,3.0,0,4,4,4,12,0xb2d3af52
1.59,2.0,18,1,3,2,6,0xb2d0b574
2433.46,2.0,1,1,3,4,8,0x3b9b2798
3626.26,2.0,18,2,3,2,7,0xb2d53a1a
777820.24,5.0,2,4,4,4,12,0xb2d41445
1507.76,1.0,184,1,2,1,4,0xb2d3507f
150047.8,3.0,18,3,4,2,9,0xb2d1998b
614024.5,15.0,4,4,4,4,12,0xb2d51737
1285.0,1.0,92,1,2,1,4,0xb2d0fa6a
120111.22,3.0,11,3,4,3,10,0xb2d4ec55
0.0,1.0,1,1,2,4,7,0xb2d63244
400045.46,3.0,14,4,4,3,11,0xb2d13c86
55.93,1.0,6,1,2,3,6,0xb2d94d91
200710.85,2.0,30,3,3,2,8,0xb2d9bc56
10404.76,2.0,12,2,3,3,8,0xb2d17444
505055.83,3.0,25,4,4,2,10,0xb2d2d347
220707.71,2.0,1,3,3,4,10,0xb2d68de9
200000.06,2.0,10,3,3,3,9,0xb2d823bc
530018.13,1.0,11,4,2,3,9,0xb2d31606
304712.1,14.0,0,4,4,4,12,0xb2d28374
500099.33,3.0,12,4,4,3,11,0xb2d5e073
3.69,1.0,69,1,2,1,4,0xb2d9a3d8
100212.29,1.0,210,3,2,1,6,0xb2d68b46
3055.51,2.0,184,2,3,1,6,0x3b9b12c9
200685.03,2.0,0,3,3,4,10,0xb2d95460
1000040.12,4.0,42,4,4,2,10,0xb2d6344f
34503.55,1.0,9,2,2,3,7,0xb2d52c56
60023.43,1.0,18,3,2,2,7,0xb2d90f1a
250021.11,2.0,55,3,3,2,8,0xb2d4fe42
30056.23,1.0,46,2,2,2,6,0xb2d1641f
60009.0,2.0,0,3,3,4,10,0xb2d97f59
110062.61,2.0,108,3,3,1,7,0xb2d19fad
30000.85,3.0,4,2,4,4,10,0xb2da008b
5000125.0,2.0,0,4,3,4,11,0xb2da65e1
200000.0,2.0,25,3,3,2,8,0xb2d6efa5
76016.14,4.0,48,3,4,2,9,0xb2d6d3f7
109.88,1.0,1,1,2,4,7,0xb2d94a8a
51627.08,1.0,1,2,2,4,8,0xb2d6b06e
409493.62,6.0,0,4,4,4,12,0xb2d37162
928.8,1.0,32,1,2,2,5,0xb2d988b3
661287.23,3.0,0,4,4,4,12,0xb2d61295
147344.29,2.0,95,3,3,1,7,0xb2d60829
0.0,2.0,48,1,3,2,6,0xb2d5dac2
2758.95,1.0,92,1,2,1,4,0xb2d10328
400032.06,3.0,10,4,4,3,11,0xb2d6ba9b
1281.55,3.0,184,1,4,1,6,0xb2d22ead
80000.0,3.0,1,3,4,4,11,0xb2d0dfa1
501776.04,2.0,34,4,3,2,9,0xb2d93551
45211.92,2.0,0,2,3,4,9,0xb2d2b5aa
50014.57,2.0,129,2,3,1,6,0xb2d547e6
50004.11,2.0,0,2,3,4,9,0xb2d93038
1242.15,1.0,4,1,2,4,7,0xb2d3ecdc
60006.02,2.0,27,3,3,2,8,0xb2d27a40
7.49,1.0,10,1,2,3,6,0xb2d6fd8d
37292.68,2.0,2,2,3,4,9,0xb2d0a26b
350000.0,2.0,3,4,3,4,11,0xb2d96a9b
20076.58,1.0,19,2,2,2,6,0xb2d6b9b2
215.71,1.0,84,1,2,1,4,0xb2d2a063
3890321.79,5.0,62,4,4,2,10,0xb2d33b2f
704787.33,9.0,9,4,4,3,11,0xb2d37527
200007.11,7.0,20,3,4,2,9,0xb2d631f0
95034.07,3.0,9,3,4,3,10,0xb2d32739
63.75,1.0,92,1,2,1,4,0xb2d2fca2d
17398.26,1.0,4,2,2,4,8,0xb2d2a80c
3053.4,1.0,2,2,2,4,8,0xb2d6c69e
50107.01,2.0,228,2,3,1,6,0xb2d6937f
560.35,1.0,9,1,2,3,6,0xb2d4291f
2387.92,1.0,0,1,2,4,7,0xb2d4cb4f
547671.0,44.0,1,4,4,4,12,0xb2d09a48
70002.21,4.0,39,3,4,2,9,0xb2d946bcd
1002058.08,2.0,28,4,3,2,9,0xb2d5730b
210651.15,8.0,0,3,4,4,11,0xb2d06879
320029.73,3.0,1,4,4,4,12,0xb2d909d0
140012.92,3.0,25,3,4,2,9,0xb2d2cbc6
156081.82,3.0,60,3,4,2,9,0xb2d61867
4699.59,1.0,10,2,2,3,7,0xb2d5cd6c
29963.95,2.0,7,2,3,3,8,0xb2d23141
0.0,1.0,5,1,2,3,6,0xb2d2a831
200000.0,2.0,9,3,3,3,9,0xb2d79106d
15000.0,1.0,4,2,2,4,8,0xb2d6aba1
5.82,5.0,11,1,4,3,8,0xb2d78b5b
1021.26,1.0,184,1,2,1,4,0xb2d31983
114395.95,2.0,0,3,3,4,10,0xb2d2e9f0
2208.72,1.0,3,1,2,4,7,0xb2d2df59
50041.76,2.0,140,2,3,1,6,0xb2d32f82
114346.71,3.0,130,3,4,1,8,0xb2d1015b
502552.68,2.0,49,4,3,2,9,0xb2d8da7c
76726.51,1.0,10,3,2,3,8,0xb2d3e46b
99.9,1.0,50,1,2,2,5,0xb2d9b07c
18063.34,1.0,6,2,2,3,7,0xb2d424f5
3.18,1.0,29,1,2,2,5,0xb2d6e915
279.6,1.0,0,1,2,4,7,0xb2d97c5d
180000.82,6.0,4,3,4,4,11,0xb2d154f3
309057.7,4.0,27,4,4,2,10,0xb2d1c326
1061.28,2.0,146,1,3,1,5,0xb2d2cbf6
7273.14,1.0,7,2,2,3,7,0xb2d6b704
30293.27,1.0,92,2,2,1,5,0xb2d2a6b4
29599.42,2.0,16,2,3,2,7,0xb2d2d1bbd
2954.73,1.0,184,2,2,1,5,0xb2d1fcbb
28499.1,1.0,29,2,2,2,6,0xb2d42b62
2345.46,1.0,0,1,2,4,7,0xb2d91582
15020.95,1.0,1,2,2,4,8,0xb2d27c49
300927.8,3.0,27,4,4,2,10,0xb2d84d7e
118800.07,2.0,3,3,3,4,10,0xb2d210d0
1630045.92,4.0,80,4,4,1,9,0xb2d4554c
3745.43,1.0,15,2,2,3,7,0xb2d32e2b
3069.17,10.0,89,2,4,1,7,0xb2d117fdd
327468.54,9.0,0,4,4,4,12,0x3b9b4880
11353.41,2.0,77,2,3,1,6,0xb2d5f60e
1071363.49,3.0,80,4,4,1,9,0xb2d0a862
50000.0,2.0,6,2,3,3,8,0xb2da52cf
1415.06,1.0,92,1,2,1,4,0xb2d25c9b
12214.75,1.0,29,2,2,2,6,0xb2d1f820
500005.28,2.0,39,4,3,2,9,0xb2d9f1d2
7026.83,1.0,0,2,2,4,8,0xb2d95bfe
160000.0,2.0,0,3,3,4,10,0xb2d97c78
23020.36,3.0,2,2,4,4,10,0xb2d09cac
671.12,1.0,8,1,2,3,6,0xb2d68666
360198.16,3.0,41,4,4,2,10,0xb2d22e7d
402081.93,2.0,6,4,3,3,10,0xb2d59660
3072751.22,4.0,5,4,4,3,11,0xb2d634d4
2524434.08,3.0,50,4,4,2,10,0xb2d6a389
35629.84,1.0,11,2,2,3,7,0xb2d4ac38
2213.04,1.0,2,1,2,4,7,0xb2d4358c
71715.26,1.0,0,3,2,4,9,0xb2d2838e
5082.32,2.0,0,2,3,4,9,0xb2d0a5d8
2800047.12,3.0,11,4,4,3,11,0xb2d8e884
14368.58,1.0,0,2,2,4,8,0xb2d31547
1060415.85,6.0,25,4,4,2,10,0xb2d63a4f
1460.36,1.0,6,1,2,3,6,0xb2d5b8de
7977.69,1.0,92,2,2,1,5,0xb2d2653a
0.01,1.0,49,1,2,2,5,0xb2d97144
1000080.68,3.0,8,4,4,3,11,0xb2d7f37d
8316.63,2.0,22,2,3,2,7,0xb2d6d9bd
261535.31,4.0,30,3,4,2,9,0xb2d5d078
101463.92,3.0,12,3,4,3,10,0xb2d1bd67
4697421.13,17.0,0,4,4,4,12,0xb2d366d4
10000.21,2.0,10,2,3,3,8,0xb2d94794
484.73,1.0,9,1,2,3,6,0xb2d6c0c1
50516.24,2.0,4,2,3,4,9,0xb2d69e84
500232.55,2.0,20,4,3,2,9,0xb2d0eeda
100161.16,2.0,73,3,3,1,7,0xb2d4b896
143019.81,3.0,42,3,4,2,9,0xb2d619ac
100561.67,1.0,168,3,2,1,6,0xb2d78a55
50000.0,2.0,1,2,3,4,9,0xb2da61db
160053.47,4.0,11,3,4,3,10,0xb2d4151c
132264.37,2.0,116,3,3,1,7,0xb2d1ca44
16.99,1.0,84,1,2,1,4,0xb2d93012
2590000.0,7.0,0,4,4,4,12,0xb2d54e6a
100080.58,3.0,34,3,4,2,9,0xb2d5634e
150001.06,3.0,158,3,4,1,8,0xb2d5061f
6.9,1.0,17,1,2,2,5,0xb2d6ca9d
82.49,1.0,13,1,2,3,6,0xb2d77682
403006.74,1.0,46,4,2,2,8,0xb2d29297
440000.4,9.0,4,4,4,4,12,0xb2d4b36d
110001.06,3.0,1,3,4,4,11,0xb2da38b7
97060.14,3.0,70,3,4,1,8,0xb2d07fee
155243.69,2.0,25,3,3,2,8,0xb2d16b54
100015.38,2.0,61,3,3,2,8,0xb2d9b01a
125551.24,2.0,53,3,3,2,8,0xb2d0beced
51451.69,2.0,59,2,3,2,7,0xb2d60629
70010.34,2.0,30,3,3,2,8,0xb2d6d031
1740164.45,4.0,41,4,4,2,10,0xb2d08cf5
1360.64,2.0,0,1,3,4,8,0x3b9b3701
20529.26,1.0,10,2,2,3,7,0xb2d8d46b
7.83,1.0,41,1,2,2,5,0xb2d0af9f
4463.64,1.0,0,2,2,4,8,0xb2d959ed
100008.82,4.0,94,3,4,1,8,0xb2d1a0c1
2089.45,1.0,12,1,2,3,6,0xb2d64262
81637.18,2.0,80,3,3,1,7,0xb2d5a826
130003.49,3.0,83,3,4,1,8,0xb2d75485
750089.9,3.0,173,4,4,1,9,0xb2d0f33b
7.34,1.0,1,1,2,4,7,0xb2d19e66
90145.1,2.0,97,3,3,1,7,0xb2d15986
27246.87,3.0,0,2,4,4,10,0x3b9b0fd8
557492.42,5.0,92,4,4,1,9,0xb2d2d4d0
227298.47,3.0,14,3,4,3,10,0xb2d41435
2741.75,1.0,0,1,2,4,7,0xb2d31843
584623.75,4.0,0,4,4,4,12,0xb2d2213ed
117.81,1.0,1,1,2,4,7,0xb2d28339
47714.49,2.0,3,2,3,4,9,0xb2d17c32
44854.54,1.0,9,2,2,3,7,0xb2d238df
800022.36,4.0,6,4,4,3,11,0x3b9b4926
718.13,1.0,10,1,2,3,6,0xb2da35de
967422.91,7.0,5,4,4,3,11,0xb2d4fdf7
2965.25,1.0,0,2,2,4,8,0xb2d614fa
2519.22,2.0,0,1,3,4,8,0x3b9b264c
132.38,1.0,22,1,2,2,5,0xb2d1fb36
13.28,1.0,33,1,2,2,5,0xb2d98a69
1377.18,1.0,6,1,2,3,6,0xb2d40de3
2920000.85,30.0,4,4,4,4,12,0xb2d22553
168111.53,2.0,125,3,3,1,7,0xb2d2cdce
10102647.2,4.0,0,4,4,4,12,0xb2d16de2
21745.19,1.0,184,2,2,1,5,0xb2d37c12
51324.98,2.0,6,2,3,3,8,0xb2d1da7e
7142.51,1.0,92,2,2,1,5,0xb2d20d5c
1394.64,1.0,165,1,2,1,4,0xb2d5e668
269208.68,3.0,0,3,4,4,11,0xb2d6430e
1060827.23,3.0,33,4,4,2,10,0xb2d89f9d
762119.08,2.0,129,4,3,1,8,0xb2d63730
20535.66,2.0,48,2,3,2,7,0xb2d65e28
433296.83,7.0,17,4,4,2,10,0xb2d5b28a
7975.84,1.0,0,2,2,4,8,0xb2d8f6b7
234564.41,4.0,108,3,4,1,8,0xb2d4f4f8
1260628.58,9.0,6,4,4,3,11,0xb2d3bd76
250031.33,3.0,1,3,4,4,11,0x3b9b33bd
16565.22,1.0,92,2,2,1,5,0xb2d3b950
2328.02,1.0,61,1,2,2,5,0xb2d54963
50202.76,2.0,18,2,3,2,7,0xb2d17aac
28852.5,6.0,11,2,4,3,9,0xb2d0f2ff
325495.47,2.0,3,4,3,4,11,0xb2d0d665
3000000.0,1.0,7,4,2,3,9,0xb2d96fb2
10708.18,1.0,10,2,2,3,7,0xb2d925ac
936.09,1.0,10,1,2,3,6,0xb2d6b6f9
3650.15,1.0,10,2,2,3,7,0xb2d624ce
89021.82,1.0,8,3,2,3,8,0xb2d3483a
668.17,1.0,10,1,2,3,6,0xb2d988b5
406180.47,3.0,43,4,4,2,10,0xb2d3c2eb
3134435.56,5.0,0,4,4,4,12,0x3b9b1846
4657.28,1.0,1,2,2,4,8,0xb2d36878
1642015.46,6.0,11,4,4,3,11,0xb2d08761
490059.18,4.0,5,4,4,3,11,0xb2d99f60
3.76,1.0,36,1,2,2,5,0xb2d6f614
7978.45,1.0,1,2,2,4,8,0xb2d457d4
2130880.36,21.0,4,4,4,4,12,0xb2d22f84
10000.21,2.0,73,2,3,1,6,0xb2d8e1de
130005.17,5.0,35,3,4,2,9,0xb2d61c17
1579.18,1.0,184,1,2,1,4,0xb2d42426
130021.09,18.0,0,3,4,4,11,0xb2d1d88c
770012.04,5.0,18,4,4,2,10,0xb2d70182d
8686.03,1.0,59,2,2,2,6,0xb2d6b8d4
487.25,1.0,0,1,2,4,7,0xb2d4b9ad
368004.52,3.0,80,4,4,1,9,0xb2d42ca9
151034.34,1.0,4,3,2,4,9,0xb2d61ff7
70756.7,1.0,20,3,2,2,7,0xb2d559a0
2.04,1.0,77,1,2,1,4,0xb2d65c20
30010.47,2.0,31,2,3,2,7,0xb2d64310
2740.27,1.0,184,1,2,1,4,0xb2d071c1
1133.01,1.0,184,1,2,1,4,0xb2d1ce27
510029.25,5.0,10,4,4,3,11,0xb2d1680e
61610.29,3.0,31,3,4,2,9,0xb2d148fa
978.36,1.0,0,1,2,4,7,0xb2d7d30a
772968.65,6.0,158,4,4,1,9,0xb2d1dc8a
150003.05,3.0,153,3,4,1,8,0xb2d3bb09
15000.11,1.0,4,2,2,4,8,0xb2d90b9a
75004.15,4.0,4,3,4,4,11,0xb2d6adcb
103488.72,2.0,9,3,3,3,9,0xb2d3af74
455000.0,4.0,5,4,4,3,11,0xb2d1adc1
8053.38,1.0,18,2,2,2,6,0xb2d98aae
5.46,1.0,18,1,2,2,5,0xb2d62acc
311175.33,4.0,2,4,4,4,12,0xb2d6944f
465559.08,3.0,3,4,4,4,12,0xb2d43464
20117.67,1.0,50,2,2,2,6,0xb2d57b6d
50873.26,2.0,185,2,3,1,6,0xb2d5e8e6d
265112.97,3.0,92,3,4,1,8,0xb2d1fbaf
4203.71,1.0,1,2,2,4,8,0xb2d70086
262604.62,2.0,8,3,3,3,9,0xb2d8e7ef
120003.59,2.0,80,3,3,1,7,0xb2d9858f
10015.6,3.0,20,2,4,2,8,0x3b9ad364
1150326.98,2.0,13,4,3,3,10,0xb2d1e90e
99900.0,1.0,1,3,2,4,9,0xb2d9801c
550084.69,14.0,0,4,4,4,12,0xb2d451f4
50438.7,2.0,142,2,3,1,6,0xb2d61307
105049.21,3.0,6,3,4,3,10,0xb2d5f092
564391.83,5.0,0,4,4,4,12,0xb2d06b24
75074.73,2.0,42,3,3,2,8,0xb2d499f2
21475.19,1.0,0,2,2,4,8,0xb2d92fb3
100004.24,2.0,181,3,3,1,7,0xb2d64f38
210002.11,5.0,32,3,4,2,9,0xb2d0bf7c
98.74,1.0,3,1,2,4,7,0xb2d2e2ec
4373.89,1.0,13,2,2,3,7,0xb2d96343
103000.0,2.0,0,3,3,4,10,0xb2d4307e
1101.77,1.0,159,1,2,1,4,0xb2d78725
1025.78,1.0,92,1,2,1,4,0xb2d0c3c1
12774.46,1.0,92,2,2,1,5,0xb2d2e6cf
578576.96,3.0,3,4,4,4,12,0xb2d558cd
5113.93,1.0,9,2,2,3,7,0xb2d8c5c5
5.82,1.0,41,1,2,2,5,0xb2d632d3
283057.76,5.0,0,3,4,4,11,0xb2d4187ed
9240.44,1.0,6,2,2,3,7,0xb2d2b615
144053.72,6.0,4,3,4,4,11,0xb2d57c8c
908.64,1.0,21,1,2,2,5,0xb2d609f6
430650.73,3.0,5,4,4,3,11,0xb2d694a9
45133.94,1.0,92,2,2,1,5,0xb2d45e4f
19722.44,1.0,0,2,2,4,8,0xb2d242bb
640935.44,5.0,4,4,4,4,12,0xb2d14e2a
10.69,1.0,18,1,2,2,5,0xb2d4e1ec
452197.83,6.0,18,4,4,2,10,0xb2d282e0
1006082.62,2.0,4,4,3,4,11,0xb2d35147
1015296.3,4.0,59,4,4,2,10,0xb2d170f8
2388.08,1.0,0,1,2,4,7,0xb2d90248
1547.9,2.0,24,1,3,2,6,0xb2d1977b
300097.98,2.0,22,3,3,2,8,0xb2d691bc
700060.0,3.0,16,4,4,2,10,0xb2d781e5
709751.87,4.0,24,4,4,2,10,0xb2d3ae52
320.89,1.0,116,1,2,1,4,0xb2d107a5
110017.36,2.0,77,3,3,1,7,0xb2d1cfef
13831.73,1.0,5,2,2,3,7,0xb2d14f7a
53.74,1.0,4,1,2,4,7,0xb2d5e5b0
91632.01,1.0,4,3,2,4,9,0xb2d7770ed
1868493.81,2.0,27,4,3,2,9,0xb2d3f86e
20009.09,2.0,263,2,3,1,6,0xb2d5fbec
50006.39,2.0,26,2,3,2,7,0xb2d28711
200000.0,2.0,153,3,3,1,7,0xb2d6e134
10048.73,2.0,106,2,3,1,6,0xb2d54b6f
1.39,1.0,0,1,2,4,7,0xb2d5ef69
309547.87,6.0,4,4,4,4,12,0xb2d1c9a1
19610.45,1.0,15,2,2,3,7,0xb2d95a34
532061.07,4.0,37,4,4,2,10,0xb2d58c51
22711.78,1.0,173,2,2,1,5,0xb2d589ef
3.4,7.0,6,1,4,3,8,0xb2d2156b
2034.7,1.0,39,1,2,2,5,0xb2d684c5
17359.23,1.0,184,2,2,1,5,0xb2d53b67
204264.98,1.0,4,3,2,4,9,0xb2d9df30
33212.76,1.0,0,2,2,4,8,0xb2d6c46f
52167.44,1.0,33,3,2,2,7,0xb2d68361
630957.39,5.0,16,4,4,2,10,0xb2d170b2
202398.0,2.0,0,3,3,4,10,0xb2d64038
20039.52,4.0,11,2,4,3,9,0xb2d0b649
600000.0,3.0,4,4,4,4,12,0xb2d6a8e2
15038.35,1.0,252,2,2,1,5,0xb2d57546
97961.26,2.0,10,3,3,3,9,0xb2d205de
483773.59,9.0,0,4,4,4,12,0xb2d10bda
110000.28,2.0,91,3,3,1,7,0xb2d0c2ac
1030024.68,3.0,11,4,4,3,11,0xb2d6350e
70001.84,5.0,66,3,4,2,9,0xb2d44983
100918.23,2.0,17,3,3,2,8,0xb2d26a0e
50001.58,2.0,92,2,3,1,6,0xb2d64437
1228087.15,2.0,80,4,3,1,8,0xb2d6960b
48.28,1.0,33,1,2,2,5,0xb2d56807
300141.08,2.0,154,4,3,1,8,0xb2d1a81c
277847.55,3.0,1,3,4,4,11,0x3b9b2d03
50001.58,2.0,24,2,3,2,7,0xb2d945f3
5062.2,1.0,184,2,2,1,5,0xb2d283ce
82224.47,2.0,32,3,3,2,8,0xb2d23dc0d
16454.05,1.0,2,2,2,4,8,0xb2d3ba05
11156.29,1.0,12,2,2,3,7,0xb2d2a1ec
207333.13,1.0,107,3,2,1,6,0xb2d68319
131363.97,3.0,179,3,4,1,8,0xb2d5f37f
413218.46,19.0,0,4,4,4,12,0xb2d066ab
270500.0,7.0,6,3,4,3,10,0xb2d218cf
161112.55,4.0,12,3,4,3,10,0xb2d65c4c
252.19,1.0,60,1,2,2,5,0xb2d634ae
158339.97,4.0,101,3,4,1,8,0xb2d40d51
19102000.0,11.0,1,4,4,4,12,0xb2d59381
250017.47,3.0,80,3,4,1,8,0xb2d1b282d
511555.63,2.0,249,4,3,1,8,0xb2d241df
16.12,2.0,3,1,3,4,8,0x3b9b2dd8
111703.05,3.0,27,3,4,2,9,0xb2d6c987
264.77,1.0,0,1,2,4,7,0xb2d6bf28
143027.9,4.0,0,3,4,4,11,0xb2d59195
120.91,1.0,5,1,2,3,6,0xb2d2321f
1958223.05,4.0,13,4,4,3,11,0x3b9b4110
460005.04,3.0,23,4,4,2,10,0xb2d691b2
20680.32,1.0,116,2,2,1,5,0xb2d23784
104.76,1.0,10,1,2,3,6,0xb2d8fd8c
950002.0,2.0,3,4,3,4,11,0xb2d97268
201421.21,2.0,81,3,3,1,7,0xb2d98c80
3808818.12,13.0,0,4,4,4,12,0xb2d647a3
3755.51,2.0,0,2,3,4,9,0xb2d1928b
4400.93,1.0,0,2,2,4,8,0xb2d9c3a4
223878.89,2.0,12,3,3,3,9,0xb2da373d
2172.21,1.0,0,1,2,4,7,0xb2d37c36
500000.28,2.0,7,4,3,3,10,0xb2d71a2a
300094.97,2.0,22,3,3,2,8,0xb2d691bcd
20379.5,1.0,1,2,2,4,8,0xb2d7c453
590025.23,2.0,18,4,3,2,9,0xb2d9b70a
60635.93,2.0,62,3,3,2,8,0xb2d5b285
14626.79,1.0,10,2,2,3,7,0xb2d5c1fe
1039.83,1.0,92,1,2,1,4,0xb2d1da79
111.14,1.0,0,1,2,4,7,0xb2d1c322
429.91,2.0,0,1,3,4,8,0x3b9b18c9
10060.35,2.0,0,2,3,4,9,0xb2d9b01c
330756.94,3.0,2,4,4,4,12,0xb2d25d84
1000001.5,2.0,13,4,3,3,10,0xb2d91635
8792.85,1.0,29,2,2,2,6,0xb2d92cbc
500076.04,2.0,6,4,3,3,10,0xb2d93027
176351.05,4.0,20,3,4,2,9,0xb2d2275a
20097.99,1.0,20,2,2,2,6,0xb2d34c21d
0.26,1.0,54,1,2,2,5,0xb2d8fdea
1022720.78,2.0,24,4,3,2,9,0xb2d65c46
5883.05,1.0,3,2,2,4,8,0xb2d90a75
5816.77,1.0,72,2,2,1,5,0xb2d5cba3
0.0,1.0,7,1,2,3,6,0xb2d68923
294484.93,5.0,27,3,4,2,9,0xb2d40ba9
6255.82,1.0,9,2,2,3,7,0xb2d2d451
60000.31,4.0,82,3,4,1,8,0xb2d6351a
462077.12,4.0,0,4,4,4,12,0xb2d16bec
3990.48,1.0,184,2,2,1,5,0xb2d2435e
1230511.04,34.0,12,4,4,3,11,0x3b9af1ee
8824.69,1.0,4,2,2,4,8,0xb2d6f368
60087.33,4.0,13,3,4,3,10,0xb2d6ac73
246471.95,4.0,1,3,4,4,11,0xb2d23268
200760.26,2.0,32,3,3,2,8,0xb2d6da15
10000.0,1.0,7,2,2,3,7,0xb2d78cbf
42861.95,2.0,184,2,3,1,6,0x3b9b16aa
152357.57,3.0,5,3,4,3,10,0xb2d427f2
58063.59,3.0,11,3,4,3,10,0xb2d17593
432203.22,6.0,0,4,4,4,12,0xb2d63c9a
193081.97,1.0,0,3,2,4,9,0xb2d9b828
9985.45,1.0,16,2,2,2,6,0xb2d6d9dc
20274.1,2.0,161,2,3,1,6,0xb2d5f3cc
359878.12,4.0,2,4,4,4,12,0xb2d166c1
50000.53,2.0,195,2,3,1,6,0xb2d69e79
45571.36,1.0,112,2,2,1,5,0xb2d588cd
9829.24,1.0,1,2,2,4,8,0xb2d2df34
861889.26,4.0,10,4,4,3,11,0x3b9b14d3
7162.41,1.0,11,2,2,3,7,0xb2d8da2c
96100.04,2.0,32,3,3,2,8,0xb2d9f441
3953.52,1.0,36,2,2,2,6,0xb2d1bfa4
80.15,1.0,45,1,2,2,5,0xb2d0fb88
10882.92,1.0,29,2,2,2,6,0xb2d92cea
4709.17,1.0,0,2,2,4,8,0xb2d6805e
500000.21,2.0,4,4,3,4,11,0xb2d944a0
201505.74,2.0,27,3,3,2,8,0xb2d5f187
200012.14,2.0,252,3,3,1,7,0xb2d6d11a
450055.73,3.0,175,4,4,1,9,0xb2d5dbd9
6549.84,1.0,10,2,2,3,7,0xb2d6fa65
60003.8,2.0,132,3,3,1,7,0xb2d5b2bb
29889.65,1.0,62,2,2,2,6,0xb2d619af
163358.67,2.0,73,3,3,1,7,0xb2d388f2
2.48,1.0,77,1,2,1,4,0xb2d587b3
3037.12,1.0,92,2,2,1,5,0xb2d3be37
400111.27,2.0,210,4,3,1,8,0xb2d0cbbe
113.02,2.0,8,1,3,3,7,0xb2d2b345
170096.51,2.0,1,3,3,4,10,0xb2d520ea
8171.77,1.0,17,2,2,2,6,0xb2d283d4
63.11,1.0,0,1,2,4,7,0xb2d4ec26
2071.32,1.0,3,1,2,4,7,0xb2d1eac1
9741.96,4.0,0,2,4,4,10,0x3b9b0e31
708586.28,7.0,5,4,4,3,11,0xb2d56afc
714837.55,3.0,173,4,4,1,9,0xb2d13f70
430556.21,6.0,0,4,4,4,12,0xb2d54ece
350000.57,2.0,12,4,3,3,10,0xb2d992a3
2000.84,1.0,0,1,2,4,7,0xb2d700fd
4293.58,1.0,285,2,2,1,5,0xb2d0e2c1
381008.05,2.0,129,4,3,1,8,0xb2d6ea1ad
73168.43,1.0,75,3,2,1,6,0xb2d41386
9792.8,1.0,0,2,2,4,8,0xb2d2eacc
41094.18,1.0,92,2,2,1,5,0xb2d112e9
1713.48,1.0,9,1,2,3,6,0xb2d1e908
1203.45,1.0,0,1,2,4,7,0xb2d68c67
14485.66,1.0,5,2,2,3,7,0xb2d6f4de
180187.89,4.0,19,3,4,2,9,0xb2d28b4b
2903.71,1.0,1,2,2,4,8,0xb2d6fff5
810737.24,5.0,26,4,4,2,10,0xb2d93ee4
201467.25,2.0,14,3,3,3,9,0xb2d576bd
100000.0,2.0,1,3,3,4,10,0xb2da59b7
1555001.42,6.0,57,4,4,2,10,0xb2d0b810
2053552.5,4.0,28,4,4,2,10,0xb2d4e8f1
68362.83,3.0,0,3,4,4,11,0xb2d58188
20093.22,2.0,83,2,3,1,6,0xb2d6135e
400042.26,2.0,1,4,3,4,11,0xb2d99e6a
1040068.97,8.0,2,4,4,4,12,0xb2d5b6e7d
2502442.06,2.0,6,4,3,3,10,0xb2d0762f
1214.17,1.0,10,1,2,3,6,0xb2d36947
670070.39,5.0,18,4,4,2,10,0x3b9b3d31
5352.53,1.0,41,2,2,2,6,0xb2d5cc68
1772.45,1.0,4,1,2,4,7,0xb2d54b9c
10986.43,1.0,19,2,2,2,6,0xb2d55439
12772.84,1.0,15,2,2,3,7,0xb2d483af
943466.9,2.0,21,4,3,2,9,0xb2d44464
1444000.89,8.0,7,4,4,3,11,0x3b9b26d6
480000.19,5.0,6,4,4,3,11,0xb2d580cb
1971.59,1.0,184,1,2,1,4,0xb2d1f0d7
764.1,1.0,26,1,2,2,5,0xb2d928a8
1000036.16,2.0,217,4,3,1,8,0xb2d214ed
331941.95,1.0,3,4,2,4,10,0xb2d0e680
204900.81,2.0,4,3,3,4,10,0xb2d38548
103318.01,2.0,101,3,3,1,7,0xb2d18de3
2866.65,1.0,2,1,2,4,7,0xb2d54026
100007.97,2.0,259,3,3,1,7,0xb2d24477d
1500001.59,3.0,27,4,4,2,10,0xb2d53f14
200713.37,2.0,18,3,3,2,8,0xb2d59f35
126151.61,11.0,0,3,4,4,11,0xb2d5cdd1
3339.23,2.0,7,2,3,3,8,0xb2d6f0ac
450515.74,6.0,27,4,4,2,10,0xb2d58322
4.43,1.0,69,1,2,1,4,0xb2d946db
252416.98,4.0,1,3,4,4,11,0xb2d1047f
1345094.91,13.0,0,4,4,4,12,0xb2d12a96
400000.01,3.0,5,4,4,3,11,0xb2d69d9c
2751.07,4.0,10,1,4,3,8,0xb2d3e680
887.84,1.0,5,1,2,3,6,0xb2d2e91d
2507.46,1.0,21,1,2,2,5,0xb2d5356c
529.75,1.0,0,1,2,4,7,0xb2d7173d
13.09,1.0,60,1,2,2,5,0xb2d8fd3f
3.59,1.0,20,1,2,2,5,0xb2d186e9
370564.17,9.0,1,4,4,4,12,0xb2d3c318
7027.98,1.0,92,2,2,1,5,0xb2d23cad
564.68,1.0,0,1,2,4,7,0xb2d61225
1515.11,1.0,184,1,2,1,4,0xb2d26fa9
758818.75,16.0,0,4,4,4,12,0xb2d23ca5
9.15,1.0,77,1,2,1,4,0xb2d62f41
105.62,3.0,32,1,4,2,7,0xb2d99fd9
113239.58,1.0,10,3,2,3,8,0xb2d563c0
3019524.94,1.0,1,4,2,4,10,0xb2d39931
512977.65,6.0,1,4,4,4,12,0xb2d5e478
9587.31,1.0,21,2,2,2,6,0xb2d60ac5
380.15,1.0,9,1,2,3,6,0xb2d3d094
184.75,1.0,9,1,2,3,6,0xb2d6554e
20013.34,1.0,3,2,2,4,8,0xb2d5d5d6
1.62,1.0,13,1,2,3,6,0xb2d5529a
131.47,1.0,18,1,2,2,5,0xb2d24d19
14.63,1.0,13,1,2,3,6,0xb2d6a0ae
49.34,1.0,4,1,2,4,7,0xb2d13f6d
40052.97,2.0,3,2,3,4,9,0xb2d20f55
411710.99,4.0,25,4,4,2,10,0xb2d656f8
11271.66,1.0,1,2,2,4,8,0xb2d23d28
100921.45,2.0,1,3,3,4,10,0xb2d24c22
1070948.34,4.0,2,4,4,4,12,0xb2d39ae5
170008.23,2.0,37,3,3,2,8,0xb2d69e8b
16.08,1.0,3,1,2,4,7,0xb2d58a48
81274.07,2.0,52,3,3,2,8,0xb2d5b3c1
3531.47,1.0,2,2,2,4,8,0xb2d63cae
5000158.33,1.0,1,4,2,4,10,0xb2da0893
505328.18,5.0,27,4,4,2,10,0xb2d78241
443.8,1.0,167,1,2,1,4,0xb2d0c5ec
90111.52,1.0,18,3,2,2,7,0xb2d3b46c
20700.18,1.0,208,2,2,1,5,0xb2d23784d
7854.1,1.0,4,2,2,4,8,0xb2d801cf
302374.01,1.0,9,4,2,3,9,0xb2d330dc
18061.72,1.0,18,2,2,2,6,0xb2d3430b
0.22,1.0,74,1,2,1,4,0xb2d645bf
22473.73,1.0,0,2,2,4,8,0xb2d5aecd
1279.94,2.0,5,1,3,3,7,0xb2d4e8e1
8734.4,1.0,9,2,2,3,7,0xb2d1fcf9
3478.42,1.0,14,2,2,3,7,0xb2d5d223
50007.36,3.0,92,2,4,1,7,0xb2d5a187
3097078.27,3.0,25,4,4,2,10,0xb2d304e6
311076.49,4.0,3,4,4,4,12,0xb2d59b1c
52869.47,10.0,0,3,4,4,11,0xb2d09c87
3366.33,7.0,2,2,4,4,10,0xb2d094ad
76.64,1.0,63,1,2,2,5,0xb2d39afd
776108.82,8.0,11,4,4,3,11,0xb2d3a460
44589.82,1.0,0,2,2,4,8,0xb2d958cf
6941.65,1.0,9,2,2,3,7,0xb2d5c199
10002.2,2.0,0,2,3,4,9,0xb2d62264
2994.02,1.0,0,2,2,4,8,0xb2d6e490
176070.6,2.0,60,3,3,2,8,0xb2d3a8b1
150474.46,5.0,20,3,4,2,9,0xb2d649fe
1.81,3.0,20,1,4,2,7,0xb2d067da
102386.82,1.0,2,3,2,4,9,0xb2d43006d
134760.45,1.0,7,3,2,3,8,0xb2d628b4
2841.74,1.0,92,1,2,1,4,0xb2d2bca2
118.22,1.0,22,1,2,2,5,0xb2d9f91d
355960.79,1.0,14,4,2,3,9,0xb2d3e4ea
200012.13,2.0,160,3,3,1,7,0xb2d6d11ad
68011.56,3.0,203,3,4,1,8,0xb2d4a5a7
3125.3,3.0,0,2,4,4,10,0xb2d17dc8d
822010.9,5.0,50,4,4,2,10,0xb2d33d2c
3761.28,1.0,18,2,2,2,6,0xb2d9798b
1373.94,1.0,14,1,2,3,6,0xb2d48cc4
10900.67,2.0,4,2,3,4,9,0xb2d5e9b7
3684.11,1.0,1,2,2,4,8,0xb2d53d9c
200002.11,2.0,52,3,3,2,8,0xb2d90c84
200080.94,2.0,7,3,3,3,9,0xb2d64cd7
200000.0,2.0,20,3,3,2,8,0xb2da2ce4
80131.34,2.0,0,3,3,4,10,0xb2d21c5e
36154.83,1.0,28,2,2,2,6,0xb2d5cbf1
13937.48,1.0,1,2,2,4,8,0xb2d9677f
4501.87,1.0,1,2,2,4,8,0xb2d43db6
301729.46,1.0,3,4,2,4,10,0xb2d255b0
794878.17,3.0,111,4,4,1,9,0xb2d13f2b
6117.07,1.0,92,2,2,1,5,0xb2d087c8
560029.15,2.0,12,4,3,3,10,0xb2d6ce58
821004.8,6.0,6,4,4,3,11,0xb2d208c1
550081.05,2.0,0,4,3,4,11,0xb2d6c582
60005.5,3.0,60,3,4,2,9,0xb2d8dfe1
332882.38,2.0,6,4,3,3,10,0xb2d64992
5377.62,1.0,13,2,2,3,7,0xb2d91649
190006.12,3.0,6,3,4,3,10,0xb2da33e7
100001.06,2.0,6,3,3,3,9,0xb2da49fc
3030.83,1.0,184,2,2,1,5,0xb2d2ef7a
53577.52,1.0,29,3,2,2,7,0xb2d5cc74
50003.42,3.0,60,2,4,2,8,0xb2d8d8ae
180837.71,8.0,3,3,4,4,11,0xb2d64c80
40027.9,3.0,1,2,4,4,10,0xb2d626d4
457426.12,3.0,97,4,4,1,9,0xb2d0b644
1052.05,1.0,92,1,2,1,4,0xb2d203c2d
2.11,1.0,75,1,2,1,4,0xb2d99bfd
25185.9,1.0,3,2,2,4,8,0xb2d2b5d9
1054728.95,7.0,1,4,4,4,12,0xb2d0d4f6
200165.34,4.0,70,3,4,1,8,0xb2d0da34
16249.56,1.0,140,2,2,1,5,0xb2d4351a
340.29,1.0,0,1,2,4,7,0xb2d967a7
500042.9,2.0,236,4,3,1,8,0xb2d1845e
1854.7,1.0,1,1,2,4,7,0xb2d2a001
310021.25,8.0,4,4,4,4,12,0xb2d56315d
208450.32,4.0,3,3,4,4,11,0xb2d4f931
18050.43,1.0,0,2,2,4,8,0xb2d42c63
900096.64,3.0,35,4,4,2,10,0xb2d68203
14271.33,1.0,1,2,2,4,8,0xb2d40824
700489.36,1.0,1,4,2,4,10,0xb2d5d1fa
9695.62,1.0,10,2,2,3,7,0xb2d40e52
400014.91,4.0,179,4,4,1,9,0xb2d1c123
120002.49,7.0,18,3,4,2,9,0xb2d8c91e
101468.52,1.0,14,3,2,3,8,0xb2d57932
70015.33,2.0,52,3,3,2,8,0xb2d271f4
722406.98,2.0,133,4,3,1,8,0xb2d6a5b0
17.48,1.0,7,1,2,3,6,0xb2d6c694
363046.29,2.0,10,4,3,3,10,0xb2d2d6cb
500255.27,5.0,1,4,4,4,12,0xb2d0f860
105.94,1.0,9,1,2,3,6,0xb2d78191d
102567.54,3.0,2,3,4,4,11,0xb2d4fc3b
700001.4,2.0,22,4,3,2,9,0xb2d6328e
480011.96,4.0,3,4,4,4,12,0xb2d2478b
13049.35,1.0,0,2,2,4,8,0xb2d6e891
40000.42,2.0,24,2,3,2,7,0xb2d94af7
1876098.86,15.0,0,4,4,4,12,0xb2d2caa4
55000.72,2.0,127,3,3,1,7,0xb2d782b9
501776.04,2.0,33,4,3,2,9,0xb2d92fac
90012.44,5.0,47,3,4,2,9,0xb2d198f2
1130.81,1.0,92,1,2,1,4,0xb2d21aac
2132021.16,39.0,1,4,4,4,12,0xb2d15a08
241129.28,8.0,35,3,4,2,9,0xb2d08504
4180.39,1.0,12,2,2,3,7,0xb2d10d8c
14460.5,1.0,11,2,2,3,7,0xb2d6c9cb
11372.09,1.0,130,2,2,1,5,0xb2d14704
120005.99,6.0,6,3,4,3,10,0xb2d29018
6426.52,1.0,19,2,2,2,6,0xb2d9c6da
12.76,1.0,7,1,2,3,6,0xb2d6bfee
211476.1,3.0,80,3,4,1,8,0xb2d6ec6f
300002.77,3.0,94,3,4,1,8,0xb2d0d2a6
104588.64,3.0,10,3,4,3,10,0xb2d10b87d
1235.43,2.0,82,1,3,1,5,0xb2d0a07a
1000239.58,2.0,14,4,3,3,10,0xb2d563cf
460018.52,4.0,6,4,4,3,11,0xb2d6eac3d
104020.98,3.0,13,3,4,3,10,0xb2d53159
104.25,1.0,27,1,2,2,5,0xb2d85913
14384.6,1.0,0,2,2,4,8,0xb2d3163b
310610.27,2.0,12,4,3,3,10,0xb2d906aa
417420.78,3.0,231,4,4,1,9,0xb2d55a39
200041.97,2.0,4,3,3,4,10,0xb2d91e6f
32340.35,1.0,1,2,2,4,8,0xb2d12e59
456600.6,1.0,0,4,2,4,10,0xb2d37657
345036.21,4.0,49,4,4,2,10,0xb2d0cdc5
52548.01,2.0,146,3,3,1,7,0xb2d39d09
100001.06,2.0,60,3,3,2,8,0xb2d9bf15
130032.91,3.0,142,3,4,1,8,0xb2d17107
511872.86,2.0,25,4,3,2,9,0xb2d6db04
8867.87,1.0,20,2,2,2,6,0xb2d8dc2b
2856.13,1.0,82,1,2,1,4,0xb2d62dcb
25.87,1.0,3,1,2,4,7,0xb2d76b4e
400016.89,2.0,53,4,3,2,9,0xb2d9c6e4
30019.76,2.0,68,2,3,1,6,0xb2d61a1f
7985.36,1.0,19,2,2,2,6,0xb2d30445
381985.21,3.0,11,4,4,3,11,0xb2d16798
71023.46,4.0,8,3,4,3,10,0xb2d430c4
2959.16,2.0,10,2,3,3,8,0xb2d622f9
400146.44,4.0,0,4,4,4,12,0xb2d6afec
21437.0,1.0,0,2,2,4,8,0xb2d3a1e0
2123177.17,3.0,29,4,4,2,10,0xb2d24c9a
3623002.8,27.0,1,4,4,4,12,0xb2d8dcd4
2420.01,1.0,9,1,2,3,6,0xb2d2ebc1
14673.52,1.0,1,2,2,4,8,0xb2d21b68
19925.4,1.0,274,2,2,1,5,0xb2d10a2e
448082.3,8.0,52,4,4,2,10,0xb2d247ad
100070.79,2.0,63,3,3,2,8,0xb2d8ead7
30533.49,2.0,46,2,3,2,7,0xb2d6cbe1
2073010.79,3.0,16,4,4,2,10,0xb2d6058f
242006.74,3.0,0,3,4,4,11,0xb2d5fdc7
215000.0,2.0,5,3,3,3,9,0xb2d90b1c
18147.94,1.0,184,2,2,1,5,0xb2d3545c
1066.37,1.0,184,1,2,1,4,0xb2d06db9
249.42,1.0,12,1,2,3,6,0xb2d6fbd8
14806.76,1.0,4,2,2,4,8,0xb2da0462
1081224.11,8.0,45,4,4,2,10,0xb2d5e09d
500057.82,4.0,11,4,4,3,11,0xb2d92320
160016.42,3.0,101,3,4,1,8,0xb2d209d2
3051.02,1.0,8,2,2,3,7,0xb2d24ee0
217059.63,4.0,18,3,4,2,9,0xb2d5e9ee
350.72,1.0,19,1,2,2,5,0xb2d2d73d
600393.96,2.0,20,4,3,2,9,0xb2d953e9
1.63,1.0,50,1,2,2,5,0xb2d9ab63
440735.41,5.0,20,4,4,2,10,0xb2d61021
7813.16,1.0,6,2,2,3,7,0xb2d7563e
50015.9,2.0,2,2,3,4,9,0xb2d43485
5018.86,1.0,92,2,2,1,5,0xb2d59f51
160005.11,3.0,18,3,4,2,9,0xb2d7edc5
73000.0,3.0,3,3,4,4,11,0xb2d8d71e
5064.6,1.0,1,2,2,4,8,0xb2d38bd1
624482.14,4.0,58,4,4,2,10,0xb2d38748
50099.06,2.0,0,2,3,4,9,0xb2d94032
100005.28,2.0,19,3,3,2,8,0xb2d94deb
419112.45,4.0,3,4,4,4,12,0xb2d41b7c
330020.88,3.0,33,4,4,2,10,0xb2d60a01
78642.85,1.0,10,3,2,3,8,0xb2d978ee
258363.47,2.0,25,3,3,2,8,0xb2d631d6
8.45,1.0,55,1,2,2,5,0xb2d6ceef
3530.65,1.0,5,2,2,3,7,0xb2d29d06
3263.75,1.0,0,2,2,4,8,0xb2d58975
61830.66,1.0,105,3,2,1,6,0xb2d1ba19
60889.46,2.0,139,3,3,1,7,0xb2d55f2c
659167.44,2.0,0,4,3,4,11,0xb2d6a6f4
570000.0,8.0,3,4,4,4,12,0xb2d0e05f
16736.88,1.0,13,2,2,3,7,0xb2d0a728
292339.29,10.0,27,3,4,2,9,0xb2d62cd0
541074.53,4.0,26,4,4,2,10,0xb2d56c90
4345926.27,5.0,1,4,4,4,12,0xb2d2a711
46179.83,1.0,10,2,2,3,7,0xb2d5c776
8034.6,1.0,92,2,2,1,5,0xb2d4ee04
579.03,1.0,0,1,2,4,7,0xb2d606fc
220003.63,2.0,0,3,3,4,10,0xb2d4b8e3d
366789.36,3.0,1,4,4,4,12,0xb2d16f2b
495146.8,4.0,2,4,4,4,12,0xb2d3ab9e
0.16,1.0,167,1,2,1,4,0xb2d5d0fd
121.5,1.0,55,1,2,2,5,0xb2d23949
5.55,1.0,8,1,2,3,6,0xb2d6a034
2.46,1.0,60,1,2,2,5,0xb2d14982
20026.62,1.0,5,2,2,3,7,0xb2d19f18
20191.1,1.0,3,2,2,4,8,0xb2d1ead5
18395.96,1.0,92,2,2,1,5,0xb2d620e6
1003084.21,4.0,14,4,4,3,11,0xb2d68369
160442.47,1.0,123,3,2,1,6,0xb2d330c0
360029.0,3.0,8,4,4,3,11,0xb2d6595e
5.8,1.0,7,1,2,3,6,0xb2d948f1
455084.48,2.0,67,4,3,1,8,0xb2d8d7a7
160441.28,2.0,55,3,3,2,8,0xb2d12049
450004.75,2.0,55,4,3,2,9,0xb2d9042b
3286651.04,38.0,0,4,4,4,12,0x3b9b1289
10007.28,1.0,79,2,2,1,5,0xb2d6b750
200044.42,3.0,87,3,4,1,8,0xb2d1231a
1007.29,2.0,92,1,3,1,5,0xb2d38501
73002.53,3.0,8,3,4,3,10,0xb2d5f5ad
400001.07,3.0,10,4,4,3,11,0xb2d9222f
135528.79,5.0,7,3,4,3,10,0xb2d0ca6a
426806.89,3.0,23,4,4,2,10,0xb2d98958
43102.03,2.0,2,2,3,4,9,0xb2d6bb1f
686.51,3.0,0,1,4,4,9,0xb2d06738
1046952.75,3.0,33,4,4,2,10,0xb2d1ac82
5434.02,1.0,9,2,2,3,7,0xb2d301e8
110573.51,2.0,83,3,3,1,7,0xb2d55c78
762.29,1.0,70,1,2,1,4,0xb2d4b637
819913.62,2.0,115,4,3,1,8,0xb2d6e860
0.14,1.0,11,1,2,3,6,0xb2d54840
12551.73,1.0,9,2,2,3,7,0xb2d320f7d
345114.61,6.0,0,4,4,4,12,0x3b9ae61c
2002.98,1.0,151,1,2,1,4,0xb2d8d090
1251246.12,2.0,27,4,3,2,9,0xb2d5b8b4
500000.0,2.0,19,4,3,2,9,0xb2d957a8d
1424.88,1.0,7,1,2,3,6,0xb2d91c53
251315.53,5.0,13,3,4,3,10,0xb2d1b8b4
1002.4,1.0,0,1,2,4,7,0xb2d474e6
602144.1,3.0,27,4,4,2,10,0xb2d3f0a1
750007.92,2.0,49,4,3,2,9,0xb2d9d4ff
16268.53,1.0,3,2,2,4,8,0xb2d29d5d
1970096.95,51.0,20,4,4,2,10,0x3b9b47f3
300012.68,2.0,182,3,3,1,7,0xb2d8a08e
50001.06,2.0,87,2,3,1,6,0xb2d8c8ff
268266.26,3.0,60,3,4,2,9,0xb2d43eef
125000.0,1.0,4,3,2,4,9,0xb2d22a0e
54168.92,1.0,10,3,2,3,8,0xb2d6c9f2d
4.06,1.0,19,1,2,2,5,0xb2d0a6af
700036.0,4.0,66,4,4,2,10,0xb2d6bc0b
2.69,1.0,76,1,2,1,4,0xb2d64a19
4.9,1.0,52,1,2,2,5,0xb2d6ad62
11462.36,1.0,15,2,2,3,7,0xb2d31947
382330.33,3.0,1,4,4,4,12,0xb2d25430
3032.76,1.0,184,2,2,1,5,0xb2d1a61e
70086.59,2.0,0,3,3,4,10,0xb2d10bf7
30197.42,2.0,5,2,3,3,8,0xb2d5e348
350017.28,4.0,77,4,4,1,9,0xb2d1c266
50728.68,2.0,24,2,3,2,7,0xb2d2248f
15108.79,1.0,92,2,2,1,5,0x3b9b2eb4
102162.64,1.0,19,3,2,2,7,0xb2d8130b
4981.25,2.0,92,2,3,1,6,0xb2d06589
3283.35,1.0,0,2,2,4,8,0xb2d211b8
2504.17,1.0,21,1,2,2,5,0xb2d9143b
1881876.34,10.0,20,4,4,2,10,0xb2d1049e
1041049.4,4.0,13,4,4,3,11,0xb2d1c3a5
500000.0,2.0,22,4,3,2,9,0xb2da20ca
55424.92,5.0,0,3,4,4,11,0xb2d5141ad
1687.59,1.0,39,1,2,2,5,0xb2d7ec80
12429.5,1.0,0,2,2,4,8,0xb2d920cbd
845024.06,6.0,10,4,4,3,11,0xb2d14386
300081.07,3.0,22,3,4,2,9,0xb2da175c
200710.49,2.0,49,3,3,2,8,0xb2d9d9c7
240874.59,7.0,0,3,4,4,11,0xb2d56f1b
200006.35,2.0,92,3,3,1,7,0xb2d6705d
10095.76,1.0,184,2,2,1,5,0xb2d2b000
100105.0,3.0,18,3,4,2,9,0xb2d8a6e7
1031066.39,8.0,8,4,4,3,11,0xb2d17e68
470066.05,5.0,4,4,4,4,12,0xb2d5fcdd
91671.39,1.0,0,3,2,4,9,0xb2d2d91e
357706.15,4.0,21,4,4,2,10,0xb2d64853
867792.5,8.0,95,4,4,1,9,0x3b9b1bc6
50562.95,1.0,0,2,2,4,8,0xb2d5fced
220000.0,2.0,12,3,3,3,9,0xb2d964ff
1551.04,2.0,184,1,3,1,5,0xb2d0b2f2
1225.63,1.0,118,1,2,1,4,0xb2d52ea2
1056.51,1.0,9,1,2,3,6,0xb2d433b8
6007.94,1.0,2,2,2,4,8,0xb2d38034
3591.28,1.0,9,2,2,3,7,0xb2d26c8a
602001.48,6.0,12,4,4,3,11,0xb2d4ea1c
411535.61,4.0,18,4,4,2,10,0xb2d6842d
79582.88,1.0,10,3,2,3,8,0xb2d6f1bf
749.33,1.0,0,1,2,4,7,0xb2d995c4
1.27,4.0,62,1,4,2,7,0xb2d17efc
101.52,1.0,9,1,2,3,6,0xb2d4be19
490141.74,6.0,26,4,4,2,10,0xb2d1613a
61002.6,3.0,19,3,4,2,9,0xb2d9eff3
683799.49,4.0,0,4,4,4,12,0xb2d2bf17
295847.09,2.0,92,3,3,1,7,0x3b9aed19
783316.95,4.0,3,4,4,4,12,0xb2d0f1e8
585000.0,2.0,8,4,3,3,10,0xb2da39ad
51739.95,2.0,49,2,3,2,7,0xb2d5d6cb
923623.88,6.0,31,4,4,2,10,0xb2d177efd
500008.96,2.0,21,4,3,2,9,0xb2d6b8ef
92.24,1.0,46,1,2,2,5,0xb2d9b622
103305.57,2.0,206,3,3,1,7,0xb2d50cca
50011.81,2.0,55,2,3,2,7,0xb2d3f64a
502005.33,2.0,19,4,3,2,9,0xb2d92facd
50190.29,1.0,4,2,2,4,8,0xb2d3adb0
286430.0,1.0,0,3,2,4,9,0xb2d0ab87
4988.63,1.0,97,2,2,1,5,0xb2d6d9bf
1820.62,1.0,102,1,2,1,4,0xb2d584a4
20006.59,2.0,116,2,3,1,6,0xb2d5ea78
202446.06,2.0,32,3,3,2,8,0xb2d6cf6c
100038.01,1.0,0,3,2,4,9,0xb2d1d1cd
78.02,1.0,11,1,2,3,6,0xb2d32f75
1000003.38,2.0,19,4,3,2,9,0xb2d94905
252343.95,4.0,3,3,4,4,11,0xb2d23a47
300003.17,2.0,53,3,3,2,8,0xb2d58f5f
1301.53,1.0,12,1,2,3,6,0xb2d6a82d
55739.91,2.0,8,3,3,3,9,0xb2d2bdac
612390.68,8.0,6,4,4,3,11,0xb2d08758
1498000.08,22.0,0,4,4,4,12,0xb2d530bb
320007.31,5.0,24,4,4,2,10,0xb2d59213
382718.5,4.0,1,4,4,4,12,0xb2d0bfec
180513.38,2.0,158,3,3,1,7,0xb2d4959c
50012.89,2.0,2,2,3,4,9,0xb2d31954
91723.17,2.0,52,3,3,2,8,0xb2d65b41
1129524.69,9.0,6,4,4,3,11,0xb2d16a4a
1064052.0,12.0,3,4,4,4,12,0xb2d124ea
1036505.87,2.0,47,4,3,2,9,0xb2d567e6
9.24,1.0,54,1,2,2,5,0xb2d60449
2014929.16,14.0,0,4,4,4,12,0xb2d65a13
306015.81,12.0,1,4,4,4,12,0xb2d4e186
4012.85,1.0,92,2,2,1,5,0xb2d60574
490000.0,9.0,7,4,4,3,11,0xb2d6907f
104198.57,5.0,23,3,4,2,9,0x3b9b2d43
98.53,1.0,0,1,2,4,7,0xb2d95ebf
270105.99,3.0,10,3,4,3,10,0xb2d3d2d4
30000.85,2.0,82,2,3,1,6,0xb2d90cc3
544161.06,9.0,0,4,4,4,12,0xb2d24a9d
1476.95,1.0,46,1,2,2,5,0xb2d44c72
17531.91,1.0,0,2,2,4,8,0xb2d34dca
200710.43,2.0,42,3,3,2,8,0xb2d923e8
782.63,3.0,0,1,4,4,9,0xb2d210c3d
1101494.46,4.0,18,4,4,2,10,0xb2d49228
3626.2,1.0,9,2,2,3,7,0xb2d9107a
1401.41,2.0,184,1,3,1,5,0xb2d0aa73
188726.66,2.0,6,3,3,3,9,0xb2d4137d
1.15,1.0,12,1,2,3,6,0xb2d8d54d
0.0,1.0,3,1,2,4,7,0xb2d5a5a4
1680005.63,8.0,1,4,4,4,12,0xb2d60739
39264.21,1.0,20,2,2,2,6,0xb2d6aa27
1593738.89,3.0,104,4,4,1,9,0x3b9b410f
2883.74,1.0,184,1,2,1,4,0xb2d2fa27
11412.97,1.0,0,2,2,4,8,0xb2d4eedd
6911.27,1.0,184,2,2,1,5,0xb2d30492
3610.11,1.0,17,2,2,2,6,0xb2d287b4
1095.68,1.0,0,1,2,4,7,0xb2d8db4b
650076.17,8.0,0,4,4,4,12,0x3b9b4575
0.43,2.0,81,1,3,1,5,0xb2d2b41b
74019.63,2.0,92,3,3,1,7,0xb2d07a61
16.84,1.0,75,1,2,1,4,0xb2d255dc
2027.62,1.0,184,1,2,1,4,0xb2d35b44
1054428.77,2.0,4,4,3,4,11,0xb2d60ef6
1249334.87,6.0,3,4,4,4,12,0xb2d38da9
500056.38,3.0,6,4,4,3,11,0xb2d86846
1.96,1.0,19,1,2,2,5,0xb2d33354
7398.44,1.0,0,2,2,4,8,0xb2d235de
11695.69,1.0,25,2,2,2,6,0xb2d5351e
328112.36,3.0,221,4,4,1,9,0xb2d076cf
101166.73,1.0,45,3,2,2,7,0xb2d62185
437044.84,3.0,80,4,4,1,9,0xb2d20a2d
6713.93,1.0,82,2,2,1,5,0xb2d96608
64215.18,2.0,69,3,3,1,7,0xb2d39c38
36584.81,3.0,11,2,4,3,9,0xb2d06479
22887.41,1.0,0,2,2,4,8,0xb2d6ad48
250049.05,2.0,74,3,3,1,7,0xb2d11e07
4696.42,1.0,184,2,2,1,5,0xb2d29338
1017000.62,24.0,4,4,4,4,12,0xb2d1b744
727396.51,2.0,184,4,3,1,8,0xb2d644f2
280008.87,2.0,87,3,3,1,7,0xb2d8c5d3
7442.76,1.0,1,2,2,4,8,0xb2d27df2
1500057.7,6.0,48,4,4,2,10,0xb2d18f07
375746.23,1.0,70,4,2,1,7,0xb2d18a3c
428942.43,5.0,18,4,4,2,10,0xb2d424e4
5629.03,1.0,6,2,2,3,7,0xb2d2ab28
206279.01,3.0,38,3,4,2,9,0xb2d5a941
57.52,1.0,71,1,2,1,4,0xb2d68c28
25022.01,1.0,1,2,2,4,8,0xb2d9a434
2007573.37,7.0,9,4,4,3,11,0xb2d2369a
12440.66,1.0,28,2,2,2,6,0xb2d3cc1b
600000.0,1.0,0,4,2,4,10,0xb2da6767
120071.69,2.0,4,3,3,4,10,0xb2d61b92
31587.1,1.0,11,2,2,3,7,0xb2d351fa
216991.5,2.0,110,3,3,1,7,0xb2d431e1
52489.34,1.0,12,3,2,3,8,0xb2d4f392
585879.33,6.0,86,4,4,1,9,0xb2d180ac
1627.88,1.0,184,1,2,1,4,0xb2d2d00a
83012.8,2.0,56,3,3,2,8,0xb2d9a7a3
2884.32,1.0,184,1,2,1,4,0xb2d34060
1227.8,1.0,184,1,2,1,4,0xb2d062ba
161.88,1.0,85,1,2,1,4,0xb2d61158
150217.8,2.0,25,3,3,2,8,0xb2d58f5b
555.73,1.0,53,1,2,2,5,0xb2d22a37
330000.54,3.0,2,4,4,4,12,0xb2d79182
520077.46,3.0,7,4,4,3,11,0xb2d375cd
250953.62,2.0,23,3,3,2,8,0xb2d9a332
40532.05,1.0,184,2,2,1,5,0xb2d489d7
22114.37,1.0,21,2,2,2,6,0xb2d609dd
101807.3,2.0,74,3,3,1,7,0xb2d2620d
916704.17,6.0,0,4,4,4,12,0xb2d3c673
352709.78,1.0,1,4,2,4,10,0xb2d9a764
4260.3,1.0,92,2,2,1,5,0xb2d3243e
1379.11,1.0,3,1,2,4,7,0xb2d336b0
2393.32,1.0,184,1,2,1,4,0xb2d2f188
2064.9,1.0,276,1,2,1,4,0xb2d619b2d
400000.46,2.0,1,4,3,4,11,0xb2d21429
0.57,2.0,41,1,3,2,6,0xb2d3c40b
682245.74,5.0,0,4,4,4,12,0xb2d0e461
190184.32,5.0,13,3,4,3,10,0xb2d64692
9.08,1.0,3,1,2,4,7,0xb2d6df00
24026.61,1.0,0,2,2,4,8,0xb2d32b14
20737.17,1.0,77,2,2,1,5,0xb2d60cb1
73002.58,8.0,5,3,4,3,10,0xb2d077d9
7879.22,1.0,0,2,2,4,8,0xb2d69ac7
1013.44,1.0,273,1,2,1,4,0xb2d58b9e
387593.58,2.0,0,4,3,4,11,0xb2d580df
300000.26,2.0,13,3,3,3,9,0xb2d8e1f6
54.62,1.0,0,1,2,4,7,0xb2d906a9
4.13,1.0,14,1,2,3,6,0xb2d81fe6
46005.9,2.0,21,2,3,2,7,0xb2d58c44
200048.52,2.0,29,3,3,2,8,0xb2d986f8
63073.3,2.0,10,3,3,3,9,0xb2d389a5
20076.45,1.0,0,2,2,4,8,0xb2d6a401
20043.91,1.0,98,2,2,1,5,0xb2d78173
11552.5,1.0,3,2,2,4,8,0xb2d15a7b
90057.53,2.0,239,3,3,1,7,0xb2d41e0a
91.12,1.0,9,1,2,3,6,0xb2d3084a
1228.31,1.0,0,1,2,4,7,0xb2d6ce7b
50002.72,2.0,20,2,3,2,7,0xb2d43554
590.67,1.0,14,1,2,3,6,0xb2d6428e
1467.56,1.0,0,1,2,4,7,0xb2d0d4e2
7.06,3.0,6,1,4,3,8,0xb2d14084
200481.42,3.0,29,3,4,2,9,0xb2d1cc8b
6652.56,1.0,6,2,2,3,7,0xb2d2dddf
400077.48,4.0,1,4,4,4,12,0xb2d10997
220808.34,2.0,18,3,3,2,8,0xb2d63ffc
487443.51,8.0,3,4,4,4,12,0xb2d5aa4f
3122.8,1.0,10,2,2,3,7,0xb2d8d403
38001.53,3.0,55,2,4,2,8,0xb2d5d976
6495.87,1.0,92,2,2,1,5,0xb2d6bb53
9738.18,1.0,26,2,2,2,6,0xb2d30ea8
216.74,1.0,0,1,2,4,7,0xb2d5d306
18118.3,1.0,0,2,2,4,8,0xb2d43ac1
197469.55,2.0,77,3,3,1,7,0xb2d32d53
397.52,1.0,116,1,2,1,4,0xb2d0ecdb
7056.17,1.0,184,2,2,1,5,0xb2d27bef
587117.75,4.0,62,4,4,2,10,0xb2d3ba71
271908.33,10.0,0,3,4,4,11,0xb2d32731
838.98,1.0,33,1,2,2,5,0xb2d76a95
1087.05,1.0,184,1,2,1,4,0xb2d0f238
10000.39,2.0,61,2,3,2,7,0xb2d8f04e
73589.96,1.0,62,3,2,2,7,0xb2d69644
3111.21,1.0,126,2,2,1,5,0xb2d3ec4a
1910.72,1.0,0,1,2,4,7,0xb2d1db29
1676.2,1.0,184,1,2,1,4,0xb2d36c89
8.97,1.0,45,1,2,2,5,0xb2d571fd
512.08,7.0,1,1,4,4,9,0x3b9b18f1
1032891.63,4.0,14,4,4,3,11,0xb2d5ba3e
660002.04,4.0,10,4,4,3,11,0xb2d22526
82544.75,3.0,65,3,4,2,9,0xb2d0fab1
820099.71,3.0,4,4,4,4,12,0xb2d34ffc
75.09,1.0,53,1,2,2,5,0xb2d4812c
4328.43,7.0,1,2,4,4,10,0xb2d069ff
16290.44,1.0,1,2,2,4,8,0xb2d510aa
418.62,1.0,14,1,2,3,6,0xb2d3b8ce
53859.24,2.0,13,3,3,3,9,0xb2d07fe3
10000.55,2.0,41,2,3,2,7,0xb2d535fc
348801.71,10.0,0,4,4,4,12,0xb2d575be
200007.34,2.0,132,3,3,1,7,0xb2d33a5f
406978.5,3.0,13,4,4,3,11,0xb2d39cd3
18099.38,2.0,75,2,3,1,6,0xb2d5f17ad
669448.92,2.0,27,4,3,2,9,0xb2d5277b
2820227.48,4.0,12,4,4,3,11,0xb2d11d79
1130.33,1.0,1,1,2,4,7,0xb2d7007d
0.0,1.0,5,1,2,3,6,0xb2d2d34a
1760018.62,4.0,45,4,4,2,10,0xb2d107ff
220265.04,3.0,20,3,4,2,9,0xb2d518cc
586922.07,8.0,4,4,4,4,12,0xb2d0831e
2135.28,2.0,92,1,3,1,5,0xb2d33faf
13249.79,1.0,0,2,2,4,8,0xb2d31e9a
61470.98,2.0,76,3,3,1,7,0xb2d64c27
100001.59,3.0,28,3,4,2,9,0xb2d9aeb6
110400.91,1.0,0,3,2,4,9,0xb2d2845c
1165041.89,2.0,0,4,3,4,11,0xb2d5bd83
883.16,1.0,13,1,2,3,6,0xb2d317c1
8081.37,1.0,184,2,2,1,5,0xb2d2a887
50016.92,2.0,18,2,3,2,7,0xb2d9d547
203554.09,2.0,153,3,3,1,7,0xb2d8fc91
6602.66,1.0,1,2,2,4,8,0xb2d3dfea
228354.51,1.0,0,3,2,4,9,0xb2d9f363
2.26,1.0,32,1,2,2,5,0xb2d2ce02
7808.58,1.0,11,2,2,3,7,0xb2d9e495
14967.35,1.0,0,2,2,4,8,0xb2d93470
2704.88,2.0,4,1,3,4,8,0xb2d1127e
210181.73,2.0,1,3,3,4,10,0xb2d6438f
4681.08,1.0,184,2,2,1,5,0xb2d1d8d8
1573.2,1.0,8,1,2,3,6,0xb2d59b2e
2005.7,1.0,0,1,2,4,7,0xb2d7f2c4
1019658.48,5.0,24,4,4,2,10,0xb2d4c7f4
60033.04,2.0,87,3,3,1,7,0xb2d26e7e
123650.06,4.0,4,3,4,4,11,0xb2d55e44
7944.21,1.0,11,2,2,3,7,0xb2d54bd2
18818.06,1.0,18,2,2,2,6,0xb2d929ab
668761.03,4.0,3,4,4,4,12,0xb2d56583
4280.72,1.0,0,2,2,4,8,0xb2d6fe28
54623.66,2.0,56,3,3,2,8,0xb2d1d8c7
11.46,1.0,58,1,2,2,5,0xb2d184f8
18853.23,1.0,0,2,2,4,8,0xb2da4a68
449.16,1.0,28,1,2,2,5,0xb2d25650
626332.28,4.0,6,4,4,3,11,0xb2d0eb39
171536.68,2.0,83,3,3,1,7,0xb2d51bc5
102345.43,2.0,157,3,3,1,7,0xb2d4ea14
360489.41,2.0,12,4,3,3,10,0xb2d252e0
660682.82,3.0,1,4,4,4,12,0xb2d0bf3c
144.67,1.0,2,1,2,4,7,0xb2d6da8c
1010.12,1.0,9,1,2,3,6,0xb2d6d7ec
2000000.49,2.0,5,4,3,3,10,0xb2d24d66
500000.55,3.0,2,4,4,4,12,0xb2d6f706
12.58,1.0,10,1,2,3,6,0xb2d60acb
484.23,1.0,5,1,2,3,6,0xb2d965e4
19862.53,1.0,0,2,2,4,8,0xb2d36b8a
0.66,1.0,68,1,2,1,4,0xb2d43c96
300066.96,2.0,21,3,3,2,8,0xb2d61e68
250007.1,2.0,31,3,3,2,8,0xb2d907d9
100004.22,2.0,209,3,3,1,7,0xb2d68918
53777.57,5.0,32,3,4,2,9,0xb2d076bd
572838.7,9.0,42,4,4,2,10,0xb2d5dbea
5335.93,1.0,4,2,2,4,8,0xb2d579cb
150014.21,3.0,123,3,4,1,8,0xb2d26105
18174.02,1.0,0,2,2,4,8,0xb2d6b8ae
77.0,1.0,63,1,2,2,5,0xb2d83b1e
860.79,1.0,0,1,2,4,7,0xb2d4fe10d
324360.44,2.0,92,4,3,1,8,0x3b9b35b6
768372.77,1.0,1,4,2,4,10,0xb2d5e624
2400.83,1.0,14,1,2,3,6,0xb2d8c628d
329105.24,2.0,58,4,3,2,9,0xb2d6b8cf
494000.0,2.0,10,4,3,3,10,0xb2d96ac0
70000.55,3.0,0,3,4,4,11,0xb2d66576
250970.63,3.0,3,3,4,4,11,0xb2d51e9a
35048.67,3.0,3,2,4,4,10,0xb2d136a4
280761.03,4.0,15,3,4,3,10,0xb2d63d7c
173629.06,2.0,0,3,3,4,10,0xb2da12cb
130002.74,2.0,10,3,3,3,9,0xb2d96532
506808.75,4.0,55,4,4,2,10,0xb2d6c2af
506643.69,4.0,33,4,4,2,10,0xb2d6dd47
101289.98,2.0,80,3,3,1,7,0xb2d26a0ed
6000.78,1.0,14,2,2,3,7,0xb2d9503a
2693.09,1.0,1,1,2,4,7,0xb2d6f0c1
201314.33,2.0,59,3,3,2,8,0xb2d292f8
405741.55,2.0,24,4,3,2,9,0xb2d63fd8
23002.47,2.0,19,2,3,2,7,0xb2d644f6
2103.2,1.0,11,1,2,3,6,0xb2d2275b
50002.11,2.0,92,2,3,1,6,0xb2d65d67
509631.69,1.0,0,4,2,4,10,0xb2d32e83
50000.53,2.0,61,2,3,2,7,0xb2d8f7f3
41354.45,1.0,0,2,2,4,8,0xb2d61276
3081236.44,8.0,14,4,4,3,11,0x3b9b490d
338273.91,15.0,4,4,4,4,12,0xb2d07825
8878.87,1.0,9,2,2,3,7,0xb2d42452
885360.53,15.0,0,4,4,4,12,0x3b9b3347
111968.9,4.0,83,3,4,1,8,0xb2d67ff2
100062.13,2.0,105,3,3,1,7,0xb2d5e037d
10583.05,1.0,4,2,2,4,8,0xb2d52c8f
65938.8,3.0,0,3,4,4,11,0xb2d06483
1661.41,1.0,9,1,2,3,6,0xb2d2eec0
109533.62,2.0,62,3,3,2,8,0xb2d2db45
187432.34,13.0,7,3,4,3,10,0x3b9af518
1314854.69,5.0,0,4,4,4,12,0xb2d67b35
3713.18,1.0,0,2,2,4,8,0xb2d906bf
417809.59,4.0,3,4,4,4,12,0xb2d4ac44
21592.26,2.0,26,2,3,2,7,0xb2d24b8f
38657.55,4.0,5,2,4,3,9,0xb2d50be9
194000.0,2.0,6,3,3,3,9,0xb2d3bc6c
5356.9,1.0,184,2,2,1,5,0xb2d0eff1
180357.77,1.0,10,3,2,3,8,0xb2d3f93c
660025.96,4.0,1,4,4,4,12,0xb2d17139
20405.28,7.0,40,2,4,2,8,0xb2d6a4f3
2302.1,1.0,144,1,2,1,4,0xb2d9058f
921.65,1.0,35,1,2,2,5,0xb2d21417
478973.89,5.0,0,4,4,4,12,0xb2d61e83
1083611.11,6.0,1,4,4,4,12,0xb2d689aa
146337.57,2.0,24,3,3,2,8,0xb2d6eef4
13734.76,1.0,1,2,2,4,8,0xb2d6b581
110020.66,3.0,66,3,4,2,9,0xb2d6c15c
72.83,1.0,28,1,2,2,5,0xb2d93956
25391.73,1.0,9,2,2,3,7,0xb2d07cdf
50002.11,2.0,62,2,3,2,7,0xb2d1859b
527.32,3.0,0,1,4,4,9,0xb2d067cf
856.88,1.0,14,1,2,3,6,0xb2d8d04c
3.76,1.0,6,1,2,3,6,0xb2d93c35
160489.42,6.0,40,3,4,2,9,0xb2d407e8
621013.37,4.0,2,4,4,4,12,0xb2d8e919
200008.44,2.0,49,3,3,2,8,0xb2d9d35c
115.26,1.0,26,1,2,2,5,0xb2d65357
440734.07,2.0,17,4,3,2,9,0xb2d62ca9
250588.26,4.0,39,3,4,2,9,0xb2d61e98
5830.61,1.0,12,2,2,3,7,0xb2da2b74
450000.91,2.0,21,4,3,2,9,0xb2d9855d
80000.0,2.0,3,3,3,4,10,0xb2d975d5
400008.44,2.0,53,4,3,2,9,0xb2d9cae6
550059.23,5.0,3,4,4,4,12,0xb2d3adb7
15013.69,1.0,2,2,2,4,8,0xb2d2aeb8
331948.48,2.0,140,4,3,1,8,0xb2d451e2
1765438.57,9.0,0,4,4,4,12,0xb2d377df
51.79,1.0,25,1,2,2,5,0xb2d93124
15142.03,1.0,184,2,2,1,5,0xb2d5c9a8
850020.26,6.0,32,4,4,2,10,0xb2d1bf25
51797.44,1.0,1,2,2,4,8,0xb2d6cf45
107476.26,2.0,224,3,3,1,7,0xb2d390c1
32.18,1.0,75,1,2,1,4,0xb2d3fc0c
100021.72,2.0,110,3,3,1,7,0xb2d26c26
2166.29,1.0,184,1,2,1,4,0xb2d38d76
285761.79,3.0,87,3,4,1,8,0xb2d5906d
100073.1,2.0,6,3,3,3,9,0xb2d39c27
12.56,1.0,13,1,2,3,6,0xb2d42b24
960.03,1.0,53,1,2,2,5,0xb2d64059
500110.58,2.0,15,4,3,3,10,0xb2d9281b
2343.81,1.0,0,1,2,4,7,0xb2d5ecd4
581887.86,8.0,6,4,4,3,11,0xb2d43477
151385.17,12.0,0,3,4,4,11,0xb2d1a119
720079.38,4.0,78,4,4,1,9,0xb2d69ca6
250989.89,3.0,213,3,4,1,8,0xb2d075ba
53880.12,2.0,34,3,3,2,8,0xb2d39825
1459.87,1.0,0,1,2,4,7,0xb2d6b7c1
501852.14,2.0,29,4,3,2,9,0xb2d8fa42
109180.4,2.0,6,3,3,3,9,0xb2d13933
204180.4,2.0,27,3,3,2,8,0xb2d5ffa9
480026.03,6.0,16,4,4,2,10,0xb2d4f8f0
37.18,1.0,11,1,2,3,6,0xb2d1928c
9711.53,1.0,0,2,2,4,8,0xb2d6c4e3
11253.93,2.0,92,2,3,1,6,0x3b9b2e0b
15.4,1.0,20,1,2,2,5,0xb2d4c7c8
201134.04,3.0,0,3,4,4,11,0xb2d60d92
400012.67,2.0,77,4,3,1,8,0xb2d99427
220072.13,2.0,46,3,3,2,8,0xb2d226ef
268001.64,3.0,17,3,4,2,9,0xb2d96af9
1998.17,1.0,0,1,2,4,7,0xb2d9538a
21521.19,1.0,5,2,2,3,7,0xb2d8e73e
16686.44,5.0,9,2,4,3,9,0xb2d6e1c6
1113447.8,2.0,195,4,3,1,8,0xb2d1e917
68.71,1.0,67,1,2,1,4,0xb2d5e718
250000.11,2.0,22,3,3,2,8,0xb2d9027f
210497.4,2.0,98,3,3,1,7,0xb2d6039d
50000.53,2.0,77,2,3,1,6,0xb2d996b7
83129.6,2.0,76,3,3,1,7,0xb2d58f82
270007.44,2.0,158,3,3,1,7,0xb2d6ca3d
12961.96,1.0,11,2,2,3,7,0xb2d2b79d
303.09,1.0,14,1,2,3,6,0xb2d24cae
109235.75,4.0,2,3,4,4,11,0xb2d0ba7c
207015.18,2.0,228,3,3,1,7,0xb2d56e61
52.78,1.0,11,1,2,3,6,0xb2d9142b
74.73,1.0,10,1,2,3,6,0xb2d9db17
22303.14,1.0,3,2,2,4,8,0xb2d56a17
10053.83,2.0,23,2,3,2,7,0xb2d6e2ab
128.79,1.0,6,1,2,3,6,0xb2d62fcd
2543.62,1.0,92,1,2,1,4,0xb2d156e9
5848.9,2.0,0,2,3,4,9,0xb2d4ad30
4042.44,1.0,10,2,2,3,7,0xb2d6a9c0
174003.24,6.0,28,3,4,2,9,0xb2d1030f
100011.64,2.0,125,3,3,1,7,0xb2d3fa74
310355.82,1.0,229,4,2,1,7,0xb2d54b78
1535193.49,7.0,2,4,4,4,12,0xb2d5298c
980270.79,4.0,21,4,4,2,10,0xb2d63844
2010.33,1.0,184,1,2,1,4,0xb2d55725
220025.44,4.0,41,3,4,2,9,0xb2d0f99f
355063.22,3.0,209,4,4,1,9,0xb2d4d954
10000.32,2.0,52,2,3,2,7,0xb2d907e9
33098.81,1.0,5,2,2,3,7,0xb2d18d70
42119.74,1.0,0,2,2,4,8,0xb2d1b63d
68000.0,3.0,0,3,4,4,11,0xb2d97bc7
176577.03,3.0,179,3,4,1,8,0xb2d22f06
2504.98,1.0,10,1,2,3,6,0xb2d417d9
11326.73,1.0,2,2,2,4,8,0xb2d69b79
18936.08,1.0,28,2,2,2,6,0xb2d6c6b4
81265.9,1.0,0,3,2,4,9,0xb2d921b8
1217.22,1.0,92,1,2,1,4,0xb2d30efa
18.65,1.0,0,1,2,4,7,0xb2d6af4a
2779.63,1.0,10,1,2,3,6,0xb2d5fbf8
0.0,1.0,55,1,2,2,5,0xb2d5cbd6
10060.91,1.0,7,2,2,3,7,0xb2d451ed
453910.34,6.0,25,4,4,2,10,0x3b9b46c5
111069.37,2.0,62,3,3,2,8,0xb2d22388
366.87,1.0,6,1,2,3,6,0xb2d916b5
517948.6,4.0,15,4,4,3,11,0xb2d43edf
702100.59,3.0,104,4,4,1,9,0xb2d400be
71555.7,3.0,3,3,4,4,11,0xb2d540ab
202415.81,2.0,0,3,3,4,10,0xb2d1dd47
400081.28,2.0,20,4,3,2,9,0xb2d94978
658.2,3.0,1,1,4,4,9,0xb2d08df4
250.09,1.0,26,1,2,2,5,0xb2d47c89
23788.7,1.0,0,2,2,4,8,0xb2d6b806
500000.0,2.0,4,4,3,4,11,0xb2d95607
2299663.29,7.0,1,4,4,4,12,0xb2d6095c
1697102.69,4.0,0,4,4,4,12,0xb2d6f005
102492.66,1.0,164,3,2,1,6,0xb2d35e94d
380050.64,2.0,10,4,3,3,10,0xb2d9a7f2
0.0,1.0,8,1,2,3,6,0xb2d610a8
120001.27,2.0,92,3,3,1,7,0xb2d98137
10000000.0,2.0,3,4,3,4,11,0xb2d9786b
3473.7,1.0,2,2,2,4,8,0xb2d92f44
157.31,1.0,2,1,2,4,7,0xb2d62e3b
12.57,1.0,34,1,2,2,5,0xb2d5ee98
280012.88,4.0,20,3,4,2,9,0xb2d9b44c
1577.56,1.0,9,1,2,3,6,0xb2d6f74f
4170.15,1.0,92,2,2,1,5,0xb2d1af34
102793.86,2.0,188,3,3,1,7,0xb2d54ac8
2262.68,1.0,0,1,2,4,7,0xb2d97b90
8021.27,1.0,131,2,2,1,5,0xb2d607d0
200173.25,2.0,249,3,3,1,7,0xb2d30c0b
14.79,1.0,138,1,2,1,4,0xb2d90cc2
10000.11,2.0,31,2,3,2,7,0xb2d93b93
51396.87,2.0,0,2,3,4,9,0xb2d41955
9810.98,1.0,0,2,2,4,8,0xb2d5e5c0
2306.7,1.0,92,1,2,1,4,0xb2d1b906
190973.82,2.0,5,3,3,3,9,0xb2d3380d
102013.46,4.0,8,3,4,3,10,0xb2d1312a
60363.85,2.0,129,3,3,1,7,0xb2d28758
70136.72,3.0,18,3,4,2,9,0xb2d0d9e7
1932.24,1.0,92,1,2,1,4,0xb2d64bca
400000.0,2.0,7,4,3,3,10,0xb2da5454
12.98,1.0,49,1,2,2,5,0xb2d5d430
1000028.4,5.0,20,4,4,2,10,0xb2d9903e
75974.12,1.0,9,3,2,3,8,0xb2d8c669
19.44,1.0,36,1,2,2,5,0xb2d396a5
70272.56,3.0,11,3,4,3,10,0xb2d78b3c
1627.22,1.0,1,1,2,4,7,0xb2d40fa7
1502.94,1.0,7,1,2,3,6,0xb2d68cb3
93674.94,1.0,0,3,2,4,9,0xb2d0cd5d
470015.79,6.0,18,4,4,2,10,0xb2d6afe1
1427.22,1.0,59,1,2,2,5,0xb2d1b6ba
2000477.71,3.0,161,4,4,1,9,0xb2d5e94a
367559.42,3.0,0,4,4,4,12,0xb2d095bf
500000.0,2.0,12,4,3,3,10,0xb2da46be
5.03,1.0,13,1,2,3,6,0xb2d6d7f0
1343598.4,1.0,184,4,2,1,7,0xb2d20edb
1159.0,1.0,1,1,2,4,7,0xb2d90bec
60000.0,2.0,3,3,3,4,10,0xb2d35a6ad
43.67,1.0,38,1,2,2,5,0xb2d9068d
4332.46,1.0,184,2,2,1,5,0x3b9b2a37
508984.74,2.0,16,4,3,2,9,0xb2d6c718
791196.31,5.0,0,4,4,4,12,0xb2d0bbfd
4223.88,1.0,0,2,2,4,8,0xb2d3fa7f
69.5,1.0,9,1,2,3,6,0xb2d5c398
30040882.96,2.0,45,4,3,2,9,0xb2d9099f
1001247.79,9.0,0,4,4,4,12,0x3b9b18f1d
0.42,1.0,0,1,2,4,7,0xb2d5df54
1181046.38,6.0,33,4,4,2,10,0xb2d262c6
2401843.85,11.0,19,4,4,2,10,0xb2d21a5c
38141.05,4.0,0,2,4,4,10,0xb2d6eb90
407878.18,2.0,73,4,3,1,8,0xb2d0f595
305655.05,5.0,147,4,4,1,9,0xb2d5820e
735.66,1.0,0,1,2,4,7,0xb2d42f8a
253026.13,5.0,2,3,4,4,11,0xb2d0a03e
650091.01,3.0,19,4,4,2,10,0xb2d9d7e0
63013.13,2.0,35,3,3,2,8,0xb2d5bd1a
14000.0,2.0,8,2,3,3,8,0xb2da4730
600027.38,2.0,129,4,3,1,8,0xb2d2107e
2091603.78,4.0,0,4,4,4,12,0xb2d194d6
423053.63,3.0,8,4,4,3,11,0xb2d57481
440063.66,4.0,1,4,4,4,12,0xb2d8ed77
170029.06,5.0,62,3,4,2,9,0xb2d33142
2002.09,1.0,2,1,2,4,7,0xb2d6c4a4
28.39,1.0,14,1,2,3,6,0xb2d2ef6d
4074.02,1.0,9,2,2,3,7,0xb2d8ca96
8464.3,1.0,0,2,2,4,8,0xb2d69a24
107625.69,2.0,0,3,3,4,10,0xb2d377b4
100353.36,3.0,32,3,4,2,9,0xb2d255d8
0.0,1.0,4,1,2,4,7,0xb2d69473
128.3,3.0,61,1,4,2,7,0xb2d3bce3
404.42,1.0,0,1,2,4,7,0xb2d48576
1833000.0,14.0,4,4,4,4,12,0xb2d5c894
10000.0,3.0,5,2,4,3,9,0xb2d53b0c
550941.5,9.0,1,4,4,4,12,0xb2d1131a
4399.34,1.0,9,2,2,3,7,0xb2d36b91
5.42,1.0,60,1,2,2,5,0xb2d937c3
532884.85,4.0,18,4,4,2,10,0xb2d1dae4
69201.81,1.0,92,3,2,1,6,0xb2d1acaa
150045.2,3.0,1,3,4,4,11,0xb2da1e7b
300.56,1.0,139,1,2,1,4,0xb2d6e0e0
12383.35,1.0,4,2,2,4,8,0xb2d6d4fb
2893.32,1.0,11,2,2,3,7,0xb2d56553
308626.19,2.0,73,4,3,1,8,0xb2d0a21f
190001.9,3.0,3,3,4,4,11,0xb2d812a7
530647.72,9.0,4,4,4,4,12,0xb2d4e7f9
91070.97,2.0,73,3,3,1,7,0xb2d6b8edd
631233.13,9.0,0,4,4,4,12,0xb2d09c74
82005.57,2.0,168,3,3,1,7,0xb2d1b194
20.42,1.0,39,1,2,2,5,0xb2d3f24c
282838.53,2.0,23,3,3,2,8,0xb2d0f4c6
4704.01,1.0,16,2,2,2,6,0xb2d8cc8e
1481.69,1.0,92,1,2,1,4,0xb2d2e5f0
190959.3,13.0,1,3,4,4,11,0x3b9b4896
27405469.49,3.0,193,4,4,1,9,0xb2d1c262
942232.05,7.0,10,4,4,3,11,0xb2d3e7c2
2227.91,1.0,121,1,2,1,4,0xb2d1d6d9
3.36,1.0,17,1,2,2,5,0xb2d5c869d
0.0,1.0,1,1,2,4,7,0xb2da54d0
2224143.41,8.0,4,4,4,4,12,0xb2d6ceba
522005.33,3.0,151,4,4,1,9,0xb2d3ccf2
67974.61,2.0,11,3,3,3,9,0xb2d111b3
650007.4,4.0,52,4,4,2,10,0xb2d636c5
408086.29,5.0,4,4,4,4,12,0xb2d2c8e2
1561058.78,29.0,0,4,4,4,12,0x3b9b0e1a
16.75,1.0,73,1,2,1,4,0xb2d9079b
30000.32,2.0,10,2,3,3,8,0xb2d966a3
534.32,1.0,1,1,2,4,7,0xb2d65b54
105092.38,1.0,49,3,2,2,7,0xb2d37c4d
10000.56,1.0,9,2,2,3,7,0xb2d51e7f
1500000.0,4.0,4,4,4,4,12,0xb2d69665
80002.74,2.0,52,3,3,2,8,0xb2d61f3c
25159.35,2.0,10,2,3,3,8,0xb2d48f38
300712.2,4.0,0,4,4,4,12,0xb2d0c4cd
1125987.87,13.0,4,4,4,4,12,0xb2d65854
500053.3,2.0,23,4,3,2,9,0xb2d905b6
10000.11,2.0,55,2,3,2,7,0xb2d904a7
51261.45,2.0,136,2,3,1,6,0xb2d33de6
600010.55,3.0,76,4,4,1,9,0xb2d98b73
160253.96,5.0,11,3,4,3,10,0xb2d21121
305930.67,2.0,154,4,3,1,8,0xb2d30e94
819.23,1.0,118,1,2,1,4,0xb2d09593
500000.0,2.0,8,4,3,3,10,0xb2da5181
453795.1,4.0,5,4,4,3,11,0xb2d37699
116733.88,2.0,10,3,3,3,9,0xb2d3e466
81.26,1.0,28,1,2,2,5,0xb2d947de
51627.2,2.0,18,2,3,2,7,0xb2d69507
410000.03,3.0,19,4,4,2,10,0xb2d90de3
100911.09,1.0,108,3,2,1,6,0xb2d38229
14529.95,1.0,3,2,2,4,8,0xb2d7f201
5039.18,1.0,4,2,2,4,8,0xb2d938b9
83886.71,2.0,13,3,3,3,9,0xb2d645a5
10148.75,1.0,0,2,2,4,8,0xb2d86944
301248.03,5.0,18,4,4,2,10,0xb2d12f47
10000.11,2.0,74,2,3,1,6,0xb2d99fb1
47548.58,1.0,0,2,2,4,8,0xb2d5867b
200000.0,5.0,3,3,4,4,11,0xb2d1227e
23732.21,1.0,9,2,2,3,7,0xb2d68fcad
3800021.06,6.0,6,4,4,3,11,0xb2d0bf73
183001.93,2.0,20,3,3,2,8,0xb2d950bd
0.55,1.0,81,1,2,1,4,0xb2d58b4d
70021.41,3.0,0,3,4,4,11,0xb2d38230
27834.87,1.0,6,2,2,3,7,0xb2d8edc9
2510249.72,7.0,13,4,4,3,11,0xb2d5bdf1
209.25,1.0,37,1,2,2,5,0xb2d0e644
1468207.2,10.0,0,4,4,4,12,0xb2d54eb6
60560.44,2.0,160,3,3,1,7,0xb2d61193
274499.0,5.0,0,3,4,4,11,0xb2d2b29c
50630.23,1.0,3,2,2,4,8,0xb2d825f4
334250.7,4.0,40,4,4,2,10,0xb2d6cbab
120366.26,5.0,1,3,4,4,11,0xb2d2da4b
1090005.39,3.0,18,4,4,2,10,0xb2d78eee
3767.92,1.0,1,2,2,4,8,0xb2d5d211
11235.0,1.0,0,2,2,4,8,0xb2d2ebdf
280005.06,3.0,27,3,4,2,9,0xb2d93be7
1541.3,1.0,0,1,2,4,7,0xb2d6c221
7549.68,1.0,0,2,2,4,8,0xb2d6b6b7
11589.46,1.0,6,2,2,3,7,0xb2d1200b
312295.66,7.0,4,4,4,4,12,0xb2d5c609
200021.22,2.0,1,3,3,4,10,0xb2d98e6b
300021.95,1.0,1,3,2,4,9,0xb2d0f935
100003.82,2.0,32,3,3,2,8,0xb2d6cd1e
15013.6,1.0,0,2,2,4,8,0xb2d77317
81086.07,1.0,68,3,2,1,6,0xb2d8d4d3
469285.9,2.0,0,4,3,4,11,0xb2d68cbc
251155.28,4.0,129,3,4,1,8,0xb2d5917d
852.95,1.0,10,1,2,3,6,0xb2d8c942
742861.65,4.0,86,4,4,1,9,0x3b9b4310
30193.71,1.0,11,2,2,3,7,0xb2d59118
200002.58,2.0,6,3,3,3,9,0xb2d1f45a
50352.13,2.0,179,2,3,1,6,0xb2d655ac
70919.83,2.0,8,3,3,3,9,0xb2d64776
3698.86,1.0,20,2,2,2,6,0xb2d30417
159020.26,2.0,0,3,3,4,10,0x3b9af2ce
3778.41,1.0,8,2,2,3,7,0xb2d5351ed
1813.76,1.0,194,1,2,1,4,0xb2d46d3bd
13754.77,1.0,3,2,2,4,8,0xb2d6b2fe
1442.8,1.0,92,1,2,1,4,0xb2d1a40e
70014.17,2.0,73,3,3,1,7,0xb2d5cdc2
2035.93,1.0,194,1,2,1,4,0xb2d58fa6
159420.16,2.0,53,3,3,2,8,0xb2d5c34d
250013.07,4.0,1,3,4,4,11,0xb2d5cf27
2400105.71,4.0,41,4,4,2,10,0xb2d62756
200030.04,2.0,10,3,3,3,9,0xb2d786a3
13629.28,1.0,1,2,2,4,8,0xb2d533c3d
527008.79,3.0,4,4,4,4,12,0xb2d2d13b
14183.25,1.0,2,2,2,4,8,0xb2d1c35c
521.45,1.0,10,1,2,3,6,0xb2d434ce
1517405.66,8.0,0,4,4,4,12,0xb2d2cab2
102.65,1.0,206,1,2,1,4,0xb2d41116
38.22,1.0,49,1,2,2,5,0xb2d35520
754529.53,1.0,11,4,2,3,9,0xb2d3a1c3
1117.91,1.0,2,1,2,4,7,0xb2d995f3
50000.0,2.0,7,2,3,3,8,0xb2d5bba8
178166.93,4.0,0,3,4,4,11,0xb2d2ff1a
12301.01,1.0,7,2,2,3,7,0xb2d96942
10080.82,1.0,92,2,2,1,5,0xb2d21a4a
163.26,2.0,25,1,3,2,6,0xb2d0955a
17437.96,1.0,1,2,2,4,8,0xb2d1feb7
1861.07,1.0,132,1,2,1,4,0xb2d5536e
204139.01,5.0,10,3,4,3,10,0xb2d5031d
60605.55,1.0,1,3,2,4,9,0xb2d405c6
1112011.55,2.0,77,4,3,1,8,0xb2d2cbe7
30001.58,2.0,98,2,3,1,6,0xb2d967cfd
21419.79,1.0,7,2,2,3,7,0xb2d21346
20150.4,1.0,92,2,2,1,5,0xb2d60983d
190000.0,7.0,3,3,4,4,11,0xb2d13d48
1491013.94,40.0,0,4,4,4,12,0xb2d247d7
28076.72,1.0,130,2,2,1,5,0xb2d55c5c
1107877.08,6.0,77,4,4,1,9,0xb2d0d8d6
797980.83,8.0,0,4,4,4,12,0xb2d2a32b
3026.06,1.0,9,2,2,3,7,0xb2d299fe
462841.29,4.0,0,4,4,4,12,0xb2d2bac2
211571.42,2.0,235,3,3,1,7,0xb2d40fa2
183249.61,3.0,5,3,4,3,10,0xb2d364fc
80.55,1.0,1,1,2,4,7,0xb2d570f6
10408.84,2.0,19,2,3,2,7,0xb2d251ba
300000.0,2.0,21,3,3,2,8,0xb2da25b0
4377.18,1.0,11,2,2,3,7,0xb2d94f23
280033.37,4.0,59,3,4,2,9,0xb2d18692
200000.0,2.0,0,3,3,4,10,0xb2da66c1
271075.98,3.0,3,3,4,4,11,0xb2d7d1e8
21564.32,1.0,4,2,2,4,8,0xb2d9026a
1.58,1.0,32,1,2,2,5,0xb2d537d3
180929.37,4.0,95,3,4,1,8,0xb2d576ca
500000.0,2.0,0,4,3,4,11,0xb2da6be7
450000.0,3.0,2,4,4,4,12,0xb2d6a2ca
280055.49,3.0,123,3,4,1,8,0xb2d1553e
1319.6,1.0,0,1,2,4,7,0xb2d68dfa
93000.0,6.0,0,3,4,4,11,0xb2d6947d
145017.93,2.0,24,3,3,2,8,0xb2d25c63
31100.96,2.0,83,2,3,1,6,0xb2d6329c
17109.84,1.0,1,2,2,4,8,0xb2d69626
500103.45,2.0,168,4,3,1,8,0xb2d8ddb3
50084.38,2.0,20,2,3,2,7,0xb2d5df7d
50000.53,2.0,25,2,3,2,7,0xb2da0da8
80167.29,3.0,102,3,4,1,8,0xb2d196c2
331172.19,2.0,10,4,3,3,10,0xb2d9f67c
827100.15,3.0,104,4,4,1,9,0xb2d3a93e
2997.57,1.0,184,2,2,1,5,0xb2d0bce7
211618.65,5.0,1,3,4,4,11,0xb2d374aa
6968.36,1.0,184,2,2,1,5,0xb2d1fb98
112.83,1.0,9,1,2,3,6,0xb2d8c55f
383.7,1.0,0,1,2,4,7,0xb2d33b66
137995.21,3.0,6,3,4,3,10,0xb2d225f4
2038.26,1.0,9,1,2,3,6,0xb2d37865
749.01,1.0,21,1,2,2,5,0xb2d6edaf
210745.94,3.0,30,3,4,2,9,0xb2d3b3ca
487179.44,4.0,1,4,4,4,12,0xb2d78702
89482.67,1.0,12,3,2,3,8,0xb2d92f69
346070.53,8.0,1,4,4,4,12,0xb2d166ef
112686.9,2.0,0,3,3,4,10,0x3b9b3ba5
5803.89,1.0,27,2,2,2,6,0xb2d6ccf7
1650017.42,4.0,39,4,4,2,10,0xb2d5b4ff
9763.57,1.0,0,2,2,4,8,0xb2d99fb8
258538.04,4.0,3,3,4,4,11,0xb2d93927
233353.03,8.0,0,3,4,4,11,0x3b9af1c3
160208.66,2.0,179,3,3,1,7,0xb2d281cc
200746.35,2.0,23,3,3,2,8,0xb2d1a5ce
525047.26,5.0,14,4,4,3,11,0xb2d5f31c
1081.2,1.0,222,1,2,1,4,0xb2d684c1
640746.45,4.0,0,4,4,4,12,0xb2d56c93
14150055.82,6.0,46,4,4,2,10,0xb2d9dfe4
124868.48,3.0,0,3,4,4,11,0xb2d20f9e
6355.78,1.0,184,2,2,1,5,0x3b9b19eb
1038.03,1.0,26,1,2,2,5,0xb2d612af
19.21,1.0,61,1,2,2,5,0xb2d94d63
2235.05,1.0,9,1,2,3,6,0xb2d25e5e
905736.17,3.0,41,4,4,2,10,0xb2d5ba3ed
1502.19,1.0,4,1,2,4,7,0xb2d21d3f
7002.65,1.0,20,2,2,2,6,0xb2d0fbed
560012.78,5.0,0,4,4,4,12,0xb2d62cd7
59804.63,3.0,28,3,4,2,9,0x3b9b3fef
75.41,1.0,0,1,2,4,7,0xb2d3a12b
282844.49,4.0,76,3,4,1,8,0xb2d6544c
452031.35,9.0,6,4,4,3,11,0xb2d52ff9
640005.18,3.0,27,4,4,2,10,0xb2d60938
53581.24,1.0,0,3,2,4,9,0xb2d5d517
485424.72,2.0,62,4,3,2,9,0xb2d6cbc8
227.13,1.0,10,1,2,3,6,0xb2d111eb
420033.61,3.0,181,4,4,1,9,0xb2d4baee
100026.08,5.0,5,3,4,3,10,0xb2d0e5d4
621338.4,1.0,7,4,2,3,9,0xb2d54758
120005.07,2.0,56,3,3,2,8,0xb2d9c318
312678.1,3.0,34,4,4,2,10,0xb2d23cc6
350030.66,2.0,5,4,3,3,10,0xb2d3784c
122619.89,2.0,143,3,3,1,7,0xb2d1a9f3
680004.42,10.0,3,4,4,4,12,0xb2d3c85a
2364.51,1.0,92,1,2,1,4,0xb2d1bad8
100068.48,1.0,35,3,2,2,7,0xb2d42b4c
368993.16,9.0,1,4,4,4,12,0xb2d064a6
77710.84,1.0,2,3,2,4,9,0xb2d420a3
397.89,1.0,0,1,2,4,7,0xb2d23012
922972.88,3.0,1,4,4,4,12,0xb2d61387
19398.9,1.0,4,2,2,4,8,0xb2d651ac
1330018.92,2.0,74,4,3,1,8,0xb2d1b523
58.02,1.0,0,1,2,4,7,0xb2d69488
202614.17,2.0,20,3,3,2,8,0xb2d2bff4
5437.8,1.0,65,2,2,2,6,0xb2d59191
64213.26,1.0,9,3,2,3,8,0xb2d8e1e1
50610.42,1.0,92,2,2,1,5,0xb2d315a2
563004.77,4.0,4,4,4,4,12,0xb2d97c59d
5753.18,1.0,3,2,2,4,8,0xb2d34543
1137.79,2.0,92,1,3,1,5,0xb2d068c1
601444.58,4.0,26,4,4,2,10,0xb2d06e65
1064006.16,9.0,7,4,4,3,11,0x3b9b1260
788.42,1.0,4,1,2,4,7,0xb2d19816
416987.37,5.0,60,4,4,2,10,0xb2d54021
180084.9,3.0,3,3,4,4,11,0xb2d5f18dd
33030.2,4.0,92,2,4,1,7,0xb2d6d6af
563.14,1.0,21,1,2,2,5,0xb2d8db06
461.08,1.0,49,1,2,2,5,0xb2d2afc0
79.49,1.0,23,1,2,2,5,0xb2d8c868
2790000.21,9.0,8,4,4,3,11,0xb2d6e458
8432.55,1.0,30,2,2,2,6,0xb2d335e9d
355.05,1.0,25,1,2,2,5,0xb2d1b50d
196.55,1.0,9,1,2,3,6,0xb2d6b670
314.12,1.0,16,1,2,2,5,0xb2d282b6
120005.19,3.0,6,3,4,3,10,0xb2d59669
1009.56,1.0,184,1,2,1,4,0xb2d358db
20337.11,1.0,17,2,2,2,6,0xb2d2d7ba
10000.11,2.0,45,2,3,2,7,0xb2d91b6a
1225.67,1.0,9,1,2,3,6,0xb2d3ee39
480182.73,3.0,79,4,4,1,9,0x3b9b2fa0d
220811.81,3.0,39,3,4,2,9,0xb2d19114
301.7,1.0,19,1,2,2,5,0xb2d9e7e0
81261.52,3.0,0,3,4,4,11,0xb2d23617
1007.86,1.0,184,1,2,1,4,0xb2d2a5fd
323523.99,3.0,83,4,4,1,9,0xb2d5251e
162494.28,2.0,144,3,3,1,7,0xb2d1de2f
1574.35,1.0,2,1,2,4,7,0xb2d5ae9c
368.37,2.0,14,1,3,3,7,0xb2d081e7
16911.08,1.0,10,2,2,3,7,0xb2d5693b
2268.18,1.0,184,1,2,1,4,0xb2d1b42a
8.96,1.0,34,1,2,2,5,0xb2d686f4
84000.08,2.0,0,3,3,4,10,0xb2d1bdf1
643.14,1.0,48,1,2,2,5,0xb2d62e7d
388.46,1.0,0,1,2,4,7,0xb2d7ecbb
200254.33,2.0,32,3,3,2,8,0xb2d5f338
13208.67,1.0,0,2,2,4,8,0xb2d6d076
2165.47,1.0,9,1,2,3,6,0xb2d8ccc3
5724.82,1.0,1,2,2,4,8,0xb2d21f63
262057.41,2.0,1,3,3,4,10,0xb2d5026d
10166.74,1.0,10,2,2,3,7,0xb2d2cd5d
815095.46,2.0,1,4,3,4,11,0xb2d0d589
4598.29,2.0,92,2,3,1,6,0xb2d4d046
92509.77,3.0,3,3,4,4,11,0xb2d6044c
57401.7,1.0,89,3,2,1,6,0xb2d0f440
1161.68,1.0,92,1,2,1,4,0xb2d07779
434000.71,4.0,16,4,4,2,10,0xb2d15b8e
1739.62,1.0,68,1,2,1,4,0xb2d6009c
50093.95,2.0,24,2,3,2,7,0xb2d88b58
4187.4,1.0,92,2,2,1,5,0xb2d1dca0
1422054.47,10.0,3,4,4,4,12,0xb2d58df0
227574.86,3.0,63,3,4,2,9,0xb2d68267
1485.34,1.0,184,1,2,1,4,0xb2d13698
1211.27,1.0,33,1,2,2,5,0xb2d62bfe
376096.81,6.0,6,4,4,3,11,0x3b9ada8c
501776.05,3.0,40,4,4,2,10,0xb2d9e470
221588.27,2.0,27,3,3,2,8,0xb2d8c7f2
260.64,1.0,0,1,2,4,7,0xb2d4fbdd
2933.4,1.0,81,2,2,1,5,0xb2d2b72c
2508.88,1.0,0,1,2,4,7,0xb2d6c1b9
1054579.88,9.0,1,4,4,4,12,0xb2d20ace
198.17,1.0,1,1,2,4,7,0xb2da33a7
1013.09,1.0,95,1,2,1,4,0xb2d6b11d
502106.55,2.0,32,4,3,2,9,0xb2d1c61c
50003.79,2.0,40,2,3,2,7,0xb2d59ab2
134337.78,3.0,24,3,4,2,9,0xb2d59d16
575240.54,5.0,0,4,4,4,12,0xb2d56d63
200003.0,2.0,12,3,3,3,9,0xb2d95e4c
1403.43,4.0,184,1,4,1,6,0xb2d3ce9d
982.04,1.0,1,1,2,4,7,0xb2d8d359
1571000.0,34.0,0,4,4,4,12,0xb2d42b37
802927.82,2.0,20,4,3,2,9,0xb2d5b726
998.48,1.0,35,1,2,2,5,0xb2d45445
411516.61,7.0,33,4,4,2,10,0x3b9af449
360039.1,2.0,13,4,3,3,10,0xb2da1b8a
1265024.48,9.0,4,4,4,4,12,0xb2d0bba3
110021.2,3.0,2,3,4,4,11,0xb2d9f62a
450000.0,3.0,6,4,4,3,11,0xb2d783d0
191008.85,4.0,0,3,4,4,11,0xb2d29fa9
1066297.51,6.0,5,4,4,3,11,0xb2d6a113
500005.28,2.0,27,4,3,2,9,0xb2d94242
153693.56,2.0,172,3,3,1,7,0xb2d610fc
3500.59,1.0,1,2,2,4,8,0xb2d4c080
362748.45,5.0,63,4,4,2,10,0xb2d24ebb
5666.5,1.0,9,2,2,3,7,0xb2d32b62
319071.32,4.0,74,4,4,1,9,0xb2d19780
1013.67,1.0,131,1,2,1,4,0xb2d23737
5.62,1.0,63,1,2,2,5,0xb2d44d3d
465484.69,5.0,0,4,4,4,12,0xb2d10681
233.31,1.0,5,1,2,3,6,0xb2d2ccfb
85679.61,2.0,4,3,3,4,10,0xb2d33597
500141.19,2.0,195,4,3,1,8,0xb2d6123f
280094.7,2.0,27,3,3,2,8,0xb2d69825
2201234.86,1.0,24,4,2,2,8,0xb2d13319
183.54,1.0,0,1,2,4,7,0xb2d2160f
846550.44,8.0,4,4,4,4,12,0xb2d596c6
516006.65,2.0,295,4,3,1,8,0xb2d693e2
430163.17,3.0,1,4,4,4,12,0xb2d5d1f7
890000.0,8.0,0,4,4,4,12,0xb2d5b26e
52539.44,2.0,4,3,3,4,10,0xb2d5c19c
61146.34,3.0,59,3,4,2,9,0xb2d33ed2
5633.73,1.0,0,2,2,4,8,0xb2d27c34
1878.86,7.0,0,1,4,4,9,0xb2d21630d
6408.19,1.0,0,2,2,4,8,0xb2d906b2
304000.59,4.0,6,4,4,3,11,0xb2d402ad
100952.55,1.0,66,3,2,2,7,0xb2d27cf7
1270036.84,6.0,18,4,4,2,10,0xb2d95428
737003.7,3.0,3,4,4,4,12,0xb2da1e3d
273052.18,5.0,25,3,4,2,9,0xb2d1e72e
2681.04,1.0,121,1,2,1,4,0xb2d6248f
1000163.17,4.0,10,4,4,3,11,0xb2d6433a
1050.52,1.0,94,1,2,1,4,0xb2d6fada
67.26,1.0,23,1,2,2,5,0xb2d6ead6
1770.33,1.0,11,1,2,3,6,0xb2d6cb99
349508.14,3.0,0,4,4,4,12,0xb2d31f7f
79.35,1.0,18,1,2,2,5,0xb2d5c760
101127.34,3.0,5,3,4,3,10,0xb2d408cbd
2.59,1.0,8,1,2,3,6,0xb2d0e2be
7632.24,1.0,23,2,2,2,6,0xb2d9be29
36558.78,1.0,51,2,2,2,6,0xb2d356b4
500555.9,9.0,4,4,4,4,12,0xb2d27578
494.92,1.0,0,1,2,4,7,0xb2d252f6
489.83,1.0,36,1,2,2,5,0xb2d8d61b
50000.53,2.0,80,2,3,1,6,0xb2d94262
391590.65,6.0,32,4,4,2,10,0xb2d32544
201.29,1.0,2,1,2,4,7,0xb2d6c31a
9565.69,1.0,8,2,2,3,7,0xb2d9e930
9006.55,1.0,2,2,2,4,8,0xb2d93763
1000064.92,3.0,23,4,4,2,10,0xb2d6e5f7
560086.09,3.0,66,4,4,2,10,0xb2d26d3e
21.75,1.0,77,1,2,1,4,0xb2d370cb
726106.21,5.0,1,4,4,4,12,0xb2d56668
450427.46,1.0,14,4,2,3,9,0xb2d8a498
64.04,1.0,157,1,2,1,4,0xb2d6104fd
477.69,1.0,13,1,2,3,6,0xb2d369af
50000.0,2.0,0,2,3,4,9,0xb2d16a81
105001.11,2.0,217,3,3,1,7,0xb2d74378
244152.07,5.0,63,3,4,2,9,0xb2d58339
300118.15,2.0,143,4,3,1,8,0xb2d19d06
400727.94,3.0,6,4,4,3,11,0xb2d97aae
81313.48,2.0,214,3,3,1,7,0xb2d765c0d
2000.25,2.0,0,1,3,4,8,0xb2d0bd69
179884.88,5.0,0,3,4,4,11,0x3b9b3c42
20927.64,1.0,1,2,2,4,8,0xb2d38289
95009.49,2.0,39,3,3,2,8,0xb2d50e9c
217170.41,2.0,20,3,3,2,8,0xb2d13dfb
1750.28,1.0,230,1,2,1,4,0xb2d634a6d
414817.5,3.0,21,4,4,2,10,0xb2d6e857
5001.16,1.0,31,2,2,2,6,0xb2d926cb
1000000.0,1.0,0,4,2,4,10,0xb2da655c
52958.38,2.0,92,3,3,1,7,0xb2d5679ad
186.19,1.0,15,1,2,3,6,0xb2d26e5a
722254.64,7.0,0,4,4,4,12,0xb2d12791
21.23,1.0,38,1,2,2,5,0xb2d6264c
952.53,1.0,10,1,2,3,6,0xb2d93282
397706.63,4.0,30,4,4,2,10,0xb2d07af9
4.29,1.0,25,1,2,2,5,0xb2d6657c
30004.11,2.0,18,2,3,2,7,0xb2da1e89
300038.12,4.0,11,3,4,3,10,0xb2d57f0a
182878.51,7.0,5,3,4,3,10,0xb2d5c5f1
512205.1,4.0,76,4,4,1,9,0xb2d07f6c
496875.32,3.0,4,4,4,4,12,0xb2d3339e
280072.12,3.0,18,3,4,2,9,0xb2d4cdd7
16725.29,1.0,7,2,2,3,7,0xb2d4fde9
6140.64,1.0,0,2,2,4,8,0xb2d2aab9
133000.31,2.0,7,3,3,3,9,0xb2d35f8f
1340.91,1.0,17,1,2,2,5,0xb2d2c5cb
21511.56,1.0,8,2,2,3,7,0xb2d8cf8a
0.0,1.0,9,1,2,3,6,0xb2d4404f
2.44,2.0,25,1,3,2,6,0xb2d07984
258489.26,4.0,1,3,4,4,11,0xb2d50917
451282.33,2.0,4,4,3,4,11,0xb2d089e3
5610.18,2.0,0,2,3,4,9,0xb2d07c56
265525.04,8.0,4,3,4,4,11,0xb2d6ee2d
96.11,1.0,10,1,2,3,6,0xb2d76472
95000.0,2.0,1,3,3,4,10,0xb2da6287
100974.95,3.0,209,3,4,1,8,0xb2d15345
881.59,1.0,0,1,2,4,7,0xb2d20fad
84.36,1.0,0,1,2,4,7,0xb2d65970
1810332.36,2.0,73,4,3,1,8,0xb2d1266a
3472.3,2.0,92,2,3,1,6,0xb2d16e84
330368.45,5.0,10,4,4,3,11,0xb2d90759
4688.44,1.0,19,2,2,2,6,0xb2d1b8b1
1006653.83,2.0,49,4,3,2,9,0xb2d94f06
1019.16,1.0,184,1,2,1,4,0x3b9b3ddf
8.44,1.0,54,1,2,2,5,0xb2d90386
41199.76,2.0,92,2,3,1,6,0xb2d1dd0e
50000.0,2.0,0,2,3,4,9,0xb2d97f4e
950020.06,3.0,18,4,4,2,10,0xb2d1205f
1016.52,1.0,184,1,2,1,4,0xb2d0f1aa
2000642.8,2.0,3,4,3,4,11,0x3b9b24a6
1027.07,1.0,8,1,2,3,6,0xb2d9afd3
5733.7,1.0,0,2,2,4,8,0xb2d43c6e
1144493.83,5.0,16,4,4,2,10,0xb2d244d1
676103.81,15.0,0,4,4,4,12,0xb2d60b76
1221737.33,2.0,49,4,3,2,9,0xb2d19400
170008.12,2.0,25,3,3,2,8,0xb2d68695
9000.81,1.0,0,2,2,4,8,0xb2d0bf47
350716.85,3.0,54,4,4,2,10,0xb2d99907
1768.06,1.0,10,1,2,3,6,0xb2d55747
8307.42,1.0,7,2,2,3,7,0xb2d1bd99
4655.31,1.0,93,2,2,1,5,0xb2d2eef2
3225.35,1.0,6,2,2,3,7,0xb2d61e74
100046.5,2.0,263,3,3,1,7,0xb2d5f920
11260.81,1.0,92,2,2,1,5,0xb2d2acf8
1.59,1.0,10,1,2,3,6,0xb2d78c27
3241.25,1.0,10,2,2,3,7,0xb2d2d8b8
18.71,1.0,68,1,2,1,4,0xb2d34f74
129324.35,7.0,49,3,4,2,9,0xb2d41c77
260059.0,2.0,92,3,3,1,7,0xb2d28607
420000.0,5.0,0,4,4,4,12,0xb2d9e951
30118.91,3.0,31,2,4,2,8,0xb2d69a0c
753721.48,7.0,1,4,4,4,12,0xb2d22db7
870098.83,4.0,138,4,4,1,9,0xb2d16d58
10341.69,2.0,46,2,3,2,7,0xb2d12a0c
500876.58,2.0,60,4,3,2,9,0xb2d6b2ab
204498.35,1.0,3,3,2,4,9,0xb2d60850
325.69,1.0,4,1,2,4,7,0xb2d3ebb2
445.36,1.0,0,1,2,4,7,0xb2d9ec5d
49.98,4.0,300,1,4,1,6,0xb2d24479
55737.53,1.0,45,3,2,2,7,0xb2d8ed21
6783.87,1.0,27,2,2,2,6,0xb2d14d59
6212.33,1.0,15,2,2,3,7,0xb2da05cc
4820.26,1.0,14,2,2,3,7,0xb2d61bedd
1136.77,1.0,52,1,2,2,5,0xb2d63195
185.0,1.0,0,1,2,4,7,0xb2d659bf
745.8,1.0,0,1,2,4,7,0xb2d6b800
196858.75,3.0,62,3,4,2,9,0xb2d5379a
4493.41,1.0,12,2,2,3,7,0xb2d61b6c
200000.0,2.0,307,3,3,1,7,0xb2d68614
87269.04,2.0,47,3,3,2,8,0xb2d323e9
50002.75,2.0,41,2,3,2,7,0xb2d223e5
667292.02,6.0,20,4,4,2,10,0x3b9ad43c
782.43,1.0,9,1,2,3,6,0xb2d315ce
100003.81,4.0,11,3,4,3,10,0xb2d69c37
312139.92,2.0,8,4,3,3,10,0xb2d57de8
116130.28,3.0,4,3,4,4,11,0xb2d1c4f4
5690.87,1.0,8,2,2,3,7,0xb2d2a6d9
600157.55,3.0,9,4,4,3,11,0xb2d20504
50.21,2.0,19,1,3,2,6,0x3b9b1849
8.33,1.0,2,1,2,4,7,0xb2d5ca1f
248368.02,1.0,4,3,2,4,9,0xb2d14c39
13012.22,2.0,168,2,3,1,6,0xb2d2b392
223003.2,3.0,13,3,4,3,10,0xb2d99c1b
1954.38,1.0,92,1,2,1,4,0xb2d124dd
12.02,1.0,19,1,2,2,5,0xb2d4f2cf
438308.46,4.0,4,4,4,4,12,0xb2d95403
36487.35,1.0,27,2,2,2,6,0xb2d1c0aa
1087.19,1.0,253,1,2,1,4,0xb2d26e23
203257.18,2.0,1,3,3,4,10,0xb2d62b4c
182055.85,1.0,92,3,2,1,6,0xb2d41654
63014.01,2.0,214,3,3,1,7,0xb2d1d6c3
3958.28,1.0,19,2,2,2,6,0xb2d272ed
1904240.25,7.0,8,4,4,3,11,0xb2d25e82
200014.78,2.0,74,3,3,1,7,0xb2d989c5
430099.86,4.0,3,4,4,4,12,0xb2d61026
250888.02,2.0,39,3,3,2,8,0xb2d9f5ed
1004.25,2.0,33,1,3,2,6,0x3b9b3b57
405655.64,3.0,20,4,4,2,10,0xb2d6097b
4545.41,1.0,3,2,2,4,8,0xb2d536be
100200.63,1.0,54,3,2,2,7,0xb2d3c074
396364.02,9.0,0,4,4,4,12,0xb2d3d0a8
442495.68,5.0,3,4,4,4,12,0xb2d1f7f7
200009.88,2.0,20,3,3,2,8,0xb2d5cb53
16981.48,1.0,14,2,2,3,7,0xb2d38f43
380004.54,10.0,21,4,4,2,10,0xb2d92ec6
250055.79,5.0,143,3,4,1,8,0xb2d0d7b0
1070953.52,4.0,3,4,4,4,12,0xb2d246a6
4162.67,3.0,145,2,4,1,7,0xb2d5fda0
5028.44,2.0,0,2,3,4,9,0x3b9b0fb1
165030.0,2.0,14,3,3,3,9,0xb2d29656
120001.27,2.0,51,3,3,2,8,0xb2d904f1
6737.48,1.0,8,2,2,3,7,0xb2d62494
79213.4,3.0,6,3,4,3,10,0x3b9b3c3b
10272.87,1.0,0,2,2,4,8,0xb2d17d3f
1052.01,4.0,24,1,4,2,7,0xb2d69390
104015.87,3.0,8,3,4,3,10,0xb2d48b81
250100.24,3.0,62,3,4,2,9,0xb2d0d1c8
1010.01,1.0,92,1,2,1,4,0xb2d290b0
520936.38,4.0,3,4,4,4,12,0xb2d570df
156453.61,2.0,0,3,3,4,10,0xb2d5646c
17942.19,2.0,158,2,3,1,6,0xb2d06807
5988.37,3.0,92,2,4,1,7,0x3b9b1671
1005.0,1.0,119,1,2,1,4,0xb2d45ce3
7207.86,1.0,82,2,2,1,5,0xb2d6e1c3
0.17,3.0,28,1,4,2,7,0xb2d93cb8
1091795.07,9.0,0,4,4,4,12,0xb2d0e5b9
76107.04,1.0,31,3,2,2,7,0xb2d5fe82
337091.7,8.0,10,4,4,3,11,0xb2d16d67
9053.74,1.0,14,2,2,3,7,0xb2d6e8e0
2933.26,1.0,92,2,2,1,5,0xb2d41788
3111.82,1.0,138,2,2,1,5,0xb2d0e36a
391115.39,3.0,59,4,4,2,10,0xb2d24c37
185558.32,2.0,88,3,3,1,7,0xb2d50cab
17.39,1.0,67,1,2,1,4,0xb2d87a94
180018.41,4.0,125,3,4,1,8,0xb2d16fd1
170006.59,4.0,11,3,4,3,10,0xb2d0ed1b
271442.61,2.0,19,3,3,2,8,0xb2d94014
760031.43,6.0,10,4,4,3,11,0xb2d19119
0.04,1.0,68,1,2,1,4,0xb2d6475f
1246864.07,5.0,5,4,4,3,11,0xb2d12b6e
97.49,1.0,2,1,2,4,7,0xb2d91ef7
0.0,1.0,191,1,2,1,4,0xb2d62199
136189.8,2.0,0,3,3,4,10,0xb2d6b32d
1053.75,1.0,309,1,2,1,4,0xb2d33e4d
150734.94,2.0,27,3,3,2,8,0xb2d4356f
3335.99,1.0,0,2,2,4,8,0xb2d30aae
1500.95,5.0,184,1,4,1,6,0x3b9b115c
466000.0,7.0,1,4,4,4,12,0x3b9b1a37
60809.63,2.0,43,3,3,2,8,0xb2d4b61e
200030.25,2.0,101,3,3,1,7,0xb2d3efb6d
163103.25,8.0,14,3,4,3,10,0xb2d1aaeb
500000.0,2.0,6,4,3,3,10,0xb2d9725e
511892.39,3.0,68,4,4,1,9,0xb2d4aaec
300394.38,2.0,7,4,3,3,10,0xb2d69e8c
180352.9,2.0,49,3,3,2,8,0xb2d3bb45
170053.79,4.0,20,3,4,2,9,0xb2d2e38b
518212.03,2.0,13,4,3,3,10,0xb2d6053d
175865.22,6.0,3,3,4,4,11,0xb2d5c609d
18025.04,1.0,7,2,2,3,7,0xb2d1d955
9020.8,1.0,92,2,2,1,5,0xb2d0653d
51.58,1.0,11,1,2,3,6,0xb2da37ce
467.73,2.0,10,1,3,3,7,0xb2d2f3a3
200047.49,2.0,42,3,3,2,8,0xb2d9ada0
0.0,1.0,12,1,2,3,6,0xb2d28028
110089.17,2.0,196,3,3,1,7,0xb2d578e2
320099.82,3.0,39,4,4,2,10,0xb2d21d36
50079.62,2.0,41,2,3,2,7,0xb2d5521d
70847.5,1.0,69,3,2,1,6,0xb2d8e432
1002.46,1.0,92,1,2,1,4,0xb2d65573
80422.57,2.0,3,3,3,4,10,0xb2d5963c
106008.94,5.0,41,3,4,2,9,0xb2d64c60
1769.58,1.0,18,1,2,2,5,0xb2d33859
2414.55,1.0,9,1,2,3,6,0xb2d2e242
2.13,1.0,9,1,2,3,6,0xb2d5a08c
3.11,1.0,49,1,2,2,5,0xb2d407f1
307424.53,1.0,40,4,2,2,8,0xb2d8d056
5849.8,1.0,1,2,2,4,8,0xb2d600dd
1518.61,1.0,9,1,2,3,6,0xb2d8d12b
267967.59,4.0,38,3,4,2,9,0xb2d63bcd
1012578.88,7.0,21,4,4,2,10,0xb2d61226
1012857.87,3.0,111,4,4,1,9,0xb2d22ac4
101168.58,2.0,87,3,3,1,7,0xb2d5d591
8213.11,1.0,0,2,2,4,8,0xb2d85ce3
355502.72,3.0,0,4,4,4,12,0xb2d51377
1218940.33,1.0,0,4,2,4,10,0xb2d3e495
9259.67,1.0,1,2,2,4,8,0xb2d8d5d3
431539.03,3.0,19,4,4,2,10,0xb2d6fb37
130016.49,2.0,42,3,3,2,8,0xb2d9e65f
28178.24,2.0,0,2,3,4,9,0xb2d0bd26
13710.54,1.0,15,2,2,3,7,0xb2d51e5b
115176.58,6.0,0,3,4,4,11,0x3b9b185c
67345.4,1.0,184,3,2,1,6,0xb2d0840d
4500.09,1.0,5,2,2,3,7,0xb2d43821
40108.28,1.0,0,2,2,4,8,0xb2d1af76
170230.92,2.0,76,3,3,1,7,0xb2d5f586
80004.68,2.0,55,3,3,2,8,0xb2d6325f
180005.7,2.0,18,3,3,2,8,0xb2da2887
40113.42,4.0,8,2,4,3,9,0xb2d58d15
14840.25,1.0,23,2,2,2,6,0xb2d45be3
512437.95,5.0,10,4,4,3,11,0xb2d3a644
1252.44,1.0,92,1,2,1,4,0xb2d266f9d
410000.95,5.0,3,4,4,4,12,0xb2d4d46d
120086.21,2.0,92,3,3,1,7,0xb2d2197e
564.48,2.0,10,1,3,3,7,0x3b9b4838
2016379.71,6.0,23,4,4,2,10,0xb2d40712
564086.1,4.0,22,4,4,2,10,0xb2d9d556
2603.37,1.0,149,1,2,1,4,0xb2d2881c
1915.63,1.0,184,1,2,1,4,0xb2d2f2e3
130000.35,3.0,3,3,4,4,11,0xb2d681e9
165007.37,4.0,0,3,4,4,11,0xb2d630e2
4.77,1.0,10,1,2,3,6,0xb2d9d3e7
4261.39,1.0,0,2,2,4,8,0xb2d6b4c4
570078.7,3.0,0,4,4,4,12,0xb2d39a6b
1409652.69,4.0,10,4,4,3,11,0x3b9b3571
760518.23,2.0,92,4,3,1,8,0xb2d2e44c
50002.68,2.0,21,2,3,2,7,0xb2da1e90
104000.0,2.0,3,3,3,4,10,0xb2d90f5b
1911.96,1.0,1,1,2,4,7,0xb2d21f0b
211747.87,2.0,15,3,3,3,9,0xb2d5ea16
1716.28,1.0,126,1,2,1,4,0xb2d37cac
1232.16,1.0,0,1,2,4,7,0xb2d27deb
200967.16,2.0,182,3,3,1,7,0xb2d61553
100004.22,2.0,92,3,3,1,7,0xb2d9799c
667743.55,3.0,53,4,4,2,10,0xb2d1dc61
2076083.92,5.0,83,4,4,1,9,0xb2d414d7d
9000.18,1.0,0,2,2,4,8,0xb2d1ff2e
200012.3,2.0,66,3,3,2,8,0xb2d4b8a8
324012.07,4.0,101,4,4,1,9,0xb2d1056f
2218.12,1.0,21,1,2,2,5,0xb2d3942e
844.38,1.0,13,1,2,3,6,0xb2d3b0c6
2243920.28,7.0,0,4,4,4,12,0xb2d11ce2
5100.58,1.0,20,2,2,2,6,0xb2d26ecd
250932.12,2.0,34,3,3,2,8,0xb2d2d995
180032.92,3.0,34,3,4,2,9,0xb2d65554
100719.53,2.0,116,3,3,1,7,0xb2d684ca
112772.98,3.0,105,3,4,1,8,0xb2d603f0
75560.4,4.0,0,3,4,4,11,0xb2d6443f
1060013.47,8.0,0,4,4,4,12,0xb2d22735
4.39,1.0,3,1,2,4,7,0xb2d6a9b8
1921281.07,9.0,32,4,4,2,10,0xb2d1872a
50000.53,2.0,45,2,3,2,7,0xb2d91b9e
0.0,1.0,0,1,2,4,7,0xb2d21a7e
3806.04,2.0,92,2,3,1,6,0x3b9b29fe
400043.91,2.0,18,4,3,2,9,0xb2da0b8d
745713.53,7.0,4,4,4,4,12,0xb2d24c31
253461.77,3.0,13,3,4,3,10,0xb2d245f8
140002.94,3.0,4,3,4,4,11,0xb2d242dd
20050.88,3.0,63,2,4,2,8,0xb2d630d8
50301.06,1.0,92,2,2,1,5,0xb2d3e9e6
155529.98,3.0,3,3,4,4,11,0xb2d64f46
21.2,1.0,14,1,2,3,6,0xb2d2457f
3.59,1.0,67,1,2,1,4,0xb2d9aeee
9641.14,3.0,7,2,4,3,9,0x3b9af490
1473.14,1.0,35,1,2,2,5,0xb2d30e8f
3801.99,1.0,31,2,2,2,6,0xb2d685f0
280046.53,1.0,22,3,2,2,7,0xb2d6d53d
103.84,1.0,101,1,2,1,4,0xb2d283f9
11.02,1.0,49,1,2,2,5,0xb2d30c79
190749.9,1.0,2,3,2,4,9,0xb2d15545
723253.38,11.0,0,4,4,4,12,0xb2d624fb
0.0,1.0,0,1,2,4,7,0xb2d5d1b9
2284051.13,10.0,4,4,4,4,12,0xb2d625b6
33041.63,2.0,157,2,3,1,6,0xb2d25a1f
488228.99,5.0,25,4,4,2,10,0xb2d78736
75.34,1.0,8,1,2,3,6,0xb2d36d4cd
43.87,1.0,26,1,2,2,5,0xb2d5f3e1
60001.9,2.0,192,3,3,1,7,0xb2d6a1a1d
280981.41,5.0,74,3,4,1,8,0xb2d2abc3
321202.8,2.0,102,4,3,1,8,0xb2d1949b
340007.1,5.0,59,4,4,2,10,0xb2d478d1
30037.05,2.0,63,2,3,2,7,0xb2d5f2bd
11592.17,1.0,159,2,2,1,5,0xb2d63b6b
2702.6,1.0,290,1,2,1,4,0xb2d156ea
7342.85,4.0,36,2,4,2,8,0xb2d6071c
60055.17,2.0,0,3,3,4,10,0xb2d34926
345977.81,4.0,20,4,4,2,10,0xb2d06838d
30008.33,2.0,86,2,3,1,6,0xb2d9807d
115082.69,4.0,69,3,4,1,8,0xb2d60954
60000.59,1.0,1,3,2,4,9,0xb2d2494d
102.46,1.0,35,1,2,2,5,0xb2d4e923
1047190.96,1.0,0,4,2,4,10,0xb2d303dd
3517.41,1.0,184,2,2,1,5,0xb2d42f60
237000.0,2.0,11,3,3,3,9,0xb2d82621
100.0,6.0,4,1,4,4,9,0xb2d2036e
250005.28,1.0,11,3,2,3,8,0xb2d9d3d2
10.48,1.0,10,1,2,3,6,0xb2d30c49
1557062.27,2.0,6,4,3,3,10,0xb2d5ea9b
0.0,1.0,2,1,2,4,7,0xb2d64fe5
28222.63,1.0,2,2,2,4,8,0xb2d5d11f
1507166.71,3.0,62,4,4,2,10,0xb2d6accd
6721.42,1.0,0,2,2,4,8,0xb2d94886
2702.62,1.0,9,1,2,3,6,0xb2d3f7d5
40000.42,2.0,92,2,3,1,6,0xb2d642a4
115484.75,1.0,0,3,2,4,9,0xb2d4313e
131743.79,4.0,0,3,4,4,11,0xb2d1b551
3929.36,1.0,2,2,2,4,8,0xb2d3e4bb
50.55,1.0,5,1,2,3,6,0xb2d2a880
100071.93,2.0,266,3,3,1,7,0xb2d20113
7006.61,1.0,24,2,2,2,6,0xb2d5a97b
30000.32,2.0,35,2,3,2,7,0xb2d9f8f1
901170.21,10.0,10,4,4,3,11,0xb2d3d3cf
18072.88,1.0,21,2,2,2,6,0xb2d21332
104156.7,2.0,140,3,3,1,7,0xb2d482a9
282144.4,1.0,33,3,2,2,7,0xb2d10802
50006.17,2.0,73,2,3,1,6,0xb2d6968b
470005.71,3.0,110,4,4,1,9,0xb2d9521c
112299.15,1.0,4,3,2,4,9,0xb2d974fd
3340.49,1.0,33,2,2,2,6,0xb2d236d6
489521.2,4.0,0,4,4,4,12,0xb2d1adc0
1497.08,1.0,82,1,2,1,4,0xb2d49f32
31624.39,1.0,1,2,2,4,8,0xb2d2250d
24620.28,1.0,184,2,2,1,5,0x3b9b25a2
1476.85,1.0,152,1,2,1,4,0xb2d6a3bc
855.02,1.0,184,1,2,1,4,0xb2d22ebd
310791.39,6.0,165,4,4,1,9,0xb2d4ee82
440870.52,3.0,18,4,4,2,10,0xb2d60569
230123.83,2.0,4,3,3,4,10,0xb2d6fed8
8.17,1.0,21,1,2,2,5,0xb2d24124
121897.08,3.0,80,3,4,1,8,0xb2d07b3f
36383.86,2.0,7,2,3,3,8,0x3b9b2850
582213.88,10.0,11,4,4,3,11,0xb2d564c2
24076.02,1.0,6,2,2,3,7,0xb2d6e5b0
120003.8,2.0,92,3,3,1,7,0xb2d65fe4
860221.8,7.0,28,4,4,2,10,0xb2d5a575d
287495.89,2.0,200,3,3,1,7,0xb2d41890
108383.9,1.0,15,3,2,3,8,0xb2d39953
1770.39,1.0,41,1,2,2,5,0xb2d1b3bc
1494.02,1.0,184,1,2,1,4,0xb2d1c4c4
451598.66,2.0,53,4,3,2,9,0xb2d9d365
40002.55,2.0,70,2,3,1,6,0xb2d665cb
14960.67,2.0,60,2,3,2,7,0xb2d0c088
200047.38,3.0,19,3,4,2,9,0xb2d23a18
1380.39,1.0,92,1,2,1,4,0x3b9af38e
672.5,1.0,70,1,2,1,4,0xb2d57479
75003.18,2.0,117,3,3,1,7,0xb2d23fda
254443.83,2.0,28,3,3,2,8,0xb2d6b771
370000.65,5.0,2,4,4,4,12,0xb2d5af12
2017.05,1.0,127,1,2,1,4,0xb2d0d3a6
1096057.96,12.0,3,4,4,4,12,0xb2d4d31a
3937.21,1.0,0,2,2,4,8,0xb2d2fdf6
16847.79,4.0,58,2,4,2,8,0xb2d8e7fe
35681.33,1.0,0,2,2,4,8,0xb2d21527
150000.0,1.0,4,3,2,4,9,0xb2d376ab
18111.43,1.0,160,2,2,1,5,0xb2d2ec6b
349.67,1.0,8,1,2,3,6,0xb2d22feb
200008.02,2.0,9,3,3,3,9,0xb2da1e88
793217.99,5.0,0,4,4,4,12,0xb2d14072
87.56,2.0,17,1,3,2,6,0xb2d2f614
48.3,1.0,6,1,2,3,6,0xb2d3803f
524006.33,2.0,88,4,3,1,8,0xb2d1dc52
120101.45,2.0,125,3,3,1,7,0xb2d41e63
0.25,1.0,5,1,2,3,6,0xb2d5e17d
24069.57,1.0,2,2,2,4,8,0xb2d2d45e
61744.2,2.0,7,3,3,3,9,0xb2d11f74
430033.99,3.0,1,4,4,4,12,0xb2d8d784d
0.94,1.0,67,1,2,1,4,0xb2d44930
5533.56,1.0,4,2,2,4,8,0xb2d5bf75
1151874.91,6.0,0,4,4,4,12,0xb2d0849e
2.23,1.0,1,1,2,4,7,0xb2d2233e
991.09,1.0,9,1,2,3,6,0xb2d547f6
42322.81,2.0,0,2,3,4,9,0xb2d3b64a
305106.01,4.0,13,4,4,3,11,0xb2d443bc
160006.13,6.0,47,3,4,2,9,0xb2d918db
0.34,1.0,35,1,2,2,5,0xb2d52774
476949.05,5.0,19,4,4,2,10,0xb2d5c1c9
42125.25,2.0,63,2,3,2,7,0xb2d5e65f
75.02,1.0,78,1,2,1,4,0xb2d7bdd9
218520.04,3.0,9,3,4,3,10,0xb2d62745
360273.95,4.0,7,4,4,3,11,0xb2d718e4
210016.19,4.0,122,3,4,1,8,0xb2d44239
5285.54,1.0,92,2,2,1,5,0xb2d12714
275516.94,9.0,67,3,4,1,8,0xb2d1850e
322622.96,2.0,148,4,3,1,8,0xb2d1b873
81138.45,2.0,0,3,3,4,10,0xb2d63e05
212014.88,3.0,144,3,4,1,8,0xb2d268f1
2804680.22,5.0,8,4,4,3,11,0xb2d9904a
3251799.89,14.0,4,4,4,4,12,0xb2d0dcb7
14946.27,3.0,13,2,4,3,9,0x3b9ad05f
3713.75,1.0,101,2,2,1,5,0xb2d5afa8
80509.61,1.0,20,3,2,2,7,0xb2d2e199
104886.57,1.0,0,3,2,4,9,0xb2d966c2
40001.27,2.0,11,2,3,3,8,0xb2da3c88
6389.1,1.0,16,2,2,2,6,0xb2d6add3
170004.59,3.0,14,3,4,3,10,0xb2d4133d
2180.28,2.0,184,1,3,1,5,0xb2d0cc29
50000.0,2.0,137,2,3,1,6,0xb2d3981f
1759.68,1.0,3,1,2,4,7,0xb2d8dac9
360013.41,5.0,62,4,4,2,10,0xb2d57eb8
322745.32,3.0,8,4,4,3,11,0xb2d93ef1
8996.57,1.0,1,2,2,4,8,0xb2d57739
38.31,1.0,2,1,2,4,7,0xb2d75665
17145.36,1.0,0,2,2,4,8,0xb2d43242
100002.11,3.0,202,3,4,1,8,0xb2d624e9
82311.17,2.0,37,3,3,2,8,0xb2d68265
1687.48,1.0,9,1,2,3,6,0xb2d4ddaad
1872.76,1.0,92,1,2,1,4,0xb2d5afb3
880037.32,3.0,110,4,4,1,9,0xb2d11b53
14547.28,3.0,10,2,4,3,9,0xb2d2872a
443.37,1.0,75,1,2,1,4,0xb2d0c5ecd
29.68,2.0,48,1,3,2,6,0xb2d07555
122245.52,2.0,27,3,3,2,8,0xb2d93960
162.57,1.0,56,1,2,2,5,0xb2d27777
273.39,1.0,77,1,2,1,4,0xb2d8d0ed
70915.24,1.0,3,3,2,4,9,0xb2d27ddc
60012.21,4.0,12,3,4,3,10,0xb2d5d0fa
500000.14,2.0,21,4,3,2,9,0xb2d95406
24395.27,1.0,14,2,2,3,7,0xb2d30da9
14430.84,4.0,1,2,4,4,10,0xb2d2868c
0.0,1.0,0,1,2,4,7,0xb2d61704
278.4,1.0,0,1,2,4,7,0xb2d8d591
1467633.87,15.0,4,4,4,4,12,0xb2d31b9c
408123.9,2.0,188,4,3,1,8,0xb2d12936d
255028.31,7.0,14,3,4,3,10,0xb2d1078e
7827.16,1.0,19,2,2,2,6,0xb2d68567
200000.0,2.0,5,3,3,3,9,0xb2d9fdf0
2198.22,1.0,4,1,2,4,7,0xb2d69bc1
74.38,1.0,33,1,2,2,5,0xb2d2137d
273164.66,1.0,0,3,2,4,9,0xb2d52c82
500000.0,2.0,7,4,3,3,10,0xb2d96e93
57017.79,1.0,1,3,2,4,9,0xb2d651e8
4471.87,1.0,92,2,2,1,5,0xb2d62005
25922.41,1.0,12,2,2,3,7,0xb2d68f9b
0.98,1.0,4,1,2,4,7,0xb2d474f5
38000.62,2.0,3,2,3,4,9,0xb2d2d211
100249.24,2.0,104,3,3,1,7,0xb2d3e388
520409.17,7.0,18,4,4,2,10,0xb2d54e9b
101213.5,2.0,66,3,3,2,8,0xb2d6c03d
5227.49,1.0,10,2,2,3,7,0xb2d23bc5
0.73,1.0,5,1,2,3,6,0xb2da1200
268857.29,3.0,11,3,4,3,10,0xb2d15d1e
697909.22,6.0,10,4,4,3,11,0xb2d313e8
700200.49,3.0,15,4,4,3,11,0xb2d90507
500005.29,2.0,182,4,3,1,8,0xb2d8c3f0
9.76,1.0,18,1,2,2,5,0xb2d61b45
500000.0,2.0,29,4,3,2,9,0xb2da0b48
1070.27,1.0,184,1,2,1,4,0xb2d519de
237948.47,12.0,0,3,4,4,11,0xb2d2798a
12399.71,1.0,11,2,2,3,7,0xb2d68704
1142.21,1.0,213,1,2,1,4,0xb2d335f1
6027.74,1.0,186,2,2,1,5,0xb2d3e9fe
67.78,1.0,23,1,2,2,5,0xb2d5e48f
190525.76,3.0,0,3,4,4,11,0xb2d33e23
100000.0,4.0,101,3,4,1,8,0xb2d1550e
2496.87,1.0,2,1,2,4,7,0xb2d60ac9
100002.64,3.0,119,3,4,1,8,0xb2d6faf4
7839.34,1.0,0,2,2,4,8,0xb2d7554f
211.35,1.0,20,1,2,2,5,0xb2d23231
1631.49,1.0,10,1,2,3,6,0xb2d49e00
505685.76,3.0,4,4,4,4,12,0xb2d74ac3
460008.33,4.0,14,4,4,3,11,0xb2d5c52a
101281.51,2.0,10,3,3,3,9,0xb2d9445d
201422.41,2.0,29,3,3,2,8,0xb2d8c478
13.19,1.0,13,1,2,3,6,0xb2da349c
155004.38,3.0,20,3,4,2,9,0xb2d93920
201763.48,4.0,0,3,4,4,11,0xb2d4107f
1036908.13,2.0,18,4,3,2,9,0xb2d638c4
10036.61,2.0,25,2,3,2,7,0xb2d62aef
2595129.78,5.0,8,4,4,3,11,0xb2d9a29c
2983.29,3.0,92,2,4,1,7,0xb2d1328c
401.32,1.0,3,1,2,4,7,0xb2d2fd93
1098.95,1.0,184,1,2,1,4,0xb2d2f5e5
10000.05,2.0,53,2,3,2,7,0xb2d551e8
1980029.59,15.0,20,4,4,2,10,0xb2d593dd
200033.3,2.0,21,3,3,2,8,0xb2d954ea
5123.74,1.0,184,2,2,1,5,0xb2d1790e
3443.29,1.0,2,2,2,4,8,0xb2d2ddfa
400741.93,3.0,25,4,4,2,10,0xb2d91fac
19152.76,1.0,5,2,2,3,7,0xb2d38acdd
71220.17,1.0,7,3,2,3,8,0xb2d6b482
2413045.51,9.0,0,4,4,4,12,0xb2d3c23c
107229.63,2.0,74,3,3,1,7,0xb2d38483
30841.41,1.0,0,2,2,4,8,0xb2d2f1f0
1090000.0,8.0,4,4,4,4,12,0xb2d3be1b
3670.68,3.0,0,2,4,4,10,0xb2d094fa
1.91,1.0,48,1,2,2,5,0xb2d2d9ab
3397.53,1.0,58,2,2,2,6,0xb2d416e5
2943.03,1.0,19,2,2,2,6,0xb2d7ecbcd
21900.55,2.0,52,2,3,2,7,0xb2d65cd0
389348.81,5.0,1,4,4,4,12,0xb2d418d5
1222.23,24.0,92,1,4,1,6,0x3b9b35e3
7.97,1.0,20,1,2,2,5,0xb2d1643e
502137.45,4.0,0,4,4,4,12,0xb2d1c024
70009.1,2.0,171,3,3,1,7,0xb2d5f9ab
172825.14,1.0,82,3,2,1,6,0xb2d1f211
22.97,2.0,34,1,3,2,6,0xb2d4eb5a
152127.4,3.0,0,3,4,4,11,0xb2d4d40cd
911283.67,3.0,8,4,4,3,11,0xb2d7002b
59061.65,1.0,25,3,2,2,7,0xb2d31149
8321.42,1.0,185,2,2,1,5,0xb2d16331
785.07,2.0,3,1,3,4,8,0xb2d0acbb
8343195.84,13.0,4,4,4,4,12,0xb2d22ca5
701040.47,3.0,5,4,4,3,11,0xb2d6fe43
2705.13,1.0,2,1,2,4,7,0xb2d8362c
35652.14,1.0,0,2,2,4,8,0xb2d22036
202222.48,3.0,0,3,4,4,11,0xb2d685b2
1195.36,5.0,0,1,4,4,9,0xb2d0650f
6630.29,1.0,92,2,2,1,5,0xb2d62c45
5165.61,1.0,12,2,2,3,7,0xb2d1429c
380.52,1.0,5,1,2,3,6,0xb2d6c597
462.2,1.0,5,1,2,3,6,0xb2d2aab8
357863.29,6.0,0,4,4,4,12,0x3b9b4604
10125.88,2.0,60,2,3,2,7,0xb2d65c47
100331.53,3.0,19,3,4,2,9,0xb2d5ee20
7.89,1.0,6,1,2,3,6,0xb2d62f40
50221.24,2.0,101,2,3,1,6,0xb2d61fc1
100003.06,2.0,6,3,3,3,9,0xb2d96ce2
1040941.64,3.0,12,4,4,3,11,0xb2d9bfbd
700024.17,2.0,0,4,3,4,11,0xb2d93046
400000.0,3.0,6,4,4,3,11,0xb2d41daf
20000.0,2.0,3,2,3,4,9,0xb2d5ea48
10260.78,2.0,1,2,3,4,9,0xb2d69226
300009.52,3.0,217,3,4,1,8,0xb2d08900
3509.49,1.0,15,2,2,3,7,0xb2d3f004
10000.63,1.0,15,2,2,3,7,0xb2d907ed
200211.8,2.0,206,3,3,1,7,0xb2d5527f
20363.41,2.0,209,2,3,1,6,0xb2d59527
30426.36,1.0,92,2,2,1,5,0xb2d23d34
200149.23,2.0,16,3,3,2,8,0xb2d12444
2189175.75,3.0,92,4,4,1,9,0xb2d53d26
1.09,1.0,81,1,2,1,4,0xb2d56def
15473.38,5.0,10,2,4,3,9,0xb2d5febb
282.08,1.0,25,1,2,2,5,0xb2d3c74c
0.0,1.0,10,1,2,3,6,0xb2d916aa
300082.65,3.0,25,3,4,2,9,0xb2d65821
10695.3,1.0,70,2,2,1,5,0xb2d2e005
0.0,3.0,78,1,4,1,6,0xb2d33260
300023.71,2.0,235,3,3,1,7,0xb2d6dfb5
14.96,1.0,16,1,2,2,5,0xb2d2b083
0.03,1.0,3,1,2,4,7,0xb2d4b62a
21468.94,1.0,237,2,2,1,5,0xb2d1bd30
40043.49,1.0,112,2,2,1,5,0xb2d78c52
500000.25,5.0,0,4,4,4,12,0x3b9b1004
762699.78,2.0,17,4,3,2,9,0xb2d91838
1576.52,1.0,17,1,2,2,5,0xb2d1f6c2
8000043.45,6.0,97,4,4,1,9,0xb2d17f4b
10097.61,1.0,184,2,2,1,5,0xb2d29a57d
67374.72,1.0,10,3,2,3,8,0xb2d6d1ec
103006.53,3.0,18,3,4,2,9,0xb2d538d7
210094.25,2.0,43,3,3,2,8,0xb2d8e5c2
504432.25,2.0,33,4,3,2,9,0xb2d6edba
3806.5,3.0,274,2,4,1,7,0xb2d0fbb0
300720.45,4.0,34,4,4,2,10,0xb2d11179
10025.22,2.0,8,2,3,3,8,0xb2da4a13
29.77,1.0,14,1,2,3,6,0xb2d12dfc
1002.7,1.0,225,1,2,1,4,0xb2d64e01
692.04,1.0,2,1,2,4,7,0xb2d694a3
230000.05,2.0,27,3,3,2,8,0xb2d8ca93
51715.9,1.0,0,2,2,4,8,0xb2d681e0
8852.7,1.0,13,2,2,3,7,0xb2d8023e
342581.44,7.0,0,4,4,4,12,0xb2d1535e
2507142.91,5.0,11,4,4,3,11,0xb2d5d7fcd
531000.0,3.0,3,4,4,4,12,0xb2d368da
23.98,1.0,10,1,2,3,6,0xb2d67bdd
53467.01,4.0,0,3,4,4,11,0x3b9b2a75
343701.56,4.0,3,4,4,4,12,0xb2d5659f
232460.21,5.0,4,3,4,4,11,0xb2d1ca49
102347.68,2.0,249,3,3,1,7,0xb2d4ea14d
361103.96,3.0,228,4,4,1,9,0xb2d3e6e4
1165.0,1.0,11,1,2,3,6,0xb2d3693f
5721114.9,4.0,50,4,4,2,10,0xb2d0cfa9
184451.45,1.0,50,3,2,2,7,0xb2d0ea82
2640710.42,92.0,3,4,4,4,12,0xb2d10abd
29.06,1.0,11,1,2,3,6,0xb2d98ec1
29285.38,1.0,0,2,2,4,8,0xb2d6836a
1016.15,1.0,92,1,2,1,4,0xb2d0cb2e
90035.82,4.0,90,3,4,1,8,0xb2d69a61
100003.97,2.0,92,3,3,1,7,0xb2d3306d
295.66,1.0,5,1,2,3,6,0xb2d960b8
6900.36,1.0,15,2,2,3,7,0xb2da3ae2
8.06,1.0,17,1,2,2,5,0xb2d6b747
821.0,3.0,80,1,4,1,6,0xb2d06efc
10132.49,1.0,92,2,2,1,5,0xb2d21df9
1494.69,1.0,184,1,2,1,4,0xb2d136b7
525000.17,3.0,6,4,4,3,11,0xb2d9501a
200110.43,2.0,1,3,3,4,10,0xb2d9e483
100027.65,2.0,129,3,3,1,7,0xb2d589c0
8730.28,1.0,184,2,2,1,5,0xb2d3c33f
7.71,1.0,22,1,2,2,5,0xb2d96772
6912.89,1.0,199,2,2,1,5,0xb2d35407
603057.8,5.0,0,4,4,4,12,0xb2d16377
3.46,1.0,0,1,2,4,7,0xb2d9fb5f
1830009.18,6.0,4,4,4,4,12,0xb2d973db
1155264.39,12.0,0,4,4,4,12,0xb2d195cc
200000.0,2.0,4,3,3,4,10,0xb2d97b15d
508385.45,4.0,0,4,4,4,12,0xb2d2d6a8
285019.38,5.0,6,3,4,3,10,0xb2d9248e
10043.83,2.0,55,2,3,2,7,0xb2d85ca6
900009.5,4.0,24,4,4,2,10,0xb2d8cbd8
8233.22,1.0,184,2,2,1,5,0xb2d2dd6b
43957.25,1.0,3,2,2,4,8,0xb2d30c3f
509.24,1.0,14,1,2,3,6,0xb2d4519c
250804.03,4.0,136,3,4,1,8,0xb2d638dd
50003.96,2.0,97,2,3,1,6,0xb2d62e1e
7254.11,1.0,1,2,2,4,8,0xb2d3f2d8
50262.15,1.0,4,2,2,4,8,0xb2d3adb6
1.96,1.0,3,1,2,4,7,0xb2d27d21
25425.32,1.0,7,2,2,3,7,0xb2d26ee9
105006.76,1.0,4,3,2,4,9,0xb2d9cec8
6703.09,1.0,0,2,2,4,8,0xb2d5ec6c
856469.85,3.0,166,4,4,1,9,0xb2d67e18
50076.01,3.0,75,2,4,1,7,0xb2d17d86
8670.17,1.0,92,2,2,1,5,0xb2d16402d
0.0,1.0,9,1,2,3,6,0xb2d50e44
900027.78,5.0,0,4,4,4,12,0xb2d6eda0
80367.71,2.0,221,3,3,1,7,0xb2d5bfa8
759063.39,10.0,5,4,4,3,11,0x3b9b2d2f
327504.1,3.0,0,4,4,4,12,0xb2d16cae
7383.06,1.0,0,2,2,4,8,0xb2d43931
500065.91,2.0,17,4,3,2,9,0xb2d5e367
13.29,1.0,60,1,2,2,5,0xb2d68300
150080.62,2.0,53,3,3,2,8,0xb2d55e77
260012.64,3.0,118,3,4,1,8,0xb2d5d4e7
100005.3,2.0,92,3,3,1,7,0xb2d63bee
3926.07,1.0,19,2,2,2,6,0xb2d781a3
12450.97,1.0,184,2,2,1,5,0xb2d35afa
2919.36,1.0,7,2,2,3,7,0xb2d29554
11501.52,5.0,7,2,4,3,9,0xb2d094ec
4.29,1.0,19,1,2,2,5,0xb2d3a9f0
1910042.18,5.0,1,4,4,4,12,0xb2d9089c
242.0,1.0,42,1,2,2,5,0xb2d37c32
73.24,1.0,6,1,2,3,6,0xb2d37c2c
200710.42,2.0,32,3,3,2,8,0xb2da0666
15.2,1.0,10,1,2,3,6,0xb2d57f60
7.46,1.0,230,1,2,1,4,0xb2d5dfbbd
6.23,1.0,8,1,2,3,6,0xb2d78bc9
641782.08,4.0,42,4,4,2,10,0xb2d9dfa5
403053.87,4.0,5,4,4,3,11,0xb2d11ea7
50006.95,2.0,21,2,3,2,7,0xb2d61044
421682.84,5.0,0,4,4,4,12,0xb2d59413
997.19,4.0,184,1,4,1,6,0x3b9ade68d
1000075.33,9.0,13,4,4,3,11,0x3b9b4024
6954.14,1.0,11,2,2,3,7,0xb2d5f1e2
515156.58,6.0,15,4,4,3,11,0xb2d34868
216522.86,2.0,15,3,3,3,9,0xb2d9cef4
450088.49,2.0,70,4,3,1,8,0xb2d4a5b8
735239.37,2.0,15,4,3,3,10,0xb2d50df2
118284.92,1.0,8,3,2,3,8,0xb2d28f45
1953000.06,12.0,3,4,4,4,12,0xb2d24df8
4090.51,1.0,18,2,2,2,6,0xb2d8ce9f
154211.95,5.0,6,3,4,3,10,0xb2d1008dd
170315.12,2.0,97,3,3,1,7,0xb2d40fa0d
1001.06,1.0,91,1,2,1,4,0xb2d405c8
528871.35,2.0,97,4,3,1,8,0xb2d52713
60386.27,2.0,0,3,3,4,10,0xb2d5b2e6
1842.09,5.0,0,1,4,4,9,0x3b9af0f0
0.22,1.0,6,1,2,3,6,0xb2d642c6
36.01,1.0,62,1,2,2,5,0xb2d3d814
202131.82,2.0,93,3,3,1,7,0xb2d97fd8
52774.25,2.0,3,3,3,4,10,0xb2d50671
451202.03,4.0,6,4,4,3,11,0xb2d96380d
30000.0,2.0,15,2,3,3,8,0xb2da3815
850589.52,1.0,21,4,2,2,8,0xb2d8d59c
50013.25,17.0,184,2,4,1,7,0x3b9b2912d
20025.92,2.0,25,2,3,2,7,0xb2d64964
1390696.17,5.0,9,4,4,3,11,0xb2d3a658d
859.94,1.0,75,1,2,1,4,0xb2d4fa51
20043.52,1.0,215,2,2,1,5,0xb2d654cb
30190.58,1.0,92,2,2,1,5,0xb2d436c1
87754.22,2.0,16,3,3,2,8,0xb2d219f2
6134.11,1.0,9,2,2,3,7,0xb2d4da7d
118522.07,1.0,38,3,2,2,7,0xb2d5f14c
503333.74,3.0,49,4,4,2,10,0xb2d5b5bc
2236.74,1.0,1,1,2,4,7,0xb2d4769f
13229.46,1.0,52,2,2,2,6,0xb2d6bb89
328007.42,2.0,0,4,3,4,11,0xb2d411f4
25051.24,1.0,67,2,2,1,5,0xb2d5de87
36.07,1.0,71,1,2,1,4,0xb2d4f402
2163.08,1.0,0,1,2,4,7,0xb2d37c03
7.6,1.0,68,1,2,1,4,0xb2d080ec
1546.78,1.0,69,1,2,1,4,0xb2d30f52
250033.64,2.0,63,3,3,2,8,0xb2d6c124
36.22,1.0,32,1,2,2,5,0xb2d694c9
500006.8,2.0,27,4,3,2,9,0xb2d93f7a
10.76,1.0,18,1,2,2,5,0xb2d0d721
816517.84,9.0,0,4,4,4,12,0xb2d4c0f1
45839.81,1.0,10,2,2,3,7,0xb2d276b7
1160.32,1.0,12,1,2,3,6,0xb2d35147d
232451.77,2.0,102,3,3,1,7,0xb2d81e2d
500037.33,4.0,105,4,4,1,9,0xb2d10d5a
2119.01,1.0,92,1,2,1,4,0xb2d40a5d
80843.38,1.0,13,3,2,3,8,0xb2d3e7ea
2029.71,1.0,129,1,2,1,4,0xb2d4ce43
3004.58,1.0,11,2,2,3,7,0xb2d5e0ba
11575.47,1.0,0,2,2,4,8,0xb2d58165
2686.75,1.0,3,1,2,4,7,0xb2d3e7cb
1430331.85,5.0,20,4,4,2,10,0xb2d24a47
30000.63,2.0,179,2,3,1,6,0xb2d6b557
6814.09,1.0,92,2,2,1,5,0xb2d2b126
3576.09,1.0,7,2,2,3,7,0xb2d51c94
500737.43,3.0,38,4,4,2,10,0xb2d4a938
5015.3,1.0,92,2,2,1,5,0xb2d598b9
3822.53,1.0,246,2,2,1,5,0xb2d3b3e1
5784.67,1.0,4,2,2,4,8,0xb2d92561
678670.05,5.0,19,4,4,2,10,0xb2d22a22
9965.86,1.0,0,2,2,4,8,0xb2d6b504
50001.58,2.0,80,2,3,1,6,0xb2d9890e
310007.24,2.0,24,4,3,2,9,0xb2d5227f
35874.05,1.0,12,2,2,3,7,0xb2d252c4
370000.0,2.0,8,4,3,3,10,0xb2d20862
168.25,1.0,10,1,2,3,6,0xb2d91e44
24028.44,3.0,8,2,4,3,9,0xb2d5dde9
150645.06,2.0,18,3,3,2,8,0xb2d240db
10101.16,1.0,184,2,2,1,5,0xb2d2d350
1320.02,1.0,0,1,2,4,7,0xb2d2ab24
342504.74,4.0,70,4,4,1,9,0xb2d22824
161515.89,2.0,0,3,3,4,10,0xb2d06ad4
614.94,1.0,34,1,2,2,5,0xb2d917c5
193.9,1.0,15,1,2,3,6,0xb2d2e3db
25547.77,1.0,92,2,2,1,5,0x3b9b3a85
260095.34,3.0,83,3,4,1,8,0xb2d0a4a6
430073.48,5.0,80,4,4,1,9,0xb2d19dc3
458.45,1.0,5,1,2,3,6,0xb2d980f6
493022.82,3.0,0,4,4,4,12,0xb2d23c3b
40002.11,2.0,20,2,3,2,7,0xb2da1468
4686.72,1.0,22,2,2,2,6,0xb2d252a9
160000.0,4.0,0,3,4,4,11,0xb2d1ade3
0.74,1.0,8,1,2,3,6,0xb2d117bd
251804.42,2.0,18,3,3,2,8,0xb2d610b0
6241.74,1.0,263,2,2,1,5,0xb2d1a03d
280007.07,6.0,80,3,4,1,8,0xb2d7050d
307.39,1.0,14,1,2,3,6,0xb2d94b12
1414.47,1.0,0,1,2,4,7,0xb2d97a48
132.6,1.0,10,1,2,3,6,0xb2d303fc
200000.55,2.0,0,3,3,4,10,0xb2d076f4
10151.15,1.0,52,2,2,2,6,0xb2d57e6f
750080.16,5.0,172,4,4,1,9,0xb2d14b47d
160844.83,2.0,1,3,3,4,10,0xb2d1a46d
46150.73,1.0,16,2,2,2,6,0xb2d3cc80d
201423.28,2.0,16,3,3,2,8,0xb2d8dcf7
4088.09,2.0,10,2,3,3,8,0xb2d23974
250618.85,2.0,4,3,3,4,10,0xb2d60d03
5545.62,1.0,92,2,2,1,5,0x3b9b18b1
3033.27,1.0,40,2,2,2,6,0xb2d86ca8
0.33,1.0,1,1,2,4,7,0xb2d93f9e
633000.04,3.0,54,4,4,2,10,0xb2d1c4b2
77241.33,2.0,5,3,3,3,9,0xb2d2154b
500134.03,3.0,249,4,4,1,9,0xb2d07721
568.16,1.0,167,1,2,1,4,0xb2d389e3
73.44,1.0,20,1,2,2,5,0xb2d406ed
551000.24,3.0,4,4,4,4,12,0xb2d9aabc
380028.56,3.0,28,4,4,2,10,0xb2d219ac
18.05,1.0,32,1,2,2,5,0xb2d9d505
10491.61,1.0,8,2,2,3,7,0xb2d6ee27
4712.13,1.0,7,2,2,3,7,0xb2d6b539
4435.94,1.0,41,2,2,2,6,0xb2d0900e
519350.41,9.0,8,4,4,3,11,0xb2d22faa
1420008.37,9.0,92,4,4,1,9,0xb2d07da9
100000.0,1.0,0,3,2,4,9,0xb2da6b97
100018.12,3.0,32,3,4,2,9,0xb2d584da
901262.7,3.0,1,4,4,4,12,0xb2d9859b
230994.18,1.0,0,3,2,4,9,0xb2d3e18d
500053.08,5.0,1,4,4,4,12,0xb2d700b0d
7994.84,2.0,3,2,3,4,9,0xb2d284e1
600218.97,2.0,14,4,3,3,10,0xb2d6f9b0
100003.7,2.0,69,3,3,1,7,0xb2d635b0
300002.7,2.0,3,3,3,4,10,0xb2d6d72a
38896.15,3.0,0,2,4,4,10,0xb2d5e881
1111817.36,3.0,82,4,4,1,9,0xb2d0788c
672028.8,2.0,122,4,3,1,8,0xb2d4083f
1191132.72,3.0,2,4,4,4,12,0xb2d0e9cb
267901.81,9.0,0,3,4,4,11,0x3b9b0e37
202409.86,1.0,0,3,2,4,9,0xb2d5ee32
174747.5,2.0,110,3,3,1,7,0xb2d14397
72618.79,3.0,3,3,4,4,11,0xb2d5a602
661315.49,8.0,1,4,4,4,12,0xb2d17ea6
50616.36,1.0,184,2,2,1,5,0xb2d0c546
300812.6,3.0,67,4,4,1,9,0xb2d1751b
18.12,1.0,67,1,2,1,4,0xb2d0aa42
50003.36,2.0,111,2,3,1,6,0xb2d3b760
190017.12,2.0,221,3,3,1,7,0xb2d0dc3d
431.89,6.0,4,1,4,4,9,0x3b9b1854
0.89,1.0,27,1,2,2,5,0xb2d6fe99
180025.11,3.0,74,3,4,1,8,0xb2d8d9f5
474.02,1.0,9,1,2,3,6,0xb2d20ff1
104.83,1.0,1,1,2,4,7,0xb2d8da57
1032.88,2.0,92,1,3,1,5,0x3b9b42a5
1010055.45,2.0,122,4,3,1,8,0xb2d5dd6f
0.86,1.0,22,1,2,2,5,0xb2d85aa8d
120326.57,8.0,41,3,4,2,9,0xb2d59ee7
17.16,1.0,0,1,2,4,7,0xb2d6c5ed
380000.0,2.0,1,4,3,4,11,0xb2d9b6f5
15092.34,1.0,18,2,2,2,6,0xb2d98756
20000.63,2.0,94,2,3,1,6,0xb2d6038c
820749.1,5.0,20,4,4,2,10,0xb2d117da
208483.66,1.0,210,3,2,1,6,0xb2d44119
2202218.47,1.0,36,4,2,2,8,0xb2d392a5
100091.17,3.0,27,3,4,2,9,0xb2d5e7b4
1887.26,1.0,184,1,2,1,4,0xb2d11009
103186.0,3.0,39,3,4,2,9,0xb2d38c56
353436.41,4.0,57,4,4,2,10,0xb2d27fb3
48554.59,6.0,0,2,4,4,10,0x3b9b1809
290005.42,5.0,6,3,4,3,10,0xb2d63923
1829.11,1.0,0,1,2,4,7,0xb2d6d153
70088.31,4.0,6,3,4,3,10,0xb2d6ec8f
361278.93,2.0,24,4,3,2,9,0xb2d9d425
544.28,1.0,12,1,2,3,6,0xb2d6c41b
767438.41,20.0,0,4,4,4,12,0xb2d17e00
25.31,1.0,4,1,2,4,7,0xb2d5576a
516008.03,2.0,28,4,3,2,9,0xb2d5a761
266000.86,26.0,151,3,4,1,8,0xb2d1236cd
47.07,1.0,81,1,2,1,4,0xb2d40a90
21528.02,1.0,92,2,2,1,5,0xb2d425bf
9014.78,1.0,10,2,2,3,7,0xb2d6cf3fd
169112.87,2.0,83,3,3,1,7,0xb2d17344
2646.39,1.0,10,1,2,3,6,0xb2d4e56fd
151847.98,1.0,6,3,2,3,8,0xb2d53022
36.21,1.0,27,1,2,2,5,0xb2d20509
255007.72,5.0,11,3,4,3,10,0xb2d1c2a5
1063.69,1.0,184,1,2,1,4,0xb2d3a4ce
200745.86,3.0,14,3,4,3,10,0xb2d5d6d9
2101.18,1.0,39,1,2,2,5,0xb2d50ce6
3073.16,1.0,5,2,2,3,7,0xb2d83bcf
1078.74,1.0,92,1,2,1,4,0xb2d21821
670747.78,3.0,6,4,4,3,11,0xb2d5ce09
2.88,1.0,25,1,2,2,5,0xb2d6d8c2
8676.53,1.0,1,2,2,4,8,0xb2d56367
50096.0,2.0,122,2,3,1,6,0xb2d7590b
1123015.67,9.0,21,4,4,2,10,0xb2d1bb0a
1901.51,2.0,63,1,3,2,6,0xb2d43fa6
556701.52,6.0,18,4,4,2,10,0xb2d4342c
220015.9,6.0,41,3,4,2,9,0xb2d62a07
41386.88,3.0,4,2,4,4,10,0xb2d5b00c
200059.73,2.0,0,3,3,4,10,0xb2d23742
600101.33,1.0,22,4,2,2,8,0xb2d9a78d
115006.8,3.0,104,3,4,1,8,0xb2d239ee
210001.89,3.0,0,3,4,4,11,0xb2d954eb
40001.05,3.0,94,2,4,1,7,0xb2d78e74
2.66,1.0,58,1,2,2,5,0xb2d4d346
748877.18,6.0,34,4,4,2,10,0xb2d2afa8
40002.11,2.0,97,2,3,1,6,0xb2d82784
1.84,1.0,83,1,2,1,4,0xb2d59bc7
355007.82,8.0,25,4,4,2,10,0xb2d5f213d
500776.15,3.0,3,4,4,4,12,0xb2d9b709
360050.01,3.0,7,4,4,3,11,0xb2d6595ed
570291.58,6.0,6,4,4,3,11,0xb2d198c1
5264.38,1.0,119,2,2,1,5,0xb2d40709
66033.19,2.0,15,3,3,3,9,0xb2d2136b
1255.18,1.0,10,1,2,3,6,0xb2d47fb3
80005.07,3.0,19,3,4,2,9,0xb2d7c758
399.86,1.0,1,1,2,4,7,0xb2d67dbb
63.8,1.0,21,1,2,2,5,0xb2d6496b
675765.75,15.0,1,4,4,4,12,0x3b9af21b
50193.45,1.0,184,2,2,1,5,0xb2d62346
505663.2,4.0,11,4,4,3,11,0xb2d1d97e
145.13,1.0,10,1,2,3,6,0xb2d2d456
5316.68,1.0,92,2,2,1,5,0xb2d29d8c
5613.15,1.0,4,2,2,4,8,0xb2d96582
750030.03,6.0,21,4,4,2,10,0xb2d217e6
29469.58,1.0,17,2,2,2,6,0xb2d95ac1
50000.0,2.0,0,2,3,4,9,0xb2d97ccf
18.99,1.0,67,1,2,1,4,0xb2d68fcf
1181.77,1.0,92,1,2,1,4,0xb2d2dded
200738.67,2.0,15,3,3,3,9,0xb2d6407e
0.0,3.0,1,1,4,4,9,0xb2d5c81a
260.12,1.0,67,1,2,1,4,0xb2d5669d
80063.16,2.0,143,3,3,1,7,0xb2d514fc
568.8,1.0,13,1,2,3,6,0xb2d5d27d
200002.11,2.0,186,3,3,1,7,0xb2d8908e
102.47,1.0,0,1,2,4,7,0xb2d2f30b
110001.48,4.0,3,3,4,4,11,0xb2d93080
45005.28,1.0,5,2,2,3,7,0xb2d9fc09
32778.22,6.0,112,2,4,1,7,0xb2d6a3b2
141034.17,2.0,76,3,3,1,7,0xb2d52af4
260837.22,7.0,40,3,4,2,9,0xb2d14b78d
9311178.61,14.0,11,4,4,3,11,0xb2d21ae4
521724.67,10.0,0,4,4,4,12,0xb2d20f31
37.81,1.0,53,1,2,2,5,0xb2d4756a
76517.42,3.0,0,3,4,4,11,0x3b9b1807
1955.84,1.0,2,1,2,4,7,0xb2d2dde0
23000636.55,10.0,4,4,4,4,12,0xb2d398f9
2000000.0,5.0,0,4,4,4,12,0xb2da6c0c
500014.98,2.0,2,4,3,4,11,0xb2d21a09
133052.08,2.0,39,3,3,2,8,0xb2d6693a
76340.65,3.0,25,3,4,2,9,0x3b9aeeef
120030.31,2.0,259,3,3,1,7,0xb2d659ec
54925.77,1.0,39,3,2,2,7,0xb2d27701
106316.1,6.0,2,3,4,4,11,0x3b9b2795
6017.71,1.0,108,2,2,1,5,0xb2d6c0b6
40092.99,2.0,7,2,3,3,8,0xb2d6a12a
725.43,12.0,0,1,4,4,9,0xb2d20eb2
765552.77,4.0,31,4,4,2,10,0x3b9af376
385000.81,4.0,3,4,4,4,12,0xb2d1dde9
2075.99,1.0,24,1,2,2,5,0xb2d2a265
1769.77,1.0,18,1,2,2,5,0xb2d5b03cd
307059.36,2.0,56,4,3,2,9,0xb2d0f97a
677592.76,2.0,53,4,3,2,9,0xb2d2267e
3110.09,1.0,10,2,2,3,7,0xb2d8d400
120056.34,3.0,122,3,4,1,8,0xb2d16ddf
100002.11,2.0,235,3,3,1,7,0xb2d6e8b9
600608.46,3.0,2,4,4,4,12,0xb2d787fd
9500000.0,2.0,5,4,3,3,10,0xb2d5ecc8
451038.51,2.0,2,4,3,4,11,0xb2d18e94
1940027.24,11.0,18,4,4,2,10,0xb2d626ce
550060.28,6.0,112,4,4,1,9,0xb2d6231f
126.7,2.0,49,1,3,2,6,0xb2d31da7
2801.17,1.0,0,1,2,4,7,0xb2d70019
600004.0,2.0,29,4,3,2,9,0xb2d902af
256.24,1.0,8,1,2,3,6,0xb2d30c8c
9.54,1.0,10,1,2,3,6,0xb2d91154
36.93,1.0,17,1,2,2,5,0xb2d6943e
3895.29,1.0,25,2,2,2,6,0xb2d2fcfb
302131.83,2.0,80,4,3,1,8,0xb2d8d7af
27985.3,1.0,2,2,2,4,8,0xb2d6c2bb
10.47,1.0,0,1,2,4,7,0xb2d8d373
16424.07,1.0,0,2,2,4,8,0xb2d1c64b
236.52,1.0,1,1,2,4,7,0xb2d12e4c
80001.69,2.0,214,3,3,1,7,0xb2d6b523
4948.22,1.0,3,2,2,4,8,0xb2d2ebd9
2255.35,1.0,0,1,2,4,7,0xb2d83b1fd
291259.67,6.0,60,3,4,2,9,0x3b9b4437
500847.13,3.0,25,4,4,2,10,0xb2d99c04
586292.44,1.0,0,4,2,4,10,0xb2d618d6
2034202.9,2.0,0,4,3,4,11,0xb2d953c2
25166.39,2.0,10,2,3,3,8,0xb2d5e5fe
3.87,1.0,74,1,2,1,4,0xb2d1bb1f
217029.99,6.0,4,3,4,4,11,0xb2d135e6
390609.73,3.0,1,4,4,4,12,0xb2d60ab3d
100087.59,2.0,97,3,3,1,7,0xb2d569bf
1659.9,1.0,6,1,2,3,6,0xb2d3edb8
282171.66,3.0,76,3,4,1,8,0xb2d0c781
776112.49,6.0,25,4,4,2,10,0xb2d5a977
65006.63,5.0,18,3,4,2,9,0xb2d61bbb
682315.14,3.0,5,4,4,3,11,0xb2d18370
235459.23,2.0,18,3,3,2,8,0xb2d91584
2400.83,1.0,14,1,2,3,6,0xb2d8d73c
436327.92,6.0,19,4,4,2,10,0xb2d08cee
5000.01,1.0,0,2,2,4,8,0xb2d4c7f1
5304.92,1.0,80,2,2,1,5,0xb2d698fc
3657.14,1.0,171,2,2,1,5,0xb2d51651
20009.85,2.0,143,2,3,1,6,0xb2d6e381
2018.32,1.0,0,1,2,4,7,0xb2d3e795
30087.19,1.0,8,2,2,3,7,0xb2da067f
8752.66,1.0,0,2,2,4,8,0xb2d79031
839793.79,5.0,1,4,4,4,12,0xb2d5bd2d
42394.59,1.0,20,2,2,2,6,0xb2d6abe9
50005.3,2.0,27,2,3,2,7,0xb2d5b089
20005.97,2.0,145,2,3,1,6,0xb2d5e898
613.96,1.0,32,1,2,2,5,0xb2d60298
10306.85,1.0,92,2,2,1,5,0xb2d2a4a2
110002.11,3.0,31,3,4,2,9,0xb2d12571
0.81,1.0,42,1,2,2,5,0xb2d27356
1721.13,1.0,92,1,2,1,4,0xb2d1fa9d
160015.45,12.0,3,3,4,4,11,0xb2d44f7a
1230341.89,4.0,12,4,4,3,11,0xb2d26c28
28716.48,1.0,0,2,2,4,8,0xb2d3a415d
819.05,1.0,0,1,2,4,7,0xb2d7802e
306476.79,4.0,8,4,4,3,11,0x3b9b3186
61697.73,2.0,12,3,3,3,9,0xb2d1add1
151036.84,4.0,10,3,4,3,10,0xb2d58fdd
3179.76,1.0,21,2,2,2,6,0xb2d5c8fb
483354.96,15.0,0,4,4,4,12,0xb2d65bf3
502782.91,5.0,7,4,4,3,11,0xb2d4207c
30001.69,3.0,92,2,4,1,7,0xb2d4ee0f
53.25,1.0,55,1,2,2,5,0xb2d69eacd
614680.04,2.0,3,4,3,4,11,0xb2d4777c
1605258.38,6.0,35,4,4,2,10,0xb2d9a7aa
1647.3,3.0,92,1,4,1,6,0xb2d088db
2502.28,1.0,16,1,2,2,5,0xb2d6c4c9
25172.92,1.0,3,2,2,4,8,0xb2d4a73c
2909.8,1.0,4,2,2,4,8,0xb2d21705
425811.79,4.0,5,4,4,3,11,0xb2d0e94a
2401.34,1.0,14,1,2,3,6,0xb2d8c5f6
16725.34,1.0,92,2,2,1,5,0xb2d18b5d
7464.16,1.0,21,2,2,2,6,0xb2d609ab
20968.88,1.0,11,2,2,3,7,0xb2d58ba2
1444.67,1.0,3,1,2,4,7,0xb2d6263a
1503134.26,9.0,1,4,4,4,12,0xb2d3e5b1
20136.67,1.0,1,2,2,4,8,0xb2d2d516
164530.14,2.0,52,3,3,2,8,0xb2d2cb5c
9068.94,1.0,0,2,2,4,8,0xb2d6c84a
40.18,1.0,63,1,2,2,5,0xb2d83af2
300006.36,2.0,18,3,3,2,8,0xb2d19801
200006.33,2.0,24,3,3,2,8,0xb2d945d8
381000.0,5.0,1,4,4,4,12,0xb2d283e5
65875.41,3.0,6,3,4,3,10,0xb2d0e9f8
0.0,2.0,8,1,3,3,7,0xb2d9dda3
57978.32,1.0,16,3,2,2,7,0xb2d3183e
685098.47,5.0,5,4,4,3,11,0xb2d20aced
100007.74,2.0,101,3,3,1,7,0xb2d68528
3.01,2.0,11,1,3,3,7,0xb2d93551d
3224804.44,5.0,60,4,4,2,10,0xb2d3a4bb
5735.61,1.0,9,2,2,3,7,0xb2d9051b
20015.44,3.0,10,2,4,3,9,0xb2d7825bd
1050907.86,7.0,16,4,4,2,10,0xb2d0e708
720025.98,7.0,9,4,4,3,11,0xb2d0db33
107146.18,3.0,75,3,4,1,8,0xb2d4f9cb
101526.32,3.0,4,3,4,4,11,0xb2d4cf4b
100017.92,2.0,132,3,3,1,7,0xb2d587ed
4238.3,2.0,1,2,3,4,9,0xb2d0b1a4
2051.7,1.0,3,1,2,4,7,0xb2d92c7d
760073.78,7.0,10,4,4,3,11,0xb2d0bc42
40000.0,1.0,7,2,2,3,7,0xb2da4c89
546.59,1.0,0,1,2,4,7,0xb2d36a43
34034.91,1.0,18,2,2,2,6,0xb2d995b4
300000.0,2.0,0,3,3,4,10,0xb2d98351
200222.95,3.0,76,3,4,1,8,0xb2d41636
50000.0,2.0,184,2,3,1,6,0xb2d09884
50000.57,2.0,0,2,3,4,9,0xb2d2cf52
798.1,1.0,8,1,2,3,6,0xb2d3eaf2
16837.27,1.0,87,2,2,1,5,0xb2d51fdd
1094.66,3.0,0,1,4,4,9,0x3b9b463a
100005.34,2.0,118,3,3,1,7,0xb2d62ca6
2202.39,1.0,3,1,2,4,7,0xb2d6bd76
52046.24,1.0,1,2,2,4,8,0xb2d232fa
200932.66,2.0,25,3,3,2,8,0xb2d6f48b
2110662.47,2.0,118,4,3,1,8,0xb2d46e30
352217.62,9.0,33,4,4,2,10,0xb2d52c13
10000.58,2.0,27,2,3,2,7,0xb2d9f039
571788.93,7.0,25,4,4,2,10,0xb2d63751
10000.11,2.0,11,2,3,3,8,0xb2da3fb6
273566.68,3.0,25,3,4,2,9,0xb2d61bc4
461060.29,14.0,19,4,4,2,10,0xb2d579ff
440393.09,4.0,5,4,4,3,11,0xb2d1460f
500053.63,2.0,7,4,3,3,10,0xb2d306b8
303198.51,2.0,27,4,3,2,9,0xb2d783e6
60164.8,5.0,0,3,4,4,11,0xb2d65e97
278000.66,11.0,47,3,4,2,9,0xb2d4f4dd
8755.84,1.0,0,2,2,4,8,0xb2d8c35e
347.05,1.0,23,1,2,2,5,0xb2d2f863
110100.93,3.0,141,3,4,1,8,0xb2d4f542
603369.2,4.0,24,4,4,2,10,0xb2d60032
308036.14,5.0,5,4,4,3,11,0xb2d1f4aa
9.7,1.0,3,1,2,4,7,0xb2da39dc
6540.13,1.0,9,2,2,3,7,0xb2d32d1a
77.61,1.0,24,1,2,2,5,0xb2d52003d
510973.93,6.0,1,4,4,4,12,0xb2d1774f
2153.37,1.0,26,1,2,2,5,0xb2d2cf30
1458.43,1.0,184,1,2,1,4,0xb2d1f923
350461.84,3.0,11,4,4,3,11,0xb2d65bc9d
7210.99,1.0,4,2,2,4,8,0xb2d9b3f8
301682.76,4.0,5,4,4,3,11,0xb2d4a74d
1151612.42,9.0,21,4,4,2,10,0xb2d1676b
56044.8,2.0,53,3,3,2,8,0xb2d1bb6c
504154.78,4.0,0,4,4,4,12,0xb2d21315
519965.55,4.0,13,4,4,3,11,0xb2d25195
58150.09,1.0,5,3,2,3,8,0xb2d30f82
20.43,1.0,10,1,2,3,6,0xb2d688e8
310425.66,2.0,63,4,3,2,9,0xb2d6340f
31257.13,1.0,10,2,2,3,7,0xb2d5a496
366303.99,7.0,27,4,4,2,10,0xb2d0be3e
59799.37,2.0,8,3,3,3,9,0xb2d1b140
434525.71,3.0,70,4,4,1,9,0xb2d1182d
213339.03,6.0,0,3,4,4,11,0x3b9b3ced
120391.44,4.0,104,3,4,1,8,0xb2d57e2fd
501591.47,2.0,0,4,3,4,11,0xb2d6fe75
459.01,1.0,54,1,2,2,5,0xb2d2536f
2500000.4,6.0,5,4,4,3,11,0xb2d78b25
500075.64,3.0,35,4,4,2,10,0xb2d1426b
24533.86,1.0,7,2,2,3,7,0xb2d396fc
900087.25,5.0,6,4,4,3,11,0xb2d120e3
13923.35,1.0,15,2,2,3,7,0xb2d8d646
200084.5,2.0,165,3,3,1,7,0xb2d45d00
4950.21,8.0,123,2,4,1,7,0x3b9b3629
2814.09,1.0,1,1,2,4,7,0xb2d97cda
3687.04,1.0,92,2,2,1,5,0xb2d353c5
90068.4,1.0,82,3,2,1,6,0xb2d98cbf
3001.32,1.0,75,2,2,1,5,0xb2d3fe6a
1062.15,1.0,92,1,2,1,4,0x3b9b2aab
21001.38,2.0,74,2,3,1,6,0xb2d5f5b9
1060.51,1.0,231,1,2,1,4,0xb2d27e5f
24407.83,1.0,1,2,2,4,8,0xb2d57b92
2369.41,2.0,92,1,3,1,5,0x3b9ad026
4452.81,1.0,9,2,2,3,7,0xb2d553a3
100219.49,1.0,4,3,2,4,9,0xb2d67e6f
633.84,1.0,9,1,2,3,6,0xb2d0b4ca
3154.14,1.0,0,2,2,4,8,0xb2d6f370
885487.96,10.0,8,4,4,3,11,0xb2d51c62d
247.11,1.0,19,1,2,2,5,0xb2d820bc
69.36,1.0,0,1,2,4,7,0xb2d407e6
1210506.88,10.0,39,4,4,2,10,0xb2d09ff5
1014.26,1.0,184,1,2,1,4,0xb2d37787
7232.84,1.0,0,2,2,4,8,0xb2d8d0e6
5327010.65,9.0,16,4,4,2,10,0xb2d4090c
120429.94,3.0,1,3,4,4,11,0xb2d1cb25
1.27,1.0,104,1,2,1,4,0xb2d95d45d
220001.9,3.0,15,3,4,3,10,0xb2d8db98
4462.07,1.0,0,2,2,4,8,0xb2d6d335
106120.46,2.0,139,3,3,1,7,0xb2d6b126
53031.58,2.0,104,3,3,1,7,0xb2d0ff84
4345.66,1.0,92,2,2,1,5,0xb2d1a4b1
86.5,1.0,0,1,2,4,7,0xb2d210d7
407138.7,2.0,1,4,3,4,11,0xb2d8c88d
1823.84,1.0,184,1,2,1,4,0xb2d21ef0
52445.9,1.0,1,3,2,4,9,0xb2d6cc9a
611051.01,2.0,217,4,3,1,8,0xb2d11e1b
1650.97,1.0,6,1,2,3,6,0xb2d5ad16
500006.11,3.0,20,4,4,2,10,0xb2d99167
291650.29,2.0,2,3,3,4,10,0xb2d15f4a
150005.84,4.0,6,3,4,3,10,0xb2d6eba9
260000.0,2.0,6,3,3,3,9,0xb2da5c1a
2993.73,1.0,0,2,2,4,8,0xb2d930c3
130106.98,3.0,67,3,4,1,8,0xb2d41879
942.14,1.0,5,1,2,3,6,0xb2d34637
13086.5,1.0,54,2,2,2,6,0xb2d6ada0d
1002.61,1.0,257,1,2,1,4,0xb2d10a6d
50167.55,2.0,193,2,3,1,6,0xb2d613ae
15005.57,2.0,57,2,3,2,7,0xb2d61750d
2.26,1.0,23,1,2,2,5,0xb2d64104
1221.49,1.0,184,1,2,1,4,0xb2d2aec3
1106.94,1.0,0,1,2,4,7,0xb2d86aa1
0.18,1.0,22,1,2,2,5,0xb2d1408d
830.74,1.0,19,1,2,2,5,0xb2d220ed
3467.37,1.0,0,2,2,4,8,0xb2d81160
239079.0,5.0,1,3,4,4,11,0x3b9b49d6
7136500.0,2.0,92,4,3,1,8,0xb2d56eb3
443623.72,4.0,90,4,4,1,9,0xb2d39734
7.37,1.0,12,1,2,3,6,0xb2d3143a
330000.0,11.0,1,4,4,4,12,0xb2d4fe1f
40432.95,4.0,0,2,4,4,10,0xb2d4f95d
820427.65,3.0,113,4,4,1,9,0x3b9b3672
3635.41,1.0,92,2,2,1,5,0xb2d311a4
307081.53,3.0,0,4,4,4,12,0xb2d909d0d
660001.52,4.0,4,4,4,4,12,0xb2d937b5
520019.64,3.0,63,4,4,2,10,0xb2d99936
398129.15,4.0,18,4,4,2,10,0xb2d145ae
143908.75,5.0,18,3,4,2,9,0xb2d65b05
3127.99,1.0,184,2,2,1,5,0xb2d39264
100010.25,2.0,4,3,3,4,10,0xb2d649d8
340064.51,6.0,6,4,4,3,11,0xb2d5951a
144024.58,1.0,29,3,2,2,7,0xb2d4711c
1000021.11,2.0,3,4,3,4,11,0xb2d963cb
1615.64,1.0,8,1,2,3,6,0xb2d38eb5
4181.09,1.0,0,2,2,4,8,0xb2d6892f
971480.46,5.0,0,4,4,4,12,0xb2d377dfd
2222258.88,6.0,1,4,4,4,12,0xb2da39b5
2159.61,1.0,3,1,2,4,7,0xb2d60988
2832.14,1.0,9,1,2,3,6,0xb2d8b198
513.88,1.0,9,1,2,3,6,0xb2d51781
10012.72,2.0,3,2,3,4,9,0xb2d5d53e
2642.33,1.0,10,1,2,3,6,0xb2d8d514
254991.57,3.0,30,3,4,2,9,0xb2d59a76
10008.44,1.0,27,2,2,2,6,0xb2d612fd
1124488.7,3.0,16,4,4,2,10,0xb2d5f8e0
53395.85,2.0,216,3,3,1,7,0xb2d278c8d
207293.76,2.0,34,3,3,2,8,0xb2d33ed9
316542.58,5.0,1,4,4,4,12,0xb2d2112bd
175004.23,3.0,6,3,4,3,10,0xb2d8d9f5d
70002.75,2.0,8,3,3,3,9,0xb2d61374
690600.0,9.0,0,4,4,4,12,0xb2d0698d
360027.61,6.0,3,4,4,4,12,0xb2d4387c
1097.85,1.0,26,1,2,2,5,0xb2d2efd8
315.92,1.0,6,1,2,3,6,0xb2d56c25
220505.39,2.0,175,3,3,1,7,0xb2d3fe11
14000.94,2.0,8,2,3,3,8,0xb2d605f3
750000.0,4.0,2,4,4,4,12,0xb2d1aaf3
2.72,1.0,38,1,2,2,5,0xb2d2450b
51462.62,1.0,184,2,2,1,5,0xb2d35f52
511817.24,3.0,28,4,4,2,10,0xb2d9388d
493000.0,5.0,4,4,4,4,12,0xb2d3c76bd
758.67,1.0,3,1,2,4,7,0xb2d5d395
1706987.56,10.0,10,4,4,3,11,0xb2d0b2f6
200892.46,4.0,80,3,4,1,8,0xb2d656bc
17.94,1.0,60,1,2,2,5,0xb2d9c07b
420036.86,3.0,132,4,4,1,9,0xb2d41430
611.46,3.0,0,1,4,4,9,0x3b9b1860
50046.44,2.0,235,2,3,1,6,0xb2d5cf67
50024.88,2.0,111,2,3,1,6,0xb2d1f8d9
2536.12,1.0,184,1,2,1,4,0xb2d132b4d
70000.0,4.0,1,3,4,4,11,0xb2d06440
11013.81,1.0,76,2,2,1,5,0xb2d58955
11.46,1.0,19,1,2,2,5,0xb2d9e7c0
20321.21,3.0,92,2,4,1,7,0xb2d109d2
215494.9,3.0,0,3,4,4,11,0xb2d23736
100066.59,2.0,47,3,3,2,8,0xb2d9d988
14691.32,1.0,112,2,2,1,5,0xb2d6609a
6.34,1.0,116,1,2,1,4,0xb2d78276
40.35,1.0,0,1,2,4,7,0xb2d15af6
61820.64,1.0,12,3,2,3,8,0xb2d5e818
50025.47,3.0,14,2,4,3,9,0x3b9af0e0
460815.99,9.0,25,4,4,2,10,0x3b9b1262
4527.58,1.0,144,2,2,1,5,0xb2d2987d
11232.9,1.0,36,2,2,2,6,0xb2d5e58a
1114427.25,7.0,21,4,4,2,10,0xb2d09c76
1028.03,1.0,10,1,2,3,6,0xb2d3c94b
260003.38,3.0,98,3,4,1,8,0xb2d8e28f
2989.83,1.0,15,2,2,3,7,0xb2d78dae
127400.37,11.0,0,3,4,4,11,0xb2d2d524
3906.45,1.0,6,2,2,3,7,0xb2d9ec0b
99486.43,1.0,0,3,2,4,9,0xb2d46eb7
20731.77,1.0,33,2,2,2,6,0xb2d5ef8b
102006.99,2.0,108,3,3,1,7,0xb2d5ee68
80064.54,2.0,92,3,3,1,7,0xb2d406a6
16906.38,1.0,184,2,2,1,5,0xb2d2fb7c
5121.2,1.0,87,2,2,1,5,0xb2d0f9c5
18652.21,1.0,6,2,2,3,7,0xb2d915d5
674070.99,5.0,3,4,4,4,12,0xb2d1e92d
55028.22,2.0,69,3,3,1,7,0xb2d106bf
7038.98,4.0,92,2,4,1,7,0xb2d0a059
30089.84,2.0,20,2,3,2,7,0xb2d60924
0.48,1.0,6,1,2,3,6,0xb2d906da
5319.25,1.0,21,2,2,2,6,0xb2d44bf6
1551.73,1.0,0,1,2,4,7,0xb2d4a5ae
240.37,1.0,40,1,2,2,5,0xb2d80ced
15009.53,2.0,184,2,3,1,6,0xb2d5f2db
2251.92,1.0,92,1,2,1,4,0xb2d15be1
1.13,1.0,72,1,2,1,4,0xb2d10a0f
4.9,1.0,30,1,2,2,5,0xb2d50627
360071.37,5.0,104,4,4,1,9,0xb2d0dcd3
152.73,1.0,75,1,2,1,4,0xb2d43757
540080.58,3.0,14,4,4,3,11,0xb2d5e5e5
40001.69,2.0,42,2,3,2,7,0xb2d9e417
62002.09,2.0,1,3,3,4,10,0xb2d6d286d
15131.12,1.0,1,2,2,4,8,0xb2d2bdd4
41455.71,1.0,5,2,2,3,7,0xb2d3c832
1346.46,1.0,0,1,2,4,7,0xb2d92240
1486.92,1.0,0,1,2,4,7,0xb2d0d1bb
23731.9,1.0,0,2,2,4,8,0xb2d69039
230018.51,5.0,11,3,4,3,10,0xb2d5b0a0
25001.06,2.0,14,2,3,3,8,0xb2d68b5c
439223.45,3.0,129,4,4,1,9,0xb2d2680f
835494.48,4.0,0,4,4,4,12,0xb2d0fc29
460012.98,2.0,18,4,3,2,9,0xb2d9d37d
212.01,1.0,22,1,2,2,5,0xb2d32f07
557.48,1.0,26,1,2,2,5,0xb2d36b6e
165.14,1.0,81,1,2,1,4,0xb2d09331
50000.01,4.0,68,2,4,1,7,0xb2d1005a
732.55,3.0,17,1,4,2,7,0x3b9b180f
187.32,1.0,92,1,2,1,4,0xb2d1805b
1555.83,1.0,92,1,2,1,4,0xb2d21dcd
1590.15,1.0,184,1,2,1,4,0xb2d1bec5
1009.76,1.0,92,1,2,1,4,0xb2d2a825
3080000.79,10.0,4,4,4,4,12,0xb2d4b340
80017.7,2.0,172,3,3,1,7,0xb2d58ece
6516.14,1.0,3,2,2,4,8,0xb2d6a4dc
638466.14,1.0,14,4,2,3,9,0xb2d155a7
166860.44,2.0,97,3,3,1,7,0x3b9b22fe
500532.76,3.0,1,4,4,4,12,0xb2d8df3e
354011.02,3.0,11,4,4,3,11,0x3b9b469d
135823.85,1.0,6,3,2,3,8,0xb2d772d2
500001.11,5.0,76,4,4,1,9,0xb2d20773
591769.42,8.0,11,4,4,3,11,0xb2d67d7b
10000.32,2.0,66,2,3,2,7,0xb2d8ed26
1012.04,1.0,184,1,2,1,4,0xb2d3f811
50372.44,4.0,34,2,4,2,8,0xb2d53d6a
2401.65,1.0,46,1,2,2,5,0xb2d92529
7765.62,1.0,57,2,2,2,6,0xb2d43ab3
200004.62,4.0,147,3,4,1,8,0xb2d8eae0
1.25,1.0,5,1,2,3,6,0xb2d9b3f7
350016.09,2.0,199,4,3,1,8,0xb2d103c2
996615.09,9.0,0,4,4,4,12,0xb2d0c872
52093.69,2.0,188,2,3,1,6,0xb2d47953
383.38,1.0,10,1,2,3,6,0xb2d40877
200008.67,2.0,165,3,3,1,7,0xb2d39628
200109.55,2.0,10,3,3,3,9,0xb2d475ed
50291.17,2.0,40,2,3,2,7,0xb2d13a87
7647.61,1.0,13,2,2,3,7,0xb2d2141a
1850084.62,2.0,5,4,3,3,10,0xb2d6dd22
1010661.0,2.0,23,4,3,2,9,0xb2d9177a
1085.95,1.0,0,1,2,4,7,0xb2d892ed
14319.65,1.0,206,2,2,1,5,0xb2d5b31b
6201.59,1.0,8,2,2,3,7,0xb2d7086d
130432.77,3.0,4,3,4,4,11,0xb2d68109
15.31,1.0,42,1,2,2,5,0xb2d9e2b8
10006.06,1.0,20,2,2,2,6,0xb2d6dd52
834013.04,16.0,5,4,4,3,11,0xb2d132a8
1578.36,1.0,0,1,2,4,7,0xb2d86a82
45000.95,2.0,5,2,3,3,8,0xb2d6f390
22.02,1.0,10,1,2,3,6,0xb2d2b072
51702.79,1.0,19,2,2,2,6,0xb2d28f44
3.36,1.0,18,1,2,2,5,0xb2d6cf2e
246.13,1.0,5,1,2,3,6,0xb2d91bf4
17.18,1.0,5,1,2,3,6,0xb2d4dcea
2641.42,1.0,184,1,2,1,4,0xb2d5f585
1450055.71,2.0,108,4,3,1,8,0xb2d5ffdb
0.23,1.0,11,1,2,3,6,0xb2d30036
590021.25,14.0,33,4,4,2,10,0xb2d074c1
30346.53,2.0,62,2,3,2,7,0xb2d6cbe1d
601720.91,3.0,3,4,4,4,12,0xb2d93216
30287.98,1.0,0,2,2,4,8,0xb2d27da2
1787.07,1.0,0,1,2,4,7,0xb2d2daa9
261460.51,7.0,42,3,4,2,9,0xb2d3cc49
560009.71,3.0,52,4,4,2,10,0xb2d63f3b
300714.03,4.0,13,4,4,3,11,0xb2d8f894
770715.87,10.0,24,4,4,2,10,0xb2d63eb3
1268.33,1.0,92,1,2,1,4,0xb2d0e9c4
306488.56,2.0,18,4,3,2,9,0xb2d5e5b6
140593.84,2.0,29,3,3,2,8,0xb2d589c1
110059.13,2.0,189,3,3,1,7,0xb2d614a2
201340.93,2.0,0,3,3,4,10,0xb2d503d3
0.0,1.0,0,1,2,4,7,0xb2d25c27
280002.96,2.0,90,3,3,1,7,0xb2d8c384
0.06,2.0,18,1,3,2,6,0xb2d260ec
2045.73,1.0,3,1,2,4,7,0xb2d33b23
30130.73,2.0,10,2,3,3,8,0xb2d64a8ad
12.88,1.0,0,1,2,4,7,0xb2d6813b
1000010.56,2.0,92,4,3,1,8,0xb2d98014
6621.36,1.0,104,2,2,1,5,0xb2d6ff6a
225000.34,5.0,0,3,4,4,11,0xb2d5dfb7
200000.53,2.0,6,3,3,3,9,0xb2da4d0b
60000.0,2.0,6,3,3,3,9,0xb2da254c
1631502.07,6.0,90,4,4,1,9,0xb2d48cd3
310000.0,2.0,4,4,3,4,11,0xb2da63d1
303830.93,5.0,1,4,4,4,12,0xb2d325d7
1000010.56,2.0,41,4,3,2,9,0xb2d922cc
10002722.22,2.0,11,4,3,3,10,0xb2da4c7f
241706.28,2.0,18,3,3,2,8,0xb2d8f4cb
500006.69,3.0,16,4,4,2,10,0xb2d6ea40
301314.36,4.0,6,4,4,3,11,0xb2d96b07
320564.54,5.0,0,4,4,4,12,0xb2d68fed
513.48,1.0,25,1,2,2,5,0xb2d24261
400038.13,2.0,20,4,3,2,9,0xb2d16c77
83027.5,2.0,196,3,3,1,7,0xb2d1fa6e
4.83,1.0,49,1,2,2,5,0xb2d2dd70
15152.07,1.0,184,2,2,1,5,0xb2d5c999
51.27,1.0,19,1,2,2,5,0xb2d88a19
230000.0,2.0,8,3,3,3,9,0xb2d9cd1b
30020.5,3.0,18,2,4,2,8,0xb2d4227cd
180007.61,2.0,119,3,3,1,7,0xb2d93ea0
476026.53,5.0,80,4,4,1,9,0xb2d1103b
41281.85,1.0,1,2,2,4,8,0xb2d68d6b
324193.18,7.0,0,4,4,4,12,0xb2d10e05
574250.11,8.0,0,4,4,4,12,0xb2d316a8
3953.96,3.0,125,2,4,1,7,0xb2d5c1a1d
8643.73,1.0,92,2,2,1,5,0xb2d17079
2119.79,1.0,0,1,2,4,7,0xb2d34d6b
230045.9,2.0,55,3,3,2,8,0xb2d16f2d
230022.49,5.0,74,3,4,1,8,0xb2d5795a
112911.98,2.0,1,3,3,4,10,0xb2d3a9ac
100423.11,3.0,12,3,4,3,10,0xb2d54848
17494.13,1.0,0,2,2,4,8,0xb2d3cf68
3752.5,1.0,0,2,2,4,8,0xb2d919ae
50002.11,2.0,14,2,3,3,8,0xb2da34ce
53.63,1.0,138,1,2,1,4,0xb2d114b1
506563.23,3.0,0,4,4,4,12,0xb2d50ab6
111105.21,9.0,0,3,4,4,11,0xb2d08d19
4448.59,1.0,15,2,2,3,7,0xb2d4702f
10162.27,2.0,151,2,3,1,6,0xb2d65820d
1150175.93,6.0,11,4,4,3,11,0xb2d30612
201421.02,2.0,34,3,3,2,8,0xb2d8f6f5
6.12,3.0,62,1,4,2,7,0xb2d526f7
2502.92,1.0,29,1,2,2,5,0xb2d701ca
0.53,1.0,67,1,2,1,4,0xb2d9b01d
10332.21,1.0,19,2,2,2,6,0xb2d37c58
220.57,1.0,66,1,2,2,5,0xb2d654c0
257805.66,5.0,202,3,4,1,8,0xb2d06d8d
5127.67,1.0,8,2,2,3,7,0xb2d1b17e
570047.65,13.0,3,4,4,4,12,0xb2d3f0f1
345312.92,7.0,111,4,4,1,9,0xb2d5675b
217111.67,6.0,0,3,4,4,11,0xb2d10d0f
546.98,2.0,29,1,3,2,6,0xb2d1f404
1462.71,1.0,198,1,2,1,4,0xb2d14e9d
550708.07,9.0,26,4,4,2,10,0xb2d4743f
175572.49,2.0,14,3,3,3,9,0xb2d5cb8a
36249.48,2.0,0,2,3,4,9,0xb2d90baf
73839.27,2.0,167,3,3,1,7,0xb2d42f40
524.95,1.0,0,1,2,4,7,0xb2d34e58
250052.76,4.0,25,3,4,2,9,0xb2d12149
5313.87,1.0,7,2,2,3,7,0xb2d6b740
203290.12,2.0,214,3,3,1,7,0xb2d62d1d
81.42,1.0,2,1,2,4,7,0xb2d656e3
56478.62,2.0,35,3,3,2,8,0xb2d1f71a
1158800.36,13.0,77,4,4,1,9,0xb2d4b322
11308.42,2.0,151,2,3,1,6,0xb2d15426
9.21,1.0,64,1,2,2,5,0xb2d2b817
16339.87,1.0,2,2,2,4,8,0xb2d96fe4
9432.19,1.0,161,2,2,1,5,0xb2d259a4
4955.74,1.0,1,2,2,4,8,0xb2d55d2a
268125.29,7.0,0,3,4,4,11,0xb2d19187
500000.0,2.0,2,4,3,4,11,0xb2d97dee
5531.73,1.0,192,2,2,1,5,0xb2d298c2
14338.49,1.0,0,2,2,4,8,0xb2d68055d
50635.57,2.0,18,2,3,2,7,0xb2d5c6f6
380062.41,3.0,101,4,4,1,9,0xb2d56f14
122340.7,2.0,47,3,3,2,8,0xb2d5b795
10000.48,2.0,0,2,3,4,9,0xb2d3fc4d
503.8,1.0,0,1,2,4,7,0xb2d24e77
120222.98,4.0,0,3,4,4,11,0xb2d65586
10211796.85,7.0,82,4,4,1,9,0xb2d2ec3c
4000.92,1.0,4,2,2,4,8,0xb2d8051c
5006005.61,2.0,0,4,3,4,11,0xb2d2aebc
1004.33,1.0,92,1,2,1,4,0xb2d51090
9097.09,1.0,184,2,2,1,5,0xb2d19b18
385981.11,2.0,27,4,3,2,9,0xb2d24c91
1309.76,1.0,9,1,2,3,6,0xb2d1ccba
707070.36,12.0,4,4,4,4,12,0x3b9b2a49
2241000.0,20.0,0,4,4,4,12,0xb2d16be4
84.87,1.0,40,1,2,2,5,0xb2d3a558
457032.53,5.0,0,4,4,4,12,0xb2d09dee
1575.89,1.0,2,1,2,4,7,0xb2d918bad
1865.29,1.0,184,1,2,1,4,0xb2d34606
499004.51,2.0,14,4,3,3,10,0xb2d3bf66
600069.26,7.0,0,4,4,4,12,0xb2d16781d
315927.57,1.0,9,4,2,3,9,0xb2d78337
320158.75,2.0,12,4,3,3,10,0xb2d5252b
5000158.41,2.0,11,4,3,3,10,0xb2d55c9a
507661.84,2.0,19,4,3,2,9,0xb2d69643
420005.04,4.0,9,4,4,3,11,0xb2d6dbc7
1152.76,1.0,92,1,2,1,4,0xb2d653fe
10190.26,1.0,195,2,2,1,5,0xb2d5dc29
200198.51,2.0,129,3,3,1,7,0xb2d644f4
405533.11,3.0,1,4,4,4,12,0xb2d59473
163525.78,2.0,0,3,3,4,10,0xb2d349b3
1850001.65,7.0,0,4,4,4,12,0xb2d1fecd
25000.26,2.0,49,2,3,2,7,0xb2d9d619
176.08,1.0,8,1,2,3,6,0xb2d6fc38
54457.86,1.0,3,3,2,4,9,0xb2d15a61
4.22,1.0,82,1,2,1,4,0xb2d8ce67
636007.46,9.0,6,4,4,3,11,0xb2d158d6
1938.76,1.0,21,1,2,2,5,0xb2d9ae31
1158.06,1.0,91,1,2,1,4,0xb2d696d8
1150.73,2.0,1,1,3,4,8,0xb2d98f69
552622.79,3.0,39,4,4,2,10,0xb2d0ffc4
47.99,1.0,88,1,2,1,4,0xb2d2c044
324045.78,3.0,10,4,4,3,11,0xb2d17793
162282.13,2.0,116,3,3,1,7,0xb2d12a93
77999.63,2.0,3,3,3,4,10,0xb2d1bc2b
72236.87,3.0,5,3,4,3,10,0xb2d4da0a
14046.54,2.0,46,2,3,2,7,0xb2d0af45
938.97,3.0,25,1,4,2,7,0xb2d8580e
436006.21,6.0,3,4,4,4,12,0xb2d0f6ad
26800.92,1.0,0,2,2,4,8,0xb2d32720
200795.81,2.0,36,3,3,2,8,0xb2d65af5
200010.17,2.0,0,3,3,4,10,0xb2d4d0ea
111403.27,4.0,295,3,4,1,8,0xb2d61e27d
310003.27,2.0,70,4,3,1,8,0xb2d9a6a6
150010.57,4.0,49,3,4,2,9,0xb2d11d56
0.0,1.0,29,1,2,2,5,0xb2d7809d
100004.56,2.0,41,3,3,2,8,0xb2d686f4d
63837.01,1.0,28,3,2,2,7,0xb2d315f8
901976.58,3.0,4,4,4,4,12,0xb2d63ab6
100476.92,2.0,73,3,3,1,7,0xb2d6b9c2
1017.07,2.0,92,1,3,1,5,0xb2d0a49a
1047.11,1.0,14,1,2,3,6,0xb2d678dd
1004366.01,2.0,35,4,3,2,9,0xb2d5f5fd
200009.22,2.0,80,3,3,1,7,0xb2d4d9d3
10696564.33,1.0,92,4,2,1,7,0xb2d19f10
9.71,1.0,25,1,2,2,5,0xb2d9611a
24365.92,2.0,92,2,3,1,6,0xb2d232d0
1.06,1.0,92,1,2,1,4,0xb2d1a388
11864.95,1.0,92,2,2,1,5,0xb2d35cf7
2904.2,1.0,0,2,2,4,8,0xb2d6c0b9
266421.69,4.0,53,3,4,2,9,0xb2d5b2ab
753797.88,6.0,7,4,4,3,11,0xb2d3f61b
300000.0,2.0,7,3,3,3,9,0xb2d2c82c
16498.28,1.0,87,2,2,1,5,0xb2d43a9d
10922.82,1.0,0,2,2,4,8,0xb2d37170
276558.38,3.0,4,3,4,4,11,0xb2d5b3b0
15712.76,1.0,14,2,2,3,7,0xb2d6bd9a
11623.56,1.0,184,2,2,1,5,0xb2d2ad12
8.45,1.0,26,1,2,2,5,0xb2d919e4
53001.0,2.0,71,3,3,1,7,0xb2d563f6
22252.73,1.0,0,2,2,4,8,0xb2d34d68
500000.0,2.0,1,4,3,4,11,0xb2da030f
38.38,1.0,68,1,2,1,4,0xb2d8f374
6169.9,1.0,3,2,2,4,8,0xb2d8214d
7382.11,1.0,21,2,2,2,6,0xb2d6bc76
7.54,1.0,32,1,2,2,5,0xb2d557de
10379.25,2.0,189,2,3,1,6,0xb2d58d04
59.07,1.0,81,1,2,1,4,0xb2d44c58
146.93,1.0,101,1,2,1,4,0xb2d649cf
221529.41,2.0,0,3,3,4,10,0xb2d6b4ce
402011.97,3.0,0,4,4,4,12,0xb2d3c584
150003.17,2.0,256,3,3,1,7,0xb2d6c9b3
1890.69,1.0,184,1,2,1,4,0xb2d0e0e9
155533.25,3.0,4,3,4,4,11,0xb2d28b4bd
11419.28,1.0,0,2,2,4,8,0xb2d52681
203062.77,2.0,195,3,3,1,7,0xb2d6370fd
267227.4,2.0,39,3,3,2,8,0xb2d395f4
23394.63,1.0,5,2,2,3,7,0xb2d373f1
301165.63,2.0,12,4,3,3,10,0xb2d9f409
2461.15,2.0,10,1,3,3,7,0xb2d37ada
2341.55,1.0,7,1,2,3,6,0xb2d96371
275394.17,2.0,0,3,3,4,10,0xb2d12be3
62247.89,2.0,0,3,3,4,10,0xb2d0e731
31175.43,3.0,115,2,4,1,7,0xb2d08d4f
415043.14,3.0,11,4,4,3,11,0xb2d8de91
2400.83,1.0,14,1,2,3,6,0xb2d8cd7b
200154.6,1.0,0,3,2,4,9,0xb2d68915
143.85,2.0,33,1,3,2,6,0xb2d8fdf8
320010.63,3.0,67,4,4,1,9,0xb2d2614c
100007.57,2.0,83,3,3,1,7,0xb2d622ae
2685.58,1.0,1,1,2,4,7,0xb2d6aa21
81007.44,4.0,69,3,4,1,8,0xb2d5ff77
164351.33,16.0,11,3,4,3,10,0xb2d5d0ca
14912.63,1.0,8,2,2,3,7,0xb2d55eaf
1450749.13,8.0,74,4,4,1,9,0xb2d10bde
105025.86,2.0,10,3,3,3,9,0xb2d4e1b2
1370.44,1.0,92,1,2,1,4,0x3b9b29f4
183589.44,3.0,1,3,4,4,11,0xb2d9da19
30.31,1.0,10,1,2,3,6,0xb2d29a24
255141.47,4.0,0,3,4,4,11,0xb2d1086c
127726.87,1.0,88,3,2,1,6,0xb2d259e4
2957.16,1.0,11,2,2,3,7,0xb2d262b3
212377.15,2.0,20,3,3,2,8,0xb2d18f48
2480.23,2.0,0,1,3,4,8,0x3b9b45cf
391398.27,2.0,27,4,3,2,9,0xb2d6f680
26236.97,2.0,9,2,3,3,8,0x3b9b298c
925152.23,5.0,56,4,4,2,10,0xb2d15f4f
1249.24,1.0,7,1,2,3,6,0xb2d3832e
1873.14,1.0,10,1,2,3,6,0xb2d8c62e
1296974.25,7.0,1,4,4,4,12,0xb2d0e6ec
26511.08,1.0,10,2,2,3,7,0xb2d3226a
1290.17,1.0,42,1,2,2,5,0xb2d30d25
100943.43,1.0,92,3,2,1,6,0xb2d2bb26
1496682.68,8.0,4,4,4,4,12,0xb2d0bf31
15360.58,1.0,0,2,2,4,8,0xb2d5cf47
14.84,1.0,211,1,2,1,4,0xb2d0d48b
109952.53,2.0,19,3,3,2,8,0xb2d64890
1004.02,1.0,92,1,2,1,4,0xb2d50db8
520002.43,7.0,10,4,4,3,11,0xb2d4d757
8364.83,1.0,41,2,2,2,6,0xb2d31eb0
214300.79,4.0,0,3,4,4,11,0xb2d4159f
1531.03,1.0,92,1,2,1,4,0xb2d2bb60
100171.09,1.0,19,3,2,2,7,0xb2d4ac3e
484012.44,9.0,3,4,4,4,12,0xb2d57e26
1370.75,1.0,193,1,2,1,4,0xb2d34b3fd
1991050.86,5.0,87,4,4,1,9,0xb2d1a520
27569.8,1.0,1,2,2,4,8,0xb2d43c0c
2.01,1.0,22,1,2,2,5,0xb2d235f2
271470.52,4.0,22,3,4,2,9,0xb2d0dbf2
62140.32,2.0,46,3,3,2,8,0xb2d5efbf
960.37,1.0,0,1,2,4,7,0xb2d5c549
514.95,1.0,2,1,2,4,7,0xb2d19b00
814196.89,2.0,216,4,3,1,8,0xb2d5ae33
100001.06,2.0,55,3,3,2,8,0xb2d90444
103.95,1.0,12,1,2,3,6,0xb2d422db
3331.48,3.0,1,2,4,4,10,0x3b9b4458
220998.35,3.0,0,3,4,4,11,0xb2d5dd3a
69.22,1.0,42,1,2,2,5,0xb2d688f4
10.59,1.0,17,1,2,2,5,0xb2d5d230
36.53,1.0,11,1,2,3,6,0xb2d6c42f
501776.06,2.0,30,4,3,2,9,0xb2d9c057
4765.93,1.0,0,2,2,4,8,0xb2d33048
1009.83,1.0,92,1,2,1,4,0xb2d29c57
245001.37,3.0,4,3,4,4,11,0xb2d67df2
273306.06,5.0,41,3,4,2,9,0xb2d2a6b7
3143.39,1.0,25,2,2,2,6,0xb2d1ea30
203231.36,2.0,41,3,3,2,8,0xb2d5ab25
497843.51,3.0,0,4,4,4,12,0xb2d1f7cd
1428.37,1.0,10,1,2,3,6,0xb2d1f748
677.54,3.0,0,1,4,4,9,0xb2d095e1
1134.03,1.0,21,1,2,2,5,0xb2d6e86a
151000.0,2.0,1,3,3,4,10,0xb2d61668
72071.67,2.0,75,3,3,1,7,0xb2d1b2b4
50004.15,3.0,46,2,4,2,8,0xb2d8e13d
128.25,1.0,66,1,2,2,5,0xb2d78b6a
300012.67,2.0,90,3,3,1,7,0xb2d8a08ed
1031.64,1.0,2,1,2,4,7,0xb2d906d6
227.21,1.0,10,1,2,3,6,0xb2d3fbf6
194.08,1.0,51,1,2,2,5,0xb2d6c2d6
209610.69,2.0,43,3,3,2,8,0xb2d57345
420069.53,3.0,0,4,4,4,12,0xb2d91957
500015.83,2.0,18,4,3,2,9,0xb2da27ae
1560670.9,4.0,6,4,4,3,11,0xb2d41035
817120.34,3.0,102,4,4,1,9,0xb2d6123e
1553.25,1.0,104,1,2,1,4,0xb2d24f80
96000.84,1.0,5,3,2,3,8,0xb2d40c97
2180.17,2.0,0,1,3,4,8,0xb2d212fe
460116.94,3.0,1,4,4,4,12,0xb2d8c9b5d
661.88,2.0,1,1,3,4,8,0xb2d075e1
150000.0,3.0,2,3,4,4,11,0xb2d533c8
9.6,1.0,14,1,2,3,6,0xb2d0c381d
100010.0,1.0,18,3,2,2,7,0xb2d42b0d
37099.53,2.0,165,2,3,1,6,0xb2d5ac11
90007.86,2.0,104,3,3,1,7,0xb2d403d4
6.18,1.0,67,1,2,1,4,0xb2d64561
559865.26,6.0,133,4,4,1,9,0xb2d46d99
430159.15,3.0,92,4,4,1,9,0xb2d1dd9f
7064.92,1.0,92,2,2,1,5,0xb2d2bbe8
658848.47,3.0,14,4,4,3,11,0xb2d6836f
11555.75,1.0,0,2,2,4,8,0xb2d2cc51
419.11,2.0,4,1,3,4,8,0x3b9b2d70
1.08,2.0,33,1,3,2,6,0xb2d50976
6.87,1.0,67,1,2,1,4,0xb2d95d12
290062.3,3.0,2,3,4,4,11,0xb2d5fcb7
16499.5,1.0,92,2,2,1,5,0xb2d0979f
73130.74,2.0,1,3,3,4,10,0xb2d64173
26214.33,1.0,184,2,2,1,5,0xb2d359a3
1004.82,1.0,262,1,2,1,4,0xb2d65241
55650.04,2.0,263,3,3,1,7,0xb2d2e395
1382356.56,3.0,20,4,4,2,10,0xb2d3567c
2250.79,1.0,18,1,2,2,5,0xb2d1ec50
930010.14,8.0,31,4,4,2,10,0xb2d469c3
4767.6,1.0,3,2,2,4,8,0xb2d8d7dc
1095010.0,1.0,0,4,2,4,10,0xb2da65d5
285804.37,3.0,33,3,4,2,9,0xb2d5ff89
2823.5,1.0,34,1,2,2,5,0xb2d16eb0
354290.72,4.0,5,4,4,3,11,0xb2d650e5
109037.88,1.0,20,3,2,2,7,0xb2d0d3ca
10175.01,4.0,92,2,4,1,7,0xb2d28caa
150386.33,1.0,4,3,2,4,9,0xb2d0d11a
3003629.16,25.0,0,4,4,4,12,0xb2d128a4
220731.46,2.0,3,3,3,4,10,0xb2d5ebe2
18058.74,1.0,184,2,2,1,5,0xb2d2f45e
4229.58,1.0,10,2,2,3,7,0xb2d50b81
20568.87,1.0,159,2,2,1,5,0xb2d19aea
3003096.75,4.0,14,4,4,3,11,0xb2d25758
6600000.0,2.0,1,4,3,4,11,0xb2da65c7
362593.67,2.0,70,4,3,1,8,0xb2d13f57
680001.9,3.0,18,4,4,2,10,0xb2da30a1
4195.93,2.0,0,2,3,4,9,0x3b9b3dee
2.85,1.0,5,1,2,3,6,0xb2d6e94d
8237.86,1.0,3,2,2,4,8,0xb2d69ac6
910.17,1.0,0,1,2,4,7,0xb2d8ea5d
26.81,1.0,39,1,2,2,5,0xb2d9781b
7996.13,1.0,13,2,2,3,7,0xb2d925acd
4190.48,1.0,13,2,2,3,7,0xb2d8fb60
51483.88,2.0,25,2,3,2,7,0xb2d685ee
200008.44,2.0,20,3,3,2,8,0xb2d94d60
7.1,1.0,20,1,2,2,5,0xb2d96550
307671.76,3.0,0,4,4,4,12,0xb2d53768
646.96,1.0,0,1,2,4,7,0xb2d4c95a
1822.52,1.0,0,1,2,4,7,0xb2d0f50e
17125.67,1.0,92,2,2,1,5,0xb2d184ab
135590.34,1.0,2,3,2,4,9,0xb2d2f29e
21520.7,1.0,115,2,2,1,5,0xb2d4e8fd
72112.9,2.0,1,3,3,4,10,0xb2d42848
950001.22,3.0,2,4,4,4,12,0xb2d61711
2042.52,2.0,92,1,3,1,5,0x3b9b25bb
50000.95,5.0,39,2,4,2,8,0xb2d94db8
2.39,1.0,12,1,2,3,6,0xb2d42b97
9.11,1.0,74,1,2,1,4,0xb2d1fb08
1755.9,1.0,10,1,2,3,6,0xb2d5cff0
818640.98,2.0,6,4,3,3,10,0xb2d167a4
1493.64,2.0,300,1,3,1,5,0x3b9b32c1
100842.9,2.0,2,3,3,4,10,0xb2d2cb91
0.0,1.0,10,1,2,3,6,0xb2d2c4b4
240655.15,2.0,0,3,3,4,10,0xb2d1b52e
30032.83,2.0,0,2,3,4,9,0xb2d62cf3
1104959.35,6.0,3,4,4,4,12,0xb2d55273
181.66,1.0,9,1,2,3,6,0xb2d36baf
2226.12,1.0,92,1,2,1,4,0xb2d2145f
51793.13,3.0,84,2,4,1,7,0xb2d186dd
107049.67,2.0,0,3,3,4,10,0xb2d930ca
252.07,1.0,2,1,2,4,7,0xb2d8f594
1150.55,1.0,67,1,2,1,4,0xb2d6c8f4
2257.54,1.0,9,1,2,3,6,0xb2d27168
1000031.75,2.0,39,4,3,2,9,0xb2d96123
1342.91,1.0,184,1,2,1,4,0xb2d315a0
0.0,1.0,4,1,2,4,7,0xb2d6550a
209514.39,9.0,0,3,4,4,11,0xb2d0d77bd
1100.0,1.0,0,1,2,4,7,0xb2d314d4
735612.16,8.0,1,4,4,4,12,0xb2d1261e
7007.28,1.0,18,2,2,2,6,0xb2d6b6a3
3652.19,1.0,9,2,2,3,7,0xb2d28acd
202864.54,2.0,17,3,3,2,8,0xb2d69a99
364663.12,1.0,1,4,2,4,10,0xb2d7abbf
160074.84,2.0,1,3,3,4,10,0xb2d70169
100073.25,2.0,263,3,3,1,7,0xb2d459be
530022.79,3.0,73,4,4,1,9,0xb2d614f9
300574.71,3.0,20,4,4,2,10,0xb2d90f48
325000.21,6.0,16,4,4,2,10,0xb2d55bde
6814.68,1.0,10,2,2,3,7,0xb2d4b40f
95000.99,3.0,27,3,4,2,9,0xb2d2e7b8
1003.58,8.0,0,1,4,4,9,0xb2d3982b
265005.86,5.0,10,3,4,3,10,0xb2d997b4
100907.65,2.0,143,3,3,1,7,0xb2d17d0c
3000297.56,3.0,18,4,4,2,10,0x3b9af191
226.21,1.0,8,1,2,3,6,0xb2d8da25
402842.11,2.0,9,4,3,3,10,0xb2d8eaa1
203.32,1.0,26,1,2,2,5,0xb2d304ef
9007.57,1.0,16,2,2,2,6,0xb2d5d163
72073.59,2.0,28,3,3,2,8,0xb2d3d21b
270000.0,2.0,1,3,3,4,10,0xb2d9308d
50160.28,2.0,14,2,3,3,8,0xb2d4c26d
65002.43,3.0,92,3,4,1,8,0xb2d66be7
38.1,1.0,18,1,2,2,5,0xb2d65132
100005.29,2.0,125,3,3,1,7,0xb2d9286dd
87000.92,2.0,27,3,3,2,8,0xb2d68e7f
850088.39,5.0,11,4,4,3,11,0xb2d0ebc4
126758.82,2.0,9,3,3,3,9,0xb2d5dcc4
1.11,1.0,39,1,2,2,5,0xb2d0e36b
73.38,1.0,16,1,2,2,5,0xb2d37c04d
16299.29,1.0,20,2,2,2,6,0xb2d81263
11001.08,2.0,63,2,3,2,7,0xb2d64d8a
200000.12,2.0,11,3,3,3,9,0xb2d823bcd
280193.91,5.0,13,3,4,3,10,0xb2d09a28
10042.39,1.0,184,2,2,1,5,0xb2d547f0
13896.85,1.0,18,2,2,2,6,0xb2d268c4
1302823.6,2.0,0,4,3,4,11,0xb2d8f9dd
4783119.9,85.0,0,4,4,4,12,0x3b9b1258
510018.26,2.0,95,4,3,1,8,0xb2d95840
30792.0,1.0,0,2,2,4,8,0xb2d5684e
146654.87,3.0,26,3,4,2,9,0xb2d56eef
9322.2,1.0,11,2,2,3,7,0xb2d95a08
200000.29,2.0,11,3,3,3,9,0xb2d6680d
320002.1,3.0,11,4,4,3,11,0xb2d8e699
2895.1,1.0,75,2,2,1,5,0xb2d3e6ea
500000.0,1.0,4,4,2,4,10,0xb2d9cb41
299956.89,1.0,19,3,2,2,7,0xb2d32fc0
939112.34,7.0,102,4,4,1,9,0xb2d124f1
225608.68,7.0,1,3,4,4,11,0xb2d31c25
10.18,1.0,1,1,2,4,7,0xb2d8d7eb
2401.19,1.0,14,1,2,3,6,0xb2d8ca67
480184.07,3.0,3,4,4,4,12,0xb2d5fcb7d
14771.34,1.0,0,2,2,4,8,0xb2d8dc2bd
87.46,1.0,21,1,2,2,5,0xb2d5d73e
211961.84,4.0,4,3,4,4,11,0xb2d19e9e
210006.65,2.0,92,3,3,1,7,0xb2d97c95
0.0,1.0,5,1,2,3,6,0xb2d4b8bf
16076.27,2.0,27,2,3,2,7,0xb2d5f093
189.56,1.0,5,1,2,3,6,0xb2d49058
10633.69,1.0,1,2,2,4,8,0xb2d9364a
7.84,1.0,4,1,2,4,7,0xb2d6c496
220031.08,1.0,0,3,2,4,9,0xb2d22b72
0.0,1.0,7,1,2,3,6,0xb2d6baed
20006.04,1.0,9,2,2,3,7,0xb2d5d1a2
300119.52,5.0,70,4,4,1,9,0xb2d21e0a
1366.28,1.0,92,1,2,1,4,0xb2d40deb
56495271.22,1.0,0,4,2,4,10,0xb2d511e1
100154.52,2.0,175,3,3,1,7,0xb2d64993
500027.53,3.0,5,4,4,3,11,0xb2d1dfbe
3941.94,1.0,16,2,2,2,6,0xb2d314d4d
67.76,1.0,27,1,2,2,5,0xb2d8c878
17977.03,1.0,19,2,2,2,6,0xb2d2e2ac
33010.82,1.0,0,2,2,4,8,0xb2d6c896
670005.97,5.0,4,4,4,4,12,0xb2d5ee7d
750007.92,4.0,25,4,4,2,10,0xb2d9d67a
4006.89,1.0,0,2,2,4,8,0xb2d8c88a
54000.57,2.0,259,3,3,1,7,0xb2d6c71e
125064.05,2.0,168,3,3,1,7,0xb2d31cad
710.93,1.0,22,1,2,2,5,0xb2d46e2e
21940.26,1.0,0,2,2,4,8,0xb2d60bc0d
120502.15,1.0,0,3,2,4,9,0xb2d205a3
400000.02,2.0,6,4,3,3,10,0xb2d9d428
1000031.55,4.0,189,4,4,1,9,0xb2d1a51c
500020.06,4.0,6,4,4,3,11,0xb2d16ce3
2155.91,1.0,0,1,2,4,7,0xb2d3aaf7d
440045.28,1.0,1,4,2,4,10,0xb2d6b0f2
72112.47,2.0,0,3,3,4,10,0xb2d3ec17
240004.16,4.0,16,3,4,2,9,0xb2d63923d
11721.06,1.0,1,2,2,4,8,0xb2d657ea
20234.51,2.0,101,2,3,1,6,0xb2d68968
788.45,1.0,33,1,2,2,5,0xb2d93ed0
490082.05,2.0,7,4,3,3,10,0xb2d8e9c6
0.0,35.0,4,1,4,4,9,0x3b9af1c0
8.22,1.0,14,1,2,3,6,0xb2d6e5a3
306196.79,2.0,39,4,3,2,9,0xb2d6a396
110098.38,2.0,104,3,3,1,7,0xb2d614b2
8222.17,1.0,3,2,2,4,8,0xb2d67fa8
65223.54,1.0,1,3,2,4,9,0xb2d69644d
500007.86,3.0,14,4,4,3,11,0xb2d6102b
297776.75,3.0,15,3,4,3,10,0xb2d2897b
60000.0,2.0,6,3,3,3,9,0xb2d96da6
253011.48,3.0,4,3,4,4,11,0xb2d5e05c
200710.53,2.0,55,3,3,2,8,0xb2d9c706
25.41,1.0,1,1,2,4,7,0xb2d5f017
10111.9,1.0,92,2,2,1,5,0xb2d10a03
1186.26,1.0,290,1,2,1,4,0xb2d5cde1
200006.72,2.0,92,3,3,1,7,0xb2d57762
2773.13,1.0,10,1,2,3,6,0xb2d2ea96
83088.97,2.0,224,3,3,1,7,0xb2d2b232
4383.72,1.0,13,2,2,3,7,0xb2d27559
500000.0,2.0,55,4,3,2,9,0xb2d9a2fb
4350.24,1.0,5,2,2,3,7,0xb2d16314
96.88,1.0,74,1,2,1,4,0xb2d2bb5a
717817.21,5.0,0,4,4,4,12,0xb2d23414d
157.88,1.0,5,1,2,3,6,0xb2d38dd2
161088.54,2.0,0,3,3,4,10,0xb2d153a5
1248080.94,5.0,1,4,4,4,12,0xb2d3f6f8
158.36,1.0,4,1,2,4,7,0xb2d2d82a
300328.34,2.0,6,4,3,3,10,0xb2d8f054
1.15,3.0,11,1,4,3,8,0xb2d97e0e
200000.0,2.0,3,3,3,4,10,0xb2da656a
6561.32,1.0,24,2,2,2,6,0xb2d28c3d
387007.52,3.0,127,4,4,1,9,0xb2d383ff
209280.91,1.0,1,3,2,4,9,0xb2d5f341
61659.8,1.0,35,3,2,2,7,0xb2d1355a
5047.33,1.0,92,2,2,1,5,0xb2d2bdc9
155211.93,4.0,6,3,4,3,10,0xb2d4191f
201421.22,2.0,82,3,3,1,7,0xb2d98c0b
578668.54,2.0,1,4,3,4,11,0xb2d53f34
10128.21,1.0,92,2,2,1,5,0xb2d5e396
0.0,1.0,1,1,2,4,7,0xb2d0e6f8
40151.12,3.0,73,2,4,1,7,0xb2d5cdd3
2190044.62,5.0,70,4,4,1,9,0xb2d254f1
3839.52,1.0,3,2,2,4,8,0xb2d23848
3035.4,1.0,0,2,2,4,8,0xb2d64241
253133.7,2.0,0,3,3,4,10,0xb2d5d499
267530.49,3.0,67,3,4,1,8,0xb2d37534
26855.75,1.0,3,2,2,4,8,0xb2d6d2c1
470796.86,4.0,42,4,4,2,10,0xb2d1714a
675.17,1.0,21,1,2,2,5,0xb2d27657
652155.89,5.0,18,4,4,2,10,0xb2d17f6f
315.54,1.0,20,1,2,2,5,0xb2d39458
8648.91,2.0,142,2,3,1,6,0xb2d4ef05
260235.67,2.0,79,3,3,1,7,0xb2d473a6
500090.92,3.0,5,4,4,3,11,0xb2d184fc
1246.89,1.0,108,1,2,1,4,0xb2d22dd3
900.6,1.0,7,1,2,3,6,0xb2d43997d
710000.77,4.0,15,4,4,3,11,0xb2d5deefd
2118.87,1.0,92,1,2,1,4,0x3b9ad794
2325.91,1.0,9,1,2,3,6,0xb2d6bf0ed
5.65,1.0,13,1,2,3,6,0xb2d68aa9
18037.09,1.0,2,2,2,4,8,0xb2d449d2
647.15,1.0,0,1,2,4,7,0xb2d368d4
187373.18,2.0,0,3,3,4,10,0xb2d1da88
202600.13,10.0,0,3,4,4,11,0xb2d61b13
3457.24,1.0,4,2,2,4,8,0xb2d1acc7
46538.7,1.0,11,2,2,3,7,0xb2d16bde
320.77,1.0,35,1,2,2,5,0xb2d98765
100101.72,2.0,24,3,3,2,8,0xb2d54c4d
640044.08,4.0,59,4,4,2,10,0xb2d60f8c
2.84,1.0,59,1,2,2,5,0xb2d3bd41
6066.77,1.0,7,2,2,3,7,0xb2d9cfad
1007.64,1.0,0,1,2,4,7,0xb2d6c16b
200088.2,2.0,132,3,3,1,7,0xb2d638d0
722.43,1.0,60,1,2,2,5,0xb2d974ac
1600521.24,7.0,4,4,4,4,12,0xb2d7444d
560988.97,3.0,75,4,4,1,9,0xb2d61bc4d
6562.43,1.0,92,2,2,1,5,0xb2d2f55a
758.13,1.0,9,1,2,3,6,0xb2d21a4d
1983.01,1.0,184,1,2,1,4,0x3b9b2cef
0.0,1.0,42,1,2,2,5,0xb2d622e3
776005.64,5.0,7,4,4,3,11,0xb2d09f84
99.79,1.0,20,1,2,2,5,0xb2d2e7ad
43.18,1.0,15,1,2,3,6,0xb2d6ce21
286.98,1.0,133,1,2,1,4,0xb2d3657f
500000.0,2.0,10,4,3,3,10,0xb2d9264d
6056.82,1.0,0,2,2,4,8,0xb2d6972b
18460.85,1.0,230,2,2,1,5,0xb2d30536
341992.3,6.0,1,4,4,4,12,0x3b9b4604d
691.61,1.0,10,1,2,3,6,0xb2d1dfee
130000.0,1.0,5,3,2,3,8,0xb2d92ffa
340006.0,9.0,0,4,4,4,12,0xb2d94ffe
10287.64,1.0,184,2,2,1,5,0xb2d2d5dc
151688.51,2.0,34,3,3,2,8,0xb2d409fa
90180.03,2.0,10,3,3,3,9,0xb2d13f7e
1000021.11,2.0,39,4,3,2,9,0xb2d9bd0d
1010.0,1.0,92,1,2,1,4,0xb2d142e3
171216.4,3.0,231,3,4,1,8,0xb2d28be1
172.25,1.0,4,1,2,4,7,0xb2d4fefd
1002464.56,2.0,5,4,3,3,10,0xb2d21e6c
151157.67,3.0,47,3,4,2,9,0xb2d6d31c
17411.7,3.0,1,2,4,4,10,0x3b9b1937
2330.31,1.0,0,1,2,4,7,0xb2d5cf9a
210002.22,2.0,83,3,3,1,7,0xb2d8d142
1421777.83,5.0,3,4,4,4,12,0xb2d09de3
651387.48,3.0,4,4,4,4,12,0xb2d8f5b3
470155.36,5.0,1,4,4,4,12,0xb2d39bfe
6529633.1,4.0,11,4,4,3,11,0xb2d163fa
100004.22,2.0,69,3,3,1,7,0xb2d8e69e
65287.52,2.0,179,3,3,1,7,0xb2d36830
908.66,1.0,22,1,2,2,5,0xb2d580c4
0.0,1.0,3,1,2,4,7,0xb2d369d6
799.8,1.0,13,1,2,3,6,0xb2d4bca2
1011.9,1.0,10,1,2,3,6,0xb2d9511f
50001.39,3.0,130,2,4,1,7,0xb2d8ef1d
765.06,1.0,30,1,2,2,5,0xb2d5c053
1715027.83,6.0,6,4,4,3,11,0xb2d0afff
302131.85,2.0,82,4,3,1,8,0xb2d98c0a
452133.32,4.0,16,4,4,2,10,0xb2d8dca7
1364000.0,10.0,4,4,4,4,12,0xb2d40d48
6.36,2.0,7,1,3,3,7,0xb2d260cf
65013.06,3.0,24,3,4,2,9,0xb2d8df2e
7102.98,1.0,9,2,2,3,7,0xb2d4282b
192772.96,2.0,0,3,3,4,10,0xb2d155d5
4279.01,1.0,92,2,2,1,5,0xb2d3590b
350010.61,8.0,7,4,4,3,11,0xb2d59251
3070.08,1.0,0,2,2,4,8,0xb2d6be57
730000.05,4.0,6,4,4,3,11,0xb2d97323
400067.22,2.0,181,4,3,1,8,0xb2d356e0
12766.59,1.0,0,2,2,4,8,0xb2d8c7d9
341.99,4.0,0,1,4,4,9,0x3b9b17fc
280000.67,4.0,4,3,4,4,11,0xb2d87faf
3227.67,1.0,35,2,2,2,6,0xb2d313cc
31720.74,1.0,21,2,2,2,6,0xb2d0b00f
737.81,1.0,1,1,2,4,7,0xb2d597ec
1200527.86,3.0,27,4,4,2,10,0xb2d1648d
479.91,2.0,4,1,3,4,8,0xb2d56b8c
437.47,1.0,89,1,2,1,4,0xb2d65a70
501813.0,2.0,41,4,3,2,9,0xb2d91222
4494.54,1.0,193,2,2,1,5,0xb2d486da
478.03,1.0,10,1,2,3,6,0xb2d3f94c
10030.74,2.0,221,2,3,1,6,0xb2d5c4db
200031.1,2.0,1,3,3,4,10,0xb2d60000
10110.38,1.0,11,2,2,3,7,0xb2d54871
518897.11,3.0,124,4,4,1,9,0xb2d5b518
22728.83,1.0,18,2,2,2,6,0xb2d91768
355244.25,2.0,38,4,3,2,9,0xb2d2fab3
207077.37,5.0,62,3,4,2,9,0xb2d3422f
490081.79,3.0,7,4,4,3,11,0x3b9b37cf
463007.66,12.0,0,4,4,4,12,0xb2d62dc8d
270573.68,4.0,80,3,4,1,8,0xb2d5a236
1002.39,1.0,18,1,2,2,5,0xb2d94dfa
3248.77,1.0,92,2,2,1,5,0xb2d3db42
615.76,1.0,7,1,2,3,6,0xb2da01de
1261363.03,4.0,25,4,4,2,10,0xb2d0de2f
10000000.0,1.0,0,4,2,4,10,0xb2d50923
9.53,1.0,46,1,2,2,5,0xb2d68533
238.99,1.0,70,1,2,1,4,0xb2d2b19f
336611.3,7.0,6,4,4,3,11,0xb2d3fb75
6132.56,1.0,19,2,2,2,6,0xb2d9d633
350985.59,4.0,67,4,4,1,9,0xb2d2447e
1232175.59,5.0,10,4,4,3,11,0xb2d07925
40026.05,2.0,14,2,3,3,8,0xb2d1916a
13374.3,1.0,49,2,2,2,6,0xb2d37c50
10975.13,1.0,19,2,2,2,6,0xb2d69653
700423.04,4.0,0,4,4,4,12,0xb2d58f4ed
5002.27,1.0,13,2,2,3,7,0xb2da0238
30611.88,2.0,7,2,3,3,8,0xb2d5747d
300047.62,2.0,25,3,3,2,8,0xb2d610ef
5778.92,1.0,0,2,2,4,8,0xb2d6ecd3
8157.41,1.0,37,2,2,2,6,0xb2d8c51b
28001.1,3.0,24,2,4,2,8,0xb2d6c36a
110005.39,3.0,11,3,4,3,10,0xb2d424ba
708.8,1.0,9,1,2,3,6,0xb2d30d83
370808.44,4.0,6,4,4,3,11,0xb2d145b3
1273.65,1.0,142,1,2,1,4,0xb2d2a2d9
70991.66,2.0,21,3,3,2,8,0xb2d5d391
61162.85,1.0,0,3,2,4,9,0xb2d18b0a
857191.44,2.0,1,4,3,4,11,0xb2d2e388
110209.05,3.0,49,3,4,2,9,0xb2d33d58
1066884.59,9.0,0,4,4,4,12,0xb2d640a8
11286.93,1.0,6,2,2,3,7,0xb2d2a91c
54265.86,1.0,179,3,2,1,6,0xb2d4fd4b
42704.44,4.0,19,2,4,2,8,0xb2d93bed
936865.1,9.0,28,4,4,2,10,0xb2d26ea0
230834.88,4.0,14,3,4,3,10,0xb2d414c1
300002.05,2.0,13,3,3,3,9,0xb2d3c7e3
2241.42,1.0,10,1,2,3,6,0xb2d0f6dd
300000.0,2.0,28,3,3,2,8,0xb2da0e2a
7142.9,1.0,39,2,2,2,6,0xb2d78d3c
7919.09,3.0,132,2,4,1,7,0xb2d0c6ca
550000.0,4.0,3,4,4,4,12,0xb2d64f7f
907766.6,3.0,47,4,4,2,10,0xb2d7573e
100064.37,2.0,92,3,3,1,7,0xb2d555b1
1011.06,1.0,131,1,2,1,4,0xb2d64bd9
198999.89,6.0,6,3,4,3,10,0xb2d2134b
4.91,1.0,16,1,2,2,5,0xb2d3d268
232000.59,9.0,12,3,4,3,10,0xb2d0f655
10116.81,1.0,23,2,2,2,6,0xb2d92fd3
410311.7,1.0,18,4,2,2,8,0xb2d96776
9391.36,16.0,92,2,4,1,7,0xb2d36b88
1371156.15,7.0,5,4,4,3,11,0xb2d12663
10356.22,2.0,110,2,3,1,6,0xb2d5fe73
1052.15,1.0,10,1,2,3,6,0xb2d6e6f9
200010.0,2.0,8,3,3,3,9,0xb2da4f5a
181101.99,4.0,46,3,4,2,9,0xb2d63dad
787445.8,4.0,98,4,4,1,9,0xb2d1706fd
971.59,1.0,14,1,2,3,6,0xb2d2f7db
30002.49,2.0,27,2,3,2,7,0xb2d62206
253957.16,3.0,41,3,4,2,9,0x3b9adf59
100600.0,3.0,0,3,4,4,11,0x3b9b0e7d
140029.09,3.0,34,3,4,2,9,0xb2d688c2
92102.12,5.0,15,3,4,3,10,0xb2d7f458
206618.21,2.0,39,3,3,2,8,0xb2d0e9fa
157377.12,4.0,8,3,4,3,10,0xb2d92b41
119.06,1.0,7,1,2,3,6,0xb2d5d53ed
110031.74,2.0,165,3,3,1,7,0xb2d5c79b
2582.34,1.0,3,1,2,4,7,0xb2d20768
1709802.15,6.0,1,4,4,4,12,0xb2d0be10
923636.55,8.0,0,4,4,4,12,0xb2d32c3c
250000.0,2.0,5,3,3,3,9,0xb2d624fd
10000.0,2.0,4,2,3,4,9,0xb2da223d
789281.41,12.0,0,4,4,4,12,0xb2d13f26
455117.32,3.0,7,4,4,3,11,0xb2d10540
505010.32,2.0,2,4,3,4,11,0xb2d63494
307118.98,3.0,18,4,4,2,10,0xb2d60db5
339154.39,4.0,0,4,4,4,12,0xb2d94010
200008.45,2.0,140,3,3,1,7,0xb2d90ca5
1066.49,1.0,102,1,2,1,4,0xb2d93efb
515375.43,6.0,8,4,4,3,11,0xb2d56bf3
91.62,1.0,45,1,2,2,5,0xb2d8ce7a
100030.71,2.0,12,3,3,3,9,0xb2d8d73d
111243.28,4.0,35,3,4,2,9,0xb2d379b6
6000.32,1.0,15,2,2,3,7,0xb2d93ee5
261263.22,4.0,6,3,4,3,10,0xb2d945ac
564176.01,6.0,94,4,4,1,9,0xb2d25bd0
906898.52,35.0,0,4,4,4,12,0x3b9af0ff
260.65,2.0,12,1,3,3,7,0xb2d5ef73
2045.66,1.0,92,1,2,1,4,0xb2d1eeb1
500000.0,2.0,10,4,3,3,10,0xb2d96a8b
113823.81,2.0,77,3,3,1,7,0xb2d5eb66
52788.14,2.0,164,3,3,1,7,0xb2d40d3d
2060.97,1.0,0,1,2,4,7,0xb2d62419
1100006.66,7.0,12,4,4,3,11,0xb2d2502a
7763.34,1.0,1,2,2,4,8,0xb2d6c4be
51169.8,2.0,19,2,3,2,7,0xb2d49fc2
11646.8,1.0,1,2,2,4,8,0xb2d6cc42
2238071.3,20.0,3,4,4,4,12,0xb2d0c4f2
2005.32,1.0,92,1,2,1,4,0xb2d5f8aa
115563.48,2.0,51,3,3,2,8,0xb2d3749d
24949.71,12.0,14,2,4,3,9,0xb2d3fae9
18381.69,1.0,0,2,2,4,8,0xb2da256c
21082.56,3.0,0,2,4,4,10,0xb2d0e441
1815483.16,2.0,0,4,3,4,11,0xb2d0b79e
20062.76,2.0,92,2,3,1,6,0xb2d5f2aa
12916.66,1.0,92,2,2,1,5,0xb2d3b0dc
20092.6,1.0,17,2,2,2,6,0xb2d6c6e9
3.83,1.0,21,1,2,2,5,0xb2d5fd16
6.33,1.0,20,1,2,2,5,0xb2d900ee
562.92,1.0,0,1,2,4,7,0xb2d8da92
5686.07,1.0,184,2,2,1,5,0xb2d22f2e
480000.0,2.0,13,4,3,3,10,0xb2d6f8e7
10027.63,1.0,6,2,2,3,7,0xb2d50dd9
14119.85,1.0,19,2,2,2,6,0xb2d3c3d9
1205.0,1.0,184,1,2,1,4,0xb2d0ce23d
7055.47,1.0,7,2,2,3,7,0xb2d91ed7
3240.6,1.0,184,2,2,1,5,0xb2d0c8a9
12238.11,1.0,18,2,2,2,6,0xb2d54c0f
1210689.3,5.0,8,4,4,3,11,0xb2d24e69
10205.41,1.0,92,2,2,1,5,0xb2d58225
802.92,1.0,9,1,2,3,6,0xb2d57baf
2963.67,1.0,0,2,2,4,8,0xb2d3220f
171005.64,3.0,6,3,4,3,10,0xb2d9e9bc
276354.65,3.0,4,3,4,4,11,0xb2d1b894
54488.41,1.0,92,3,2,1,6,0xb2d34921
1581.13,1.0,299,1,2,1,4,0xb2d40829
7459.54,1.0,29,2,2,2,6,0xb2d4081e
137261.63,6.0,56,3,4,2,9,0xb2d41d1a
820994.81,5.0,7,4,4,3,11,0xb2d204fd
302863.38,3.0,107,4,4,1,9,0xb2d76963
10000.21,2.0,53,2,3,2,7,0xb2d9cd96
81614.46,4.0,46,3,4,2,9,0xb2d2573d
650000.0,1.0,0,4,2,4,10,0xb2d11b14
1248.78,11.0,25,1,4,2,7,0xb2d6888cd
127.79,1.0,10,1,2,3,6,0xb2d90b39
510011.07,3.0,90,4,4,1,9,0xb2d635d3
90084.04,4.0,74,3,4,1,8,0xb2d53605
230.4,1.0,0,1,2,4,7,0xb2d33540
50406.21,2.0,82,2,3,1,6,0xb2d63c68
101219.75,2.0,25,3,3,2,8,0xb2d93592
200032.58,2.0,95,3,3,1,7,0xb2d418cc
930058.82,3.0,51,4,4,2,10,0xb2d2985a
667326.71,6.0,0,4,4,4,12,0xb2d5376b
501393.39,2.0,7,4,3,3,10,0xb2d5c481
115902.92,1.0,2,3,2,4,9,0xb2d47d75
934.32,1.0,0,1,2,4,7,0xb2d68f3b
35787.7,1.0,0,2,2,4,8,0xb2d38a07
1.0,2.0,83,1,3,1,5,0xb2d4e7cf
1340000.0,4.0,0,4,4,4,12,0xb2d1a63f
20000.42,2.0,92,2,3,1,6,0xb2d63545
191448.78,5.0,6,3,4,3,10,0xb2d59069
48118.12,1.0,5,2,2,3,7,0xb2d357ed
116917.26,3.0,70,3,4,1,8,0xb2d34d55d
306086.66,9.0,7,4,4,3,11,0xb2d3d893d
655.83,1.0,50,1,2,2,5,0xb2d1f73a
35002.59,2.0,11,2,3,3,8,0xb2d959ff
155502.39,3.0,0,3,4,4,11,0xb2d4363d
25549.07,1.0,2,2,2,4,8,0xb2d6cad8
504945.48,2.0,34,4,3,2,9,0xb2d1b911
103239.13,4.0,18,3,4,2,9,0xb2d58256
4250380.71,6.0,11,4,4,3,11,0xb2d6d2a0
300012.68,2.0,125,3,3,1,7,0xb2d704ef
2437.33,1.0,239,1,2,1,4,0xb2d54065
50011.4,2.0,27,2,3,2,7,0xb2d12701
627.32,1.0,30,1,2,2,5,0xb2d683b9
500018.4,2.0,25,4,3,2,9,0xb2d60b16
310000.0,2.0,1,4,3,4,11,0xb2d97fee
7092.46,1.0,92,2,2,1,5,0xb2d14357
1612.34,1.0,0,1,2,4,7,0xb2d6b01f
65600000.0,4.0,9,4,4,3,11,0xb2d6b37c
50015.98,2.0,122,2,3,1,6,0xb2d765ba
2494610.26,5.0,0,4,4,4,12,0x3b9b1baf
8.59,1.0,12,1,2,3,6,0xb2d5302f
5.44,1.0,79,1,2,1,4,0xb2d4fb64
9543.21,1.0,1,2,2,4,8,0xb2d65088
419839.44,6.0,58,4,4,2,10,0xb2d5269f
180009.49,8.0,14,3,4,3,10,0xb2d12054
88894.34,1.0,21,3,2,2,7,0xb2d254a2
13314.4,2.0,20,2,3,2,7,0xb2d1711f
1427.97,1.0,92,1,2,1,4,0xb2d177f9
101028.63,1.0,184,3,2,1,6,0xb2d16b16
2365.21,1.0,25,1,2,2,5,0xb2d682ac
361797.87,2.0,13,4,3,3,10,0xb2d6478a
2109.04,2.0,92,1,3,1,5,0x3b9b3d71
2200016.71,3.0,0,4,4,4,12,0xb2d1efb6
3.24,1.0,9,1,2,3,6,0xb2d1cd2d
757.23,1.0,2,1,2,4,7,0xb2d60a00
5169.22,1.0,20,2,2,2,6,0xb2d60aa0
157.6,1.0,6,1,2,3,6,0xb2d9646f
200000.0,2.0,78,3,3,1,7,0xb2d8dc65
6.33,1.0,19,1,2,2,5,0xb2d95295
721609.94,3.0,45,4,4,2,10,0xb2d13ebf
114848.11,3.0,92,3,4,1,8,0xb2d18dd7
1107.8,1.0,10,1,2,3,6,0xb2d9041f
305544.91,3.0,113,4,4,1,9,0xb2d44454
584.78,1.0,53,1,2,2,5,0xb2d26781
61050.33,3.0,21,3,4,2,9,0xb2d5e0cb
228250.54,3.0,147,3,4,1,8,0xb2d49ec8
300000.0,3.0,0,3,4,4,11,0xb2d96e5e
2969175.92,4.0,3,4,4,4,12,0xb2d62428
526503.9,4.0,0,4,4,4,12,0xb2d14770
7611038.11,3.0,6,4,4,3,11,0xb2d2ea84d
150005.03,2.0,92,3,3,1,7,0xb2d57a3d
19.89,1.0,25,1,2,2,5,0xb2d2d001
19097.05,1.0,11,2,2,3,7,0xb2d5f648
10000.21,2.0,31,2,3,2,7,0xb2d93aaf
3020.84,1.0,184,2,2,1,5,0xb2d23d0c
77971.3,1.0,81,3,2,1,6,0xb2d51518
699.08,1.0,4,1,2,4,7,0xb2d941f9
295408.09,1.0,1,3,2,4,9,0xb2d32ce2
6327.59,1.0,0,2,2,4,8,0xb2d210e2
10000.11,2.0,46,2,3,2,7,0xb2d8d743
330874.9,2.0,5,4,3,3,10,0xb2d412a1
13.16,1.0,7,1,2,3,6,0xb2d8fb51
1093.49,1.0,92,1,2,1,4,0xb2d2df6a
450000.0,3.0,15,4,4,3,11,0xb2da3781
1295.98,1.0,50,1,2,2,5,0xb2d4aa3e
60493.49,3.0,11,3,4,3,10,0xb2d6528e
314935.25,3.0,139,4,4,1,9,0xb2d43a19
1058.48,1.0,184,1,2,1,4,0xb2d421fa
14000000.0,2.0,1,4,3,4,11,0xb2d97ae8
43.77,1.0,21,1,2,2,5,0xb2d2004b
41289.25,1.0,271,2,2,1,5,0xb2d4dbd8
1769.75,1.0,9,1,2,3,6,0xb2d5d59b
70.15,1.0,12,1,2,3,6,0xb2d54cd4
250573.17,4.0,18,3,4,2,9,0xb2d56766
201202.3,3.0,6,3,4,3,10,0xb2d6591b
7409.65,1.0,81,2,2,1,5,0xb2d3a6dc
200045.43,12.0,104,3,4,1,8,0xb2d1d27e
600000.97,6.0,2,4,4,4,12,0xb2d9232f
406008.26,7.0,60,4,4,2,10,0xb2d0bd48d
11.4,1.0,53,1,2,2,5,0xb2d8cb3e
619939.4,5.0,76,4,4,1,9,0xb2d62372
1028107.07,2.0,0,4,3,4,11,0xb2d41574
513030.0,3.0,4,4,4,4,12,0xb2d61e13
124.21,1.0,4,1,2,4,7,0xb2d5617c
800927.51,4.0,4,4,4,4,12,0xb2d20d1f
0.29,3.0,8,1,4,3,8,0x3b9b1a39
6.8,1.0,38,1,2,2,5,0xb2d948a2d
147.52,1.0,10,1,2,3,6,0xb2d992e6
409028.55,5.0,6,4,4,3,11,0xb2d1dd5d
32716.08,1.0,27,2,2,2,6,0xb2d690e3
43.53,1.0,9,1,2,3,6,0xb2d2ec04
684046.41,5.0,25,4,4,2,10,0xb2d3f7a8
660.49,1.0,50,1,2,2,5,0xb2d58e97
1070.16,1.0,278,1,2,1,4,0xb2d2f62d
7563.96,1.0,1,2,2,4,8,0xb2d2b913
103599.7,2.0,41,3,3,2,8,0xb2d29365
900100.0,2.0,4,4,3,4,11,0xb2d979de
31079.19,2.0,80,2,3,1,6,0xb2d5bcf9
360016.31,2.0,122,4,3,1,8,0xb2d262c5
7114.79,1.0,0,2,2,4,8,0xb2d6bb5f
14035.19,1.0,0,2,2,4,8,0xb2d2ac90
7315.95,1.0,20,2,2,2,6,0xb2d56ea2
54223.16,1.0,0,3,2,4,9,0xb2d3a203
396019.32,5.0,94,4,4,1,9,0xb2d54021d
762085.06,8.0,13,4,4,3,11,0xb2d0b028
657773.18,11.0,11,4,4,3,11,0xb2d2c408
10008.3,3.0,17,2,4,2,8,0x3b9b3f7c
20217.57,2.0,102,2,3,1,6,0xb2d5b6cc
658283.58,7.0,6,4,4,3,11,0xb2d0f0c2
2517.43,1.0,21,1,2,2,5,0xb2d2e22c
290061.24,5.0,4,3,4,4,11,0xb2d1662f
1108.5,1.0,26,1,2,2,5,0xb2d4100c
4537.21,1.0,92,2,2,1,5,0xb2d22de7
102639.13,1.0,2,3,2,4,9,0xb2d27c4a
843057.95,4.0,122,4,4,1,9,0xb2d0dd27
6451.17,1.0,5,2,2,3,7,0xb2d58387
2473.85,1.0,210,1,2,1,4,0xb2d2f20b
452288.58,5.0,26,4,4,2,10,0xb2d2cad5
482951.01,6.0,4,4,4,4,12,0xb2d68658
11091.72,1.0,87,2,2,1,5,0xb2d681ae
14006.0,1.0,10,2,2,3,7,0xb2d909d4
190297.17,7.0,11,3,4,3,10,0xb2d5bcb0
100014.9,1.0,1,3,2,4,9,0xb2d0e8dc
8423.01,1.0,16,2,2,2,6,0xb2d5ec63
513064.29,8.0,13,4,4,3,11,0xb2d233f8
3235657.12,10.0,0,4,4,4,12,0x3b9b0e5c
230014.14,3.0,31,3,4,2,9,0xb2d633f4
19092.82,2.0,10,2,3,3,8,0xb2d27d11
83586.25,2.0,92,3,3,1,7,0xb2d0b24c
52.91,1.0,9,1,2,3,6,0xb2d180a4
254023.12,5.0,0,3,4,4,11,0xb2d0b305
1034.8,1.0,184,1,2,1,4,0xb2d08910
402521.56,1.0,98,4,2,1,7,0xb2d28750
30000.47,3.0,24,2,4,2,8,0xb2d53255
78008.74,1.0,18,3,2,2,7,0xb2d409eb
2195.36,1.0,94,1,2,1,4,0xb2d4017d
4488.68,1.0,0,2,2,4,8,0xb2d78fff
750005.02,12.0,2,4,4,4,12,0xb2d075ae
211422.08,3.0,60,3,4,2,9,0xb2d9b2d6
486000.0,7.0,1,4,4,4,12,0xb2d7cedd
377130.0,2.0,18,4,3,2,9,0xb2d06d23
152122.03,2.0,12,3,3,3,9,0xb2d25164
200677.87,2.0,6,3,3,3,9,0xb2d41ea5
1238924.87,7.0,4,4,4,4,12,0xb2d53ce8
100428.99,2.0,24,3,3,2,8,0xb2d8deac
73849.33,2.0,27,3,3,2,8,0xb2d3c830
500000.0,2.0,27,4,3,2,9,0xb2d94695
55681.5,1.0,5,3,2,3,8,0xb2d2e1f8
577000.0,13.0,4,4,4,4,12,0xb2d3b503
571010.86,13.0,8,4,4,3,11,0xb2d52cde
3096.42,1.0,85,2,2,1,5,0xb2d68cd9
17838.85,1.0,4,2,2,4,8,0xb2d2038d
1098.39,1.0,4,1,2,4,7,0xb2d55226
10034.13,1.0,92,2,2,1,5,0xb2d5d7e8
2792.95,1.0,0,1,2,4,7,0xb2d85cc4
280093.8,3.0,104,3,4,1,8,0xb2d0bf7f
330613.3,11.0,0,4,4,4,12,0x3b9af0cd
30468.87,2.0,60,2,3,2,7,0xb2d6b947
19124.49,1.0,16,2,2,2,6,0xb2d24843
10532.22,1.0,9,2,2,3,7,0xb2d6e1ac
478061.59,2.0,25,4,3,2,9,0xb2d22045
552416.37,4.0,99,4,4,1,9,0xb2d243bc
18219.45,1.0,15,2,2,3,7,0xb2d8c707
100314.15,4.0,83,3,4,1,8,0xb2d4907d
5.76,1.0,18,1,2,2,5,0xb2d97aa8
327.57,2.0,7,1,3,3,7,0xb2d4f3d1
200000.0,2.0,28,3,3,2,8,0xb2d94150
301066.33,2.0,44,4,3,2,9,0xb2d99c5c
50000.48,2.0,94,2,3,1,6,0xb2d11345
51913.52,2.0,179,2,3,1,6,0xb2d59f2f
2011.1,1.0,92,1,2,1,4,0x3b9aeff1
200009.04,3.0,0,3,4,4,11,0xb2d353fb
450006.51,2.0,5,4,3,3,10,0xb2d6abb8
7562.27,1.0,11,2,2,3,7,0xb2d8da52
493.1,1.0,9,1,2,3,6,0xb2d8fd8a
90961.58,4.0,3,3,4,4,11,0xb2d4d1a1
857130.93,6.0,45,4,4,2,10,0xb2d19202
13961.85,1.0,184,2,2,1,5,0xb2d2694f
347056.26,3.0,63,4,4,2,10,0xb2d6859a
2017.58,1.0,92,1,2,1,4,0xb2d58a09
280004.73,3.0,11,3,4,3,10,0xb2d9d376
86629.3,2.0,0,3,3,4,10,0x3b9af1d7
603964.76,2.0,20,4,3,2,9,0xb2d5d6a2
113130.67,2.0,6,3,3,3,9,0xb2d2fb38
415263.53,14.0,0,4,4,4,12,0x3b9b3efd
225.84,2.0,0,1,3,4,8,0xb2d6d2ff
584788.14,7.0,34,4,4,2,10,0xb2d15154
400016.92,2.0,41,4,3,2,9,0xb2d439ab
240000.84,3.0,39,3,4,2,9,0xb2d993cc
461.71,1.0,7,1,2,3,6,0xb2d2c93e
7931.22,1.0,10,2,2,3,7,0xb2d37172
167024.06,5.0,0,3,4,4,11,0x3b9b2af1
25359.8,1.0,0,2,2,4,8,0xb2d31fd9
2309.54,1.0,10,1,2,3,6,0xb2d634fb
251.45,1.0,4,1,2,4,7,0xb2d1021b
401417.04,3.0,3,4,4,4,12,0xb2d2acb6
20160.8,1.0,15,2,2,3,7,0xb2d71898
200000.53,2.0,0,3,3,4,10,0xb2d9354c
500000.0,3.0,8,4,4,3,11,0xb2d92020
189.07,1.0,18,1,2,2,5,0xb2d615b1
245017.94,2.0,74,3,3,1,7,0xb2d1309d
25001.01,3.0,38,2,4,2,8,0xb2d1487e
78.57,1.0,19,1,2,2,5,0xb2d40f30
6188.98,1.0,14,2,2,3,7,0xb2d3a21b
41681.87,1.0,4,2,2,4,8,0xb2d16c6d
425.27,1.0,1,1,2,4,7,0xb2d223da
432642.9,3.0,4,4,4,4,12,0xb2d57481d
20092.04,2.0,199,2,3,1,6,0xb2d5b50a
70007.66,4.0,27,3,4,2,9,0xb2d408e7
72236.53,2.0,6,3,3,3,9,0xb2d3bbb1
20146.93,3.0,18,2,4,2,8,0xb2d578c4
604111.43,3.0,10,4,4,3,11,0xb2d24161
209823.94,10.0,0,3,4,4,11,0xb2d6ef26
274006.26,3.0,28,3,4,2,9,0xb2d1ca63
37133.48,1.0,141,2,2,1,5,0xb2d37cd1
150397.36,2.0,0,3,3,4,10,0xb2d290f4
106198.37,2.0,3,3,3,4,10,0xb2d4d17ed
628033.57,6.0,55,4,4,2,10,0xb2d43654
634885.65,7.0,13,4,4,3,11,0x3b9b3ee6
184610.18,2.0,0,3,3,4,10,0xb2d337dc
235705.69,2.0,143,3,3,1,7,0xb2d5d1f7d
35777.3,4.0,81,2,4,1,7,0xb2d6558e
30000.32,2.0,21,2,3,2,7,0xb2da2013
1557.45,1.0,92,1,2,1,4,0xb2d33c90
350499.46,4.0,12,4,4,3,11,0xb2d23fa0
8106.42,1.0,305,2,2,1,5,0xb2d528dc
108914.76,4.0,1,3,4,4,11,0xb2d141fc
400.03,1.0,7,1,2,3,6,0xb2d32439
1500025.33,3.0,13,4,4,3,11,0xb2d93a6a
836918.02,7.0,0,4,4,4,12,0xb2d212e9
19618.76,2.0,9,2,3,3,8,0xb2d455f2
19374.74,1.0,21,2,2,2,6,0xb2d572a7
85.42,4.0,12,1,4,3,8,0x3b9b1c2a
1126.96,1.0,7,1,2,3,6,0xb2d2b664
64.47,2.0,3,1,3,4,8,0xb2d08a5d
34183.44,1.0,184,2,2,1,5,0xb2d52527d
19699.39,1.0,15,2,2,3,7,0xb2d4da51
1007285.64,2.0,56,4,3,2,9,0xb2d6870b
157.72,1.0,0,1,2,4,7,0xb2d5580b
2010089.65,3.0,11,4,4,3,11,0xb2d57bd1
17000.18,3.0,42,2,4,2,8,0xb2d9e845
1654.17,1.0,105,1,2,1,4,0xb2d43b5e
252.22,1.0,0,1,2,4,7,0xb2d6a9f7
104122.0,2.0,41,3,3,2,8,0xb2d2af68
360604.31,1.0,0,4,2,4,10,0xb2d69d22
4353.39,2.0,82,2,3,1,6,0xb2d91f1c
2.43,1.0,28,1,2,2,5,0xb2d5fe44
8051.91,1.0,184,2,2,1,5,0xb2d3e55c
1225.12,2.0,92,1,3,1,5,0xb2d06a65
2322032.49,7.0,53,4,4,2,10,0xb2d537f8
20823.61,2.0,184,2,3,1,6,0x3b9ade66
10013.55,1.0,71,2,2,1,5,0xb2d99045
9.41,1.0,37,1,2,2,5,0xb2d53ad5
51.43,1.0,3,1,2,4,7,0xb2d34fec
138.69,2.0,10,1,3,3,7,0xb2d31bcf
200002.71,2.0,13,3,3,3,9,0xb2d98d7c
17687.5,1.0,7,2,2,3,7,0xb2d354b2
360199.17,7.0,10,4,4,3,11,0xb2d078d8
56049.93,1.0,18,3,2,2,7,0xb2d5d5bc
4489.58,1.0,0,2,2,4,8,0xb2d54885
1713.87,1.0,36,1,2,2,5,0xb2d6c6f6
350007.06,3.0,21,4,4,2,10,0xb2d93c96
50006.69,2.0,14,2,3,3,8,0xb2da0610
120041.72,2.0,221,3,3,1,7,0xb2d63fc5
203839.35,3.0,48,3,4,2,9,0xb2d6d594
74655.45,2.0,18,3,3,2,8,0xb2d50cb8d
2038.42,1.0,5,1,2,3,6,0xb2d6c87d
1962.75,1.0,0,1,2,4,7,0xb2d2491a
200005.36,4.0,154,3,4,1,8,0xb2d54fd3
1222.25,1.0,184,1,2,1,4,0xb2d56877
767.68,1.0,11,1,2,3,6,0xb2d1a942
303.26,1.0,20,1,2,2,5,0xb2d240fe
200000.0,2.0,11,3,3,3,9,0xb2da4a95
902397.37,8.0,1,4,4,4,12,0x3b9b0fca
46454.71,1.0,0,2,2,4,8,0xb2d17fbb
5656.46,1.0,10,2,2,3,7,0xb2d67e79
184.98,2.0,80,1,3,1,5,0xb2d4973c
222467.05,4.0,31,3,4,2,9,0xb2d607a4
54535.12,2.0,108,3,3,1,7,0xb2d44610
50002.06,2.0,35,2,3,2,7,0xb2d9df2e
46253.48,1.0,6,2,2,3,7,0xb2d2c942
80000.53,4.0,4,3,4,4,11,0xb2da22f5
1201819.95,4.0,15,4,4,3,11,0xb2d8e0ed
530011.19,2.0,95,4,3,1,8,0xb2d97693
1078364.78,4.0,6,4,4,3,11,0xb2d10d1b
232548.75,1.0,3,3,2,4,9,0xb2d2c0a8
103243137.05,11.0,6,4,4,3,11,0xb2d4cdea
80477.14,4.0,5,3,4,3,10,0xb2d9ac3c
10053.05,2.0,1,2,3,4,9,0xb2d94d39
200000.0,2.0,28,3,3,2,8,0xb2d941b3
46.04,1.0,1,1,2,4,7,0xb2d5fd92
3391379.15,26.0,0,4,4,4,12,0x3b9adbd3
10190.18,2.0,116,2,3,1,6,0xb2d63103
8326.03,1.0,92,2,2,1,5,0xb2d37d47
564459.63,8.0,70,4,4,1,9,0xb2d43c69
220018.06,5.0,95,3,4,1,8,0xb2d3c7dc
107008.28,3.0,47,3,4,2,9,0xb2d46ea6
9.5,1.0,55,1,2,2,5,0xb2d8fc84
119638.95,5.0,25,3,4,2,9,0xb2d41a75
0.0,2.0,1,1,3,4,8,0xb2d6b9ef
125006.6,2.0,39,3,3,2,8,0xb2d99fd7
821.05,1.0,9,1,2,3,6,0xb2d60d6d
1506248.31,13.0,0,4,4,4,12,0x3b9af270
8.98,1.0,14,1,2,3,6,0xb2d6895a
3010000.0,2.0,3,4,3,4,11,0xb2d94b20
751.09,1.0,16,1,2,2,5,0xb2d20bdc
20037.29,2.0,2,2,3,4,9,0xb2d6daf4
485025.5,2.0,80,4,3,1,8,0xb2d6acb5
685687.46,4.0,49,4,4,2,10,0xb2d92813
300043.38,2.0,3,3,3,4,10,0xb2d6ac2b
214810.86,2.0,1,3,3,4,10,0xb2d2c007
812937.3,3.0,29,4,4,2,10,0xb2d62ff1
5673.38,1.0,9,2,2,3,7,0xb2d139d2
25574.4,1.0,3,2,2,4,8,0xb2d2b5ff
427574.6,7.0,32,4,4,2,10,0xb2d06348
6059.49,1.0,92,2,2,1,5,0xb2d2957c
316008.88,5.0,62,4,4,2,10,0xb2d19e69
43.27,1.0,208,1,2,1,4,0xb2d3c4f6
30224.7,1.0,20,2,2,2,6,0xb2d37c9c
24522.75,1.0,13,2,2,3,7,0xb2d18f0d
4770.28,1.0,0,2,2,4,8,0xb2d39f34
2258.77,1.0,42,1,2,2,5,0xb2d2bdacd
20766.55,2.0,179,2,3,1,6,0xb2d59887
720.81,2.0,5,1,3,3,7,0xb2d11276
600767.61,8.0,13,4,4,3,11,0xb2d20647
500011.46,3.0,101,4,4,1,9,0xb2d8149d
300023.69,2.0,143,3,3,1,7,0xb2d6dfb5d
480055.77,2.0,19,4,3,2,9,0xb2d691d9
917812.7,5.0,6,4,4,3,11,0xb2d1c9efd
302828.01,3.0,0,4,4,4,12,0xb2d78f56
1060.49,2.0,184,1,3,1,5,0xb2d06ce3
360038.31,5.0,1,4,4,4,12,0xb2d6880d
363.55,4.0,6,1,4,3,8,0xb2d084bb
1378188.61,6.0,5,4,4,3,11,0xb2d0bb2a
403561.87,4.0,3,4,4,4,12,0xb2d09911
10390.69,3.0,14,2,4,3,9,0x3b9b3f27
500073.89,1.0,3,4,2,4,10,0xb2d87d6b
942543.01,3.0,13,4,4,3,11,0xb2d42f56
2.24,1.0,17,1,2,2,5,0xb2d240f5
18.47,1.0,75,1,2,1,4,0xb2d9819f
5252.09,1.0,184,2,2,1,5,0xb2d25e88
13083.92,1.0,92,2,2,1,5,0xb2d3f909
13357.36,1.0,3,2,2,4,8,0xb2d6a238
271640.82,3.0,73,3,4,1,8,0xb2d5c787
507295.8,4.0,22,4,4,2,10,0xb2d5ef7d
1104587.86,7.0,18,4,4,2,10,0xb2d578f3
20007.13,2.0,12,2,3,3,8,0xb2d9d5e6
500000.0,2.0,24,4,3,2,9,0xb2d6e6c2
426424.44,8.0,2,4,4,4,12,0xb2d3a2a8
1257000.4,7.0,0,4,4,4,12,0xb2d6e6d6
1279.01,1.0,131,1,2,1,4,0xb2d37fe0
300328.73,2.0,13,4,3,3,10,0xb2d6c9c4
49258.33,1.0,5,2,2,3,7,0xb2d6cf05
5012.05,1.0,20,2,2,2,6,0xb2d28634
2698.28,3.0,0,1,4,4,9,0x3b9b338c
409770.87,12.0,1,4,4,4,12,0xb2d081f7
218.04,1.0,6,1,2,3,6,0xb2d26647
529134.81,7.0,111,4,4,1,9,0xb2d4ef62
1193721.65,12.0,11,4,4,3,11,0xb2d1aeb2
5858.92,1.0,104,2,2,1,5,0xb2d62af2
50365.82,3.0,48,2,4,2,8,0xb2d96e7b
7575.87,1.0,92,2,2,1,5,0xb2d2462a
294032.36,10.0,19,3,4,2,9,0xb2d60b92
500000.44,3.0,11,4,4,3,11,0xb2d95985
100076.51,2.0,33,3,3,2,8,0xb2d21fb5
822004.59,5.0,6,4,4,3,11,0xb2d641c3
310807.31,3.0,25,4,4,2,10,0xb2d637b0
108765.27,1.0,0,3,2,4,9,0xb2d12e5a
11609.66,1.0,29,2,2,2,6,0xb2d928e3
125000.0,6.0,7,3,4,3,10,0xb2d16e62
7086.63,1.0,11,2,2,3,7,0xb2d9372b
196860.54,3.0,154,3,4,1,8,0xb2d5379ad
1.79,1.0,13,1,2,3,6,0xb2d5304c
3519.23,1.0,92,2,2,1,5,0xb2d24331
12689.75,1.0,9,2,2,3,7,0xb2d3645a
2.37,1.0,5,1,2,3,6,0xb2d6a94e
100004.37,2.0,56,3,3,2,8,0xb2d6ba03
2.53,1.0,69,1,2,1,4,0xb2d5cf25d
117608.95,4.0,0,3,4,4,11,0x3b9af269
3928.76,1.0,0,2,2,4,8,0xb2d6c163
1222000.44,8.0,1,4,4,4,12,0xb2d27583
20180.04,2.0,92,2,3,1,6,0xb2d600b9
70001.79,2.0,6,3,3,3,9,0xb2d96bd8d
564074.38,2.0,36,4,3,2,9,0xb2d1c236
4.75,1.0,0,1,2,4,7,0xb2da3152
1495.8,1.0,2,1,2,4,7,0xb2d4284a
55118.25,3.0,0,3,4,4,11,0x3b9b2b8f
950031.8,4.0,77,4,4,1,9,0x3b9af258
20000.21,2.0,18,2,3,2,7,0x3b9b41a9
3783.7,2.0,92,2,3,1,6,0xb2d5637d
440065.57,5.0,20,4,4,2,10,0xb2d940c1
80.38,1.0,73,1,2,1,4,0xb2d2e57c
10763.84,1.0,4,2,2,4,8,0xb2d18d3f
105102.63,2.0,31,3,3,2,8,0xb2d1a3e9
60106.82,2.0,11,3,3,3,9,0xb2d2490c
70005.07,2.0,80,3,3,1,7,0xb2d122a9
1205202.37,5.0,14,4,4,3,11,0xb2d5ea8f
7457.92,1.0,0,2,2,4,8,0xb2d62c6e
500000.0,2.0,3,4,3,4,11,0xb2da656d
11275.84,1.0,0,2,2,4,8,0xb2d6a9aa
180002.25,8.0,70,3,4,1,8,0xb2d350ca
180015.88,3.0,55,3,4,2,9,0xb2d0de0e
216.11,1.0,22,1,2,2,5,0xb2d2da36
60002.01,2.0,1,3,3,4,10,0xb2d680ea
501776.04,2.0,31,4,3,2,9,0xb2d8fa35
1512213.01,5.0,41,4,4,2,10,0xb2d56e51
363738.63,3.0,107,4,4,1,9,0xb2d8e108
70009.11,2.0,263,3,3,1,7,0xb2d5f9abd
7874.51,1.0,1,2,2,4,8,0xb2d15a54
142036.69,3.0,0,3,4,4,11,0xb2d8f575
7509.0,1.0,10,2,2,3,7,0xb2d4aa2d
5189.1,1.0,92,2,2,1,5,0xb2d48fdc
109105.94,1.0,5,3,2,3,8,0xb2d27610
692.41,1.0,9,1,2,3,6,0xb2d60341
3808.07,3.0,184,2,4,1,7,0x3b9aefb0
600000.0,2.0,92,4,3,1,8,0xb2d5bb9e
23434.43,1.0,3,2,2,4,8,0xb2d5f942
10146.94,1.0,92,2,2,1,5,0xb2d1362e
60705.21,1.0,190,3,2,1,6,0xb2d31167
500021.14,2.0,108,4,3,1,8,0xb2d51c81
1923069.65,4.0,142,4,4,1,9,0xb2d5077d
15.05,1.0,78,1,2,1,4,0xb2d10b3e
260397.83,2.0,7,3,3,3,9,0xb2d420c1
310325.85,2.0,196,4,3,1,8,0xb2d1de9a
1722.59,1.0,9,1,2,3,6,0xb2d47112d
250000.0,4.0,18,3,4,2,9,0xb2d2ad2b
404393.71,3.0,86,4,4,1,9,0xb2d48f7d
200002.11,2.0,221,3,3,1,7,0xb2d703fe
1012.32,1.0,92,1,2,1,4,0xb2d3f78b
5864.58,1.0,91,2,2,1,5,0xb2d613cd
101916.03,2.0,27,3,3,2,8,0xb2d28d7d
0.0,12.0,0,1,4,4,9,0xb2d3357c
101184.76,2.0,83,3,3,1,7,0xb2d3ebbe
646021.74,5.0,4,4,4,4,12,0xb2d541b3
2610071.62,4.0,12,4,4,3,11,0xb2d8a74e
733716.85,2.0,249,4,3,1,8,0xb2d0d606
204733.41,2.0,14,3,3,3,9,0xb2d2ee7e
53038.38,2.0,200,3,3,1,7,0xb2d1c40b
50634.98,2.0,0,2,3,4,9,0xb2d34924
45995.67,1.0,11,2,2,3,7,0xb2d276b7d
53115.27,2.0,3,3,3,4,10,0xb2d4d97a
10976.19,1.0,8,2,2,3,7,0xb2d62a1c
1208.57,1.0,92,1,2,1,4,0xb2d4af6a
463.45,1.0,3,1,2,4,7,0xb2d2080f
100005.28,2.0,69,3,3,1,7,0xb2d9a29a
140002.32,3.0,70,3,4,1,8,0xb2d5e3f6
12.69,1.0,231,1,2,1,4,0xb2d6e9be
8550.6,1.0,184,2,2,1,5,0xb2d0f810
1258262.58,5.0,0,4,4,4,12,0xb2d29b36
2190.2,2.0,6,1,3,3,7,0xb2d448fe
2523.93,1.0,92,1,2,1,4,0xb2d2fe0a
21.07,1.0,10,1,2,3,6,0xb2d5cca5
1810.57,1.0,92,1,2,1,4,0xb2d28d36
205.81,1.0,17,1,2,2,5,0xb2d1cc82
62895.17,4.0,0,3,4,4,11,0xb2d06751
1000084.45,3.0,6,4,4,3,11,0xb2d700e1
53000.63,3.0,42,3,4,2,9,0xb2d98f8a
490616.16,3.0,0,4,4,4,12,0xb2d2628f
902.36,1.0,1,1,2,4,7,0xb2d68cf6
2535.04,1.0,45,1,2,2,5,0xb2d8e21b
42066.63,2.0,92,2,3,1,6,0xb2d3942a
200000.0,2.0,14,3,3,3,9,0xb2da3e18
6000456.47,3.0,6,4,4,3,11,0xb2d9ea9f
2702.1,1.0,8,1,2,3,6,0xb2d9511fd
20383.97,1.0,11,2,2,3,7,0xb2d64acc
656.38,1.0,9,1,2,3,6,0xb2d51b31
640871.9,11.0,0,4,4,4,12,0x3b9b2fd4
3081.57,1.0,10,2,2,3,7,0xb2d6d322
44295.58,2.0,0,2,3,4,9,0xb2d11114
50002.69,2.0,62,2,3,2,7,0xb2d78bc3
82015.58,3.0,60,3,4,2,9,0xb2d5b757
43813.18,1.0,1,2,2,4,8,0xb2d6505f
197.94,2.0,5,1,3,3,7,0xb2d0b81b
838.57,1.0,20,1,2,2,5,0xb2d204f5
987480.77,6.0,15,4,4,3,11,0xb2d60f1e
230408.67,3.0,2,3,4,4,11,0xb2d4fc8c
112149.57,1.0,10,3,2,3,8,0xb2d32370
900814.72,3.0,25,4,4,2,10,0xb2d255e6
184317.71,2.0,1,3,3,4,10,0xb2d16de2d
20295.16,3.0,92,2,4,1,7,0xb2d6d87f
5821.53,1.0,245,2,2,1,5,0xb2d5ea0a
2908627.88,7.0,30,4,4,2,10,0xb2d60eaf
4856.78,1.0,10,2,2,3,7,0xb2d1e60b
507108.62,2.0,116,4,3,1,8,0xb2d90592
20222.91,2.0,18,2,3,2,7,0xb2d60849
50402.0,1.0,92,2,2,1,5,0xb2d3290e
43222.0,1.0,20,2,2,2,6,0xb2d58c79
140007.93,6.0,25,3,4,2,9,0xb2d0ccde
204751.58,8.0,35,3,4,2,9,0xb2d13c15
120002.54,3.0,31,3,4,2,9,0xb2d6f20e
233506.4,3.0,90,3,4,1,8,0xb2d2a118
110020.68,3.0,158,3,4,1,8,0xb2d6c15cd
42945.52,1.0,9,2,2,3,7,0xb2d5d517d
15.36,1.0,10,1,2,3,6,0xb2d9306d
230500.88,4.0,42,3,4,2,9,0xb2d4ec8a
270317.15,2.0,25,3,3,2,8,0xb2d1a58b
100101.86,2.0,172,3,3,1,7,0xb2d472bf
70006.89,3.0,80,3,4,1,8,0xb2d08682
600000.42,2.0,80,4,3,1,8,0xb2d5a76c
552527.48,3.0,21,4,4,2,10,0xb2d28c39
366088.2,4.0,3,4,4,4,12,0xb2d5d8ad
2813686.87,13.0,0,4,4,4,12,0xb2d148f1
150008.36,3.0,73,3,4,1,8,0xb2d5ea8e
107258.15,5.0,60,3,4,2,9,0xb2d3bd83
372158.24,5.0,12,4,4,3,11,0xb2d1603c
5016086.72,2.0,39,4,3,2,9,0x3b9af08d
2582.04,1.0,6,1,2,3,6,0xb2d0e99d
2496957.08,16.0,53,4,4,2,10,0xb2d15428
420071.75,3.0,32,4,4,2,10,0xb2d646a8
22312.52,1.0,10,2,2,3,7,0xb2d6f286
1000000.0,3.0,1,4,4,4,12,0xb2d68abc
3632.67,1.0,9,2,2,3,7,0xb2d74fb4
95017.73,3.0,59,3,4,2,9,0xb2d643b4
2287.69,1.0,184,1,2,1,4,0xb2d2ea48
300065.65,2.0,25,3,3,2,8,0xb2d9cad7
200004.22,2.0,87,3,3,1,7,0xb2d87f6f
225007.15,2.0,235,3,3,1,7,0xb2d6e592
40453.59,1.0,10,2,2,3,7,0xb2d78dd3
2216.59,1.0,0,1,2,4,7,0xb2d9f9bb
34.95,1.0,49,1,2,2,5,0xb2d52fdc
560756.18,11.0,7,4,4,3,11,0xb2d197ca
1124584.04,4.0,20,4,4,2,10,0xb2d10b00
200154.99,4.0,0,3,4,4,11,0xb2d9f341
109000.0,4.0,1,3,4,4,11,0xb2d3cf27
182.97,1.0,1,1,2,4,7,0xb2d6aef9
1200137.94,2.0,90,4,3,1,8,0xb2d46e57
104882.43,1.0,9,3,2,3,8,0xb2d1ddc8
466.78,1.0,8,1,2,3,6,0xb2d7690c
180012.46,5.0,35,3,4,2,9,0xb2d5607d
819576.75,5.0,56,4,4,2,10,0xb2d12896
150429.61,6.0,34,3,4,2,9,0xb2d1724bd
765395.72,4.0,0,4,4,4,12,0xb2d14714
360639.5,3.0,76,4,4,1,9,0xb2d1e32c
352208.27,5.0,1,4,4,4,12,0xb2d641e7
1713.21,1.0,8,1,2,3,6,0xb2d2086f
9868.2,1.0,14,2,2,3,7,0xb2d4d105
3.71,1.0,38,1,2,2,5,0xb2d42934
4184.21,1.0,223,2,2,1,5,0xb2d0c96e
50082.93,2.0,53,2,3,2,7,0xb2d42077
200000.0,2.0,1,3,3,4,10,0xb2da6654
125025.03,7.0,0,3,4,4,11,0x3b9b43b6
6187.41,1.0,17,2,2,2,6,0xb2d59c4f
260049.13,2.0,12,3,3,3,9,0xb2d5a16f
11402.62,2.0,82,2,3,1,6,0x3b9b2f98
588.04,1.0,0,1,2,4,7,0xb2d35822
400752.26,3.0,18,4,4,2,10,0xb2d8c479
1039107.84,7.0,4,4,4,4,12,0xb2d4a590
72839.69,1.0,13,3,2,3,8,0xb2d26bd0
10105.02,1.0,56,2,2,2,6,0xb2d703f1
3949.63,1.0,20,2,2,2,6,0xb2d277bc
14372.38,1.0,8,2,2,3,7,0xb2d4a45e
372.8,1.0,7,1,2,3,6,0xb2d2e3a5
2091.09,1.0,21,1,2,2,5,0xb2d2f388
11203484.01,3.0,92,4,4,1,9,0xb2d40eaa
1008.86,1.0,92,1,2,1,4,0xb2d2a3bc
327723.28,3.0,0,4,4,4,12,0xb2d2ae1b
51006.74,2.0,13,2,3,3,8,0xb2d9acc9
165410.37,4.0,0,3,4,4,11,0xb2d18dcf
4736.69,1.0,59,2,2,2,6,0xb2d58691
1677.67,1.0,9,1,2,3,6,0xb2d4234f
100012.97,3.0,0,3,4,4,11,0xb2d5821a
1306.9,1.0,0,1,2,4,7,0xb2d6b387
474602.5,3.0,32,4,4,2,10,0xb2d1ce73
2902.85,1.0,0,2,2,4,8,0xb2d6c25e
2003.94,1.0,89,1,2,1,4,0xb2d8828a
382559.8,3.0,20,4,4,2,10,0xb2d7442c
248453.09,1.0,119,3,2,1,6,0xb2d559e5
401531.88,3.0,13,4,4,3,11,0xb2d669ab
199.0,1.0,69,1,2,1,4,0xb2d24ddb
20000.82,3.0,18,2,4,2,8,0xb2d920bf
166583.17,2.0,74,3,3,1,7,0xb2d634d5
10930.94,2.0,52,2,3,2,7,0xb2d2bb62
17518.91,1.0,21,2,2,2,6,0xb2d6dd52d
78.78,1.0,0,1,2,4,7,0xb2d4d4a4
470004.96,2.0,42,4,3,2,9,0xb2d9e8ad
1000044.6,4.0,8,4,4,3,11,0xb2d78936
17.78,1.0,34,1,2,2,5,0xb2d21b01
403120.08,6.0,0,4,4,4,12,0xb2d618ce
619844.64,6.0,13,4,4,3,11,0xb2d3ca19
470000.0,2.0,13,4,3,3,10,0xb2d95fc6
71.17,1.0,0,1,2,4,7,0xb2d91d63
50000.53,3.0,14,2,4,3,9,0xb2da2fb2
1377012.17,25.0,8,4,4,3,11,0xb2d1e0af
3647.01,1.0,44,2,2,2,6,0xb2d555b1d
0.96,1.0,6,1,2,3,6,0xb2d4573d
0.13,2.0,1,1,3,4,8,0xb2d0a224
852851.79,3.0,30,4,4,2,10,0xb2d8c362
1404.49,1.0,184,1,2,1,4,0xb2d20009
275.36,1.0,23,1,2,2,5,0xb2d6a992
1789.15,1.0,92,1,2,1,4,0xb2d403b0
5690.0,1.0,0,2,2,4,8,0xb2d5658f
90000.95,2.0,27,3,3,2,8,0xb2d941eb
8669.49,1.0,0,2,2,4,8,0xb2d8d990
57503.54,1.0,14,3,2,3,8,0xb2d3ea85
78313.61,3.0,83,3,4,1,8,0xb2d1b324
665653.7,6.0,32,4,4,2,10,0xb2d5fcb1
16419.65,1.0,184,2,2,1,5,0x3b9af42e
8716.89,1.0,184,2,2,1,5,0xb2d2a8d6
128.97,1.0,22,1,2,2,5,0xb2d42c4e
1200249.53,7.0,0,4,4,4,12,0xb2d8f60e
3286.96,1.0,8,2,2,3,7,0xb2d319af
454200.12,3.0,24,4,4,2,10,0xb2d4527b
200021.8,4.0,20,3,4,2,9,0xb2d34f1e
244159.67,6.0,3,3,4,4,11,0xb2d5b1b8
5520.99,1.0,0,2,2,4,8,0xb2d40596
17699.46,1.0,11,2,2,3,7,0xb2d6063c
6373.52,1.0,10,2,2,3,7,0xb2d6f293
4532.13,2.0,94,2,3,1,6,0xb2d383ba
19220.26,4.0,0,2,4,4,10,0xb2d5631a
12470.07,27.0,110,2,4,1,7,0xb2d281a7
1067.34,1.0,92,1,2,1,4,0xb2d334f9
1405049.65,2.0,29,4,3,2,9,0xb2d8ea18
600000.31,4.0,6,4,4,3,11,0xb2d685f2
200446.64,2.0,21,3,3,2,8,0xb2d4aae7
100003.17,2.0,10,3,3,3,9,0xb2d96074
1521410.61,3.0,34,4,4,2,10,0xb2d65279
234609.82,3.0,139,3,4,1,8,0xb2d1774b
50177.78,4.0,21,2,4,2,8,0xb2d5cb45
692166.57,4.0,48,4,4,2,10,0xb2d56e95
80100.86,2.0,20,3,3,2,8,0xb2d107ea
540000.0,5.0,7,4,4,3,11,0xb2d96e87
442672.56,4.0,87,4,4,1,9,0xb2d1fc39
18522.2,2.0,10,2,3,3,8,0x3b9b405d
80964.43,1.0,5,3,2,3,8,0xb2d629bed
300009.92,2.0,20,3,3,2,8,0xb2d98e8f
3072.86,1.0,28,2,2,2,6,0xb2d5bfb5
50001.58,2.0,80,2,3,1,6,0xb2d8d36f
95546.16,5.0,0,3,4,4,11,0xb2d0a43bd
60001.27,2.0,18,3,3,2,8,0xb2da2a44
36.2,1.0,3,1,2,4,7,0xb2d2f1d1
120016.62,2.0,3,3,3,4,10,0xb2d1c543
310089.74,5.0,4,4,4,4,12,0xb2d6340a
3440000.0,7.0,5,4,4,3,11,0xb2d37e13
82551.39,2.0,14,3,3,3,9,0xb2d651d5
24200.82,1.0,6,2,2,3,7,0xb2d49709
3122.04,2.0,0,2,3,4,9,0x3b9b2d9e
749.09,1.0,7,1,2,3,6,0xb2d5cfe0
212007.46,4.0,125,3,4,1,8,0xb2d13124d
75.87,1.0,9,1,2,3,6,0xb2d5d002
64.97,1.0,8,1,2,3,6,0xb2d1cb79
1.0,2.0,90,1,3,1,5,0xb2d81e82
80006.14,2.0,17,3,3,2,8,0xb2d5bd6d
1050024.28,2.0,13,4,3,3,10,0xb2d9543d
110004.64,2.0,48,3,3,2,8,0x3b9b4278
326336.72,2.0,8,4,3,3,10,0xb2d121a6
10001.05,1.0,3,2,2,4,8,0xb2d963f6
42.02,1.0,0,1,2,4,7,0xb2d93f14
60049.85,2.0,42,3,3,2,8,0xb2d683e8
285124.55,2.0,0,3,3,4,10,0xb2d2124f
83775.97,3.0,10,3,4,3,10,0xb2d07df9
70023.48,2.0,10,3,3,3,9,0xb2d1b148
3260462.15,18.0,0,4,4,4,12,0x3b9af246
1947.33,1.0,4,1,2,4,7,0xb2d43e2e
20.58,1.0,40,1,2,2,5,0xb2d91c4a
2.45,1.0,4,1,2,4,7,0xb2d6a668
20181.75,1.0,92,2,2,1,5,0xb2d4e2bf
219.88,1.0,1,1,2,4,7,0xb2d6c9e8
10632.62,2.0,0,2,3,4,9,0xb2d3fd62
1223.31,1.0,184,1,2,1,4,0xb2d3b8f4
716127.68,1.0,11,4,2,3,9,0xb2d0de15
9.22,1.0,1,1,2,4,7,0xb2d433d2
306644.6,5.0,31,4,4,2,10,0xb2d16d50
5971.12,4.0,258,2,4,1,7,0xb2d2c27c
653775.04,2.0,10,4,3,3,10,0x3b9b3a0e
250002.64,3.0,92,3,4,1,8,0xb2d9812c
160044.41,4.0,39,3,4,2,9,0xb2d24afa
140030.5,2.0,3,3,3,4,10,0xb2d623ad
10113.63,2.0,92,2,3,1,6,0xb2d5b70c
250003.69,3.0,73,3,4,1,8,0xb2d8d07b
5030.07,1.0,0,2,2,4,8,0xb2d16d30
1334.63,1.0,8,1,2,3,6,0xb2d30596
101234.14,2.0,11,3,3,3,9,0xb2d3eb65d
2297.36,1.0,2,1,2,4,7,0xb2d5c063
500230.33,2.0,63,4,3,2,9,0xb2d647c3
7025.3,1.0,0,2,2,4,8,0xb2d2eb33
200754.31,2.0,20,3,3,2,8,0xb2d8db89
200.99,1.0,7,1,2,3,6,0xb2d8f0d3
2710.99,1.0,5,1,2,3,6,0xb2d6a39b
1950052.25,4.0,24,4,4,2,10,0xb2d8ce7b
23487.94,1.0,0,2,2,4,8,0xb2d1525f
20000.84,2.0,53,2,3,2,7,0xb2d9c857
30062.46,1.0,3,2,2,4,8,0xb2d8d2fb
59577.96,1.0,49,3,2,2,7,0xb2d37cce
10129.53,1.0,11,2,2,3,7,0xb2d46dbb
110.41,1.0,8,1,2,3,6,0xb2d34833
200000.0,2.0,7,3,3,3,9,0xb2d97003
1.98,1.0,51,1,2,2,5,0xb2d33a84
5390.45,1.0,139,2,2,1,5,0xb2d41072
102101.33,3.0,6,3,4,3,10,0xb2d93e5c
169087.53,3.0,260,3,4,1,8,0xb2d484f4d
1.51,1.0,20,1,2,2,5,0xb2d8c8bd
31987.18,1.0,10,2,2,3,7,0xb2d5898ed
54334.9,2.0,125,3,3,1,7,0xb2d3b6f6
1328.88,2.0,1,1,3,4,8,0xb2d2fd43
500000.0,2.0,22,4,3,2,9,0xb2da1feb
253733.2,5.0,0,3,4,4,11,0xb2d69e86
3415.82,1.0,92,2,2,1,5,0xb2d2c8d1
319083.62,2.0,19,4,3,2,9,0xb2d0fd4b
16001.05,2.0,28,2,3,2,7,0xb2d58e36
52536.71,2.0,92,3,3,1,7,0xb2d44d35
201007.28,8.0,20,3,4,2,9,0xb2d690b3
381644.05,5.0,27,4,4,2,10,0xb2d286bd
70227.25,2.0,3,3,3,4,10,0xb2d190d1
22321.59,1.0,300,2,2,1,5,0xb2d3a264
500002.68,4.0,0,4,4,4,12,0xb2d69896
137596.83,3.0,80,3,4,1,8,0xb2d61873
510061.8,5.0,3,4,4,4,12,0xb2d1680ed
91980.12,2.0,6,3,3,3,9,0xb2d2411a
376000.84,6.0,6,4,4,3,11,0xb2d553db
70633.37,2.0,76,3,3,1,7,0xb2d26f90
5059.54,1.0,92,2,2,1,5,0xb2d17a1a
200000.18,2.0,4,3,3,4,10,0xb2d8df3ed
1348000.04,8.0,0,4,4,4,12,0xb2d2d7be
862357.57,1.0,74,4,2,1,7,0xb2d208d1
13.05,1.0,4,1,2,4,7,0xb2d321dc
50999.07,1.0,92,2,2,1,5,0xb2d5ab77
50006.18,2.0,165,2,3,1,6,0xb2d6968bd
357018.11,2.0,102,4,3,1,8,0xb2d95ff3
39.06,1.0,33,1,2,2,5,0xb2d8f0c3
50608.21,2.0,47,2,3,2,7,0xb2d6d8a8
40083.39,2.0,28,2,3,2,7,0xb2d5d66c
2064.63,1.0,3,1,2,4,7,0xb2d5dbbdd
30651.89,1.0,49,2,2,2,6,0xb2d61372
710.02,1.0,1,1,2,4,7,0xb2d4dea9
4890.45,1.0,2,2,2,4,8,0xb2d2d3ba
11.34,1.0,15,1,2,3,6,0xb2d22a03
251015.78,3.0,182,3,4,1,8,0xb2d556fe
844.71,1.0,2,1,2,4,7,0xb2d67ddc
461134.9,3.0,26,4,4,2,10,0xb2d9a1c9
2693.82,1.0,46,1,2,2,5,0xb2d99567
358006.19,4.0,3,4,4,4,12,0xb2d131ba
500001.78,4.0,13,4,4,3,11,0xb2d54ac1
250268.11,3.0,0,3,4,4,11,0xb2d689ef
5491555.75,7.0,6,4,4,3,11,0xb2d219e4
482961.41,5.0,3,4,4,4,12,0xb2d3e5d6
2403.64,1.0,203,1,2,1,4,0xb2d470d1
30193.7,1.0,9,2,2,3,7,0xb2d3e52a
278961.31,2.0,139,3,3,1,7,0xb2d105b5
384.22,1.0,0,1,2,4,7,0xb2d3eb62
125850.61,2.0,68,3,3,1,7,0xb2d55e44d
10144.38,1.0,1,2,2,4,8,0xb2d802e6
35.89,1.0,14,1,2,3,6,0xb2d6904e
2477828.21,5.0,11,4,4,3,11,0xb2d110b1
22354.5,1.0,113,2,2,1,5,0xb2d16d87
0.09,1.0,0,1,2,4,7,0xb2d62cb0
2010.75,1.0,59,1,2,2,5,0xb2d8f233
30724.64,2.0,34,2,3,2,7,0xb2d587a6
1157.21,4.0,0,1,4,4,9,0xb2d09f51
200002.11,3.0,119,3,4,1,8,0xb2d16c48
420017.73,2.0,56,4,3,2,9,0xb2d9c2fd
441.17,1.0,3,1,2,4,7,0xb2d2d5ce
25226.54,3.0,9,2,4,3,9,0xb2da0ec4
243.53,1.0,22,1,2,2,5,0xb2d9c5ee
1850000.3,3.0,0,4,4,4,12,0xb2d384cb
404.55,1.0,9,1,2,3,6,0xb2d2bcde
4654.28,2.0,92,2,3,1,6,0x3b9acf21
58255.63,2.0,139,3,3,1,7,0xb2d06c71
4242.88,1.0,8,2,2,3,7,0xb2d94a77
10094.66,1.0,92,2,2,1,5,0xb2d2bcf5
10000.42,2.0,35,2,3,2,7,0xb2d9f519
200022.6,2.0,11,3,3,3,9,0xb2d69916
380577.67,2.0,0,4,3,4,11,0xb2d652cd
28161.77,1.0,24,2,2,2,6,0xb2d627e6
344522.84,3.0,32,4,4,2,10,0xb2d89141
1138.2,1.0,7,1,2,3,6,0xb2d17b94
138856.96,1.0,184,3,2,1,6,0xb2d42138d
60712.72,2.0,0,3,3,4,10,0xb2d2ffa0
94011.26,2.0,14,3,3,3,9,0xb2d47787
34.5,1.0,78,1,2,1,4,0xb2d51a27
542479.44,9.0,0,4,4,4,12,0x3b9b1873
119323.77,2.0,49,3,3,2,8,0xb2d2b32b
3.88,1.0,208,1,2,1,4,0xb2d40b44
13904.16,1.0,5,2,2,3,7,0xb2d6ad5a
103320.29,2.0,62,3,3,2,8,0xb2d309c0
900080.0,2.0,27,4,3,2,9,0xb2d3b56f
9522.51,1.0,8,2,2,3,7,0xb2d2b2e5
228559.58,5.0,19,3,4,2,9,0xb2d1cf87
3.19,1.0,6,1,2,3,6,0xb2d2e1fa
90582.95,4.0,10,3,4,3,10,0xb2d57ee9
46.72,1.0,1,1,2,4,7,0xb2d35059
100006.96,4.0,3,3,4,4,11,0x3b9b345c
400017.29,2.0,54,4,3,2,9,0xb2d55b1d
170000.52,6.0,4,3,4,4,11,0xb2d47a2d
1014933.17,2.0,103,4,3,1,8,0xb2d67d49
51000.16,2.0,15,2,3,3,8,0xb2d4391b
10.1,1.0,0,1,2,4,7,0xb2d7ffec
1126.12,1.0,20,1,2,2,5,0xb2d0c3c4
150008.53,6.0,1,3,4,4,11,0xb2d637de
212036.46,7.0,19,3,4,2,9,0xb2d4e17e
2026.74,1.0,92,1,2,1,4,0xb2d255e2
7737.12,1.0,36,2,2,2,6,0xb2d9189c
127942.63,2.0,0,3,3,4,10,0xb2d4ff03
200264.51,2.0,252,3,3,1,7,0xb2d5ff3a
20258.73,1.0,0,2,2,4,8,0xb2d2d2e2
3126.24,1.0,0,2,2,4,8,0xb2d6b7ae
15763.32,1.0,184,2,2,1,5,0xb2d104b6
8912.67,1.0,18,2,2,2,6,0xb2d3ce4a
505887.53,4.0,66,4,4,2,10,0xb2d197c1
1790.16,1.0,4,1,2,4,7,0xb2d1c1b9
196133.63,3.0,5,3,4,3,10,0xb2d1a466
56150.03,1.0,5,3,2,3,8,0xb2d22e0e
399.05,1.0,3,1,2,4,7,0xb2d547ea
8.73,2.0,82,1,3,1,5,0x3b9b3436
913235.22,9.0,5,4,4,3,11,0xb2d59f81
10290.2,2.0,3,2,3,4,9,0xb2d64e91
136.36,1.0,23,1,2,2,5,0xb2d957a2
120063.26,1.0,0,3,2,4,9,0xb2d2d7f0
300118.19,2.0,164,4,3,1,8,0xb2d5ff20
50040.5,3.0,66,2,4,2,8,0xb2d643c0
90649.01,2.0,5,3,3,3,9,0xb2d43183
10312.4,1.0,45,2,2,2,6,0xb2d62627
2000085.44,2.0,83,4,3,1,8,0xb2d261b1
340097.57,3.0,27,4,4,2,10,0xb2d550be
527008.11,7.0,7,4,4,3,11,0xb2d19145
700021.46,3.0,9,4,4,3,11,0xb2d21be2
26000.55,3.0,171,2,4,1,7,0xb2d6a8fd
360012.44,7.0,1,4,4,4,12,0x3b9b3a4b
2117.98,1.0,0,1,2,4,7,0xb2d6f93b
100000.0,1.0,1,3,2,4,9,0xb2da6971
183129.78,6.0,4,3,4,4,11,0xb2d32869
3106.66,1.0,11,2,2,3,7,0xb2d9429e
6878.43,1.0,46,2,2,2,6,0xb2d78787
30100.33,1.0,10,2,2,3,7,0xb2d957e3d
68240.45,2.0,3,3,3,4,10,0xb2d554ee
2430.54,1.0,0,1,2,4,7,0xb2d15fb3
21718.04,1.0,1,2,2,4,8,0xb2d6bf9c
310327.33,3.0,18,4,4,2,10,0xb2d07f6cd
1860818.38,2.0,92,4,3,1,8,0xb2d60385
202803.2,1.0,54,3,2,2,7,0xb2d42480
199078.24,2.0,28,3,3,2,8,0xb2d19a05
500000.0,2.0,0,4,3,4,11,0xb2da6b13
20136.84,2.0,108,2,3,1,6,0xb2d63b96
15558.84,1.0,11,2,2,3,7,0xb2d31930
385368.81,4.0,3,4,4,4,12,0xb2d0f1ba
860021.85,7.0,1,4,4,4,12,0xb2d584aad
1205.81,1.0,260,1,2,1,4,0xb2d3457f
1323106.03,8.0,0,4,4,4,12,0xb2d10091
3668.13,3.0,184,2,4,1,7,0x3b9b35bc
1401.41,2.0,92,1,3,1,5,0xb2d0aa73d
1402768.02,24.0,3,4,4,4,12,0x3b9b0e1ad
72.26,1.0,88,1,2,1,4,0xb2d25c27d
464.12,1.0,10,1,2,3,6,0xb2d9e8ef
1406.47,1.0,92,1,2,1,4,0xb2d1c3d3
208.65,1.0,13,1,2,3,6,0xb2d6a47c
3032.29,1.0,39,2,2,2,6,0xb2d9ef87
1864.0,1.0,184,1,2,1,4,0xb2d1b081
51797.09,2.0,25,2,3,2,7,0xb2d5bd60
1113015.32,5.0,21,4,4,2,10,0xb2d5c04a
467424.58,4.0,160,4,4,1,9,0xb2d41445d
21440.99,1.0,8,2,2,3,7,0xb2d1d9fd
210069.77,3.0,92,3,4,1,8,0xb2d1b29d
382010.83,8.0,6,4,4,3,11,0xb2d1e5f4
50015.35,2.0,10,2,3,3,8,0xb2d5cb33
1512.33,1.0,92,1,2,1,4,0xb2d1f2d5
20098.28,2.0,4,2,3,4,9,0xb2d5db39
2205.1,1.0,0,1,2,4,7,0xb2d8c88ad
361.17,1.0,10,1,2,3,6,0xb2d9e573
10001.18,2.0,210,2,3,1,6,0xb2d56569
500102.68,2.0,235,4,3,1,8,0xb2d1b916
8051.52,1.0,13,2,2,3,7,0xb2da0e96
117664.09,4.0,11,3,4,3,10,0xb2d201fd
250007.69,4.0,3,3,4,4,11,0xb2d12caa
379554.2,4.0,41,4,4,2,10,0xb2d20474
936.89,2.0,0,1,3,4,8,0xb2d51f3b
100009.12,2.0,238,3,3,1,7,0xb2d15285
236702.16,4.0,60,3,4,2,9,0xb2d16c10d
450239.34,3.0,41,4,4,2,10,0xb2d67e1d
200000.0,2.0,20,3,3,2,8,0xb2d94532
65822.73,9.0,92,3,4,1,8,0x3b9b4371
200475.69,2.0,0,3,3,4,10,0xb2d4a928
684027.68,8.0,6,4,4,3,11,0xb2d5efd6
127.77,1.0,6,1,2,3,6,0xb2d6355d
160350.61,1.0,3,3,2,4,9,0xb2d13c29
100009.72,2.0,3,3,3,4,10,0xb2d553a8
1623.06,3.0,184,1,4,1,6,0xb2d276a4d
100025.43,2.0,19,3,3,2,8,0xb2d906f3
283134.01,1.0,4,3,2,4,9,0xb2d523b0
1282.82,1.0,3,1,2,4,7,0xb2d1b078
10714.24,1.0,4,2,2,4,8,0xb2d19ba2
0.21,1.0,47,1,2,2,5,0xb2d6b33e
690175.68,4.0,8,4,4,3,11,0xb2d2303e
39.91,1.0,68,1,2,1,4,0xb2d6b5dd
142.22,1.0,7,1,2,3,6,0xb2d32866
80000.07,8.0,9,3,4,3,10,0xb2d2e844
727.08,1.0,55,1,2,2,5,0xb2d26b99
200000.0,2.0,3,3,3,4,10,0xb2d97473
1966.1,1.0,8,1,2,3,6,0xb2d1fa0b
874597.17,5.0,0,4,4,4,12,0xb2d60b74
698131.96,4.0,11,4,4,3,11,0xb2d38a68
622223.06,1.0,24,4,2,2,8,0xb2d2fcba
51944.63,3.0,4,2,4,4,10,0xb2d6b46c
1.06,1.0,166,1,2,1,4,0xb2d8e1c7
6230.83,1.0,10,2,2,3,7,0xb2d3e8cc
80004.75,2.0,20,3,3,2,8,0xb2d93ca0
6024.07,1.0,92,2,2,1,5,0xb2d60aab
101447.3,3.0,97,3,4,1,8,0xb2d5e72cd
197031.87,3.0,11,3,4,3,10,0xb2d17274
184630.62,1.0,9,3,2,3,8,0xb2d52eef
1.37,1.0,5,1,2,3,6,0xb2d9e1eb
104998.43,2.0,195,3,3,1,7,0xb2d39953d
27424.25,2.0,1,2,3,4,9,0xb2d5346a
43148.89,1.0,1,2,2,4,8,0xb2d2eeac
10.7,1.0,60,1,2,2,5,0xb2d6846f
8574.0,1.0,1,2,2,4,8,0xb2d48386
262772.05,2.0,28,3,3,2,8,0xb2d78312d
210142.89,3.0,143,3,4,1,8,0xb2d615ab
0.0,1.0,92,1,2,1,4,0xb2d30ae6
213072.19,2.0,90,3,3,1,7,0xb2d3d9cf
7165.38,1.0,92,2,2,1,5,0xb2d2e882
117724.95,4.0,54,3,4,2,9,0xb2d06a70
40100.4,2.0,76,2,3,1,6,0xb2d69cb0
1.48,1.0,11,1,2,3,6,0xb2da403f
336796.92,4.0,0,4,4,4,12,0xb2d7eee4
1009.44,1.0,184,1,2,1,4,0xb2d280ef
0.0,1.0,0,1,2,4,7,0xb2d57efa
1869.58,1.0,39,1,2,2,5,0xb2d6bfce
5088.79,1.0,92,2,2,1,5,0xb2d1e0d9
11283.8,1.0,7,2,2,3,7,0xb2d7597c
412097.59,4.0,7,4,4,3,11,0xb2d25d76
2607.26,1.0,12,1,2,3,6,0xb2d6c244d
273861.14,2.0,34,3,3,2,8,0xb2d75b92
67000.53,6.0,3,3,4,4,11,0xb2d85853
70343.23,3.0,63,3,4,2,9,0xb2d7c793
3808.86,1.0,105,2,2,1,5,0xb2d5a79c
673005.1,8.0,3,4,4,4,12,0xb2d75ba1
320000.0,5.0,0,4,4,4,12,0xb2d260fc
1129.97,1.0,0,1,2,4,7,0xb2d2e892
586541.75,4.0,5,4,4,3,11,0xb2d1397b
4.94,1.0,22,1,2,2,5,0xb2d3bb91
39866.49,1.0,3,2,2,4,8,0xb2d5cf1f
389.0,1.0,10,1,2,3,6,0xb2d3f583
25577.4,1.0,27,2,2,2,6,0xb2d40e62
341032.88,3.0,34,4,4,2,10,0xb2d6d925
9.59,1.0,5,1,2,3,6,0xb2d54c19
0.0,1.0,74,1,2,1,4,0xb2d5e628
150106.65,2.0,125,3,3,1,7,0xb2d3aa63
1000008.4,2.0,22,4,3,2,9,0xb2d6e5f5
500000.41,2.0,14,4,3,3,10,0xb2d26555
3082.72,1.0,32,2,2,2,6,0xb2d9d355
50000.0,3.0,3,2,4,4,10,0xb2d97477
42476.52,1.0,8,2,2,3,7,0xb2d2d16c
16.16,6.0,10,1,4,3,8,0xb2d1bf0f
24635.8,1.0,0,2,2,4,8,0xb2da0dc9
7314.03,1.0,3,2,2,4,8,0xb2d82233
202000.0,1.0,1,3,2,4,9,0xb2d56b0c
3495335.82,8.0,8,4,4,3,11,0xb2d69a0f
1443.04,1.0,98,1,2,1,4,0xb2d517df
970015.79,8.0,11,4,4,3,11,0xb2d32c3cd
30959.17,1.0,11,2,2,3,7,0xb2d408d0
550501.51,2.0,3,4,3,4,11,0xb2d591c7
288.5,1.0,39,1,2,2,5,0xb2d3e0cb
338223.83,9.0,21,4,4,2,10,0xb2d1cd36
0.06,1.0,16,1,2,2,5,0xb2d2b191
10.15,1.0,28,1,2,2,5,0xb2d69dcb
417.91,1.0,5,1,2,3,6,0xb2d78969
1209.22,1.0,26,1,2,2,5,0xb2d2f558
6476983.17,3.0,12,4,4,3,11,0xb2d21666
83132.52,6.0,92,3,4,1,8,0xb2d077d0
40228.92,1.0,248,2,2,1,5,0xb2d3296f
452.33,1.0,10,1,2,3,6,0xb2d3031a
22441.62,1.0,21,2,2,2,6,0xb2d60a46
110045.94,2.0,130,3,3,1,7,0xb2d3d818
5395.03,1.0,13,2,2,3,7,0xb2d27531
318000.0,9.0,8,4,4,3,11,0xb2d61bbbd
9724.59,1.0,0,2,2,4,8,0xb2d6b5e8
254787.02,3.0,38,3,4,2,9,0xb2d37534d
1270000.42,7.0,0,4,4,4,12,0xb2d2394f
650000.21,6.0,0,4,4,4,12,0xb2d695f2
50581.17,2.0,3,2,3,4,9,0xb2d792c5
474683.8,3.0,179,4,4,1,9,0xb2d125f6
100003.17,2.0,24,3,3,2,8,0xb2d9450d
30002.22,2.0,129,2,3,1,6,0xb2d63b90
309008.39,5.0,101,4,4,1,9,0xb2d0771d
195000.0,6.0,0,3,4,4,11,0xb2d39c33
250091.01,1.0,12,3,2,3,8,0xb2d6427e
200710.42,2.0,8,3,3,3,9,0xb2d92e26
177.81,1.0,0,1,2,4,7,0xb2d6ad53
1307.61,1.0,10,1,2,3,6,0xb2d8cf29
408368.66,10.0,4,4,4,4,12,0xb2d08388
250343.45,2.0,4,3,3,4,10,0xb2d1fea9
98.95,1.0,11,1,2,3,6,0xb2d9db97
1.37,1.0,37,1,2,2,5,0xb2d68b42
300114.32,2.0,188,4,3,1,8,0xb2d48f8a
9500.9,1.0,6,2,2,3,7,0xb2d91936
200000.07,2.0,18,3,3,2,8,0xb2d6f09b
24.4,1.0,7,1,2,3,6,0xb2d9720a
2464.69,1.0,46,1,2,2,5,0xb2d5d257
347451.86,2.0,179,4,3,1,8,0xb2d125dd
156524.96,3.0,139,3,4,1,8,0xb2d3ec28
710003.91,4.0,9,4,4,3,11,0xb2d5ab26
0.16,1.0,40,1,2,2,5,0xb2d5154e
150059.18,2.0,3,3,3,4,10,0xb2d24418
19.36,1.0,0,1,2,4,7,0xb2d36271
151064.77,3.0,104,3,4,1,8,0xb2d62cd6
418757.62,2.0,122,4,3,1,8,0xb2d24866
52825.07,1.0,0,3,2,4,9,0xb2d98d04
42260.94,1.0,7,2,2,3,7,0xb2d69013
464825.55,4.0,8,4,4,3,11,0xb2d473f7
1071.24,1.0,184,1,2,1,4,0xb2d29353
46718.77,1.0,0,2,2,4,8,0xb2d22c7cd
7173.81,1.0,0,2,2,4,8,0xb2d6b5aa
19.46,1.0,14,1,2,3,6,0xb2d6936a
71.49,1.0,82,1,2,1,4,0xb2d5a0e6
30000.9,2.0,3,2,3,4,9,0xb2d5ba76
313.63,1.0,6,1,2,3,6,0xb2d6bb6e
250046.91,3.0,38,3,4,2,9,0xb2d50a97
47.94,1.0,10,1,2,3,6,0xb2d2f13d
5042.51,1.0,5,2,2,3,7,0xb2d42b33
75003.17,2.0,104,3,3,1,7,0xb2d7c758d
401163.07,6.0,3,4,4,4,12,0xb2d3b1b2
202200.07,7.0,7,3,4,3,10,0xb2d30e32
370013.71,4.0,0,4,4,4,12,0xb2d907ef
3180.08,1.0,156,2,2,1,5,0xb2d428b7
6.57,1.0,53,1,2,2,5,0xb2d292c2
273.75,1.0,2,1,2,4,7,0xb2d222dd
13120.14,1.0,0,2,2,4,8,0xb2d3956b
344946.25,1.0,24,4,2,2,8,0xb2d1661c
147338.31,2.0,3,3,3,4,10,0xb2d60829d
2.01,6.0,22,1,4,2,7,0xb2d5e66c
24.38,1.0,12,1,2,3,6,0xb2da1267
311851.2,4.0,48,4,4,2,10,0xb2d3a10b
2191.77,1.0,5,1,2,3,6,0xb2d43506
2695.03,1.0,0,1,2,4,7,0xb2d210cd
7049.05,1.0,29,2,2,2,6,0xb2d928cd
6044.79,1.0,25,2,2,2,6,0xb2d96cc0
601731.95,4.0,15,4,4,3,11,0xb2d916d0
753496.48,7.0,18,4,4,2,10,0xb2d1556e
46.54,1.0,10,1,2,3,6,0xb2d94408
372.14,1.0,8,1,2,3,6,0xb2d1d044
200004.72,3.0,39,3,4,2,9,0xb2d5ce74
146.0,1.0,23,1,2,2,5,0xb2d39744
513978.2,3.0,41,4,4,2,10,0xb2d22fce
11.89,1.0,9,1,2,3,6,0xb2d303c9
10087.38,1.0,0,2,2,4,8,0xb2d17da0
150013.02,2.0,28,3,3,2,8,0xb2d29ee9
1683.41,1.0,92,1,2,1,4,0xb2d2bf93
70000.74,2.0,20,3,3,2,8,0xb2d951bd
162.25,1.0,3,1,2,4,7,0xb2d5dd75
30005.09,2.0,70,2,3,1,6,0xb2d550ba
20909.26,1.0,1,2,2,4,8,0xb2d278b4
601007.84,3.0,1,4,4,4,12,0xb2d58807
337.08,2.0,0,1,3,4,8,0xb2d21246
3807.56,1.0,0,2,2,4,8,0xb2d2f98c
1150385.0,6.0,6,4,4,3,11,0xb2d9841b
60421.28,1.0,0,3,2,4,9,0xb2d6ca37
10229.84,1.0,62,2,2,2,6,0xb2d5e07a
573.86,1.0,5,1,2,3,6,0xb2d62b5c
7.5,1.0,78,1,2,1,4,0xb2d39f93
204867.01,6.0,14,3,4,3,10,0xb2d25074
4.4,1.0,15,1,2,3,6,0xb2d37ce8
7.17,2.0,46,1,3,2,6,0xb2d9c7a7
241034.97,7.0,55,3,4,2,9,0xb2d5987d
200000.0,2.0,29,3,3,2,8,0xb2da09b4
416000.75,3.0,1,4,4,4,12,0xb2d8d5e1
51317.61,2.0,49,2,3,2,7,0xb2d6b11c
39159.13,3.0,4,2,4,4,10,0xb2d6260a
43.23,1.0,116,1,2,1,4,0xb2d3c4f6d
23.1,1.0,20,1,2,2,5,0xb2d96851
10783.6,2.0,5,2,3,3,8,0xb2d4ac2e
2000133.15,3.0,25,4,4,2,10,0xb2d63de3
120647.34,6.0,0,3,4,4,11,0xb2d54c6b
50970.0,3.0,36,2,4,2,8,0xb2d6052e
120094.6,2.0,173,3,3,1,7,0xb2d43c6d
15298.94,1.0,280,2,2,1,5,0xb2d5eab9
5393.54,1.0,14,2,2,3,7,0xb2da377e
21591.92,1.0,7,2,2,3,7,0xb2d218a1
2252.43,1.0,21,1,2,2,5,0xb2d8f44e
530729.91,14.0,18,4,4,2,10,0xb2d5748b
305.49,1.0,27,1,2,2,5,0xb2d0db60
12.12,1.0,0,1,2,4,7,0xb2d6a92e
1301071.67,3.0,55,4,4,2,10,0xb2d25e3a
6480.68,1.0,23,2,2,2,6,0xb2d2484f
3.71,3.0,72,1,4,1,6,0xb2d8dfca
2858.53,1.0,0,1,2,4,7,0xb2d6be90
28.07,1.0,72,1,2,1,4,0xb2d294e3
1189035.4,5.0,49,4,4,2,10,0xb2d54857
35.99,1.0,50,1,2,2,5,0xb2d8c518
10047.7,1.0,92,2,2,1,5,0xb2d4eb4c
908059.08,7.0,24,4,4,2,10,0xb2d19237
520068.5,2.0,158,4,3,1,8,0xb2d407e3
1522.85,1.0,2,1,2,4,7,0xb2d76af4
182064.13,3.0,11,3,4,3,10,0xb2d4206f
9857.52,1.0,19,2,2,2,6,0xb2d6c643
27.23,1.0,33,1,2,2,5,0xb2d8e1ba
7493.43,1.0,0,2,2,4,8,0xb2d99846
245002.49,3.0,12,3,4,3,10,0xb2da0d50
10593.12,1.0,12,2,2,3,7,0xb2d6f764
300061.17,1.0,19,3,2,2,7,0xb2da0a63
3068.2,1.0,0,2,2,4,8,0xb2d55227d
96.28,1.0,10,1,2,3,6,0xb2d3ea56
12120.92,1.0,24,2,2,2,6,0xb2d4baed
312202.61,2.0,37,4,3,2,9,0xb2d8f1a2
430106.72,5.0,3,4,4,4,12,0xb2d272cc
705591.91,2.0,90,4,3,1,8,0xb2d22029
200001.0,2.0,10,3,3,3,9,0xb2d9675d
4563.61,1.0,92,2,2,1,5,0xb2d15af8
201421.04,2.0,66,3,3,2,8,0xb2d9aee4
1937.08,1.0,1,1,2,4,7,0xb2d76921
1015.5,1.0,92,1,2,1,4,0xb2d0fbe5
0.54,1.0,11,1,2,3,6,0xb2d39ca7
1331333.27,12.0,11,4,4,3,11,0xb2d089ef
315.02,5.0,3,1,4,4,9,0xb2d1f84d
3488.55,1.0,92,2,2,1,5,0xb2d31598
288013.45,3.0,203,3,4,1,8,0xb2d207f0
404333.37,8.0,0,4,4,4,12,0x3b9b3099
2078.33,1.0,190,1,2,1,4,0xb2d2e29bd
5314.57,2.0,0,2,3,4,9,0xb2d13fe0
438.73,1.0,5,1,2,3,6,0xb2d62751
901377.45,1.0,3,4,2,4,10,0xb2d4b2c0d
12282.55,1.0,0,2,2,4,8,0xb2d3829c
374042.72,3.0,16,4,4,2,10,0xb2d3e67e
39738.22,1.0,21,2,2,2,6,0xb2d69a35
19467.97,3.0,4,2,4,4,10,0x3b9b4693
1803.06,1.0,14,1,2,3,6,0xb2d4c961
221617.21,4.0,87,3,4,1,8,0xb2d593cd
68.24,1.0,7,1,2,3,6,0xb2d4074f
10000.0,3.0,80,2,4,1,7,0xb2d2c5b8
1000000.0,2.0,20,4,3,2,9,0xb2d9d5cf
201658.15,6.0,0,3,4,4,11,0xb2d07b76
590062.52,3.0,15,4,4,3,11,0xb2d835d1
635.96,1.0,11,1,2,3,6,0xb2d6a327
250007.39,4.0,70,3,4,1,8,0xb2d99c54
234358.77,3.0,28,3,4,2,9,0xb2d62610d
1700.29,1.0,9,1,2,3,6,0xb2d634fbd
56725.32,1.0,0,3,2,4,9,0xb2d5168c
4420.24,1.0,135,2,2,1,5,0xb2d439d1
1910032.33,5.0,3,4,4,4,12,0xb2d3f76d
6273.75,1.0,0,2,2,4,8,0xb2d513e1
10000.11,2.0,6,2,3,3,8,0xb2d47c81
88391.74,1.0,201,3,2,1,6,0xb2d57be5
35.78,2.0,4,1,3,4,8,0xb2d08fa6
7354.92,1.0,0,2,2,4,8,0xb2d3ba7d
50001.58,2.0,18,2,3,2,7,0xb2d968a6
150006.95,4.0,32,3,4,2,9,0xb2d3422c
194004.38,3.0,11,3,4,3,10,0xb2d4169e
5067.85,1.0,0,2,2,4,8,0xb2d906c0
1824.62,1.0,92,1,2,1,4,0xb2d40034
286000.0,2.0,15,3,3,3,9,0xb2da37c7
10953.24,1.0,15,2,2,3,7,0xb2d6b701
647003.65,7.0,65,4,4,2,10,0xb2d572ab
15690.59,1.0,14,2,2,3,7,0xb2d47463
5518.81,1.0,9,2,2,3,7,0xb2d6d690
109474.3,2.0,184,3,3,1,7,0xb2d0957f
5036.11,1.0,184,2,2,1,5,0xb2d40a6d
0.0,1.0,6,1,2,3,6,0xb2d53884
10000.21,2.0,18,2,3,2,7,0xb2da2c38
6285.63,1.0,2,2,2,4,8,0xb2d357e8
275748.55,2.0,104,3,3,1,7,0xb2d14aa0
21010.59,2.0,87,2,3,1,6,0xb2d36249
30959.67,1.0,231,2,2,1,5,0xb2d1f7d8
59493.04,1.0,1,3,2,4,9,0xb2d4c65a
2900078.35,1.0,0,4,2,4,10,0xb2d6b0f2d
81293.41,3.0,20,3,4,2,9,0xb2d43673
1600033.78,2.0,18,4,3,2,9,0xb2d95397d
230052.29,2.0,4,3,3,4,10,0xb2d17246
353592.25,3.0,3,4,4,4,12,0xb2d31796
1.59,1.0,76,1,2,1,4,0xb2d6568b
250000.53,4.0,1,3,4,4,11,0xb2d9ca1a
80001.69,2.0,53,3,3,2,8,0xb2d9cddf
3334.2,1.0,127,2,2,1,5,0xb2d1e18e
400032.08,4.0,175,4,4,1,9,0xb2d0bb8a
58.78,1.0,30,1,2,2,5,0xb2d33326
3209.19,1.0,0,2,2,4,8,0xb2d8f7af
300142.91,2.0,90,4,3,1,8,0xb2d10d38d
37.55,1.0,31,1,2,2,5,0xb2d2ebed
10.56,1.0,197,1,2,1,4,0xb2d26891
1894246.13,5.0,94,4,4,1,9,0xb2d530b4
210748.8,2.0,54,3,3,2,8,0xb2d904d3
20000.21,2.0,48,2,3,2,7,0xb2d9d982
240824.76,3.0,1,3,4,4,11,0xb2d10f12
22903.25,1.0,2,2,2,4,8,0xb2d2ea93
250005.28,2.0,46,3,3,2,8,0xb2d8f5bf
2359.2,1.0,6,1,2,3,6,0xb2d6f4f7
7441.24,1.0,92,2,2,1,5,0xb2d17d25d
82806.32,2.0,235,3,3,1,7,0xb2d40d88
537.82,1.0,17,1,2,2,5,0xb2d37258
83755.83,1.0,92,3,2,1,6,0x3b9b304a
2141.13,1.0,12,1,2,3,6,0xb2d342ec
87513.29,2.0,136,3,3,1,7,0xb2d297ad
175.81,1.0,72,1,2,1,4,0xb2d2ed3b
261436.63,6.0,47,3,4,2,9,0xb2d52103d
1767008.9,5.0,6,4,4,3,11,0xb2d101d7
100009.51,3.0,40,3,4,2,9,0xb2d5ba7a
225252.84,6.0,0,3,4,4,11,0xb2d252f7
1433.31,1.0,0,1,2,4,7,0xb2d8dfc5
236.38,1.0,30,1,2,2,5,0xb2d42a03
7610.3,1.0,92,2,2,1,5,0xb2d37c5c
50001.6,2.0,263,2,3,1,6,0xb2d16ef6
250000.04,3.0,14,3,4,3,10,0xb2d78b09
80002.01,3.0,4,3,4,4,11,0xb2d1010a
257387.15,3.0,39,3,4,2,9,0xb2d2c0ba
321136.67,2.0,8,4,3,3,10,0xb2d92f46
714080.04,7.0,3,4,4,4,12,0xb2d6005a
21.66,1.0,76,1,2,1,4,0xb2d596c8
694340.52,13.0,0,4,4,4,12,0x3b9ad55ed
51707.51,1.0,184,2,2,1,5,0xb2d2d04c
2597.37,1.0,3,1,2,4,7,0xb2d31d07
2015.67,1.0,184,1,2,1,4,0xb2d3b46b
51.02,1.0,0,1,2,4,7,0xb2d3f2ae
60000.87,3.0,99,3,4,1,8,0xb2d4f123
116192.6,6.0,0,3,4,4,11,0xb2d0d832
491414.85,4.0,4,4,4,4,12,0xb2d1b8d1
114.02,13.0,53,1,4,2,7,0xb2d2fff5
155003.9,2.0,54,3,3,2,8,0xb2d90c68
273261.83,4.0,3,3,4,4,11,0xb2d2a6b7d
200718.38,2.0,47,3,3,2,8,0xb2d9cc45
12249.09,1.0,40,2,2,2,6,0xb2d219f0
0.0,1.0,56,1,2,2,5,0xb2d42dff
69.95,1.0,23,1,2,2,5,0xb2d199e6
1770309.29,2.0,0,4,3,4,11,0xb2d5f819
7583.15,1.0,184,2,2,1,5,0xb2d2462ad
423000.0,2.0,11,4,3,3,10,0xb2da4cb0
80004.9,2.0,158,3,3,1,7,0xb2d2284c
1200000.0,3.0,3,4,4,4,12,0xb2d9788fd
382.5,1.0,1,1,2,4,7,0xb2d53601
31.89,1.0,0,1,2,4,7,0xb2d4a5d6
312434.65,3.0,28,4,4,2,10,0xb2d603b8
311830.29,3.0,0,4,4,4,12,0xb2d6d54d
666003.86,4.0,6,4,4,3,11,0xb2d96bcb
446195.29,6.0,10,4,4,3,11,0xb2d3c853
50782.07,2.0,10,2,3,3,8,0xb2d2b5c5
730092.29,4.0,0,4,4,4,12,0xb2d063d4
210020.0,4.0,0,3,4,4,11,0xb2d9c38c
2527.2,1.0,92,1,2,1,4,0xb2d33d2e
100039.67,2.0,9,3,3,3,9,0xb2d94023
233269.56,2.0,134,3,3,1,7,0xb2d92428
34366.33,1.0,18,2,2,2,6,0xb2d6bd2a
250000.0,1.0,0,3,2,4,9,0xb2d5a291d
440000.92,2.0,4,4,3,4,11,0xb2d9fd96
1014.52,1.0,92,1,2,1,4,0xb2d14ac7
63.66,1.0,55,1,2,2,5,0xb2d96e9c
300004.66,9.0,55,3,4,2,9,0xb2d19d18
497.84,1.0,23,1,2,2,5,0xb2d1b9c6
10000.21,2.0,8,2,3,3,8,0xb2da491e
5.29,1.0,24,1,2,2,5,0xb2d23d10
11572.33,1.0,7,2,2,3,7,0xb2d55118
75.4,1.0,14,1,2,3,6,0xb2d40666
707243.31,1.0,1,4,2,4,10,0xb2d283d4d
10028.47,2.0,21,2,3,2,7,0xb2d64837
43.54,1.0,1,1,2,4,7,0xb2d6bdd9
224693.97,2.0,193,3,3,1,7,0xb2d0c38fd
0.0,1.0,59,1,2,2,5,0xb2d29a80
211005.97,5.0,4,3,4,4,11,0xb2d953db
2497.05,1.0,16,1,2,2,5,0xb2d2cf59
252055.69,5.0,1,3,4,4,11,0xb2d560af
140003.08,7.0,35,3,4,2,9,0xb2d4ec90
169039.48,2.0,67,3,3,1,7,0xb2d4517c
5201.11,1.0,184,2,2,1,5,0xb2d131a4
75156.8,2.0,0,3,3,4,10,0xb2d34d56
136.67,1.0,1,1,2,4,7,0xb2d3185b
142501.99,5.0,0,3,4,4,11,0xb2d7fc07
2739.81,2.0,92,1,3,1,5,0xb2d0d462
430044.15,5.0,52,4,4,2,10,0xb2d13e02
816622.69,16.0,7,4,4,3,11,0x3b9b1850
588236.69,8.0,0,4,4,4,12,0xb2d56fd3
20000.42,2.0,208,2,3,1,6,0xb2d783ff
20721.8,1.0,6,2,2,3,7,0xb2d2bf5e
5258.66,1.0,0,2,2,4,8,0xb2d41191
30000.32,2.0,42,2,3,2,7,0xb2d9e759
0.01,1.0,48,1,2,2,5,0xb2d57c23
6875.53,3.0,4,2,4,4,10,0x3b9b198b
262307.87,3.0,20,3,4,2,9,0xb2d382e5
401420.89,2.0,44,4,3,2,9,0xb2d9212c
3058.82,1.0,0,2,2,4,8,0xb2d9a331
24610.28,1.0,184,2,2,1,5,0xb2d1f35e
3351.89,1.0,67,2,2,1,5,0xb2d34435
1130.05,1.0,5,1,2,3,6,0xb2d6deebd
1522.17,1.0,184,1,2,1,4,0x3b9b19e2
100029.15,3.0,35,3,4,2,9,0xb2d6c0dd
522377.83,6.0,0,4,4,4,12,0x3b9af1b1
1571590.07,4.0,4,4,4,4,12,0x3b9b3b09
389488.83,9.0,7,4,4,3,11,0xb2d6488b
562150.03,3.0,259,4,4,1,9,0xb2d07d30
573435.93,6.0,3,4,4,4,12,0xb2d61e83d
1074.54,1.0,20,1,2,2,5,0xb2d26fd3
106.77,1.0,9,1,2,3,6,0xb2d2f13dd
409066.3,2.0,4,4,3,4,11,0xb2d8f440
230010.33,4.0,13,3,4,3,10,0xb2d55ccf
37405.95,1.0,0,2,2,4,8,0xb2d63b66
2.32,1.0,6,1,2,3,6,0xb2d958db
17000.0,1.0,0,2,2,4,8,0xb2d37562
6457.43,1.0,9,2,2,3,7,0xb2d38d09
46031.95,2.0,53,2,3,2,7,0xb2d9b602
0.92,6.0,7,1,4,3,8,0x3b9b102e
5265.74,1.0,0,2,2,4,8,0xb2d32718
1144.52,1.0,184,1,2,1,4,0xb2d09de4
2375.86,1.0,4,1,2,4,7,0xb2d9090f
136000.0,3.0,4,3,4,4,11,0xb2d1beb6
10758.72,1.0,75,2,2,1,5,0xb2d336dc
195125.72,5.0,42,3,4,2,9,0xb2d29229
413.81,1.0,3,1,2,4,7,0xb2d222ddd
3191.76,1.0,12,2,2,3,7,0xb2d4f8de
106489.88,2.0,167,3,3,1,7,0xb2d2c1c0
45799.14,4.0,11,2,4,3,9,0xb2d3431b
1027.77,1.0,92,1,2,1,4,0xb2d40607
388.2,1.0,9,1,2,3,6,0xb2d2a967
18107.46,1.0,0,2,2,4,8,0xb2d34040
202843.07,2.0,133,3,3,1,7,0xb2d926b2
28.64,2.0,73,1,3,1,5,0xb2d2bb06
250007.85,3.0,63,3,4,2,9,0xb2d28af9
321.0,3.0,5,1,4,3,8,0x3b9af1e3
3050.06,1.0,0,2,2,4,8,0xb2d2d7b4
4005.74,1.0,146,2,2,1,5,0xb2d90a06
565000.01,7.0,71,4,4,1,9,0xb2d0d6ae
26.99,1.0,0,1,2,4,7,0xb2d69b72
2459510.31,1.0,3,4,2,4,10,0xb2d2d9c0
114.57,2.0,131,1,3,1,5,0x3b9b2dc9
150097.73,2.0,116,3,3,1,7,0xb2d3bc5c
6339.43,1.0,117,2,2,1,5,0xb2d6c4ae
423.92,1.0,12,1,2,3,6,0xb2d5d52d
330425.16,3.0,80,4,4,1,9,0xb2d3cfb6
308205.02,3.0,30,4,4,2,10,0xb2d39dd5
213089.01,5.0,6,3,4,3,10,0xb2d193b6
6908.36,1.0,124,2,2,1,5,0xb2d21f01
11118.16,5.0,8,2,4,3,9,0xb2d11aaa
1710.11,1.0,92,1,2,1,4,0xb2d41d2a
549358.85,7.0,18,4,4,2,10,0x3b9b419c
272816.14,1.0,4,3,2,4,9,0xb2d4a9db
340015.42,2.0,20,4,3,2,9,0xb2d98125
54977.82,2.0,17,3,3,2,8,0xb2d55013
1969.45,1.0,107,1,2,1,4,0xb2d2d9db
200075.98,2.0,139,3,3,1,7,0xb2d4523a
128952.18,4.0,19,3,4,2,9,0xb2d21fb0
10057.43,1.0,2,2,2,4,8,0xb2d95145
6505.35,1.0,20,2,2,2,6,0xb2d99e26
359003.82,9.0,27,4,4,2,10,0xb2d6819e
585.53,1.0,75,1,2,1,4,0xb2d695b5
432304.65,3.0,50,4,4,2,10,0xb2d6dd88
669.74,6.0,0,1,4,4,9,0x3b9b1829
200030.26,3.0,25,3,4,2,9,0xb2d5f3fc
140002.96,3.0,11,3,4,3,10,0xb2da1166
945.09,1.0,10,1,2,3,6,0xb2d93900
19435.48,1.0,1,2,2,4,8,0xb2d2b3f2
250592.06,2.0,0,3,3,4,10,0xb2d573c4
6586.64,2.0,0,2,3,4,9,0xb2d1a3c8
1503.73,1.0,0,1,2,4,7,0xb2d4cb77
24579.95,1.0,139,2,2,1,5,0xb2d1dc44
1.45,1.0,23,1,2,2,5,0xb2d93fa3
47453.06,1.0,184,2,2,1,5,0x3b9b2b00
530017.8,3.0,19,4,4,2,10,0xb2d696c2d
275240.45,1.0,172,3,2,1,6,0xb2d11f7e
19690.59,1.0,66,2,2,2,6,0xb2d40659d
10000.21,2.0,18,2,3,2,7,0xb2d63dc4
552998.88,5.0,2,4,4,4,12,0xb2d16becd
21128.34,1.0,92,2,2,1,5,0xb2d2361d
31.19,1.0,11,1,2,3,6,0xb2d8e013
1252696.34,4.0,74,4,4,1,9,0xb2d5b377
3612.1,1.0,92,2,2,1,5,0xb2d261be
1114071.93,9.0,11,4,4,3,11,0xb2d1ea14d
40329.5,1.0,1,2,2,4,8,0xb2d6cc41
3742.01,1.0,5,2,2,3,7,0xb2d960c0
20000.42,2.0,18,2,3,2,7,0xb2da2bee
310000.0,2.0,8,4,3,3,10,0xb2da3363
307562.01,5.0,101,4,4,1,9,0xb2d559b7
220000.0,2.0,12,3,3,3,9,0xb2d95ff5
100046.46,2.0,171,3,3,1,7,0xb2d5f920d
8662.1,1.0,125,2,2,1,5,0xb2d435aa
3801.93,1.0,10,2,2,3,7,0xb2d4bcca
137090.44,1.0,1,3,2,4,9,0xb2d0e381
41399.26,1.0,0,2,2,4,8,0xb2d99439
351100.82,3.0,54,4,4,2,10,0xb2d578f5
2664.07,1.0,0,1,2,4,7,0xb2d6c165
5682164.03,12.0,3,4,4,4,12,0xb2d25552
2510.87,1.0,10,1,2,3,6,0xb2d3ef51
5000052.78,2.0,20,4,3,2,9,0xb2d9519f
468.98,1.0,92,1,2,1,4,0xb2d42333
153.34,1.0,5,1,2,3,6,0xb2d2f57e
225112.34,2.0,9,3,3,3,9,0xb2d11c6e
254062.65,5.0,31,3,4,2,9,0xb2d258f4
97022.64,6.0,1,3,4,4,11,0xb2d9244b
302665.27,2.0,64,4,3,2,9,0xb2d675d2
921645.3,5.0,0,4,4,4,12,0xb2d12189
1919.14,1.0,146,1,2,1,4,0xb2d6274b
2806424.74,15.0,5,4,4,3,11,0xb2d3c378
627151.27,11.0,0,4,4,4,12,0xb2d3cc39
100001.06,2.0,90,3,3,1,7,0xb2d8c3ec
400187.8,4.0,0,4,4,4,12,0xb2d3a5a6
462.86,1.0,9,1,2,3,6,0xb2d78662
75555.68,20.0,2,3,4,4,11,0x3b9b36b3
7900.26,1.0,1,2,2,4,8,0xb2d1c568
5147.9,1.0,0,2,2,4,8,0xb2d6b59d
135270.17,7.0,0,3,4,4,11,0xb2d1851d
72586.8,2.0,1,3,3,4,10,0xb2d14594
840.35,1.0,39,1,2,2,5,0xb2d21c63
102539.79,2.0,0,3,3,4,10,0xb2d56362
253854.89,2.0,0,3,3,4,10,0xb2d97b54
5657.07,1.0,4,2,2,4,8,0xb2d5ec32
1102.5,1.0,0,1,2,4,7,0xb2d3ba26
8003.12,1.0,5,2,2,3,7,0xb2d5f6e7
250000.0,3.0,0,3,4,4,11,0xb2d9812cd
226342.88,2.0,124,3,3,1,7,0xb2d42a75
200063.26,2.0,11,3,3,3,9,0xb2d591a1
45787.74,4.0,0,2,4,4,10,0xb2d906a8
62001.96,3.0,60,3,4,2,9,0xb2d15b7f
10121.32,2.0,41,2,3,2,7,0xb2d6e280
310452.89,2.0,22,4,3,2,9,0xb2d3afdd
550000.0,2.0,0,4,3,4,11,0xb2d8fdab
103043.24,2.0,46,3,3,2,8,0xb2d3b501
770039.98,4.0,139,4,4,1,9,0xb2d289eb
2123.09,1.0,5,1,2,3,6,0xb2d62d9c
164422.65,4.0,77,3,4,1,8,0xb2d52dad
43573.88,1.0,5,2,2,3,7,0xb2d24280
2208846.76,1.0,92,4,2,1,7,0x3b9b2c52
566400.93,4.0,30,4,4,2,10,0xb2d23792
254403.3,2.0,259,3,3,1,7,0xb2d51ba1
83088.87,2.0,132,3,3,1,7,0xb2d54f6fd
2027.99,1.0,2,1,2,4,7,0xb2d21710
100014.04,3.0,25,3,4,2,9,0xb2d65cd4
1180000.0,16.0,0,4,4,4,12,0xb2d5aa0d
4143.14,1.0,26,2,2,2,6,0xb2d92331
11.53,1.0,60,1,2,2,5,0xb2d23745
0.07,1.0,6,1,2,3,6,0xb2d299da
150007.11,8.0,39,3,4,2,9,0xb2d62fc5
1122.96,1.0,9,1,2,3,6,0xb2d20f8d
2101.78,1.0,92,1,2,1,4,0xb2d1627a
144724.51,6.0,0,3,4,4,11,0xb2d56d12d
5021.31,1.0,184,2,2,1,5,0xb2d55cf4
527.83,1.0,9,1,2,3,6,0xb2d53685
3113.39,1.0,184,2,2,1,5,0xb2d0ae98
2223467.41,3.0,22,4,4,2,10,0xb2d6bcc0
500035.07,7.0,11,4,4,3,11,0xb2d1771e
1491.49,1.0,92,1,2,1,4,0x3b9b3840d
4056.89,1.0,14,2,2,3,7,0xb2d2e58e
8773.36,1.0,1,2,2,4,8,0xb2d68fe8
1589.32,1.0,6,1,2,3,6,0xb2d95d68
571.44,1.0,60,1,2,2,5,0xb2d0bf99
8719.59,1.0,32,2,2,2,6,0xb2d4c847
81483.21,1.0,55,3,2,2,7,0xb2d1f294
503552.9,2.0,78,4,3,1,8,0xb2d5d23e
2957.18,1.0,3,2,2,4,8,0xb2d4971e
13.51,1.0,53,1,2,2,5,0xb2d9497d
10568.07,1.0,0,2,2,4,8,0xb2d6bf87
1998.29,1.0,92,1,2,1,4,0xb2d0ae09
550004.45,4.0,55,4,4,2,10,0xb2d1417e
10858.64,1.0,1,2,2,4,8,0xb2d69c26
1338.21,1.0,10,1,2,3,6,0xb2da25b8
780005.9,5.0,12,4,4,3,11,0xb2d4cc96
1450487.29,3.0,139,4,4,1,9,0xb2d24c91d
44593.7,1.0,5,2,2,3,7,0xb2d5f9bc
395.72,1.0,0,1,2,4,7,0xb2d40553
1003.86,1.0,4,1,2,4,7,0xb2d21b52
150349.11,2.0,11,3,3,3,9,0xb2d1a471
14790222.25,133.0,0,4,4,4,12,0xb2d350d9
2401314.99,10.0,13,4,4,3,11,0xb2d7c64b
1329.77,1.0,11,1,2,3,6,0xb2d3b122
53005.66,2.0,52,3,3,2,8,0xb2d3ba0a
38000.3,3.0,116,2,4,1,7,0xb2d3cf2f
405679.18,2.0,0,4,3,4,11,0xb2d8c88dd
62437.26,2.0,60,3,3,2,8,0xb2d25391
101043.26,4.0,10,3,4,3,10,0xb2d28faf
3271.8,1.0,7,2,2,3,7,0xb2d6456e
1.35,1.0,36,1,2,2,5,0xb2d49063
54637.66,1.0,0,3,2,4,9,0xb2d41d1d
130082.44,2.0,108,3,3,1,7,0xb2d4ee0b
1121.11,1.0,92,1,2,1,4,0xb2d1f4d8
35352.37,1.0,184,2,2,1,5,0xb2d392c4
61578.15,1.0,123,3,2,1,6,0xb2d59298
115878.35,2.0,2,3,3,4,10,0xb2d0b4cc
52763.9,1.0,133,3,2,1,6,0xb2d2a771
311163.67,10.0,14,4,4,3,11,0xb2d172e7
35146.81,1.0,168,2,2,1,5,0xb2d37652
194851.23,4.0,0,3,4,4,11,0xb2d47d45
228444.15,3.0,0,3,4,4,11,0xb2d994e4
22010.6,1.0,7,2,2,3,7,0xb2d3169a
51860.68,2.0,32,2,3,2,7,0xb2d42a0a
49596.37,1.0,1,2,2,4,8,0xb2d2fb25
16592.56,1.0,2,2,2,4,8,0xb2d571cd
1053010.45,6.0,27,4,4,2,10,0xb2d963b8
54497.19,1.0,0,3,2,4,9,0xb2d2dfb2
548000.0,5.0,10,4,4,3,11,0xb2d8fdfc
110409.25,4.0,1,3,4,4,11,0xb2d0dbc2
210496.61,5.0,4,3,4,4,11,0xb2d58cdf
208111.91,4.0,224,3,4,1,8,0xb2d11d31
1387.61,1.0,75,1,2,1,4,0xb2d10b16
10101.73,2.0,193,2,3,1,6,0xb2d7ec83
50014.81,2.0,259,2,3,1,6,0xb2d5fb1c
20000.42,2.0,8,2,3,3,8,0xb2da464d
50806.43,2.0,20,2,3,2,7,0xb2d92133
3820.66,1.0,3,2,2,4,8,0xb2d50aca
373.44,1.0,43,1,2,2,5,0xb2d22471
150006.49,12.0,83,3,4,1,8,0xb2d1a2c0
22070.12,1.0,24,2,2,2,6,0xb2d96475
30435.95,1.0,5,2,2,3,7,0xb2d6302c
13.55,1.0,0,1,2,4,7,0xb2d4fdd0
11.36,1.0,0,1,2,4,7,0xb2d2c53e
36705.19,1.0,112,2,2,1,5,0xb2d12c8ad
84004.42,2.0,92,3,3,1,7,0xb2d1bdf1d
85.08,1.0,0,1,2,4,7,0xb2d2a33b
4616.11,1.0,3,2,2,4,8,0xb2d907c2
250021.13,4.0,20,3,4,2,9,0xb2d4c45d
50098.45,2.0,172,2,3,1,6,0xb2d5d7b8
4014.64,1.0,5,2,2,3,7,0xb2d10910
642781.34,10.0,1,4,4,4,12,0xb2d6f31c
206102.89,5.0,80,3,4,1,8,0xb2d34a8a
6142.26,1.0,6,2,2,3,7,0xb2d0ff1e
3818.86,1.0,154,2,2,1,5,0xb2d3b3e1d
600086.63,5.0,8,4,4,3,11,0xb2d21292
6.52,1.0,44,1,2,2,5,0xb2d6af88
303106.96,3.0,24,4,4,2,10,0xb2d253e6
22722.71,1.0,26,2,2,2,6,0xb2d60596
12320.98,1.0,0,2,2,4,8,0xb2d23896
816006.37,4.0,124,4,4,1,9,0xb2d6f612
90001.8,3.0,213,3,4,1,8,0xb2d6222dd
238027.42,2.0,76,3,3,1,7,0xb2d92132
100004.68,2.0,27,3,3,2,8,0xb2d85bca
118013.62,3.0,69,3,4,1,8,0xb2d148c8
360000.0,2.0,6,4,3,3,10,0xb2d97352
274352.02,2.0,168,3,3,1,7,0xb2d13fc5
147.78,1.0,60,1,2,2,5,0xb2d9bff0
9938.75,1.0,20,2,2,2,6,0xb2d95482
150085.61,2.0,116,3,3,1,7,0xb2d69d4a
1869.06,1.0,10,1,2,3,6,0xb2d27e31
6731.45,1.0,0,2,2,4,8,0xb2d7c54a
60002.53,2.0,154,3,3,1,7,0xb2d8f533
100645.49,2.0,129,3,3,1,7,0xb2d3a3ab
44437.83,1.0,75,2,2,1,5,0xb2d6256b
108001.74,2.0,9,3,3,3,9,0xb2d8fd9e
16911530.29,65.0,0,4,4,4,12,0xb2d2d08f
1010.96,1.0,223,1,2,1,4,0xb2d315c1
1177.75,1.0,0,1,2,4,7,0xb2d3a9a7
542.33,1.0,19,1,2,2,5,0xb2d2dff2
3742.33,1.0,5,2,2,3,7,0xb2d62b28
50493.76,2.0,221,2,3,1,6,0xb2d63dc8
300102.17,2.0,4,4,3,4,11,0xb2d28820
401492.61,4.0,7,4,4,3,11,0x3b9b3186d
50361.54,1.0,92,2,2,1,5,0xb2d5eda9
100000.06,2.0,1,3,3,4,10,0xb2d0d261
4332.56,1.0,11,2,2,3,7,0xb2d92a25
300041.34,2.0,20,3,3,2,8,0xb2d62edd
301194.03,2.0,224,4,3,1,8,0xb2d3935d
37919.08,4.0,0,2,4,4,10,0x3b9b1086
277.68,1.0,11,1,2,3,6,0xb2d68a8a
1.58,1.0,60,1,2,2,5,0xb2d48916
50001.7,2.0,40,2,3,2,7,0xb2d8e1b5
1522.09,1.0,92,1,2,1,4,0xb2d13e47
5024.76,1.0,185,2,2,1,5,0xb2d4ea1b
202078.03,2.0,0,3,3,4,10,0xb2d0e72b
903384.29,8.0,3,4,4,4,12,0x3b9af17d
129679.51,7.0,80,3,4,1,8,0xb2d3fcaf
1209570.77,5.0,27,4,4,2,10,0xb2d200fc
5227.79,1.0,4,2,2,4,8,0xb2d95ec9
5877.4,1.0,70,2,2,1,5,0xb2d3146f
0.0,1.0,1,1,2,4,7,0xb2d65399
89345.46,2.0,3,3,3,4,10,0xb2d3ff91
52092.51,2.0,92,2,3,1,6,0xb2d47782
402138.52,4.0,52,4,4,2,10,0xb2d148ea
781.12,1.0,0,1,2,4,7,0xb2d0dfa9
2.36,1.0,74,1,2,1,4,0xb2d5b2bf
611040.41,2.0,125,4,3,1,8,0xb2d11e1bd
7426.77,1.0,92,2,2,1,5,0xb2d14e9c
58049.96,3.0,14,3,4,3,10,0xb2d1f062
50025.84,1.0,38,2,2,2,6,0xb2d92d84
10826.0,1.0,15,2,2,3,7,0xb2d6d72b
114.2,1.0,24,1,2,2,5,0xb2d2d73b
220838.0,2.0,0,3,3,4,10,0xb2d96a6f
340000.87,6.0,12,4,4,3,11,0xb2d6f16c
1080889.44,7.0,0,4,4,4,12,0xb2d54eb8
11356.49,1.0,11,2,2,3,7,0xb2d9026ad
2704.37,1.0,91,1,2,1,4,0xb2d40cf2
450000.0,2.0,3,4,3,4,11,0xb2d97ee8
61105.4,2.0,11,3,3,3,9,0xb2d1ddc0
1011.11,1.0,184,1,2,1,4,0xb2d626ac
614410.36,8.0,4,4,4,4,12,0xb2d08758d
350000.0,2.0,9,4,3,3,10,0xb2d61969
119187.87,1.0,0,3,2,4,9,0xb2d311a0
370028.5,10.0,5,4,4,3,11,0xb2d0f9b7
1252064.24,7.0,0,4,4,4,12,0xb2d5a0bf
1817.6,1.0,184,1,2,1,4,0xb2d0b8fc
450000.11,8.0,1,4,4,4,12,0xb2d47a2dd
39491.91,1.0,0,2,2,4,8,0xb2d1a431
257026.31,4.0,24,3,4,2,9,0xb2d11d7e
4026.11,1.0,1,2,2,4,8,0xb2d3a439
10.74,1.0,60,1,2,2,5,0xb2d3e1aa
49760.73,1.0,0,2,2,4,8,0xb2d825f4d
756499.93,6.0,0,4,4,4,12,0xb2d633bf
565953.9,3.0,228,4,4,1,9,0xb2d3f36e
244.58,1.0,19,1,2,2,5,0xb2d68dfad
0.0,2.0,4,1,3,4,8,0xb2d950d9
50010.04,2.0,18,2,3,2,7,0xb2d1146f
1142883.41,6.0,13,4,4,3,11,0xb2d4d318
10000.11,2.0,69,2,3,1,6,0xb2d8e9b2
150209.59,2.0,6,3,3,3,9,0xb2d9ce0c
824.29,1.0,8,1,2,3,6,0xb2d237e0
78.67,1.0,0,1,2,4,7,0xb2d20b82
397.9,1.0,208,1,2,1,4,0xb2d0ecdbd
15442.75,1.0,24,2,2,2,6,0xb2d5b9bb
1007104.95,2.0,61,4,3,2,9,0xb2d8fd14
327347.74,4.0,0,4,4,4,12,0xb2d11c78
300915.07,2.0,3,4,3,4,11,0xb2da4c01
5879.62,1.0,5,2,2,3,7,0xb2d607b1
711505.58,5.0,6,4,4,3,11,0xb2d586a8
12.24,1.0,28,1,2,2,5,0xb2d9f6f9
236873.56,5.0,1,3,4,4,11,0xb2d6d5fe
52017.63,2.0,24,2,3,2,7,0xb2d56ac4
310100.11,3.0,66,4,4,2,10,0xb2d6943f
2296.99,1.0,184,1,2,1,4,0xb2d11795
400000.0,3.0,29,4,4,2,10,0xb2d9e29c
662524.15,7.0,25,4,4,2,10,0xb2d0f0c2d
673.66,2.0,0,1,3,4,8,0x3b9af291
9133.54,1.0,1,2,2,4,8,0xb2d65000
89.14,1.0,5,1,2,3,6,0xb2d53e0f
100095.55,2.0,151,3,3,1,7,0xb2d10e0f
5311.88,1.0,78,2,2,1,5,0xb2d61e6c
316000.0,2.0,2,4,3,4,11,0xb2da08c3
600000.5,2.0,19,4,3,2,9,0xb2d8d74e
50058.6,1.0,121,2,2,1,5,0xb2d94063
656.87,1.0,33,1,2,2,5,0xb2d5613b
6023.48,1.0,29,2,2,2,6,0xb2d90302
97002.86,7.0,10,3,4,3,10,0xb2d5e4b3
100000.0,1.0,0,3,2,4,9,0xb2d98458
7.68,1.0,83,1,2,1,4,0xb2d6810d
101.7,1.0,78,1,2,1,4,0xb2d31467
200209.31,5.0,27,3,4,2,9,0xb2d6221e
614014.44,4.0,42,4,4,2,10,0xb2d26ec2
1250008.12,4.0,23,4,4,2,10,0xb2d85723
8767.32,1.0,8,2,2,3,7,0xb2d60a42
49826.46,2.0,1,2,3,4,9,0xb2d161b0
270011.92,2.0,4,3,3,4,10,0xb2d6c7ec
1001.17,1.0,121,1,2,1,4,0xb2d919cb
62201.89,2.0,154,3,3,1,7,0xb2d15cba
6405.07,1.0,7,2,2,3,7,0xb2d6c70e
121619.87,2.0,92,3,3,1,7,0xb2d23a78
6.68,2.0,84,1,3,1,5,0xb2d982cc
51235.57,3.0,216,2,4,1,7,0xb2d57518
2.79,1.0,10,1,2,3,6,0xb2d166b2
200711.18,2.0,25,3,3,2,8,0xb2d7894d
605.63,1.0,1,1,2,4,7,0xb2d1a7f7
213310.57,1.0,11,3,2,3,8,0xb2d137e2
300064.8,3.0,21,3,4,2,9,0xb2d60351
1272.71,1.0,92,1,2,1,4,0xb2d1046f
400.83,1.0,0,1,2,4,7,0xb2d8cd25
150056.89,3.0,4,3,4,4,11,0xb2d63bb7
30880.77,1.0,20,2,2,2,6,0xb2d2c135
290.2,1.0,1,1,2,4,7,0xb2d64ea6
150105.82,3.0,16,3,4,2,9,0xb2d981e3
51359.66,1.0,184,2,2,1,5,0xb2d3bf42
3131.85,1.0,10,2,2,3,7,0xb2d69756
1103.58,1.0,184,1,2,1,4,0xb2d203d1
107474.25,3.0,108,3,4,1,8,0xb2d38a2c
3.92,1.0,4,1,2,4,7,0xb2d78d04
146.11,1.0,5,1,2,3,6,0xb2d2dc84
230016.65,8.0,31,3,4,2,9,0xb2d59f03
626491.78,1.0,105,4,2,1,7,0xb2d594d6
4666.1,1.0,2,2,2,4,8,0xb2d3d2b8
166087.83,2.0,48,3,3,2,8,0xb2d2aa28
806093.66,3.0,6,4,4,3,11,0xb2d160c6
1109.64,1.0,184,1,2,1,4,0xb2d34a7d
107.2,1.0,8,1,2,3,6,0xb2d87458
410012.31,3.0,1,4,4,4,12,0xb2d9fa85
338988.25,4.0,5,4,4,3,11,0xb2d36ef1
872688.71,14.0,0,4,4,4,12,0xb2d14ab8
14.66,1.0,0,1,2,4,7,0xb2d59dcf
521726.75,3.0,60,4,4,2,10,0xb2d0c82f
429670.75,3.0,120,4,4,1,9,0xb2d780c3
250000.05,3.0,7,3,4,3,10,0xb2d85844
55.39,1.0,0,1,2,4,7,0x3b9b22ec
2016.16,1.0,1,1,2,4,7,0xb2d917c5d
123122.73,3.0,126,3,4,1,8,0xb2d390d4
6.23,1.0,0,1,2,4,7,0xb2d2314a
755535.94,8.0,3,4,4,4,12,0xb2d0bc42d
5958.65,1.0,38,2,2,2,6,0xb2d38cb2
702914.87,3.0,19,4,4,2,10,0xb2d60cf1
1220554.1,10.0,19,4,4,2,10,0xb2d59d05
297493.54,3.0,12,3,4,3,10,0xb2d64a60
0.0,1.0,0,1,2,4,7,0xb2d6efc7
80006.32,2.0,62,3,3,2,8,0xb2d5677e
100333.67,3.0,99,3,4,1,8,0xb2d3af30
98249.54,97.0,0,3,4,4,11,0x3b9b3f4f
121092.65,2.0,42,3,3,2,8,0xb2d8feda
114.01,1.0,7,1,2,3,6,0xb2d78cd7
124295.34,1.0,7,3,2,3,8,0xb2d62983
377004.98,4.0,47,4,4,2,10,0xb2d5b3a4
3522.4,1.0,184,2,2,1,5,0xb2d192b4
6470.59,1.0,111,2,2,1,5,0xb2d4646b
7970.13,1.0,22,2,2,2,6,0xb2d3f9ef
200005.28,3.0,0,3,4,4,11,0xb2d3774b
1484.09,1.0,184,1,2,1,4,0xb2d23160d
10233.91,1.0,63,2,2,2,6,0xb2d5d804
14.93,1.0,12,1,2,3,6,0xb2d90d01
112021.56,3.0,144,3,4,1,8,0xb2d4544d
2.13,1.0,41,1,2,2,5,0xb2d58caa
224366.92,3.0,41,3,4,2,9,0xb2d28a84
1500031.67,2.0,18,4,3,2,9,0xb2da2019
62809.9,2.0,90,3,3,1,7,0xb2d4351e
101.21,1.0,13,1,2,3,6,0xb2d29b1b
40.23,1.0,23,1,2,2,5,0xb2d8d5ac
700022.64,2.0,63,4,3,2,9,0xb2d1856e
1178566.47,4.0,217,4,4,1,9,0xb2d44693
1121.9,1.0,92,1,2,1,4,0xb2d3689a
217212.51,2.0,108,3,3,1,7,0xb2d68b33
101494.46,4.0,92,3,4,1,8,0xb2d624ec
100804.56,2.0,67,3,3,1,7,0xb2d5b72e
1359.07,1.0,0,1,2,4,7,0xb2d40881
955939.35,9.0,4,4,4,4,12,0xb2d32704
694.54,1.0,9,1,2,3,6,0xb2d3040b
3505.43,1.0,151,2,2,1,5,0xb2d6539a
2931608.29,6.0,4,4,4,4,12,0xb2d6f508
18568.16,3.0,0,2,4,4,10,0x3b9af0c1
50774.16,2.0,136,2,3,1,6,0xb2d54190
60013.13,3.0,55,3,4,2,9,0xb2d55c69
504982.22,3.0,0,4,4,4,12,0xb2d45d1d
650017.43,6.0,56,4,4,2,10,0xb2d97021
84987.86,2.0,110,3,3,1,7,0xb2d161ca
402009.45,4.0,5,4,4,3,11,0xb2d210c2
10442.64,1.0,0,2,2,4,8,0xb2d3ed2f
10056.36,1.0,8,2,2,3,7,0xb2d2a377
19998.03,1.0,184,2,2,1,5,0xb2d30ba0
48501.08,1.0,10,2,2,3,7,0xb2d5e186
10000.72,2.0,147,2,3,1,6,0xb2d5e597
100007.81,3.0,1,3,4,4,11,0xb2d574d0
96718.4,1.0,5,3,2,3,8,0xb2d9f3cc
268063.48,8.0,0,3,4,4,11,0xb2d8dc23
226003.06,5.0,87,3,4,1,8,0xb2d24501
896.3,1.0,9,1,2,3,6,0xb2d551e7
502987.17,2.0,39,4,3,2,9,0xb2d40cf9
350761.18,4.0,30,4,4,2,10,0xb2d0c9fd
632680.98,5.0,11,4,4,3,11,0xb2d95d7a
604.5,2.0,0,1,3,4,8,0x3b9b27f4
55030.78,2.0,256,3,3,1,7,0xb2d25c1d
501464.03,2.0,7,4,3,3,10,0xb2d68c4c
10.5,1.0,40,1,2,2,5,0xb2d5d29c
1000000.0,2.0,18,4,3,2,9,0xb2d95b29
695.91,1.0,32,1,2,2,5,0xb2d92517
764697.42,2.0,83,4,3,1,8,0xb2d2151b
2018.42,1.0,92,1,2,1,4,0xb2d3943c
250002.11,3.0,28,3,4,2,9,0xb2d90260
329878.21,3.0,0,4,4,4,12,0xb2d3c405
1645.34,1.0,8,1,2,3,6,0xb2d2a046
10000.32,2.0,39,2,3,2,7,0xb2d9ec5c
5001.94,1.0,6,2,2,3,7,0xb2d754c3
119024.39,2.0,11,3,3,3,9,0xb2d5dbe3
50.57,1.0,3,1,2,4,7,0xb2d781c3
1917.54,1.0,92,1,2,1,4,0xb2d1dd25
230037.48,3.0,28,3,4,2,9,0xb2d170d1
139498.55,7.0,0,3,4,4,11,0xb2d61b4c
20433.86,1.0,5,2,2,3,7,0xb2d23f04
100002.32,3.0,18,3,4,2,9,0xb2d982fd
7535.99,1.0,26,2,2,2,6,0xb2d645b7
986.59,5.0,0,1,4,4,9,0x3b9af182
5578.64,1.0,7,2,2,3,7,0xb2d2c3b2
5046.44,2.0,92,2,3,1,6,0xb2d298df
200073.05,3.0,26,3,4,2,9,0xb2d6e19e
26868.13,2.0,0,2,3,4,9,0x3b9af1a0
100164.44,3.0,6,3,4,3,10,0xb2d950d8
45941.17,1.0,10,2,2,3,7,0xb2d3569e
3565529.57,6.0,4,4,4,4,12,0xb2d53c61
402811.97,6.0,6,4,4,3,11,0xb2d333a3
565941.0,5.0,0,4,4,4,12,0xb2d3cc9f
280898.72,4.0,0,3,4,4,11,0x3b9ae61cd
7573.61,1.0,80,2,2,1,5,0xb2d68551
43262.65,6.0,18,2,4,2,8,0xb2d1c248
151.0,1.0,26,1,2,2,5,0xb2d37c75
717.84,1.0,6,1,2,3,6,0xb2d68eea
26320.99,1.0,2,2,2,4,8,0xb2d7087d
602597.35,7.0,53,4,4,2,10,0xb2d07764
800076.0,1.0,18,4,2,2,8,0xb2d9569f
230076.27,4.0,2,3,4,4,11,0xb2d69c5a
819115.35,3.0,37,4,4,2,10,0xb2d11b3d
200004.53,2.0,4,3,3,4,10,0x3b9b4069
235194.29,3.0,52,3,4,2,9,0xb2d1e676
0.69,1.0,68,1,2,1,4,0xb2d7a7db
45.35,1.0,34,1,2,2,5,0xb2d6fe5c
60740.53,2.0,4,3,3,4,10,0xb2d6d90f
21049.75,1.0,23,2,2,2,6,0xb2d69a3c
340300.6,12.0,10,4,4,3,11,0xb2d2368b
250000.0,2.0,0,3,3,4,10,0xb2d94090
17502.07,1.0,14,2,2,3,7,0xb2d92d0f
270013.57,4.0,82,3,4,1,8,0xb2d1d72f
865015.0,6.0,39,4,4,2,10,0xb2d51bb9
240143.69,3.0,95,3,4,1,8,0xb2d1092ad
65058.21,2.0,108,3,3,1,7,0xb2d10d42
9013.62,1.0,6,2,2,3,7,0xb2d2dda9
363364.77,1.0,21,4,2,2,8,0xb2d1d24a
5005.96,1.0,123,2,2,1,5,0xb2d926cbd
320046.71,2.0,13,4,3,3,10,0xb2d6f8bf
87007.38,3.0,117,3,4,1,8,0xb2d5edae
111416.88,1.0,21,3,2,2,7,0xb2d41036
20000.84,2.0,41,2,3,2,7,0xb2d20e85
31126.03,1.0,4,2,2,4,8,0xb2d5daad
3900.3,1.0,2,2,2,4,8,0xb2d6bf09
203324.0,4.0,5,3,4,3,10,0xb2d9f916
1.71,1.0,13,1,2,3,6,0xb2d17cb1
160000.9,3.0,1,3,4,4,11,0xb2d0c143
1199393.34,3.0,88,4,4,1,9,0xb2d0e9cbd
100071.51,2.0,20,3,3,2,8,0xb2d59142
200004.43,2.0,10,3,3,3,9,0xb2d67a81
54210.62,2.0,0,3,3,4,10,0xb2d1c6fc
1669.9,1.0,132,1,2,1,4,0xb2d3465f
55015.33,1.0,9,3,2,3,8,0xb2d6e7dc
12051.59,1.0,10,2,2,3,7,0xb2d8cb70
5161.75,1.0,4,2,2,4,8,0xb2d31065
520308.64,3.0,122,4,4,1,9,0x3b9b0eda
105.25,2.0,21,1,3,2,6,0xb2d67f08
500000.0,2.0,25,4,3,2,9,0xb2d9478b
1000042.38,4.0,39,4,4,2,10,0xb2d65d5e
0.29,1.0,9,1,2,3,6,0xb2d908ca
56234.71,2.0,59,3,3,2,8,0xb2d08ba4
9.5,1.0,6,1,2,3,6,0xb2d8fd13
272.28,1.0,1,1,2,4,7,0xb2d24639
43261.84,1.0,184,2,2,1,5,0xb2d30864
789066.77,6.0,5,4,4,3,11,0xb2d2638b
155293.66,1.0,0,3,2,4,9,0xb2d992d7
34.39,1.0,6,1,2,3,6,0xb2d2e739
55672.51,2.0,0,3,3,4,10,0xb2d184cc
40043.5,2.0,52,2,3,2,7,0xb2d6adcd
15207991.49,10.0,4,4,4,4,12,0x3b9add51
1950.27,1.0,10,1,2,3,6,0xb2d4bc48
14.64,2.0,131,1,3,1,5,0xb2d17321
1011.3,1.0,97,1,2,1,4,0xb2d5a043
1891.28,1.0,11,1,2,3,6,0xb2d20fe5
120662.0,2.0,12,3,3,3,9,0x3b9b4648
1001592.8,4.0,25,4,4,2,10,0xb2d67e18d
39601.51,1.0,92,2,2,1,5,0xb2d34c09d
929000.09,8.0,0,4,4,4,12,0xb2d520f7
335013.09,6.0,108,4,4,1,9,0xb2d1e28b
54.59,1.0,82,1,2,1,4,0xb2d5ac20
11203.58,3.0,73,2,4,1,7,0xb2d4eb27
311006.13,16.0,0,4,4,4,12,0xb2d10d3f
406379.78,5.0,34,4,4,2,10,0xb2d64eae
1104.68,1.0,10,1,2,3,6,0xb2d6a38f
3090.03,1.0,1,2,2,4,8,0xb2d964cd
1102.72,8.0,184,1,4,1,6,0xb2d30a35
505.5,2.0,92,1,3,1,5,0xb2d3cd18
1395.19,1.0,92,1,2,1,4,0xb2d574cc
1065.82,1.0,0,1,2,4,7,0xb2d2a5a0
959.51,1.0,2,1,2,4,7,0xb2d66689
1374340.42,7.0,1,4,4,4,12,0xb2d12663d
1448.64,1.0,5,1,2,3,6,0xb2d3859a
76013.38,5.0,18,3,4,2,9,0xb2d60cf9
323427.91,1.0,0,4,2,4,10,0xb2d30e93
130051.95,6.0,0,3,4,4,11,0xb2d5494e
50008.15,2.0,92,2,3,1,6,0xb2d21651
255429.29,1.0,117,3,2,1,6,0xb2d42082
36824.99,2.0,250,2,3,1,6,0x3b9b3b23
720.12,1.0,84,1,2,1,4,0xb2d5d478
1075.63,1.0,210,1,2,1,4,0xb2d2301c
37549.61,1.0,21,2,2,2,6,0xb2d69530
64.87,1.0,49,1,2,2,5,0xb2d45b97
400004.37,3.0,8,4,4,3,11,0xb2d98583
52011.43,2.0,90,2,3,1,6,0xb2d55593
580000.75,6.0,3,4,4,4,12,0xb2d0972e
15451.93,1.0,3,2,2,4,8,0xb2d99e5a
6218.92,1.0,4,2,2,4,8,0xb2d6b08c
2946.33,1.0,60,2,2,2,6,0xb2d3b339
100.68,3.0,63,1,4,2,7,0xb2d48438
7028.32,1.0,184,2,2,1,5,0xb2d60282
2808.81,1.0,92,1,2,1,4,0xb2d21ff8
14760.02,1.0,81,2,2,1,5,0xb2d43d8a
150294.87,2.0,11,3,3,3,9,0xb2d6eae1
53276.6,4.0,3,3,4,4,11,0xb2d65319
252131.82,3.0,6,3,4,3,10,0xb2d98116
199357.32,2.0,136,3,3,1,7,0xb2d23240
1613.22,1.0,9,1,2,3,6,0xb2d2bfcb
35.79,1.0,26,1,2,2,5,0xb2d53664
550001.81,3.0,4,4,4,4,12,0xb2d62859
109063.09,3.0,10,3,4,3,10,0x3b9b2c75
108059.55,2.0,20,3,3,2,8,0xb2d21e45d
3744.61,2.0,92,2,3,1,6,0xb2d22a84d
530368.45,11.0,0,4,4,4,12,0xb2d6a0b3
5640.86,2.0,0,2,3,4,9,0x3b9b3ddc
194043.06,5.0,0,3,4,4,11,0xb2d1eaec
308741.15,3.0,95,4,4,1,9,0xb2d5fcaf
540021.35,5.0,97,4,4,1,9,0xb2d074a4
507107.23,2.0,126,4,3,1,8,0xb2d935b9
131.61,1.0,21,1,2,2,5,0xb2d5af77
202147.33,2.0,104,3,3,1,7,0xb2d5e83b
90000.95,2.0,31,3,3,2,8,0xb2d93cbc
474.4,1.0,82,1,2,1,4,0xb2d5be4b
2654.92,1.0,3,1,2,4,7,0xb2d62bae
252743.55,3.0,4,3,4,4,11,0xb2d8d6af
54366.22,2.0,53,3,3,2,8,0xb2d3e48b
402020.65,4.0,0,4,4,4,12,0xb2d6dec1
635.97,2.0,124,1,3,1,5,0xb2d289d5
2.64,1.0,28,1,2,2,5,0xb2d6aa49
2388.05,1.0,0,1,2,4,7,0xb2d6d7bc
29020.79,1.0,10,2,2,3,7,0xb2d68ea5
140512.93,1.0,7,3,2,3,8,0xb2d1ee3f
501774.22,3.0,1,4,4,4,12,0xb2d91228
100117.02,2.0,76,3,3,1,7,0xb2d3c081
500000.0,2.0,12,4,3,3,10,0xb2d96316
282486.76,5.0,87,3,4,1,8,0xb2d39abe
700198.05,2.0,67,4,3,1,8,0xb2d4042dd
491575.93,4.0,13,4,4,3,11,0xb2d65370
204989.98,2.0,30,3,3,2,8,0xb2d68877
200000.0,2.0,1,3,3,4,10,0xb2d97ebd
100021.19,2.0,132,3,3,1,7,0xb2d550f5
300072.05,2.0,20,3,3,2,8,0xb2d923b1
2825.51,1.0,145,1,2,1,4,0xb2d48c6c
102211.55,3.0,27,3,4,2,9,0xb2d087ca
95.72,1.0,68,1,2,1,4,0xb2d3410f
50057.12,2.0,11,2,3,3,8,0xb2d25b1a
85.08,1.0,34,1,2,2,5,0xb2d9781c
0.0,1.0,7,1,2,3,6,0xb2d21f4d
97.43,1.0,166,1,2,1,4,0xb2d8dd26
184743.04,3.0,132,3,4,1,8,0xb2d23c5b
7507.78,1.0,162,2,2,1,5,0xb2d352ded
6614.95,1.0,197,2,2,1,5,0xb2d57f77
207153.78,1.0,17,3,2,2,7,0xb2d29864
2954.66,1.0,0,2,2,4,8,0xb2d6b537
1451.04,1.0,1,1,2,4,7,0xb2d1f31f
170891.13,3.0,206,3,4,1,8,0xb2d11596
1809181.04,19.0,0,4,4,4,12,0xb2d224c0
910035.22,2.0,16,4,3,2,9,0xb2d63575
650477.46,3.0,0,4,4,4,12,0xb2d26a15
16736.79,1.0,141,2,2,1,5,0xb2d390ab
2181.11,1.0,196,1,2,1,4,0xb2d40c70
175346.66,4.0,62,3,4,2,9,0xb2d41008
5088.3,1.0,2,2,2,4,8,0xb2da07ef
7034.73,1.0,184,2,2,1,5,0xb2d23cadd
572739.72,6.0,34,4,4,2,10,0xb2d62cd7d
150094.75,3.0,69,3,4,1,8,0xb2d5c7ba
643305.71,2.0,110,4,3,1,8,0xb2d12b21
456.44,1.0,8,1,2,3,6,0xb2d8f739
4303.23,1.0,260,2,2,1,5,0xb2d27eae
66.68,1.0,0,1,2,4,7,0xb2d5ef71
1301.37,1.0,25,1,2,2,5,0xb2d41cc6
95005.89,2.0,58,3,3,2,8,0xb2d596b8
766.58,1.0,5,1,2,3,6,0xb2d32b2c
39.92,1.0,35,1,2,2,5,0xb2d6b400
1337.54,1.0,92,1,2,1,4,0xb2d3bcad
60190.45,3.0,0,3,4,4,11,0x3b9af2b6d
2323895.19,10.0,4,4,4,4,12,0xb2d200e4
1172001.1,5.0,6,4,4,3,11,0xb2d2954f
236321.86,2.0,41,3,3,2,8,0xb2d55868
10000.11,2.0,41,2,3,2,7,0xb2d923c3
300003.8,3.0,3,3,4,4,11,0xb2d954ae
4870.65,1.0,0,2,2,4,8,0xb2d6aa3e
1158.08,1.0,29,1,2,2,5,0xb2d53782
747.19,1.0,11,1,2,3,6,0xb2d1e628
930000.64,5.0,11,4,4,3,11,0xb2d923e8d
11449.01,2.0,10,2,3,3,8,0xb2d68cbe
1667.13,1.0,184,1,2,1,4,0xb2d2350e
517102.09,3.0,24,4,4,2,10,0xb2d423a8
110502.1,1.0,1,3,2,4,9,0xb2d34a3f
150018.42,4.0,0,3,4,4,11,0xb2d60777
148950.77,2.0,9,3,3,3,9,0x3b9b1b58
373689.11,1.0,0,4,2,4,10,0xb2d4d339
3517.84,1.0,5,2,2,3,7,0xb2d6e963
753004.89,7.0,18,4,4,2,10,0xb2d1556ed
200040.1,2.0,7,3,3,3,9,0xb2d96f37
1.85,2.0,14,1,3,3,7,0xb2d6c179
180027.0,5.0,7,3,4,3,10,0xb2d4ce5b
923557.66,4.0,3,4,4,4,12,0xb2d2aadc
107740.32,1.0,92,3,2,1,6,0xb2d1e303
532243.39,5.0,53,4,4,2,10,0xb2d25f7b
16199.24,1.0,10,2,2,3,7,0xb2d2b7ba
6594.12,2.0,0,2,3,4,9,0xb2d2dfb7
440146.14,8.0,18,4,4,2,10,0xb2d8cd7a
6599.7,1.0,0,2,2,4,8,0xb2d5ee2f
20.94,1.0,77,1,2,1,4,0xb2d63589
500062.66,3.0,0,4,4,4,12,0xb2d78340
30042.13,3.0,0,2,4,4,10,0xb2d48c24
201459.25,2.0,47,3,3,2,8,0xb2d2a1a0
858000.0,5.0,2,4,4,4,12,0xb2d24312
251007.17,5.0,67,3,4,1,8,0xb2d08306
3921.93,1.0,92,2,2,1,5,0x3b9adc71
11.97,1.0,4,1,2,4,7,0xb2d29418
45.81,1.0,0,1,2,4,7,0xb2d8e48f
1061889.26,3.0,49,4,4,2,10,0xb2d96b17
40239.94,1.0,184,2,2,1,5,0xb2d407d0
1045.04,1.0,92,1,2,1,4,0xb2d287c3
333.51,1.0,18,1,2,2,5,0xb2d1baaa
400035.84,3.0,7,4,4,3,11,0xb2d22cfb
130026.96,2.0,0,3,3,4,10,0xb2d5d389
18193.14,1.0,0,2,2,4,8,0xb2d5302d
849058.63,7.0,28,4,4,2,10,0xb2d0fbbf
550016.36,3.0,35,4,4,2,10,0xb2d97f92
42.78,1.0,25,1,2,2,5,0xb2d36e85
45954.9,3.0,104,2,4,1,7,0xb2d61c33
80000.32,3.0,0,3,4,4,11,0xb2d5f710
159743.2,1.0,7,3,2,3,8,0xb2da5583
75012.4,2.0,10,3,3,3,9,0xb2d64d6b
400100.43,7.0,8,4,4,3,11,0xb2da174a
1501.9,1.0,129,1,2,1,4,0xb2d64601
250731.08,5.0,0,3,4,4,11,0xb2d11418
14180.57,1.0,15,2,2,3,7,0xb2d7552b
250071.06,2.0,143,3,3,1,7,0xb2d60fae
560040.12,5.0,27,4,4,2,10,0xb2d8c596
341381.59,4.0,17,4,4,2,10,0xb2d07d71
20477.01,2.0,52,2,3,2,7,0xb2d5e162
205402.53,4.0,53,3,4,2,9,0xb2d2ce78
501776.21,2.0,49,4,3,2,9,0xb2d9d98d
1020057.1,2.0,10,4,3,3,10,0xb2d6baa4
500128.53,2.0,0,4,3,4,11,0xb2d98454
260921.93,3.0,0,3,4,4,11,0xb2d57f74
50148.39,2.0,184,2,3,1,6,0xb2d100cc
410821.42,6.0,10,4,4,3,11,0xb2d113be
60291.1,2.0,3,3,3,4,10,0xb2d6547d
713117.14,2.0,77,4,3,1,8,0xb2d0e680d
23672.15,1.0,132,2,2,1,5,0xb2d3e83c
451962.99,9.0,0,4,4,4,12,0xb2d126b5
1001050.51,2.0,132,4,3,1,8,0xb2d69191
501777.15,3.0,29,4,4,2,10,0xb2d8c4e5
200000.0,2.0,25,3,3,2,8,0xb2d6c3c0
371575.06,5.0,41,4,4,2,10,0xb2d52ffc
4609.87,1.0,20,2,2,2,6,0xb2d91978
16264.81,1.0,2,2,2,4,8,0xb2d3048c
1062.29,1.0,0,1,2,4,7,0xb2d55271
227043.3,2.0,87,3,3,1,7,0xb2d68cc5
402014.49,4.0,157,4,4,1,9,0xb2d2c75d
0.05,1.0,67,1,2,1,4,0xb2d8cfd4
150060.6,2.0,31,3,3,2,8,0xb2d91d29
500069.2,3.0,16,4,4,2,10,0xb2d6c642
12428.11,3.0,7,2,4,3,9,0xb2d1087d
208381.24,8.0,0,3,4,4,11,0x3b9b2f0d
150018.75,2.0,139,3,3,1,7,0xb2d11a38
85002.72,5.0,16,3,4,2,9,0xb2d0dc09
408000.0,4.0,6,4,4,3,11,0xb2d8fdfcd
203.24,1.0,0,1,2,4,7,0xb2d55a84
32.15,1.0,7,1,2,3,6,0xb2d5ffab
80004.22,2.0,40,3,3,2,8,0xb2d5c0a9
67858.85,3.0,8,3,4,3,10,0xb2d2aacf
819885.5,3.0,42,4,4,2,10,0xb2d8d1bb
162532.04,2.0,32,3,3,2,8,0xb2d2eac7
629532.3,10.0,4,4,4,4,12,0xb2d2417f
450016.38,3.0,111,4,4,1,9,0xb2d149e7
3001.6,1.0,184,2,2,1,5,0xb2d11de3
2033.93,1.0,184,1,2,1,4,0xb2d0d655
300000.0,5.0,5,3,4,3,10,0xb2d23b21
76598.85,1.0,13,3,2,3,8,0xb2d9ba21
7021.15,1.0,0,2,2,4,8,0xb2d4045c
640044.82,4.0,4,4,4,4,12,0xb2d5f5a4
18644.73,1.0,14,2,2,3,7,0xb2d2ef01
330044.77,9.0,11,4,4,3,11,0xb2d5b172
1512.61,2.0,92,1,3,1,5,0xb2d0827b
58753.65,12.0,0,3,4,4,11,0x3b9b40ea
2556.77,1.0,0,1,2,4,7,0xb2d4f55f
2378.87,1.0,129,1,2,1,4,0xb2d13881
1402852.61,3.0,34,4,4,2,10,0xb2d23f7a
1007.71,1.0,92,1,2,1,4,0xb2d62a3f
327007.12,2.0,256,4,3,1,8,0xb2d48846
535678.99,1.0,3,4,2,4,10,0xb2d2a693
100024.06,2.0,98,3,3,1,7,0xb2d6007a
210825.84,3.0,73,3,4,1,8,0xb2d8e4b7
500741.45,3.0,21,4,4,2,10,0xb2d5a919
200005.95,2.0,1,3,3,4,10,0xb2d24c86
1674.77,1.0,10,1,2,3,6,0xb2d6e956
1279.97,1.0,27,1,2,2,5,0xb2d22305
45.14,2.0,51,1,3,2,6,0xb2d40cda
738.26,1.0,9,1,2,3,6,0xb2d2c250
1376.46,1.0,92,1,2,1,4,0xb2d2401e
65002.69,4.0,6,3,4,3,10,0xb2d5fd7b
15177757.68,3.0,4,4,4,4,12,0x3b9b2373
270590.28,5.0,0,3,4,4,11,0xb2d5849b
155395.96,6.0,0,3,4,4,11,0xb2d6e0d2
303445.04,2.0,4,4,3,4,11,0xb2d39497
19369.71,1.0,2,2,2,4,8,0xb2d2a42f
300003.17,3.0,14,3,4,3,10,0xb2d993c9
30.98,1.0,22,1,2,2,5,0xb2d31243
289.02,1.0,17,1,2,2,5,0xb2d2ef79
2572.29,1.0,9,1,2,3,6,0xb2d92cef
1552.27,1.0,26,1,2,2,5,0xb2d76a17
500000.22,3.0,19,4,4,2,10,0xb2d53c8c
220004.65,3.0,28,3,4,2,9,0xb2d9c785
1112.36,1.0,0,1,2,4,7,0xb2d34d62
1340000.0,2.0,4,4,3,4,11,0xb2da59b5
2237.37,1.0,14,1,2,3,6,0xb2d5d3aa
5.07,1.0,63,1,2,2,5,0xb2d88ea2
85041.33,2.0,31,3,3,2,8,0xb2d1588b
13465.08,1.0,15,2,2,3,7,0xb2d8ec98
260472.08,2.0,17,3,3,2,8,0xb2d2a143
10131.29,2.0,252,2,3,1,6,0xb2d63097
290003.7,5.0,110,3,4,1,8,0xb2d1fd69
105856.46,8.0,9,3,4,3,10,0xb2d2d167
226075.04,3.0,66,3,4,2,9,0xb2d3e607
2000118.5,4.0,245,4,4,1,9,0xb2d41c7e
270000.0,3.0,6,3,4,3,10,0xb2da503c
672931.2,5.0,0,4,4,4,12,0xb2d3ae7e
226002.5,12.0,0,3,4,4,11,0xb2d2b158
635775.75,2.0,0,4,3,4,11,0xb2d6214e
50315.24,2.0,59,2,3,2,7,0x3b9b4974
1208225.61,2.0,13,4,3,3,10,0xb2d1ca61
322057.57,3.0,0,4,4,4,12,0xb2d1758c
910187.79,5.0,11,4,4,3,11,0xb2d6a19f
20000.84,2.0,92,2,3,1,6,0xb2d64874
10052.78,1.0,184,2,2,1,5,0xb2d53d3c
1.68,2.0,57,1,3,2,6,0xb2d64c16
8.19,1.0,10,1,2,3,6,0xb2d35cf2
37.69,2.0,7,1,3,3,7,0xb2d782e6
13792.92,1.0,1,2,2,4,8,0xb2d60e8e
8.0,1.0,3,1,2,4,7,0xb2d68ae5
395.28,1.0,2,1,2,4,7,0xb2d0cfcf
952.66,1.0,17,1,2,2,5,0xb2d53491
320000.0,2.0,6,4,3,3,10,0xb2d96ade
172003.95,3.0,70,3,4,1,8,0xb2d6427f
150724.82,2.0,47,3,3,2,8,0xb2d59de2
286559.89,2.0,0,3,3,4,10,0xb2d58e3f
2137.62,1.0,184,1,2,1,4,0xb2d3169d
53087.28,2.0,77,3,3,1,7,0xb2d45b25
150027.81,2.0,16,3,3,2,8,0xb2d2f3d7
200004.61,2.0,15,3,3,3,9,0xb2d8fc8e
250000.19,2.0,25,3,3,2,8,0xb2d2fb79
501129.72,6.0,0,4,4,4,12,0xb2d147de
460023.01,7.0,0,4,4,4,12,0xb2d93ed6
181003.25,4.0,18,3,4,2,9,0xb2d489e2
4231.77,1.0,2,2,2,4,8,0xb2d24046
500010.56,2.0,60,4,3,2,9,0xb2d9bc33
0.0,1.0,4,1,2,4,7,0xb2d145f4
66005.49,3.0,161,3,4,1,8,0xb2d5947d
300000.95,2.0,4,3,3,4,10,0xb2d948ed
10067.2,1.0,1,2,2,4,8,0xb2d68657
5948.66,1.0,0,2,2,4,8,0xb2d60792
350000.0,2.0,0,4,3,4,11,0xb2da35e4
7381.97,1.0,14,2,2,3,7,0xb2d6bf1f
18802.55,2.0,68,2,3,1,6,0xb2d515b9
2068.7,1.0,1,1,2,4,7,0xb2d90399
1875.81,1.0,184,1,2,1,4,0xb2d3a27c
1778828.97,3.0,4,4,4,4,12,0xb2d12321
390419.34,2.0,7,4,3,3,10,0xb2d3b3ee
3.38,1.0,60,1,2,2,5,0xb2d4be93
10.13,1.0,28,1,2,2,5,0xb2d6972c
20009.7,1.0,92,2,2,1,5,0xb2d33e46
198216.82,1.0,0,3,2,4,9,0xb2d3bd17
20.06,1.0,60,1,2,2,5,0xb2d5f580
18.99,1.0,67,1,2,1,4,0xb2d99621
153.64,1.0,28,1,2,2,5,0xb2d3ced5
505304.87,4.0,33,4,4,2,10,0xb2d0a1e8d
60000.63,2.0,92,3,3,1,7,0xb2d2f066
4162.42,1.0,9,2,2,3,7,0xb2d954f6
200000.0,2.0,7,3,3,3,9,0xb2d516a0
112917.59,3.0,3,3,4,4,11,0xb2d622f1
829.82,1.0,0,1,2,4,7,0xb2d2071b
12576.45,1.0,92,2,2,1,5,0xb2d2883e
6749.86,1.0,20,2,2,2,6,0xb2d687a5
7355511.42,6.0,31,4,4,2,10,0xb2d5186e
26589.18,2.0,0,2,3,4,9,0xb2d623fe
213021.55,3.0,35,3,4,2,9,0xb2d0dc29
29.06,1.0,10,1,2,3,6,0xb2d61587
372409.63,4.0,18,4,4,2,10,0xb2d245b2
149856.82,2.0,4,3,3,4,10,0xb2d5e65fd
6.38,4.0,12,1,4,3,8,0xb2d09276
200000.0,2.0,11,3,3,3,9,0xb2d969a7
51517.83,2.0,104,2,3,1,6,0xb2d581c7
408539.51,2.0,41,4,3,2,9,0xb2d5fdb0
209.35,1.0,3,1,2,4,7,0xb2d32799
386006.36,10.0,0,4,4,4,12,0xb2d5e7a9
153757.66,3.0,5,3,4,3,10,0xb2d16c2e
157754.06,3.0,59,3,4,2,9,0xb2d1a760
303025.98,2.0,136,4,3,1,8,0xb2d22a70
3543.17,1.0,2,2,2,4,8,0xb2d5cdcd
484613.98,5.0,3,4,4,4,12,0xb2d5e84b
310291.22,5.0,3,4,4,4,12,0xb2d0fdba
1.48,1.0,19,1,2,2,5,0xb2da2772
60451.39,2.0,0,3,3,4,10,0xb2d34919
495855.01,3.0,1,4,4,4,12,0xb2d09490
1513.14,1.0,1,1,2,4,7,0xb2d42e00
1000094.45,2.0,6,4,3,3,10,0xb2d1bbcc
31436.86,1.0,0,2,2,4,8,0xb2d614b5
212774.74,2.0,0,3,3,4,10,0xb2d4a34b
12.5,1.0,27,1,2,2,5,0xb2d8e452
2414011.23,3.0,9,4,4,3,11,0xb2d92b17
693176.02,6.0,0,4,4,4,12,0x3b9b2fc5
310009.88,5.0,25,4,4,2,10,0xb2d60623
500000.13,2.0,13,4,3,3,10,0xb2d8e0f3
202132.32,2.0,58,3,3,2,8,0xb2d948b0
2.17,1.0,31,1,2,2,5,0xb2d685fc
480056.37,4.0,95,4,4,1,9,0xb2d49d8d
1419081.48,4.0,126,4,4,1,9,0xb2d56fea
263919.04,1.0,92,3,2,1,6,0xb2d246b8
133090.64,2.0,112,3,3,1,7,0xb2d1c039
1558692.33,6.0,10,4,4,3,11,0xb2d0b810d
285083.02,6.0,0,3,4,4,11,0xb2d4423d
65148.34,2.0,76,3,3,1,7,0xb2d36b3b
50000.53,2.0,70,2,3,1,6,0xb2d9a6be
5910.17,1.0,15,2,2,3,7,0xb2d1fa4b
388.38,1.0,15,1,2,3,6,0xb2d783d2
2054.85,1.0,12,1,2,3,6,0xb2d44332
15006.84,1.0,0,2,2,4,8,0xb2d6e7e1
200002.14,2.0,24,3,3,2,8,0xb2d1e6d0
3001.33,1.0,19,2,2,2,6,0xb2d6b6c6
400084.25,5.0,19,4,4,2,10,0xb2d6c505
4748.67,2.0,247,2,3,1,6,0x3b9b340d
5350.82,1.0,10,2,2,3,7,0xb2d92241
1050373.95,2.0,77,4,3,1,8,0xb2d59901
830035.48,4.0,70,4,4,1,9,0xb2d614f9d
203769.42,3.0,0,3,4,4,11,0xb2d259ac
32108.22,2.0,1,2,3,4,9,0xb2d5a81d
74.86,1.0,17,1,2,2,5,0xb2d50dfdd
2255.26,1.0,92,1,2,1,4,0xb2d0e00d
451485.39,3.0,13,4,4,3,11,0xb2d9bc94
14433.84,1.0,0,2,2,4,8,0xb2d9d120
1294.19,1.0,184,1,2,1,4,0xb2d0c3d2
50002.64,2.0,63,2,3,2,7,0xb2d9afe8
308842.76,1.0,92,4,2,1,7,0xb2d51ea9d
55000.0,2.0,3,3,3,4,10,0xb2d640f0
65.04,1.0,12,1,2,3,6,0xb2d58094
21705.37,1.0,82,2,2,1,5,0xb2d4d1e6
133829.73,1.0,48,3,2,2,7,0xb2d5a96e
38.29,1.0,10,1,2,3,6,0xb2d75f70
800167.16,7.0,10,4,4,3,11,0xb2d56cbf
9290.76,1.0,92,2,2,1,5,0xb2d5cbf2
70130.8,3.0,21,3,4,2,9,0xb2d582ec
1344.7,2.0,120,1,3,1,5,0xb2d09c4c
500065.31,2.0,0,4,3,4,11,0xb2d6deae
15622.55,1.0,10,2,2,3,7,0xb2d6ba99
4056.66,1.0,0,2,2,4,8,0xb2d6cfc8
570018.0,15.0,12,4,4,3,11,0xb2d08c2c
305735.41,3.0,20,4,4,2,10,0xb2d17f19
794.99,1.0,33,1,2,2,5,0xb2d6bf1fd
6896.79,1.0,14,2,2,3,7,0xb2d99631
6708.76,1.0,33,2,2,2,6,0xb2d6c89a
7146.25,2.0,92,2,3,1,6,0xb2d35e6c
26784.67,1.0,3,2,2,4,8,0xb2d6ed21
15000.36,1.0,0,2,2,4,8,0xb2d6ac8b
732.14,1.0,10,1,2,3,6,0xb2d80dd1
13007.96,1.0,67,2,2,1,5,0xb2d8f0c9
685500.8,5.0,11,4,4,3,11,0xb2d15e86
1800132.28,3.0,20,4,4,2,10,0xb2d5b7b6
50002.97,2.0,74,2,3,1,6,0xb2d88d9d
3229.49,1.0,61,2,2,2,6,0xb2d5066e
200249.71,3.0,10,3,4,3,10,0xb2d28927
50.88,1.0,14,1,2,3,6,0xb2d2d076
6364.79,1.0,9,2,2,3,7,0xb2d71607
4780.5,1.0,20,2,2,2,6,0xb2da2841
38.59,1.0,10,1,2,3,6,0xb2d4163a
521859.78,4.0,24,4,4,2,10,0xb2d20635
291066.45,7.0,53,3,4,2,9,0xb2d620dd
200000.0,2.0,26,3,3,2,8,0xb2d948b0d
20000.21,2.0,48,2,3,2,7,0xb2d9da9c
124964.44,2.0,80,3,3,1,7,0xb2d16dee
10196.55,1.0,4,2,2,4,8,0xb2d923dc
2498.94,1.0,0,1,2,4,7,0xb2d92715
3158.78,1.0,6,2,2,3,7,0xb2d4ee7f
123485.36,5.0,4,3,4,4,11,0x3b9b185cd
142.45,1.0,16,1,2,2,5,0xb2d37c75d
362941.1,4.0,1,4,4,4,12,0xb2d6d0d8
5101.1,1.0,15,2,2,3,7,0xb2d9b374
202421.43,4.0,0,3,4,4,11,0xb2d9e227
1750000.0,12.0,3,4,4,4,12,0xb2d5856e
11342.25,1.0,10,2,2,3,7,0xb2d44b6c
22.15,1.0,4,1,2,4,7,0xb2d43c19
0.0,1.0,7,1,2,3,6,0xb2d14f96
1.25,1.0,46,1,2,2,5,0xb2d2c28a
51204.72,2.0,1,2,3,4,9,0xb2d5ce23
2234718.91,4.0,3,4,4,4,12,0xb2d134f7
200000.0,2.0,4,3,3,4,10,0xb2da633b
963000.0,8.0,5,4,4,3,11,0xb2d6be39
324.17,2.0,22,1,3,2,6,0xb2d182e4
280.75,2.0,35,1,3,2,6,0xb2d24161d
414777.28,4.0,80,4,4,1,9,0x3b9b3610
10.03,1.0,87,1,2,1,4,0xb2d8708f
25448.86,1.0,15,2,2,3,7,0xb2d7184a
25500.33,1.0,11,2,2,3,7,0xb2da3d73
16010.74,1.0,18,2,2,2,6,0xb2d91729
600954.48,3.0,0,4,4,4,12,0xb2d78546
120077.48,2.0,27,3,3,2,8,0xb2d41418
500032.95,3.0,119,4,4,1,9,0x3b9b2e23
34230.28,1.0,6,2,2,3,7,0xb2d18d34
22.45,1.0,15,1,2,3,6,0xb2d16c8e
784476.44,4.0,50,4,4,2,10,0xb2d9872b
211.12,1.0,25,1,2,2,5,0xb2d3ecc5
5006.93,1.0,11,2,2,3,7,0xb2d985f4
990633.61,6.0,38,4,4,2,10,0xb2d16560
5.19,11.0,47,1,4,2,7,0xb2d17b30
100933.93,3.0,8,3,4,3,10,0xb2d60dfd
477.54,1.0,2,1,2,4,7,0xb2d6c3fc
0.0,1.0,7,1,2,3,6,0xb2d90aab
5.28,1.0,83,1,2,1,4,0xb2d6e937d
309612.64,3.0,80,4,4,1,9,0xb2d12315
1091828.72,3.0,199,4,4,1,9,0xb2d3e14c
2219.44,1.0,0,1,2,4,7,0xb2d68142
4986.27,1.0,59,2,2,2,6,0xb2d1295c
922108.69,11.0,0,4,4,4,12,0xb2d69222d
20049.33,1.0,19,2,2,2,6,0xb2d1dd24
200042.95,3.0,95,3,4,1,8,0xb2d17677
51514.4,1.0,14,2,2,3,7,0xb2d5d1b0
21103.85,2.0,27,2,3,2,7,0xb2d41724
203500.28,1.0,0,3,2,4,9,0xb2d3a573
2410287.43,1.0,0,4,2,4,10,0xb2d35495
160069.99,2.0,164,3,3,1,7,0xb2d6021c
774501.09,8.0,4,4,4,4,12,0xb2d5fbe6
5326.44,1.0,96,2,2,1,5,0xb2d443b5
62653.19,1.0,5,3,2,3,8,0xb2d2de59
200041.73,3.0,22,3,4,2,9,0xb2d6e19ed
774072.58,2.0,0,4,3,4,11,0xb2d61801
4242.35,1.0,11,2,2,3,7,0xb2d6f15d
880461.25,5.0,1,4,4,4,12,0xb2d25676
43004.06,1.0,8,2,2,3,7,0xb2d54b71
2318.01,1.0,0,1,2,4,7,0xb2d34367
100896.61,1.0,3,3,2,4,9,0xb2d9000d
518220.27,1.0,13,4,2,3,9,0xb2d10f62
1988.1,1.0,111,1,2,1,4,0xb2d75768
3722.08,1.0,9,2,2,3,7,0xb2d703f0
240486.68,2.0,9,3,3,3,9,0xb2d60569d
1532.71,1.0,184,1,2,1,4,0xb2d1ec99
170095.4,2.0,55,3,3,2,8,0xb2d6ccbd
340000.0,4.0,7,4,4,3,11,0xb2d6b904
1109.45,1.0,260,1,2,1,4,0xb2d21810
886318.34,8.0,88,4,4,1,9,0xb2d0cf6f
366.06,1.0,9,1,2,3,6,0xb2d30a7d
14625.89,1.0,11,2,2,3,7,0xb2d9199b
500035.3,2.0,7,4,3,3,10,0xb2d6e5b7
51425.69,3.0,21,2,4,2,8,0xb2d2b9f9
20588.63,1.0,251,2,2,1,5,0xb2d19aead
8965.02,1.0,10,2,2,3,7,0xb2d8f2eb
42562.91,2.0,0,2,3,4,9,0xb2d6694cd
258000.99,6.0,6,3,4,3,10,0xb2d5a7d7
717131.51,7.0,25,4,4,2,10,0xb2d61050
120041.22,2.0,140,3,3,1,7,0xb2d1bb1fd
50029.52,2.0,212,2,3,1,6,0xb2d40c55
471499.31,5.0,108,4,4,1,9,0x3b9b32e4
61608.39,3.0,47,3,4,2,9,0xb2d535d7
30212.64,2.0,147,2,3,1,6,0xb2d6620d
55012.55,1.0,5,3,2,3,8,0xb2d28a49
602443.67,6.0,1,4,4,4,12,0x3b9b3316
168500.31,5.0,1,3,4,4,11,0xb2d2a4cd
23250.1,1.0,0,2,2,4,8,0xb2d6b0fc
2012.83,1.0,16,1,2,2,5,0xb2d34b35
300339.89,2.0,0,4,3,4,11,0xb2d6e1c1
1277037.92,11.0,0,4,4,4,12,0xb2d396e1
309.57,1.0,9,1,2,3,6,0xb2d20477
750024.87,2.0,108,4,3,1,8,0xb2d68d1f
92.02,1.0,43,1,2,2,5,0xb2d5918e
537.79,1.0,5,1,2,3,6,0xb2d91944
242211.93,18.0,2,3,4,4,11,0xb2d124ce
23069.02,1.0,92,2,2,1,5,0xb2d60eb4
1129060.55,5.0,1,4,4,4,12,0xb2d5d98e
12300.38,1.0,0,2,2,4,8,0xb2d3cab3
963.25,1.0,5,1,2,3,6,0xb2d2ae92d
265272.84,5.0,4,3,4,4,11,0xb2d1096c
156.14,1.0,11,1,2,3,6,0xb2d2d2b0
150047.72,2.0,0,3,3,4,10,0xb2d0edc9
9144.51,1.0,8,2,2,3,7,0xb2d21947
200023.66,2.0,53,3,3,2,8,0xb2d59286
550000.0,3.0,1,4,4,4,12,0xb2d93f21
6110.01,1.0,92,2,2,1,5,0x3b9b3740
40234.31,3.0,34,2,4,2,8,0xb2d680ef
40360.96,1.0,8,2,2,3,7,0xb2d3c4cd
377300.32,1.0,0,4,2,4,10,0xb2d108d0
856049.93,3.0,83,4,4,1,9,0xb2d15bbf
340.98,1.0,9,1,2,3,6,0xb2d35fde
527006.77,7.0,11,4,4,3,11,0xb2d080da
9922.0,1.0,3,2,2,4,8,0xb2d4b6fc
132226.19,1.0,0,3,2,4,9,0xb2d1870c
20.95,1.0,61,1,2,2,5,0xb2d2bd88
40002.53,2.0,92,2,3,1,6,0xb2d5ec79
7395.17,1.0,11,2,2,3,7,0xb2d935ee
692265.28,4.0,25,4,4,2,10,0xb2d64828
351436.56,4.0,6,4,4,3,11,0xb2d52ef5
4541.36,1.0,180,2,2,1,5,0xb2d240c5
110004.18,3.0,38,3,4,2,9,0xb2d5b720
50008.63,2.0,172,2,3,1,6,0xb2d5a1c7
120009.83,3.0,38,3,4,2,9,0xb2d8e7a1
301069.53,2.0,18,4,3,2,9,0xb2d0eca0
51046.15,2.0,42,2,3,2,7,0xb2d4cb6a
287829.56,2.0,1,3,3,4,10,0xb2d1a3ed
1447.37,1.0,9,1,2,3,6,0xb2d6f600
7.92,1.0,55,1,2,2,5,0xb2d9a291
50001.58,2.0,18,2,3,2,7,0xb2da27ea
40938.07,1.0,4,2,2,4,8,0xb2d35bd6
2292.19,1.0,184,1,2,1,4,0xb2d1b171
9828.28,1.0,139,2,2,1,5,0xb2d426a1
460921.21,2.0,10,4,3,3,10,0xb2d4ad2c
460.93,1.0,40,1,2,2,5,0xb2d2454c
10.68,1.0,75,1,2,1,4,0xb2d37c1d
900342.66,3.0,83,4,4,1,9,0x3b9b49cc
20001.52,3.0,13,2,4,3,9,0xb2d52dae
99014.47,6.0,77,3,4,1,8,0xb2d60cf9d
200730.15,3.0,87,3,4,1,8,0xb2d2134e
209336.73,2.0,108,3,3,1,7,0xb2d325eb
501787.2,2.0,27,4,3,2,9,0xb2d6a8d3
401659.19,3.0,136,4,4,1,9,0xb2d60b60
99204.86,2.0,22,3,3,2,8,0xb2d3a0a6
162628.52,1.0,119,3,2,1,6,0xb2d2ba10
212000.11,3.0,2,3,4,4,11,0xb2d50a0e
74564.64,3.0,0,3,4,4,11,0x3b9af0e0d
85049.59,3.0,80,3,4,1,8,0xb2d0aabc
401523.39,2.0,31,4,3,2,9,0xb2d558a9
2.15,1.0,39,1,2,2,5,0xb2d42724
133000.14,3.0,18,3,4,2,9,0xb2d3119a
2232108.03,5.0,0,4,4,4,12,0xb2d3e1fe
953.87,1.0,3,1,2,4,7,0xb2d1d932
732904.3,9.0,0,4,4,4,12,0x3b9adb31
168.94,1.0,4,1,2,4,7,0xb2d2cdb6
1226289.5,4.0,3,4,4,4,12,0xb2d430c7
0.0,1.0,8,1,2,3,6,0xb2d28936
728548.7,3.0,0,4,4,4,12,0xb2d648bd
12151.25,1.0,29,2,2,2,6,0xb2d5c917
6408.96,1.0,194,2,2,1,5,0xb2d3a258
800112.79,4.0,21,4,4,2,10,0xb2d6407b
868.88,2.0,17,1,3,2,6,0x3b9b48b2
2631.86,1.0,157,1,2,1,4,0xb2d60683
610079.68,3.0,18,4,4,2,10,0xb2d9ca4d
1000009.29,3.0,5,4,4,3,11,0xb2d6e5fcd
450892.89,3.0,15,4,4,3,11,0xb2d783d0d
1560351.64,6.0,1,4,4,4,12,0xb2d24cad
729.33,1.0,80,1,2,1,4,0xb2d32d75
120084.19,2.0,119,3,3,1,7,0xb2d64aa5
200699.51,2.0,5,3,3,3,9,0xb2d5abc0
600035.47,2.0,52,4,3,2,9,0xb2d3515d
469600.18,12.0,0,4,4,4,12,0x3b9b3932
140002.96,4.0,21,3,4,2,9,0xb2d14cbb
21726.22,1.0,174,2,2,1,5,0xb2d4d1e6d
63.42,1.0,73,1,2,1,4,0xb2d83c32
301383.95,2.0,6,4,3,3,10,0xb2d36073
340003.59,3.0,83,4,4,1,9,0xb2d95d89
10212.2,1.0,201,2,2,1,5,0xb2d5b5f2
3027.26,1.0,92,2,2,1,5,0xb2d2b78f
2000000.43,3.0,6,4,4,3,11,0x3b9b31f7
9219.79,1.0,0,2,2,4,8,0xb2d2b6c0
541260.6,2.0,184,4,3,1,8,0xb2d23f37
73574.33,1.0,8,3,2,3,8,0xb2d0c0d0
2081395.92,2.0,94,4,3,1,8,0xb2d308c1
2677.48,1.0,92,1,2,1,4,0xb2d1e2a9
1200103.35,6.0,3,4,4,4,12,0xb2d51ed9
261339.3,4.0,107,3,4,1,8,0xb2d1fe68
114.45,1.0,98,1,2,1,4,0xb2d29451
4989.1,1.0,82,2,2,1,5,0xb2d96743
30649.8,3.0,0,2,4,4,10,0xb2d1eb4b
782.24,1.0,2,1,2,4,7,0xb2d6bd29
1025.94,1.0,92,1,2,1,4,0xb2d21994
1535531.72,2.0,5,4,3,3,10,0xb2d13bb8
2000052.78,2.0,69,4,3,1,8,0xb2d8e87f
17823.11,1.0,24,2,2,2,6,0xb2d2f111
317.69,3.0,6,1,4,3,8,0xb2d0af8f
77799.49,2.0,0,3,3,4,10,0xb2d0f4d2
168.26,1.0,39,1,2,2,5,0xb2d2597c
50354.15,4.0,24,2,4,2,8,0xb2d0d925
532608.74,4.0,0,4,4,4,12,0xb2d46d67
98071.44,3.0,7,3,4,3,10,0xb2d63bef
630915.95,1.0,5,4,2,3,9,0xb2d6258c
79211.4,1.0,8,3,2,3,8,0xb2d631c6
31388.36,2.0,40,2,3,2,7,0x3b9b17d5
260044.15,2.0,80,3,3,1,7,0xb2d63766
102981.07,1.0,4,3,2,4,9,0xb2d3627c
40781.28,1.0,0,2,2,4,8,0xb2d56b12
591.21,1.0,0,1,2,4,7,0xb2d4829d
51486.48,2.0,18,2,3,2,7,0xb2d67cb1
1012.43,1.0,0,1,2,4,7,0xb2d27c1e
17553.82,1.0,158,2,2,1,5,0xb2d6be5b
31360.75,2.0,0,2,3,4,9,0xb2d5a93a
1015.63,1.0,184,1,2,1,4,0xb2d13d42
6479.16,1.0,122,2,2,1,5,0xb2d5e5b6d
11902.75,1.0,0,2,2,4,8,0xb2d6e490d
292.23,1.0,27,1,2,2,5,0xb2d41e91
270000.0,20.0,0,3,4,4,11,0xb2d4f290
95.43,1.0,0,1,2,4,7,0xb2d4e143
360033.35,3.0,24,4,4,2,10,0xb2d6d0a2
650.86,1.0,10,1,2,3,6,0xb2d31a04
692004.18,19.0,0,4,4,4,12,0xb2d547e7
246745.38,3.0,52,3,4,2,9,0xb2d30bd1
522641.24,3.0,1,4,4,4,12,0xb2d152c0
27061.35,1.0,44,2,2,2,6,0xb2d5e818d
6636.06,1.0,4,2,2,4,8,0xb2d2d7c3
71112.67,10.0,1,3,4,4,11,0x3b9adbd8
50000.53,2.0,92,2,3,1,6,0xb2d656c2
1.06,1.0,60,1,2,2,5,0xb2d9bceb
4555.59,1.0,3,2,2,4,8,0xb2d33402
1014.47,1.0,92,1,2,1,4,0xb2d14eb6
280590.04,4.0,67,3,4,1,8,0xb2d3d3ca
10001.69,9.0,20,2,4,2,8,0xb2d0f338d
39172.22,4.0,136,2,4,1,7,0xb2d62f9e
201188.21,2.0,28,3,3,2,8,0xb2d6b313
10416.01,1.0,14,2,2,3,7,0xb2d16f74
2100022.17,2.0,32,4,3,2,9,0xb2d926a0
10.82,1.0,42,1,2,2,5,0xb2d2e014
51083.52,2.0,92,2,3,1,6,0xb2d298b7
50000.0,2.0,0,2,3,4,9,0xb2d2c96e
320003.38,2.0,18,4,3,2,9,0xb2da2e7a
14.86,1.0,66,1,2,2,5,0xb2d580ae
100006.12,3.0,31,3,4,2,9,0xb2d60216
265.96,1.0,0,1,2,4,7,0xb2d75846
1421.69,1.0,82,1,2,1,4,0xb2d69406
281859.9,1.0,0,3,2,4,9,0xb2d6acef
331933.73,4.0,92,4,4,1,9,0xb2d14142
580055.01,8.0,6,4,4,3,11,0x3b9b3d40
22335.49,1.0,4,2,2,4,8,0xb2d12f7c
2022.6,1.0,184,1,2,1,4,0xb2d25ed3
110468.77,3.0,139,3,4,1,8,0xb2d2e867
14.85,1.0,0,1,2,4,7,0xb2d3107a
3292.78,1.0,0,2,2,4,8,0xb2d4a267
61023.07,1.0,184,3,2,1,6,0xb2d42e8a
758.98,1.0,6,1,2,3,6,0xb2d2b60b
500016.16,2.0,80,4,3,1,8,0xb2d8b2ff
100046.79,2.0,123,3,3,1,7,0xb2d4104b
4939937.04,7.0,92,4,4,1,9,0xb2d24dc2d
454.73,1.0,23,1,2,2,5,0xb2d29583
490008.78,9.0,0,4,4,4,12,0xb2d6273e
985.83,1.0,5,1,2,3,6,0xb2d0bb87
208078.56,3.0,8,3,4,3,10,0xb2d8fdd9
6473.68,3.0,5,2,4,3,9,0xb2d52978
5358.01,1.0,184,2,2,1,5,0x3b9b309a
407051.98,3.0,13,4,4,3,11,0x3b9b4757
10028.21,1.0,92,2,2,1,5,0xb2d6136f
789356.16,7.0,3,4,4,4,12,0xb2d077a5
126753.07,6.0,0,3,4,4,11,0xb2d6487a
500005.28,2.0,52,4,3,2,9,0xb2d5ba39
19947.47,1.0,14,2,2,3,7,0xb2d346f0
520474.42,7.0,52,4,4,2,10,0xb2d082b4
381889.98,5.0,25,4,4,2,10,0xb2d5621e
10923.06,4.0,92,2,4,1,7,0xb2d0d2ae
11970.66,1.0,92,2,2,1,5,0xb2d31b78
1090135.99,4.0,7,4,4,3,11,0xb2d8ce83
13445.99,1.0,0,2,2,4,8,0xb2d175c3
15184.94,1.0,16,2,2,2,6,0xb2d23843
5203.93,1.0,0,2,2,4,8,0xb2d9e0e5
1351.97,2.0,184,1,3,1,5,0xb2d0aa9c
8280.35,1.0,0,2,2,4,8,0xb2d4f27f
170116.34,4.0,18,3,4,2,9,0xb2d1f2d2
38575.86,1.0,92,2,2,1,5,0xb2d4ee13
2324.78,1.0,1,1,2,4,7,0xb2d9305f
136045.07,3.0,0,3,4,4,11,0xb2d4e45b
357.95,1.0,24,1,2,2,5,0xb2d623a0
42005.84,2.0,62,2,3,2,7,0xb2d563ad
441091.98,5.0,14,4,4,3,11,0xb2d14ed8
56368.75,2.0,53,3,3,2,8,0xb2d2569f
21.54,1.0,48,1,2,2,5,0xb2d43261
324.65,2.0,74,1,3,1,5,0xb2d06d0e
421872.62,1.0,6,4,2,3,9,0xb2d58260
8429888.45,19.0,0,4,4,4,12,0xb2d1e276
777.08,1.0,6,1,2,3,6,0xb2d6a11e
350000.47,2.0,18,4,3,2,9,0xb2d8d74f
660000.0,9.0,8,4,4,3,11,0xb2d51e53
418552.49,2.0,4,4,3,4,11,0xb2d562b8
104628.51,3.0,3,3,4,4,11,0xb2d23c39
49.02,1.0,20,1,2,2,5,0xb2d3903a
50001.58,2.0,92,2,3,1,6,0xb2d97c52
500201.63,3.0,2,4,4,4,12,0xb2d963ad
2554.32,1.0,201,1,2,1,4,0xb2d70471
1934633.61,14.0,34,4,4,2,10,0xb2d15743
7674.64,1.0,20,2,2,2,6,0xb2d68e6d
13123.58,3.0,207,2,4,1,7,0xb2d3bce3d
5360725.81,17.0,4,4,4,4,12,0x3b9b12c1
464.2,1.0,3,1,2,4,7,0xb2d62cd1
10028.21,1.0,277,2,2,1,5,0xb2d6a14b
26767.22,1.0,10,2,2,3,7,0xb2d2b5f4
17496.32,1.0,4,2,2,4,8,0xb2d2a78d
13876.3,1.0,0,2,2,4,8,0xb2d1f776d
6500.63,1.0,10,2,2,3,7,0xb2d41c80
4007.87,1.0,1,2,2,4,8,0xb2d683c2
56013.26,3.0,5,3,4,3,10,0xb2d17de6d
750898.21,9.0,3,4,4,4,12,0x3b9b186d
1351.68,1.0,4,1,2,4,7,0xb2d6bfe2
2931549.97,7.0,14,4,4,3,11,0xb2d42073
505605.92,5.0,18,4,4,2,10,0xb2d57e0b
101.02,1.0,0,1,2,4,7,0xb2d988ea
182207.85,5.0,0,3,4,4,11,0xb2d9b2e1
180062.49,2.0,10,3,3,3,9,0xb2d13e78
400000.0,2.0,0,4,3,4,11,0xb2d94084
250051.24,4.0,181,3,4,1,8,0xb2d1becc
32.77,1.0,12,1,2,3,6,0xb2d2953e
74.82,1.0,2,1,2,4,7,0xb2d6c416
467003.05,7.0,10,4,4,3,11,0xb2d6a726
301065.63,2.0,31,4,3,2,9,0xb2d93ea2
5055.94,1.0,19,2,2,2,6,0xb2d6af58
300014.84,4.0,4,3,4,4,11,0xb2d40149
5.76,1.0,71,1,2,1,4,0xb2d592ed
10497.27,1.0,0,2,2,4,8,0xb2d9603c
299242.62,4.0,56,3,4,2,9,0xb2d12169
48103.37,2.0,47,2,3,2,7,0xb2d3d29d
352000.92,3.0,3,4,4,4,12,0xb2d5bd90
103.75,1.0,16,1,2,2,5,0xb2d8f10f
219747.33,7.0,8,3,4,3,10,0xb2d4e5c8
14122.91,3.0,0,2,4,4,10,0xb2d12c23
473222.71,4.0,0,4,4,4,12,0xb2d25b48
498403.03,6.0,45,4,4,2,10,0xb2d16d3a
3.35,1.0,18,1,2,2,5,0xb2d61734
85924.64,4.0,0,3,4,4,11,0xb2d2111c
25.22,1.0,2,1,2,4,7,0xb2d3ea1e
270714.54,3.0,30,3,4,2,9,0xb2d9a39c
8.08,1.0,45,1,2,2,5,0xb2d2c494
42.54,1.0,18,1,2,2,5,0xb2d6c1e5
8854.47,1.0,15,2,2,3,7,0xb2da05a2
128.79,1.0,19,1,2,2,5,0xb2d2b693d
17096.8,1.0,179,2,2,1,5,0xb2d1f818
40007.86,2.0,25,2,3,2,7,0xb2d93207
40104.4,2.0,147,2,3,1,6,0xb2d6f04b
30001.58,2.0,209,2,3,1,6,0xb2d686f6
128534.56,1.0,4,3,2,4,9,0xb2d2b60e
406962.57,6.0,0,4,4,4,12,0x3b9b1a2e
805390.39,5.0,22,4,4,2,10,0xb2d65bf8
129404.34,5.0,1,3,4,4,11,0xb2d463fd
399008.95,5.0,0,4,4,4,12,0xb2d3c5aa
227750.3,1.0,19,3,2,2,7,0xb2d5ba48
3956.86,1.0,184,2,2,1,5,0xb2d217ca
128778.21,3.0,221,3,4,1,8,0xb2d16b5a
16786.61,1.0,1,2,2,4,8,0xb2d6bcd4
384125.9,4.0,0,4,4,4,12,0x3b9b0e15
10223.29,3.0,115,2,4,1,7,0xb2d676a5
30001.58,2.0,92,2,3,1,6,0xb2d63485
31.43,1.0,73,1,2,1,4,0xb2d469bf
1090644.51,5.0,0,4,4,4,12,0xb2d3474ed
422902.45,3.0,15,4,4,3,11,0xb2d6444e
326006.9,3.0,157,4,4,1,9,0xb2d6859ad
406427.7,3.0,35,4,4,2,10,0xb2d6aabb
203438.43,2.0,152,3,3,1,7,0xb2d6092a
100610.82,3.0,132,3,4,1,8,0x3b9b2d23d
542019.29,7.0,3,4,4,4,12,0xb2d0d7c2
40000.95,3.0,0,2,4,4,10,0xb2d9402a
45713.74,1.0,4,2,2,4,8,0xb2d5d811
600000.13,5.0,24,4,4,2,10,0xb2d5dbb8
127112.05,1.0,0,3,2,4,9,0xb2d9b340
1468220.47,8.0,0,4,4,4,12,0x3b9b4929
4.54,1.0,32,1,2,2,5,0xb2d929c3
21.48,1.0,9,1,2,3,6,0xb2d46574
50460.52,1.0,184,2,2,1,5,0xb2d2e39cd
1641.89,1.0,0,1,2,4,7,0xb2d6c445
20000.21,2.0,20,2,3,2,7,0xb2d6e688
1110.39,1.0,4,1,2,4,7,0xb2d8ff65
14099.3,2.0,0,2,3,4,9,0xb2d65e36
50000.62,2.0,3,2,3,4,9,0xb2d57e48
17079.0,1.0,0,2,2,4,8,0xb2d4145f
500000.06,2.0,4,4,3,4,11,0xb2d61875
601.46,1.0,8,1,2,3,6,0xb2d12095
90000.0,8.0,0,3,4,4,11,0xb2d1941f
110005.82,2.0,182,3,3,1,7,0xb2d88ad3
705347.18,4.0,82,4,4,1,9,0xb2d4336c
406.4,1.0,18,1,2,2,5,0xb2d93c32
84911.41,3.0,5,3,4,3,10,0xb2d219d2
26.07,1.0,41,1,2,2,5,0xb2d12230
7.28,1.0,40,1,2,2,5,0xb2d9c250
326.24,1.0,0,1,2,4,7,0xb2d44b1dd
3370000.14,6.0,12,4,4,3,11,0xb2d24cb3
31060.63,1.0,7,2,2,3,7,0xb2d6b635d
8277.9,1.0,10,2,2,3,7,0xb2d995b0
209148.05,1.0,225,3,2,1,6,0xb2d31687
67186.07,9.0,0,3,4,4,11,0x3b9b32e3
21.97,1.0,0,1,2,4,7,0xb2d64b80
90002.96,2.0,8,3,3,3,9,0xb2da133a
410952.15,2.0,19,4,3,2,9,0xb2d29816
1808.62,1.0,12,1,2,3,6,0xb2d7fe1c
3523.45,1.0,4,2,2,4,8,0xb2d282ef
280015.93,6.0,1,3,4,4,11,0x3b9b2f45
10379.9,6.0,31,2,4,2,8,0xb2d108a5
2.19,1.0,21,1,2,2,5,0xb2d50da8
67181.23,3.0,13,3,4,3,10,0xb2d4f382
573901.7,5.0,18,4,4,2,10,0xb2d239e9
200000.0,2.0,29,3,3,2,8,0xb2da0bb7
37.16,1.0,22,1,2,2,5,0xb2d55fdd
62550.66,2.0,92,3,3,1,7,0xb2d25be7
100058.44,2.0,139,3,3,1,7,0xb2d58363
1580.15,1.0,0,1,2,4,7,0xb2d35305
155256.04,1.0,3,3,2,4,9,0xb2d3c684
4705.29,1.0,5,2,2,3,7,0xb2d0d412
6.57,1.0,38,1,2,2,5,0xb2d37cc2
109.56,1.0,26,1,2,2,5,0xb2d9f004
904300.46,5.0,7,4,4,3,11,0xb2d567eb
60316.11,2.0,10,3,3,3,9,0xb2d51880
468000.0,3.0,4,4,4,4,12,0xb2d879ee
0.0,1.0,6,1,2,3,6,0xb2d229a8
14294.54,1.0,0,2,2,4,8,0xb2d2cf30d
1476.41,1.0,23,1,2,2,5,0xb2d16ec8
200014.07,2.0,10,3,3,3,9,0xb2d2baf2
186461.71,3.0,0,3,4,4,11,0xb2d41b7cd
50000.53,2.0,34,2,3,2,7,0xb2d93311
10099.64,2.0,151,2,3,1,6,0xb2d67fc8
200186.24,3.0,89,3,4,1,8,0xb2d41636d
127242.87,2.0,41,3,3,2,8,0xb2d2528b
408595.07,6.0,0,4,4,4,12,0xb2d605f5
1300000.0,2.0,21,4,3,2,9,0xb2d95187
12195.63,1.0,1,2,2,4,8,0xb2d28018
498911.47,8.0,4,4,4,4,12,0xb2d321b8
3232.81,1.0,10,2,2,3,7,0xb2d423e0
10001.08,1.0,15,2,2,3,7,0xb2d98a70
51579.81,1.0,0,2,2,4,8,0xb2d6b117
932.13,1.0,1,1,2,4,7,0xb2d2c48f
28.54,1.0,41,1,2,2,5,0xb2d5d12d
294.45,1.0,25,1,2,2,5,0xb2d371af
3929.42,1.0,14,2,2,3,7,0xb2d24d6c
80008.73,3.0,19,3,4,2,9,0xb2d37c20
10006.61,2.0,101,2,3,1,6,0xb2d7edfd
1657.04,1.0,92,1,2,1,4,0xb2d2d9a7
251.93,1.0,2,1,2,4,7,0xb2d62d25d
2441108.59,3.0,67,4,4,1,9,0xb2d96182
588958.32,5.0,10,4,4,3,11,0x3b9b317e
204618.49,1.0,19,3,2,2,7,0xb2d509dc
505058.95,4.0,18,4,4,2,10,0xb2d8de1d
1486502.6,12.0,70,4,4,1,9,0xb2d09e64
833108.84,4.0,14,4,4,3,11,0xb2d15348
224.69,1.0,3,1,2,4,7,0xb2d6adda
8174.72,1.0,0,2,2,4,8,0xb2d26ce5
736671.73,4.0,24,4,4,2,10,0x3b9b4310d
813.53,1.0,24,1,2,2,5,0xb2d438fd
2946.42,1.0,0,2,2,4,8,0xb2d96428
592.3,1.0,10,1,2,3,6,0xb2d9d742
1000.0,1.0,0,1,2,4,7,0xb2d6f017
690094.23,5.0,3,4,4,4,12,0xb2d23439
54002.51,5.0,8,3,4,3,10,0xb2d7827a
17212.74,1.0,9,2,2,3,7,0xb2d624f3
368.29,1.0,2,1,2,4,7,0xb2d200a5
10011.61,1.0,119,2,2,1,5,0xb2d781d9
192391.48,3.0,0,3,4,4,11,0xb2d3418e
140069.6,2.0,92,3,3,1,7,0xb2d451b7
21626.42,2.0,0,2,3,4,9,0xb2d311b2
17000.0,1.0,3,2,2,4,8,0xb2d94e2a
20001.11,2.0,263,2,3,1,6,0xb2d5f9c7
560197.28,17.0,1,4,4,4,12,0xb2d07e1d
458509.95,3.0,0,4,4,4,12,0xb2d36393
400041.67,2.0,9,4,3,3,10,0xb2d998de
1847.73,1.0,8,1,2,3,6,0xb2d24e1a
1522.15,1.0,92,1,2,1,4,0xb2d136b6
8473.53,1.0,184,2,2,1,5,0xb2d1bf8b
440448.32,5.0,3,4,4,4,12,0xb2d60625d
7037.77,1.0,92,2,2,1,5,0xb2d1100f
50002.11,2.0,69,2,3,1,6,0xb2d8e69c
2001.06,1.0,59,1,2,2,5,0xb2d8d090d
1063685.14,6.0,4,4,4,4,12,0xb2d21dc2
500010.56,2.0,18,4,3,2,9,0xb2da1c7d
33132.41,1.0,6,2,2,3,7,0xb2d3a19cd
300103.39,2.0,16,4,3,2,9,0xb2d78c67
290302.77,3.0,125,3,4,1,8,0xb2d54931
92002.71,4.0,6,3,4,3,10,0xb2d9b752
1652.81,1.0,0,1,2,4,7,0xb2d6f580
2963.24,1.0,5,2,2,3,7,0xb2d35243
557081.49,4.0,78,4,4,1,9,0xb2d56e7a
384.71,1.0,0,1,2,4,7,0xb2d4ed6e
821.02,1.0,7,1,2,3,6,0xb2d41a27
1753.02,1.0,17,1,2,2,5,0xb2d3642e
30060.45,4.0,21,2,4,2,8,0xb2d6352d
10000.11,2.0,55,2,3,2,7,0xb2d90456
732442.73,3.0,2,4,4,4,12,0xb2d58e9d
1030000.1,3.0,7,4,4,3,11,0xb2d9e7d2
286184.27,2.0,49,3,3,2,8,0x3b9b2b32
1270000.0,5.0,3,4,4,4,12,0xb2d42510
173303.96,1.0,24,3,2,2,7,0xb2d36a1d
367869.54,5.0,18,4,4,2,10,0xb2d5c75f
104824.97,2.0,90,3,3,1,7,0xb2d17bbbd
158993.17,2.0,3,3,3,4,10,0xb2d21955
203729.23,4.0,76,3,4,1,8,0xb2d17e1d
210000.0,2.0,0,3,3,4,10,0xb2d97c95d
300000.63,2.0,4,3,3,4,10,0xb2da01a3
253.24,1.0,9,1,2,3,6,0xb2d45563
3742.02,2.0,92,2,3,1,6,0xb2d0a64e
1245.46,1.0,273,1,2,1,4,0xb2d52bb9
1730118.41,6.0,17,4,4,2,10,0xb2d57d1c
1214491.52,10.0,0,4,4,4,12,0x3b9af100
1000870.61,2.0,0,4,3,4,11,0xb2d45cc6
1.13,1.0,26,1,2,2,5,0xb2d29aa2
5446.05,1.0,0,2,2,4,8,0xb2d930d0
200000.84,2.0,20,3,3,2,8,0xb2d8d510
336074.45,4.0,20,4,4,2,10,0xb2d1b894d
12131.49,1.0,184,2,2,1,5,0xb2d28ede
507738.61,2.0,129,4,3,1,8,0xb2d70050
510000.89,11.0,0,4,4,4,12,0xb2d3a384
640006.44,4.0,7,4,4,3,11,0xb2d8d8e2
10000.61,2.0,27,2,3,2,7,0xb2d917c1
30187.99,1.0,0,2,2,4,8,0xb2d22034
471.5,1.0,15,1,2,3,6,0xb2d586cb
100088.32,2.0,1,3,3,4,10,0xb2d63ddc
43462.28,1.0,2,2,2,4,8,0xb2d2287d
204266.37,2.0,19,3,3,2,8,0xb2d65a1f
204317.08,3.0,33,3,4,2,9,0x3b9b2c28
410700.32,4.0,34,4,4,2,10,0xb2d25b9c
3684.23,1.0,184,2,2,1,5,0xb2d139a9
17252.24,1.0,184,2,2,1,5,0xb2d5d790
1014325.35,13.0,1,4,4,4,12,0xb2d12f38
943.31,3.0,92,1,4,1,6,0x3b9adb0c
964.27,1.0,0,1,2,4,7,0xb2d24794
2712.04,1.0,9,1,2,3,6,0xb2d1a77bd
301579.68,3.0,46,4,4,2,10,0xb2d509ed
200012.24,2.0,15,3,3,3,9,0xb2d99d77
80367.36,2.0,129,3,3,1,7,0xb2d5bfa8d
60000.63,2.0,48,3,3,2,8,0xb2d91459
401426.52,3.0,13,4,4,3,11,0xb2d5b3cd
702794.3,4.0,0,4,4,4,12,0xb2d12bf8
9317199.18,14.0,63,4,4,2,10,0xb2d2489c
576449.42,5.0,2,4,4,4,12,0xb2d91698
12970.49,1.0,184,2,2,1,5,0xb2d14b76
844000.0,21.0,8,4,4,3,11,0xb2d1d938
77622.69,1.0,141,3,2,1,6,0xb2d39053
3327.48,1.0,14,2,2,3,7,0xb2d22a29
0.0,1.0,0,1,2,4,7,0xb2d1776f
1649.29,1.0,67,1,2,1,4,0xb2d25904
5536.57,1.0,7,2,2,3,7,0xb2d54eba
341886.66,2.0,25,4,3,2,9,0xb2d93dc1
38485.85,1.0,0,2,2,4,8,0xb2d2f62e
1.26,1.0,81,1,2,1,4,0xb2d5cb51
32213.63,3.0,1,2,4,4,10,0xb2d535fcd
4928.07,1.0,9,2,2,3,7,0xb2d3627e
1078.1,1.0,184,1,2,1,4,0xb2d3d395
1208000.05,6.0,0,4,4,4,12,0xb2d08842d
307197.96,3.0,20,4,4,2,10,0xb2d1326f
16921.4,1.0,20,2,2,2,6,0xb2d69e58
4649.45,1.0,54,2,2,2,6,0xb2d6cee6
84941.26,6.0,0,3,4,4,11,0x3b9b4333
4091999.33,7.0,8,4,4,3,11,0xb2d23096
289618.73,3.0,203,3,4,1,8,0xb2d4ee29
500010.56,2.0,45,4,3,2,9,0xb2d91877
4314.99,2.0,1,2,3,4,9,0x3b9b370b
13063.99,1.0,14,2,2,3,7,0xb2d22b77
255526.83,2.0,3,3,3,4,10,0xb2d256a2
50001.06,2.0,10,2,3,3,8,0xb2d95e48
57089.3,2.0,111,3,3,1,7,0xb2d162b7
26.75,2.0,54,1,3,2,6,0xb2d550d1
1284186.62,11.0,0,4,4,4,12,0x3b9b17f1
1194106.11,6.0,3,4,4,4,12,0xb2d18060
11.38,33.0,15,1,4,3,8,0x3b9af0e3
20000.22,2.0,13,2,3,3,8,0xb2d95e32
80283.09,2.0,5,3,3,3,9,0xb2d2206e
200052.13,2.0,19,3,3,2,8,0xb2d8d9ba
20044.15,2.0,47,2,3,2,7,0xb2d8c361
185866.75,3.0,10,3,4,3,10,0xb2d216be
1590039.37,12.0,8,4,4,3,11,0xb2d5dbef
4933.24,7.0,20,2,4,2,8,0x3b9ad271
20000.63,2.0,92,2,3,1,6,0xb2d64442
589.76,1.0,0,1,2,4,7,0xb2d2eb0e
11835.74,1.0,0,2,2,4,8,0xb2d6c572
41063.47,1.0,0,2,2,4,8,0xb2d4ebe1
2.56,1.0,64,1,2,2,5,0xb2d58f0f
25015.83,1.0,6,2,2,3,7,0xb2d754a9
500175.62,4.0,9,4,4,3,11,0xb2d50361
81.27,1.0,35,1,2,2,5,0xb2d2fba5
1360064.32,2.0,9,4,3,3,10,0xb2d8dd09
81456.36,2.0,0,3,3,4,10,0xb2d1f0a7
952458.98,3.0,105,4,4,1,9,0xb2d42f56d
500016.69,3.0,13,4,4,3,11,0xb2d6cc95
12199.21,2.0,210,2,3,1,6,0xb2d63715
9.14,1.0,18,1,2,2,5,0xb2d5e461
20.14,1.0,2,1,2,4,7,0xb2d8ee4c
100009.11,2.0,146,3,3,1,7,0xb2d15285d
127578.01,2.0,70,3,3,1,7,0xb2d41649
3.55,1.0,4,1,2,4,7,0xb2d2007c
2291.55,1.0,92,1,2,1,4,0xb2d22e82
204267.04,2.0,97,3,3,1,7,0xb2d87e7f
25.69,1.0,27,1,2,2,5,0xb2d2d50f
50597.46,2.0,154,2,3,1,6,0xb2d6c3a7
200000.0,2.0,5,3,3,3,9,0xb2da59fc
1040742.51,9.0,1,4,4,4,12,0xb2d10bfa
2231277.18,6.0,11,4,4,3,11,0xb2d6452b
50546.51,2.0,77,2,3,1,6,0xb2d8d869
4981.06,1.0,14,2,2,3,7,0xb2d8ca69
870074.74,9.0,6,4,4,3,11,0xb2d16d43
101.78,1.0,1,1,2,4,7,0xb2d97ae1
11707.36,1.0,184,2,2,1,5,0xb2d1dc6d
13588.59,1.0,14,2,2,3,7,0xb2d449d4
510664.77,3.0,76,4,4,1,9,0xb2d7f2d4
492.14,1.0,0,1,2,4,7,0xb2d90786
1030575.79,4.0,3,4,4,4,12,0xb2d18006
41.17,1.0,29,1,2,2,5,0xb2d9798c
180038.72,3.0,52,3,4,2,9,0x3b9b18e6
0.53,1.0,18,1,2,2,5,0xb2d5f5ce
817.27,1.0,8,1,2,3,6,0xb2d26d62
14902.21,1.0,2,2,2,4,8,0xb2d405ea
720009.14,4.0,11,4,4,3,11,0xb2d1009e
620738.42,3.0,3,4,4,4,12,0xb2d40010
6587.6,1.0,1,2,2,4,8,0xb2d4c205
132085.34,6.0,8,3,4,3,10,0xb2d4299c
10000.27,2.0,95,2,3,1,6,0xb2d9767e
475046.97,5.0,59,4,4,2,10,0xb2d1e5d9
5032.42,1.0,92,2,2,1,5,0xb2d34b3e
350779.15,3.0,18,4,4,2,10,0xb2d1fffa
93046.98,4.0,133,3,4,1,8,0xb2d5f14f
3.36,2.0,85,1,3,1,5,0xb2d0a422
384952.44,2.0,5,4,3,3,10,0xb2d69618
1918.99,1.0,92,1,2,1,4,0xb2d31f64d
160439.27,2.0,7,3,3,3,9,0xb2d621ce
5128.33,1.0,0,2,2,4,8,0xb2d6bd8f
240117.0,1.0,1,3,2,4,9,0xb2d68eeb
402411.45,3.0,63,4,4,2,10,0xb2d966fe
1017100.82,3.0,12,4,4,3,11,0xb2d13551
4001.69,1.0,0,2,2,4,8,0xb2d6fd3d
954560.81,4.0,44,4,4,2,10,0xb2d2dc2b
202899.77,2.0,118,3,3,1,7,0xb2d5f659
5029.08,1.0,21,2,2,2,6,0xb2d59217
266.84,1.0,10,1,2,3,6,0xb2d698f3
172210.57,4.0,0,3,4,4,11,0x3b9b2f0a
25743.88,1.0,10,2,2,3,7,0xb2d32835
80000090.29,2.0,306,4,3,1,8,0xb2d37eb8
1741.92,1.0,92,1,2,1,4,0xb2d147c9
1371.91,1.0,184,1,2,1,4,0xb2d0fd09
200017.94,3.0,87,3,4,1,8,0xb2d614f5
654638.71,5.0,0,4,4,4,12,0xb2d64192
3817.53,1.0,0,2,2,4,8,0xb2d6e79f
999.6,1.0,0,1,2,4,7,0xb2d3b5fc
190569.22,4.0,0,3,4,4,11,0xb2d55160
1.69,1.0,35,1,2,2,5,0xb2d63206
55626.62,2.0,118,3,3,1,7,0xb2d56371
126116.81,1.0,1,3,2,4,9,0xb2d5cbea
210018.03,3.0,80,3,4,1,8,0xb2d5f8b4
7137.02,1.0,27,2,2,2,6,0xb2d0df0b
8036.76,1.0,184,2,2,1,5,0xb2d55c31
756000.0,7.0,2,4,4,4,12,0x3b9b25da
301065.63,2.0,9,4,3,3,10,0xb2d92cf3
24420.46,1.0,8,2,2,3,7,0xb2d3483e
2038406.24,6.0,0,4,4,4,12,0xb2d10b4a
14459.32,1.0,6,2,2,3,7,0xb2d60974
2537.82,1.0,124,1,2,1,4,0xb2d15130
3850.47,1.0,91,2,2,1,5,0xb2d19699
500000.0,2.0,5,4,3,3,10,0xb2d8f2b1
207107.91,1.0,4,3,2,4,9,0xb2d62c4b
442110.02,7.0,6,4,4,3,11,0xb2d12939
292.55,1.0,3,1,2,4,7,0xb2d2a65a
7.49,1.0,74,1,2,1,4,0xb2d966c6
1400000.0,7.0,19,4,4,2,10,0xb2d9569d
4.79,1.0,1,1,2,4,7,0xb2d65cef
0.01,1.0,7,1,2,3,6,0xb2d916f9
664.53,6.0,0,1,4,4,9,0xb2d08d9e
107253.65,3.0,90,3,4,1,8,0xb2d48611
205620.23,1.0,28,3,2,2,7,0xb2d68699
42132.78,1.0,0,2,2,4,8,0xb2d210c4
2171.7,1.0,15,1,2,3,6,0xb2d790ee
815066.31,6.0,19,4,4,2,10,0xb2d4ac36
6551.93,3.0,184,2,4,1,7,0xb2d171b6
220058.43,1.0,10,3,2,3,8,0xb2d9cc0d
300000.0,5.0,6,3,4,3,10,0xb2d4eb0a
785.5,1.0,39,1,2,2,5,0xb2d3a67a
146119.06,2.0,4,3,3,4,10,0xb2d9481c
163.41,1.0,21,1,2,2,5,0xb2d6d0fc
81229.79,3.0,0,3,4,4,11,0xb2d374bfd
150899.65,5.0,15,3,4,3,10,0xb2d20308
200001.26,2.0,8,3,3,3,9,0xb2d96eb3
100079.67,3.0,34,3,4,2,9,0xb2d9127d
235000.0,4.0,0,3,4,4,11,0xb2d3fa25
400000.0,3.0,9,4,4,3,11,0xb2d9446bd
569952.85,3.0,154,4,4,1,9,0xb2d6c9bc
5007.16,1.0,64,2,2,2,6,0xb2d7a77e
85.6,1.0,2,1,2,4,7,0xb2d6dba4
357301.84,3.0,52,4,4,2,10,0xb2d13cbd
9807.67,1.0,11,2,2,3,7,0xb2d40728
206230.12,2.0,92,3,3,1,7,0xb2d4426a
400000.0,2.0,1,4,3,4,11,0xb2da2bfe
1227.52,1.0,9,1,2,3,6,0xb2d30943
2568.43,1.0,17,1,2,2,5,0xb2d2990c
7647.77,1.0,89,2,2,1,5,0xb2d3c3ed
3636.58,1.0,17,2,2,2,6,0xb2d3515f
4.57,1.0,20,1,2,2,5,0xb2d6b7bb
800008.44,3.0,38,4,4,2,10,0xb2d107f7
354954.07,3.0,14,4,4,3,11,0xb2d32636
402053.94,3.0,6,4,4,3,11,0xb2d686ee
3.01,1.0,67,1,2,1,4,0xb2d6c4b0
100001.06,2.0,6,3,3,3,9,0xb2da49f3
200000.84,2.0,8,3,3,3,9,0xb2d8eb62
202074.2,4.0,179,3,4,1,8,0xb2d2ba34
966.18,1.0,3,1,2,4,7,0xb2d4370c
989004.53,9.0,3,4,4,4,12,0xb2d49f4c
2539.04,1.0,0,1,2,4,7,0xb2d31989
1329531.7,3.0,126,4,4,1,9,0xb2d1643d
537972.08,1.0,10,4,2,3,9,0xb2d40e87
5.38,1.0,55,1,2,2,5,0xb2d52272
16552.17,1.0,15,2,2,3,7,0xb2d94c36
481.41,3.0,0,1,4,4,9,0x3b9af341
300032.33,3.0,0,3,4,4,11,0xb2d81d38
2021.84,1.0,92,1,2,1,4,0xb2d21cfd
500087.57,1.0,1,4,2,4,10,0xb2d29397
201428.47,2.0,0,3,3,4,10,0xb2d698de
10.2,2.0,18,1,3,2,6,0x3b9b2908
1381.59,1.0,9,1,2,3,6,0xb2d9442c
3816714.08,7.0,8,4,4,3,11,0xb2d6b2a9d
71.11,1.0,1,1,2,4,7,0xb2d94f7e
20.87,1.0,48,1,2,2,5,0xb2d5488e
0.65,1.0,92,1,2,1,4,0xb2d24c9e
90.78,1.0,6,1,2,3,6,0xb2d44ac0
52002.2,2.0,70,2,3,1,6,0xb2d9a439
164387.95,2.0,5,3,3,3,9,0xb2d3accf
325123.97,6.0,14,4,4,3,11,0x3b9b4367
5624.93,1.0,10,2,2,3,7,0xb2d62c2d
2081.96,1.0,0,1,2,4,7,0xb2d918f5
83257.24,2.0,7,3,3,3,9,0xb2d31ddb
222.05,1.0,0,1,2,4,7,0xb2d47309
621106.65,5.0,0,4,4,4,12,0xb2d91348
385.46,1.0,18,1,2,2,5,0xb2d2122c
0.0,2.0,3,1,3,4,8,0xb2d21246d
2632.78,1.0,3,1,2,4,7,0xb2d27c2d
10948.19,1.0,184,2,2,1,5,0xb2d29031
424582.68,3.0,0,4,4,4,12,0xb2d57408
1500414.84,2.0,24,4,3,2,9,0xb2d23fd6
859042.62,7.0,24,4,4,2,10,0xb2d302e8
712.32,1.0,9,1,2,3,6,0xb2d5cd06
10543.08,1.0,39,2,2,2,6,0xb2d2c65a
520121.53,3.0,1,4,4,4,12,0xb2d9732d
150004.75,5.0,18,3,4,2,9,0x3b9ace95
10001.22,2.0,66,2,3,2,7,0xb2d6c709
25215.42,1.0,10,2,2,3,7,0xb2d8e7b1
604272.57,5.0,29,4,4,2,10,0xb2d1039b
5473.11,1.0,18,2,2,2,6,0xb2d614a7
3102.81,1.0,125,2,2,1,5,0xb2d359b7
88008.75,2.0,83,3,3,1,7,0xb2d60f22
340331.21,4.0,32,4,4,2,10,0xb2d43586
456426.38,2.0,14,4,3,3,10,0xb2d0fa2d
2001.12,1.0,116,1,2,1,4,0xb2d154f2
409332.84,1.0,0,4,2,4,10,0xb2d10fe8
95521.37,4.0,108,3,4,1,8,0xb2d41d1ad
1198.63,2.0,184,1,3,1,5,0xb2d17d9d
90592.92,3.0,36,3,4,2,9,0xb2d25f78
747473.41,4.0,0,4,4,4,12,0xb2d0b40f
100003.17,2.0,102,3,3,1,7,0xb2d95eed
98.99,1.0,61,1,2,2,5,0xb2d963d9
220000.77,3.0,13,3,4,3,10,0xb2d5f5c0
268026.76,6.0,0,3,4,4,11,0xb2d093e0
300051.52,2.0,15,3,3,3,9,0xb2d58c29
500000.0,2.0,16,4,3,2,9,0xb2d65e35
1087018.85,5.0,10,4,4,3,11,0xb2d0c4ae
212056.09,2.0,188,3,3,1,7,0xb2d3b130
10350.4,1.0,20,2,2,2,6,0xb2d56566
130005.34,2.0,147,3,3,1,7,0xb2d1b3a1
50154.24,2.0,92,2,3,1,6,0xb2d10a0fd
20557.85,3.0,0,2,4,4,10,0xb2d8fb87
400013.06,2.0,14,4,3,3,10,0xb2d178d2
111087.55,2.0,184,3,3,1,7,0x3b9b371e
400410.95,2.0,25,4,3,2,9,0xb2d5a573
165358.72,3.0,0,3,4,4,11,0xb2d53058
8559.88,1.0,92,2,2,1,5,0xb2d1e9c4
307.6,1.0,0,1,2,4,7,0xb2d392ab
650014.78,8.0,14,4,4,3,11,0xb2d5e942
1469.72,1.0,9,1,2,3,6,0xb2d6d250
758013.52,8.0,10,4,4,3,11,0xb2d159b0
10000077.32,2.0,5,4,3,3,10,0xb2d3b8c1
150051.67,3.0,48,3,4,2,9,0xb2d576ea
964.63,1.0,2,1,2,4,7,0xb2d78060
80003.84,2.0,9,3,3,3,9,0xb2da38d1
164.21,1.0,14,1,2,3,6,0xb2d2403d
328497.09,5.0,18,4,4,2,10,0xb2d0e628
201616.02,2.0,90,3,3,1,7,0xb2d60923
363598.82,11.0,1,4,4,4,12,0xb2d6eb94
100002.89,3.0,0,3,4,4,11,0xb2d11d56d
458587.64,2.0,60,4,3,2,9,0xb2d5cbe0
348.33,1.0,0,1,2,4,7,0xb2d4634c
1790689.91,10.0,8,4,4,3,11,0xb2d3dcfc
40510.65,2.0,6,2,3,3,8,0xb2d32329
1.7,1.0,7,1,2,3,6,0xb2d3f264
4186.67,1.0,2,2,2,4,8,0xb2d92b32
720721.95,4.0,16,4,4,2,10,0xb2d47627
309082.51,3.0,70,4,4,1,9,0xb2d1b488
10070000.0,3.0,3,4,4,4,12,0xb2d96cfa
210017.24,3.0,21,3,4,2,9,0xb2d2265e
474951.19,5.0,19,4,4,2,10,0xb2d4ff56
267.18,1.0,9,1,2,3,6,0xb2d26797
690024.53,4.0,172,4,4,1,9,0xb2d2a261
270269.81,4.0,13,3,4,3,10,0xb2d59a73
60000.64,3.0,14,3,4,3,10,0xb2da30f4
349432.88,5.0,21,4,4,2,10,0xb2d6149b
9488.61,1.0,10,2,2,3,7,0xb2d51b5f
222005.03,5.0,0,3,4,4,11,0xb2d12536
2010071.96,4.0,1,4,4,4,12,0xb2d4e8f1d
3049.89,1.0,184,2,2,1,5,0xb2d22f8b
8804.04,1.0,6,2,2,3,7,0xb2d439d5
100423.41,4.0,10,3,4,3,10,0xb2d46875
411492.69,6.0,6,4,4,3,11,0xb2d68296
424058.61,7.0,87,4,4,1,9,0xb2d42552
1195124.07,1.0,120,4,2,1,7,0xb2d34ae8
29167.6,1.0,11,2,2,3,7,0xb2d2073d
2015.81,1.0,9,1,2,3,6,0xb2d30c45
219480.64,1.0,92,3,2,1,6,0xb2d3a682
311195.21,5.0,21,4,4,2,10,0xb2d1fcfe
23140.95,1.0,19,2,2,2,6,0xb2d30bf6
96.99,1.0,19,1,2,2,5,0xb2d60b97
258001.26,5.0,18,3,4,2,9,0xb2d3cebb
3.55,1.0,29,1,2,2,5,0xb2d3f104
1533399.49,8.0,34,4,4,2,10,0xb2d16cb2
1389.1,1.0,10,1,2,3,6,0xb2d4f1a2
5182.71,1.0,184,2,2,1,5,0xb2d1c2f1
622848.07,4.0,53,4,4,2,10,0xb2d5699c
123306.3,3.0,0,3,4,4,11,0xb2d11227d
649.18,1.0,63,1,2,2,5,0xb2d32c7f
604262.99,2.0,63,4,3,2,9,0xb2d9ae14
160076.6,2.0,4,3,3,4,10,0xb2d5c36b
110708.47,4.0,13,3,4,3,10,0xb2d57cc5
1494.4,1.0,0,1,2,4,7,0xb2d34ef4
151317.18,3.0,126,3,4,1,8,0xb2d11808
80017.68,2.0,80,3,3,1,7,0xb2d58eced
3492.6,1.0,1,2,2,4,8,0xb2d8cd89
1496.8,1.0,184,1,2,1,4,0xb2d3e775
460368.55,2.0,22,4,3,2,9,0xb2d98160
203291.96,2.0,34,3,3,2,8,0xb2d68699d
301.81,1.0,6,1,2,3,6,0xb2d79046
1879.43,2.0,60,1,3,2,6,0xb2d69e0b
170049.68,6.0,11,3,4,3,10,0xb2d5774a
2133.2,1.0,5,1,2,3,6,0xb2d6265b
500150.4,2.0,102,4,3,1,8,0xb2d23ddf
620010.94,4.0,54,4,4,2,10,0xb2d5e16d
35103.2,1.0,132,2,2,1,5,0xb2d6e5bf
266.67,2.0,0,1,3,4,8,0xb2d7c96a
3007.79,1.0,40,2,2,2,6,0xb2d59d1e
4209.52,1.0,1,2,2,4,8,0xb2d65c42
51943.07,2.0,136,2,3,1,6,0xb2d5cbe8
100002.11,2.0,92,3,3,1,7,0xb2d58a40
20000.21,2.0,231,2,3,1,6,0xb2d6f0df
547000.8,12.0,1,4,4,4,12,0xb2d11131
300000.0,2.0,4,3,3,4,10,0xb2da260c
11392.33,2.0,36,2,3,2,7,0xb2d12fad
139804.84,3.0,19,3,4,2,9,0xb2d20f21
202320.57,5.0,10,3,4,3,10,0xb2d66919
250006.87,5.0,3,3,4,4,11,0xb2d80506
6484.95,1.0,0,2,2,4,8,0xb2d222ff
228.79,1.0,3,1,2,4,7,0xb2d24fdf
7256.84,1.0,8,2,2,3,7,0xb2d68c5d
94235.02,3.0,34,3,4,2,9,0xb2d5746c
7.71,1.0,18,1,2,2,5,0xb2d649d7
20782.04,1.0,305,2,2,1,5,0xb2d50ac9
2557.03,1.0,42,1,2,2,5,0xb2d64f33d
79.63,1.0,116,1,2,1,4,0xb2d69d13
35413.55,3.0,21,2,4,2,8,0xb2d7de29
200716.21,3.0,24,3,4,2,9,0xb2d07a2a
13979.68,1.0,21,2,2,2,6,0xb2da07f2
21.3,1.0,2,1,2,4,7,0xb2d283f9d
258106.76,1.0,1,3,2,4,9,0xb2d33ac0
10615.85,1.0,0,2,2,4,8,0xb2da230f
8679.62,1.0,3,2,2,4,8,0xb2d60ad3
200000.0,2.0,7,3,3,3,9,0xb2d96ed8
9458.56,1.0,7,2,2,3,7,0xb2d6beaa
500036.73,2.0,15,4,3,3,10,0xb2da027e
330.06,1.0,9,1,2,3,6,0xb2d27719
57454.03,1.0,184,3,2,1,6,0xb2d398db
44721.59,1.0,286,2,2,1,5,0xb2d298f4
2191.28,1.0,9,1,2,3,6,0xb2d5db23
39.08,8.0,89,1,4,1,6,0xb2d24b79
4026.45,1.0,25,2,2,2,6,0xb2d0ecf5
149704.2,1.0,18,3,2,2,7,0xb2d28ce4
1208913.35,11.0,31,4,4,2,10,0xb2d089efd
16266.78,1.0,32,2,2,2,6,0xb2d43c6ed
12.67,2.0,29,1,3,2,6,0xb2d65333
4714.91,3.0,0,2,4,4,10,0x3b9b0ff5
361522.54,3.0,0,4,4,4,12,0xb2d239ab
80249.68,3.0,53,3,4,2,9,0xb2d60e7e
10002.01,2.0,73,2,3,1,6,0xb2d8e350
26.08,1.0,9,1,2,3,6,0xb2d783ae
3553.7,1.0,9,2,2,3,7,0xb2d3fb85
130002.33,4.0,14,3,4,3,10,0xb2d92200
4091.38,1.0,0,2,2,4,8,0xb2d6929e
400026.64,2.0,20,4,3,2,9,0xb2d7846bd
9598.32,1.0,0,2,2,4,8,0xb2d6b4ca
5414.51,1.0,33,2,2,2,6,0xb2d32ef6
350163.71,2.0,15,4,3,3,10,0xb2d2c898
2424.7,1.0,13,1,2,3,6,0xb2d9d3b5
35838.04,1.0,13,2,2,3,7,0xb2d4b920
1235.02,1.0,1,1,2,4,7,0xb2d46e8d
300574.87,5.0,8,4,4,3,11,0xb2d5a236d
32.92,1.0,56,1,2,2,5,0xb2d2d5c8
242616.85,2.0,9,3,3,3,9,0xb2d6a483
151178.71,3.0,14,3,4,3,10,0xb2d1112c
1684.12,1.0,92,1,2,1,4,0xb2d2c77c
8007.88,1.0,5,2,2,3,7,0xb2d34826
1527515.39,19.0,1,4,4,4,12,0xb2d62f64
856027.88,3.0,102,4,4,1,9,0xb2d14ce9
350014.85,5.0,27,4,4,2,10,0xb2d4ce56
81886.36,2.0,6,3,3,3,9,0xb2d599ad
677430.38,7.0,13,4,4,3,11,0xb2d57a17
110143.32,2.0,119,3,3,1,7,0xb2d641ce
12004.73,1.0,4,2,2,4,8,0xb2d8c532
1.35,1.0,18,1,2,2,5,0xb2d9577b
16.39,1.0,0,1,2,4,7,0xb2d3219b
407007.95,7.0,6,4,4,3,11,0xb2d44d88
500000.0,2.0,28,4,3,2,9,0xb2d94131
120000.67,1.0,2,3,2,4,9,0xb2d57975
242802.08,2.0,116,3,3,1,7,0xb2d5a7aa
3980.18,1.0,1,2,2,4,8,0xb2d707e5
177041.4,5.0,27,3,4,2,9,0xb2d4f11e
1023.33,1.0,92,1,2,1,4,0xb2d2c9f7
519312.16,3.0,5,4,4,3,11,0xb2d85c3e
8332.74,1.0,6,2,2,3,7,0xb2d9019b
100102.44,2.0,92,3,3,1,7,0xb2d60c03
500000.69,5.0,98,4,4,1,9,0xb2d5d442
402000.86,3.0,0,4,4,4,12,0xb2d1b8d1d
152497.86,2.0,10,3,3,3,9,0xb2d95fe5
4564.8,1.0,234,2,2,1,5,0xb2d34498
245054.64,4.0,3,3,4,4,11,0xb2d69a62
159660.48,1.0,70,3,2,1,6,0xb2d4dc22
404014.72,6.0,0,4,4,4,12,0xb2d0cb64
40132.25,1.0,18,2,2,2,6,0xb2d1c288
241090.75,4.0,25,3,4,2,9,0xb2d65ad5
309633.59,1.0,269,4,2,1,7,0xb2d50e78
238.06,2.0,25,1,3,2,6,0xb2d11062
130051.31,6.0,102,3,4,1,8,0xb2d08689
201003.71,2.0,0,3,3,4,10,0xb2d311d2
0.68,1.0,3,1,2,4,7,0xb2d31cac
103852.01,2.0,34,3,3,2,8,0xb2d3a913
110000.0,2.0,6,3,3,3,9,0xb2da14af
280075.34,6.0,37,3,4,2,9,0xb2d12478
5726.7,1.0,5,2,2,3,7,0xb2d32039
6983.16,1.0,10,2,2,3,7,0xb2d75c09
6724.39,1.0,213,2,2,1,5,0xb2d6bf19
8151.24,1.0,0,2,2,4,8,0xb2d43145
123012.65,3.0,0,3,4,4,11,0xb2d4311a
314151.21,2.0,37,4,3,2,9,0xb2d15de2
0.01,1.0,184,1,2,1,4,0xb2d1edfe
17314.24,1.0,21,2,2,2,6,0xb2d8c85c
750531.59,6.0,0,4,4,4,12,0xb2d51e07
943543.38,5.0,0,4,4,4,12,0xb2d15251
140245.99,3.0,0,3,4,4,11,0xb2d1b0a0
500000.0,2.0,5,4,3,3,10,0xb2da5d0d
2350197.51,2.0,15,4,3,3,10,0xb2d15511
20.18,1.0,74,1,2,1,4,0xb2d622bb
32.19,1.0,34,1,2,2,5,0xb2d91b97
9969.08,1.0,184,2,2,1,5,0xb2d2dc08
0.15,1.0,3,1,2,4,7,0xb2d6c6cf
19.74,1.0,2,1,2,4,7,0xb2d688e1
811281.43,2.0,214,4,3,1,8,0xb2d45871
10464.45,2.0,6,2,3,3,8,0xb2d5e564
1095016.61,6.0,2,4,4,4,12,0xb2d6ef5d
843.96,2.0,3,1,3,4,8,0xb2d911c9
2242.03,1.0,3,1,2,4,7,0xb2d906b8
505092.35,4.0,27,4,4,2,10,0xb2d3a86f
10043.77,1.0,184,2,2,1,5,0xb2d5d7e8d
3981.11,1.0,6,2,2,3,7,0xb2d4cbb5
2401.24,1.0,7,1,2,3,6,0xb2d3d0b0
342183.1,4.0,143,4,4,1,9,0xb2d22b6f
14938.5,1.0,1,2,2,4,8,0xb2d95a1d
19347.75,1.0,77,2,2,1,5,0xb2d5c5cfd
54280.46,1.0,7,3,2,3,8,0xb2d47471
5180.15,1.0,2,2,2,4,8,0xb2d2ecbb
1107.25,1.0,92,1,2,1,4,0xb2d1043b
43451.26,2.0,0,2,3,4,9,0xb2d06775
1521.5,5.0,40,1,4,2,7,0xb2d18142
640007.81,1.0,6,4,2,3,9,0xb2d933b1
11666688.55,2.0,10,4,3,3,10,0xb2d25be1
794047.56,3.0,29,4,4,2,10,0xb2d7eec3
910007.42,4.0,32,4,4,2,10,0xb2d32403
17234.01,1.0,0,2,2,4,8,0xb2d6037c
2022.16,1.0,184,1,2,1,4,0xb2d22eb0
50061.37,1.0,109,2,2,1,5,0xb2d4e8ed
880038.05,5.0,0,4,4,4,12,0xb2d962fa
520000.0,2.0,8,4,3,3,10,0xb2da4d34
600000.0,4.0,22,4,4,2,10,0xb2da2227
250.15,1.0,0,1,2,4,7,0xb2d6bae0
751490.81,3.0,23,4,4,2,10,0xb2d9aac3
130226.31,2.0,139,3,3,1,7,0xb2d343ab
241128.19,2.0,34,3,3,2,8,0xb2d5ee39
350144.5,5.0,0,4,4,4,12,0xb2d40f3d
2412000.15,5.0,0,4,4,4,12,0xb2d9894d
743.95,1.0,0,1,2,4,7,0xb2d0dc68
300002.53,3.0,1,3,4,4,11,0xb2da3827
9592.4,1.0,13,2,2,3,7,0xb2d5c9bd
918.51,2.0,20,1,3,2,6,0xb2d8dc43
2521.36,1.0,184,1,2,1,4,0xb2d2c37a
174321.49,3.0,10,3,4,3,10,0xb2d1c998
90001.26,3.0,10,3,4,3,10,0xb2d32949
51222.63,1.0,0,2,2,4,8,0xb2d656e0
353078.83,9.0,27,4,4,2,10,0xb2d152d3
284.92,1.0,9,1,2,3,6,0xb2d3ffe3
516707.09,19.0,0,4,4,4,12,0xb2d16cd5
4.88,1.0,37,1,2,2,5,0xb2d282bc
38740.59,1.0,1,2,2,4,8,0xb2d405c6d
447599.1,3.0,1,4,4,4,12,0xb2d2baa8
7191.63,1.0,1,2,2,4,8,0xb2d38296
0.16,1.0,75,1,2,1,4,0xb2d5d0fdd
274.85,1.0,5,1,2,3,6,0xb2d8df3d
27132.41,1.0,11,2,2,3,7,0xb2d3abd7
215647.26,1.0,0,3,2,4,9,0xb2d8d4f0
7623.23,1.0,18,2,2,2,6,0xb2d703f0d
64.08,1.0,18,1,2,2,5,0xb2d5b272
100004.22,2.0,235,3,3,1,7,0xb2d6e42a
602203.6,4.0,0,4,4,4,12,0xb2d0a02b
233035.62,4.0,20,3,4,2,9,0xb2d9801f
50002.85,2.0,55,2,3,2,7,0xb2d683a7d
0.21,1.0,47,1,2,2,5,0xb2d8c66d
593000.87,12.0,0,4,4,4,12,0xb2d1722f
437.4,2.0,3,1,3,4,8,0x3b9af235
20328.75,2.0,136,2,3,1,6,0xb2d63483
350692.24,2.0,6,4,3,3,10,0xb2d24ce1
4.86,1.0,9,1,2,3,6,0xb2d5570e
12308.72,1.0,19,2,2,2,6,0xb2d6a74b
500005.28,2.0,55,4,3,2,9,0xb2d903de
145254.88,1.0,11,3,2,3,8,0xb2d0e381d
701759.0,4.0,9,4,4,3,11,0xb2d4529d
205366.47,2.0,133,3,3,1,7,0xb2d5ab25d
25075.62,3.0,10,2,4,3,9,0xb2d54ec2
784.46,1.0,0,1,2,4,7,0xb2d210c8
2713.93,1.0,10,1,2,3,6,0xb2d4dcc5
16406.41,1.0,0,2,2,4,8,0xb2d78e0a
453.48,1.0,2,1,2,4,7,0xb2d53d4b
5188.27,1.0,16,2,2,2,6,0xb2d2c4fb
61.37,1.0,19,1,2,2,5,0xb2d6bb3f
52.78,1.0,12,1,2,3,6,0xb2d563ed
31811.43,3.0,28,2,4,2,8,0xb2d53d98
146.82,1.0,60,1,2,2,5,0xb2d9a639
13316.62,1.0,0,2,2,4,8,0xb2d1a385
0.0,1.0,1,1,2,4,7,0xb2d5d46a
1130064.25,3.0,32,4,4,2,10,0xb2d08cf5d
13629.63,1.0,15,2,2,3,7,0xb2d0f738
380000.0,7.0,10,4,4,3,11,0xb2d9d5ae
987115.05,15.0,0,4,4,4,12,0xb2d17950
430037.07,5.0,8,4,4,3,11,0xb2d59a51
7511.64,2.0,0,2,3,4,9,0x3b9b3b76
305147.6,1.0,180,4,2,1,7,0xb2d5f5b2
457418.01,5.0,64,4,4,2,10,0xb2d622c1
1690160.97,5.0,101,4,4,1,9,0xb2d646a8d
904752.25,4.0,4,4,4,4,12,0xb2d1e1b0
200089.64,3.0,1,3,4,4,11,0xb2d60721
793.44,3.0,0,1,4,4,9,0xb2d2110c
1444556.06,3.0,0,4,4,4,12,0xb2d1b3f1
1241603.97,8.0,1,4,4,4,12,0xb2d3b5eb
356884.99,2.0,15,4,3,3,10,0xb2d5f1b3
23508.39,1.0,102,2,2,1,5,0xb2d30ad0
281687.85,2.0,45,3,3,2,8,0xb2d3b07e
445176.61,4.0,39,4,4,2,10,0xb2d51616
70784.28,2.0,35,3,3,2,8,0xb2d913a5
3000000.12,16.0,17,4,4,2,10,0xb2d1ba48
101800.24,3.0,62,3,4,2,9,0xb2d6196e
202843.55,2.0,58,3,3,2,8,0xb2d9033a
1257.4,1.0,91,1,2,1,4,0xb2d407ae
50219.95,1.0,184,2,2,1,5,0xb2d5d2e4
0.8,1.0,1,1,2,4,7,0xb2d15843
212004.51,3.0,13,3,4,3,10,0xb2d5e76d
40006.55,1.0,0,2,2,4,8,0xb2d451f8
5150.04,1.0,39,2,2,2,6,0xb2d3cef0
300099.81,2.0,143,4,3,1,8,0xb2d182dc
7433.9,1.0,184,2,2,1,5,0xb2d14e9cd
27428.58,1.0,4,2,2,4,8,0xb2d39e80
10254.79,1.0,10,2,2,3,7,0xb2d6ff75
212210.15,3.0,11,3,4,3,10,0xb2d88a0a
5.21,5.0,60,1,4,2,7,0xb2d384bc
107.22,1.0,184,1,2,1,4,0xb2d32723
171510.84,5.0,38,3,4,2,9,0xb2d19bf7
149216.92,2.0,18,3,3,2,8,0x3b9af19b
24435.12,1.0,58,2,2,2,6,0xb2d6c09d
1421.37,1.0,10,1,2,3,6,0xb2d6b128
8694.29,1.0,0,2,2,4,8,0xb2d6a1ca
3237.14,1.0,22,2,2,2,6,0xb2d6a372d
79.65,1.0,0,1,2,4,7,0xb2d332e9
20000.21,2.0,80,2,3,1,6,0xb2d8d847
2525.71,1.0,92,1,2,1,4,0xb2d2f38f
401441.7,2.0,28,4,3,2,9,0xb2d9bdbc
79001.49,8.0,8,3,4,3,10,0xb2d68698
10100.11,2.0,11,2,3,3,8,0xb2da4689
402511.02,3.0,19,4,4,2,10,0xb2d3c595
10003.2,2.0,20,2,3,2,7,0xb2d65754
600043.01,6.0,20,4,4,2,10,0xb2d5cc90
7179.96,1.0,1,2,2,4,8,0xb2d54f1f
1285.16,1.0,0,1,2,4,7,0xb2d34d82
4703.04,2.0,10,2,3,3,8,0xb2d5c3d6
1975.63,2.0,216,1,3,1,5,0xb2d07de8
666.18,1.0,70,1,2,1,4,0xb2d625d0
1108.06,1.0,11,1,2,3,6,0xb2d277a7
210490.42,7.0,39,3,4,2,9,0xb2d407e8d
11667.45,1.0,92,2,2,1,5,0xb2d35f7e
2184374.86,8.0,0,4,4,4,12,0xb2d40700
2.73,1.0,64,1,2,2,5,0xb2d5f6a2
51294.28,2.0,3,2,3,4,9,0xb2d6227a
0.47,1.0,2,1,2,4,7,0xb2d627db
99.16,1.0,77,1,2,1,4,0xb2d5716c
500007.87,3.0,106,4,4,1,9,0xb2d6102bd
480007.0,2.0,23,4,3,2,9,0xb2d68237
2171.74,1.0,13,1,2,3,6,0xb2d6a958
50020.94,2.0,245,2,3,1,6,0xb2d61b59
58220.11,3.0,0,3,4,4,11,0xb2d17593d
280029.94,4.0,49,3,4,2,9,0xb2d5b9b3
20225.14,1.0,31,2,2,2,6,0xb2d5c617
470035.03,3.0,119,4,4,1,9,0xb2d2e3ad
405.05,1.0,4,1,2,4,7,0xb2d3c7c3
30002.8,2.0,26,2,3,2,7,0xb2d994ea
1.76,1.0,40,1,2,2,5,0xb2d4f5eb
160001.16,3.0,6,3,4,3,10,0xb2d9daaa
100006.9,2.0,132,3,3,1,7,0xb2d2137b
10210.15,1.0,7,2,2,3,7,0xb2d92057
934503.9,6.0,5,4,4,3,11,0xb2d1266d
31.34,1.0,28,1,2,2,5,0xb2d58de1
174196.43,7.0,0,3,4,4,11,0x3b9af1d9
100171.43,2.0,189,3,3,1,7,0xb2d16ee3
80001.9,3.0,52,3,4,2,9,0xb2d8d001
500000.32,2.0,25,4,3,2,9,0xb2d78471
4.14,1.0,9,1,2,3,6,0xb2d81faa
73868.05,2.0,3,3,3,4,10,0xb2d483fb
200809.85,3.0,30,3,4,2,9,0xb2d93cea
2851.4,1.0,92,1,2,1,4,0xb2d1a324
6782.14,1.0,92,2,2,1,5,0xb2d28855
100609.87,2.0,104,3,3,1,7,0xb2d622e4
5706.74,1.0,92,2,2,1,5,0x3b9ade3c
100867.49,2.0,4,3,3,4,10,0xb2d0bf70
325.81,1.0,44,1,2,2,5,0xb2d2d82ad
425008.02,3.0,54,4,4,2,10,0xb2d6583e
130004.75,3.0,41,3,4,2,9,0xb2d8e48a
7.18,1.0,92,1,2,1,4,0xb2d0b86a
10799.6,1.0,184,2,2,1,5,0xb2d3f009
278.55,1.0,0,1,2,4,7,0xb2d49698d
1620.1,1.0,1,1,2,4,7,0xb2d33f10
36.1,1.0,59,1,2,2,5,0xb2d8e4ed
35000.79,3.0,6,2,4,3,9,0xb2da4205
585021.92,4.0,1,4,4,4,12,0xb2d93266
1036017.36,8.0,10,4,4,3,11,0xb2d23fb1
0.51,1.0,4,1,2,4,7,0xb2d91017
10096.3,1.0,189,2,2,1,5,0xb2d58dfd
220009.45,5.0,1,3,4,4,11,0xb2d6893f
3114.69,2.0,61,2,3,2,7,0xb2d12750
10291.32,2.0,3,2,3,4,9,0xb2d64bd8
2.67,1.0,41,1,2,2,5,0xb2d429f0
10000.85,2.0,13,2,3,3,8,0xb2d64860
731835.85,3.0,58,4,4,2,10,0xb2d4f26e
10115.03,2.0,26,2,3,2,7,0xb2d91b4e
961000.71,13.0,0,4,4,4,12,0xb2d3ad10d
500088.61,4.0,0,4,4,4,12,0xb2d50fbb
2313027.0,2.0,76,4,3,1,8,0xb2d4adcd
30000.32,2.0,13,2,3,3,8,0xb2d95ce6
331175.61,2.0,43,4,3,2,9,0xb2d9e713
18.0,1.0,5,1,2,3,6,0xb2d9025f
30001.52,3.0,44,2,4,2,8,0xb2d9c644
1194.46,1.0,3,1,2,4,7,0xb2d41907
82915.77,2.0,0,3,3,4,10,0xb2d5c251
3104.84,1.0,92,2,2,1,5,0xb2d55382
30401.99,2.0,7,2,3,3,8,0xb2d5747dd
50174.81,1.0,12,2,2,3,7,0xb2d8c4b8
10181.95,1.0,184,2,2,1,5,0xb2d0b55e
5510.54,1.0,116,2,2,1,5,0xb2d64797
44.33,1.0,33,1,2,2,5,0xb2d92c45
500276.04,2.0,1,4,3,4,11,0xb2da0435
36.15,1.0,28,1,2,2,5,0xb2d6c89ad
346.14,1.0,10,1,2,3,6,0xb2d914f0
15289.03,3.0,1,2,4,4,10,0xb2d3d9e2
100043.88,2.0,4,3,3,4,10,0xb2d4f369
10000477.05,1.0,0,4,2,4,10,0xb2d624d8
460015.44,6.0,6,4,4,3,11,0xb2d63841
32686.55,1.0,38,2,2,2,6,0xb2d279bd
2252.04,1.0,8,1,2,3,6,0xb2d4daa6
7882.09,1.0,0,2,2,4,8,0xb2d210ae
5882.72,1.0,184,2,2,1,5,0xb2d42a09
39550.0,1.0,0,2,2,4,8,0xb2d94641
43192.47,1.0,12,2,2,3,7,0xb2d1febf
20765.81,2.0,87,2,3,1,6,0xb2d59887d
291796.56,2.0,190,3,3,1,7,0xb2d2f258
3387.94,1.0,19,2,2,2,6,0xb2d38cad
70054.76,3.0,24,3,4,2,9,0xb2d3721a
166.73,1.0,20,1,2,2,5,0xb2d54acd
1056.96,1.0,92,1,2,1,4,0xb2d1ad10
4804.51,1.0,10,2,2,3,7,0xb2d393e7
10249.81,1.0,0,2,2,4,8,0xb2d6ba41
500000.0,3.0,15,4,4,3,11,0xb2da0a7e
11747.67,1.0,3,2,2,4,8,0xb2d6e87c
9811.07,1.0,15,2,2,3,7,0xb2d85b97
160133.36,2.0,123,3,3,1,7,0xb2d2fe61
450000.44,2.0,25,4,3,2,9,0xb2d9cc70
50001.06,2.0,11,2,3,3,8,0xb2da417c
13.16,1.0,26,1,2,2,5,0xb2d57fbf
576000.86,6.0,5,4,4,3,11,0xb2d91a39
407010.55,4.0,10,4,4,3,11,0xb2d1a08c
301700.42,4.0,56,4,4,2,10,0xb2d17765
1001.35,1.0,138,1,2,1,4,0xb2d91a18
70002.74,2.0,28,3,3,2,8,0xb2da0afc
1918947.58,15.0,0,4,4,4,12,0xb2d0694d
2400.13,1.0,1,1,2,4,7,0xb2d790dd
410611.74,5.0,24,4,4,2,10,0xb2d6174d
213502.45,1.0,0,3,2,4,9,0xb2d21109
291643.44,3.0,11,3,4,3,10,0xb2d1a6ca
592768.31,3.0,18,4,4,2,10,0xb2d0bc07
63369.83,1.0,0,3,2,4,9,0xb2d5304e
16334.27,1.0,14,2,2,3,7,0xb2d4879d
20000.21,2.0,74,2,3,1,6,0xb2d99f8e
17.12,1.0,47,1,2,2,5,0xb2d9ce3e
1053.15,1.0,4,1,2,4,7,0xb2d54eca
374348.45,4.0,63,4,4,2,10,0xb2d694e8
450000.0,2.0,3,4,3,4,11,0xb2d5baf4
12.67,1.0,25,1,2,2,5,0xb2d93f0b
46.13,1.0,63,1,2,2,5,0xb2d37bb0d
20000.63,2.0,14,2,3,3,8,0xb2da36cf
510.95,1.0,23,1,2,2,5,0xb2d6d94b
503628.71,2.0,32,4,3,2,9,0xb2d60226
110008.52,3.0,77,3,4,1,8,0xb2d63ae3
2722.21,1.0,173,1,2,1,4,0xb2d52004
0.0,1.0,3,1,2,4,7,0xb2d0c524
27.1,1.0,67,1,2,1,4,0xb2d40146
250023.65,5.0,12,3,4,3,10,0xb2d5c243
316457.01,10.0,1,4,4,4,12,0xb2d21348
1049927.01,5.0,8,4,4,3,11,0xb2d248ec
70613.08,1.0,0,3,2,4,9,0xb2d53a58
87.29,2.0,36,1,3,2,6,0xb2d0a644
1368299.93,18.0,0,4,4,4,12,0x3b9b17e9
800000.0,2.0,1,4,3,4,11,0xb2da6598
510000.0,6.0,3,4,4,4,12,0xb2d9b26e
897017.3,1.0,187,4,2,1,7,0x3b9b1882
51409.71,1.0,4,2,2,4,8,0xb2d56600
8304.95,1.0,10,2,2,3,7,0xb2d6b0b4
1415.27,1.0,22,1,2,2,5,0xb2d6ab9e
15583.54,1.0,92,2,2,1,5,0xb2d45eb7
641.81,1.0,82,1,2,1,4,0xb2d29397d
100032.82,2.0,41,3,3,2,8,0xb2d27106
110001.16,2.0,76,3,3,1,7,0xb2d8dcf8
2334.38,1.0,10,1,2,3,6,0xb2d4b35b
92.22,1.0,20,1,2,2,5,0xb2d37a8a
120061.04,7.0,19,3,4,2,9,0xb2d08b20d
446375.82,4.0,92,4,4,1,9,0xb2d4e774
11380.55,1.0,5,2,2,3,7,0xb2d371f3
718638.42,1.0,4,4,2,4,10,0xb2d59568
250.66,1.0,116,1,2,1,4,0xb2d4c066
70067.33,2.0,136,3,3,1,7,0xb2d547f9
324183.1,3.0,39,4,4,2,10,0xb2d14de6
203179.56,14.0,0,3,4,4,11,0xb2d2473d
1012.01,1.0,184,1,2,1,4,0xb2d25241
250005.28,3.0,24,3,4,2,9,0xb2d161ba
80004.84,3.0,83,3,4,1,8,0xb2d432cf
859272.96,6.0,14,4,4,3,11,0xb2d25628
6.47,1.0,5,1,2,3,6,0xb2d9541d
920006.67,8.0,6,4,4,3,11,0xb2d52399d
30048.2,1.0,5,2,2,3,7,0xb2d6264cd
110000.84,2.0,1,3,3,4,10,0xb2d63ec5
10478.06,1.0,0,2,2,4,8,0xb2d210d3
1015.22,1.0,92,1,2,1,4,0xb2d105f2
4.27,1.0,9,1,2,3,6,0xb2d68b6b
46519.89,1.0,34,2,2,2,6,0xb2d6964d
17485.41,1.0,130,2,2,1,5,0xb2d744db
814633.76,11.0,5,4,4,3,11,0xb2d6b959
170009.79,2.0,0,3,3,4,10,0xb2d58f3c
25.07,1.0,154,1,2,1,4,0xb2d691d2
131253.87,2.0,8,3,3,3,9,0xb2d3dbd9
12025.83,1.0,257,2,2,1,5,0xb2d3fb6ad
2581.05,1.0,92,1,2,1,4,0xb2d3939f
100005.76,2.0,19,3,3,2,8,0xb2d626ad
4.75,1.0,28,1,2,2,5,0xb2d93fab
118321.27,1.0,22,3,2,2,7,0xb2d55d99
4353.23,1.0,0,2,2,4,8,0xb2d8d02c
150020.59,2.0,101,3,3,1,7,0xb2d22770
101.47,1.0,25,1,2,2,5,0xb2d9c7f8
0.0,1.0,1,1,2,4,7,0xb2d56cc4
495.47,2.0,0,1,3,4,8,0xb2d48b67
164151.41,4.0,75,3,4,1,8,0xb2d0dcd0
50567.79,1.0,92,2,2,1,5,0xb2d0c546d
53469.47,1.0,15,3,2,3,8,0xb2d38c9f
588021.65,4.0,0,4,4,4,12,0xb2d3f48f
400148.1,2.0,39,4,3,2,9,0xb2d1a6b9
3105.68,1.0,20,2,2,2,6,0xb2d96828
98935.5,1.0,41,3,2,2,7,0xb2d2a9c6
62001.02,3.0,13,3,4,3,10,0xb2d99957
330.7,1.0,20,1,2,2,5,0xb2d30416
2355.96,1.0,184,1,2,1,4,0xb2d4712a
5927.39,1.0,1,2,2,4,8,0xb2d17d5e
387058.61,6.0,36,4,4,2,10,0xb2d5e7b3
40936.01,4.0,0,2,4,4,10,0xb2d6a35a
321080.34,3.0,38,4,4,2,10,0xb2d1ace7
1027.04,1.0,184,1,2,1,4,0xb2d2e15a
379149.31,2.0,33,4,3,2,9,0xb2d1e193
8.88,1.0,27,1,2,2,5,0xb2d690ca
250016.04,2.0,16,3,3,2,8,0xb2d99941
509549.95,6.0,11,4,4,3,11,0xb2d12e43
66.03,1.0,16,1,2,2,5,0xb2d52207
23000.25,3.0,18,2,4,2,8,0xb2d932de
640000.0,2.0,5,4,3,3,10,0xb2d95099
2471.48,1.0,118,1,2,1,4,0xb2d2f20bd
115001.21,2.0,25,3,3,2,8,0xb2da148a
256.18,1.0,9,1,2,3,6,0xb2d90845
1935429.4,8.0,0,4,4,4,12,0xb2d4b623
107950.44,4.0,0,3,4,4,11,0x3b9b2cb9
8829.57,1.0,11,2,2,3,7,0xb2d96599
50167.83,2.0,92,2,3,1,6,0xb2d35039
2108.82,1.0,184,1,2,1,4,0xb2d2cf38
1544.25,1.0,4,1,2,4,7,0xb2d8ca91
378000.0,9.0,0,4,4,4,12,0xb2d16d91
29912.09,1.0,10,2,2,3,7,0xb2d3e978
1428.22,1.0,184,1,2,1,4,0xb2d11fb4
46244.19,1.0,21,2,2,2,6,0xb2d63469
175.01,1.0,17,1,2,2,5,0xb2d70828
72171.32,1.0,0,3,2,4,9,0xb2d5abfd
1286.23,1.0,184,1,2,1,4,0xb2d0fa6ad
6544.68,1.0,126,2,2,1,5,0xb2d2a2cf
80002.21,2.0,53,3,3,2,8,0xb2d9cda0
100101.71,3.0,123,3,4,1,8,0xb2d93974
846.92,1.0,0,1,2,4,7,0xb2d9958a
915.32,1.0,10,1,2,3,6,0xb2d79035
64159.69,1.0,6,3,2,3,8,0xb2d0e732
50836.96,2.0,125,2,3,1,6,0xb2d58f29
15.83,1.0,60,1,2,2,5,0xb2d8fe04
901.2,1.0,14,1,2,3,6,0xb2d31de3
1304.43,1.0,1,1,2,4,7,0xb2d541cf
50938.5,2.0,24,2,3,2,7,0xb2d65a01
7482.87,1.0,28,2,2,2,6,0xb2d37d13
390145.05,3.0,1,4,4,4,12,0xb2d67ed3
500000.0,2.0,11,4,3,3,10,0xb2d9692f
12760.75,1.0,1,2,2,4,8,0xb2d262bd
595.56,1.0,1,1,2,4,7,0xb2d57722
80000.84,2.0,18,3,3,2,8,0xb2da2ed2
4150.9,1.0,279,2,2,1,5,0xb2d293ec
1282138.78,5.0,46,4,4,2,10,0xb2d42f57
10000.53,2.0,90,2,3,1,6,0xb2d6f67a
4.22,1.0,67,1,2,1,4,0xb2d8ed92
950611.31,9.0,0,4,4,4,12,0xb2d19d25
49.77,1.0,12,1,2,3,6,0xb2d132f0
508172.42,4.0,14,4,4,3,11,0xb2d064f2
5692.66,1.0,41,2,2,2,6,0xb2d3caad
183082.74,3.0,26,3,4,2,9,0xb2d0a394
8500.0,2.0,1,2,3,4,9,0xb2d0886c
6798.81,1.0,92,2,2,1,5,0xb2d29380
3240.39,1.0,0,2,2,4,8,0xb2d20ba3
400012.67,3.0,66,4,4,2,10,0xb2d477a7
1750.49,1.0,92,1,2,1,4,0xb2d4743d
377.1,1.0,29,1,2,2,5,0xb2d52224
194.22,1.0,56,1,2,2,5,0xb2d7e761
1078.15,1.0,92,1,2,1,4,0xb2d2cd3f
70155.72,3.0,206,3,4,1,8,0xb2d0723b
50951.62,1.0,1,2,2,4,8,0xb2d3903f
55.28,1.0,11,1,2,3,6,0xb2d923ad
137883.6,2.0,0,3,3,4,10,0xb2d6f70e
3413.95,1.0,174,2,2,1,5,0xb2d5f329
6147.69,1.0,214,2,2,1,5,0xb2d3f34c
8326.24,3.0,1,2,4,4,10,0x3b9b3c6c
250400.05,4.0,0,3,4,4,11,0xb2d5e190
1598.56,1.0,1,1,2,4,7,0xb2d90061
355248.81,4.0,77,4,4,1,9,0xb2d2b423
1359.65,1.0,17,1,2,2,5,0xb2d59b50
200047.87,2.0,10,3,3,3,9,0xb2d67e7a
0.0,1.0,7,1,2,3,6,0xb2d58648
0.71,1.0,53,1,2,2,5,0xb2d6aab9
86592.6,3.0,0,3,4,4,11,0xb2d9d3a7
11018.21,1.0,0,2,2,4,8,0xb2d2f82b
200042.46,2.0,5,3,3,3,9,0xb2d913cf
100000.0,1.0,0,3,2,4,9,0xb2da6b52
18522.53,2.0,0,2,3,4,9,0xb2d697bf
150001.59,4.0,4,3,4,4,11,0xb2da164e
111.98,1.0,0,1,2,4,7,0xb2d34487
801.8,1.0,27,1,2,2,5,0xb2d1704c
137147.35,4.0,5,3,4,3,10,0xb2d7045a
110847.42,5.0,0,3,4,4,11,0xb2d6c3c4
12645.61,1.0,18,2,2,2,6,0xb2d69b38
311102.13,2.0,27,4,3,2,9,0xb2d46611
1966820.25,9.0,0,4,4,4,12,0x3b9b18f3
50001.58,2.0,92,2,3,1,6,0xb2d64446
89532.5,1.0,0,3,2,4,9,0xb2d96872
1801.34,1.0,21,1,2,2,5,0xb2d6af79
104247.75,3.0,98,3,4,1,8,0xb2d282b4
2042.87,1.0,10,1,2,3,6,0xb2d92d1f
804514.01,7.0,1,4,4,4,12,0x3b9b49d2
2481.36,1.0,17,1,2,2,5,0xb2d2db29d
268462.35,3.0,52,3,4,2,9,0xb2d33b16
500000.0,6.0,0,4,4,4,12,0xb2d4b8fa
720015.2,2.0,10,4,3,3,10,0xb2d91e83
12901.13,2.0,24,2,3,2,7,0xb2d91ce7
281989.38,2.0,61,3,3,2,8,0xb2d98149
800020.09,4.0,132,4,4,1,9,0xb2d6ef37
2284.84,1.0,0,1,2,4,7,0xb2d2b5cbd
6570.13,1.0,26,2,2,2,6,0xb2d57b03
2100000.0,3.0,4,4,4,4,12,0xb2d67e29
989.74,1.0,1,1,2,4,7,0xb2d39565
19525.38,2.0,10,2,3,3,8,0xb2d4e12e
863.33,1.0,11,1,2,3,6,0xb2d0b3a2
350000.0,6.0,0,4,4,4,12,0xb2d40a3f
523177.74,5.0,78,4,4,1,9,0xb2d0f967
2832.65,1.0,0,1,2,4,7,0xb2d787a3
1773.15,5.0,39,1,4,2,7,0x3b9b1839
201629.47,5.0,10,3,4,3,10,0xb2d08032
200003.16,3.0,9,3,4,3,10,0xb2d5573e
0.01,2.0,1,1,3,4,8,0xb2d2bb06d
151702.67,2.0,95,3,3,1,7,0xb2d41fcc
1302.66,1.0,25,1,2,2,5,0xb2d1dc63
510207.15,5.0,20,4,4,2,10,0xb2d91529d
200319.48,3.0,3,3,4,4,11,0xb2d57f04
929.49,1.0,19,1,2,2,5,0xb2d666a8
0.0,1.0,10,1,2,3,6,0xb2d6433e
7011.33,1.0,9,2,2,3,7,0xb2d315fa
523553.07,5.0,4,4,4,4,12,0xb2d06560
1265.84,1.0,48,1,2,2,5,0xb2d319e7
2376.55,1.0,184,1,2,1,4,0xb2d083ea
8385.41,1.0,0,2,2,4,8,0xb2d62578
40012.25,2.0,185,2,3,1,6,0xb2d3a621
491053.15,4.0,9,4,4,3,11,0xb2d65370d
600093.8,2.0,27,4,3,2,9,0xb2d7830c
1400428.56,1.0,39,4,2,2,8,0xb2d9a7b2
850832.99,10.0,10,4,4,3,11,0xb2d3a7fcd
2011.73,2.0,0,1,3,4,8,0xb2d152fa
270143.31,3.0,18,3,4,2,9,0xb2d62e1d
111248.79,2.0,39,3,3,2,8,0xb2d8d28a
667071.66,3.0,82,4,4,1,9,0xb2d65913
304270.17,3.0,133,4,4,1,9,0xb2d83469
455267.5,5.0,34,4,4,2,10,0xb2d56492
1195.87,1.0,0,1,2,4,7,0xb2d5bde3
222.72,1.0,10,1,2,3,6,0xb2d3e91ed
60135.87,4.0,1,3,4,4,11,0xb2d408e7d
176003.0,4.0,0,3,4,4,11,0xb2d3cb97
555028.32,3.0,20,4,4,2,10,0xb2d16b62
1405697.39,3.0,85,4,4,1,9,0xb2d90a28
1300087.26,5.0,2,4,4,4,12,0xb2d206dd
16.6,1.0,42,1,2,2,5,0xb2d5a5f2
1655.32,2.0,184,1,3,1,5,0x3b9b309d
2.81,1.0,11,1,2,3,6,0xb2da29be
602613.88,2.0,194,4,3,1,8,0xb2d1b23e
30403.61,3.0,94,2,4,1,7,0xb2d5e81c
95496.45,1.0,0,3,2,4,9,0xb2d61fc3
110001.16,2.0,199,3,3,1,7,0xb2d69a8d
18143.11,1.0,43,2,2,2,6,0xb2d15119
110971.44,2.0,1,3,3,4,10,0x3b9af15a
0.0,1.0,8,1,2,3,6,0xb2d5edee
1513.78,1.0,184,1,2,1,4,0xb2d1f2d5d
7425.73,1.0,0,2,2,4,8,0xb2d28cdd
1451110.63,5.0,2,4,4,4,12,0xb2d683f2
150130.19,2.0,92,3,3,1,7,0xb2d17f83
2905.91,2.0,10,2,3,3,8,0xb2d12abfd
601396.79,3.0,15,4,4,3,11,0xb2d90410
201421.06,2.0,71,3,3,1,7,0xb2d9a47e
1607178.26,9.0,0,4,4,4,12,0xb2d5e2cbd
20000.51,2.0,169,2,3,1,6,0xb2d6b4c0
13137.76,1.0,18,2,2,2,6,0xb2d95fbc
309006.81,12.0,1,4,4,4,12,0xb2d92854
508262.13,5.0,18,4,4,2,10,0xb2d6357b
81561.49,3.0,189,3,4,1,8,0xb2d0a795
88.9,1.0,12,1,2,3,6,0xb2d2aeeb
50013.72,1.0,36,2,2,2,6,0xb2d9f95f
320126.64,1.0,1,4,2,4,10,0xb2d5fc2e
105983.57,1.0,139,3,2,1,6,0xb2d6ad57
226051.34,16.0,80,3,4,1,8,0xb2d06860
640000.31,3.0,1,4,4,4,12,0xb2d0d421
1712.07,1.0,138,1,2,1,4,0xb2d62b4f
305448.33,3.0,22,4,4,2,10,0xb2d57872
3219.02,1.0,0,2,2,4,8,0xb2d8f1dc
54000.0,2.0,8,3,3,3,9,0xb2d2f2fe
52975.27,2.0,294,3,3,1,7,0xb2d1b8ca
399.66,1.0,110,1,2,1,4,0xb2d50dc4
320017.56,3.0,235,4,4,1,9,0xb2d5b4f3
143.18,1.0,63,1,2,2,5,0xb2d6d484
527017.25,3.0,139,4,4,1,9,0xb2d0c38b
28043.48,1.0,21,2,2,2,6,0xb2d60f80
119760.87,3.0,59,3,4,2,9,0xb2d27ab1
15000.0,2.0,92,2,3,1,6,0xb2d60072
0.48,1.0,12,1,2,3,6,0xb2d551ff
1718.87,1.0,24,1,2,2,5,0xb2d2cc2e
406.64,1.0,3,1,2,4,7,0xb2d24d68
110041.87,3.0,70,3,4,1,8,0xb2d5ba05
290000.0,2.0,19,3,3,2,8,0xb2d9586d
51272.21,2.0,118,2,3,1,6,0xb2d5df77
17.39,1.0,56,1,2,2,5,0xb2d69b9d
272778.73,4.0,49,3,4,2,9,0xb2d25b7d
0.16,1.0,6,1,2,3,6,0xb2d8c9c3
1.07,1.0,15,1,2,3,6,0xb2d63cb4
1128.53,1.0,184,1,2,1,4,0xb2d26119
4002.27,1.0,19,2,2,2,6,0xb2d6b713
528290.29,2.0,70,4,3,1,8,0xb2d1eb07
110047.42,3.0,67,3,4,1,8,0xb2d0e5e9
1006.03,1.0,184,1,2,1,4,0xb2d3133f
50318.57,2.0,4,2,3,4,9,0xb2d6599a
50918.35,2.0,11,2,3,3,8,0xb2d14fdc
200043.16,2.0,19,3,3,2,8,0xb2d6dbaf
73212.95,2.0,76,3,3,1,7,0xb2d50e2d
2648294.37,8.0,11,4,4,3,11,0xb2d1bd74
11.03,9.0,42,1,4,2,7,0xb2d2da77
15712.08,1.0,24,2,2,2,6,0xb2d8c48d
2035.3,1.0,0,1,2,4,7,0xb2d55147
725007.3,3.0,63,4,4,2,10,0xb2d62708
1290080.05,3.0,5,4,4,3,11,0xb2d40334
105045.77,3.0,3,3,4,4,11,0xb2d40f5d
2310.76,1.0,184,1,2,1,4,0xb2d1a1fd
24.21,1.0,208,1,2,1,4,0xb2d4af81
40847.74,5.0,0,2,4,4,10,0xb2d5a63a
250089.31,2.0,216,3,3,1,7,0xb2d19b51
28485.46,1.0,12,2,2,3,7,0xb2d58b5c
19996.72,3.0,92,2,4,1,7,0x3b9ada37
4525.52,1.0,27,2,2,2,6,0xb2d42100
423.39,1.0,89,1,2,1,4,0xb2d228c0
125.52,1.0,6,1,2,3,6,0xb2d6f80f
56318.78,2.0,1,3,3,4,10,0xb2d61e99
4.44,1.0,83,1,2,1,4,0xb2d6e962
120015.03,2.0,165,3,3,1,7,0xb2d065c8
1409.98,1.0,92,1,2,1,4,0xb2d5ddd3
237129.45,4.0,24,3,4,2,9,0xb2d60167
402153.78,2.0,23,4,3,2,9,0xb2d8d2fa
7132.28,1.0,0,2,2,4,8,0xb2d6b19c
1182.91,1.0,184,1,2,1,4,0xb2d2ddedd
30188.16,1.0,297,2,2,1,5,0xb2d5dc13
2193.1,1.0,21,1,2,2,5,0xb2d5c7ff
113237.32,3.0,90,3,4,1,8,0xb2d08a09
237747.53,2.0,17,3,3,2,8,0xb2d5a623
181596.74,3.0,108,3,4,1,8,0xb2d5e756
17468.63,1.0,38,2,2,2,6,0xb2d744dbd
1.86,1.0,52,1,2,2,5,0xb2d22190
1286.4,1.0,92,1,2,1,4,0xb2d34d6a
621484.1,5.0,186,4,4,1,9,0xb2d4e752
252.5,1.0,25,1,2,2,5,0xb2d90fb1
5229.51,1.0,92,2,2,1,5,0xb2d0794c
300698.89,2.0,55,4,3,2,9,0xb2d13aecd
351656.18,3.0,47,4,4,2,10,0xb2d39b10
0.0,1.0,7,1,2,3,6,0xb2d68e03
730001.44,7.0,6,4,4,3,11,0xb2d43f7e
16819.1,2.0,27,2,3,2,7,0xb2d0d6c5
4.18,1.0,29,1,2,2,5,0xb2d30e69
120003.4,4.0,0,3,4,4,11,0xb2d94766
51394.53,2.0,6,2,3,3,8,0xb2d64778
50005.06,2.0,97,2,3,1,6,0xb2d85705
35.7,1.0,69,1,2,1,4,0xb2d33a5fd
126829.96,3.0,34,3,4,2,9,0xb2d26d0e
20.89,1.0,1,1,2,4,7,0xb2d95771
4056.75,1.0,0,2,2,4,8,0xb2d699e2d
4188686.75,8.0,24,4,4,2,10,0xb2d2e1da
3203.84,1.0,14,2,2,3,7,0xb2d7ee54
2020993.82,6.0,4,4,4,4,12,0xb2d2b3dc
360220.19,4.0,0,4,4,4,12,0xb2d4434d
191800002.0,3.0,295,4,4,1,9,0xb2d4a6a2
257125.0,2.0,21,3,3,2,8,0xb2d093fe
180003.02,3.0,0,3,4,4,11,0xb2d5f048
200031.28,2.0,13,3,3,3,9,0xb2d960ee
3760.75,6.0,103,2,4,1,7,0xb2d8d1fb
70330.72,2.0,11,3,3,3,9,0xb2d47d20
0.0,1.0,9,1,2,3,6,0xb2d9f998
400015.34,5.0,28,4,4,2,10,0xb2d9f8ae
5043.81,1.0,20,2,2,2,6,0xb2d1bf82
87.48,1.0,67,1,2,1,4,0xb2d52b3e
18813.69,1.0,2,2,2,4,8,0xb2d1c02e
3.17,1.0,12,1,2,3,6,0xb2d95bff
2542.72,1.0,10,1,2,3,6,0xb2d9ca56
10000.21,2.0,74,2,3,1,6,0xb2d99d26
1778463.15,6.0,4,4,4,4,12,0xb2d2468d
7831.15,1.0,5,2,2,3,7,0xb2d6e00b
5.49,1.0,25,1,2,2,5,0xb2d18cea
33875.32,2.0,0,2,3,4,9,0xb2d2fec1
170018.39,3.0,108,3,4,1,8,0xb2d5ba09
157726.36,1.0,1,3,2,4,9,0xb2d66390
1525.29,1.0,5,1,2,3,6,0xb2d2f034
218377.09,1.0,3,3,2,4,9,0xb2d41439
965122.03,4.0,0,4,4,4,12,0xb2d27f8b
301006.42,3.0,14,4,4,3,11,0xb2d681f9
31002.3,1.0,10,2,2,3,7,0xb2d56443
994.36,1.0,10,1,2,3,6,0xb2d4337c
997829.93,3.0,6,4,4,3,11,0xb2d43637
22302.37,1.0,3,2,2,4,8,0xb2d6bda7
5218.38,1.0,1,2,2,4,8,0xb2d32118
30050.34,2.0,46,2,3,2,7,0xb2d5c3a8
295.47,1.0,22,1,2,2,5,0xb2d53d80
1133483.53,10.0,0,4,4,4,12,0xb2d626ced
100013.65,3.0,39,3,4,2,9,0xb2d0d928d
1183187.13,1.0,21,4,2,2,8,0xb2d13952
50040.27,2.0,171,2,3,1,6,0xb2d1cc46
533532.92,5.0,3,4,4,4,12,0xb2d4d1a4
43.14,2.0,10,1,3,3,7,0xb2d2f614d
605.78,1.0,208,1,2,1,4,0xb2d0b543
8364.01,1.0,0,2,2,4,8,0xb2d33b31
458963.16,4.0,0,4,4,4,12,0xb2d91545
53269.59,2.0,3,3,3,4,10,0xb2d4d92f
200192.09,4.0,11,3,4,3,10,0xb2d55dfb
2600110.04,5.0,25,4,4,2,10,0xb2d0dcd1
19501.58,1.0,204,2,2,1,5,0xb2d4c27b
1983.93,1.0,184,1,2,1,4,0xb2d1246e
416390.17,3.0,2,4,4,4,12,0xb2d290e1
8573.84,1.0,0,2,2,4,8,0xb2d6ee91
22155.0,1.0,15,2,2,3,7,0xb2d2e9ae
30000.95,4.0,80,2,4,1,7,0xb2d7d54b
278.52,1.0,28,1,2,2,5,0xb2d91eb1
35177.13,1.0,24,2,2,2,6,0xb2d69d95
1189.89,1.0,92,1,2,1,4,0xb2d1d3d9
3124.04,1.0,4,2,2,4,8,0xb2d4e612
50.07,1.0,49,1,2,2,5,0xb2d40ea6
695.52,1.0,60,1,2,2,5,0xb2d147c0
48.46,1.0,9,1,2,3,6,0xb2d278fa
50772.86,2.0,48,2,3,2,7,0xb2d13f64
2301.04,1.0,0,1,2,4,7,0xb2d6fe92
52673.76,2.0,74,3,3,1,7,0xb2d548ba
2352011.29,11.0,27,4,4,2,10,0xb2d1be1a
335493.62,4.0,20,4,4,2,10,0xb2d58398
17195.4,1.0,1,2,2,4,8,0xb2d791b6
1140000.0,15.0,0,4,4,4,12,0xb2d56fbd
690088.88,4.0,5,4,4,3,11,0xb2d5bcc2
1006.89,1.0,92,1,2,1,4,0xb2d2a5fdd
140005.91,2.0,14,3,3,3,9,0xb2da356a
200000.0,2.0,0,3,3,4,10,0xb2d900e0
307.24,1.0,9,1,2,3,6,0xb2d390a2
19017.15,1.0,7,2,2,3,7,0x3b9af53d
100014.35,2.0,6,3,3,3,9,0xb2d4f4f7
868332.21,6.0,5,4,4,3,11,0xb2d43a14
5206.69,1.0,92,2,2,1,5,0xb2d150bb
2319.93,1.0,0,1,2,4,7,0xb2d599c6
35884.36,2.0,0,2,3,4,9,0xb2d906cd
225875.87,2.0,69,3,3,1,7,0xb2d6085b
38007.37,5.0,71,2,4,1,7,0xb2d31b7a
78185.87,2.0,80,3,3,1,7,0xb2d1c931
6.33,1.0,81,1,2,1,4,0xb2d8d20a
7570.24,1.0,2,2,2,4,8,0xb2d4094f
1003.39,1.0,184,1,2,1,4,0xb2d6586c
333119.78,3.0,0,4,4,4,12,0xb2d5f1d0
336547.45,4.0,184,4,4,1,9,0xb2d0a429
4915.61,1.0,0,2,2,4,8,0xb2d4cb28
579713.5,4.0,3,4,4,4,12,0xb2d1fc67
131842.64,3.0,184,3,4,1,8,0xb2d1a6aa
8759.36,1.0,3,2,2,4,8,0xb2d302e6
2269.23,1.0,184,1,2,1,4,0xb2d161b2
20000.21,2.0,32,2,3,2,7,0xb2da031e
1000158.02,2.0,13,4,3,3,10,0xb2d368a9
122465.72,3.0,143,3,4,1,8,0xb2d5b5f1
5473.54,1.0,21,2,2,2,6,0xb2d20f90
1148.86,1.0,1,1,2,4,7,0xb2d1d225
52125.22,1.0,9,2,2,3,7,0xb2d2b404
435.82,1.0,2,1,2,4,7,0xb2d35e96
233058.45,2.0,13,3,3,3,9,0xb2d410d3
27657.69,1.0,0,2,2,4,8,0xb2d5a5d9
204659.34,4.0,0,3,4,4,11,0xb2d1be07
8.03,1.0,3,1,2,4,7,0xb2d8d2ef
541.0,1.0,25,1,2,2,5,0xb2d32191
751626.97,4.0,0,4,4,4,12,0xb2d9a0e2
12424.46,1.0,0,2,2,4,8,0xb2d78cd2
317991.89,1.0,9,4,2,3,9,0xb2d35468
5069.07,2.0,184,2,3,1,6,0xb2d20387
0.0,3.0,4,1,4,4,9,0xb2d15c34
370101.23,5.0,122,4,4,1,9,0xb2d634b2
60760.49,1.0,1,3,2,4,9,0xb2d205c1
1013156.3,6.0,13,4,4,3,11,0xb2d5ba9a
2400027.47,5.0,7,4,4,3,11,0xb2d6c74f
201553.88,2.0,22,3,3,2,8,0xb2d6bc7e
13297.31,1.0,15,2,2,3,7,0xb2d4dd24
1.89,1.0,2,1,2,4,7,0xb2d583c8
100029.45,1.0,0,3,2,4,9,0xb2d41387
713661.19,16.0,0,4,4,4,12,0xb2d29c1b
500022.98,2.0,9,4,3,3,10,0xb2d6a0db
1871.54,1.0,9,1,2,3,6,0xb2d41bed
87238.19,2.0,0,3,3,4,10,0xb2d78f19
227.03,1.0,9,1,2,3,6,0xb2d49097
113170.61,1.0,5,3,2,3,8,0xb2d3a35f
130995.93,1.0,7,3,2,3,8,0xb2d17a16
21.69,1.0,18,1,2,2,5,0xb2d37e05
17767.28,1.0,15,2,2,3,7,0xb2d8ee6c
201421.07,3.0,4,3,4,4,11,0xb2d8c68b
1.16,2.0,5,1,3,3,7,0xb2d6d7a4
11528.33,1.0,184,2,2,1,5,0xb2d10336
370996.29,1.0,0,4,2,4,10,0xb2d9f2fc
98154.76,2.0,95,3,3,1,7,0xb2d64e8a
250042.98,3.0,92,3,4,1,8,0xb2d26fc2
22.17,1.0,53,1,2,2,5,0xb2d96d2b
10300.54,1.0,95,2,2,1,5,0xb2d651eb
124.39,1.0,11,1,2,3,6,0xb2d3e848
360305.29,4.0,46,4,4,2,10,0xb2d54931d
90001.6,4.0,39,3,4,2,9,0xb2d124c9
869304.78,5.0,0,4,4,4,12,0xb2d248ba
1472.2,1.0,8,1,2,3,6,0xb2d37367
198.36,1.0,18,1,2,2,5,0xb2d941d8
90344.72,1.0,3,3,2,4,9,0xb2d94acc
4813.2,1.0,216,2,2,1,5,0xb2d4f914
60605.03,5.0,0,3,4,4,11,0x3b9b472c
21632.69,1.0,10,2,2,3,7,0xb2d42ded
2552.98,1.0,0,1,2,4,7,0xb2d19c23
6767967.27,1.0,0,4,2,4,10,0xb2d67a3c
285730.52,4.0,4,3,4,4,11,0xb2d64692d
2248.43,1.0,92,1,2,1,4,0x3b9b3a8cd
2576.56,1.0,1,1,2,4,7,0xb2d321dcd
50001.58,2.0,10,2,3,3,8,0xb2d1afa7
750988.01,3.0,1,4,4,4,12,0xb2d9992a
105193.33,1.0,141,3,2,1,6,0xb2d37c4dd
94.56,1.0,62,1,2,2,5,0xb2d276e0
813000.0,2.0,12,4,3,3,10,0xb2d964f5
9353.54,1.0,92,2,2,1,5,0xb2d18161
51656.11,2.0,38,2,3,2,7,0xb2d5d505
7.28,1.0,92,1,2,1,4,0xb2d1b46f
508357.37,5.0,13,4,4,3,11,0xb2d5c263
250000.0,2.0,26,3,3,2,8,0xb2da1473
150034.67,3.0,52,3,4,2,9,0xb2d0dbc8
268923.25,5.0,0,3,4,4,11,0xb2d1d45f
47582.33,1.0,0,2,2,4,8,0xb2d26d08
10213.66,2.0,50,2,3,2,7,0xb2d1ef0b
938.57,1.0,10,1,2,3,6,0xb2d9301b
8462.39,1.0,1,2,2,4,8,0xb2d526c3
1060000.28,17.0,5,4,4,3,11,0xb2d15255
700058.8,2.0,0,4,3,4,11,0xb2d9cccb
5263.16,1.0,184,2,2,1,5,0xb2d1341c
1963.48,1.0,92,1,2,1,4,0xb2d13354
9677.9,1.0,11,2,2,3,7,0xb2d6b4cf
542644.62,1.0,0,4,2,4,10,0xb2d3e495d
330009.57,4.0,5,4,4,3,11,0xb2d4ee03
476073.59,8.0,13,4,4,3,11,0xb2d17861
4028.78,6.0,7,2,4,3,9,0xb2d4fe5f
500004.16,2.0,26,4,3,2,9,0xb2d90590
1376342.63,2.0,228,4,3,1,8,0xb2d263ce
71000.85,2.0,0,3,3,4,10,0xb2d6461d
76.61,1.0,18,1,2,2,5,0xb2d34158
50009.53,2.0,157,2,3,1,6,0xb2d18c1a
24001.27,2.0,56,2,3,2,7,0xb2d9bfc9
159908.2,2.0,108,3,3,1,7,0xb2d6067a
2035.75,1.0,6,1,2,3,6,0xb2d3e84cd
11637.91,1.0,11,2,2,3,7,0xb2d4ace6
710014.99,2.0,31,4,3,2,9,0xb2d93ade
1.06,1.0,18,1,2,2,5,0xb2d956e8
1727.15,1.0,11,1,2,3,6,0xb2d8e576
3598.04,1.0,9,2,2,3,7,0xb2d9c627
190076.89,6.0,8,3,4,3,10,0xb2d80e88
200002.11,2.0,48,3,3,2,8,0xb2d1aaf3d
534358.96,83.0,0,4,4,4,12,0x3b9b12c8
103863.99,2.0,231,3,3,1,7,0xb2d5385b
60.85,1.0,15,1,2,3,6,0xb2d3793d
792019.11,6.0,25,4,4,2,10,0xb2d16454
6804.48,1.0,4,2,2,4,8,0xb2d90a4d
186013.3,13.0,25,3,4,2,9,0xb2d1a2c0d
457068.69,7.0,8,4,4,3,11,0xb2d2ba3d
1075002.91,14.0,53,4,4,2,10,0xb2d180d5
103090.1,1.0,2,3,2,4,9,0xb2d2ed54
25263.57,1.0,4,2,2,4,8,0xb2d28e0b
18.31,1.0,3,1,2,4,7,0xb2d548a7
10937.68,1.0,92,2,2,1,5,0xb2d29031d
43.35,1.0,101,1,2,1,4,0xb2d1115d
180005.48,2.0,95,3,3,1,7,0xb2d53ccb
74371.43,3.0,3,3,4,4,11,0xb2d3bd79
233773.74,4.0,18,3,4,2,9,0xb2d28983
65287.24,2.0,87,3,3,1,7,0xb2d36830d
6875.05,1.0,1,2,2,4,8,0xb2d6b55a
7331.21,1.0,1,2,2,4,8,0xb2d69417
68061.53,2.0,158,3,3,1,7,0xb2d110a9
403457.97,1.0,8,4,2,3,9,0xb2d287ad
248.28,1.0,89,1,2,1,4,0xb2d2d537d
463980.93,5.0,3,4,4,4,12,0xb2d3ee77
233310.8,3.0,102,3,4,1,8,0xb2d5f8dd
93802.69,4.0,16,3,4,2,9,0x3b9af28fd
5008.18,1.0,33,2,2,2,6,0xb2d8e6ad
446941.75,4.0,32,4,4,2,10,0xb2d6b2e7
500000.0,3.0,10,4,4,3,11,0xb2d8e370
30894.8,1.0,74,2,2,1,5,0xb2d66a3d
292228.67,1.0,0,3,2,4,9,0xb2d2d989
4715.73,1.0,0,2,2,4,8,0xb2d2cf0f
67.75,1.0,13,1,2,3,6,0xb2d5dd2f
46.95,1.0,9,1,2,3,6,0xb2d3c1dd
239.15,1.0,0,1,2,4,7,0xb2d50a8c
90915.97,2.0,0,3,3,4,10,0xb2d88191
97000.0,2.0,8,3,3,3,9,0xb2da4e9c
1203238.92,5.0,26,4,4,2,10,0xb2d1cf34
1115248.88,5.0,25,4,4,2,10,0xb2d92622
8701.79,1.0,12,2,2,3,7,0xb2d4e888d
50623.12,1.0,182,2,2,1,5,0xb2d63629
85804.7,1.0,141,3,2,1,6,0xb2d3ba8b
1127.81,1.0,0,1,2,4,7,0xb2d0b1c1
12598.31,1.0,9,2,2,3,7,0xb2d5bf95
1299.59,1.0,119,1,2,1,4,0xb2d40198
210091.93,2.0,19,3,3,2,8,0xb2d99025
29.45,1.0,69,1,2,1,4,0xb2d6f27e
1929248.43,3.0,8,4,4,3,11,0xb2d406c7
300013.02,2.0,21,3,3,2,8,0xb2d638af
21900.0,1.0,3,2,2,4,8,0xb2d95e89
616249.73,4.0,108,4,4,1,9,0xb2d6a895
483046.14,8.0,1,4,4,4,12,0x3b9b3c59d
1000000.0,1.0,0,4,2,4,10,0xb2d75579
23277.02,1.0,9,2,2,3,7,0xb2d22422
74479.85,1.0,11,3,2,3,8,0xb2d39575
532313.37,3.0,40,4,4,2,10,0xb2d5e548
900005.16,3.0,7,4,4,3,11,0xb2d6476f
1443.36,2.0,10,1,3,3,7,0xb2d9164f
772918.93,4.0,3,4,4,4,12,0xb2d25a28
343366.26,4.0,47,4,4,2,10,0xb2d17753
538212.59,6.0,0,4,4,4,12,0xb2d3418cd
81.36,2.0,33,1,3,2,6,0xb2d77f9f
197.93,1.0,24,1,2,2,5,0xb2d28a37
201040.06,4.0,60,3,4,2,9,0xb2d6c3cc
70004.6,2.0,80,3,3,1,7,0xb2d5a6c4
380039.56,7.0,0,4,4,4,12,0xb2d0b111
500030.99,4.0,56,4,4,2,10,0xb2d6294b
15.49,1.0,14,1,2,3,6,0xb2d5e628d
2406602.12,6.0,39,4,4,2,10,0xb2d26194
879152.49,8.0,15,4,4,3,11,0xb2d10f96
17647.74,1.0,243,2,2,1,5,0xb2d0eaa4
980086.76,8.0,6,4,4,3,11,0xb2d645ce
2.11,1.0,89,1,2,1,4,0xb2d6362e
50279.12,2.0,48,2,3,2,7,0xb2d4f872
21558.89,1.0,1,2,2,4,8,0x3b9b3047
2163.93,1.0,184,1,2,1,4,0xb2d21197
184067.87,2.0,157,3,3,1,7,0xb2d185a6
20145.87,1.0,1,2,2,4,8,0xb2d39cdb
8.24,1.0,15,1,2,3,6,0xb2d7855b
7519.85,2.0,0,2,3,4,9,0x3b9b3a21d
5700043.82,18.0,52,4,4,2,10,0xb2d1fc21
29984.99,1.0,0,2,2,4,8,0xb2d6b7e7
300631.91,2.0,8,4,3,3,10,0xb2d6d0db
75115.39,3.0,55,3,4,2,9,0xb2d49e22
1114.03,1.0,92,1,2,1,4,0xb2d1db30
10001.53,2.0,34,2,3,2,7,0xb2d9f56f
39.45,1.0,18,1,2,2,5,0xb2d94b2c
3030765.09,4.0,31,4,4,2,10,0xb2d0f6f6
600062.92,2.0,9,4,3,3,10,0xb2d4f125
850350.79,3.0,34,4,4,2,10,0xb2d9895c
15009.52,2.0,92,2,3,1,6,0xb2d5f2dbd
25000.11,2.0,0,2,3,4,9,0xb2da396d
925387.99,9.0,0,4,4,4,12,0x3b9af160
0.0,1.0,9,1,2,3,6,0xb2d14b46
11.13,1.0,2,1,2,4,7,0xb2d5dc7f
1545.81,1.0,0,1,2,4,7,0xb2d54eee
9629.03,1.0,0,2,2,4,8,0xb2d451b6
441652.42,3.0,49,4,4,2,10,0xb2d91230
15127.5,1.0,92,2,2,1,5,0xb2d5c9a8d
3325.73,1.0,12,2,2,3,7,0xb2d62f55
5928.68,1.0,6,2,2,3,7,0xb2d744de
244.02,1.0,6,1,2,3,6,0xb2d1b59a
1871.9,1.0,0,1,2,4,7,0xb2d9d9dc
100001.06,3.0,31,3,4,2,9,0xb2d5559e
600000.61,4.0,5,4,4,3,11,0xb2d5d990d
202746.67,1.0,21,3,2,2,7,0xb2d2f172
100052.78,3.0,18,3,4,2,9,0xb2da2322
400000.42,3.0,0,4,4,4,12,0xb2d8d439d
350191.12,5.0,3,4,4,4,12,0xb2d4ac88
307395.63,2.0,112,4,3,1,8,0xb2d27b74
6204.56,1.0,22,2,2,2,6,0xb2d304c3d
50558.63,1.0,0,2,2,4,8,0xb2d4c5f7
501960.41,3.0,0,4,4,4,12,0xb2d6d73e
5936.93,1.0,119,2,2,1,5,0xb2d30ee1
687556.56,8.0,1,4,4,4,12,0xb2d179f5
25.47,1.0,184,1,2,1,4,0xb2d131b7
1943983.38,5.0,0,4,4,4,12,0xb2d4154dd
3354.84,1.0,92,2,2,1,5,0xb2d4ce1d
3.66,1.0,11,1,2,3,6,0xb2d823f4
940000.33,16.0,0,4,4,4,12,0xb2d55c10
2.25,1.0,101,1,2,1,4,0x3b9af45d
650092.56,5.0,6,4,4,3,11,0xb2d6a225
577239.99,1.0,1,4,2,4,10,0xb2d181fad
50444.93,2.0,139,2,3,1,6,0xb2d4b2db
504265.24,4.0,77,4,4,1,9,0xb2d94460
3886.6,13.0,0,2,4,4,10,0xb2d0647f
204073.36,7.0,14,3,4,3,10,0xb2d69085
10000.11,2.0,10,2,3,3,8,0xb2d96795
400000.0,2.0,5,4,3,3,10,0xb2da5cee
200000.0,2.0,8,3,3,3,9,0xb2d92eda
521746.67,3.0,0,4,4,4,12,0xb2d412d1
7053.79,1.0,8,2,2,3,7,0xb2d916e1
746447.69,2.0,83,4,3,1,8,0xb2d511c0
2871.12,1.0,10,1,2,3,6,0xb2d57246
13209.67,1.0,20,2,2,2,6,0xb2d69534
420026.91,3.0,73,4,4,1,9,0xb2d59a24
500000.04,2.0,8,4,3,3,10,0xb2d9f5d6
600005.08,2.0,20,4,3,2,9,0xb2d1d98e
3054.86,1.0,184,2,2,1,5,0xb2d29f4c
500000.28,2.0,15,4,3,3,10,0xb2d8d9e6
180025.97,4.0,10,3,4,3,10,0xb2d4e8ff
1000070.98,3.0,28,4,4,2,10,0xb2d700ae
439385.29,3.0,4,4,4,4,12,0xb2d2650a
1579.61,1.0,207,1,2,1,4,0xb2d40829d
413.67,1.0,20,1,2,2,5,0xb2d4c400
165284.46,4.0,25,3,4,2,9,0xb2d5851d
615021.04,5.0,70,4,4,1,9,0xb2d5df48
20560.89,1.0,2,2,2,4,8,0xb2d2b606
130022.86,2.0,39,3,3,2,8,0xb2d3497c
75310.6,7.0,0,3,4,4,11,0x3b9b1815
1111505.49,7.0,10,4,4,3,11,0xb2d1e7ff
50001.06,2.0,200,2,3,1,6,0xb2d78fd4
12531.04,2.0,204,2,3,1,6,0xb2d69f0a
670084.01,3.0,8,4,4,3,11,0xb2d56dfd
609466.99,3.0,94,4,4,1,9,0xb2d426df
700704.05,3.0,12,4,4,3,11,0xb2da39ef
57.58,1.0,53,1,2,2,5,0xb2d58d19
9.97,1.0,20,1,2,2,5,0xb2d2affe
561442.46,6.0,76,4,4,1,9,0xb2d07700
50103.0,2.0,18,2,3,2,7,0xb2d2ecc2
8104.42,2.0,184,2,3,1,6,0x3b9ad3b4
49173.74,7.0,0,2,4,4,10,0x3b9b28e5
450000.0,3.0,10,4,4,3,11,0xb2da4e70
509001.69,3.0,4,4,4,4,12,0xb2d5f570
501776.05,3.0,40,4,4,2,10,0xb2d9e7cc
359060.23,4.0,182,4,4,1,9,0xb2d62ea1
7773002.13,14.0,0,4,4,4,12,0x3b9b1915
504032.89,2.0,20,4,3,2,9,0xb2da24fb
3723.07,1.0,0,2,2,4,8,0xb2d964b3
13948.45,1.0,92,2,2,1,5,0xb2d2694fd
1065.65,1.0,11,1,2,3,6,0xb2d1c522
74505.92,1.0,0,3,2,4,9,0xb2d69118d
50883.2,4.0,184,2,4,1,7,0xb2d2a277
373897.96,6.0,4,4,4,4,12,0xb2d1723b
750039.2,1.0,1,4,2,4,10,0xb2d56fad
12.52,1.0,74,1,2,1,4,0xb2d59640
3675.36,1.0,7,2,2,3,7,0xb2d3137e
420031.77,2.0,92,4,3,1,8,0xb2d63328
103251.81,1.0,0,3,2,4,9,0xb2d5c878
1549489.42,3.0,97,4,4,1,9,0xb2d24399
260042.39,3.0,136,3,4,1,8,0xb2d5f23b
231404.76,5.0,0,3,4,4,11,0xb2d0cfa2
125000.22,9.0,3,3,4,4,11,0xb2d44f7ad
103818.12,2.0,92,3,3,1,7,0xb2d22258
7051.26,1.0,5,2,2,3,7,0xb2d69f3c
4000.0,1.0,6,2,2,3,7,0xb2d25c2b
681837.6,4.0,0,4,4,4,12,0xb2d64a4a
204.82,1.0,0,1,2,4,7,0xb2d261d4
913.44,1.0,13,1,2,3,6,0xb2d2739d
184474.38,4.0,0,3,4,4,11,0xb2d090bf
50719.78,2.0,1,2,3,4,9,0xb2d6e1b4
4249.31,1.0,165,2,2,1,5,0xb2d4414b
15470.89,1.0,9,2,2,3,7,0xb2d35c62
50000.53,2.0,38,2,3,2,7,0xb2d78a54
37097.85,1.0,49,2,2,2,6,0xb2d37cd1d
200714.12,2.0,33,3,3,2,8,0xb2d61a3d
5.78,1.0,75,1,2,1,4,0xb2d56368
322.04,1.0,1,1,2,4,7,0xb2d64e0d
4190.57,1.0,184,2,2,1,5,0x3b9b33a3
11.71,1.0,10,1,2,3,6,0xb2d58ed7
0.0,1.0,9,1,2,3,6,0xb2d3c951d
1078.5,1.0,184,1,2,1,4,0x3b9b439c
50000.61,2.0,6,2,3,3,8,0xb2d96b26
7.22,1.0,63,1,2,2,5,0xb2d6851e
3051.3,1.0,112,2,2,1,5,0xb2d8dfa1
61654.11,1.0,53,3,2,2,7,0xb2d5c557
6092.55,1.0,17,2,2,2,6,0xb2d90387
211.86,2.0,25,1,3,2,6,0xb2d9e232
0.3,1.0,2,1,2,4,7,0xb2d683e3
71287.77,2.0,184,3,3,1,7,0x3b9b405e
37353.73,3.0,0,2,4,4,10,0xb2d080a8
48060.34,1.0,0,2,2,4,8,0xb2d51f24d
1739.12,1.0,0,1,2,4,7,0xb2d60f71
16594.78,1.0,1,2,2,4,8,0xb2d5520c
189648.26,2.0,25,3,3,2,8,0xb2d616b7
59416.23,1.0,1,3,2,4,9,0xb2d6bf34
0.0,1.0,15,1,2,3,6,0xb2d5030c
200000.0,2.0,8,3,3,3,9,0xb2d15c47
209076.37,3.0,25,3,4,2,9,0xb2d07941
15048.73,1.0,92,2,2,1,5,0xb2d5ebab
1800038.0,2.0,80,4,3,1,8,0xb2d3eaff
93.03,1.0,14,1,2,3,6,0xb2d1cbd1
165003.86,3.0,18,3,4,2,9,0xb2d179d9d
53750.84,2.0,97,3,3,1,7,0xb2d0e420
35841.93,1.0,9,2,2,3,7,0xb2d629a3
367.1,1.0,60,1,2,2,5,0xb2d63775
49.04,1.0,2,1,2,4,7,0xb2d5d72f
61046.41,1.0,0,3,2,4,9,0xb2d18724d
504001.33,9.0,3,4,4,4,12,0xb2d4cf05
2158849.96,6.0,60,4,4,2,10,0xb2d3a4bbd
249.54,1.0,28,1,2,2,5,0xb2d5de77
82852.41,2.0,110,3,3,1,7,0xb2d0d999
5436.44,1.0,40,2,2,2,6,0xb2d92881
430018.2,2.0,210,4,3,1,8,0xb2d6454a
8019743.61,3.0,5,4,4,3,11,0xb2d2eaae
303198.59,2.0,110,4,3,1,8,0xb2d78757
7351.31,3.0,151,2,4,1,7,0x3b9b2458
10000.11,2.0,189,2,3,1,6,0xb2d85960
406603.83,6.0,3,4,4,4,12,0x3b9b443c
3117.74,1.0,0,2,2,4,8,0xb2d6b97c
955925.98,17.0,0,4,4,4,12,0xb2d23f1d
486.45,1.0,74,1,2,1,4,0xb2d5e92c
439442.1,5.0,1,4,4,4,12,0xb2d104e0
228.78,1.0,4,1,2,4,7,0xb2d34e9d
503485.76,5.0,0,4,4,4,12,0xb2d63248
1002.98,1.0,158,1,2,1,4,0xb2d4784b
5497.31,1.0,3,2,2,4,8,0xb2d31418
73.34,1.0,70,1,2,1,4,0xb2d3b57e
13.3,1.0,40,1,2,2,5,0xb2d98410
938125.24,9.0,4,4,4,4,12,0xb2d2048d
115127.8,3.0,4,3,4,4,11,0xb2d57a88
50241.67,1.0,184,2,2,1,5,0xb2d58e0a
500025.97,2.0,76,4,3,1,8,0xb2d40a09
5975.41,1.0,7,2,2,3,7,0xb2d4fdd6
1263067.14,4.0,3,4,4,4,12,0xb2d6f06d
85506.11,3.0,11,3,4,3,10,0xb2d11c74
17561.92,1.0,107,2,2,1,5,0xb2d28987
1399.96,1.0,0,1,2,4,7,0xb2d906c3
105000.01,2.0,21,3,3,2,8,0xb2d4e1ecd
3527.21,1.0,1,2,2,4,8,0xb2d552b9
49963.91,2.0,95,2,3,1,6,0xb2d7b017d
0.91,1.0,3,1,2,4,7,0xb2d5ce35
7671.97,1.0,1,2,2,4,8,0xb2d81fd4
125559.49,7.0,28,3,4,2,9,0xb2d80e5c
100003.17,2.0,31,3,3,2,8,0xb2d8e48ad
1562.43,1.0,158,1,2,1,4,0xb2d39040
452.76,2.0,14,1,3,3,7,0xb2d0b922
821.5,1.0,9,1,2,3,6,0xb2d5e69a
1017.88,1.0,184,1,2,1,4,0xb2d62658
2820.22,1.0,184,1,2,1,4,0xb2d4e15f
510700.0,10.0,4,4,4,4,12,0xb2d6592e
9120.77,2.0,92,2,3,1,6,0x3b9b0f59
140000.52,5.0,0,3,4,4,11,0xb2d625c8
20002.66,2.0,3,2,3,4,9,0xb2d8c607
30000.32,2.0,90,2,3,1,6,0xb2d8c3a2
200004.22,3.0,132,3,4,1,8,0xb2d91573d
993.23,1.0,4,1,2,4,7,0xb2d59486
60001.27,2.0,74,3,3,1,7,0xb2d99c0a
41.84,1.0,12,1,2,3,6,0xb2d6ed5c
2031.66,1.0,2,1,2,4,7,0xb2d1f990
2230056.95,2.0,139,4,3,1,8,0xb2d1fbbc
120007.93,2.0,168,3,3,1,7,0xb2d5cc1d
400321.76,3.0,0,4,4,4,12,0xb2d64f77
1025008.7,18.0,0,4,4,4,12,0xb2d2022e
14438.4,1.0,10,2,2,3,7,0xb2d5d534
105741.95,2.0,172,3,3,1,7,0xb2d3b73b
13772.16,1.0,29,2,2,2,6,0xb2d9294a
18192.62,1.0,96,2,2,1,5,0xb2d3bd3f
600006.34,2.0,129,4,3,1,8,0xb2d704ca
329825.51,3.0,13,4,4,3,11,0xb2d5ccbc
400030.55,2.0,0,4,3,4,11,0xb2da28ec
200008.53,4.0,10,3,4,3,10,0xb2d2ac2b
110426.2,2.0,21,3,3,2,8,0xb2d9b655
593.96,1.0,48,1,2,2,5,0xb2d16822
1300652.08,6.0,0,4,4,4,12,0xb2d6d8da
250000.0,2.0,27,3,3,2,8,0xb2da1257
15218.52,1.0,25,2,2,2,6,0xb2d942cb
3169.8,1.0,165,2,2,1,5,0xb2d3ef90
200003.17,2.0,133,3,3,1,7,0xb2d9107d
10344.23,1.0,9,2,2,3,7,0xb2d5cc68d
1794.67,1.0,9,1,2,3,6,0xb2d57966
233000.0,2.0,6,3,3,3,9,0xb2da5b89
166007.81,3.0,20,3,4,2,9,0xb2d940d0
83.44,1.0,21,1,2,2,5,0xb2d58ec4
2003.12,1.0,158,1,2,1,4,0xb2d8f626
254330.68,1.0,184,3,2,1,6,0xb2d09b58
574180.44,13.0,3,4,4,4,12,0xb2d558bd
285274.63,3.0,2,3,4,4,11,0xb2d23d78
7790.45,1.0,3,2,2,4,8,0xb2d8b2e9
200009.95,2.0,1,3,3,4,10,0xb2d65552
512309.19,2.0,31,4,3,2,9,0xb2d22df8
666963.98,6.0,23,4,4,2,10,0xb2d16ff5
4405.51,1.0,0,2,2,4,8,0xb2d6b5b2
10000.04,2.0,95,2,3,1,6,0xb2d694bc
1016.58,1.0,111,1,2,1,4,0xb2d0df38
1270093.92,4.0,20,4,4,2,10,0xb2d5c8ba
2612.54,1.0,184,1,2,1,4,0xb2d53f03
4323.47,1.0,2,2,2,4,8,0xb2d2b3a0
8670.91,1.0,20,2,2,2,6,0xb2d627c4
912980.68,4.0,103,4,4,1,9,0xb2d3a3d5
426690.78,2.0,26,4,3,2,9,0xb2d65915
205003.97,6.0,35,3,4,2,9,0xb2d8c838
121319.84,2.0,67,3,3,1,7,0xb2d2d673
1.4,1.0,17,1,2,2,5,0xb2d1dbac
1214.24,2.0,92,1,3,1,5,0xb2d1f653
50181.99,2.0,93,2,3,1,6,0xb2d5cb1d
430000.38,26.0,7,4,4,3,11,0xb2d2d96f
830073.7,5.0,1,4,4,4,12,0xb2d2d746
45917.58,1.0,14,2,2,3,7,0xb2d999d7
432717.72,3.0,0,4,4,4,12,0xb2d210b0
28825.79,2.0,12,2,3,3,8,0xb2d40335
458107.43,3.0,1,4,4,4,12,0xb2d20ecb
1207234.94,7.0,20,4,4,2,10,0xb2d5ff09
0.7,2.0,1,1,3,4,8,0x3b9b1a1ad
100004.22,2.0,181,3,3,1,7,0xb2d6ac75
5094.34,1.0,4,2,2,4,8,0xb2d3eaea
727004.99,5.0,0,4,4,4,12,0xb2d216e9
20000.42,2.0,73,2,3,1,6,0xb2d8e1b4
1341.61,2.0,9,1,3,3,7,0xb2d36f6f
170045.16,4.0,1,3,4,4,11,0xb2d36e27
2818.33,3.0,0,1,4,4,9,0x3b9af0f8
65371.26,2.0,3,3,3,4,10,0xb2d80ef3
77427.79,3.0,221,3,4,1,8,0xb2d16b39
0.0,1.0,0,1,2,4,7,0xb2d26778
517023.27,1.0,5,4,2,3,9,0xb2da0e7a
8370.24,1.0,15,2,2,3,7,0xb2d6a447
1685.03,1.0,184,1,2,1,4,0xb2d2bf93d
100007.88,3.0,195,3,4,1,8,0x3b9b4343
362.68,1.0,10,1,2,3,6,0xb2d4c83f
500005.28,2.0,74,4,3,1,8,0xb2d99f5c
1010.0,1.0,184,1,2,1,4,0xb2d51b46
400001.9,2.0,21,4,3,2,9,0xb2d953a9
6572.52,1.0,13,2,2,3,7,0xb2d8da5d
26.73,1.0,56,1,2,2,5,0xb2d2484fd
93353.91,1.0,0,3,2,4,9,0xb2d5683b
61646.6,2.0,52,3,3,2,8,0xb2d5e42c
203554.28,2.0,7,3,3,3,9,0xb2d6287b
4959.6,1.0,8,2,2,3,7,0xb2d1275b
26002.17,2.0,21,2,3,2,7,0xb2d68df9d
470838.53,4.0,9,4,4,3,11,0xb2d4ac44d
897.31,1.0,184,1,2,1,4,0xb2d2a810
53479.12,2.0,111,3,3,1,7,0xb2d40b9e
60098.76,2.0,125,3,3,1,7,0xb2d6eac9
1659.72,1.0,0,1,2,4,7,0xb2d68c84
18443.62,1.0,0,2,2,4,8,0xb2d786e1
500000.0,2.0,11,4,3,3,10,0xb2da47c1
150006.33,2.0,90,3,3,1,7,0xb2d8a79b
822539.54,5.0,25,4,4,2,10,0xb2d1d698
497001.83,9.0,3,4,4,4,12,0xb2d109cb
70059.66,1.0,0,3,2,4,9,0xb2d2fbc6
135.19,1.0,0,1,2,4,7,0xb2d32a1a
36000.38,2.0,263,2,3,1,6,0xb2d6c156
768.68,1.0,0,1,2,4,7,0xb2d4d090
1090.34,1.0,0,1,2,4,7,0xb2d34d6c
90.91,1.0,25,1,2,2,5,0xb2d1e8c7
1012.47,1.0,181,1,2,1,4,0xb2d58b9ed
270495.47,4.0,5,3,4,3,10,0xb2d1ea3b
1648.88,3.0,184,1,4,1,6,0xb2d088dbd
30081.6,2.0,76,2,3,1,6,0xb2d5a567
289425.44,2.0,136,3,3,1,7,0xb2d100a1
599.69,1.0,9,1,2,3,6,0xb2d78ef5
340.5,1.0,0,1,2,4,7,0xb2d5548d
1816.77,1.0,92,1,2,1,4,0xb2d54926
0.59,1.0,44,1,2,2,5,0xb2d59786
5677.97,1.0,184,2,2,1,5,0xb2d1b451
25015.67,1.0,63,2,2,2,6,0xb2d0df8a
251104.31,3.0,11,3,4,3,10,0xb2d1c24e
497071.4,2.0,31,4,3,2,9,0xb2d5f83c
1240.63,1.0,10,1,2,3,6,0xb2d8e3bd
50230.7,2.0,25,2,3,2,7,0xb2d4feab
522069.28,5.0,125,4,4,1,9,0xb2d3f48fd
620000.23,7.0,0,4,4,4,12,0xb2d8cd86
402277.0,3.0,53,4,4,2,10,0xb2d3bc06
490246.02,6.0,0,4,4,4,12,0xb2d5eb50
600000.78,4.0,8,4,4,3,11,0xb2d15921
300000.0,2.0,5,3,3,3,9,0xb2da5db7
910003.37,7.0,13,4,4,3,11,0xb2d16e68
600088.7,6.0,41,4,4,2,10,0xb2d0eca7
250000.59,2.0,1,3,3,4,10,0xb2d2c320
18894.01,1.0,0,2,2,4,8,0xb2d23a68
100003.98,2.0,98,3,3,1,7,0xb2d140c7
501777.16,2.0,36,4,3,2,9,0xb2d64476
1067.63,1.0,0,1,2,4,7,0xb2d37c45
8.89,1.0,7,1,2,3,6,0xb2d6d3d6
430568.82,4.0,101,4,4,1,9,0x3b9b2cc3
1110860.85,2.0,27,4,3,2,9,0xb2d28a0b
8129.0,1.0,19,2,2,2,6,0xb2d4b9b5
80039.94,2.0,223,3,3,1,7,0xb2d10c07
160130.45,3.0,59,3,4,2,9,0xb2d3c658
4795.91,1.0,8,2,2,3,7,0xb2d9893c
3563.93,1.0,8,2,2,3,7,0xb2d707f6
255.31,1.0,31,1,2,2,5,0xb2d60c5b
1329.77,1.0,0,1,2,4,7,0xb2d51f38
1770069.04,10.0,3,4,4,4,12,0xb2d65007d
1087.93,1.0,184,1,2,1,4,0xb2d2091fd
217003.07,3.0,83,3,4,1,8,0xb2d682a4
4000353.22,4.0,2,4,4,4,12,0xb2d352f9
100024.43,3.0,33,3,4,2,9,0xb2d57e70
213279.34,2.0,214,3,3,1,7,0xb2d32830
407729.7,5.0,53,4,4,2,10,0xb2d60620
500107.98,4.0,7,4,4,3,11,0xb2d5a494
1155105.66,8.0,3,4,4,4,12,0xb2d0bcd5
10707.95,4.0,19,2,4,2,8,0xb2d278f7
7476.87,3.0,92,2,4,1,7,0xb2d094aa
111.2,1.0,21,1,2,2,5,0xb2d915d1
1240020.39,7.0,6,4,4,3,11,0xb2d903a1
1016.52,1.0,92,1,2,1,4,0xb2d0b874
240072.93,2.0,8,3,3,3,9,0xb2d93b02
190172.63,3.0,0,3,4,4,11,0xb2d63f13
10065.48,1.0,0,2,2,4,8,0xb2d51544
101368.91,2.0,66,3,3,2,8,0xb2d61dfc
127011.35,2.0,35,3,3,2,8,0xb2d9b4ab
10.0,1.0,3,1,2,4,7,0xb2d94ef6
8158.49,1.0,10,2,2,3,7,0xb2d4090b
1110.23,1.0,184,1,2,1,4,0xb2d1a60ed
81934.6,2.0,63,3,3,2,8,0xb2d68887
27116.91,1.0,5,2,2,3,7,0xb2d18d6c
449111.08,7.0,24,4,4,2,10,0x3b9b28fd
2544062.1,17.0,0,4,4,4,12,0xb2d613e3
1454246.78,16.0,38,4,4,2,10,0xb2d21fce
189.49,1.0,55,1,2,2,5,0xb2d881b4
204604.87,4.0,0,3,4,4,11,0xb2d2d7f4
205565.08,1.0,184,3,2,1,6,0xb2d405f7
317564.08,1.0,10,4,2,3,9,0xb2d86aca
125054.79,6.0,49,3,4,2,9,0xb2d14e0b
30017.33,2.0,206,2,3,1,6,0xb2d5b9cf
505391.39,2.0,83,4,3,1,8,0xb2d6a905
22674.19,1.0,184,2,2,1,5,0xb2d2d703
100863.09,1.0,0,3,2,4,9,0xb2d0f0d9
420010.55,3.0,0,4,4,4,12,0xb2d24e4d
960139.13,3.0,174,4,4,1,9,0xb2d5eb9f
754059.27,4.0,7,4,4,3,11,0xb2d640b7
1361.46,1.0,11,1,2,3,6,0xb2d2e5d6
500000.06,2.0,10,4,3,3,10,0xb2da4d7b
20000.63,2.0,130,2,3,1,6,0xb2d926e4
13.79,1.0,8,1,2,3,6,0xb2d68713
3800.96,1.0,0,2,2,4,8,0xb2d6b62d
7136.32,1.0,5,2,2,3,7,0xb2d2c88d
374922.89,4.0,8,4,4,3,11,0xb2d5fc13
27730.5,1.0,0,2,2,4,8,0xb2d690e3d
327351.45,3.0,92,4,4,1,9,0xb2d52947
107367.99,2.0,80,3,3,1,7,0xb2d0c1ba
20047.64,2.0,92,2,3,1,6,0xb2d5ff41
284519.76,5.0,0,3,4,4,11,0xb2d201ce
305.54,1.0,117,1,2,1,4,0xb2d8df6f
998.41,1.0,0,1,2,4,7,0xb2d6aa0c
10182.06,1.0,184,2,2,1,5,0xb2d0a5b5
20000.0,2.0,4,2,3,4,9,0xb2d8ff0e
2188362.62,5.0,4,4,4,4,12,0xb2d11d7ed
214004.26,6.0,18,3,4,2,9,0xb2d1b3d5d
1595855.3,9.0,11,4,4,3,11,0xb2d16cb2d
710118.54,1.0,6,4,2,3,9,0xb2d9445c
19500.0,3.0,184,2,4,1,7,0xb2d655f3
42950.49,2.0,0,2,3,4,9,0xb2d1197f
142.65,1.0,10,1,2,3,6,0xb2d2d6c8
11533.48,1.0,10,2,2,3,7,0xb2d42682
403495.17,4.0,70,4,4,1,9,0xb2d12bb0
130058.11,2.0,208,3,3,1,7,0xb2d6a788
56140.87,7.0,92,3,4,1,8,0xb2d3e47b
20217.14,1.0,0,2,2,4,8,0xb2d6f8b2
1506420.89,3.0,0,4,4,4,12,0xb2d37e41
212058.49,2.0,0,3,3,4,10,0xb2d3553f
50004.53,5.0,101,2,4,1,7,0xb2d60f37
3.26,1.0,10,1,2,3,6,0xb2d3fffb
3960.92,1.0,32,2,2,2,6,0xb2d9d3b0
610021.01,7.0,3,4,4,4,12,0xb2d1bd12
10.82,1.0,19,1,2,2,5,0xb2d20e6f
1165.64,1.0,92,1,2,1,4,0xb2d0b794
201131.79,2.0,29,3,3,2,8,0xb2d204d7
20732.32,1.0,41,2,2,2,6,0xb2d08f1c
1966.36,1.0,12,1,2,3,6,0xb2d93d52
7389.43,1.0,8,2,2,3,7,0xb2d0c036
6983.01,1.0,92,2,2,1,5,0xb2d31276
505329.6,2.0,34,4,3,2,9,0xb2d824e1
120006.54,2.0,63,3,3,2,8,0xb2d9aec2
3503.03,1.0,1,2,2,4,8,0xb2d6ffe6
85439.78,3.0,11,3,4,3,10,0xb2d3b8da
2908.57,1.0,0,2,2,4,8,0xb2d34651
751473.16,9.0,33,4,4,2,10,0xb2d12578d
5714.08,1.0,49,2,2,2,6,0xb2d56bc3
201424.14,2.0,52,3,3,2,8,0xb2d65ce4
93260.84,2.0,143,3,3,1,7,0xb2d53083
256.18,1.0,5,1,2,3,6,0xb2d6f3dd
2200.63,1.0,0,1,2,4,7,0xb2d5516a
330002.15,4.0,16,4,4,2,10,0xb2d69d34
6664.31,5.0,263,2,4,1,7,0x3b9b28db
361752.37,7.0,11,4,4,3,11,0xb2d56563
1172.94,1.0,42,1,2,2,5,0xb2d16116
19.0,1.0,89,1,2,1,4,0xb2d98403
11552.49,1.0,3,2,2,4,8,0xb2d8daf4
91.56,1.0,46,1,2,2,5,0xb2d283db
11416.43,1.0,0,2,2,4,8,0xb2d5f0bc
530000.04,9.0,0,4,4,4,12,0xb2d5a759
2269.8,1.0,184,1,2,1,4,0xb2d4f349
12699.02,1.0,10,2,2,3,7,0x3b9b3664
12.19,1.0,1,1,2,4,7,0xb2d941b5
50655.34,2.0,64,2,3,2,7,0xb2d6983bd
406682.77,5.0,43,4,4,2,10,0xb2d08282
1802.11,1.0,92,1,2,1,4,0xb2d21bac
2955.9,1.0,10,2,2,3,7,0xb2d6fbe9
3.15,1.0,61,1,2,2,5,0xb2d28759
5437.08,1.0,4,2,2,4,8,0xb2d9069f
81554.1,3.0,76,3,4,1,8,0xb2d568c9
131504.75,1.0,92,3,2,1,6,0xb2d2554e
1503.75,1.0,92,1,2,1,4,0xb2d25c9d
609466.04,5.0,32,4,4,2,10,0xb2d1076e
150011.15,2.0,214,3,3,1,7,0xb2d52b11
100000.0,2.0,300,3,3,1,7,0xb2d68e2e
20237.05,1.0,102,2,2,1,5,0xb2d69c9f
1001.16,1.0,120,1,2,1,4,0xb2d91a17
2707.92,1.0,0,1,2,4,7,0xb2d3453f
63717.5,1.0,19,3,2,2,7,0xb2d40fd3
137.97,1.0,6,1,2,3,6,0xb2d5893e
5347.96,1.0,2,2,2,4,8,0xb2d2dfb2d
31.56,1.0,67,1,2,1,4,0xb2d5af77d
6019.06,1.0,95,2,2,1,5,0xb2d227d9
1544.79,1.0,0,1,2,4,7,0xb2d55126
686.61,2.0,119,1,3,1,5,0xb2d1bd41
80811.28,4.0,3,3,4,4,11,0xb2d6d53c
1332543.91,5.0,4,4,4,4,12,0xb2d5eb5e
20358.48,2.0,17,2,3,2,7,0xb2d6bb01
16844.23,1.0,11,2,2,3,7,0xb2d08cfc
41275.84,1.0,1,2,2,4,8,0xb2d6b488
350000.77,3.0,8,4,4,3,11,0xb2d67ea1
7625.39,1.0,11,2,2,3,7,0xb2d93718
2319900.0,1.0,3,4,2,4,10,0xb2d96c2d
1120.77,1.0,0,1,2,4,7,0xb2d311a7
19614.57,1.0,1,2,2,4,8,0xb2d54e40
6.79,1.0,92,1,2,1,4,0xb2d39a3a
10113.08,1.0,6,2,2,3,7,0xb2d0e58a
279000.0,2.0,10,3,3,3,9,0xb2d96c48d
122060.49,3.0,14,3,4,3,10,0xb2d22532
4512.38,1.0,92,2,2,1,5,0xb2d17955
6848.51,1.0,19,2,2,2,6,0xb2d4e563
20579.65,1.0,7,2,2,3,7,0xb2d5f609
44970.21,1.0,0,2,2,4,8,0xb2d26587
72630.07,2.0,20,3,3,2,8,0xb2d27195
330092.77,5.0,11,4,4,3,11,0xb2d22f97
203695.44,2.0,39,3,3,2,8,0xb2d78ec3
76236.56,1.0,209,3,2,1,6,0xb2d3fc9b
3003.18,1.0,13,2,2,3,7,0xb2d29562
50000.53,2.0,76,2,3,1,6,0xb2d8d78f
20181.7,1.0,184,2,2,1,5,0xb2d23add
369.5,1.0,5,1,2,3,6,0xb2d33a13
975025.04,5.0,110,4,4,1,9,0xb2d3a565
10196.48,1.0,0,2,2,4,8,0xb2d17887
2030083.28,3.0,231,4,4,1,9,0xb2d4ee81
21480.28,1.0,14,2,2,3,7,0xb2d65fc0
1007400.26,2.0,5,4,3,3,10,0xb2d68bcf
489343.5,7.0,4,4,4,4,12,0xb2d23db4
105202.07,2.0,73,3,3,1,7,0xb2d44db4
182103.13,6.0,0,3,4,4,11,0xb2d1bae6
53859.55,2.0,66,3,3,2,8,0xb2d38856
1629240.64,11.0,5,4,4,3,11,0xb2d0bf31d
131920.71,2.0,0,3,3,4,10,0xb2d0a704
40981.72,3.0,0,2,4,4,10,0xb2d0d8db
1088.26,1.0,92,1,2,1,4,0xb2d22a15
57075.39,6.0,0,3,4,4,11,0xb2d6fb0f
421845.2,6.0,1,4,4,4,12,0xb2d6180a
451007.62,2.0,1,4,3,4,11,0xb2d65d75
240002.67,9.0,18,3,4,2,9,0xb2d69eb4
171564.09,5.0,0,3,4,4,11,0x3b9af26f
307371.55,1.0,5,4,2,3,9,0xb2d59059
2997.05,1.0,3,2,2,4,8,0xb2d6c22a
196088.38,2.0,157,3,3,1,7,0xb2d1dca2
543091.99,4.0,4,4,4,4,12,0xb2d142dd
4522.09,1.0,0,2,2,4,8,0xb2d64b06
4790.4,1.0,92,2,2,1,5,0xb2d271b1
300020.34,2.0,111,3,3,1,7,0xb2d2a074
55.99,1.0,25,1,2,2,5,0xb2d28db1
1922050.38,4.0,14,4,4,3,11,0xb2d1c758
113610.92,3.0,13,3,4,3,10,0xb2d3a00a
4008.38,1.0,32,2,2,2,6,0xb2d5fb29
3.85,1.0,70,1,2,1,4,0xb2d3a5e7
71059.68,3.0,67,3,4,1,8,0xb2d19f0d
449891.58,2.0,1,4,3,4,11,0xb2d59dfd
1887.32,1.0,92,1,2,1,4,0xb2d29a25
943.42,1.0,10,1,2,3,6,0xb2d2f355
1441.03,4.0,0,1,4,4,9,0x3b9b18db
8493.14,1.0,18,2,2,2,6,0xb2d9172c
87639.6,1.0,3,3,2,4,9,0xb2d34066
280009.23,6.0,102,3,4,1,8,0xb2d6f587d
143.16,1.0,0,1,2,4,7,0xb2d2619e
558.41,1.0,9,1,2,3,6,0xb2d6e6ba
593564.08,7.0,0,4,4,4,12,0xb2d1f7f7d
206898.57,1.0,3,3,2,4,9,0xb2d11e90
156284.47,2.0,143,3,3,1,7,0xb2d3b5b2
1150069.35,6.0,42,4,4,2,10,0xb2d8cd9e
470523.51,1.0,0,4,2,4,10,0xb2d276d2
58888.74,2.0,15,3,3,3,9,0xb2d628b3
40006.33,1.0,25,2,2,2,6,0xb2da0a30
318.04,1.0,20,1,2,2,5,0xb2d764c0
2832.0,1.0,14,1,2,3,6,0xb2d698be
193045.88,4.0,6,3,4,3,10,0xb2d438fa
1070015.07,7.0,3,4,4,4,12,0xb2d13dce
50055.08,2.0,62,2,3,2,7,0xb2d88b58d
1085.37,1.0,43,1,2,2,5,0xb2d36b74
100038.81,2.0,46,3,3,2,8,0xb2d5ecdc
365780.64,1.0,10,4,2,3,9,0xb2d57b8b
7583.16,1.0,9,2,2,3,7,0xb2d60a81
5002.25,1.0,20,2,2,2,6,0xb2d140c1
600000.0,2.0,11,4,3,3,10,0xb2da37f4
42.24,1.0,35,1,2,2,5,0xb2d6533b
442748.83,5.0,3,4,4,4,12,0xb2d6d0d8d
2617.87,1.0,13,1,2,3,6,0xb2d8db55
51001.63,2.0,74,2,3,1,6,0xb2d60f24
2750.77,1.0,89,1,2,1,4,0xb2d2ad1f
295698.63,13.0,0,3,4,4,11,0x3b9af1a9
2009.62,1.0,148,1,2,1,4,0xb2d4180f
139.04,1.0,75,1,2,1,4,0xb2d6f005d
73017.37,2.0,175,3,3,1,7,0xb2d1b968
6235.76,1.0,0,2,2,4,8,0xb2d3c9a0d
50000.53,2.0,83,2,3,1,6,0xb2d59061
70050.47,2.0,133,3,3,1,7,0xb2d6e17a
103653.92,2.0,83,3,3,1,7,0xb2d613f4
1004.47,2.0,309,1,3,1,5,0x3b9b3fc7
2982.76,1.0,0,2,2,4,8,0xb2d55200
293.55,1.0,38,1,2,2,5,0xb2d1c330
1219.09,1.0,133,1,2,1,4,0xb2d5c082
3193.03,1.0,40,2,2,2,6,0xb2d6a1d7
1399.55,1.0,16,1,2,2,5,0xb2d2d592
105100.75,2.0,92,3,3,1,7,0xb2d32f6b
610008.12,5.0,0,4,4,4,12,0xb2d9036d
2090000.0,2.0,6,4,3,3,10,0xb2da5b32
4001.16,1.0,6,2,2,3,7,0xb2d3e86d
84714.7,2.0,64,3,3,2,8,0xb2d601a7
21430.33,1.0,1,2,2,4,8,0xb2d214af
28443.67,1.0,3,2,2,4,8,0xb2d3a66d
50001.68,2.0,231,2,3,1,6,0xb2d630cc
200000.0,2.0,1,3,3,4,10,0xb2da6083
25395.46,1.0,8,2,2,3,7,0xb2d1f7b7
12.43,1.0,11,1,2,3,6,0xb2d54874
78954.83,4.0,3,3,4,4,11,0xb2d3f0b7
796886.8,10.0,1,4,4,4,12,0xb2d24a9e
4524.6,2.0,1,2,3,4,9,0x3b9af233
3000000.0,9.0,3,4,4,4,12,0xb2d6a872
5706421.32,1.0,7,4,2,3,9,0xb2d37b3a
332068.76,7.0,19,4,4,2,10,0xb2d2e935
10.13,1.0,14,1,2,3,6,0xb2d26e18
300022.47,5.0,4,3,4,4,11,0xb2d1c973
1220315.14,3.0,27,4,4,2,10,0xb2d90489
142556.3,4.0,1,3,4,4,11,0xb2d58764
0.27,1.0,31,1,2,2,5,0xb2d1487ed
1365.17,1.0,113,1,2,1,4,0xb2d77774
882083.46,6.0,6,4,4,3,11,0xb2d13947
30000.32,2.0,73,2,3,1,6,0xb2d8e447
1064308.91,5.0,1,4,4,4,12,0xb2d29b36d
1509.43,1.0,0,1,2,4,7,0xb2d952e9
95172.39,2.0,6,3,3,3,9,0xb2d1caa3
340.53,1.0,4,1,2,4,7,0xb2d9b768
156004.88,3.0,60,3,4,2,9,0xb2d5f98e
25.07,1.0,42,1,2,2,5,0xb2d6f449
2007105.06,3.0,22,4,4,2,10,0xb2d90f90
18934.0,1.0,40,2,2,2,6,0xb2d1317a
170221.24,2.0,97,3,3,1,7,0xb2d60c8b
188008.95,5.0,1,3,4,4,11,0xb2d0fcb1
178121.58,1.0,11,3,2,3,8,0xb2d91262
210176.35,5.0,40,3,4,2,9,0xb2d6cbcbd
203556.15,2.0,91,3,3,1,7,0xb2d8c478d
1240.1,1.0,17,1,2,2,5,0xb2d27a84
5.05,1.0,10,1,2,3,6,0xb2d92822
486072.13,7.0,77,4,4,1,9,0xb2d3e9c7
1540164.63,9.0,18,4,4,2,10,0xb2d56da0
39634.74,1.0,43,2,2,2,6,0xb2d632ea
833.91,1.0,74,1,2,1,4,0xb2d563ae
630.72,1.0,3,1,2,4,7,0xb2d33b68
400004.96,3.0,15,4,4,3,11,0xb2d69c55d
53.44,1.0,35,1,2,2,5,0xb2d4ac76d
33701.52,1.0,0,2,2,4,8,0xb2d21251
272005.42,3.0,67,3,4,1,8,0xb2d1e038
9984.84,2.0,0,2,3,4,9,0xb2d2bd84
2569.46,1.0,7,1,2,3,6,0xb2d366a6
5.71,1.0,82,1,2,1,4,0xb2d18b65
610365.38,4.0,7,4,4,3,11,0xb2d38ee8
582.62,1.0,4,1,2,4,7,0xb2d538d6
536500.0,3.0,96,4,4,1,9,0xb2d21e21
50167.31,3.0,7,2,4,3,9,0xb2d593cb
426549.57,9.0,6,4,4,3,11,0xb2d4f367
322692.79,2.0,11,4,3,3,10,0xb2d7829c
521066.51,5.0,1,4,4,4,12,0xb2d55590d
48538.12,1.0,0,2,2,4,8,0xb2d51f1f
379619.56,4.0,122,4,4,1,9,0xb2d0c1b4
10204.97,1.0,0,2,2,4,8,0xb2d8ebbc
4.39,1.0,72,1,2,1,4,0xb2d69dc3
8822.85,1.0,0,2,2,4,8,0xb2d284f3
0.0,1.0,0,1,2,4,7,0xb2d2adac
826865.24,2.0,39,4,3,2,9,0xb2d1ac82d
16185.7,1.0,20,2,2,2,6,0xb2d6e01d
0.0,1.0,6,1,2,3,6,0xb2d9fcc8
12029.08,1.0,0,2,2,4,8,0xb2d903c4
134.83,1.0,23,1,2,2,5,0xb2d3f9e4
509851.41,3.0,43,4,4,2,10,0xb2d5d69e
400013.76,3.0,8,4,4,3,11,0xb2d57747
389682.28,1.0,0,4,2,4,10,0xb2d24774
50105.84,1.0,49,2,2,2,6,0xb2d3b415
0.0,1.0,184,1,2,1,4,0xb2d30b9e
30.61,1.0,41,1,2,2,5,0xb2d0ff6b
608529.3,4.0,134,4,4,1,9,0xb2d91b7d
200001.06,2.0,1,3,3,4,10,0xb2d9faef
2799.83,1.0,6,1,2,3,6,0xb2d6804b
100435.75,2.0,118,3,3,1,7,0xb2d11eae
0.0,1.0,10,1,2,3,6,0xb2d2526e
5143.45,1.0,4,2,2,4,8,0xb2d67def
3195.85,2.0,92,2,3,1,6,0xb2d1ce0e
612865.79,5.0,17,4,4,2,10,0xb2d7c564
280011.23,9.0,1,3,4,4,11,0xb2d9e44d
1620.84,1.0,34,1,2,2,5,0xb2d926a2
153429.7,4.0,3,3,4,4,11,0xb2d10af1
162.78,1.0,31,1,2,2,5,0xb2d4bdd5
1739.71,1.0,2,1,2,4,7,0xb2d343c2
147539.94,7.0,16,3,4,2,9,0xb2d6477d
1003.77,1.0,92,1,2,1,4,0xb2d58cdd
984.14,2.0,40,1,3,2,6,0x3b9b2ae0
1262.46,1.0,9,1,2,3,6,0xb2d9332e
194960.16,3.0,5,3,4,3,10,0xb2d3c886
13.52,1.0,40,1,2,2,5,0xb2d2daad
20410.25,1.0,50,2,2,2,6,0xb2d8eba6
4120.4,1.0,1,2,2,4,8,0xb2d2b2ac
2930.25,1.0,10,2,2,3,7,0xb2d929a7
50005.73,4.0,11,2,4,3,9,0xb2d0a830
10329.15,1.0,12,2,2,3,7,0xb2d55e72
90009.38,3.0,10,3,4,3,10,0xb2d68160
52688.06,2.0,239,3,3,1,7,0xb2d43a10
1982.03,1.0,92,1,2,1,4,0xb2d1246ed
150008.51,2.0,104,3,3,1,7,0xb2d57b6fd
300000.0,2.0,14,3,3,3,9,0xb2da3bf0
0.5,1.0,56,1,2,2,5,0xb2d581f1
600113.46,2.0,27,4,3,2,9,0xb2d7bd2d
150006.36,3.0,20,3,4,2,9,0xb2d5ad42
550002.73,3.0,4,4,4,4,12,0xb2d74332
156500.51,4.0,87,3,4,1,8,0xb2d3df56
2000.39,1.0,0,1,2,4,7,0xb2d68caa
30000.63,2.0,80,2,3,1,6,0xb2d98df0
983050.16,4.0,3,4,4,4,12,0xb2d8c6fb
16016.32,2.0,15,2,3,3,8,0xb2d3fa70
112770.32,3.0,13,3,4,3,10,0xb2d603f0d
1020976.16,2.0,39,4,3,2,9,0xb2d697ad
100001.06,2.0,92,3,3,1,7,0xb2d9801a
1915084.08,1.0,0,4,2,4,10,0xb2d3f835
79906.29,1.0,0,3,2,4,9,0xb2d97a8c
30450.67,2.0,196,2,3,1,6,0xb2d60b20
303240.93,2.0,74,4,3,1,8,0xb2d5cb5f
202946.22,2.0,108,3,3,1,7,0xb2d91581
220009.67,2.0,77,3,3,1,7,0xb2d3c168
377000.11,10.0,0,4,4,4,12,0xb2d700a5
1029000.0,13.0,0,4,4,4,12,0xb2d3153b
170057.75,2.0,53,3,3,2,8,0xb2d1b4a0
210000.0,2.0,3,3,3,4,10,0xb2d910fb
2494.08,1.0,50,1,2,2,5,0xb2d6b994
240516.74,4.0,18,3,4,2,9,0xb2d5254e
201175.62,3.0,19,3,4,2,9,0xb2d1527e
50051.26,4.0,23,2,4,2,8,0xb2d23248
440015.54,5.0,41,4,4,2,10,0xb2d207cf
100473.03,3.0,25,3,4,2,9,0xb2d17584
402058.3,5.0,4,4,4,4,12,0xb2d43f7b
401406.54,5.0,66,4,4,2,10,0xb2d06d3a
27.76,1.0,7,1,2,3,6,0xb2d42100d
1586.54,1.0,0,1,2,4,7,0xb2d2de62
402176.38,4.0,76,4,4,1,9,0xb2d1c86b
1007120.93,2.0,72,4,3,1,8,0xb2d955eb
520418.79,2.0,20,4,3,2,9,0xb2d5ee2a
59380.11,1.0,184,3,2,1,6,0xb2d266ef
9413.1,1.0,92,2,2,1,5,0xb2d34f17
500000.6,2.0,6,4,3,3,10,0xb2d9b42c
13730.52,4.0,258,2,4,1,7,0xb2d60a65
15043.04,2.0,0,2,3,4,9,0xb2d58036
200088.07,2.0,4,3,3,4,10,0xb2d78f25
56946.4,1.0,13,3,2,3,8,0xb2d97a9f
271114.3,2.0,26,3,3,2,8,0xb2d23642
350013.22,3.0,97,4,4,1,9,0xb2d68916
3730.39,1.0,11,2,2,3,7,0xb2d2e2c4
468.81,1.0,2,1,2,4,7,0xb2d20c6e
622.79,1.0,0,1,2,4,7,0xb2d6bf9b
200014.87,2.0,13,3,3,3,9,0xb2d9a407
3749.06,2.0,21,2,3,2,7,0xb2d56363
613.53,1.0,0,1,2,4,7,0xb2d78527
340017.95,2.0,97,4,3,1,8,0xb2d81ebb
1056.9,1.0,16,1,2,2,5,0xb2d106de
0.0,1.0,8,1,2,3,6,0xb2d90569
111953.86,1.0,0,3,2,4,9,0xb2d4a758
7420.07,1.0,13,2,2,3,7,0xb2d2d2c7
450015.62,3.0,11,4,4,3,11,0xb2d744d9
160002.32,3.0,94,3,4,1,8,0xb2d716b6
0.0,3.0,84,1,4,1,6,0xb2d6f252
80000.84,2.0,4,3,3,4,10,0xb2d98130
10000.11,2.0,27,2,3,2,7,0xb2d9412e
710180.18,9.0,4,4,4,4,12,0xb2d48060
83650.58,1.0,8,3,2,3,8,0xb2d570b8
10000.42,2.0,90,2,3,1,6,0xb2d8a7a3
50010.64,4.0,24,2,4,2,8,0x3b9b292c
32871.86,1.0,0,2,2,4,8,0xb2d6472e
205392.71,4.0,63,3,4,2,9,0xb2d102e4
49.26,1.0,82,1,2,1,4,0xb2d6b371
2032.67,1.0,0,1,2,4,7,0xb2d69bbf
21101.18,3.0,20,2,4,2,8,0xb2d6db18
5.51,1.0,59,1,2,2,5,0xb2d6d13ed
76.23,1.0,13,1,2,3,6,0xb2d3905a
1010844.85,32.0,0,4,4,4,12,0xb2d0a237
100037.23,2.0,55,3,3,2,8,0xb2d5e678
0.94,1.0,0,1,2,4,7,0xb2d68960
314723.96,6.0,19,4,4,2,10,0xb2d29529
690051.92,6.0,4,4,4,4,12,0xb2d40bcf
94392.35,2.0,69,3,3,1,7,0xb2d65e51
131167.84,4.0,10,3,4,3,10,0xb2d64c17
76.26,1.0,33,1,2,2,5,0xb2d6de67
134807.43,1.0,0,3,2,4,9,0xb2d25eff
1.06,1.0,47,1,2,2,5,0xb2d31525
67.62,2.0,69,1,3,1,5,0x3b9acc87d
2710.84,1.0,195,1,2,1,4,0xb2d5dc4d
1130571.09,4.0,1,4,4,4,12,0xb2d1d1d2
48.73,1.0,11,1,2,3,6,0xb2d39099
21.55,1.0,9,1,2,3,6,0xb2d716e8
812193.14,7.0,59,4,4,2,10,0xb2d5a917
250014.91,2.0,90,3,3,1,7,0xb2d4ae44
0.27,1.0,67,1,2,1,4,0xb2d64888
1479.55,1.0,9,1,2,3,6,0xb2d4a9a6
5652.64,1.0,0,2,2,4,8,0xb2d69f64
10155.53,1.0,215,2,2,1,5,0xb2d48e52
50001.06,2.0,101,2,3,1,6,0xb2d81638
630084.41,2.0,99,4,3,1,8,0xb2d61b41
17700007.11,2.0,42,4,3,2,9,0xb2d9e7c9
556353.61,9.0,1,4,4,4,12,0xb2d2a29f
3844.91,1.0,15,2,2,3,7,0xb2d8c872
922097.69,8.0,22,4,4,2,10,0xb2d789e9d
1.06,1.0,93,1,2,1,4,0xb2d97c67
253001.06,3.0,13,3,4,3,10,0xb2d936cc
203772.67,4.0,19,3,4,2,9,0xb2d2368a
2572.23,1.0,0,1,2,4,7,0xb2d51e5bd
414068.37,2.0,51,4,3,2,9,0xb2d1c8cb
516014.99,2.0,101,4,3,1,8,0xb2d0cde4
4048.9,1.0,264,2,2,1,5,0xb2d24744
1043007.86,18.0,10,4,4,3,11,0xb2d17962d
3158.66,1.0,8,2,2,3,7,0xb2d6edd2
1092785.24,14.0,4,4,4,4,12,0xb2d2489b
1000104.95,3.0,8,4,4,3,11,0xb2d9ab07
2657.07,1.0,92,1,2,1,4,0xb2d1ff96
109.78,1.0,49,1,2,2,5,0xb2d904d9
1000002.01,3.0,22,4,4,2,10,0xb2d6e839
12728.2,1.0,184,2,2,1,5,0xb2d3a4ab
500000.0,2.0,4,4,3,4,11,0xb2d97b38
35364.9,1.0,17,2,2,2,6,0xb2d1ce39
206444.13,2.0,58,3,3,2,8,0xb2d304f6
136.29,1.0,2,1,2,4,7,0xb2d567b0
515049.13,2.0,74,4,3,1,8,0xb2d656f7
0.5,1.0,56,1,2,2,5,0xb2d64fdf
113086.07,4.0,175,3,4,1,8,0xb2d28456
43.69,1.0,11,1,2,3,6,0xb2da0b54
816058.65,5.0,1,4,4,4,12,0xb2d1b25d
36843.73,1.0,21,2,2,2,6,0xb2d4ed3e
504777.11,4.0,5,4,4,3,11,0xb2d1ccb7
30341.86,1.0,27,2,2,2,6,0xb2d7176d
1615.01,1.0,0,1,2,4,7,0xb2d61eec
17722.46,1.0,18,2,2,2,6,0xb2d5cfba
25966.69,1.0,21,2,2,2,6,0xb2d3eaf4
235.55,1.0,0,1,2,4,7,0xb2d98ef9
488608.33,9.0,3,4,4,4,12,0xb2d93e5cd
260188.08,4.0,129,3,4,1,8,0xb2d5e8ec
1092.79,1.0,92,1,2,1,4,0xb2d2f2d0
1215368.85,8.0,0,4,4,4,12,0xb2d08a36
70090.55,2.0,179,3,3,1,7,0xb2d4e9ec
151174.18,1.0,184,3,2,1,6,0xb2d3bbed
3.25,1.0,1,1,2,4,7,0xb2d6098c
3638.08,1.0,6,2,2,3,7,0xb2d2a29e
81792.46,1.0,6,3,2,3,8,0xb2d4affb
391060.36,5.0,1,4,4,4,12,0xb2d209ae
454132.34,3.0,4,4,4,4,12,0xb2d42114
155748.27,2.0,103,3,3,1,7,0xb2d35b8e
0.58,1.0,6,1,2,3,6,0xb2d17489
74001.97,3.0,45,3,4,2,9,0xb2d1f955
24962.67,1.0,5,2,2,3,7,0xb2d4a9a8
15306.87,6.0,1,2,4,4,10,0xb2d520ee
394.79,1.0,4,1,2,4,7,0xb2d80536
25000.0,1.0,4,2,2,4,8,0xb2da3e7f
316.93,1.0,67,1,2,1,4,0xb2d60e6e
173775.65,3.0,18,3,4,2,9,0xb2d29532
107759.91,3.0,83,3,4,1,8,0xb2d0a12d
177.49,1.0,11,1,2,3,6,0xb2d34097
502407.94,7.0,18,4,4,2,10,0xb2d111c4
104242.41,3.0,6,3,4,3,10,0xb2d282b4d
51001.52,4.0,87,2,4,1,7,0xb2d12373d
50224.42,2.0,27,2,3,2,7,0xb2d8e50d
200002.11,2.0,228,3,3,1,7,0xb2d6f046
818188.07,9.0,12,4,4,3,11,0xb2d15fcd
9224.46,1.0,1,2,2,4,8,0xb2d5b070
50000.53,2.0,55,2,3,2,7,0xb2d90582
402900.44,6.0,6,4,4,3,11,0xb2d5727e
10114.73,1.0,148,2,2,1,5,0xb2d703f1d
8680.84,1.0,33,2,2,2,6,0xb2d6e89c
320007.66,3.0,25,4,4,2,10,0xb2d53c68
20457.49,2.0,83,2,3,1,6,0xb2d5f103
60005.97,5.0,1,3,4,4,11,0xb2d6c916
6.39,1.0,48,1,2,2,5,0xb2d6dbc4
2040043.0,6.0,32,4,4,2,10,0xb2d22236
100013.19,2.0,27,3,3,2,8,0xb2da06a4
376809.53,4.0,1,4,4,4,12,0xb2d219d2d
2425119.97,2.0,31,4,3,2,9,0xb2d6dc3d
380018.76,10.0,19,4,4,2,10,0xb2d21b38
30477.32,4.0,3,2,4,4,10,0xb2d5749c
300055.8,2.0,179,3,3,1,7,0xb2d50f34
21403.06,1.0,63,2,2,2,6,0xb2d60f36
40538.73,2.0,1,2,3,4,9,0xb2d2dd5c
1124.57,1.0,184,1,2,1,4,0xb2d20f02
6.45,2.0,31,1,3,2,6,0xb2d0a421
5298.5,1.0,0,2,2,4,8,0xb2d34059
1458503.36,1.0,0,4,2,4,10,0xb2d5cc34
65027.7,3.0,98,3,4,1,8,0xb2d0e9f8d
846242.57,5.0,140,4,4,1,9,0xb2d22728
50001.06,2.0,6,2,3,3,8,0xb2da4760
1388523.23,5.0,18,4,4,2,10,0x3b9b48ad
1713.24,1.0,92,1,2,1,4,0xb2d2419e
12104.45,1.0,21,2,2,2,6,0xb2d6d560
2444.82,1.0,9,1,2,3,6,0xb2d32cf6
480038.01,2.0,169,4,3,1,8,0xb2d5e9ba
40247.38,2.0,51,2,3,2,7,0xb2d0c3f4
235.9,1.0,7,1,2,3,6,0xb2d9b952
250001.47,3.0,3,3,4,4,11,0xb2d6e6ee
7.85,1.0,104,1,2,1,4,0xb2d11c3d
140103.9,2.0,42,3,3,2,8,0xb2d550e5
1291.07,1.0,92,1,2,1,4,0xb2d2a9b8
21203.14,2.0,0,2,3,4,9,0xb2d91342
20000.63,2.0,73,2,3,1,6,0xb2d8dfc1
446614.75,11.0,0,4,4,4,12,0x3b9b40e1
45750.13,1.0,9,2,2,3,7,0xb2d8b660
0.63,1.0,1,1,2,4,7,0xb2d6e061
797913.04,6.0,10,4,4,3,11,0xb2d6def8
10803.3,1.0,2,2,2,4,8,0xb2d22faf
307471.25,2.0,109,4,3,1,8,0xb2d63998
63838.61,3.0,157,3,4,1,8,0x3b9b3e60
70858.3,1.0,1,3,2,4,9,0xb2d94072
79.58,3.0,11,1,4,3,8,0xb2d1957b
60107.51,2.0,15,3,3,3,9,0xb2d238a4
383510.65,3.0,0,4,4,4,12,0xb2d2ee4c
14174.6,1.0,8,2,2,3,7,0xb2d98bff
300017.51,2.0,15,3,3,3,9,0xb2d5edc9
140139.43,3.0,77,3,4,1,8,0xb2d478f2
82910.92,3.0,216,3,4,1,8,0xb2d07feed
100007.15,7.0,24,3,4,2,9,0xb2d6a925
7988.47,3.0,2,2,4,4,10,0xb2d170ad
181400.82,5.0,0,3,4,4,11,0x3b9b0e40
16.13,1.0,8,1,2,3,6,0xb2d2bdd2
400011.48,3.0,0,4,4,4,12,0xb2d2a9e5
17.92,1.0,59,1,2,2,5,0xb2d700fe
307795.84,1.0,1,4,2,4,10,0xb2d5f37a
1007.02,1.0,1,1,2,4,7,0xb2d49043
1100294.64,4.0,0,4,4,4,12,0xb2d63645
225035.48,3.0,14,3,4,3,10,0xb2d33c5d
630.21,1.0,4,1,2,4,7,0xb2d11f41
524.93,1.0,3,1,2,4,7,0xb2d31ad2
110007.19,2.0,63,3,3,2,8,0xb2d1a95a
350167.89,3.0,24,4,4,2,10,0xb2d3e446
49.09,1.0,7,1,2,3,6,0xb2d64ad9
5.64,1.0,104,1,2,1,4,0xb2d5a719
5000998.46,1.0,0,4,2,4,10,0xb2d331b1
41271.49,1.0,71,2,2,1,5,0xb2d1012e
10493.89,2.0,96,2,3,1,6,0xb2d2dccd
179000.0,4.0,3,3,4,4,11,0xb2d65899
150106.69,3.0,208,3,4,1,8,0xb2d206f2
107677.51,4.0,10,3,4,3,10,0xb2d0acc1
75468.86,3.0,4,3,4,4,11,0xb2d63481
6408.85,1.0,1,2,2,4,8,0xb2d55286
318489.25,4.0,0,4,4,4,12,0xb2d2a7ae
201214.0,2.0,12,3,3,3,9,0xb2d3e3ea
108.15,13.0,92,1,4,1,6,0xb2d117eb
311634.71,5.0,10,4,4,3,11,0xb2d077ab
10002.32,2.0,59,2,3,2,7,0xb2d8fa23
2.16,1.0,0,1,2,4,7,0xb2d6fdb5
201421.06,2.0,71,3,3,1,7,0xb2d9a7a0
206403.23,2.0,24,3,3,2,8,0xb2d692c7
4042.98,1.0,3,2,2,4,8,0xb2d60f88
103087.47,2.0,214,3,3,1,7,0xb2d100ac
100272.15,1.0,55,3,2,2,7,0xb2d6076a
111.46,1.0,10,1,2,3,6,0xb2d9ad3b
102247.68,2.0,39,3,3,2,8,0xb2d54864
120000.5,4.0,3,3,4,4,11,0xb2d245bf
4372.6,1.0,1,2,2,4,8,0xb2d1f6db
132000.0,4.0,1,3,4,4,11,0xb2d32949d
3134.05,1.0,7,2,2,3,7,0xb2d2d77e
1193929.26,5.0,1,4,4,4,12,0xb2d37081
65003.43,2.0,235,3,3,1,7,0xb2d24a4f
39939.23,1.0,45,2,2,2,6,0xb2d6be24
202852.95,2.0,97,3,3,1,7,0xb2d933ba
6008.4,1.0,9,2,2,3,7,0xb2d31ff4
229302.54,6.0,35,3,4,2,9,0xb2d759a1
505100.84,3.0,6,4,4,3,11,0xb2d98606
120007.84,3.0,12,3,4,3,10,0xb2d91db7
820175.38,5.0,19,4,4,2,10,0xb2d64989
2734.7,1.0,9,1,2,3,6,0xb2d24082
1161.53,1.0,3,1,2,4,7,0xb2d67471
151645.62,2.0,7,3,3,3,9,0xb2d39c20
3769.02,1.0,11,2,2,3,7,0xb2d2d892
156.74,1.0,0,1,2,4,7,0xb2d60e83
156337.67,2.0,0,3,3,4,10,0xb2d4de8a
9.5,1.0,66,1,2,2,5,0xb2d88af9
500010.56,2.0,67,4,3,1,8,0xb2d5dd2a
1197.48,2.0,92,1,3,1,5,0xb2d17d9dd
158979.9,4.0,41,3,4,2,9,0xb2d126a0d
100383.85,2.0,10,3,3,3,9,0xb2d6063b
1065.34,3.0,6,1,4,3,8,0xb2d06cda
873051.07,4.0,6,4,4,3,11,0xb2d277f7d
17631.41,1.0,0,2,2,4,8,0xb2d6bb58
2999.71,1.0,10,2,2,3,7,0xb2d6caf0
231758.74,2.0,0,3,3,4,10,0xb2d167aa
10000.11,2.0,45,2,3,2,7,0xb2d91d02
1148800.52,7.0,36,4,4,2,10,0xb2d43630
434.58,1.0,10,1,2,3,6,0xb2d90623
1251.1,1.0,6,1,2,3,6,0xb2d3654c
50009.58,2.0,53,2,3,2,7,0xb2d9cb1e
7463.06,1.0,54,2,2,2,6,0xb2d67db5
7645.35,1.0,1,2,2,4,8,0xb2d5c79fd
5.86,1.0,57,1,2,2,5,0xb2d9ac28
137.72,1.0,6,1,2,3,6,0xb2d22197
3729.99,1.0,201,2,2,1,5,0xb2d3ed94
361513.63,4.0,22,4,4,2,10,0xb2d5b1e5
4660.07,1.0,184,2,2,1,5,0xb2d18acf
600025.86,5.0,6,4,4,3,11,0xb2d96b64
117718.9,4.0,97,3,4,1,8,0xb2d56d0b
276.41,1.0,14,1,2,3,6,0xb2d91c4f
528790.14,2.0,0,4,3,4,11,0xb2d3775a
30005.38,2.0,67,2,3,1,6,0xb2d614c3
100007.39,2.0,11,3,3,3,9,0xb2d95b3f
3873.18,1.0,9,2,2,3,7,0xb2d26259
32.17,1.0,3,1,2,4,7,0xb2d55873
201521.11,2.0,61,3,3,2,8,0xb2d8fae7
390264.62,4.0,3,4,4,4,12,0xb2d0f5d9
3623.35,1.0,184,2,2,1,5,0xb2d2b98e
32.83,1.0,48,1,2,2,5,0xb2d96fd5
300006.17,4.0,20,3,4,2,9,0xb2d5d252
1321.2,1.0,7,1,2,3,6,0xb2d2645a
254448.16,3.0,0,3,4,4,11,0xb2d32f03
459.98,1.0,0,1,2,4,7,0xb2d23ffb
445359.13,13.0,3,4,4,4,12,0x3b9b2f0c
2414.8,1.0,92,1,2,1,4,0xb2d1fd78
7432.1,1.0,1,2,2,4,8,0xb2d459ea
1113183.58,4.0,4,4,4,4,12,0xb2d6fccc
500000.0,3.0,11,4,4,3,11,0xb2da4a15
194022.83,8.0,16,3,4,2,9,0x3b9b42bf
1930.99,2.0,184,1,3,1,5,0xb2d08bf4
109290.82,12.0,14,3,4,3,10,0xb2d2f28c
1407.13,1.0,92,1,2,1,4,0xb2d325ba
1512508.21,9.0,66,4,4,2,10,0xb2d3e5c2
8508.24,1.0,7,2,2,3,7,0xb2d34abc
747730.16,4.0,18,4,4,2,10,0xb2d61bf4
100092.11,2.0,1,3,3,4,10,0xb2d94787
3817821.39,16.0,4,4,4,4,12,0xb2d629b9
2854.72,1.0,16,1,2,2,5,0xb2d98731
341.22,1.0,42,1,2,2,5,0xb2d6bab3
1261594.21,4.0,18,4,4,2,10,0xb2d1a7f1d
405117.51,3.0,0,4,4,4,12,0xb2d772c4
10011.88,1.0,92,2,2,1,5,0xb2d3511d
10.39,1.0,30,1,2,2,5,0xb2d28223
900047.36,5.0,1,4,4,4,12,0xb2d61fd8
245212.34,4.0,56,3,4,2,9,0xb2d23f9b
80052.35,2.0,139,3,3,1,7,0xb2d17c1e
2650.84,1.0,5,1,2,3,6,0xb2d0dc37
50001.58,2.0,18,2,3,2,7,0xb2d5d2ce
8436.46,4.0,184,2,4,1,7,0xb2d381f8
283080.85,4.0,1,3,4,4,11,0xb2d64a0e
296919.89,1.0,41,3,2,2,7,0xb2d55ca1
6.28,1.0,56,1,2,2,5,0xb2d9a2a2
5251.89,1.0,10,2,2,3,7,0xb2d9f673
985.49,1.0,20,1,2,2,5,0xb2d54b9cd
111255.97,2.0,3,3,3,4,10,0xb2d5779d
305777.11,3.0,133,4,4,1,9,0xb2d42f96
30455.59,1.0,184,2,2,1,5,0xb2d23d34d
25327.99,1.0,0,2,2,4,8,0xb2d2aafe
2089.02,1.0,24,1,2,2,5,0xb2d29430
162490.45,2.0,168,3,3,1,7,0xb2d1c340
2543.57,1.0,9,1,2,3,6,0xb2d439bd
757008.72,35.0,3,4,4,4,12,0xb2d60638
20628.79,1.0,0,2,2,4,8,0xb2d45ec1
334667.71,3.0,3,4,4,4,12,0xb2d8c8a8
248019.72,4.0,111,3,4,1,8,0xb2d62a60
830012.37,6.0,55,4,4,2,10,0xb2d6eaf4
128.83,1.0,0,1,2,4,7,0xb2d8c51d
50469.59,1.0,184,2,2,1,5,0xb2d1d00d
0.0,1.0,3,1,2,4,7,0xb2d93b84
3706.88,1.0,184,2,2,1,5,0xb2d21871
552476.88,7.0,0,4,4,4,12,0xb2d598bd
2259.01,2.0,184,1,3,1,5,0xb2d0ec50
50912.54,2.0,158,2,3,1,6,0xb2d65a81
9.59,1.0,16,1,2,2,5,0xb2d92483
80003.29,3.0,20,3,4,2,9,0xb2d648c0
500080.1,3.0,4,4,4,4,12,0xb2d6fd67
33673.31,3.0,3,2,4,4,10,0xb2d0a645
1803038.06,2.0,48,4,3,2,9,0xb2d9be5e
4982.09,1.0,184,2,2,1,5,0xb2d25ce4
225270.83,2.0,6,3,3,3,9,0xb2d88a34
30004.15,1.0,0,2,2,4,8,0xb2d9b550
20000.57,3.0,1,2,4,4,10,0xb2d0c1db
200000.55,2.0,6,3,3,3,9,0xb2d8efce
213159.73,5.0,0,3,4,4,11,0xb2d3186e
100004.75,2.0,32,3,3,2,8,0xb2d96074d
423200.72,3.0,53,4,4,2,10,0xb2d4aab1
4704.52,1.0,15,2,2,3,7,0xb2d8cd2c
210003.27,4.0,53,3,4,2,9,0xb2d5a941d
25.91,1.0,57,1,2,2,5,0xb2d5e07e
8645.37,1.0,184,2,2,1,5,0xb2d11196
5151.38,1.0,5,2,2,3,7,0xb2d3b091
2250000.0,14.0,0,4,4,4,12,0xb2d168d9
42930.79,1.0,18,2,2,2,6,0xb2d417f7
412099.02,5.0,1,4,4,4,12,0xb2d10ed9
120019.26,2.0,143,3,3,1,7,0xb2d1cb10
1000026.4,3.0,11,4,4,3,11,0xb2d81034
100214.17,3.0,6,3,4,3,10,0xb2d93eac
10717.41,1.0,184,2,2,1,5,0xb2d396ea
123850.08,2.0,14,3,3,3,9,0xb2d424d2
20000.21,2.0,14,2,3,3,8,0xb2da335c
39658.71,1.0,26,2,2,2,6,0xb2d8e7e5
135052.45,3.0,0,3,4,4,11,0x3b9b2ae7
100720.66,9.0,0,3,4,4,11,0xb2d11ac6
795.57,1.0,10,1,2,3,6,0xb2d4149c
208027.41,4.0,83,3,4,1,8,0xb2d87e40
108.76,3.0,36,1,4,2,7,0xb2d1809e
6.42,1.0,92,1,2,1,4,0xb2d2bcb3
0.0,1.0,27,1,2,2,5,0xb2d6022a
67.55,1.0,20,1,2,2,5,0xb2d9a62e
501805.4,3.0,25,4,4,2,10,0xb2d9123a
22522.53,1.0,7,2,2,3,7,0xb2d6f593
1628.17,1.0,184,1,2,1,4,0xb2d23526
191570.82,1.0,0,3,2,4,9,0xb2d8a0ed
2234.5,1.0,184,1,2,1,4,0xb2d1c2aa
28070.7,1.0,6,2,2,3,7,0xb2d372f1
6.92,1.0,0,1,2,4,7,0xb2d2b4b6
717.34,1.0,14,1,2,3,6,0xb2d6026f
2411032.05,6.0,27,4,4,2,10,0xb2d0a511
4717.14,1.0,7,2,2,3,7,0xb2d12d57
900265.5,2.0,0,4,3,4,11,0xb2d2fb29
11970.11,1.0,0,2,2,4,8,0xb2d315f8d
1759.23,1.0,0,1,2,4,7,0xb2d38dfa
69.2,1.0,92,1,2,1,4,0xb2d246ac
112.66,1.0,11,1,2,3,6,0xb2d6acfa
3094.91,1.0,11,2,2,3,7,0xb2d5e10d
2338.12,2.0,119,1,3,1,5,0xb2d83cb0
320018.91,2.0,139,4,3,1,8,0xb2d6e2fb
202842.88,2.0,33,3,3,2,8,0xb2d7642a
37.02,1.0,11,1,2,3,6,0xb2d615ea
248.12,1.0,0,1,2,4,7,0xb2d31968
10000.23,2.0,77,2,3,1,6,0xb2d0e7d8
1219369.03,3.0,31,4,4,2,10,0xb2d5bd7a
631164.33,4.0,18,4,4,2,10,0xb2d0d03c
104090.43,2.0,157,3,3,1,7,0xb2d248e2
3577.22,1.0,35,2,2,2,6,0xb2d2ef32
900000.88,2.0,1,4,3,4,11,0xb2d925e7
50671.75,1.0,274,2,2,1,5,0xb2d63629d
500000.54,2.0,103,4,3,1,8,0xb2d78418
10000.05,2.0,67,2,3,1,6,0xb2d2b38e
526167.85,2.0,5,4,3,3,10,0xb2d16622
211007.42,2.0,3,3,3,4,10,0xb2d4cc3f
120635.49,2.0,2,3,3,4,10,0xb2d952e7
252427.04,3.0,0,3,4,4,11,0xb2d1801e
2321000.85,5.0,18,4,4,2,10,0xb2d46611d
28.29,1.0,3,1,2,4,7,0xb2d68b65
427337.34,2.0,10,4,3,3,10,0xb2d53ce8d
201421.15,2.0,77,3,3,1,7,0xb2d99924
315324.87,3.0,9,4,4,3,11,0xb2d2cbfb
480013.32,2.0,20,4,3,2,9,0xb2d12a9c
7170.27,1.0,92,2,2,1,5,0xb2d1eff0
700000.0,4.0,2,4,4,4,12,0xb2d41322
220026.65,2.0,216,3,3,1,7,0xb2d52677
27.16,1.0,0,1,2,4,7,0xb2d54f63
2015637.16,1.0,1,4,2,4,10,0xb2d29025
13145.36,1.0,5,2,2,3,7,0xb2d8e7b8
2146.29,1.0,10,1,2,3,6,0xb2d34ec7
1061.52,1.0,184,1,2,1,4,0xb2d06bc9
378223.41,10.0,0,4,4,4,12,0x3b9b4880d
1007.83,1.0,184,1,2,1,4,0xb2d42245
130292.17,4.0,39,3,4,2,9,0xb2d64e91d
2468.45,1.0,0,1,2,4,7,0xb2d34d1d
60965.46,6.0,0,3,4,4,11,0xb2d28df1
51801.78,2.0,76,2,3,1,6,0xb2d6332a
109602.31,1.0,1,3,2,4,9,0xb2d5ee6d
11.89,1.0,75,1,2,1,4,0xb2d5dbe9d
100093.34,2.0,104,3,3,1,7,0xb2d64587
5616.13,1.0,2,2,2,4,8,0xb2d2121e
537174.42,12.0,13,4,4,3,11,0xb2d4fa60
139229.72,1.0,0,3,2,4,9,0xb2d609df
2970067.24,2.0,108,4,3,1,8,0xb2d41461
110023.29,3.0,124,3,4,1,8,0xb2d11f32
43521.5,1.0,8,2,2,3,7,0x3b9b1a07
450016.66,4.0,1,4,4,4,12,0xb2d44232
1696665.18,1.0,0,4,2,4,10,0xb2d2eb6e
219957.2,2.0,0,3,3,4,10,0xb2d65282
512851.36,4.0,98,4,4,1,9,0xb2d5c545
682329.38,13.0,0,4,4,4,12,0xb2d0db79
94043.37,2.0,79,3,3,1,7,0xb2d1794e
57812.98,1.0,149,3,2,1,6,0xb2d359d9
0.0,1.0,6,1,2,3,6,0xb2d50fa3
352797.36,4.0,0,4,4,4,12,0xb2d1daba
1153.07,2.0,92,1,3,1,5,0xb2d09879
30001.58,2.0,92,2,3,1,6,0xb2d65cc5
302131.52,2.0,64,4,3,2,9,0xb2d9b82b
1.76,1.0,20,1,2,2,5,0xb2d790f7
23152.11,1.0,1,2,2,4,8,0xb2d0cef1
16137.81,1.0,5,2,2,3,7,0xb2d100edd
750.74,1.0,21,1,2,2,5,0xb2d1de2a
4122.6,1.0,1,2,2,4,8,0xb2d8e417
200712.72,2.0,18,3,3,2,8,0xb2d98233
62001.86,2.0,92,3,3,1,7,0xb2d636a6
7170.44,1.0,29,2,2,2,6,0xb2d92660
150097.64,2.0,24,3,3,2,8,0xb2d3bc5cd
1089.61,1.0,10,1,2,3,6,0xb2da2118
590091.35,5.0,10,4,4,3,11,0xb2d0e7ff
15024.05,1.0,11,2,2,3,7,0xb2d40023
53.28,1.0,9,1,2,3,6,0xb2d8ca5e
7605.89,1.0,5,2,2,3,7,0xb2d6f279
20092.09,2.0,18,2,3,2,7,0xb2d39399
50399.77,6.0,0,2,4,4,10,0x3b9b1c0ad
2603920.45,5.0,1,4,4,4,12,0xb2d54946
2054091.14,12.0,25,4,4,2,10,0xb2d4f3a1
269.91,1.0,15,1,2,3,6,0xb2d16f40
13.45,2.0,9,1,3,3,7,0xb2d8f9f0
40017.83,2.0,30,2,3,2,7,0xb2d93cb3
163255.36,3.0,4,3,4,4,11,0xb2d1cb82
75723.75,2.0,2,3,3,4,10,0xb2d07283
49541.1,1.0,17,2,2,2,6,0xb2d92bfb
489000.0,2.0,7,4,3,3,10,0xb2d96e6f
3417.11,1.0,92,2,2,1,5,0xb2d3f384
150138.69,2.0,214,3,3,1,7,0xb2d56057
3958.6,1.0,3,2,2,4,8,0xb2d32c0c
500021.27,2.0,161,4,3,1,8,0xb2d50f7c
1667.71,1.0,44,1,2,2,5,0xb2d2cc49
325687.23,2.0,165,4,3,1,8,0xb2d6cc14
1430.79,1.0,8,1,2,3,6,0xb2d41a27d
540.39,1.0,9,1,2,3,6,0xb2d74465
283000.0,5.0,6,3,4,3,10,0xb2d14d1d
20295.26,1.0,184,2,2,1,5,0xb2d17225
150226.31,3.0,30,3,4,2,9,0xb2d26856
3772.17,4.0,1,2,4,4,10,0xb2d34515
54334.16,1.0,2,3,2,4,9,0xb2d0fba6
2771.84,1.0,1,1,2,4,7,0xb2d8c4eb
150007.39,3.0,20,3,4,2,9,0xb2da1cce
150049.5,2.0,24,3,3,2,8,0xb2d614ba
6.65,1.0,33,1,2,2,5,0xb2d9f43e
2072.09,1.0,12,1,2,3,6,0xb2d53155
10001.6,3.0,41,2,4,2,8,0xb2d2c5b8d
535683.18,2.0,92,4,3,1,8,0xb2d23f37d
200000.0,2.0,11,3,3,3,9,0xb2d968b9
10013.8,1.0,17,2,2,2,6,0xb2d9c5b0
200000.42,2.0,1,3,3,4,10,0xb2da06a2
208304.54,8.0,2,3,4,4,11,0xb2d57275
40001.47,3.0,53,2,4,2,8,0xb2d9c63b
204286.52,2.0,75,3,3,1,7,0xb2d50f0e
610000.0,2.0,0,4,3,4,11,0xb2d627cb
4019.29,1.0,3,2,2,4,8,0xb2d6a75d
2181.41,1.0,139,1,2,1,4,0xb2d68619
97.95,1.0,6,1,2,3,6,0xb2d4b9a8
204835.6,4.0,25,3,4,2,9,0xb2d51b25
100493.58,1.0,14,3,2,3,8,0xb2d42660
26.92,1.0,34,1,2,2,5,0xb2d946a7
2927.4,1.0,6,2,2,3,7,0xb2d7471d
852.35,4.0,0,1,4,4,9,0xb2d22ed5
2260093.13,2.0,181,4,3,1,8,0xb2d19e81
3605.79,1.0,184,2,2,1,5,0x3b9b3717
19307.36,1.0,9,2,2,3,7,0xb2d3137ed
60657.84,2.0,0,3,3,4,10,0xb2d5deb7
87.98,1.0,17,1,2,2,5,0xb2d6c182
465.84,1.0,41,1,2,2,5,0xb2d48885
344.18,1.0,10,1,2,3,6,0xb2d7d889
150015.64,4.0,45,3,4,2,9,0xb2d15c82
21204314.64,176.0,1,4,4,4,12,0xb2d155d0
71341.35,3.0,0,3,4,4,11,0xb2d5daadd
722497.15,5.0,14,4,4,3,11,0xb2d1941a
341576.75,4.0,0,4,4,4,12,0xb2d0623a
550765.26,8.0,1,4,4,4,12,0xb2d4fa60d
4874.08,36.0,92,2,4,1,7,0xb2d4259a
50665.76,1.0,2,2,2,4,8,0xb2d2a377d
2259.96,1.0,1,1,2,4,7,0xb2d323a3
521081.58,2.0,101,4,3,1,8,0xb2d36620d
747913.91,17.0,0,4,4,4,12,0x3b9b4692
412672.93,7.0,13,4,4,3,11,0xb2d620d3
1710780.81,4.0,25,4,4,2,10,0xb2d240b2
754059.79,4.0,8,4,4,3,11,0xb2d640b7d
40021.54,1.0,16,2,2,2,6,0xb2d284e8
20557.43,2.0,10,2,3,3,8,0xb2d60d5d
4.56,1.0,52,1,2,2,5,0xb2d8e3f4
20080.63,2.0,123,2,3,1,6,0xb2d694de
212939.25,2.0,16,3,3,2,8,0xb2d0b6bf
102533.9,2.0,15,3,3,3,9,0xb2d5bfd4
793008.41,4.0,92,4,4,1,9,0xb2d4d4a0
63771.73,2.0,3,3,3,4,10,0xb2d4da08
3688.7,1.0,184,2,2,1,5,0xb2d25412
2741.0,1.0,92,1,2,1,4,0xb2d3501b
70000.74,2.0,28,3,3,2,8,0xb2da09e1
10011.32,2.0,57,2,3,2,7,0xb2d9aa0c
9617.2,1.0,8,2,2,3,7,0xb2d6cef5
250660.64,7.0,1,3,4,4,11,0xb2d59f03d
467065.47,7.0,30,4,4,2,10,0xb2d1b545
701948.89,3.0,3,4,4,4,12,0xb2d5fc1c
3576.1,1.0,4,2,2,4,8,0xb2d1c2cb
4.22,1.0,82,1,2,1,4,0xb2d7045d
3786.11,1.0,129,2,2,1,5,0xb2d5fe23
100006.5,2.0,132,3,3,1,7,0xb2d242a0
0.73,1.0,4,1,2,4,7,0xb2d9e4b3
1142.79,2.0,159,1,3,1,5,0xb2d467d5
200002.0,2.0,1,3,3,4,10,0xb2da2b31
335000.0,1.0,1,4,2,4,10,0xb2da27e0
508021.58,3.0,118,4,4,1,9,0xb2d0fdc5
250000.38,3.0,23,3,4,2,9,0xb2d8f69e
2665.85,1.0,10,1,2,3,6,0xb2d9d3ce
4013.07,1.0,0,2,2,4,8,0xb2d9d4a4
1058.4,2.0,92,1,3,1,5,0xb2d48d86
664000.24,10.0,1,4,4,4,12,0xb2d14532
4914.83,1.0,0,2,2,4,8,0xb2d6e888
31.64,1.0,4,1,2,4,7,0xb2d281e4
91516.28,1.0,0,3,2,4,9,0xb2d4637e
83370.62,1.0,1,3,2,4,9,0xb2d3270d
263.54,1.0,4,1,2,4,7,0xb2d2f0ab
89815.57,1.0,4,3,2,4,9,0xb2d2a8af
76.47,1.0,60,1,2,2,5,0xb2d1bb0f
61.36,1.0,14,1,2,3,6,0xb2d6d394
440125.06,4.0,0,4,4,4,12,0xb2d0acdf
305503.5,4.0,81,4,4,1,9,0xb2d5c35b
232024.08,2.0,6,3,3,3,9,0xb2d9f3e9
180050.74,3.0,38,3,4,2,9,0xb2d41f48
30175.44,1.0,92,2,2,1,5,0xb2d14559
50001.06,2.0,18,2,3,2,7,0xb2d94b6b
1420000.0,1.0,1,4,2,4,10,0xb2da4f45
7.38,1.0,24,1,2,2,5,0xb2d24ba3
369242.48,1.0,20,4,2,2,8,0xb2d309da
601632.6,6.0,4,4,4,4,12,0xb2d207ef
2064.73,1.0,35,1,2,2,5,0xb2d3e388d
390000.0,2.0,0,4,3,4,11,0xb2d97c53
295236.0,11.0,0,3,4,4,11,0x3b9af14a
16287.04,1.0,10,2,2,3,7,0xb2d3a93b
86657.06,2.0,9,3,3,3,9,0xb2d8d421
445328.39,2.0,79,4,3,1,8,0xb2d62ca9d
630012.19,4.0,31,4,4,2,10,0xb2d64192d
5124904.27,12.0,0,4,4,4,12,0xb2d25346
65190.74,1.0,5,3,2,3,8,0xb2d134e9
9116.06,1.0,21,2,2,2,6,0xb2d688c9
3529.73,1.0,8,2,2,3,7,0xb2d128f8
17.4,1.0,34,1,2,2,5,0xb2d5e785
100000.54,2.0,0,3,3,4,10,0xb2d0ea54
587238.01,2.0,184,4,3,1,8,0xb2d180d4
8101.32,1.0,18,2,2,2,6,0xb2d418de
100074.61,2.0,122,3,3,1,7,0xb2d2e11d
200045.68,2.0,32,3,3,2,8,0xb2d70801
111422.57,6.0,4,3,4,4,11,0xb2d6294c
91342.79,1.0,9,3,2,3,8,0xb2d916a8
1476004.81,5.0,11,4,4,3,11,0xb2d5fe36
315.53,1.0,0,1,2,4,7,0xb2d34448
500000.06,2.0,5,4,3,3,10,0xb2d946a8
516313.59,4.0,49,4,4,2,10,0xb2d24109
251518.41,2.0,0,3,3,4,10,0xb2d94475d
62531.86,1.0,184,3,2,1,6,0xb2d269e6
50002.64,2.0,118,2,3,1,6,0xb2d93f12
80002.53,2.0,18,3,3,2,8,0xb2da2723
4500.78,1.0,1,2,2,4,8,0xb2d30b06
413045.42,4.0,20,4,4,2,10,0xb2d1d85e
1154.86,1.0,8,1,2,3,6,0xb2d3245a
200009.42,2.0,18,3,3,2,8,0xb2d5bfa9
2122528.82,11.0,11,4,4,3,11,0xb2d66a7a
0.52,1.0,9,1,2,3,6,0xb2d91836
120.97,1.0,0,1,2,4,7,0xb2d906db
5515.1,1.0,1,2,2,4,8,0xb2d386a9
20139.86,1.0,45,2,2,2,6,0xb2d35e3d
23929.28,1.0,13,2,2,3,7,0xb2d31df5
550925.01,3.0,54,4,4,2,10,0xb2d223f3
380040.92,2.0,66,4,3,2,9,0xb2d598fd
1209.73,1.0,184,1,2,1,4,0xb2d4af6ad
335.29,1.0,19,1,2,2,5,0xb2d1baaad
0.6,1.0,74,1,2,1,4,0xb2d5ad56
10.56,1.0,27,1,2,2,5,0xb2d96e01
622146.63,7.0,60,4,4,2,10,0xb2d7904d
1066.65,3.0,0,1,4,4,9,0xb2d069ce
20.87,1.0,7,1,2,3,6,0xb2d598d7
22.84,1.0,3,1,2,4,7,0xb2d82703
2253.91,2.0,27,1,3,2,6,0xb2d8ffdb
6698.8,1.0,184,2,2,1,5,0xb2d41b05
3317396.25,5.0,48,4,4,2,10,0xb2d6bcc0d
974.5,1.0,0,1,2,4,7,0xb2d2e663
3031.21,1.0,4,2,2,4,8,0xb2d34426
510799.54,2.0,14,4,3,3,10,0xb2d81e36
273284.94,7.0,40,3,4,2,9,0xb2d416be
27007.26,34.0,0,2,4,4,10,0x3b9b30d8
96.9,1.0,105,1,2,1,4,0xb2d60ab7
40007.82,3.0,6,2,4,3,9,0xb2d621e8
170032.69,3.0,114,3,4,1,8,0xb2d16e22
1210646.59,2.0,21,4,3,2,9,0xb2d41064
30000.53,3.0,66,2,4,2,8,0xb2d8cfd4d
2.04,1.0,26,1,2,2,5,0xb2d5baef
1.1,1.0,36,1,2,2,5,0xb2d9adaa
332573.02,2.0,6,4,3,3,10,0xb2d626a6
190108.38,5.0,9,3,4,3,10,0xb2d0844f
2500000.0,4.0,3,4,4,4,12,0xb2d67e20
9400.38,16.0,184,2,4,1,7,0xb2d36b88d
6229.51,1.0,19,2,2,2,6,0xb2d8e255
175.55,1.0,10,1,2,3,6,0xb2d97f1f
100001.06,2.0,42,3,3,2,8,0xb2d6c807
30000.32,2.0,34,2,3,2,7,0xb2d931fd
1296.09,1.0,128,1,2,1,4,0xb2d92bf8
8422.44,1.0,7,2,2,3,7,0xb2d9692e
420000.0,2.0,3,4,3,4,11,0xb2d9793b
211014.17,2.0,167,3,3,1,7,0xb2d363c8
200710.53,2.0,55,3,3,2,8,0xb2d90737
5705.71,1.0,21,2,2,2,6,0xb2d305d8d
123880.64,8.0,95,3,4,1,8,0xb2d60b84
1644045.87,18.0,5,4,4,3,11,0xb2d07a6e
0.11,1.0,33,1,2,2,5,0xb2d92ca1
1726019.19,7.0,32,4,4,2,10,0xb2d502da
18795.08,1.0,25,2,2,2,6,0xb2d2fe93
252008.9,3.0,77,3,4,1,8,0xb2d921c9
10000.32,2.0,137,2,3,1,6,0xb2d91589
161.67,1.0,20,1,2,2,5,0xb2d280f2
33026.95,4.0,3,2,4,4,10,0xb2d5da13
550053.32,4.0,116,4,4,1,9,0xb2d2c5c6
19.36,1.0,65,1,2,2,5,0xb2d63a69
3613.25,60.0,18,2,4,2,8,0xb2d13bbe
13810.0,1.0,1,2,2,4,8,0xb2d5ba81
18290.23,1.0,0,2,2,4,8,0xb2d6e87cd
446.98,1.0,116,1,2,1,4,0xb2d4ef78
1409.8,1.0,11,1,2,3,6,0xb2d34f7cd
750.84,1.0,18,1,2,2,5,0xb2d5d2cf
644.77,1.0,17,1,2,2,5,0xb2d6fd89
584112.98,8.0,0,4,4,4,12,0xb2d576ead
734314.16,4.0,34,4,4,2,10,0xb2d2d34c
448.96,1.0,2,1,2,4,7,0xb2d912ad
7197.14,1.0,25,2,2,2,6,0xb2d97ce2
1014.35,1.0,34,1,2,2,5,0xb2d56c4f
1920130.34,12.0,34,4,4,2,10,0xb2d3838d
210748.64,2.0,30,3,3,2,8,0xb2d77fa0d
7890.75,1.0,0,2,2,4,8,0xb2d2a6e4
318609.26,3.0,0,4,4,4,12,0xb2d5fb3f
538038.4,4.0,5,4,4,3,11,0xb2d60ed8
393550.64,1.0,20,4,2,2,8,0xb2d6293b
47359.67,1.0,136,2,2,1,5,0xb2d3cbcc
498.03,1.0,10,1,2,3,6,0xb2d56c94
0.4,1.0,7,1,2,3,6,0xb2d5ad88
284645.17,11.0,7,3,4,3,10,0x3b9b1867
671039.07,2.0,13,4,3,3,10,0xb2d8f1e9
101.86,1.0,12,1,2,3,6,0xb2d1d47e
8427.03,1.0,48,2,2,2,6,0xb2d12357
6.34,1.0,111,1,2,1,4,0xb2d95295d
4360028.13,7.0,0,4,4,4,12,0xb2d893f5
675875.61,5.0,101,4,4,1,9,0xb2d2e254
3093.02,1.0,184,2,2,1,5,0xb2d2aec1
8723.06,1.0,10,2,2,3,7,0xb2d9ed54
6451.15,1.0,9,2,2,3,7,0xb2d8cca6
1081.08,1.0,92,1,2,1,4,0xb2d229e5
111617.82,2.0,108,3,3,1,7,0xb2d5757b
100009.92,1.0,1,3,2,4,9,0xb2d656b2
25016.18,2.0,139,2,3,1,6,0xb2d61bfc
297.14,1.0,20,1,2,2,5,0xb2d20bbd
617.54,1.0,0,1,2,4,7,0xb2d6baa2
14216.04,1.0,13,2,2,3,7,0xb2d3311c
500000.0,2.0,12,4,3,3,10,0xb2da37ca
4878.76,36.0,184,2,4,1,7,0xb2d4259ad
105084.08,11.0,1,3,4,4,11,0xb2d56328
32051.56,10.0,3,2,4,4,10,0xb2d234b3
304135.05,4.0,97,4,4,1,9,0xb2d62d3a
14000.74,2.0,27,2,3,2,7,0xb2da07d9
420026.13,5.0,63,4,4,2,10,0xb2d417ac
1200287.64,6.0,48,4,4,2,10,0xb2d63c22
5115.44,1.0,9,2,2,3,7,0xb2d33d96
5287.77,1.0,106,2,2,1,5,0xb2d35e46
42.55,1.0,4,1,2,4,7,0xb2d07048
1955.67,1.0,5,1,2,3,6,0xb2d3528f
805.18,1.0,10,1,2,3,6,0xb2d1d5f5
9334.02,5.0,92,2,4,1,7,0x3b9b276c
40002.12,3.0,92,2,4,1,7,0xb2d62ba9
200086.17,2.0,235,3,3,1,7,0xb2d2e46b
105198.17,2.0,28,3,3,2,8,0xb2d5025c
38.09,1.0,23,1,2,2,5,0xb2d5c7e7
830.64,1.0,2,1,2,4,7,0xb2d6da5d
209692.58,2.0,39,3,3,2,8,0xb2d19204
1200845.39,6.0,18,4,4,2,10,0xb2d5ab67
483118.9,4.0,0,4,4,4,12,0xb2d54c13
721162.36,12.0,0,4,4,4,12,0xb2d06745
3304.16,1.0,14,2,2,3,7,0xb2d6b8a3
75600.0,2.0,35,3,3,2,8,0xb2d9fd2f
11344.85,1.0,1,2,2,4,8,0xb2d97b12
3603.3,1.0,92,2,2,1,5,0xb2d5c7b4
250192.89,3.0,9,3,4,3,10,0xb2d6ff76
1730535.44,5.0,2,4,4,4,12,0xb2d7546e
5643.76,1.0,29,2,2,2,6,0xb2d3ce4b
153760.34,2.0,228,3,3,1,7,0xb2d234e0
14530.98,1.0,10,2,2,3,7,0xb2d39c18
6.34,1.0,9,1,2,3,6,0xb2d8ef4e
3.53,2.0,57,1,3,2,6,0xb2d9447c
457499.84,4.0,21,4,4,2,10,0xb2d9242c
109.36,1.0,9,1,2,3,6,0xb2d31884
20356.86,2.0,76,2,3,1,6,0xb2d63a48
500034.14,3.0,8,4,4,3,11,0xb2d6ea1f
500000.0,2.0,24,4,3,2,9,0xb2d94add
791979.06,4.0,23,4,4,2,10,0xb2d68def
20301.13,2.0,94,2,3,1,6,0xb2d84e4c
425889.93,13.0,6,4,4,3,11,0xb2d5361f
28097.66,1.0,14,2,2,3,7,0xb2d7fdb6
402897.03,3.0,56,4,4,2,10,0xb2d59516
440.82,1.0,0,1,2,4,7,0xb2d2cec1
40762.96,2.0,0,2,3,4,9,0xb2d38cac
457089.96,4.0,0,4,4,4,12,0xb2d12c11
10949.72,1.0,7,2,2,3,7,0xb2d36c69
143492.09,1.0,10,3,2,3,8,0xb2d8c4f8
140782.47,9.0,0,3,4,4,11,0xb2d3a12f
782486.89,3.0,25,4,4,2,10,0xb2d5c4eb
505014.94,2.0,1,4,3,4,11,0xb2d6d8e1
5017.68,1.0,3,2,2,4,8,0xb2d2c42f
970010.24,2.0,98,4,3,1,8,0xb2d6353d
151733.87,4.0,32,3,4,2,9,0xb2d0d9bf
783015.34,8.0,9,4,4,3,11,0xb2d10992
700000.0,2.0,6,4,3,3,10,0xb2d972b3
3004.79,1.0,160,2,2,1,5,0xb2d6ba60
310051.41,5.0,27,4,4,2,10,0xb2d60fa2
649194.76,8.0,11,4,4,3,11,0xb2d1232a
883712.21,7.0,25,4,4,2,10,0xb2d6a2de
17501.74,1.0,0,2,2,4,8,0xb2d9f5d1
0.0,1.0,5,1,2,3,6,0xb2d11c2b
400006.73,2.0,4,4,3,4,11,0xb2d62c43
53624.54,2.0,6,3,3,3,9,0xb2d57847
188481.43,1.0,0,3,2,4,9,0xb2d618a4
160039.55,4.0,30,3,4,2,9,0xb2d40bea
375.3,1.0,15,1,2,3,6,0xb2d18a7f
39715.97,1.0,105,2,2,1,5,0xb2d1092f
334.11,1.0,10,1,2,3,6,0xb2d38a3d
236641.11,1.0,5,3,2,3,8,0xb2d77f5b
10004.64,2.0,185,2,3,1,6,0xb2d5e420
1719.59,1.0,9,1,2,3,6,0xb2d6302a
0.11,1.0,4,1,2,4,7,0xb2d1b56b
2401.01,1.0,0,1,2,4,7,0xb2d70210
20001.55,2.0,111,2,3,1,6,0xb2d6b33ed
0.58,1.0,32,1,2,2,5,0xb2d6257d
787436.17,2.0,87,4,3,1,8,0xb2d58cef
10057.72,1.0,29,2,2,2,6,0xb2d92bfe
33701.29,1.0,6,2,2,3,7,0xb2d6dff0
140.33,1.0,90,1,2,1,4,0xb2d50d01
435.86,1.0,7,1,2,3,6,0xb2d6c8e2
200721.02,3.0,97,3,4,1,8,0xb2d49d72
280032.17,4.0,21,3,4,2,9,0x3b9b41e2
37.5,1.0,32,1,2,2,5,0xb2d39efd
795038.07,11.0,75,4,4,1,9,0xb2d2ade5
75002.38,2.0,92,3,3,1,7,0xb2d5db56
10353.92,1.0,18,2,2,2,6,0xb2d4c864
27708.38,1.0,0,2,2,4,8,0xb2d45ada
301068.98,2.0,5,4,3,3,10,0xb2d6be36
201462.26,2.0,62,3,3,2,8,0xb2d23a40
19555.79,1.0,0,2,2,4,8,0xb2d39255
1523.61,1.0,184,1,2,1,4,0xb2d136b6d
1004.56,1.0,0,1,2,4,7,0xb2d6eceb
1421.04,1.0,92,1,2,1,4,0xb2d35026
280005.06,3.0,119,3,4,1,8,0xb2d93be7d
453.85,11.0,0,1,4,4,9,0xb2d17f84
2662.0,1.0,184,1,2,1,4,0xb2d3b3f7
0.0,1.0,8,1,2,3,6,0xb2d6bf40
4864.09,1.0,11,2,2,3,7,0xb2d918dc
400005.37,6.0,179,4,4,1,9,0xb2d0fd15
362558.62,2.0,63,4,3,2,9,0xb2d6e5ac
0.0,1.0,48,1,2,2,5,0xb2d9166cd
2046.35,1.0,67,1,2,1,4,0xb2d4fd61
1264814.29,5.0,21,4,4,2,10,0xb2d19b34
161865.86,2.0,60,3,3,2,8,0xb2d141cbd
2020.86,3.0,136,1,4,1,6,0xb2d53193
13250.27,2.0,80,2,3,1,6,0xb2d5d0d1
77314.89,2.0,83,3,3,1,7,0xb2d6a134
212481.9,1.0,6,3,2,3,8,0xb2d8e0b3
103068.42,2.0,39,3,3,2,8,0xb2d19ed9
550310.07,3.0,6,4,4,3,11,0xb2d3fcf1
44678.67,1.0,194,2,2,1,5,0xb2d298f4d
110.35,1.0,27,1,2,2,5,0xb2d63813
5.52,1.0,4,1,2,4,7,0xb2d5a599
227007.19,2.0,94,3,3,1,7,0xb2d85769
315479.28,5.0,0,4,4,4,12,0xb2d06522
1947.75,1.0,0,1,2,4,7,0xb2d8da51
115049.96,3.0,0,3,4,4,11,0xb2d1a0c1d
4015.91,1.0,138,2,2,1,5,0xb2d3c748
204726.32,3.0,0,3,4,4,11,0xb2d2edf3
29.65,1.0,184,1,2,1,4,0xb2d33ed0
0.68,1.0,2,1,2,4,7,0xb2d6908bd
0.0,3.0,6,1,4,3,8,0xb2d2f13e
100065.39,2.0,32,3,3,2,8,0xb2d5ebe9
36425.32,1.0,10,2,2,3,7,0xb2d3718c
370008.93,2.0,0,4,3,4,11,0xb2d2cdc9
50058.05,2.0,79,2,3,1,6,0xb2d5e387
100004.22,2.0,213,3,3,1,7,0xb2d6824f
50001.06,2.0,130,2,3,1,6,0xb2d929e6
2461.08,1.0,184,1,2,1,4,0xb2d2d6bdd
20215.57,1.0,101,2,2,1,5,0xb2d61e7e
506096.28,2.0,110,4,3,1,8,0xb2d6a387
111800.32,2.0,2,3,3,4,10,0xb2d0a30b
81.31,1.0,16,1,2,2,5,0xb2d6a799
16.6,1.0,41,1,2,2,5,0xb2d0e439
504165.24,4.0,3,4,4,4,12,0x3b9b311b
5050.1,3.0,13,2,4,3,9,0xb2d60810
941910.69,3.0,49,4,4,2,10,0xb2d903cb
1004.98,1.0,9,1,2,3,6,0xb2d259c1
658028.83,5.0,1,4,4,4,12,0xb2d20808
50026.53,2.0,2,2,3,4,9,0xb2d94766d
4588.52,1.0,0,2,2,4,8,0xb2d4f6fd
100001.76,1.0,0,3,2,4,9,0xb2d251e2
820023.56,7.0,1,4,4,4,12,0xb2d6286c
31446.88,1.0,0,2,2,4,8,0xb2d2ac80
10620.82,1.0,302,2,2,1,5,0xb2d12528
727331.19,4.0,28,4,4,2,10,0xb2d4ac59
19633.28,1.0,9,2,2,3,7,0xb2d5375c
6.85,1.0,38,1,2,2,5,0xb2d14adb
890220.78,7.0,8,4,4,3,11,0xb2d0cb04
1128648.65,2.0,168,4,3,1,8,0xb2d4ea0a
3310.54,1.0,1,2,2,4,8,0xb2d6a0bc
114924.6,4.0,12,3,4,3,10,0xb2d43402
900067.01,5.0,111,4,4,1,9,0xb2d16dc2
129.86,8.0,0,1,4,4,9,0xb2d06489
2017.51,1.0,2,1,2,4,7,0xb2d5da29
2590.18,1.0,45,1,2,2,5,0xb2d16172
101179.13,2.0,132,3,3,1,7,0xb2d6ccf4
47.36,1.0,5,1,2,3,6,0xb2d3f648
623047.63,11.0,1,4,4,4,12,0xb2d64a15
691857.85,6.0,0,4,4,4,12,0xb2d1e8e0
90880.28,2.0,66,3,3,2,8,0xb2d6a0e8
1296.22,2.0,184,1,3,1,5,0xb2d1acdb
51674.78,3.0,53,2,4,2,8,0xb2d41d1c
1965308.92,9.0,0,4,4,4,12,0xb2d19a17
71308.25,3.0,20,3,4,2,9,0xb2d5e752
22467.38,1.0,13,2,2,3,7,0xb2d559ef
180150.15,2.0,27,3,3,2,8,0xb2d39b03
140254.2,2.0,151,3,3,1,7,0xb2d5b01e
262537.75,4.0,0,3,4,4,11,0xb2d21962
165679.76,1.0,0,3,2,4,9,0xb2d6df08
625003.8,6.0,4,4,4,4,12,0xb2d58ba4
725446.07,3.0,11,4,4,3,11,0xb2d29f03
9401.0,2.0,0,2,3,4,9,0xb2d096d6
114055.99,3.0,73,3,4,1,8,0xb2d14598
590061.1,3.0,14,4,4,3,11,0xb2d1e774
330039.64,4.0,69,4,4,1,9,0xb2d580cbd
5.4,1.0,76,1,2,1,4,0xb2d60a60
396052.23,9.0,0,4,4,4,12,0xb2d1dfea
5820.62,1.0,2,2,2,4,8,0xb2d2b815
280095.23,3.0,104,3,4,1,8,0xb2d48e35
590001.28,8.0,1,4,4,4,12,0xb2d5ad5cd
3590.6,1.0,1,2,2,4,8,0xb2d5726c
93.36,3.0,11,1,4,3,8,0xb2d06779
283710.83,3.0,28,3,4,2,9,0xb2d1de59
1320.96,1.0,9,1,2,3,6,0xb2d1dd59
53298.66,2.0,11,3,3,3,9,0xb2d08cdd
497000.22,11.0,21,4,4,2,10,0xb2d0d7ac
54162.42,2.0,48,3,3,2,8,0xb2d16a71
51451.82,2.0,87,2,3,1,6,0xb2d5963b
66001.52,5.0,18,3,4,2,9,0xb2d564c7
400084.3,5.0,14,4,4,3,11,0xb2d53dc4
733716.16,2.0,157,4,3,1,8,0xb2d0d606d
1513079.13,4.0,0,4,4,4,12,0xb2d0c12a
513226.01,2.0,157,4,3,1,8,0xb2d446ed
255735.87,3.0,3,3,4,4,11,0xb2d257bb
200000.0,2.0,6,3,3,3,9,0xb2da4f90
2336.11,1.0,27,1,2,2,5,0xb2d2d316
1723.66,1.0,0,1,2,4,7,0xb2d910b2
19.04,1.0,2,1,2,4,7,0xb2d47309d
26.43,1.0,28,1,2,2,5,0xb2d06a36
21657.9,2.0,24,2,3,2,7,0xb2d57a1c
520011.47,4.0,18,4,4,2,10,0xb2d8c3c7
110146.15,2.0,27,3,3,2,8,0xb2d41036d
755015.59,4.0,35,4,4,2,10,0xb2d64ee0
692077.94,6.0,0,4,4,4,12,0xb2d2019b
50061.64,2.0,104,2,3,1,6,0xb2d60c28
90000.0,2.0,3,3,3,4,10,0xb2d975b3
49112.69,1.0,29,2,2,2,6,0xb2d42882
650000.0,20.0,0,4,4,4,12,0xb2d25d3b
0.81,1.0,4,1,2,4,7,0xb2d90fc8
1025.04,1.0,293,1,2,1,4,0xb2d1d4c5
3019.48,5.0,4,2,4,4,10,0xb2d18142d
41330.97,1.0,0,2,2,4,8,0xb2d6a7cd
60002.0,3.0,182,3,4,1,8,0xb2d6e6f4
108224.15,4.0,129,3,4,1,8,0xb2d393a5
90082.72,4.0,49,3,4,2,9,0xb2d173b9
4507.01,1.0,18,2,2,2,6,0xb2d6a5a1
500015.83,2.0,94,4,3,1,8,0xb2d86d25
4045999.47,18.0,7,4,4,3,11,0xb2d11f9a
52000.0,2.0,0,2,3,4,9,0xb2d45492d
310259.18,3.0,0,4,4,4,12,0xb2d31f7fd
170270.72,8.0,18,3,4,2,9,0xb2d0a45ad
32238.7,1.0,1,2,2,4,8,0xb2d99338
506635.49,2.0,11,4,3,3,10,0xb2d0e9dc
406349.01,4.0,0,4,4,4,12,0xb2d1056fd
0.0,1.0,8,1,2,3,6,0xb2d388e9
30252.79,3.0,104,2,4,1,7,0xb2d68437
1434.5,1.0,6,1,2,3,6,0xb2d26d25
405003.08,16.0,25,4,4,2,10,0xb2d603e7
10265.32,1.0,0,2,2,4,8,0xb2d40bff
150001.58,2.0,35,3,3,2,8,0xb2d2b6b3
2725.23,1.0,0,1,2,4,7,0xb2d8eb8b
60001.27,2.0,24,3,3,2,8,0xb2d9484f
130351.58,2.0,0,3,3,4,10,0xb2d24614
10172.79,1.0,133,2,2,1,5,0xb2d6455a
850784.81,1.0,0,4,2,4,10,0xb2d60aebd
198.44,1.0,83,1,2,1,4,0xb2d9606b
462638.7,5.0,50,4,4,2,10,0x3b9af419
4389.85,1.0,0,2,2,4,8,0xb2d21918
22531.1,1.0,59,2,2,2,6,0xb2d100af
100809.46,2.0,19,3,3,2,8,0xb2d69c9e
24.77,1.0,92,1,2,1,4,0xb2d113e4
504172.35,3.0,18,4,4,2,10,0xb2d1ba55
16103.91,1.0,14,2,2,3,7,0xb2d4bb35
27094.28,1.0,0,2,2,4,8,0xb2d43a53
1714.31,1.0,22,1,2,2,5,0xb2d23cbd
130716.52,10.0,6,3,4,3,10,0xb2d5279e
60741.96,4.0,92,3,4,1,8,0xb2d5b5af
803402.39,5.0,3,4,4,4,12,0xb2d5f85e
3525.23,1.0,4,2,2,4,8,0xb2d5a5a1
2.34,1.0,1,1,2,4,7,0xb2d4c669
432615.11,6.0,86,4,4,1,9,0xb2d38ddc
1472.8,1.0,179,1,2,1,4,0xb2d3a92b
113845.74,2.0,92,3,3,1,7,0xb2d62f04
2407.95,1.0,15,1,2,3,6,0xb2d904bf
384050.79,2.0,75,4,3,1,8,0xb2d8dacb
150012.63,4.0,70,3,4,1,8,0xb2d06f35
925898.45,11.0,0,4,4,4,12,0x3b9ae50e
810041.32,3.0,69,4,4,1,9,0xb2d1c11b
425173.68,8.0,27,4,4,2,10,0xb2d52ff9d
102.07,1.0,7,1,2,3,6,0xb2d99bfc
3095.2,1.0,8,2,2,3,7,0xb2d6566d
1061654.39,8.0,16,4,4,2,10,0xb2d15983
7375.76,1.0,105,2,2,1,5,0xb2d340da
810125.66,3.0,1,4,4,4,12,0xb2d23ae4
90000.0,3.0,0,3,4,4,11,0xb2d36455
21085.56,1.0,6,2,2,3,7,0xb2d2fda4
8945.97,1.0,3,2,2,4,8,0xb2d2c7f7
40001.69,2.0,98,2,3,1,6,0xb2d6404d
185084.62,6.0,2,3,4,4,11,0xb2d2bc41
10994.87,1.0,6,2,2,3,7,0xb2d2bdca
3.04,1.0,18,1,2,2,5,0xb2d438dd
95099.81,2.0,144,3,3,1,7,0xb2d3ac72
773623.98,2.0,0,4,3,4,11,0xb2d56871
603000.0,10.0,0,4,4,4,12,0xb2d64bf9
6636.66,1.0,184,2,2,1,5,0xb2d62c45d
3326.91,1.0,5,2,2,3,7,0xb2d53591
400027.56,3.0,0,4,4,4,12,0xb2d5577f
1975.58,1.0,184,1,2,1,4,0xb2d26db1
21449.22,1.0,0,2,2,4,8,0xb2d482a3
2215049.59,9.0,4,4,4,4,12,0xb2d572b7
3450038.61,7.0,17,4,4,2,10,0xb2d15862
321.2,1.0,208,1,2,1,4,0xb2d107a5d
14008.51,1.0,20,2,2,2,6,0xb2d6ddde
244680.0,2.0,92,3,3,1,7,0xb2d37246
1666.02,1.0,92,1,2,1,4,0xb2d1cca2
72.18,1.0,2,1,2,4,7,0xb2d5319b
60027.48,3.0,0,3,4,4,11,0xb2d5fa90
227.56,4.0,9,1,4,3,8,0xb2d2482b
260897.4,3.0,4,3,4,4,11,0xb2d938ac
4780.73,1.0,14,2,2,3,7,0xb2d90a02
400007.21,4.0,53,4,4,2,10,0xb2d62a0d
1094.79,1.0,106,1,2,1,4,0xb2d41622
51948.9,2.0,12,2,3,3,8,0xb2d5ac20d
600000.0,4.0,0,4,4,4,12,0xb2d20c8f
0.0,1.0,92,1,2,1,4,0xb2d2f990
28.5,4.0,35,1,4,2,7,0xb2d69fea
277853.22,2.0,11,3,3,3,9,0xb2d3a635
286.93,1.0,1,1,2,4,7,0xb2d3a8a5
993000.0,2.0,9,4,3,3,10,0xb2d6c5be
816.94,1.0,9,1,2,3,6,0xb2d5cec2
2682.18,1.0,0,1,2,4,7,0xb2d95514
16941.46,1.0,43,2,2,2,6,0xb2d6dcc8
225003.43,1.0,0,3,2,4,9,0xb2d9f3a4
352.19,1.0,0,1,2,4,7,0xb2d2166d
798.66,1.0,10,1,2,3,6,0x3b9b3344
3.48,1.0,184,1,2,1,4,0xb2d39fe5
4.44,2.0,27,1,3,2,6,0xb2da0f2e
7365.87,1.0,38,2,2,2,6,0xb2d4a93f
427.56,1.0,2,1,2,4,7,0xb2d3b61d
1092776.07,4.0,1,4,4,4,12,0xb2d5ef88
100012.52,4.0,27,3,4,2,9,0xb2d440ff
3163.36,1.0,0,2,2,4,8,0xb2d18702
6502.07,1.0,155,2,2,1,5,0xb2d2dbf7
120002.53,2.0,199,3,3,1,7,0xb2d69803
10006.08,2.0,14,2,3,3,8,0xb2d6c99e
661.16,1.0,7,1,2,3,6,0xb2d7ee95d
57156.61,2.0,0,3,3,4,10,0xb2d5ba67
20819.6,1.0,21,2,2,2,6,0xb2d68eaf
38470.54,7.0,1,2,4,4,10,0x3b9b3dab
20675.49,1.0,31,2,2,2,6,0xb2d58c6c
1480.69,1.0,30,1,2,2,5,0xb2d14cba
140000.0,2.0,4,3,3,4,10,0xb2da58dd
2702.48,1.0,2,1,2,4,7,0xb2d30ae4
16044.63,1.0,92,2,2,1,5,0xb2d08eb9
37.31,4.0,6,1,4,3,8,0xb2d1cc56
47378.25,5.0,92,2,4,1,7,0xb2d086c8
5987.42,1.0,146,2,2,1,5,0xb2d4098a
8119.7,1.0,1,2,2,4,8,0xb2d15767
28642.62,1.0,110,2,2,1,5,0xb2d1a3d0
417092.91,2.0,83,4,3,1,8,0xb2d28798
10376.54,1.0,288,2,2,1,5,0xb2d0fa7a
201421.0,2.0,61,3,3,2,8,0xb2d8fc91d
1815.74,1.0,18,1,2,2,5,0xb2d19117
20000.63,2.0,77,2,3,1,6,0xb2d99029
39750.9,1.0,2,2,2,4,8,0xb2d39ede
550139.81,3.0,17,4,4,2,10,0xb2d5720a
300041.46,2.0,21,3,3,2,8,0xb2d62eddd
13199.16,2.0,35,2,3,2,7,0xb2d195db
37002.06,3.0,76,2,4,1,7,0xb2d959c9
0.0,1.0,19,1,2,2,5,0xb2d60a11
580007.26,3.0,11,4,4,3,11,0xb2d68a3d
4009617.39,10.0,9,4,4,3,11,0xb2d0da56
5176.95,1.0,0,2,2,4,8,0xb2d78bf7
10154.94,2.0,235,2,3,1,6,0xb2d6e8bd
8164.48,1.0,3,2,2,4,8,0xb2d3404d
100004.03,3.0,11,3,4,3,10,0xb2d557b9
251455.04,4.0,15,3,4,3,10,0xb2d7546b
2136.42,1.0,168,1,2,1,4,0xb2d25d5e
100035.74,3.0,154,3,4,1,8,0xb2d5baeb
700097.12,6.0,20,4,4,2,10,0xb2d974c0
387735.39,2.0,60,4,3,2,9,0xb2d9c378
1646.57,1.0,184,1,2,1,4,0x3b9b0f34
838213.05,8.0,5,4,4,3,11,0xb2d10d26
258668.41,10.0,0,3,4,4,11,0xb2d064d1
36423.11,2.0,7,2,3,3,8,0xb2d6abf6
1507078.08,8.0,9,4,4,3,11,0xb2d3c3f1
10500.0,1.0,3,2,2,4,8,0xb2da0785
281006.15,6.0,61,3,4,2,9,0xb2d6070a
20001.12,2.0,62,2,3,2,7,0xb2d781f9
75653.95,3.0,27,3,4,2,9,0xb2d39229
16000000.0,2.0,13,4,3,3,10,0xb2d86d9c
81902.58,2.0,7,3,3,3,9,0xb2d99909
9123.08,1.0,287,2,2,1,5,0xb2d46814
5139.8,1.0,8,2,2,3,7,0xb2d07ffa
163.0,1.0,70,1,2,1,4,0xb2d9285d
300093.98,2.0,21,3,3,2,8,0xb2d68e27d
50001.6,2.0,228,2,3,1,6,0xb2d637c4
981.18,1.0,16,1,2,2,5,0xb2d3ee9b
21411.41,1.0,0,2,2,4,8,0xb2d22741
1379001.0,7.0,3,4,4,4,12,0xb2d1c0c5
284978.96,4.0,168,3,4,1,8,0xb2d6544cd
0.93,1.0,184,1,2,1,4,0xb2d16e13
100005.58,3.0,168,3,4,1,8,0xb2d566a1
209043.06,3.0,60,3,4,2,9,0xb2d0650a
2838.78,1.0,92,1,2,1,4,0xb2d4f69fd
6481.2,1.0,11,2,2,3,7,0xb2d8e43f
70304.25,1.0,0,3,2,4,9,0xb2d5e7dd
57298.74,1.0,10,3,2,3,8,0xb2d28dfa
209353.79,3.0,1,3,4,4,11,0xb2d57fe0
127.39,4.0,6,1,4,3,8,0xb2d53190
26124.13,2.0,1,2,3,4,9,0xb2d9aaaf
150158.32,3.0,20,3,4,2,9,0xb2d777a0
202.98,1.0,20,1,2,2,5,0xb2d1a896
506882.79,5.0,87,4,4,1,9,0xb2d5b341
1026570.99,1.0,10,4,2,3,9,0xb2d932ae
723725.68,13.0,0,4,4,4,12,0xb2d08388d
10000.21,2.0,221,2,3,1,6,0xb2d6259b
20097.33,3.0,4,2,4,4,10,0xb2d59a82
20.43,1.0,10,1,2,3,6,0xb2d5d4b7
0.85,1.0,18,1,2,2,5,0xb2d5f086
1117.78,6.0,0,1,4,4,9,0xb2d0a4df
505339.52,3.0,172,4,4,1,9,0xb2d8d4bfd
10000.53,2.0,216,2,3,1,6,0xb2d64d11
150070.18,2.0,18,3,3,2,8,0xb2d0ecdc
380021.53,5.0,6,4,4,3,11,0xb2d24ca8
328545.07,1.0,19,4,2,2,8,0xb2d4b529d
0.88,1.0,3,1,2,4,7,0xb2d8c35f
109111.33,3.0,49,3,4,2,9,0xb2d67b3a
270164.71,4.0,6,3,4,3,10,0xb2d0b995
90002.85,2.0,95,3,3,1,7,0xb2d97240
550023.79,4.0,98,4,4,1,9,0xb2d1286f
104762.09,1.0,0,3,2,4,9,0xb2d6db88
9329.63,1.0,35,2,2,2,6,0xb2d2038dd
14605.32,1.0,35,2,2,2,6,0xb2d68c5f
903196.88,2.0,34,4,3,2,9,0xb2d9ffe0
92092.09,9.0,0,3,4,4,11,0x3b9af1bf
13818.02,2.0,10,2,3,3,8,0xb2d08d62
2301.3,1.0,15,1,2,3,6,0xb2d6a079
51966.25,2.0,200,2,3,1,6,0xb2d422a6
4347344.54,25.0,0,4,4,4,12,0x3b9b1801
10157.57,1.0,0,2,2,4,8,0xb2d68c75
553.22,1.0,3,1,2,4,7,0xb2d629bf
291062.59,4.0,20,3,4,2,9,0xb2d68a8b
1686.16,1.0,92,1,2,1,4,0xb2d11409
18554.34,1.0,74,2,2,1,5,0xb2d343bf
1000068.91,3.0,51,4,4,2,10,0xb2d243d3
20000.0,2.0,21,2,3,2,7,0xb2d9520e
367851.95,3.0,8,4,4,3,11,0xb2d3a932
369823.78,4.0,17,4,4,2,10,0xb2d40b11
0.74,1.0,0,1,2,4,7,0xb2d32827
3797.89,1.0,103,2,2,1,5,0xb2d573b1
98.91,1.0,15,1,2,3,6,0xb2d5387e
7907.5,1.0,8,2,2,3,7,0xb2d6185a
100005.33,2.0,26,3,3,2,8,0xb2d62ca6d
1118.42,2.0,92,1,3,1,5,0xb2d0af86
781000.34,8.0,0,4,4,4,12,0xb2d138e1
132220.72,5.0,13,3,4,3,10,0xb2d5eb40
2613.16,1.0,0,1,2,4,7,0xb2d1dac2
3652.9,1.0,1,2,2,4,8,0xb2d6e941
4301.62,1.0,0,2,2,4,8,0xb2d6b6bb
10064.26,1.0,16,2,2,2,6,0xb2d98ab3
2400.83,1.0,14,1,2,3,6,0xb2d8ca89
51691.15,1.0,184,2,2,1,5,0xb2d10563
606.58,1.0,4,1,2,4,7,0xb2d99182
317004.23,5.0,18,4,4,2,10,0xb2d80509
1913.54,1.0,184,1,2,1,4,0xb2d1b9d6
4260.53,4.0,184,2,4,1,7,0xb2d09721
598.92,1.0,26,1,2,2,5,0xb2d32cae
200711.55,2.0,33,3,3,2,8,0xb2d62ea8
380139.94,4.0,4,4,4,4,12,0xb2d2d5f2
6156.96,1.0,25,2,2,2,6,0xb2d1d454
53849.26,2.0,189,3,3,1,7,0xb2d3d9d5
4751166.3,3.0,4,4,4,4,12,0xb2d8f5b5d
593231.53,2.0,0,4,3,4,11,0xb2d1379d
819800.0,4.0,7,4,4,3,11,0xb2d1938e
303024.63,2.0,26,4,3,2,9,0xb2d1ba34
55.65,1.0,15,1,2,3,6,0xb2d69dcd
380000.0,2.0,5,4,3,3,10,0xb2d9737e
94253.51,2.0,6,3,3,3,9,0xb2d1f9bad
30000.0,2.0,3,2,3,4,9,0xb2d9732b
211023.79,3.0,2,3,4,4,11,0xb2d245a0
41095.17,3.0,114,2,4,1,7,0xb2d21bc4d
400055.65,2.0,102,4,3,1,8,0xb2d4c1be
4704.01,1.0,15,2,2,3,7,0xb2d8cd7bd
40.62,1.0,4,1,2,4,7,0xb2d18c6a
322000.0,2.0,3,4,3,4,11,0xb2d9b61d
17.34,3.0,28,1,4,2,7,0xb2d0ef7e
1705.48,1.0,29,1,2,2,5,0xb2d5cb2d
83471.77,1.0,0,3,2,4,9,0xb2d8e816
102602.23,2.0,153,3,3,1,7,0xb2d22987
4839.65,1.0,7,2,2,3,7,0xb2d6b4b3
717654.91,8.0,20,4,4,2,10,0xb2d17f6fd
41731.51,2.0,7,2,3,3,8,0xb2d24ba8
0.75,1.0,0,1,2,4,7,0xb2d0f2c5
5015.58,1.0,5,2,2,3,7,0xb2d9c2b5
490.68,1.0,8,1,2,3,6,0xb2d8c792
1185.7,1.0,92,1,2,1,4,0xb2d2d620
13536.77,1.0,0,2,2,4,8,0xb2d65088d
51102.92,2.0,18,2,3,2,7,0xb2d49b6f
247887.03,4.0,15,3,4,3,10,0xb2d60190
492076.83,3.0,32,4,4,2,10,0xb2d5b844
200267.59,2.0,143,3,3,1,7,0x3b9b49e2
88.64,1.0,8,1,2,3,6,0xb2d970d4
712765.43,2.0,12,4,3,3,10,0xb2d14714d
55001.21,3.0,74,3,4,1,8,0xb2d59705
60052.15,2.0,2,3,3,4,10,0xb2d3c426
200000.0,2.0,5,3,3,3,9,0xb2d87de2
200148.39,5.0,0,3,4,4,11,0xb2d097fb
18.01,1.0,30,1,2,2,5,0xb2d6299b
1048.54,1.0,34,1,2,2,5,0xb2d3ef85
337121.67,6.0,0,4,4,4,12,0xb2d28970
1.79,1.0,51,1,2,2,5,0xb2d33f9b
785015.46,9.0,13,4,4,3,11,0xb2d6f2b5
1313410.32,6.0,27,4,4,2,10,0xb2d40432
211117.12,2.0,272,3,3,1,7,0xb2d17c3a
23000.24,2.0,74,2,3,1,6,0xb2d9a04f
16.45,1.0,0,1,2,4,7,0xb2d29d79
0.28,1.0,20,1,2,2,5,0xb2d60bbc
332678.01,2.0,50,4,3,2,9,0xb2d290bf
60.38,1.0,15,1,2,3,6,0xb2d49678
267055.45,5.0,0,3,4,4,11,0xb2d6174f
407470.3,3.0,16,4,4,2,10,0xb2d65e27
401420.86,2.0,42,4,3,2,9,0xb2d9e9ce
145375.83,1.0,92,3,2,1,6,0xb2d42d31
228269.05,5.0,38,3,4,2,9,0xb2d5fc34
26491.54,1.0,184,2,2,1,5,0xb2d215ee
5508.01,1.0,0,2,2,4,8,0xb2d8c692
54605.73,1.0,7,3,2,3,8,0xb2d8d251
54.67,1.0,58,1,2,2,5,0xb2d97ed2
26633.7,1.0,3,2,2,4,8,0xb2d4f9a3
70098.22,4.0,4,3,4,4,11,0xb2d6211b
257.98,1.0,88,1,2,1,4,0xb2d102a7
1525.93,1.0,7,1,2,3,6,0xb2d913b7
1335.25,1.0,0,1,2,4,7,0xb2d61e39
8287.74,1.0,18,2,2,2,6,0xb2d94e3d
102670.5,3.0,94,3,4,1,8,0xb2d5bf70
683799.72,4.0,7,4,4,3,11,0xb2d31110
301079.15,2.0,31,4,3,2,9,0xb2d8f105
2967.29,1.0,184,2,2,1,5,0xb2d30ea9
2335047.44,10.0,0,4,4,4,12,0xb2d3b4fb
431593.15,2.0,28,4,3,2,9,0xb2d71820
94704.22,3.0,0,3,4,4,11,0xb2d6d143
50002.11,2.0,20,2,3,2,7,0xb2d94d52
73364.96,3.0,19,3,4,2,9,0xb2d312d4
580008.2,10.0,4,4,4,4,12,0xb2d4743fd
835.71,1.0,0,1,2,4,7,0xb2d98a3f
683000.83,13.0,4,4,4,4,12,0xb2d23eb7
12000.38,2.0,60,2,3,2,7,0xb2d9b97d
7091.58,1.0,92,2,2,1,5,0xb2d31e4a
13036.31,1.0,25,2,2,2,6,0xb2d6c6b3
1974.32,1.0,0,1,2,4,7,0xb2d8ea5dd
20091.85,1.0,11,2,2,3,7,0xb2d562db
191218.46,7.0,5,3,4,3,10,0x3b9b2f07
101486.88,2.0,62,3,3,2,8,0xb2d690d3
1006.59,1.0,184,1,2,1,4,0xb2d31119
395815.23,10.0,2,4,4,4,12,0xb2d2134bd
260042.43,3.0,228,3,4,1,8,0xb2d5f23bd
911042.44,7.0,4,4,4,4,12,0xb2d12034
30000.32,2.0,188,2,3,1,6,0xb2d6a932
2280057.07,3.0,10,4,4,3,11,0xb2d61b51
13.02,1.0,66,1,2,2,5,0xb2d5b6eb
36281.5,1.0,92,2,2,1,5,0xb2d61b54
3623668.34,4.0,92,4,4,1,9,0xb2d7014b
79446.73,1.0,184,3,2,1,6,0xb2d361f4
130005.13,3.0,27,3,4,2,9,0xb2d654ee
1101.49,1.0,9,1,2,3,6,0xb2d2db5c
370006.03,29.0,22,4,4,2,10,0xb2d226d9
50170.97,2.0,99,2,3,1,6,0xb2d6d7a8
90053.41,5.0,16,3,4,2,9,0xb2d2bcb5
10807.24,1.0,42,2,2,2,6,0xb2d93428
6030138.79,6.0,19,4,4,2,10,0xb2d15c67
2544000.0,13.0,2,4,4,4,12,0xb2d24de8
674801.41,3.0,4,4,4,4,12,0xb2d0e9ff
8731.33,1.0,43,2,2,2,6,0xb2d271d9
231412.86,4.0,1,3,4,4,11,0xb2d6375b
200000.0,1.0,4,3,2,4,9,0xb2d94e50
630064.45,8.0,11,4,4,3,11,0xb2d20647d
0.57,1.0,5,1,2,3,6,0xb2d931dc
210036.7,2.0,8,3,3,3,9,0xb2d5c0bb
197265.79,1.0,0,3,2,4,9,0xb2d912e1
229604.46,3.0,15,3,4,3,10,0xb2d128c6d
2700103.34,9.0,11,4,4,3,11,0xb2d32408
620533.43,2.0,90,4,3,1,8,0xb2d1d987d
0.0,12.0,1,1,4,4,9,0xb2d0a5c4
6437.59,1.0,7,2,2,3,7,0xb2d8e210
20227.53,1.0,153,2,2,1,5,0xb2d110d0
4216.05,2.0,0,2,3,4,9,0x3b9b3d94
120015.02,2.0,73,3,3,1,7,0xb2d065c8d
50158.74,1.0,0,2,2,4,8,0xb2d24b84
30008.07,2.0,83,2,3,1,6,0xb2d5eb33
205114.52,2.0,79,3,3,1,7,0xb2d18b3f
125492.94,2.0,81,3,3,1,7,0xb2d47679
200053.27,2.0,185,3,3,1,7,0xb2d3a8bb
54203.14,3.0,231,3,4,1,8,0xb2d1b2a4
148916.81,2.0,0,3,3,4,10,0xb2d40b22
146745.56,2.0,116,3,3,1,7,0xb2d13bc2
5242.94,1.0,4,2,2,4,8,0xb2d85d86
200000.0,2.0,3,3,3,4,10,0xb2d97eb4
1777.77,1.0,12,1,2,3,6,0xb2d61a64
0.0,1.0,184,1,2,1,4,0xb2d2844e
8875.14,1.0,13,2,2,3,7,0xb2d2c17d
500010.56,2.0,21,4,3,2,9,0xb2d9f702
430592.71,6.0,13,4,4,3,11,0xb2d24449
1514127.0,8.0,4,4,4,4,12,0xb2d17a03
114.39,1.0,21,1,2,2,5,0xb2d1f745
3028.26,1.0,2,2,2,4,8,0xb2d69f4b
263.43,1.0,28,1,2,2,5,0xb2d6557c
133159.67,4.0,6,3,4,3,10,0xb2d60f1f
282576.5,6.0,11,3,4,3,10,0xb2d273f0
1139006.47,18.0,3,4,4,4,12,0xb2d6277a
558.8,1.0,10,1,2,3,6,0xb2d438eb
1040227.7,4.0,92,4,4,1,9,0xb2d0f877
2789.71,1.0,0,1,2,4,7,0xb2d58ce3
1513.52,1.0,16,1,2,2,5,0xb2d26b7fd
20078.59,3.0,0,2,4,4,10,0xb2d6ee98
930845.19,6.0,19,4,4,2,10,0xb2d5d3c3
1.79,1.0,47,1,2,2,5,0xb2d9984e
23.91,1.0,47,1,2,2,5,0xb2d37c6f
1215086.38,5.0,14,4,4,3,11,0xb2d1cf2e
1.58,1.0,6,1,2,3,6,0xb2d8dc35
228170.45,1.0,45,3,2,2,7,0xb2d10145
379038.95,2.0,84,4,3,1,8,0xb2d8d2ae
353731.57,2.0,95,4,3,1,8,0xb2d96a9bd
489513.33,1.0,13,4,2,3,9,0xb2d27005
10000.82,2.0,11,2,3,3,8,0xb2d07e80
710000.72,4.0,0,4,4,4,12,0xb2d33139
504.34,1.0,11,1,2,3,6,0xb2d92f32
120657.64,3.0,0,3,4,4,11,0xb2d645de
270000.0,2.0,4,3,3,4,10,0xb2d237bb
7095.18,1.0,8,2,2,3,7,0xb2d40728d
22998.75,1.0,6,2,2,3,7,0xb2d7ed7d
42.96,1.0,44,1,2,2,5,0xb2d301f5
217921.13,2.0,77,3,3,1,7,0xb2d3ae97
505030.19,3.0,188,4,4,1,9,0xb2d62691
1029.98,1.0,144,1,2,1,4,0xb2d22327
50144.82,2.0,34,2,3,2,7,0xb2d17a0d
3910.21,1.0,12,2,2,3,7,0xb2d36a17
2892.96,1.0,0,2,2,4,8,0xb2d4ce13
185.29,1.0,1,1,2,4,7,0xb2d2074c
3445.78,1.0,10,2,2,3,7,0xb2d37180
404388.41,4.0,74,4,4,1,9,0xb2d5615a
30000.74,3.0,90,2,4,1,7,0xb2d78dc6
12971.67,1.0,1,2,2,4,8,0xb2d6de86
163673.0,2.0,98,3,3,1,7,0xb2d3ac5a
375412.37,1.0,1,4,2,4,10,0x3b9b3058
500193.42,2.0,154,4,3,1,8,0xb2d176f9d
45553.09,1.0,2,2,2,4,8,0xb2d6c256
80047.92,3.0,186,3,4,1,8,0xb2d50f51
39.66,1.0,2,1,2,4,7,0xb2d54b5f
2581.62,1.0,12,1,2,3,6,0xb2d1df93
2803.08,1.0,184,1,2,1,4,0xb2d1e288
11.81,1.0,0,1,2,4,7,0xb2d62d8e
268535.17,1.0,3,3,2,4,9,0xb2da41d0
500004.16,2.0,29,4,3,2,9,0xb2d9017e
500528.99,3.0,19,4,4,2,10,0xb2d27211
20031.71,2.0,0,2,3,4,9,0xb2d91237
3.17,1.0,167,1,2,1,4,0xb2d8d7b2
30005.21,2.0,104,2,3,1,6,0xb2d7b018
0.01,1.0,184,1,2,1,4,0xb2d2ad19
533.93,1.0,45,1,2,2,5,0xb2d8efd8
602223.68,3.0,210,4,4,1,9,0xb2d555a9
6.92,1.0,73,1,2,1,4,0xb2d1b037
409.33,1.0,6,1,2,3,6,0xb2d260f6
20027.3,2.0,32,2,3,2,7,0xb2d6a4bb
3863.05,1.0,280,2,2,1,5,0xb2d2f67b
11.62,1.0,5,1,2,3,6,0xb2d792d1
99.97,1.0,23,1,2,2,5,0xb2d2ee59
210431.83,3.0,92,3,4,1,8,0xb2d69b52
303281.43,8.0,0,4,4,4,12,0x3b9af167
505041.72,5.0,8,4,4,3,11,0xb2d28923d
67117.35,2.0,11,3,3,3,9,0xb2d69db1
453609.33,2.0,129,4,3,1,8,0xb2d69018
600778.09,7.0,26,4,4,2,10,0xb2d0c0bc
1184.57,1.0,92,1,2,1,4,0xb2d3f4ef
3887.61,1.0,2,2,2,4,8,0xb2d2f713
8668.9,1.0,5,2,2,3,7,0xb2d39205
106783.71,2.0,0,3,3,4,10,0xb2d12bd8
3521.49,1.0,3,2,2,4,8,0xb2d41d27
50001.06,2.0,92,2,3,1,6,0xb2d6574b
15551.94,2.0,130,2,3,1,6,0xb2d5d5bf
100492.4,2.0,92,3,3,1,7,0xb2d0bc3a
100001.06,2.0,32,3,3,2,8,0xb2da04af
210392.05,4.0,31,3,4,2,9,0xb2d3c58b
23.55,1.0,26,1,2,2,5,0xb2d98e49
11694.57,1.0,7,2,2,3,7,0xb2d2e1ed
552001.38,3.0,19,4,4,2,10,0xb2d98ea3
8840.46,1.0,1,2,2,4,8,0xb2d2edef
6884.57,1.0,4,2,2,4,8,0xb2d961d7
1.35,1.0,18,1,2,2,5,0xb2d3ed2ad
2425.29,1.0,10,1,2,3,6,0xb2d69e6d
700.0,1.0,1,1,2,4,7,0xb2d68fa3
1121000.46,5.0,4,4,4,4,12,0xb2d17882
1600103.61,2.0,216,4,3,1,8,0xb2d1ae98
366870.22,2.0,10,4,3,3,10,0xb2d11325
270091.93,5.0,3,3,4,4,11,0xb2d5d9b4
60603.97,1.0,12,3,2,3,8,0xb2d27932
12102.45,1.0,92,2,2,1,5,0xb2d238f9
0.3,22.0,3,1,4,4,9,0xb2d90383
2531.87,8.0,92,1,4,1,6,0xb2d22b9d
37107.79,1.0,0,2,2,4,8,0xb2d224d4
51651.62,2.0,192,2,3,1,6,0xb2d08cddd
300000.47,3.0,8,3,4,3,10,0xb2d7002e
1352780.28,1.0,184,4,2,1,7,0xb2d12a24
868.22,7.0,13,1,4,3,8,0xb2d318d9
1069.21,1.0,52,1,2,2,5,0xb2d595a3
1004593.32,3.0,0,4,4,4,12,0xb2d4ad08
5.1,1.0,19,1,2,2,5,0xb2d5bb05
31293.09,2.0,123,2,3,1,6,0xb2d113c7
6541810.21,3.0,60,4,4,2,10,0xb2d3b8c1d
50001.06,2.0,45,2,3,2,7,0xb2d918a0
20927.66,1.0,6,2,2,3,7,0xb2d91745
320000.63,3.0,8,4,4,3,11,0xb2d9de3f
466605.1,7.0,0,4,4,4,12,0xb2d3ce60
50272.57,2.0,13,2,3,3,8,0xb2d35a28
500000.0,3.0,13,4,4,3,11,0xb2d14983
0.0,2.0,6,1,3,3,7,0xb2d0b1cc
18462.18,1.0,18,2,2,2,6,0xb2d15394
200020.88,2.0,20,3,3,2,8,0xb2d8d4b9
2064.29,1.0,91,1,2,1,4,0xb2d8253c
50003.19,2.0,57,2,3,2,7,0xb2d9ace8
2871.24,1.0,14,1,2,3,6,0xb2d6edd8
978911.48,12.0,16,4,4,2,10,0xb2d06e48
100030.53,3.0,14,3,4,3,10,0x3b9b3500
230022.08,2.0,39,3,3,2,8,0xb2d41251
500002.96,3.0,10,4,4,3,11,0xb2d3630b
2231.42,1.0,32,1,2,2,5,0xb2d17eb6
151206.42,4.0,87,3,4,1,8,0xb2d5af19
4046.9,1.0,1,2,2,4,8,0xb2d31de1
4424.29,1.0,0,2,2,4,8,0xb2d8c36a
1015292.88,3.0,1,4,4,4,12,0xb2d68301
4184.61,1.0,0,2,2,4,8,0xb2d9090fd
230760.03,3.0,27,3,4,2,9,0xb2d09a84
21035.03,1.0,21,2,2,2,6,0xb2da0789
202889.93,2.0,33,3,3,2,8,0xb2d2e14f
600058.91,5.0,49,4,4,2,10,0xb2d4f6eb
75008.55,3.0,55,3,4,2,9,0xb2d63ead
196198.23,4.0,4,3,4,4,11,0xb2d16082
592988.92,9.0,31,4,4,2,10,0xb2d1a664
190.97,1.0,90,1,2,1,4,0xb2d3260a
496067.47,23.0,14,4,4,3,11,0xb2d0d43d
115.25,1.0,0,1,2,4,7,0xb2d21335
1100000.0,1.0,0,4,2,4,10,0xb2d98403d
100262.6,2.0,83,3,3,1,7,0xb2d2158a
276997.25,3.0,0,3,4,4,11,0xb2d2127e
383049.33,3.0,14,4,4,3,11,0xb2d47e12
15307.02,1.0,7,2,2,3,7,0xb2d867af
842690.57,1.0,1,4,2,4,10,0xb2d34a2e
110014.48,23.0,1,3,4,4,11,0xb2d139ee
948812.67,14.0,21,4,4,2,10,0xb2d23a8f
2214.04,1.0,184,1,2,1,4,0xb2d0c796
1065.99,1.0,263,1,2,1,4,0xb2d58116
537.87,1.0,0,1,2,4,7,0xb2d2d3c3
10331.24,1.0,92,2,2,1,5,0x3b9b2e42
30328.78,1.0,4,2,2,4,8,0xb2d2ac12
2103043.31,4.0,29,4,4,2,10,0xb2d335e1d
12154.59,2.0,4,2,3,4,9,0xb2d59ef2
60190.85,3.0,52,3,4,2,9,0xb2d5345d
10076.09,1.0,36,2,2,2,6,0xb2d17f1b
100484.58,2.0,39,3,3,2,8,0xb2d138f7
16.76,1.0,5,1,2,3,6,0xb2d6093f
150595.44,2.0,0,3,3,4,10,0xb2d2fb89
50141.26,2.0,125,2,3,1,6,0xb2d1baa9
4087.43,2.0,0,2,3,4,9,0xb2d11ae3
100001.59,6.0,0,3,4,4,11,0xb2d8d286
36.1,1.0,59,1,2,2,5,0xb2d16d7a
4441.15,1.0,20,2,2,2,6,0xb2d3109b
10034.89,1.0,92,2,2,1,5,0xb2d4937b
18.02,1.0,11,1,2,3,6,0xb2d6e3b0
49.3,1.0,28,1,2,2,5,0xb2d9f3d3
122124.25,4.0,102,3,4,1,8,0xb2d6b047
320013.21,3.0,11,4,4,3,11,0xb2d3f0fb
190338.95,2.0,114,3,3,1,7,0xb2d285c3
52702.64,2.0,8,3,3,3,9,0xb2d6599ad
1433.84,1.0,11,1,2,3,6,0xb2d30f08
2183.21,1.0,288,1,2,1,4,0xb2d40c70d
202843.39,2.0,143,3,3,1,7,0xb2d6ed9c
438005.56,4.0,1,4,4,4,12,0xb2d4390f
140636.59,7.0,0,3,4,4,11,0xb2d1642a
108.47,1.0,38,1,2,2,5,0xb2d16a50
357.62,1.0,61,1,2,2,5,0xb2d2be9c
90731.48,2.0,1,3,3,4,10,0xb2d4a3d1
246.08,1.0,3,1,2,4,7,0xb2d59faa
147614.21,2.0,24,3,3,2,8,0xb2d5cea2
655983.52,6.0,0,4,4,4,12,0xb2d839b5
257112.75,2.0,110,3,3,1,7,0xb2d6c450
340.08,1.0,15,1,2,3,6,0xb2d282b6d
60069.17,2.0,129,3,3,1,7,0xb2d116db
30000.95,2.0,87,2,3,1,6,0xb2d59705d
30000.32,4.0,7,2,4,3,9,0xb2da2d79
2298.48,1.0,5,1,2,3,6,0xb2d2b5d7
392005.56,3.0,56,4,4,2,10,0xb2d4e709
867000.99,4.0,6,4,4,3,11,0xb2d57e96
12810.74,1.0,0,2,2,4,8,0xb2d36c36
137704.83,1.0,0,3,2,4,9,0xb2d22bc1
112207.19,4.0,10,3,4,3,10,0xb2d4dbed
700000.0,9.0,2,4,4,4,12,0xb2d5d442d
39561.26,1.0,15,2,2,3,7,0xb2d91436
250031.69,2.0,14,3,3,3,9,0xb2d0f710
200228.99,3.0,0,3,4,4,11,0xb2d5ff0f
8744.96,1.0,15,2,2,3,7,0xb2d9e80e
107785.33,2.0,0,3,3,4,10,0xb2d0cd26
220000.6,5.0,0,3,4,4,11,0xb2d1542b
8727.98,1.0,9,2,2,3,7,0xb2d3f5c5
4328883.48,9.0,27,4,4,2,10,0xb2d50d2a
43392.17,4.0,18,2,4,2,8,0xb2d07f79
480019.85,2.0,15,4,3,3,10,0xb2d9f433
92.0,1.0,10,1,2,3,6,0xb2d31046
171.98,1.0,0,1,2,4,7,0xb2d8f337
200022.74,2.0,41,3,3,2,8,0xb2d30bbd
50003.47,2.0,189,2,3,1,6,0xb2d3ed9c
300353.49,2.0,63,4,3,2,9,0xb2d15d82
706399.47,5.0,98,4,4,1,9,0xb2d64c0d
64.78,1.0,10,1,2,3,6,0xb2d60b87
0.22,1.0,22,1,2,2,5,0xb2da00ea
6793.34,1.0,9,2,2,3,7,0xb2d904f6
200002.32,3.0,11,3,4,3,10,0xb2d965c2d
1559.02,1.0,6,1,2,3,6,0xb2d21733
431101.87,3.0,69,4,4,1,9,0xb2d279d4
1895.24,1.0,10,1,2,3,6,0xb2d602e5
2869.42,1.0,10,1,2,3,6,0xb2d516da
175191.22,3.0,80,3,4,1,8,0xb2d1c998d
318014.91,2.0,7,4,3,3,10,0xb2d8e033d
1813.44,1.0,4,1,2,4,7,0xb2d1d506
71000.0,6.0,5,3,4,3,10,0xb2d633d2
483552.63,2.0,73,4,3,1,8,0xb2d15a7a
5087.48,1.0,38,2,2,2,6,0xb2d49e55
2948.36,1.0,0,2,2,4,8,0xb2d620c8
500021.11,2.0,34,4,3,2,9,0xb2d92ebd
34078.28,1.0,9,2,2,3,7,0xb2d9867f
400004.22,2.0,80,4,3,1,8,0xb2d99183
1139443.6,12.0,0,4,4,4,12,0x3b9af245
136409.14,6.0,1,3,4,4,11,0xb2d3cf4e
1589.07,1.0,119,1,2,1,4,0xb2d42ba4
302220.24,2.0,64,4,3,2,9,0xb2d4d9cb
4696.59,1.0,5,2,2,3,7,0xb2d5db23d
5017.49,1.0,92,2,2,1,5,0xb2d5c1d6
1.76,1.0,0,1,2,4,7,0xb2d5bcca
65022.43,4.0,70,3,4,1,8,0x3b9b292cd
6358.07,1.0,184,2,2,1,5,0xb2d1a373
532013.09,12.0,11,4,4,3,11,0xb2d3a384d
73086.81,1.0,0,3,2,4,9,0xb2d25fb7
1567134.91,4.0,58,4,4,2,10,0xb2d598ce
200000.0,2.0,1,3,3,4,10,0xb2da67eb
34034.75,4.0,0,2,4,4,10,0xb2d0bf4a
203.61,1.0,0,1,2,4,7,0xb2d2aeac
1054842.55,4.0,5,4,4,3,11,0xb2d7901e
3960.62,1.0,7,2,2,3,7,0xb2d94e63
1200.33,1.0,11,1,2,3,6,0xb2d5cc14
50001.58,2.0,42,2,3,2,7,0xb2d5f04a
470016.24,3.0,0,4,4,4,12,0xb2d14a00
20101.56,2.0,104,2,3,1,6,0xb2d64e29
3075.11,3.0,4,2,4,4,10,0xb2d0685f
33028.27,2.0,208,2,3,1,6,0xb2d55634
50031.67,3.0,55,2,4,2,8,0xb2d5d6ab
320060.12,3.0,5,4,4,3,11,0xb2d64ef0
20000.42,2.0,67,2,3,1,6,0xb2d9ada5
8015.88,1.0,0,2,2,4,8,0xb2d906c3d
389806.5,5.0,0,4,4,4,12,0xb2d32544d
2006.38,2.0,10,1,3,3,7,0xb2d70811
220710.94,3.0,45,3,4,2,9,0xb2d908f6
10004.47,2.0,35,2,3,2,7,0xb2d65950
80003.45,2.0,67,3,3,1,7,0xb2d4f5ebd
600520.18,2.0,200,4,3,1,8,0xb2d68885
157.88,2.0,10,1,3,3,7,0xb2d9a93c
40005.1,3.0,53,2,4,2,8,0xb2d57e71
1902.49,1.0,0,1,2,4,7,0xb2d68739
4084.93,1.0,9,2,2,3,7,0xb2d6dd95
9.69,1.0,7,1,2,3,6,0xb2d8f926
4001.69,1.0,0,2,2,4,8,0xb2d70445
61503.55,1.0,2,3,2,4,9,0xb2d2c5d6
42.43,1.0,0,1,2,4,7,0xb2d5e0fe
255637.44,5.0,17,3,4,2,9,0xb2d0d0fe
192008.95,5.0,24,3,4,2,9,0xb2d3ee74
1428.41,1.0,9,1,2,3,6,0xb2d58c28
987.92,1.0,0,1,2,4,7,0xb2d1e955
213113.47,5.0,0,3,4,4,11,0xb2d0b91d
54005.22,2.0,165,3,3,1,7,0xb2d45c77
151006.34,3.0,39,3,4,2,9,0xb2d0dbc8d
18376.0,1.0,67,2,2,1,5,0xb2d1f376
64294.62,2.0,136,3,3,1,7,0xb2d3d20a
24509.85,1.0,10,2,2,3,7,0xb2d5d75b
10610.63,1.0,210,2,2,1,5,0xb2d12528d
58.33,2.0,74,1,3,1,5,0xb2d825cd
26658.3,1.0,10,2,2,3,7,0xb2d9350d
576551.36,2.0,47,4,3,2,9,0xb2d51dd8
594013.25,7.0,3,4,4,4,12,0xb2d1d2a8
238482.5,1.0,9,3,2,3,8,0xb2d32b79
25074.26,1.0,3,2,2,4,8,0xb2d963c9
7673.34,1.0,0,2,2,4,8,0xb2d599c6d
582716.25,5.0,2,4,4,4,12,0x3b9b311bd
1501.24,2.0,87,1,3,1,5,0xb2d5be9c
9.59,1.0,46,1,2,2,5,0xb2d68af9
101.85,1.0,1,1,2,4,7,0xb2d6c4cd
104050.94,3.0,49,3,4,2,9,0xb2d606bf
50063.69,2.0,111,2,3,1,6,0xb2d24a30
1261.51,1.0,15,1,2,3,6,0xb2d6b37a
1097.44,1.0,92,1,2,1,4,0xb2d1fd2a
3013.62,1.0,184,2,2,1,5,0xb2d27c5e
675290.6,6.0,1,4,4,4,12,0xb2d082d3d
30000.32,2.0,21,2,3,2,7,0xb2da2029
501257.61,6.0,0,4,4,4,12,0xb2d06793
880033.03,7.0,0,4,4,4,12,0xb2d4aa57
1052866.66,7.0,0,4,4,4,12,0xb2d2381a
1015.01,1.0,184,1,2,1,4,0xb2d35b71
122804.03,8.0,0,3,4,4,11,0xb2d0b4b2
15223.24,1.0,1,2,2,4,8,0xb2d59067
101001.07,2.0,66,3,3,2,8,0xb2d8eead
810513.72,5.0,50,4,4,2,10,0xb2d43579
106022.69,2.0,7,3,3,3,9,0xb2d92b8ed
221205.6,5.0,26,3,4,2,9,0xb2d5a9f5
1120160.55,2.0,18,4,3,2,9,0xb2d9a00f
232265.61,1.0,9,3,2,3,8,0xb2d8d1c2
157513.42,1.0,184,3,2,1,6,0x3b9b25b0
93652.27,3.0,45,3,4,2,9,0xb2d24ace
551045.41,5.0,18,4,4,2,10,0xb2d55a37
3597000.1,24.0,0,4,4,4,12,0xb2d64317
80576.64,2.0,66,3,3,2,8,0xb2d6c7c9
2.37,1.0,55,1,2,2,5,0xb2d48270
317747.95,5.0,6,4,4,3,11,0xb2d2288d
10157.48,2.0,6,2,3,3,8,0xb2d43371
2399.45,1.0,6,1,2,3,6,0xb2d2bf7d
357.2,2.0,98,1,3,1,5,0x3b9b3100
339080.19,2.0,21,4,3,2,9,0xb2d323e8
1519.24,1.0,184,1,2,1,4,0xb2d15ac7
20000.22,2.0,170,2,3,1,6,0xb2d6ab09
0.85,1.0,4,1,2,4,7,0xb2d5a784
430898.04,3.0,22,4,4,2,10,0xb2d90cb4
3.63,2.0,59,1,3,2,6,0xb2d0f6dc
150004.32,4.0,18,3,4,2,9,0xb2d65442
188.5,1.0,2,1,2,4,7,0xb2d64b71
31216.28,1.0,9,2,2,3,7,0xb2d46f15
2769.07,1.0,0,1,2,4,7,0xb2d5c98e
100001.06,3.0,6,3,4,3,10,0xb2da4a61
1564.61,1.0,9,1,2,3,6,0xb2d3110f
294.96,1.0,15,1,2,3,6,0xb2d0b450
200710.46,2.0,15,3,3,3,9,0xb2d91e8c
1827.78,1.0,8,1,2,3,6,0xb2d4ba5e
102.14,1.0,184,1,2,1,4,0xb2d0fec9
20379.96,2.0,119,2,3,1,6,0xb2d62521
500028.2,2.0,11,4,3,3,10,0xb2d9691d
51025.64,2.0,22,2,3,2,7,0xb2d1e12c
1211.27,1.0,48,1,2,2,5,0xb2d6db1a
4655.73,1.0,1,2,2,4,8,0xb2d3cd47
2604175.26,3.0,47,4,4,2,10,0xb2d48dc3
422007.63,4.0,24,4,4,2,10,0xb2d6fd19
58.53,1.0,0,1,2,4,7,0xb2d906c9
102882.94,2.0,118,3,3,1,7,0xb2d400c0
206.97,1.0,5,1,2,3,6,0x3b9af4b7
51013.35,2.0,3,2,3,4,9,0xb2d601df
528784.96,1.0,0,4,2,4,10,0xb2d36fed
8027.27,1.0,213,2,2,1,5,0xb2d2dfad
23632.83,2.0,143,2,3,1,6,0xb2d6b055
610000.11,4.0,20,4,4,2,10,0xb2d95252
469019.95,3.0,0,4,4,4,12,0xb2d28155
326.26,1.0,46,1,2,2,5,0xb2d3ea3c
273.12,1.0,10,1,2,3,6,0xb2d23a4f
5.12,1.0,60,1,2,2,5,0xb2d5374d
200027.6,2.0,80,3,3,1,7,0xb2d699c6
51476.69,9.0,2,2,4,4,10,0xb2d14c8a
384342.14,4.0,5,4,4,3,11,0xb2d12c3d
361625.54,3.0,42,4,4,2,10,0xb2d2ced9
269.24,1.0,0,1,2,4,7,0xb2d6a4cd
221011.82,5.0,1,3,4,4,11,0xb2d6d59b
30.64,1.0,5,1,2,3,6,0xb2d253c9
500088.05,3.0,0,4,4,4,12,0xb2d90ea9
200773.39,5.0,66,3,4,2,9,0xb2d64191
1798.45,2.0,2,1,3,4,8,0xb2d1dbc6
2987.45,1.0,14,2,2,3,7,0xb2d38bf7
420732.46,3.0,27,4,4,2,10,0xb2d1b2f4
1000053.81,3.0,6,4,4,3,11,0xb2d9f205
450005.15,3.0,11,4,4,3,11,0xb2d78c67d
850041.5,6.0,56,4,4,2,10,0xb2d55a36
8759.35,1.0,184,2,2,1,5,0xb2d215aa
136.34,1.0,25,1,2,2,5,0xb2d26a05
9771.5,1.0,92,2,2,1,5,0xb2d11ddc
1156.24,1.0,0,1,2,4,7,0xb2d6b0d0
161.56,3.0,0,1,4,4,9,0xb2d11fbd
30019.54,2.0,11,2,3,3,8,0xb2d55ead
594.48,1.0,10,1,2,3,6,0xb2d5708b
40461.22,2.0,4,2,3,4,9,0xb2d6276ed
29555.91,1.0,0,2,2,4,8,0xb2d31558
5888.2,1.0,10,2,2,3,7,0xb2d836b3
373.1,1.0,9,1,2,3,6,0xb2d36c5a
820118.09,3.0,11,4,4,3,11,0xb2d22232
26408.54,2.0,10,2,3,3,8,0xb2d585a9
130000.6,3.0,18,3,4,2,9,0xb2d25e75
230091.73,5.0,42,3,4,2,9,0xb2d07e67
1972795.86,6.0,23,4,4,2,10,0xb2d2d466
250020.59,3.0,68,3,4,1,8,0xb2d4e870
5100.59,1.0,92,2,2,1,5,0xb2d13ab6
300003.09,2.0,10,3,3,3,9,0xb2da29d0
42.11,1.0,0,1,2,4,7,0xb2d5512c
1587.74,1.0,54,1,2,2,5,0xb2d1630f
40027.63,3.0,4,2,4,4,10,0xb2d5e08e
504.88,1.0,0,1,2,4,7,0xb2d1778e
100002.11,2.0,92,3,3,1,7,0xb2d64522
10.18,1.0,26,1,2,2,5,0xb2d58468
120041.68,2.0,129,3,3,1,7,0xb2d63fc5d
400000.0,3.0,10,4,4,3,11,0xb2d965ff
6139.41,1.0,92,2,2,1,5,0xb2d0ce83
844.85,1.0,0,1,2,4,7,0xb2d6b3f3
462559.05,8.0,0,4,4,4,12,0xb2d3bd78
526.57,1.0,4,1,2,4,7,0xb2d2f72e
1527471.38,7.0,0,4,4,4,12,0xb2d5a446
10000.32,2.0,92,2,3,1,6,0xb2d64c2b
334765.47,7.0,3,4,4,4,12,0xb2d41767
296000.14,2.0,10,3,3,3,9,0xb2d5b5c9
181476.53,4.0,18,3,4,2,9,0xb2d6a0d4
1298.51,1.0,92,1,2,1,4,0xb2d29893
4142.2,1.0,0,2,2,4,8,0xb2d3ebb2d
287.16,1.0,6,1,2,3,6,0xb2d34819
423022.05,2.0,231,4,3,1,8,0xb2d53cb6
53277.0,4.0,95,3,4,1,8,0xb2d65319d
229648.53,2.0,0,3,3,4,10,0xb2d35e2a
29903.35,1.0,18,2,2,2,6,0xb2d95c18
5152.87,1.0,0,2,2,4,8,0xb2d8ea58
1363.04,2.0,0,1,3,4,8,0x3b9af2a8
831634.42,3.0,79,4,4,1,9,0xb2d5570c
1217.34,1.0,92,1,2,1,4,0xb2d34a70
80391.65,2.0,181,3,3,1,7,0xb2d38226
11028.7,1.0,28,2,2,2,6,0xb2d0e8f2
1.5,1.0,18,1,2,2,5,0x3b9af45dd
201049.99,2.0,3,3,3,4,10,0xb2d93f55
150003.7,3.0,5,3,4,3,10,0xb2d91f72
3.17,1.0,19,1,2,2,5,0xb2d94b00
26224.9,1.0,6,2,2,3,7,0xb2d653c9
726.92,1.0,31,1,2,2,5,0xb2d5f112
2372000.0,16.0,0,4,4,4,12,0xb2d069d5
590040.14,9.0,1,4,4,4,12,0xb2d67e12
208668.75,1.0,0,3,2,4,9,0xb2d1ab07
239453.5,2.0,184,3,3,1,7,0x3b9b2fdc
168120.42,2.0,195,3,3,1,7,0xb2d1af21
280023.46,3.0,3,3,4,4,11,0xb2d2f6af
30000.0,2.0,0,2,3,4,9,0xb2d97cd7
320000.28,3.0,6,4,4,3,11,0xb2d4cc9e
51062.24,3.0,76,2,4,1,7,0xb2d5be1a
701854.24,3.0,32,4,4,2,10,0xb2d8e0edd
2997.64,2.0,92,2,3,1,6,0x3b9b16b2
465124.66,1.0,5,4,2,3,9,0xb2d0eac4
150117.26,2.0,4,3,3,4,10,0xb2d60350
11247.16,1.0,29,2,2,2,6,0xb2d91f1b
265023.45,5.0,18,3,4,2,9,0xb2d415ea
400046.8,3.0,18,4,4,2,10,0xb2d56d86
106.3,1.0,20,1,2,2,5,0xb2d2926f
303069.26,5.0,14,4,4,3,11,0xb2d821a4
602886.07,6.0,20,4,4,2,10,0x3b9b3fe6
642229.32,6.0,4,4,4,4,12,0xb2d5ce1a
340056.13,3.0,27,4,4,2,10,0xb2d940e9
1383.37,1.0,92,1,2,1,4,0xb2d2cfbe
105524.74,4.0,11,3,4,3,10,0xb2d25e87
100005.3,2.0,216,3,3,1,7,0xb2d67f45
2180023.01,3.0,13,4,4,3,11,0xb2d95182
10036.47,1.0,184,2,2,1,5,0xb2d63c13
7284.82,1.0,92,2,2,1,5,0xb2d29ad9
900631.17,6.0,3,4,4,4,12,0xb2d3c421
0.0,1.0,5,1,2,3,6,0xb2d3f89d
8599.2,1.0,5,2,2,3,7,0xb2d29adf
3480.01,1.0,0,2,2,4,8,0xb2d0f034
102760.57,3.0,1,3,4,4,11,0xb2d56434
11102.78,1.0,18,2,2,2,6,0xb2d34046
1500000.0,3.0,8,4,4,3,11,0xb2da3624
3029.85,1.0,92,2,2,1,5,0xb2d1a61ed
702.92,1.0,0,1,2,4,7,0xb2d43529
1442228.14,12.0,5,4,4,3,11,0xb2d15150
500005.3,2.0,206,4,3,1,8,0xb2d67e27
42177.84,1.0,0,2,2,4,8,0xb2d47d20d
291073.48,4.0,8,3,4,3,10,0xb2d27d95
93081.17,6.0,0,3,4,4,11,0x3b9af2af
300961.46,3.0,14,4,4,3,11,0xb2d261ba
56006.48,2.0,21,3,3,2,8,0xb2d66904
200000.08,2.0,11,3,3,3,9,0xb2d06ec1
72811.36,1.0,5,3,2,3,8,0xb2d102a7d
940000.0,7.0,0,4,4,4,12,0xb2d6d6b5
105003.55,3.0,206,3,4,1,8,0xb2d109bc
56.26,1.0,80,1,2,1,4,0xb2d33c4f
528350.78,8.0,67,4,4,1,9,0xb2d43d6a
2170777.48,4.0,32,4,4,2,10,0xb2d07d23
734554.66,3.0,25,4,4,2,10,0xb2d78643
84502.34,5.0,13,3,4,3,10,0xb2d92e8d
20276.24,1.0,52,2,2,2,6,0xb2d496a0
136.89,1.0,71,1,2,1,4,0xb2d236f3
232.61,1.0,14,1,2,3,6,0xb2d944b6
51.67,1.0,139,1,2,1,4,0xb2d620f8
3053311.39,2.0,154,4,3,1,8,0xb2d4a230
655.94,1.0,73,1,2,1,4,0xb2d69a7e
1026082.12,11.0,0,4,4,4,12,0xb2d2865d
710350.32,4.0,83,4,4,1,9,0xb2d3ebd1
547022.14,4.0,53,4,4,2,10,0xb2d238ba
280013.42,3.0,104,3,4,1,8,0xb2d21d36d
85089.23,2.0,0,3,3,4,10,0xb2d97cd5
11698.6,1.0,0,2,2,4,8,0xb2d41f72
156436.58,11.0,0,3,4,4,11,0xb2d50502
80000.0,2.0,4,3,3,4,10,0xb2d9b579
19256.05,1.0,8,2,2,3,7,0xb2d0b7ae
50000.0,2.0,7,2,3,3,8,0xb2d5adc8
65.27,1.0,7,1,2,3,6,0xb2d3f2cd
14791.44,1.0,184,2,2,1,5,0xb2d2c9b1
261489.74,3.0,1,3,4,4,11,0xb2d94806
60061.72,2.0,14,3,3,3,9,0xb2d64878
8937.65,1.0,0,2,2,4,8,0xb2d7874d
40000.43,2.0,6,2,3,3,8,0xb2d650dc
263753.2,4.0,4,3,4,4,11,0xb2d06f60
1944480.7,15.0,11,4,4,3,11,0xb2d58a75
132222.0,3.0,81,3,4,1,8,0xb2d0d697
1145023.17,4.0,92,4,4,1,9,0xb2d40bbe
5436.22,1.0,0,2,2,4,8,0xb2d6ac8bd
201007.43,3.0,38,3,4,2,9,0xb2d90268
471.43,1.0,32,1,2,2,5,0xb2d59eb1
816.77,2.0,0,1,3,4,8,0x3b9b2560
110004.64,2.0,55,3,3,2,8,0xb2d8fe42
3019.79,1.0,14,2,2,3,7,0xb2d400db
16.92,1.0,55,1,2,2,5,0xb2d9a7f1
1782.09,1.0,0,1,2,4,7,0xb2d25f49
100015.95,2.0,123,3,3,1,7,0xb2d3f281
100006.89,3.0,16,3,4,2,9,0xb2d2202d
170000.0,6.0,4,3,4,4,11,0xb2d3291f
11698.38,1.0,18,2,2,2,6,0xb2d0e0ff
531292.99,5.0,40,4,4,2,10,0xb2d141dd
270003.92,3.0,3,3,4,4,11,0x3b9b454c
107800.6,2.0,63,3,3,2,8,0xb2d43a75
20001.19,2.0,185,2,3,1,6,0xb2d5ea4e
50098.22,2.0,62,2,3,2,7,0xb2d1a43e
2248868.04,14.0,33,4,4,2,10,0xb2d2102f
1347.92,1.0,2,1,2,4,7,0xb2d6cf37
201746.19,2.0,47,3,3,2,8,0xb2d139a8
555072.93,3.0,0,4,4,4,12,0xb2d612b5
30556.65,1.0,15,2,2,3,7,0xb2d705f1d
19670.61,1.0,9,2,2,3,7,0xb2d8c48a
29175.05,7.0,0,2,4,4,10,0xb2d16cbd
500080.3,2.0,22,4,3,2,9,0xb2d8d075
0.0,1.0,9,1,2,3,6,0xb2d5732a
4337.6,1.0,96,2,2,1,5,0xb2d28f1d
60006.25,2.0,18,3,3,2,8,0xb2da2aeb
1324.04,1.0,16,1,2,2,5,0xb2d5b1bd
1529.79,1.0,8,1,2,3,6,0xb2d39fd8
2314011.16,7.0,39,4,4,2,10,0xb2d29e58
11629.67,1.0,10,2,2,3,7,0xb2da3a20
190000.0,6.0,4,3,4,4,11,0xb2d625c8d
200002.11,2.0,28,3,3,2,8,0xb2da0b7e
12.11,1.0,55,1,2,2,5,0xb2d3da51
1005.12,1.0,92,1,2,1,4,0xb2d381c1
1262.37,4.0,0,1,4,4,9,0xb2d34515d
889249.5,3.0,77,4,4,1,9,0xb2d1e0f7
5817.68,1.0,92,2,2,1,5,0xb2d1ecbe
0.84,1.0,6,1,2,3,6,0xb2d6a4be
60001.58,4.0,63,3,4,2,9,0xb2d925ae
100005.28,2.0,48,3,3,2,8,0xb2d9d389
200008.79,2.0,112,3,3,1,7,0xb2d4387d
138003.56,2.0,3,3,3,4,10,0xb2d217e7
235681.21,1.0,1,3,2,4,9,0xb2d4aa8d
205140.17,1.0,1,3,2,4,9,0xb2d45cdc
1038.46,1.0,6,1,2,3,6,0xb2d8cb1d
105001.11,2.0,95,3,3,1,7,0xb2d97ae5
462.19,4.0,37,1,4,2,7,0xb2d4b956
2543566.89,13.0,1,4,4,4,12,0xb2d15720
10052.04,1.0,184,2,2,1,5,0xb2d32feb
1520762.89,4.0,8,4,4,3,11,0xb2d0c12ad
109529.84,3.0,111,3,4,1,8,0xb2d265c3
2224.0,1.0,9,1,2,3,6,0xb2d3a87d
299021.22,4.0,104,3,4,1,8,0xb2d6dbb4
670021.22,2.0,94,4,3,1,8,0xb2d86c50d
225000.0,2.0,0,3,3,4,10,0xb2d6085bd
1875.01,1.0,22,1,2,2,5,0xb2d2fc5a
126.79,2.0,24,1,3,2,6,0xb2d1f6f7
9.17,1.0,19,1,2,2,5,0xb2d564a7
5.26,2.0,29,1,3,2,6,0xb2d2fe6b
23.75,1.0,34,1,2,2,5,0xb2d3b734
31286.42,3.0,275,2,4,1,7,0xb2d0bf00
50787.19,2.0,55,2,3,2,7,0xb2d6419b
633917.48,1.0,0,4,2,4,10,0xb2d6b289
3779.62,1.0,110,2,2,1,5,0xb2d60b86d
200000.0,2.0,3,3,3,4,10,0xb2d5fce2
120109.97,5.0,31,3,4,2,9,0xb2d5d57a
293002.7,4.0,8,3,4,3,10,0xb2d41f64
134841.62,2.0,63,3,3,2,8,0xb2d5b9f3
270672.94,3.0,11,3,4,3,10,0xb2d0bd6c
6338.51,1.0,21,2,2,2,6,0xb2d6de5a
10958.66,1.0,184,2,2,1,5,0xb2d22f81
6669.37,1.0,1,2,2,4,8,0xb2d7bd25
219236.95,5.0,1,3,4,4,11,0xb2d699ed
3095.49,1.0,11,2,2,3,7,0xb2d9642a
49.61,3.0,36,1,4,2,7,0xb2d09019
60000.0,1.0,0,3,2,4,9,0xb2da10aa
202847.72,2.0,87,3,3,1,7,0xb2d904c5
800793.97,5.0,11,4,4,3,11,0xb2d78a62
44.39,1.0,56,1,2,2,5,0xb2d46fdb
150039.37,2.0,35,3,3,2,8,0xb2d2694e
431327.49,8.0,18,4,4,2,10,0xb2d619ba
901143.06,5.0,5,4,4,3,11,0xb2d5d99c
125014.43,2.0,136,3,3,1,7,0xb2d6f1a7
258.83,1.0,77,1,2,1,4,0xb2d78cd0
74455.15,3.0,14,3,4,3,10,0xb2d50504
240947.77,2.0,196,3,3,1,7,0xb2d1273d
324416.42,13.0,3,4,4,4,12,0xb2d250d7
50000.0,2.0,68,2,3,1,6,0xb2d64988
9993.14,1.0,3,2,2,4,8,0xb2d312f9
217354.96,3.0,83,3,4,1,8,0x3b9af486
270116.22,4.0,14,3,4,3,10,0xb2d551b6
183.48,1.0,9,1,2,3,6,0xb2d2f5fe
0.0,1.0,92,1,2,1,4,0xb2d30b9ed
210092.73,2.0,0,3,3,4,10,0xb2d1bb2e
33.01,1.0,0,1,2,4,7,0xb2d6b4d1
500080.3,2.0,22,4,3,2,9,0xb2d8d06a
10952.35,1.0,0,2,2,4,8,0xb2d6f3a7
9096.54,1.0,2,2,2,4,8,0xb2d96531
4700.08,1.0,0,2,2,4,8,0xb2d0f27e
3687380.0,4.0,1,4,4,4,12,0xb2d923b9d
916440.7,3.0,18,4,4,2,10,0xb2d1534ed
1000025.9,5.0,83,4,4,1,9,0xb2d55eba
1837.98,1.0,0,1,2,4,7,0xb2d270de
80003.07,2.0,65,3,3,2,8,0xb2d2a477
500714.09,1.0,6,4,2,3,9,0xb2d97f45
6.23,1.0,14,1,2,3,6,0xb2d95b45
500044.96,3.0,122,4,4,1,9,0xb2d1db6c
50000.53,2.0,13,2,3,3,8,0xb2d95cd0
56360.09,2.0,0,3,3,4,10,0xb2d6a98e
34647.45,1.0,141,2,2,1,5,0xb2d37c38
2156.83,5.0,92,1,4,1,6,0xb2d0dd7a
1039134.32,11.0,19,4,4,2,10,0xb2d56c1e
31216.78,1.0,2,2,2,4,8,0xb2d3685f
1932097.91,12.0,0,4,4,4,12,0x3b9b3683
570047.7,3.0,15,4,4,3,11,0xb2d5f9d2
1679.03,1.0,92,1,2,1,4,0xb2d24a0e
1065115.5,17.0,0,4,4,4,12,0x3b9af1fc
70218.43,2.0,73,3,3,1,7,0xb2d562b1
52927.91,3.0,98,3,4,1,8,0xb2d152dc
82707.58,5.0,20,3,4,2,9,0xb2d09b57
200324.36,3.0,1,3,4,4,11,0xb2d07739
13986.97,1.0,92,2,2,1,5,0xb2d1e869
196.74,1.0,0,1,2,4,7,0xb2d7045dd
939162.31,7.0,0,4,4,4,12,0x3b9b31e0
308308.25,2.0,18,4,3,2,9,0xb2d64221
50056.49,2.0,46,2,3,2,7,0xb2d83852
400000.0,3.0,8,4,4,3,11,0xb2d0e7e7
70772.87,4.0,73,3,4,1,8,0xb2d57179
20022.36,2.0,14,2,3,3,8,0xb2d1f756
4643.12,1.0,184,2,2,1,5,0xb2d2fafed
15.83,1.0,47,1,2,2,5,0xb2d94b6a
395025.0,11.0,20,4,4,2,10,0xb2d0cf5a
50362.61,2.0,6,2,3,3,8,0xb2d606be
500000.65,3.0,4,4,4,4,12,0xb2d6599f
63529.73,5.0,0,3,4,4,11,0xb2d0b636
105376.02,2.0,76,3,3,1,7,0xb2d2b623
246033.66,5.0,29,3,4,2,9,0xb2d2730d
2770.29,1.0,35,1,2,2,5,0xb2d38d00
700035.19,4.0,48,4,4,2,10,0xb2d307f9
59.32,1.0,10,1,2,3,6,0xb2d94db9
4561.87,1.0,7,2,2,3,7,0xb2d55d7ed
815.42,1.0,70,1,2,1,4,0xb2d69a37d
100530.1,3.0,130,3,4,1,8,0xb2d6c50b
41545.54,2.0,139,2,3,1,6,0xb2d5376dd
1302019.62,7.0,0,4,4,4,12,0xb2d1923e
370.46,1.0,5,1,2,3,6,0xb2d70910
27214.32,1.0,4,2,2,4,8,0xb2d86c11
3629.39,1.0,22,2,2,2,6,0xb2d38ef5
119946.42,2.0,11,3,3,3,9,0xb2d170d5
51633.91,1.0,0,2,2,4,8,0xb2d5fe57
20000.0,2.0,0,2,3,4,9,0x3b9b2335
204864.11,3.0,25,3,4,2,9,0xb2d5ba09d
115744.43,3.0,3,3,4,4,11,0xb2d1b9fc
2302.08,1.0,2,1,2,4,7,0xb2d58c02
200002.1,2.0,9,3,3,3,9,0xb2d8eb62d
1119.9,1.0,1,1,2,4,7,0xb2d436b4
3421.76,2.0,92,2,3,1,6,0xb2d264eb
1237730.68,7.0,179,4,4,1,9,0x3b9b3ecd
465035.12,8.0,18,4,4,2,10,0xb2d18b51
123228.38,2.0,7,3,3,3,9,0xb2d6ab17
132829.72,3.0,46,3,4,2,9,0xb2d57a40
131034.18,1.0,18,3,2,2,7,0xb2d28154
614074.41,4.0,88,4,4,1,9,0xb2d4adbd
50001.0,2.0,61,2,3,2,7,0xb2d58772
116293.82,8.0,0,3,4,4,11,0xb2d2f34e
907.72,1.0,4,1,2,4,7,0xb2d716ce
1100338.98,2.0,168,4,3,1,8,0xb2d5749a
820.61,1.0,5,1,2,3,6,0xb2d62376
443880.24,7.0,13,4,4,3,11,0xb2d64dbb
145695.39,2.0,22,3,3,2,8,0xb2d49beb
370465.25,3.0,0,4,4,4,12,0xb2d2a471
526250.45,6.0,22,4,4,2,10,0xb2d478ea
50000.83,3.0,101,2,4,1,7,0xb2d07a63
10135.53,1.0,92,2,2,1,5,0xb2d1144f
2179.66,1.0,29,1,2,2,5,0xb2d20fba
20000002.98,7.0,10,4,4,3,11,0xb2d35d06
82569.49,1.0,0,3,2,4,9,0xb2d43c02
0.0,1.0,1,1,2,4,7,0xb2d12174
12012.82,4.0,8,2,4,3,9,0xb2d37c95
325039.74,2.0,132,4,3,1,8,0xb2d69522
60342.94,1.0,20,3,2,2,7,0xb2d1b45cd
51190.52,1.0,33,2,2,2,6,0xb2d64fb4
219518.36,4.0,23,3,4,2,9,0xb2d083a8
331156.83,3.0,70,4,4,1,9,0xb2d108f7
3096.08,1.0,184,2,2,1,5,0xb2d2c027
1528382.62,8.0,25,4,4,2,10,0xb2d3c3f1d
302839.2,4.0,18,4,4,2,10,0xb2d546cc
83012.72,2.0,0,3,3,4,10,0xb2d58f82d
10.67,1.0,103,1,2,1,4,0xb2d6058b
1895.4,1.0,0,1,2,4,7,0xb2d8de9f
824.23,1.0,2,1,2,4,7,0xb2d91bab
150091.04,3.0,0,3,4,4,11,0xb2d3a011
123735.12,4.0,32,3,4,2,9,0xb2d37d5b
8906.11,1.0,75,2,2,1,5,0xb2d8e7a5
304372.17,4.0,74,4,4,1,9,0xb2d41572
10.55,2.0,42,1,3,2,6,0xb2d10d85
10110.31,1.0,184,2,2,1,5,0xb2d28b2ed
214.89,1.0,5,1,2,3,6,0xb2d86ae4
1114317.75,1.0,6,4,2,3,9,0xb2d46923
19746.17,1.0,28,2,2,2,6,0xb2d6c451
1370.07,1.0,62,1,2,2,5,0xb2d7785f
72.51,1.0,10,1,2,3,6,0xb2d4189a
68.61,1.0,89,1,2,1,4,0xb2d8a38e
17709.68,1.0,4,2,2,4,8,0xb2d91326
5596.98,1.0,14,2,2,3,7,0xb2d95db2
710.31,1.0,29,1,2,2,5,0xb2d0eee3
50001.06,2.0,60,2,3,2,7,0xb2d9be48
294706.37,1.0,54,3,2,2,7,0xb2d3b5f1
655.2,1.0,8,1,2,3,6,0xb2d36e41
20000.21,2.0,27,2,3,2,7,0xb2d942a6
40008.42,2.0,31,2,3,2,7,0xb2d93931
30000.63,2.0,31,2,3,2,7,0xb2d93861
221652.19,2.0,26,3,3,2,8,0xb2d2e9eb
97.63,1.0,0,1,2,4,7,0xb2d6d905
109.12,1.0,0,1,2,4,7,0xb2d653d6
6256125.84,7.0,19,4,4,2,10,0xb2d53c61d
10.57,1.0,110,1,2,1,4,0xb2d954d3
51006.08,2.0,70,2,3,1,6,0xb2d65ede
229977.64,1.0,0,3,2,4,9,0xb2d4fc0f
204999.4,2.0,109,3,3,1,7,0xb2d69a99d
3929.79,1.0,0,2,2,4,8,0xb2d3aadf
1856.11,1.0,10,1,2,3,6,0xb2d9330e
861.91,1.0,4,1,2,4,7,0xb2d2e928
0.0,1.0,1,1,2,4,7,0xb2d6439e
50322.79,1.0,92,2,2,1,5,0xb2d447a9
5229.98,1.0,0,2,2,4,8,0xb2d2fc40
670008.93,5.0,14,4,4,3,11,0xb2d6fa2a
33396.02,1.0,153,2,2,1,5,0xb2d39495
4090.22,1.0,28,2,2,2,6,0xb2d425f5
670811.9,16.0,4,4,4,4,12,0x3b9b3eec
6110.71,1.0,6,2,2,3,7,0xb2d68efd
47184.25,1.0,1,2,2,4,8,0xb2d2928f
609160.68,9.0,7,4,4,3,11,0xb2d2267c
100105.3,2.0,23,3,3,2,8,0xb2d244f0
29.64,1.0,24,1,2,2,5,0xb2d4f80e
144002.9,3.0,0,3,4,4,11,0xb2d112c8
52192.05,5.0,6,3,4,3,10,0xb2d06aae
314822.17,4.0,1,4,4,4,12,0xb2d07941d
1032.6,1.0,0,1,2,4,7,0xb2d5d754
800580.65,1.0,1,4,2,4,10,0xb2d6ef2e
100008.02,2.0,74,3,3,1,7,0xb2d98993
1737.15,2.0,184,1,3,1,5,0x3b9b2638
95484.01,1.0,0,3,2,4,9,0xb2d24611
4342.82,1.0,0,2,2,4,8,0xb2d6e888d
10007.07,1.0,92,2,2,1,5,0xb2d9769e
170221.45,2.0,189,3,3,1,7,0xb2d60c8bd
1000000.0,2.0,0,4,3,4,11,0xb2d9818f
785.11,1.0,8,1,2,3,6,0xb2d8d695
261.04,1.0,28,1,2,2,5,0xb2d2bdd4d
63.16,1.0,8,1,2,3,6,0xb2d81480
2162.76,1.0,1,1,2,4,7,0xb2d24642
505329.64,2.0,96,4,3,1,8,0xb2d95607d
140007.41,2.0,203,3,3,1,7,0xb2d6d6ac
603804.92,2.0,1,4,3,4,11,0xb2d905d5
4181.2,1.0,0,2,2,4,8,0xb2d694b2
50675.75,3.0,210,2,4,1,7,0xb2d5dde5
5692.19,1.0,21,2,2,2,6,0xb2d94590
145003.85,8.0,10,3,4,3,10,0xb2d3ef50
32628.86,1.0,3,2,2,4,8,0xb2d324c6
2985.2,1.0,93,2,2,1,5,0xb2d2cde4
68737.87,3.0,13,3,4,3,10,0xb2d58b49
500020.48,2.0,2,4,3,4,11,0xb2d93f98
17008.67,1.0,14,2,2,3,7,0xb2d5c24c
10205.43,2.0,9,2,3,3,8,0xb2d5a18e
1.43,1.0,29,1,2,2,5,0xb2d5c0fc
172.21,1.0,13,1,2,3,6,0xb2d39b61
730.45,1.0,21,1,2,2,5,0xb2d64ce2
200002.11,2.0,20,3,3,2,8,0xb2d95121
412548.97,4.0,11,4,4,3,11,0xb2d178aa
2816.26,1.0,92,1,2,1,4,0xb2d4414c
54384.87,4.0,25,3,4,2,9,0xb2d5d7c3
200451.25,4.0,31,3,4,2,9,0xb2d389cb
280006.34,3.0,82,3,4,1,8,0xb2d97353
128057.36,2.0,1,3,3,4,10,0xb2d17799
70020.45,3.0,28,3,4,2,9,0xb2d6ed5e
102921.19,2.0,60,3,3,2,8,0xb2d6824fd
20151.04,1.0,92,2,2,1,5,0xb2d604d8
1385036.33,24.0,0,4,4,4,12,0x3b9b3434
0.0,1.0,2,1,2,4,7,0xb2d4f342
14710.32,1.0,9,2,2,3,7,0xb2d6dd95d
105008.63,2.0,56,3,3,2,8,0xb2d52b73
4063.41,1.0,122,2,2,1,5,0xb2d55118d
3717.73,1.0,5,2,2,3,7,0xb2d68cbf
776634.91,5.0,11,4,4,3,11,0xb2d2e219
0.0,1.0,7,1,2,3,6,0xb2d988d7
15000.09,1.0,10,2,2,3,7,0xb2d41fb7
6008.39,1.0,1,2,2,4,8,0xb2d8da55
2.99,1.0,20,1,2,2,5,0xb2d3cbae
101745.75,2.0,192,3,3,1,7,0xb2d5dd1a
150110.25,2.0,112,3,3,1,7,0xb2d2016e
71.58,1.0,45,1,2,2,5,0xb2d2b0b2
763495.9,1.0,63,4,2,2,8,0xb2d14d11
208645.4,3.0,87,3,4,1,8,0xb2d3d4cb
100045.67,2.0,40,3,3,2,8,0xb2d63b5e
73192.18,1.0,11,3,2,3,8,0xb2d38a51
200811.56,2.0,30,3,3,2,8,0xb2d78150
635590.95,5.0,4,4,4,4,12,0xb2d6c12e
5329.45,1.0,92,2,2,1,5,0xb2d52b00
5091.23,1.0,145,2,2,1,5,0xb2d6d1be
70010.39,2.0,70,3,3,1,7,0xb2d5cb3f
5.36,1.0,89,1,2,1,4,0xb2d1a547
459042.04,7.0,27,4,4,2,10,0xb2d0d1d2
270056.19,3.0,56,3,4,2,9,0xb2d8f0e8
1072.12,2.0,0,1,3,4,8,0xb2d5304a
14619.35,1.0,127,2,2,1,5,0xb2d68c5fd
1100615.38,1.0,2,4,2,4,10,0xb2d45af5
500000.0,2.0,25,4,3,2,9,0xb2d9cd6a
585391.63,2.0,135,4,3,1,8,0xb2d0811a
4475.26,1.0,184,2,2,1,5,0xb2d0c5b2
395155.69,4.0,3,4,4,4,12,0xb2d5ab9f
200103.14,3.0,28,3,4,2,9,0xb2d95d4f
1036.73,1.0,42,1,2,2,5,0xb2d4db29
790204.93,3.0,20,4,4,2,10,0xb2d6dd99
94558.31,2.0,39,3,3,2,8,0xb2d1cd8d
961.71,1.0,2,1,2,4,7,0xb2d25649
400014.57,6.0,8,4,4,3,11,0xb2d213a8
644.86,1.0,30,1,2,2,5,0xb2d4c93d
16000.01,1.0,1,2,2,4,8,0xb2d2b375
3370.33,1.0,92,2,2,1,5,0xb2d11580
45005.63,2.0,4,2,3,4,9,0xb2d390f9
71.53,1.0,0,1,2,4,7,0xb2d5bf96
540768.89,6.0,11,4,4,3,11,0xb2d111f2
25178.12,1.0,29,2,2,2,6,0xb2d535f2
3075.49,1.0,92,2,2,1,5,0xb2d19932
829643.5,9.0,0,4,4,4,12,0x3b9b44bf
750070.84,4.0,80,4,4,1,9,0xb2d2611a
600018.46,3.0,130,4,4,1,9,0xb2d1b518
154476.02,3.0,11,3,4,3,10,0xb2d06e6e
420102.25,5.0,25,4,4,2,10,0x3b9b2aa1
3243.11,1.0,92,2,2,1,5,0xb2d1e43a
4398.89,1.0,95,2,2,1,5,0xb2d540c6
19.89,1.0,55,1,2,2,5,0xb2d6ebc7
5790.93,1.0,5,2,2,3,7,0xb2d50beb
40.07,3.0,49,1,4,2,7,0x3b9b46c8
402004.63,19.0,0,4,4,4,12,0xb2d2519f
25133.03,2.0,153,2,3,1,6,0xb2d28cfe
1943193.61,7.0,18,4,4,2,10,0xb2d1c784
3.58,1.0,60,1,2,2,5,0xb2d69817
1319576.88,14.0,0,4,4,4,12,0x3b9b1810d
7143.62,1.0,0,2,2,4,8,0xb2d68ee5
160270.18,4.0,10,3,4,3,10,0xb2d0f1d0
0.98,1.0,20,1,2,2,5,0xb2d609ff
494948.64,7.0,4,4,4,4,12,0xb2d21dd5
90002.62,2.0,206,3,3,1,7,0xb2d50960
2000063.51,4.0,2,4,4,4,12,0xb2d33bcf
25.45,1.0,92,1,2,1,4,0xb2d131b7d
214000.0,2.0,1,3,3,4,10,0xb2da2061
233058.51,2.0,105,3,3,1,7,0xb2d410d3d
200884.82,2.0,0,3,3,4,10,0xb2d6d725
150006.33,2.0,14,3,3,3,9,0xb2da3584
80922.21,3.0,24,3,4,2,9,0xb2d2678a
2045.22,1.0,0,1,2,4,7,0xb2d2a514d
50019.02,2.0,77,2,3,1,6,0xb2d267e6
374003.57,5.0,4,4,4,4,12,0xb2d17c50
771334.6,3.0,0,4,4,4,12,0xb2d594bd
6.0,1.0,53,1,2,2,5,0xb2d0d70b
3469.5,1.0,3,2,2,4,8,0xb2d306f1
223994.14,2.0,32,3,3,2,8,0xb2d42a75d
500000.0,2.0,29,4,3,2,9,0xb2da0bc2
5000100.02,2.0,28,4,3,2,9,0xb2da0ee0
5124.16,2.0,184,2,3,1,6,0xb2d2bf13
340958.84,3.0,0,4,4,4,12,0xb2d578eb
1010016.27,5.0,3,4,4,4,12,0xb2d3ee62
142022483.33,1.0,24,4,2,2,8,0xb2d6b852
300063.06,4.0,1,3,4,4,11,0xb2d2723c
8622.84,1.0,4,2,2,4,8,0xb2d836ca
1.58,1.0,81,1,2,1,4,0xb2d8ccdb
556951.74,4.0,102,4,4,1,9,0xb2d12d97
18873.55,2.0,302,2,3,1,6,0x3b9b3682
14.23,2.0,20,1,3,2,6,0xb2d93f85
4579.78,1.0,3,2,2,4,8,0xb2d48fde
200000.1,3.0,1,3,4,4,11,0x3b9b41b1
151871.72,2.0,0,3,3,4,10,0xb2d25da9
27345.78,1.0,96,2,2,1,5,0xb2d60720
4641179.1,11.0,6,4,4,3,11,0xb2d25346d
332780.92,4.0,6,4,4,3,11,0xb2d57493
336.94,1.0,35,1,2,2,5,0xb2d598f3
1405061.83,11.0,35,4,4,2,10,0xb2d16d98
301131.27,2.0,29,4,3,2,9,0xb2d8fa89
70517.74,3.0,6,3,4,3,10,0xb2d9895a
2450128.57,9.0,0,4,4,4,12,0xb2d5578d
213653.24,2.0,74,3,3,1,7,0xb2d33b85d
4123546.77,11.0,0,4,4,4,12,0x3b9af147
295872.9,3.0,34,3,4,2,9,0xb2d9f5c7
30301.62,2.0,27,2,3,2,7,0xb2d5d777
10190.39,2.0,10,2,3,3,8,0xb2d6b2af
105033.63,2.0,25,3,3,2,8,0xb2d3a913d
100010.68,2.0,24,3,3,2,8,0xb2d29861
1000042.22,2.0,60,4,3,2,9,0xb2d9b4eb
2924136.82,13.0,0,4,4,4,12,0x3b9ad78a
11040.09,1.0,10,2,2,3,7,0xb2d6efde
255000.72,2.0,89,3,3,1,7,0xb2d6960ed
160007.28,2.0,122,3,3,1,7,0xb2d65d46d
503692.57,2.0,0,4,3,4,11,0xb2d6910e
52.63,1.0,22,1,2,2,5,0xb2d44a51
325329.89,7.0,0,4,4,4,12,0xb2d5e76a
6599.67,1.0,27,2,2,2,6,0xb2d3081a
245000.01,5.0,0,3,4,4,11,0xb2d60dbb
140987.28,3.0,136,3,4,1,8,0xb2d63556
200012.12,2.0,98,3,3,1,7,0xb2d96e7c
870.17,1.0,23,1,2,2,5,0xb2d1cf1a
1022000.75,6.0,3,4,4,4,12,0xb2d5a6b1
2092.27,1.0,26,1,2,2,5,0xb2d184d9
514241.6,2.0,75,4,3,1,8,0xb2d62c55
4385.44,1.0,5,2,2,3,7,0xb2d430a8
1724.28,1.0,10,1,2,3,6,0xb2d5738a
2139.44,1.0,92,1,2,1,4,0xb2d37b93
3133.64,1.0,4,2,2,4,8,0xb2d186fc
210063.11,2.0,69,3,3,1,7,0xb2d3617c
80079.64,2.0,82,3,3,1,7,0xb2d620eb
252264.56,2.0,4,3,3,4,10,0xb2d56bd9
14258.84,2.0,83,2,3,1,6,0xb2d5e745
2221.83,1.0,10,1,2,3,6,0xb2d9a339
350036.36,8.0,1,4,4,4,12,0xb2d22c93
356445.89,6.0,35,4,4,2,10,0xb2d08f55
70147.67,1.0,6,3,2,3,8,0xb2d973ad
175023.79,4.0,31,3,4,2,9,0x3b9b28f6
2787.51,1.0,5,1,2,3,6,0xb2d5519f
10321.25,2.0,52,2,3,2,7,0xb2d594cc
4074.9,1.0,92,2,2,1,5,0xb2d07234
10.43,1.0,63,1,2,2,5,0xb2d21f55
5.99,1.0,35,1,2,2,5,0xb2d41473
0.0,1.0,9,1,2,3,6,0xb2d2973b
9316.39,2.0,7,2,3,3,8,0xb2d514aed
59398.33,1.0,49,3,2,2,7,0xb2d39283
300000.0,2.0,27,3,3,2,8,0xb2d9447cd
653.44,1.0,10,1,2,3,6,0xb2d554b1
202941.42,1.0,113,3,2,1,6,0xb2d2f172d
46.08,1.0,0,1,2,4,7,0xb2d0f3a0
179.56,1.0,231,1,2,1,4,0xb2d5ec24
130725.03,6.0,63,3,4,2,9,0xb2d598a6
920298.43,28.0,0,4,4,4,12,0x3b9b12ad
3602.72,1.0,103,2,2,1,5,0xb2d652c9
351651.68,3.0,18,4,4,2,10,0xb2d382d9
36016.02,6.0,0,2,4,4,10,0x3b9af214
18.11,1.0,67,1,2,1,4,0xb2d67e0f
470393.28,2.0,116,4,3,1,8,0xb2d56641
30131.14,1.0,3,2,2,4,8,0xb2d3aed0
50270.87,2.0,98,2,3,1,6,0xb2d50fec
435812.59,6.0,1,4,4,4,12,0xb2d31c21
50037.04,2.0,108,2,3,1,6,0xb2d60ae8
20721.47,1.0,4,2,2,4,8,0xb2d7f300
188393.81,1.0,10,3,2,3,8,0xb2d8c128
1165828.25,15.0,70,4,4,1,9,0xb2d19190
261.23,1.0,29,1,2,2,5,0xb2d4edf7
1729.82,1.0,3,1,2,4,7,0xb2d5d7f4
3075358.17,3.0,0,4,4,4,12,0xb2d39b36
10064.17,1.0,14,2,2,3,7,0xb2d57eee
9095.46,1.0,184,2,2,1,5,0xb2d2acc2
3612020.57,11.0,3,4,4,4,12,0xb2d39348
770105.02,2.0,129,4,3,1,8,0xb2d294b1
440065.3,3.0,4,4,4,4,12,0xb2d60dc5
100131.28,2.0,25,3,3,2,8,0xb2d63b97
500435.68,2.0,49,4,3,2,9,0xb2d5993b
13908.62,1.0,0,2,2,4,8,0xb2d6a04fd
171096.08,6.0,3,3,4,4,11,0xb2d23c03
300012.83,1.0,2,3,2,4,9,0xb2d6d787
263.59,3.0,92,1,4,1,6,0x3b9b2cbe
82857.14,1.0,9,3,2,3,8,0xb2d960f8
103.0,1.0,20,1,2,2,5,0xb2d22afb
350046.22,2.0,3,4,3,4,11,0xb2d6d4a9
1377.6,1.0,184,1,2,1,4,0xb2d22499
550026.88,4.0,12,4,4,3,11,0xb2d4526b
25487.46,2.0,0,2,3,4,9,0xb2d23931
71650.27,2.0,100,3,3,1,7,0xb2d546b7
1492.65,1.0,6,1,2,3,6,0xb2d61b1f
10000.53,2.0,92,2,3,1,6,0xb2d63c2c
78.35,1.0,15,1,2,3,6,0xb2d69195
133007.73,4.0,118,3,4,1,8,0xb2d56160
7496.95,1.0,184,2,2,1,5,0xb2d3b259
20648.84,2.0,14,2,3,3,8,0xb2d5cdfa
501786.84,2.0,31,4,3,2,9,0xb2d9388dd
231105.06,2.0,179,3,3,1,7,0xb2d8c9c9
18997.83,2.0,2,2,3,4,9,0xb2d1928bd
2222.66,1.0,92,1,2,1,4,0xb2d51729
18040.2,1.0,10,2,2,3,7,0xb2d23101
553527.0,3.0,3,4,4,4,12,0xb2d6d41c
609.43,1.0,7,1,2,3,6,0xb2d442be
250010.78,2.0,119,3,3,1,7,0xb2d93c9c
794.73,1.0,4,1,2,4,7,0xb2d5b08c
2007.52,1.0,146,1,2,1,4,0xb2d8a1c9
1266094.0,7.0,0,4,4,4,12,0xb2d6e1f3
68035.78,3.0,10,3,4,3,10,0xb2d591f4
4501.01,2.0,5,2,3,3,8,0xb2d21669
6911.22,1.0,8,2,2,3,7,0xb2d23297
250000.0,2.0,8,3,3,3,9,0xb2da521b
102335.14,2.0,70,3,3,1,7,0xb2d6661d
7.2,1.0,14,1,2,3,6,0xb2d1f758
780139.47,4.0,7,4,4,3,11,0xb2d6c417
0.34,1.0,2,1,2,4,7,0xb2d8fe4e
21978.69,3.0,0,2,4,4,10,0x3b9b3254
201009.25,4.0,8,3,4,3,10,0xb2d50cac
336595.55,12.0,2,4,4,4,12,0xb2d26b6b
10000.32,2.0,38,2,3,2,7,0xb2d92690
4521.06,1.0,9,2,2,3,7,0xb2d3f2d7
3203.4,1.0,1,2,2,4,8,0xb2d5b4bd
2600000.27,14.0,16,4,4,2,10,0xb2d1ba48d
320000.66,2.0,1,4,3,4,11,0xb2d125c2
43212.16,2.0,193,2,3,1,6,0xb2d583a1
170013.0,3.0,32,3,4,2,9,0xb2d245e6
3.1,1.0,55,1,2,2,5,0xb2d1cffa
528757.28,8.0,0,4,4,4,12,0x3b9b1940
141708.5,4.0,20,3,4,2,9,0xb2d5e726
50010.31,3.0,136,2,4,1,7,0xb2d61698
4915587.34,5.0,5,4,4,3,11,0xb2d5498c
1318.31,2.0,92,1,3,1,5,0xb2d0e6a8
804327.61,3.0,63,4,4,2,10,0xb2d17492
306317.67,2.0,82,4,3,1,8,0xb2d6c195
3000066.68,7.0,0,4,4,4,12,0xb2d5f5e0
530646.68,3.0,118,4,4,1,9,0xb2d570a9
167540.39,3.0,0,3,4,4,11,0xb2d2afa5d
706033.68,23.0,48,4,4,2,10,0xb2d4ed3f
50001.06,2.0,18,2,3,2,7,0xb2d89f87
102337.78,1.0,12,3,2,3,8,0xb2d62464d
1500.41,1.0,10,1,2,3,6,0xb2d937d4
14026.08,1.0,17,2,2,2,6,0xb2d5d82f
23.58,1.0,8,1,2,3,6,0xb2d9c6b5
6087.75,1.0,62,2,2,2,6,0xb2d35468d
390056.03,2.0,25,4,3,2,9,0xb2d933b5
0.42,1.0,4,1,2,4,7,0xb2d9bd93
220077.61,3.0,67,3,4,1,8,0xb2d12cbe
200044.46,6.0,41,3,4,2,9,0xb2d11875
66013.19,2.0,21,3,3,2,8,0xb2d16dac
10789.24,1.0,92,2,2,1,5,0xb2d3f009d
6326.84,1.0,130,2,2,1,5,0xb2d32087
274798.33,2.0,8,3,3,3,9,0xb2d6d3c8
29442.09,1.0,2,2,2,4,8,0xb2d2f67e
950083.84,2.0,12,4,3,3,10,0xb2d69c28
576.19,1.0,10,1,2,3,6,0xb2d3d09b
668.38,1.0,19,1,2,2,5,0xb2d60a3b
302131.51,2.0,63,4,3,2,9,0xb2d9bab8
7241.36,1.0,16,2,2,2,6,0xb2d1c7be
200000.0,2.0,5,3,3,3,9,0xb2da5ad9
827.27,1.0,43,1,2,2,5,0xb2d564ae
6.35,1.0,22,1,2,2,5,0xb2d52958
19689.98,1.0,25,2,2,2,6,0xb2d6c055
827027.75,2.0,3,4,3,4,11,0xb2d15a9f
8009.8,1.0,126,2,2,1,5,0xb2d9374c
53415.12,2.0,217,3,3,1,7,0xb2d3ede3
6010.5,11.0,0,2,4,4,10,0xb2d17b30d
28951.23,1.0,11,2,2,3,7,0xb2d1f4d9
70.07,1.0,77,1,2,1,4,0xb2d605bb
230138.29,2.0,206,3,3,1,7,0xb2d59d13
57.23,1.0,14,1,2,3,6,0xb2da0047
18500.95,1.0,92,2,2,1,5,0xb2d316d4
169015.45,7.0,129,3,4,1,8,0x3b9b2f07d
217555.52,3.0,66,3,4,2,9,0xb2d15a4e
40068.04,1.0,1,2,2,4,8,0xb2d68ee5d
2012.11,1.0,44,1,2,2,5,0xb2d0a04b
100025.41,2.0,27,3,3,2,8,0xb2d5109f
276797.47,4.0,19,3,4,2,9,0xb2d2dfab
14820.94,1.0,100,2,2,1,5,0xb2d6e933
44490.96,1.0,0,2,2,4,8,0xb2d95ac1d
280000.0,5.0,3,3,4,4,11,0xb2d29116
11386.18,2.0,7,2,3,3,8,0xb2d2236e
160302.09,2.0,62,3,3,2,8,0xb2d5d185
434070.89,9.0,29,4,4,2,10,0x3b9b34f4
60001.27,2.0,200,3,3,1,7,0xb2d20582
17052.19,1.0,1,2,2,4,8,0xb2d3c1bc
289060.02,5.0,143,3,4,1,8,0xb2d18438
200710.43,2.0,41,3,3,2,8,0xb2d9efbc
1300026.0,4.0,108,4,4,1,9,0xb2d1342a
1142.13,1.0,14,1,2,3,6,0xb2d5fe16
5044.69,1.0,92,2,2,1,5,0xb2d230da
410060.56,2.0,21,4,3,2,9,0xb2d62c9a
1000000.12,5.0,2,4,4,4,12,0xb2d6a654
202132.28,2.0,116,3,3,1,7,0xb2d94d2e
30.53,1.0,0,1,2,4,7,0xb2da53d0
0.0,1.0,3,1,2,4,7,0xb2d411b8
816827.17,3.0,15,4,4,3,11,0xb2d6f770
5281.34,1.0,184,2,2,1,5,0xb2d33180
2421.45,1.0,181,1,2,1,4,0xb2d4eab1
371.3,1.0,46,1,2,2,5,0xb2d24b4d
46510.76,1.0,2,2,2,4,8,0xb2d37c14
50147.29,2.0,43,2,3,2,7,0xb2d6f71e
781.47,1.0,2,1,2,4,7,0xb2d6077c
24742.82,1.0,34,2,2,2,6,0xb2d13476
46.98,1.0,53,1,2,2,5,0xb2d3ba2a
118222.4,4.0,3,3,4,4,11,0xb2d1ad94
10000.42,1.0,14,2,2,3,7,0xb2da3791
400014.79,12.0,12,4,4,3,11,0xb2d13f39
1000010.61,3.0,3,4,4,4,12,0xb2d268bd
179029.54,1.0,59,3,2,2,7,0xb2d1658e
31.91,1.0,18,1,2,2,5,0xb2d92baf
8004.86,1.0,20,2,2,2,6,0xb2d6dd5f
1816.88,1.0,184,1,2,1,4,0xb2d30225
635003.48,4.0,5,4,4,3,11,0xb2d62b8e
10419.49,1.0,20,2,2,2,6,0xb2d593c8
9889.61,2.0,92,2,3,1,6,0xb2d0aa21
440000.0,3.0,0,4,4,4,12,0xb2d6d74e
60657.44,2.0,0,3,3,4,10,0xb2d56c8f
876.65,1.0,10,1,2,3,6,0xb2d31624
2.76,1.0,32,1,2,2,5,0xb2d3828c
6.65,1.0,10,1,2,3,6,0xb2d58dc0
130015.03,4.0,0,3,4,4,11,0xb2d64e6e
900190.21,3.0,25,4,4,2,10,0xb2d61095
30730.9,3.0,10,2,4,3,9,0xb2d0c1e3
3112.64,1.0,92,2,2,1,5,0xb2d0983f
2004.4,1.0,17,1,2,2,5,0xb2d7f11c
1743.06,1.0,4,1,2,4,7,0xb2d528fe
120009.73,2.0,8,3,3,3,9,0xb2d16c14
121916.23,1.0,0,3,2,4,9,0xb2d4a364
9134.42,1.0,0,2,2,4,8,0xb2d792d4
200000.57,2.0,166,3,3,1,7,0xb2d638b4
200002.94,2.0,10,3,3,3,9,0xb2d6fce0
4802.03,1.0,20,2,2,2,6,0xb2d580a2
15129.08,1.0,2,2,2,4,8,0xb2d45ef5
53894.79,1.0,0,3,2,4,9,0xb2d747f7
12632.98,1.0,0,2,2,4,8,0xb2d32e0e
5257.92,1.0,92,2,2,1,5,0xb2d3f58a
2585.23,1.0,0,1,2,4,7,0xb2d5948ad
1987.59,8.0,0,1,4,4,9,0xb2d45cc6d
629627.41,8.0,1,4,4,4,12,0xb2d2c92f
305934.32,2.0,53,4,3,2,9,0xb2d280c6
52129.74,1.0,1,2,2,4,8,0xb2d634af
103053.3,2.0,52,3,3,2,8,0xb2d2f641
2374.54,1.0,5,1,2,3,6,0xb2d0c1c0
3370.59,1.0,0,2,2,4,8,0xb2d59a20
10044.42,1.0,38,2,2,2,6,0xb2d94e77
210.47,1.0,92,1,2,1,4,0xb2d312f7
968.56,1.0,21,1,2,2,5,0xb2d26ca4
302188.87,9.0,26,4,4,2,10,0xb2d5dd25
9.5,1.0,49,1,2,2,5,0xb2d8c3ac
10.73,1.0,53,1,2,2,5,0xb2d9ce6e
2048.72,1.0,0,1,2,4,7,0xb2d694d0
6.65,1.0,21,1,2,2,5,0xb2da0dd9
71388.6,3.0,18,3,4,2,9,0xb2d0d9bfd
1401.4,1.0,10,1,2,3,6,0xb2d68bfb
189613.9,4.0,58,3,4,2,9,0xb2d54b40
160696.95,2.0,41,3,3,2,8,0xb2d2eac7d
830210.05,2.0,139,4,3,1,8,0xb2d6be01
3435.96,1.0,1,2,2,4,8,0xb2d6f8e0
1118000.0,12.0,6,4,4,3,11,0xb2d10718
120010.89,3.0,95,3,4,1,8,0xb2d07fd1
8251.37,1.0,28,2,2,2,6,0xb2d9112a
83.28,1.0,27,1,2,2,5,0xb2d78038
1846.12,1.0,0,1,2,4,7,0xb2d96410
1506.0,2.0,133,1,3,1,5,0xb2d67edd
30075.52,3.0,12,2,4,3,9,0xb2d5e554
0.2,1.0,5,1,2,3,6,0xb2d37c6ed
200813.74,2.0,44,3,3,2,8,0xb2d910cb
11.07,1.0,67,1,2,1,4,0xb2d98f6e
2292.07,1.0,2,1,2,4,7,0xb2d6b5df
20.11,1.0,15,1,2,3,6,0xb2d6315f
1496.75,3.0,0,1,4,4,9,0xb2d374aad
696099.16,4.0,83,4,4,1,9,0xb2d1f8ef
5748.01,1.0,10,2,2,3,7,0xb2d9581a
201.24,1.0,12,1,2,3,6,0xb2d6a8ee
5935729.82,7.0,4,4,4,4,12,0xb2d3a479
2000.84,1.0,0,1,2,4,7,0xb2d6fe1c
453197.46,2.0,73,4,3,1,8,0xb2d99786
714490.85,1.0,15,4,2,3,9,0xb2d40388
30000.32,2.0,108,2,3,1,6,0xb2d5ba07
1905700.26,4.0,0,4,4,4,12,0xb2d07877
140546.16,4.0,13,3,4,3,10,0xb2d5b160
200000.0,2.0,101,3,3,1,7,0xb2d1297a
1366.78,1.0,1,1,2,4,7,0xb2d80491
50133.05,2.0,15,2,3,3,8,0xb2d146c5
9003.86,51.0,1,2,4,4,10,0xb2d90383d
35285.93,1.0,162,2,2,1,5,0xb2d2b5c9
1193.42,1.0,201,1,2,1,4,0xb2d696c1
7292.38,3.0,8,2,4,3,9,0x3b9b288c
681.13,1.0,10,1,2,3,6,0xb2d8ff05
213048.9,2.0,56,3,3,2,8,0xb2d0a976
348.9,1.0,92,1,2,1,4,0xb2d4eadb
10099.26,2.0,180,2,3,1,6,0xb2d5dc52
262742.61,2.0,0,3,3,4,10,0xb2d3aa1e
500052.19,2.0,19,4,3,2,9,0xb2d8d2a1
240563.27,11.0,80,3,4,1,8,0xb2d22a94
400000.0,3.0,4,4,4,4,12,0xb2da2e77
3604.98,1.0,0,2,2,4,8,0xb2d41f92
19977.8,4.0,180,2,4,1,7,0xb2d64bccd
50237.85,2.0,206,2,3,1,6,0xb2d5a7c9
234012.81,2.0,78,3,3,1,7,0xb2d3a25f
300057.92,3.0,0,3,4,4,11,0xb2d67ed3d
723220.24,5.0,53,4,4,2,10,0xb2d10e14
5104.05,1.0,1,2,2,4,8,0xb2d15c9c
1780075.18,2.0,98,4,3,1,8,0xb2d96b4d
303357.91,2.0,11,4,3,3,10,0xb2d952f5
500016.29,3.0,25,4,4,2,10,0xb2d5beb5
83.76,1.0,8,1,2,3,6,0xb2d214d9
17316.0,1.0,0,2,2,4,8,0xb2d2ead8
80262.92,1.0,92,3,2,1,6,0xb2d0916a
700013.27,4.0,24,4,4,2,10,0xb2d24fce
134.94,1.0,70,1,2,1,4,0xb2d8a498d
71072.17,3.0,181,3,4,1,8,0xb2d58efb
133320.49,5.0,0,3,4,4,11,0x3b9b17ea
400017.43,4.0,13,4,4,3,11,0xb2d94a62
27.72,1.0,11,1,2,3,6,0xb2d301e0
1011207.07,2.0,3,4,3,4,11,0xb2d7bdd9d
310211.19,2.0,57,4,3,2,9,0xb2d1792b
250013.49,2.0,0,3,3,4,10,0xb2d0b5ab
840.3,1.0,4,1,2,4,7,0xb2d69035
1339071.97,4.0,90,4,4,1,9,0xb2d4d993
213278.78,2.0,31,3,3,2,8,0xb2d2e122
527.29,1.0,4,1,2,4,7,0xb2d5548dd
2106.46,1.0,5,1,2,3,6,0xb2d3609a
1376341.34,2.0,136,4,3,1,8,0xb2d263ced
465345.34,9.0,9,4,4,3,11,0xb2d5b015
28.79,1.0,208,1,2,1,4,0xb2d68bb9
180007.6,2.0,27,3,3,2,8,0xb2d93ea0d
1901.0,1.0,119,1,2,1,4,0xb2d6f209
4181.95,1.0,0,2,2,4,8,0xb2d2cf90
42056.31,1.0,5,2,2,3,7,0xb2d2a92b
1814.44,1.0,26,1,2,2,5,0xb2d61de4
3695.63,1.0,9,2,2,3,7,0xb2d269b4
10000.11,2.0,83,2,3,1,6,0xb2d98586
200812.06,2.0,43,3,3,2,8,0xb2d9d6ec
2258.03,1.0,1,1,2,4,7,0xb2d176eb
15.05,1.0,67,1,2,1,4,0xb2d9997b
2961.64,1.0,49,2,2,2,6,0xb2d57524
212133.43,7.0,7,3,4,3,10,0xb2d166f1
727020.63,11.0,0,4,4,4,12,0xb2d0897f
1141973.82,11.0,59,4,4,2,10,0xb2d103ad
721.27,2.0,0,1,3,4,8,0xb2d0d766
7894.41,1.0,29,2,2,2,6,0xb2d92697
1499.29,3.0,0,1,4,4,9,0x3b9b3536
441.53,1.0,25,1,2,2,5,0xb2d68952
760002.75,8.0,31,4,4,2,10,0xb2d5b10b
50011.79,2.0,59,2,3,2,7,0xb2d648d7
651000.0,10.0,3,4,4,4,12,0xb2d2605b
1.54,1.0,85,1,2,1,4,0xb2d87a45
142865.9,4.0,1,3,4,4,11,0xb2d246c4
2615.88,1.0,74,1,2,1,4,0xb2d2881cd
4057.64,2.0,62,2,3,2,7,0x3b9b36a0
0.0,1.0,0,1,2,4,7,0xb2d57efad
3387.7,1.0,0,2,2,4,8,0xb2d443be
7362.79,6.0,160,2,4,1,7,0xb2d20ac6
5417.53,1.0,1,2,2,4,8,0xb2d83b2f
388205.1,6.0,11,4,4,3,11,0xb2d32f16
600031.4,3.0,49,4,4,2,10,0xb2d3e426
340051.86,2.0,48,4,3,2,9,0xb2d22578
700000.33,4.0,5,4,4,3,11,0xb2d90b77
380007.71,3.0,5,4,4,3,11,0xb2d92725
3229.5,1.0,13,2,2,3,7,0xb2d5e419
120007.22,2.0,168,3,3,1,7,0xb2d30563
4879.52,9.0,184,2,4,1,7,0xb2d22f26
639019.74,5.0,77,4,4,1,9,0xb2d1bef3
188.97,1.0,123,1,2,1,4,0xb2d6f7ab
1.93,1.0,24,1,2,2,5,0xb2d651c2
315722.56,2.0,6,4,3,3,10,0xb2d41957
270026.59,8.0,38,3,4,2,9,0xb2d3acd8
394.31,1.0,10,1,2,3,6,0xb2d75f9f
169.72,1.0,0,1,2,4,7,0xb2d3b363
30000.0,2.0,8,2,3,3,8,0xb2d5f357d
22772.35,1.0,6,2,2,3,7,0xb2d6b2a8
122305.62,2.0,245,3,3,1,7,0xb2d15831
602.88,1.0,0,1,2,4,7,0xb2d33805
10010.08,2.0,27,2,3,2,7,0xb2d775d3
500122.45,6.0,0,4,4,4,12,0xb2d25a12
230100.75,2.0,3,3,3,4,10,0xb2d96e80
222026.34,8.0,0,3,4,4,11,0xb2d4e17ed
328901.68,2.0,139,4,3,1,8,0xb2d2882b
2945431.69,86.0,0,4,4,4,12,0xb2d4a6e0
132713.2,2.0,70,3,3,1,7,0xb2d3a1e3
525.01,1.0,4,1,2,4,7,0xb2d3992c
1525.33,1.0,184,1,2,1,4,0xb2d14692
200005.73,2.0,10,3,3,3,9,0xb2d5c1cb
70005.89,2.0,17,3,3,2,8,0xb2d1f2b9
7774.54,1.0,0,2,2,4,8,0xb2d6ad3a
139.06,1.0,13,1,2,3,6,0xb2da377a
6013.29,1.0,118,2,2,1,5,0xb2d5c89e
500000.0,3.0,1,4,4,4,12,0xb2d62b0f
12351.94,2.0,2,2,3,4,9,0xb2d38fb4d
20136.42,1.0,3,2,2,4,8,0xb2d26ca0
150060.95,2.0,95,3,3,1,7,0xb2d64da6
568000.8,3.0,10,4,4,3,11,0xb2d96302
11122.43,1.0,47,2,2,2,6,0xb2d57ab3
3500.86,1.0,0,2,2,4,8,0xb2da115d
400031.09,4.0,83,4,4,1,9,0xb2d0bb8ad
1051.12,1.0,0,1,2,4,7,0xb2d210ff
5120.47,1.0,92,2,2,1,5,0xb2d4c811
4614.72,1.0,15,2,2,3,7,0xb2d8100e
6.33,1.0,20,1,2,2,5,0xb2d9497dd
36.74,1.0,71,1,2,1,4,0xb2d558e5
60002.0,3.0,90,3,4,1,8,0xb2d6e6f4d
1302037.3,15.0,28,4,4,2,10,0xb2d24f08
740163.61,6.0,27,4,4,2,10,0xb2d437ee
25.38,1.0,10,1,2,3,6,0xb2d3c15f
800005.69,2.0,7,4,3,3,10,0xb2d716a4
1367.72,1.0,23,1,2,2,5,0xb2d3007b
20310.66,1.0,24,2,2,2,6,0xb2d3ab48
895002.61,8.0,1,4,4,4,12,0xb2d31674
3.47,1.0,18,1,2,2,5,0xb2d7009d
144267.98,1.0,20,3,2,2,7,0xb2d59163
1680.64,1.0,184,1,2,1,4,0xb2d24a0ed
25000.26,2.0,18,2,3,2,7,0xb2d958aa
60005.95,2.0,69,3,3,1,7,0xb2d34926d
298270.67,9.0,4,3,4,4,11,0x3b9af261
402039.37,1.0,14,4,2,3,9,0xb2d59a3c
37290.99,1.0,10,2,2,3,7,0xb2d47151
1007.37,1.0,184,1,2,1,4,0xb2d3fb4f
200008.46,2.0,250,3,3,1,7,0xb2d6835e
400000.0,2.0,4,4,3,4,11,0xb2da09e0
6646.89,1.0,8,2,2,3,7,0xb2d9c71d
12960.0,1.0,3,2,2,4,8,0xb2d64e28
0.01,1.0,28,1,2,2,5,0xb2d27fc4
521556.87,4.0,62,4,4,2,10,0xb2d0ab02
114298.89,2.0,24,3,3,2,8,0xb2d28a3b
3133.54,1.0,184,2,2,1,5,0xb2d07e04
2622.65,1.0,10,1,2,3,6,0xb2d24ea9
800041.59,2.0,48,4,3,2,9,0xb2d90e77
15045.09,2.0,4,2,3,4,9,0xb2d9830e
106527.9,2.0,74,3,3,1,7,0xb2d26501
200365.19,2.0,8,3,3,3,9,0xb2d78b5f
53.94,1.0,5,1,2,3,6,0xb2d93175
69268.28,1.0,184,3,2,1,6,0xb2d1acaad
1271.59,1.0,305,1,2,1,4,0xb2d60563
201115.45,4.0,11,3,4,3,10,0xb2d55dfbd
2887.61,1.0,1,2,2,4,8,0xb2d57bafd
494.99,1.0,13,1,2,3,6,0xb2d63a4d
163.93,1.0,11,1,2,3,6,0xb2d985f7
201006.06,3.0,0,3,4,4,11,0xb2d561b6
117001.35,4.0,3,3,4,4,11,0xb2d91ecf
356324.94,8.0,18,4,4,2,10,0xb2d3a4bd
1453.39,1.0,97,1,2,1,4,0xb2d64e71
100435.33,2.0,26,3,3,2,8,0xb2d11eaed
105332.91,1.0,184,3,2,1,6,0xb2d167d6
2380.05,1.0,95,1,2,1,4,0xb2d12611
466.09,1.0,52,1,2,2,5,0xb2d5826e
4169.94,6.0,18,2,4,2,8,0xb2d21672
7122.41,1.0,2,2,2,4,8,0xb2d0ca9f
459002.56,14.0,0,4,4,4,12,0xb2d5f6dd
6627.43,1.0,10,2,2,3,7,0xb2d50f6c
751169.45,2.0,32,4,3,2,9,0xb2d92fcfd
833.19,1.0,11,1,2,3,6,0xb2d1cede
31099.47,2.0,216,2,3,1,6,0xb2d41888
501078.45,3.0,23,4,4,2,10,0xb2d90cc4
101880.0,2.0,3,3,3,4,10,0xb2d3d05d
650060.98,3.0,41,4,4,2,10,0xb2d24e64
60013.83,3.0,94,3,4,1,8,0xb2d68b40
5100.0,1.0,0,2,2,4,8,0xb2d967a6
130098.9,2.0,119,3,3,1,7,0xb2d10652
606620.28,3.0,0,4,4,4,12,0xb2d17a8a
1.62,3.0,20,1,4,2,7,0xb2d0acfd
211186.35,1.0,33,3,2,2,7,0xb2d33989
906.07,1.0,6,1,2,3,6,0xb2d2f26a
12344.44,1.0,49,2,2,2,6,0xb2d37c3c
500714.65,5.0,27,4,4,2,10,0xb2d93778
5022.31,1.0,184,2,2,1,5,0xb2d5c1d6d
20088.09,3.0,36,2,4,2,8,0xb2d58e46
612520.8,2.0,0,4,3,4,11,0xb2d5ae5a
4303664.18,1.0,0,4,2,4,10,0xb2d37865d
5190.57,5.0,0,2,4,4,10,0x3b9b2b3a
1136.93,2.0,168,1,3,1,5,0xb2d43959
1359.07,10.0,0,1,4,4,9,0x3b9b258fd
0.42,1.0,3,1,2,4,7,0xb2d5a825
996438.17,1.0,184,4,2,1,7,0xb2d2a0e9
1008.21,1.0,92,1,2,1,4,0xb2d2901bd
1000.52,1.0,7,1,2,3,6,0xb2d6fafb
300272.53,2.0,10,4,3,3,10,0xb2d98b30
3794.48,1.0,184,2,2,1,5,0xb2d10638
1951.5,1.0,92,1,2,1,4,0xb2d282a5
2045.69,1.0,38,1,2,2,5,0xb2d68716
640054.86,6.0,31,4,4,2,10,0xb2d2be57
1616.72,1.0,9,1,2,3,6,0xb2d26261
33144.76,1.0,32,2,2,2,6,0xb2d43a3d
917219.82,20.0,1,4,4,4,12,0xb2d07e70
100021.64,3.0,185,3,4,1,8,0xb2d43a8a
580006.47,2.0,0,4,3,4,11,0xb2d18a8a
1.27,2.0,110,1,3,1,5,0xb2d07d02
200002.1,2.0,12,3,3,3,9,0xb2d8e6cf
19252.02,1.0,27,2,2,2,6,0xb2d9037a
11105.61,2.0,122,2,3,1,6,0xb2d5fd1f
10.1,1.0,22,1,2,2,5,0xb2d9021d
549.93,1.0,25,1,2,2,5,0xb2d6dfe0
106582.46,1.0,27,3,2,2,7,0xb2d188a2
12.83,1.0,22,1,2,2,5,0xb2d220b9
39.71,1.0,55,1,2,2,5,0xb2d83b56
790000.0,9.0,0,4,4,4,12,0xb2d54ac5
265008.33,9.0,0,3,4,4,11,0xb2d8ed52
11363.52,2.0,1,2,3,4,9,0xb2d52e42
509263.95,9.0,13,4,4,3,11,0x3b9ae41a
160.44,1.0,8,1,2,3,6,0xb2d526d2
6827.32,1.0,6,2,2,3,7,0xb2d424b6
141357.58,3.0,18,3,4,2,9,0xb2d10d01
15001.05,2.0,7,2,3,3,8,0xb2d16002
10000.86,2.0,266,2,3,1,6,0xb2d5f11d
26291.34,1.0,2,2,2,4,8,0xb2d47912
500000.0,3.0,4,4,4,4,12,0xb2da5ba8
12283.74,1.0,0,2,2,4,8,0xb2d32c0cd
0.0,1.0,2,1,2,4,7,0xb2d68a00
22747.04,2.0,27,2,3,2,7,0xb2d15a4d
1060002.56,5.0,5,4,4,3,11,0xb2d7edd3
122919.37,2.0,14,3,3,3,9,0xb2d2548e
501776.04,2.0,36,4,3,2,9,0xb2d9fb19
263838.53,1.0,200,3,2,1,6,0x3b9b347a
62421.78,2.0,56,3,3,2,8,0xb2d5f1c4
172.33,1.0,0,1,2,4,7,0xb2d42c89
46392.81,1.0,92,2,2,1,5,0xb2d0ee4b
51640.11,1.0,0,2,2,4,8,0xb2d5aabb
1392.68,1.0,184,1,2,1,4,0xb2d272ec
3436.69,1.0,19,2,2,2,6,0xb2d236f3d
828200.73,2.0,18,4,3,2,9,0xb2d95991
550796.99,3.0,26,4,4,2,10,0xb2d69eb1
76888.78,1.0,43,3,2,2,7,0xb2d59ec4
2.14,1.0,15,1,2,3,6,0xb2d12911
400074.75,4.0,8,4,4,3,11,0xb2d17339
25012.72,2.0,45,2,3,2,7,0xb2d5e471
55.37,1.0,38,1,2,2,5,0xb2d3e454
55851.72,2.0,199,3,3,1,7,0xb2d0e2ae
266947.12,2.0,98,3,3,1,7,0xb2d5fea3
1010097.53,7.0,14,4,4,3,11,0xb2d504f6
6140.67,1.0,23,2,2,2,6,0xb2d366a3
1454.35,1.0,3,1,2,4,7,0xb2d1c72b
15751.96,1.0,0,2,2,4,8,0xb2d59a23
30000.0,2.0,6,2,3,3,8,0xb2d97028
1151900.95,4.0,6,4,4,3,11,0xb2d17342
237104.34,3.0,49,3,4,2,9,0xb2d6b9f6
60001.27,2.0,80,3,3,1,7,0xb2d8d4e8
118363.03,5.0,2,3,4,4,11,0x3b9af2c5d
706088.04,2.0,14,4,3,3,10,0xb2d51a08
9351.87,1.0,15,2,2,3,7,0xb2d6a06a
300001.07,4.0,14,3,4,3,10,0xb2d7f1ac
562.58,1.0,18,1,2,2,5,0xb2d22853
93000.98,3.0,42,3,4,2,9,0xb2d8d1c6
0.0,2.0,0,1,3,4,8,0xb2da4b81
10023.85,1.0,266,2,2,1,5,0xb2d50311d
110000.52,2.0,0,3,3,4,10,0xb2d470c2
5539.84,1.0,29,2,2,2,6,0xb2d91f5e
390056.7,9.0,0,4,4,4,12,0xb2d07114
422.99,1.0,25,1,2,2,5,0xb2d3ff47
70023.22,2.0,167,3,3,1,7,0xb2d1e2b9
500000.0,2.0,18,4,3,2,9,0xb2da3652
1500053.21,9.0,14,4,4,3,11,0xb2d15283
1126.08,1.0,7,1,2,3,6,0xb2d6f01c
500033.64,2.0,0,4,3,4,11,0xb2d0ee32
454212.94,4.0,10,4,4,3,11,0xb2d0cba8
1836.63,1.0,0,1,2,4,7,0xb2d919d7
333906.07,2.0,87,4,3,1,8,0xb2d323e8d
2027.5,1.0,1,1,2,4,7,0xb2d58a28
1503296.45,6.0,0,4,4,4,12,0xb2d280b3
7262.45,1.0,92,2,2,1,5,0xb2d5bf23
495975.82,17.0,3,4,4,4,12,0xb2d1342c
1.82,1.0,20,1,2,2,5,0xb2d3d2e8
200000.0,2.0,4,3,3,4,10,0xb2d97a79
8081.37,1.0,184,2,2,1,5,0xb2d2a883
12257.96,1.0,2,2,2,4,8,0xb2d8cb01
520751.39,2.0,32,4,3,2,9,0xb2d58ef9
15.84,1.0,50,1,2,2,5,0xb2d8ff6f
206439.71,2.0,11,3,3,3,9,0xb2d8e672
181018.91,5.0,76,3,4,1,8,0xb2d35e67d
200000.0,1.0,0,3,2,4,9,0xb2da6a86
310639.96,2.0,6,4,3,3,10,0xb2d1bed0
30003.08,2.0,42,2,3,2,7,0xb2d26dec
10000.34,2.0,101,2,3,1,6,0xb2d56771
209555.75,2.0,39,3,3,2,8,0x3b9b3eac
2007.8,1.0,184,1,2,1,4,0xb2d61b93
4402.79,1.0,272,2,2,1,5,0xb2d2b0f0
148.29,1.0,22,1,2,2,5,0xb2d27400
1.67,1.0,67,1,2,1,4,0xb2d0a40d
600032.22,3.0,4,4,4,4,12,0xb2d93216d
30115.9,1.0,4,2,2,4,8,0xb2d62206d
5106.3,1.0,80,2,2,1,5,0xb2d69db4
1137.74,1.0,12,1,2,3,6,0xb2d3e4a5
714.66,1.0,0,1,2,4,7,0xb2d6bb8b
101.74,1.0,43,1,2,2,5,0xb2d411fb
808115.0,4.0,32,4,4,2,10,0xb2d6f612d
300000.0,5.0,0,3,4,4,11,0xb2d6ec37
3981.83,1.0,11,2,2,3,7,0xb2d4352c
303602.1,2.0,27,4,3,2,9,0xb2d22d35
68283.99,1.0,2,3,2,4,9,0xb2d28055
51775.82,3.0,59,2,4,2,8,0x3b9b2cb5
59075.63,2.0,0,3,3,4,10,0xb2d21119
25316.99,1.0,3,2,2,4,8,0xb2d32b39
110056.61,3.0,23,3,4,2,9,0xb2d0e608
7300.02,2.0,25,2,3,2,7,0xb2d93da4
491240.02,7.0,10,4,4,3,11,0xb2d3a190
276596.31,1.0,0,3,2,4,9,0xb2d344fa
700723.15,4.0,21,4,4,2,10,0xb2d9debb
378613.37,6.0,25,4,4,2,10,0xb2d99602
2355.53,1.0,16,1,2,2,5,0xb2d2c5cbd
873.23,1.0,0,1,2,4,7,0xb2d571cdd
102461.63,2.0,67,3,3,1,7,0xb2d43736
1001.17,1.0,121,1,2,1,4,0xb2d919a1
150000.11,2.0,69,3,3,1,7,0xb2d5f4aa
500000.0,2.0,22,4,3,2,9,0xb2d9504c
20000.0,2.0,6,2,3,3,8,0xb2d2f4ea
51155.16,1.0,0,2,2,4,8,0xb2d59804
225001.22,7.0,25,3,4,2,9,0xb2d502a8
1014.28,2.0,29,1,3,2,6,0xb2d6cd79
19930.78,1.0,0,2,2,4,8,0xb2d6b56c
8708.52,1.0,92,2,2,1,5,0xb2d2a8d6d
73.37,1.0,9,1,2,3,6,0xb2d94dc5
252307.53,144.0,0,3,4,4,11,0xb2d19faf
121717.27,1.0,7,3,2,3,8,0xb2d6a5ab
31261.62,2.0,4,2,3,4,9,0xb2d5fbef
956635.29,7.0,11,4,4,3,11,0xb2d3679e
110000.0,4.0,1,3,4,4,11,0xb2d17543
0.48,2.0,26,1,3,2,6,0xb2d97828
571277.35,3.0,3,4,4,4,12,0xb2d58b5e
905.68,1.0,3,1,2,4,7,0xb2d680b9
163164.82,7.0,0,3,4,4,11,0xb2d57285
1034.33,1.0,16,1,2,2,5,0xb2d39b25
180003.8,2.0,39,3,3,2,8,0xb2d1b26a
2.76,1.0,45,1,2,2,5,0xb2d52d95
13963.91,1.0,4,2,2,4,8,0xb2d1d69d
465288.99,2.0,49,4,3,2,9,0xb2d6d0c4
8607.02,2.0,92,2,3,1,6,0xb2d30df2
50000.53,2.0,147,2,3,1,6,0xb2d6e1fb
2017390.87,3.0,26,4,4,2,10,0xb2d65452
30012.4,2.0,110,2,3,1,6,0xb2d60cc4
27060.22,1.0,14,2,2,3,7,0xb2d9357f
273539.08,5.0,4,3,4,4,11,0xb2d5f85b
24407.76,1.0,12,2,2,3,7,0xb2d94218
31001.63,2.0,95,2,3,1,6,0xb2d35b3f
32639.35,1.0,1,2,2,4,8,0xb2d55f39
3008.05,1.0,0,2,2,4,8,0xb2d6c199
122409.9,1.0,294,3,2,1,6,0xb2d5d26a
556636.78,8.0,11,4,4,3,11,0xb2d0ad6e
13.37,1.0,4,1,2,4,7,0xb2d15be6
4.3,1.0,11,1,2,3,6,0xb2d815a8
770104.49,4.0,8,4,4,3,11,0xb2d38a68d
114193.67,3.0,4,3,4,4,11,0xb2d0dc24
541.96,1.0,55,1,2,2,5,0xb2d5d0b6
250004.65,8.0,3,3,4,4,11,0xb2d634a8
1932.77,1.0,14,1,2,3,6,0xb2d8cfcc
6428.66,1.0,184,2,2,1,5,0xb2d14df8
15296.11,1.0,67,2,2,1,5,0xb2d684cc
2.02,1.0,17,1,2,2,5,0xb2d2dba9
412037.16,5.0,4,4,4,4,12,0xb2d1b164
507759.4,3.0,80,4,4,1,9,0xb2d57885
206145.26,2.0,113,3,3,1,7,0xb2d67cc8
20115.79,2.0,27,2,3,2,7,0xb2d92f7e
51955.52,1.0,0,2,2,4,8,0xb2d64778d
80047.87,3.0,94,3,4,1,8,0xb2d50f51d
56.66,1.0,48,1,2,2,5,0xb2d60a95
90007.95,3.0,18,3,4,2,9,0xb2d6be8d
169582.63,1.0,184,3,2,1,6,0x3b9b488b
29625.93,3.0,3,2,4,4,10,0xb2d60ce5
426.13,1.0,8,1,2,3,6,0xb2d21976
204276.59,2.0,203,3,3,1,7,0xb2d6836fd
1963234.76,7.0,32,4,4,2,10,0xb2d1c784d
218436.47,2.0,21,3,3,2,8,0xb2d593be
301123.55,2.0,20,4,3,2,9,0xb2d70522
1500049.32,2.0,5,4,3,3,10,0xb2d9fcd3
0.0,1.0,10,1,2,3,6,0xb2d8efcb
438031.61,6.0,13,4,4,3,11,0xb2d469cc
920068.61,3.0,11,4,4,3,11,0xb2d9899f
0.85,1.0,43,1,2,2,5,0xb2d64cea
250305.02,1.0,19,3,2,2,7,0xb2d45bd4
1009567.04,4.0,28,4,4,2,10,0xb2d6247d
4062535.81,1.0,0,4,2,4,10,0xb2d6264d
4.21,1.0,4,1,2,4,7,0xb2d4061b
3.3,1.0,9,1,2,3,6,0xb2d92100
13000.0,1.0,3,2,2,4,8,0xb2d96f2d
456277.8,5.0,9,4,4,3,11,0xb2d3177d
629.97,1.0,6,1,2,3,6,0xb2d31162
202905.98,3.0,0,3,4,4,11,0xb2d11fd1
303935.46,1.0,0,4,2,4,10,0xb2d445fe
15530.91,1.0,4,2,2,4,8,0xb2d68920
616274.05,7.0,11,4,4,3,11,0xb2d1e899
192.19,1.0,10,1,2,3,6,0xb2d2e364d
520001.27,3.0,1,4,4,4,12,0xb2d8f79c
1100018.52,8.0,6,4,4,3,11,0xb2d1011e
2559.56,1.0,10,1,2,3,6,0xb2d78b0c
1020.44,1.0,10,1,2,3,6,0xb2d71724
81387.69,3.0,0,3,4,4,11,0x3b9b4592
46.28,1.0,15,1,2,3,6,0xb2d6234d
350000.0,2.0,9,4,3,3,10,0xb2d5890f
78258.87,1.0,14,3,2,3,8,0xb2d319a7
8143.68,1.0,200,2,2,1,5,0xb2d40e6d
51514.56,1.0,216,2,2,1,5,0xb2d3f5f0
5271.14,2.0,10,2,3,3,8,0xb2d2d0f2
1002.83,1.0,278,1,2,1,4,0xb2d6af53
8954.3,1.0,5,2,2,3,7,0xb2d624d6
550000.0,2.0,21,4,3,2,9,0xb2da260f
7654.06,1.0,5,2,2,3,7,0xb2d39582
216132.1,2.0,0,3,3,4,10,0xb2d1a548d
2906770.45,7.0,3,4,4,4,12,0xb2d60eafd
50001.06,2.0,74,2,3,1,6,0xb2d99d83
41673.41,1.0,8,2,2,3,7,0xb2d93f4d
1500130.39,3.0,28,4,4,2,10,0xb2d981e8
6.35,1.0,80,1,2,1,4,0xb2d37bd3
22.08,1.0,22,1,2,2,5,0xb2d0cf48
185354.89,7.0,0,3,4,4,11,0x3b9b18ef
100002.11,2.0,53,3,3,2,8,0xb2d65815
1600000.0,25.0,0,4,4,4,12,0xb2d0d1c6
615054.49,4.0,17,4,4,2,10,0xb2d0842f
478667.22,4.0,10,4,4,3,11,0xb2d2d75dd
72024.91,3.0,18,3,4,2,9,0xb2d4f32e
100002.65,2.0,221,3,3,1,7,0xb2d395f3
218994.8,1.0,91,3,2,1,6,0xb2d2e312
111650.25,1.0,3,3,2,4,9,0xb2d41562
510716.45,4.0,6,4,4,3,11,0xb2d5c545d
500000.0,2.0,8,4,3,3,10,0xb2da52b5
3.99,1.0,54,1,2,2,5,0xb2d16abc
3070.4,1.0,9,2,2,3,7,0xb2d6fdf9
5455.62,1.0,40,2,2,2,6,0xb2d5d3e9
3354142.01,28.0,3,4,4,4,12,0xb2d29c55
3.5,1.0,33,1,2,2,5,0xb2d3b479
330003.68,4.0,6,4,4,3,11,0xb2d71a60
459431.48,4.0,12,4,4,3,11,0xb2d185b4
230676.96,2.0,4,3,3,4,10,0xb2d6fcd5d
496003.98,10.0,38,4,4,2,10,0xb2d1baaf
29863.32,1.0,11,2,2,3,7,0xb2d2ebcc
528.39,1.0,7,1,2,3,6,0xb2d6979e
808098.93,9.0,83,4,4,1,9,0xb2d242d7
211929.97,6.0,48,3,4,2,9,0xb2d50146
410711.33,4.0,14,4,4,3,11,0xb2d5f5fe
5541.95,1.0,22,2,2,2,6,0xb2d8e21f
5618.3,1.0,287,2,2,1,5,0xb2d57de9
22132.62,1.0,0,2,2,4,8,0xb2d61ba5
126000.0,2.0,0,3,3,4,10,0xb2d20269d
2.66,1.0,16,1,2,2,5,0xb2d13cc9
510674.97,2.0,9,4,3,3,10,0xb2d0cde4d
9.83,1.0,0,1,2,4,7,0xb2d6af57
7635.57,1.0,0,2,2,4,8,0xb2d60a40
502247.2,4.0,29,4,4,2,10,0xb2d42e0e
99.7,1.0,89,1,2,1,4,0xb2d16821
33551.12,1.0,184,2,2,1,5,0x3b9b195c
1007.03,1.0,92,1,2,1,4,0xb2d4ec3c
81.05,1.0,21,1,2,2,5,0xb2d0d14c
2474.01,1.0,2,1,2,4,7,0xb2d6e268
200016.75,2.0,113,3,3,1,7,0xb2d35732
292077.47,5.0,95,3,4,1,8,0xb2d6123b
146444.07,1.0,150,3,2,1,6,0xb2d23a6e
0.0,1.0,3,1,2,4,7,0xb2d9d56d
5036.48,1.0,184,2,2,1,5,0xb2d3a965
900057.66,4.0,108,4,4,1,9,0xb2d126f5
7.16,1.0,12,1,2,3,6,0xb2d94a8f
101149.92,2.0,39,3,3,2,8,0xb2d91d94
10860.93,3.0,4,2,4,4,10,0xb2d394ae
20869.85,1.0,0,2,2,4,8,0xb2d5b60d
420139.87,5.0,0,4,4,4,12,0xb2d10db1
0.42,1.0,8,1,2,3,6,0xb2d95807
200710.48,2.0,18,3,3,2,8,0xb2d916e0
222323.15,4.0,1,3,4,4,11,0xb2d6019c
100000.0,1.0,0,3,2,4,9,0xb2d9846a
263000.0,2.0,0,3,3,4,10,0xb2d35bb5
350443.6,4.0,18,4,4,2,10,0xb2d0ab02d
512.53,1.0,26,1,2,2,5,0xb2d6a781
996.0,1.0,1,1,2,4,7,0xb2d28a04
55.21,1.0,36,1,2,2,5,0xb2d22b45
128117.24,5.0,0,3,4,4,11,0xb2d6b375
206402.68,2.0,295,3,3,1,7,0xb2d5b189
72486.52,1.0,7,3,2,3,8,0xb2d6286e
593976.5,6.0,0,4,4,4,12,0xb2d27740
300003.17,2.0,21,3,3,2,8,0xb2da21d0
212238.45,2.0,96,3,3,1,7,0xb2d97b61
0.11,1.0,184,1,2,1,4,0xb2d0ef72
4213.33,2.0,184,2,3,1,6,0x3b9b324c
9515.13,1.0,5,2,2,3,7,0xb2d1d682
1614.09,1.0,2,1,2,4,7,0xb2d2e0dc
292502.91,5.0,60,3,4,2,9,0xb2d180b4d
29545.21,1.0,2,2,2,4,8,0xb2d1bf6a
69.24,1.0,26,1,2,2,5,0xb2d330a0
320231.79,3.0,19,4,4,2,10,0xb2d99332
261.06,1.0,4,1,2,4,7,0xb2d6b261
13190.95,1.0,9,2,2,3,7,0xb2d39113
2508.48,1.0,92,1,2,1,4,0xb2d28dbd
504009.45,6.0,0,4,4,4,12,0xb2d5bc2a
65.45,1.0,63,1,2,2,5,0xb2d445e3
3067.4,1.0,0,2,2,4,8,0xb2d6b2be
100040.01,2.0,14,3,3,3,9,0xb2d63b5ed
30448.45,2.0,129,2,3,1,6,0x3b9b2f4c
201760.69,5.0,4,3,4,4,11,0xb2d257cd
3391.13,1.0,0,2,2,4,8,0xb2d364ec
14607677.78,2.0,1,4,3,4,11,0xb2d9f553
124.77,1.0,25,1,2,2,5,0xb2d388e3
258016.52,2.0,0,3,3,4,10,0xb2d58695
50000.53,2.0,32,2,3,2,7,0xb2da035b
109467.94,1.0,63,3,2,2,7,0xb2d256d9
10096.26,1.0,184,2,2,1,5,0xb2d2f225
120011.38,2.0,74,3,3,1,7,0xb2d54825
51178.68,2.0,31,2,3,2,7,0xb2d68372
9163.79,1.0,29,2,2,2,6,0xb2d93906
460001.93,3.0,6,4,4,3,11,0xb2d6d0c1
91862.73,1.0,0,3,2,4,9,0xb2d3155c
950019.21,5.0,7,4,4,3,11,0xb2d64c3e
51395.22,3.0,0,2,4,4,10,0xb2d230d9
741.47,1.0,0,1,2,4,7,0xb2d28e62
203554.26,2.0,129,3,3,1,7,0xb2d8eb39d
51292.83,1.0,82,2,2,1,5,0xb2d586e8
50098.31,2.0,154,2,3,1,6,0xb2d1a43ed
100010.07,2.0,11,3,3,3,9,0xb2d4096d
4.49,1.0,0,1,2,4,7,0xb2d13289
100010.11,3.0,21,3,4,2,9,0xb2d109c0
133512.81,2.0,0,3,3,4,10,0xb2d34d50
6939.07,1.0,128,2,2,1,5,0xb2d33f3a
884301.67,7.0,0,4,4,4,12,0xb2d0667f
1000174.22,4.0,31,4,4,2,10,0xb2d5669dd
500134.63,3.0,26,4,4,2,10,0xb2d3ff5f
450024.36,2.0,27,4,3,2,9,0xb2d6c5c9
3024059.49,23.0,15,4,4,3,11,0xb2d0d02b
3567.12,1.0,17,2,2,2,6,0xb2d2cf59d
1515.41,1.0,101,1,2,1,4,0xb2d31360
291.36,2.0,6,1,3,3,7,0xb2d782f7
3062.65,1.0,92,2,2,1,5,0xb2d0be9c
17.75,3.0,1,1,4,4,9,0xb2d0b39d
9016.78,1.0,1,2,2,4,8,0xb2d68b65d
17852.27,1.0,15,2,2,3,7,0xb2d8cb2d
632.51,1.0,4,1,2,4,7,0xb2d3811f
20001.42,2.0,212,2,3,1,6,0xb2d6e2f4
48099.07,1.0,3,2,2,4,8,0xb2d6067f
600617.04,5.0,12,4,4,3,11,0xb2d4a965
170000.0,3.0,8,3,4,3,10,0xb2d5da4c
1093.19,1.0,10,1,2,3,6,0xb2d3ff63
500021.13,2.0,147,4,3,1,8,0xb2d90273
31.67,1.0,7,1,2,3,6,0xb2d57e54
1549.34,1.0,19,1,2,2,5,0xb2d29e2a
111145.95,1.0,4,3,2,4,9,0xb2d2527b
61615.3,1.0,92,3,2,1,6,0xb2d34671
398.26,2.0,2,1,3,4,8,0xb2d16c41
1011.36,1.0,92,1,2,1,4,0xb2d25103
468000.71,7.0,6,4,4,3,11,0xb2d59e6a
5219.63,1.0,0,2,2,4,8,0xb2d963fc
1668438.49,3.0,11,4,4,3,11,0xb2d3a8b5
4001.69,1.0,0,2,2,4,8,0xb2d78630
211864.63,3.0,21,3,4,2,9,0xb2d3db69
2595.61,1.0,172,1,2,1,4,0xb2d3df57
150025.38,2.0,101,3,3,1,7,0xb2d5fcd9d
1706.61,1.0,0,1,2,4,7,0xb2d3e504
2256.67,1.0,0,1,2,4,7,0xb2d21112
320026.06,3.0,3,4,4,4,12,0xb2d6db84d
1407000.15,3.0,8,4,4,3,11,0xb2d6e02c
610006.33,3.0,24,4,4,2,10,0xb2d85897
200386.86,2.0,89,3,3,1,7,0xb2d42627
201421.0,2.0,62,3,3,2,8,0xb2d9bcbf
5005.33,1.0,92,2,2,1,5,0xb2d1e10d
100020.2,2.0,101,3,3,1,7,0xb2d60bce
41.93,2.0,4,1,3,4,8,0xb2d922b1
105007.01,2.0,11,3,3,3,9,0xb2d5dd1ad
49671.14,5.0,54,2,4,2,8,0xb2d11638
310002.74,2.0,18,4,3,2,9,0xb2d98a1c
3050.86,1.0,4,2,2,4,8,0xb2d2bb16
1.74,1.0,6,1,2,3,6,0xb2d972de
105392.2,3.0,80,3,4,1,8,0xb2d4957b
50090.09,3.0,0,2,4,4,10,0x3b9b2e60
228.46,1.0,12,1,2,3,6,0xb2d0a4f6
213896.45,5.0,49,3,4,2,9,0xb2d4bce9
205812.32,4.0,0,3,4,4,11,0xb2d218ad
327744.21,1.0,3,4,2,4,10,0xb2d0fd7c
134.83,1.0,0,1,2,4,7,0xb2d6f2ce
23931.79,1.0,184,2,2,1,5,0xb2d1038c
500000.0,2.0,0,4,3,4,11,0xb2d98482
391000.01,5.0,3,4,4,4,12,0xb2d4e3c6
30262.27,1.0,14,2,2,3,7,0xb2d225f2
500000.0,3.0,26,4,4,2,10,0xb2da124c
7496.1,2.0,9,2,3,3,8,0xb2d94306
100117.22,2.0,28,3,3,2,8,0xb2d932c1
47756.68,1.0,0,2,2,4,8,0xb2d265af
283919.65,19.0,0,3,4,4,11,0xb2d58596
1024123.53,3.0,139,4,4,1,9,0xb2d5e34a
1015023.82,7.0,6,4,4,3,11,0xb2d225e5
404824.7,7.0,26,4,4,2,10,0xb2d075e7
7568.08,1.0,0,2,2,4,8,0xb2d6a653
237.31,1.0,6,1,2,3,6,0xb2d29f6d
60000.0,6.0,3,3,4,4,11,0xb2d13877
110659.85,1.0,4,3,2,4,9,0xb2d574f5
360031.27,4.0,92,4,4,1,9,0xb2d420df
50011.36,2.0,116,2,3,1,6,0xb2d0cf2a
70010.96,3.0,0,3,4,4,11,0xb2d31d94
20.0,1.0,81,1,2,1,4,0xb2d563a7
400007.18,3.0,14,4,4,3,11,0xb2da3ab4
1524138.69,7.0,1,4,4,4,12,0xb2d3659d
56.9,1.0,13,1,2,3,6,0xb2d925d2
90019847.72,5.0,21,4,4,2,10,0xb2d68dd0
900022.25,4.0,15,4,4,3,11,0xb2d61c43d
7402.11,1.0,11,2,2,3,7,0xb2d90dae
490142.21,3.0,4,4,4,4,12,0xb2d30c97
490028.4,5.0,0,4,4,4,12,0xb2d548a8
365000.0,11.0,0,4,4,4,12,0xb2d5e9b0
1000000.26,3.0,13,4,4,3,11,0xb2d6afd3
220945.35,3.0,36,3,4,2,9,0xb2d59886
280003.09,6.0,38,3,4,2,9,0xb2d58070
2848.83,1.0,34,1,2,2,5,0xb2d9cbff
39453.8,5.0,0,2,4,4,10,0x3b9b4333d
80083.28,2.0,102,3,3,1,7,0xb2d28429
156.85,1.0,1,1,2,4,7,0xb2d250e7
24.87,1.0,28,1,2,2,5,0xb2d6d291
53771.7,1.0,1,3,2,4,9,0xb2d6c0bc
80063.22,2.0,235,3,3,1,7,0xb2d514fcd
100627.28,7.0,0,3,4,4,11,0xb2d0647d
102192.08,1.0,12,3,2,3,8,0xb2d68c76
280187.37,11.0,0,3,4,4,11,0xb2d210dcd
20133.24,1.0,10,2,2,3,7,0xb2d8c935
470073.18,2.0,235,4,3,1,8,0xb2d58f37
107010.05,2.0,7,3,3,3,9,0xb2d57cc6
3054.37,1.0,174,2,2,1,5,0xb2d2d700d
820013.06,11.0,70,4,4,1,9,0xb2d16100
488420.8,6.0,33,4,4,2,10,0xb2d230ef
1000092.83,1.0,4,4,2,4,10,0xb2d3acae
30001.27,2.0,34,2,3,2,7,0xb2d92e42
215088.85,3.0,1,3,4,4,11,0xb2d24c75
6605002.84,7.0,0,4,4,4,12,0xb2d1082e
8.44,1.0,60,1,2,2,5,0xb2d9b607
140.78,1.0,60,1,2,2,5,0xb2d27d76
668020.36,24.0,3,4,4,4,12,0x3b9b181f
2167.26,1.0,13,1,2,3,6,0xb2d6990a
301469.91,3.0,13,4,4,3,11,0xb2d26e04
200198.47,2.0,15,3,3,3,9,0xb2d29221
11590.33,1.0,171,2,2,1,5,0xb2d5cc38
88012.0,3.0,1,3,4,4,11,0xb2d283ec
3904.55,1.0,1,2,2,4,8,0xb2d3e970d
703729.9,4.0,10,4,4,3,11,0xb2d2326d
2559.22,1.0,16,1,2,2,5,0xb2d2849a
500003.47,3.0,11,4,4,3,11,0xb2d4e796
1070043.06,5.0,3,4,4,4,12,0xb2d14078
10000.21,2.0,46,2,3,2,7,0xb2d9dee8
21627.11,1.0,10,2,2,3,7,0xb2d567ee
230005.05,5.0,13,3,4,3,10,0xb2d6070ad
150018.87,3.0,12,3,4,3,10,0xb2da20a2
413280.39,7.0,0,4,4,4,12,0xb2d5a7f3
164.22,1.0,10,1,2,3,6,0xb2d8f5fd
215440.96,2.0,18,3,3,2,8,0xb2d3a932d
3841.53,1.0,0,2,2,4,8,0xb2da23be
1595.0,1.0,194,1,2,1,4,0xb2d1d69cd
1254204.94,23.0,3,4,4,4,12,0x3b9b124f
62181.49,4.0,0,3,4,4,11,0x3b9b1817
500000.89,2.0,0,4,3,4,11,0xb2d96b2c
3112.34,1.0,10,2,2,3,7,0xb2d6f300
3606.68,1.0,1,2,2,4,8,0xb2d53026
2876.12,1.0,125,1,2,1,4,0xb2d46e18
80000.84,2.0,76,3,3,1,7,0xb2d8de68
110069.72,2.0,216,3,3,1,7,0xb2d3e6ef
1185.47,1.0,0,1,2,4,7,0xb2d2dde2
411009.95,12.0,56,4,4,2,10,0xb2d5e7a9d
52171.3,1.0,9,3,2,3,8,0xb2d6da42
7193.99,1.0,77,2,2,1,5,0xb2d21166
162857.87,3.0,49,3,4,2,9,0xb2d3c658d
402524.64,6.0,5,4,4,3,11,0xb2d53898
60000.0,1.0,0,3,2,4,9,0xb2d5ab34
1382.94,1.0,184,1,2,1,4,0xb2d129de
1260.41,1.0,18,1,2,2,5,0xb2d5fbefd
283958.26,2.0,196,3,3,1,7,0xb2d61b50
55012.2,4.0,64,3,4,2,9,0xb2d62535
14054.69,1.0,0,2,2,4,8,0xb2d3859ad
997.87,1.0,26,1,2,2,5,0xb2d2bd0dd
223410.99,6.0,11,3,4,3,10,0xb2d1123d
622.82,1.0,21,1,2,2,5,0xb2d325a7
266009.95,4.0,139,3,4,1,8,0xb2d419d8
404949.37,7.0,0,4,4,4,12,0xb2d0b319
4084.55,1.0,105,2,2,1,5,0xb2d29ada
1100000.58,2.0,7,4,3,3,10,0xb2d9af8c
108842.87,1.0,20,3,2,2,7,0xb2d0f5d5
4636.11,1.0,10,2,2,3,7,0xb2d5cdcdd
206881.64,2.0,2,3,3,4,10,0xb2d13478
3889.94,1.0,184,2,2,1,5,0xb2d0e27d
49.33,1.0,0,1,2,4,7,0xb2d27d49
7460.41,2.0,0,2,3,4,9,0xb2d0f2d2
201464.56,1.0,92,3,2,1,6,0xb2d380bd
27.46,1.0,48,1,2,2,5,0xb2d2b4ff
4.13,1.0,38,1,2,2,5,0xb2d6a348
52306.56,3.0,0,3,4,4,11,0xb2d068a7
500000.53,3.0,1,4,4,4,12,0xb2d8cd3e
380876.87,1.0,3,4,2,4,10,0xb2d321a7
7099.27,1.0,184,2,2,1,5,0xb2d14357d
5242.24,1.0,0,2,2,4,8,0xb2d6865b
5302.12,1.0,0,2,2,4,8,0xb2d7c093
131.68,1.0,20,1,2,2,5,0xb2d60c1d
5170.65,1.0,8,2,2,3,7,0xb2d323f9
1180039.15,4.0,8,4,4,3,11,0xb2d90d26d
32.76,1.0,8,1,2,3,6,0xb2d8e895
978.27,1.0,0,1,2,4,7,0xb2d615f7
50002.11,2.0,92,2,3,1,6,0xb2d63ed1
150007.94,2.0,209,3,3,1,7,0xb2d687c8
500160.89,3.0,11,4,4,3,11,0xb2d1037f
110159.88,3.0,202,3,4,1,8,0x3b9b30da
4593249.11,17.0,0,4,4,4,12,0xb2d366d4d
134.02,1.0,1,1,2,4,7,0xb2da06fe
134919.63,4.0,62,3,4,2,9,0xb2d430f4
200802.06,2.0,59,3,3,2,8,0xb2d6c644
2870.96,1.0,229,1,2,1,4,0xb2d2db87
4904.32,1.0,1,2,2,4,8,0xb2d700a9
116.33,1.0,69,1,2,1,4,0xb2d20c91
2085696.9,7.0,10,4,4,3,11,0xb2d57cb8
870078.9,8.0,0,4,4,4,12,0xb2d43663d
61007.93,1.0,12,3,2,3,8,0xb2d653dd
272.24,1.0,48,1,2,2,5,0xb2d0e723
122898.56,2.0,136,3,3,1,7,0xb2d170ec
49237.29,1.0,0,2,2,4,8,0xb2d955da
5.28,1.0,25,1,2,2,5,0xb2d946b2
17290.93,1.0,1,2,2,4,8,0xb2d55df4
67115.27,2.0,3,3,3,4,10,0xb2d55e49
2702.39,1.0,14,1,2,3,6,0xb2d8c612
6646.81,1.0,0,2,2,4,8,0xb2d41d79
9816.67,1.0,0,2,2,4,8,0xb2d574e8
419366.1,2.0,60,4,3,2,9,0xb2d53f0e
20000.0,2.0,181,2,3,1,6,0xb2d3aed9
1201.65,1.0,10,1,2,3,6,0xb2d3f274
500000.0,3.0,9,4,4,3,11,0xb2d8de5b
6885.35,1.0,92,2,2,1,5,0xb2d0ec84
1908047.18,8.0,70,4,4,1,9,0xb2d31bf7
50030.97,1.0,2,2,2,4,8,0xb2d99d22
520080.03,3.0,0,4,4,4,12,0xb2d6a8f3
600.99,1.0,0,1,2,4,7,0xb2d8c6b8
359.34,1.0,0,1,2,4,7,0xb2d37409
4301066.16,10.0,8,4,4,3,11,0x3b9acd0c
260391.54,3.0,5,3,4,3,10,0xb2d17e91
204989.67,2.0,221,3,3,1,7,0xb2d56e56
2356.11,1.0,4,1,2,4,7,0xb2d90285
1187076.31,5.0,4,4,4,4,12,0xb2d65886
269154.4,3.0,200,3,4,1,8,0xb2d22c00
140001.48,3.0,14,3,4,3,10,0xb2d95d1b
700045.93,2.0,5,4,3,3,10,0xb2d90b54
220056.29,2.0,101,3,3,1,7,0xb2d64a63
4795.3,1.0,92,2,2,1,5,0xb2d2f16d
2758.42,1.0,11,1,2,3,6,0xb2d6a03f
90721.19,1.0,1,3,2,4,9,0xb2d42e1f
3906.37,1.0,13,2,2,3,7,0xb2d6c875
2851.4,1.0,92,1,2,1,4,0xb2d1f9be
88.24,1.0,0,1,2,4,7,0xb2d1dec0
16.51,1.0,5,1,2,3,6,0xb2d91392
34.15,1.0,83,1,2,1,4,0xb2d83be0
5826.74,1.0,1,2,2,4,8,0xb2d48848
400000.01,3.0,1,4,4,4,12,0xb2d7002ed
1175019.21,9.0,0,4,4,4,12,0xb2d0e7f2
2927.78,1.0,3,2,2,4,8,0xb2d0f314
880.45,1.0,10,1,2,3,6,0xb2d5eedf
11026.8,2.0,0,2,3,4,9,0xb2d120b2
205589.68,2.0,28,3,3,2,8,0xb2d5c733
80.67,1.0,14,1,2,3,6,0xb2d6bacd
60089.5,2.0,94,3,3,1,7,0xb2d5265d
1116.3,1.0,2,1,2,4,7,0xb2d5c7d6
1441357.62,9.0,27,4,4,2,10,0xb2d4b729
2624.83,1.0,4,1,2,4,7,0xb2d48cce
141995.72,2.0,88,3,3,1,7,0xb2d063c8
285302.74,7.0,1,3,4,4,11,0xb2d18ada
5886.65,2.0,0,2,3,4,9,0xb2d08d46
263.34,1.0,0,1,2,4,7,0xb2d88199
9021.29,1.0,92,2,2,1,5,0xb2d52c59
637847.3,17.0,4,4,4,4,12,0xb2d2663a
487522.25,6.0,46,4,4,2,10,0xb2d0c914
160183.09,3.0,25,3,4,2,9,0xb2d6c134
28.97,1.0,2,1,2,4,7,0xb2d21124
160000.95,1.0,0,3,2,4,9,0xb2d699c6d
193443.37,2.0,200,3,3,1,7,0xb2d26f86
111558.36,1.0,0,3,2,4,9,0xb2d18105
483817.83,8.0,5,4,4,3,11,0xb2d6b5da
1.32,1.0,55,1,2,2,5,0xb2d64552
110003.48,2.0,92,3,3,1,7,0xb2d63925
95665.59,3.0,4,3,4,4,11,0xb2d4babe
80000.53,4.0,1,3,4,4,11,0xb2da15e4
17006.01,2.0,124,2,3,1,6,0xb2d5b8c6
56777.23,2.0,0,3,3,4,10,0xb2d177cc
200774.34,2.0,28,3,3,2,8,0xb2d6531a
724011.78,9.0,14,4,4,3,11,0xb2d07619
200000.0,2.0,0,3,3,4,10,0xb2da64ab
2339513.33,2.0,67,4,3,1,8,0xb2d4adcdd
23149.74,3.0,0,2,4,4,10,0xb2d1f6ff
184008.44,3.0,210,3,4,1,8,0xb2d59624
50313.27,2.0,4,2,3,4,9,0xb2d694c0
103.87,1.0,8,1,2,3,6,0xb2d9a7a4
70002.22,2.0,10,3,3,3,9,0xb2d961cc
1026001.61,5.0,11,4,4,3,11,0xb2d618c0
2.25,2.0,88,1,3,1,5,0xb2d484d0
640013.51,2.0,94,4,3,1,8,0xb2d87d91
240139.76,3.0,53,3,4,2,9,0xb2d1fc67d
10078.45,2.0,39,2,3,2,7,0xb2d9688c
1040000.35,3.0,0,4,4,4,12,0xb2d0dbcd
219914.27,3.0,9,3,4,3,10,0xb2d299bb
52058.65,2.0,66,2,3,2,7,0xb2d5da52
1612.73,1.0,1,1,2,4,7,0xb2d3cdff
554455.77,8.0,13,4,4,3,11,0xb2d23a6c
501128.27,3.0,6,4,4,3,11,0xb2d6d3fb
44012.02,2.0,33,2,3,2,7,0xb2d5d5aa
30067.36,4.0,28,2,4,2,8,0x3b9b2533
410134.02,3.0,2,4,4,4,12,0xb2d90cb4d
14328.84,1.0,10,2,2,3,7,0xb2d32f57
103734.67,2.0,221,3,3,1,7,0xb2d12a81
409071.87,3.0,24,4,4,2,10,0xb2d5177a
5055000.28,7.0,0,4,4,4,12,0xb2d621e9
97242.93,2.0,30,3,3,2,8,0xb2d5fd29
610000.05,6.0,0,4,4,4,12,0xb2d3c35d
1016.52,1.0,92,1,2,1,4,0xb2d1a32f
82.22,1.0,1,1,2,4,7,0xb2d52917
555001.1,14.0,13,4,4,3,11,0xb2d20615
4465.71,1.0,1,2,2,4,8,0xb2d55195
150001.06,3.0,4,3,4,4,11,0xb2da4a50
2587.83,1.0,92,1,2,1,4,0xb2d1a314
349850.47,2.0,0,4,3,4,11,0xb2d6328a
53.85,2.0,0,1,3,4,8,0xb2d94a5f
966839.25,7.0,5,4,4,3,11,0xb2d17297
1386.99,1.0,92,1,2,1,4,0xb2d1f0e2
132054.07,2.0,19,3,3,2,8,0xb2d6246f
106458.88,2.0,0,3,3,4,10,0xb2d2d50a
5006.44,1.0,131,2,2,1,5,0xb2d6ffae
514225.68,2.0,111,4,3,1,8,0xb2d6c3ef
221422.07,2.0,13,3,3,3,9,0xb2d1874f
3178.12,1.0,9,2,2,3,7,0xb2d32ef3
401063.99,3.0,12,4,4,3,11,0xb2d78d1b
115.06,1.0,24,1,2,2,5,0xb2d5c7df
2467478.71,14.0,1,4,4,4,12,0xb2d06cd1
937.05,1.0,37,1,2,2,5,0xb2d286fb
30460.28,3.0,4,2,4,4,10,0xb2d550bb
100164.48,3.0,48,3,4,2,9,0xb2d60ce1
14143.38,1.0,0,2,2,4,8,0xb2d3d516
41.98,1.0,34,1,2,2,5,0xb2d0d9d8
105046.91,3.0,95,3,4,1,8,0xb2d40f5dd
445105.49,4.0,19,4,4,2,10,0xb2d7753c
827.47,1.0,51,1,2,2,5,0xb2d68282
100366.96,1.0,0,3,2,4,9,0xb2d0f18e
21.07,1.0,55,1,2,2,5,0xb2d68fc4
1355485.64,9.0,0,4,4,4,12,0xb2d2d7aa
200052.86,2.0,118,3,3,1,7,0xb2d2adc9
7899.45,3.0,13,2,4,3,9,0x3b9b3ebf
31.73,1.0,11,1,2,3,6,0xb2d6b6a7
50412.48,3.0,31,2,4,2,8,0xb2d2b0f9
9.96,1.0,3,1,2,4,7,0xb2d6d194
369053.59,4.0,73,4,4,1,9,0xb2d18a7c
130098.81,2.0,27,3,3,2,8,0xb2d10652d
509109.94,9.0,4,4,4,4,12,0xb2d3c569
2151671.31,1.0,1,4,2,4,10,0x3b9b3058d
180357.42,11.0,1,3,4,4,11,0xb2d682ab
2275.42,1.0,184,1,2,1,4,0xb2d30c34
2370.12,1.0,10,1,2,3,6,0xb2d33a8d
245279.02,7.0,6,3,4,3,10,0xb2d14e71
15.62,1.0,13,1,2,3,6,0xb2d41434
212.6,1.0,4,1,2,4,7,0xb2d21b39
467416.43,7.0,1,4,4,4,12,0xb2d0e090
218064.47,2.0,0,3,3,4,10,0xb2d3033b
3000060.22,3.0,20,4,4,2,10,0x3b9b4733
8155.66,1.0,6,2,2,3,7,0xb2d3c4cdd
49313.06,1.0,10,2,2,3,7,0xb2d2fffe
119.56,9.0,0,1,4,4,9,0xb2d09fd7
1476001.05,5.0,0,4,4,4,12,0xb2d5fe36d
2081.04,1.0,1,1,2,4,7,0xb2d7ed72
414710.51,4.0,6,4,4,3,11,0xb2d52afa
204266.03,2.0,195,3,3,1,7,0xb2d80e49
1272.61,1.0,184,1,2,1,4,0xb2d14415
190348.25,6.0,75,3,4,1,8,0x3b9b47e7
65264.46,2.0,214,3,3,1,7,0xb2d36551
6973.58,1.0,184,2,2,1,5,0xb2d38373
400124.09,3.0,1,4,4,4,12,0xb2d5f238
1600016.91,2.0,119,4,3,1,8,0xb2d93679
183251.48,2.0,13,3,3,3,9,0xb2d31cb1
61528.24,2.0,0,3,3,4,10,0xb2d4159e
1012.81,1.0,92,1,2,1,4,0xb2d2c171
500016.02,2.0,80,4,3,1,8,0xb2d6b575
204984.95,2.0,148,3,3,1,7,0xb2d657b9
59018.68,1.0,7,3,2,3,8,0xb2d8cec6
24.5,1.0,3,1,2,4,7,0xb2d3e4b3
200000.0,2.0,5,3,3,3,9,0xb2da569c
0.83,1.0,22,1,2,2,5,0xb2d4118a
9330.63,1.0,11,2,2,3,7,0xb2d40953
150080.18,3.0,20,3,4,2,9,0xb2d2c190
8465.4,1.0,92,2,2,1,5,0xb2d1bf8bd
100043.91,2.0,94,3,3,1,7,0xb2d1ea6c
15431.96,1.0,20,2,2,2,6,0xb2d6a7b7
7229.63,1.0,7,2,2,3,7,0xb2d31de7d
218412.24,2.0,83,3,3,1,7,0xb2d41439d
303267.73,2.0,9,4,3,3,10,0xb2d90884
30011.19,2.0,60,2,3,2,7,0xb2d9bc6e
811.66,5.0,0,1,4,4,9,0xb2d064ac
201422.19,2.0,76,3,3,1,7,0xb2d992f7
16344.45,3.0,0,2,4,4,10,0xb2d91273
200002.1,2.0,20,3,3,2,8,0xb2d8d876
490710.42,3.0,22,4,4,2,10,0xb2d96178
450031.14,3.0,1,4,4,4,12,0xb2d1532f
430728.24,5.0,4,4,4,4,12,0xb2d9b9ab
278.28,1.0,29,1,2,2,5,0xb2d77ef9
66000.7,2.0,32,3,3,2,8,0xb2da02e8
900031.73,5.0,80,4,4,1,9,0xb2d176f2
23766.75,1.0,5,2,2,3,7,0xb2d2b79a
89.91,1.0,70,1,2,1,4,0xb2d20c0d
478722.27,3.0,0,4,4,4,12,0xb2d135a1
20357.35,1.0,51,2,2,2,6,0xb2d3cad6
309.86,1.0,10,1,2,3,6,0xb2d790d3
9650.51,1.0,14,2,2,3,7,0xb2d26778d
304109.71,4.0,5,4,4,3,11,0xb2d42196
19436.99,1.0,0,2,2,4,8,0xb2d6c178
500004.52,2.0,14,4,3,3,10,0xb2d6db27
0.0,1.0,118,1,2,1,4,0xb2d29a7e
3.7,1.0,19,1,2,2,5,0xb2d69653d
1279.63,1.0,10,1,2,3,6,0xb2d47ef2
1380.77,1.0,0,1,2,4,7,0xb2d4cb77d
240754.53,2.0,54,3,3,2,8,0x3b9b1a09
77316.85,2.0,1,3,3,4,10,0xb2d2312d
9099.01,1.0,0,2,2,4,8,0xb2d8e7a4
140345.3,3.0,0,3,4,4,11,0xb2d9946f
6461.39,1.0,92,2,2,1,5,0xb2d553b1
150003.49,4.0,6,3,4,3,10,0xb2d75485d
228.43,1.0,17,1,2,2,5,0xb2d85852
61.2,1.0,75,1,2,1,4,0xb2d218d8
500480.77,3.0,32,4,4,2,10,0xb2d6b15f
65.55,1.0,0,1,2,4,7,0xb2d44407
205873.27,8.0,39,3,4,2,9,0xb2d1936c
49.28,1.0,1,1,2,4,7,0xb2d93071
87773.69,2.0,40,3,3,2,8,0xb2d587e7
82733.24,1.0,9,3,2,3,8,0xb2d401c8
50950.19,1.0,3,2,2,4,8,0xb2d34de9
14817.27,1.0,0,2,2,4,8,0xb2d8ea15
440690.99,3.0,14,4,4,3,11,0xb2d62726d
69.92,1.0,0,1,2,4,7,0xb2d6861d
119421.26,3.0,217,3,4,1,8,0xb2d416c8
54.56,1.0,72,1,2,1,4,0xb2d0d60d
8091.03,1.0,14,2,2,3,7,0xb2d693fbd
9135.31,1.0,0,2,2,4,8,0xb2d7c0b3
509718.95,4.0,101,4,4,1,9,0xb2d12c80
9435.19,1.0,22,2,2,2,6,0xb2d2c99e
880000.86,2.0,12,4,3,3,10,0xb2d9e6d8
20011.05,2.0,18,2,3,2,7,0xb2d654eed
800070.6,5.0,8,4,4,3,11,0xb2d3778a
5675.15,1.0,30,2,2,2,6,0xb2d97d5f
65.78,1.0,66,1,2,2,5,0xb2d605bbd
1525.88,1.0,92,1,2,1,4,0xb2d0f08e
443163.67,4.0,39,4,4,2,10,0xb2d9810c
60026.2,2.0,143,3,3,1,7,0xb2d5d5fd
81174.89,2.0,92,3,3,1,7,0xb2d5bca8
717857.69,3.0,1,4,4,4,12,0xb2d1516f
2107.34,1.0,1,1,2,4,7,0xb2d1bead
2684.39,3.0,0,1,4,4,9,0xb2d2d7e6
217000.18,7.0,4,3,4,4,11,0xb2d0f655d
506862.08,2.0,30,4,3,2,9,0xb2d45cfb
401420.92,5.0,43,4,4,2,10,0xb2d0cba7
5401.04,1.0,0,2,2,4,8,0xb2d437f2
1578.97,1.0,12,1,2,3,6,0xb2d214e5
505206.2,2.0,16,4,3,2,9,0xb2d5fe7c
20.27,1.0,54,1,2,2,5,0xb2d2668d
903332.57,58.0,0,4,4,4,12,0x3b9b2f32
301133.59,2.0,11,4,3,3,10,0xb2d9c3cb
357875.42,6.0,3,4,4,4,12,0xb2d56759
1018.55,1.0,184,1,2,1,4,0xb2d5e9d2
255006.23,3.0,27,3,4,2,9,0xb2d58a5a
16294.4,1.0,12,2,2,3,7,0xb2d4dbbe
73629.05,18.0,0,3,4,4,11,0x3b9b17e5
37.24,3.0,75,1,4,1,6,0xb2d2e5bb
401446.89,3.0,38,4,4,2,10,0xb2d6e7eb
955.62,1.0,6,1,2,3,6,0xb2d3480d
52001.1,2.0,123,2,3,1,6,0xb2d54815
268969.55,1.0,19,3,2,2,7,0xb2d0f461
100073.08,2.0,144,3,3,1,7,0xb2d6d2fa
67.13,1.0,19,1,2,2,5,0xb2d29968
10000.11,2.0,206,2,3,1,6,0xb2d68ff0
1117934.87,5.0,6,4,4,3,11,0xb2d3ac7e
3804.08,1.0,10,2,2,3,7,0xb2d972b9
1804.45,1.0,81,1,2,1,4,0xb2d415f6
3300034.83,2.0,13,4,3,3,10,0xb2d95991d
18000.0,1.0,0,2,2,4,8,0xb2da3da3
35233.31,1.0,42,2,2,2,6,0xb2d685c5
143622.41,4.0,46,3,4,2,9,0xb2d6284f
130006.86,3.0,97,3,4,1,8,0xb2d789f0
990394.8,8.0,0,4,4,4,12,0xb2d68a29
13996.44,1.0,1,2,2,4,8,0xb2d3c1bcd
105008.28,4.0,18,3,4,2,9,0xb2d6de5f
330058.84,3.0,95,4,4,1,9,0xb2d3ba45
1000005.28,1.0,0,4,2,4,10,0xb2d92f19
588076.33,4.0,92,4,4,1,9,0xb2d51e4f
129979.88,3.0,55,3,4,2,9,0xb2d13506
536.64,1.0,9,1,2,3,6,0xb2d8ce04
1253.62,1.0,0,1,2,4,7,0xb2d2aa41
415094.33,5.0,21,4,4,2,10,0xb2d690b1
173132.21,4.0,0,3,4,4,11,0xb2d5a964
5068.29,1.0,92,2,2,1,5,0xb2d20713
163.82,1.0,46,1,2,2,5,0xb2d9020e
40103.81,2.0,4,2,3,4,9,0xb2d95c82
847.6,2.0,92,1,3,1,5,0x3b9b16d5
5.42,1.0,77,1,2,1,4,0xb2d38faf
1153.87,1.0,184,1,2,1,4,0xb2d653fed
6065.31,1.0,184,2,2,1,5,0xb2d289e5
50060.08,1.0,4,2,2,4,8,0xb2d596a7
460.11,1.0,44,1,2,2,5,0xb2d330a4
127627.07,5.0,6,3,4,3,10,0xb2d53f6a
500000.0,2.0,13,4,3,3,10,0xb2da435f
183903.36,6.0,0,3,4,4,11,0x3b9b463d
50830.36,2.0,231,2,3,1,6,0xb2d620d1
8118.85,5.0,29,2,4,2,8,0x3b9b2a54
4623.73,5.0,92,2,4,1,7,0x3b9af418
1623.87,1.0,1,1,2,4,7,0xb2d6bda3
170000.0,3.0,0,3,4,4,11,0xb2d971f6
13232.07,1.0,25,2,2,2,6,0xb2d1c3cd
5619.85,1.0,3,2,2,4,8,0xb2d6e7e5
308461.08,3.0,10,4,4,3,11,0xb2d36065
441187.28,2.0,193,4,3,1,8,0xb2d117cd
3603.65,1.0,184,2,2,1,5,0xb2d5729b
59.83,1.0,3,1,2,4,7,0xb2d3f9efd
13647.3,10.0,0,2,4,4,10,0x3b9af125
1030.66,1.0,237,1,2,1,4,0xb2d28a86
15.32,1.0,19,1,2,2,5,0xb2d32f6f
72321.21,3.0,0,3,4,4,11,0xb2d60b2a
170.56,1.0,28,1,2,2,5,0xb2d85b6bd
3509000.0,9.0,0,4,4,4,12,0xb2d683cd
10307.52,1.0,181,2,2,1,5,0xb2d653c1
100093.63,2.0,83,3,3,1,7,0xb2d8d009
693.09,1.0,18,1,2,2,5,0xb2d348b2
203492.55,3.0,13,3,4,3,10,0xb2d18067
52399.5,2.0,69,3,3,1,7,0xb2d12220
15655.66,1.0,0,2,2,4,8,0xb2d32748
1689.27,1.0,9,1,2,3,6,0xb2d468d3
69718.8,7.0,0,3,4,4,11,0xb2d0ae5d
212.83,2.0,92,1,3,1,5,0x3b9b1abc
628.56,1.0,42,1,2,2,5,0xb2d34645
160005.81,3.0,62,3,4,2,9,0xb2d78651
77918.74,1.0,42,3,2,2,7,0xb2d45607
210018.3,3.0,18,3,4,2,9,0xb2d630a8
200006.33,2.0,95,3,3,1,7,0xb2d97439
11467.74,1.0,13,2,2,3,7,0xb2d22eee
396071.96,2.0,18,4,3,2,9,0xb2d68368
200098.77,2.0,7,3,3,3,9,0xb2d6432d
35286.53,3.0,32,2,4,2,8,0xb2d619a0
165.39,2.0,7,1,3,3,7,0xb2d616ef
2602000.0,25.0,1,4,4,4,12,0xb2d530bbd
325653.35,13.0,6,4,4,3,11,0xb2d1b544
1677.02,1.0,2,1,2,4,7,0xb2d15de3
660019.17,2.0,93,4,3,1,8,0xb2d1c1e8
4423.52,1.0,0,2,2,4,8,0xb2d6b71a
554824.57,4.0,77,4,4,1,9,0xb2d3ba77
18.55,1.0,12,1,2,3,6,0xb2d3028b
124.18,1.0,34,1,2,2,5,0xb2d9527e
630099.27,10.0,4,4,4,4,12,0xb2d633a4
172873.73,3.0,228,3,4,1,8,0xb2d10c4e
950099.63,4.0,1,4,4,4,12,0xb2d2d89f
1400003.04,7.0,0,4,4,4,12,0xb2d3ee03
262795.79,3.0,11,3,4,3,10,0xb2d60e9c
13976.23,1.0,5,2,2,3,7,0xb2d651acd
1008.74,2.0,117,1,3,1,5,0xb2d0d752
450009.5,3.0,24,4,4,2,10,0xb2d948bb
108530.58,2.0,95,3,3,1,7,0xb2d526ea
1440.71,1.0,0,1,2,4,7,0xb2d8f6bf
1056302.44,2.0,12,4,3,3,10,0xb2d3b398
8.01,1.0,22,1,2,2,5,0xb2d977cf
21220.21,1.0,7,2,2,3,7,0xb2d6a193
200000.89,2.0,11,3,3,3,9,0xb2d5d75c
52265.64,2.0,235,3,3,1,7,0xb2d41032
29336.95,1.0,96,2,2,1,5,0xb2d1bfaf
509737.99,2.0,159,4,3,1,8,0xb2d15ad4
4132.47,1.0,3,2,2,4,8,0xb2d2537d
5008.61,1.0,48,2,2,2,6,0xb2d64867
13153.27,1.0,245,2,2,1,5,0xb2d66a30
5380.0,1.0,92,2,2,1,5,0xb2d2ba18
320067.83,2.0,19,4,3,2,9,0xb2d64f50
994953.32,5.0,31,4,4,2,10,0xb2d0ea86
37682.67,1.0,89,2,2,1,5,0xb2d2dd24
64068.59,1.0,18,3,2,2,7,0xb2d91729d
90002.57,2.0,35,3,3,2,8,0xb2d7088f
220019.96,2.0,221,3,3,1,7,0xb2d13e89
2050.85,1.0,86,1,2,1,4,0xb2d9546e
3918.89,1.0,46,2,2,2,6,0xb2d5d47c
310000.53,2.0,19,4,3,2,9,0xb2d940cd
150013.57,4.0,56,3,4,2,9,0xb2d60777d
130094.87,3.0,11,3,4,3,10,0xb2d063d4d
97504.72,1.0,25,3,2,2,7,0xb2d6230e
37.1,1.0,13,1,2,3,6,0xb2d63c93
211371.93,2.0,1,3,3,4,10,0xb2d38e3c
451695.65,2.0,16,4,3,2,9,0xb2d6f483
59265.09,1.0,1,3,2,4,9,0xb2d35bb9
11.7,1.0,7,1,2,3,6,0xb2d3001a
200002.58,2.0,21,3,3,2,8,0xb2d1379a
20000.21,2.0,92,2,3,1,6,0xb2d980a9
304282.08,4.0,87,4,4,1,9,0xb2d39868
9446.25,1.0,5,2,2,3,7,0xb2d5cf00
3219.49,1.0,199,2,2,1,5,0xb2d6026c
14.31,1.0,0,1,2,4,7,0xb2d9d696
30001.27,2.0,60,2,3,2,7,0xb2d9b562
40000.84,2.0,80,2,3,1,6,0xb2d8d592
5966.08,1.0,35,2,2,2,6,0xb2d5e0cc
21500.0,2.0,3,2,3,4,9,0xb2d97300
600056.47,4.0,0,4,4,4,12,0xb2d5fbc6
183.3,1.0,9,1,2,3,6,0xb2d22dc9
1438.17,1.0,184,1,2,1,4,0xb2d40715
61819.06,3.0,2,3,4,4,11,0x3b9b1800
2086.53,1.0,21,1,2,2,5,0xb2d2558b
140015.58,3.0,14,3,4,3,10,0xb2d644fd
150097.54,4.0,24,3,4,2,9,0xb2d0e8d2
251.62,1.0,9,1,2,3,6,0xb2d8796a
125.65,1.0,18,1,2,2,5,0xb2d60c14
750024.78,4.0,6,4,4,3,11,0xb2d78dff
463115.95,9.0,0,4,4,4,12,0xb2d1c795
1214.18,1.0,220,1,2,1,4,0xb2d6a710
1157.38,1.0,184,1,2,1,4,0xb2d580de
1047.14,1.0,0,1,2,4,7,0xb2d944a5
44.25,2.0,18,1,3,2,6,0xb2d65d98
102883.79,2.0,210,3,3,1,7,0xb2d400c0d
201583.51,3.0,4,3,4,4,11,0xb2d41680
383069.15,7.0,11,4,4,3,11,0xb2d16ef2
16896.94,1.0,145,2,2,1,5,0xb2d4af62
22048.83,1.0,0,2,2,4,8,0xb2d54ec0
10012.27,1.0,15,2,2,3,7,0xb2d9cfba
50107.74,1.0,214,2,2,1,5,0xb2d6b39b
200232.28,1.0,0,3,2,4,9,0xb2d9411a
60146.54,3.0,27,3,4,2,9,0xb2d6937c
112373.74,5.0,70,3,4,1,8,0xb2d62842
3777.33,1.0,113,2,2,1,5,0xb2d0e22b
201421.01,2.0,64,3,3,2,8,0xb2d9adf5
5550.95,1.0,184,2,2,1,5,0x3b9b18b1d
37.91,1.0,8,1,2,3,6,0xb2d2dcc0
410432.85,4.0,6,4,4,3,11,0xb2d317e7
150000.0,1.0,0,3,2,4,9,0xb2d97e41
200150.77,2.0,0,3,3,4,10,0xb2d9ff78
1457.87,1.0,92,1,2,1,4,0xb2d2e34f
100001.06,2.0,34,3,3,2,8,0xb2d932c1d
154013.02,2.0,161,3,3,1,7,0xb2d5cba5
420013.12,4.0,27,4,4,2,10,0xb2d6845f
601.99,1.0,0,1,2,4,7,0xb2d237d5
300018.98,2.0,15,3,3,3,9,0xb2da32f3
120096.73,5.0,20,3,4,2,9,0xb2d16d28
1158.32,2.0,184,1,3,1,5,0xb2d313d6
6961.67,1.0,92,2,2,1,5,0xb2d1fb98d
1289.43,1.0,8,1,2,3,6,0xb2d26c22
500031.41,2.0,17,4,3,2,9,0xb2d7c6e4
1781.37,1.0,19,1,2,2,5,0xb2d191b2
50003.87,3.0,118,2,4,1,7,0xb2d593cbd
20000.21,2.0,49,2,3,2,7,0xb2d9d6e2
320203.55,3.0,66,4,4,2,10,0xb2d5dd20
800008.58,3.0,122,4,4,1,9,0xb2d43579d
100003.17,2.0,73,3,3,1,7,0xb2d8e0e4
8009.34,1.0,92,2,2,1,5,0x3b9af6d1
1054548.23,2.0,153,4,3,1,8,0xb2d446d1
96260.83,6.0,0,3,4,4,11,0xb2d06941
80099.11,4.0,11,3,4,3,10,0xb2d38343
251001.83,4.0,17,3,4,2,9,0xb2d994d3
0.26,2.0,62,1,3,2,6,0xb2d17b24
509826.13,10.0,10,4,4,3,11,0xb2d5c022
52012.88,2.0,20,2,3,2,7,0xb2d242a2
542.26,1.0,0,1,2,4,7,0xb2d23619
4205.69,1.0,9,2,2,3,7,0xb2d8fd8cd
46160.53,3.0,186,2,4,1,7,0xb2d4273f
102735548.16,10.0,0,4,4,4,12,0x3b9ad071
126.67,1.0,87,1,2,1,4,0xb2d94ad2
653073.18,2.0,10,4,3,3,10,0xb2d95d9e
165577.43,2.0,213,3,3,1,7,0xb2d171d6
400000.24,3.0,9,4,4,3,11,0x3b9b46c0
1000026.39,3.0,13,4,4,3,11,0xb2d9e345
55001.16,2.0,60,3,3,2,8,0xb2d9be22
80192.21,4.0,3,3,4,4,11,0xb2d32400
1050000.0,5.0,0,4,4,4,12,0xb2d60c99
20686.19,2.0,0,2,3,4,9,0xb2da3641
3554.09,1.0,92,2,2,1,5,0xb2d53cb0
552587.32,16.0,0,4,4,4,12,0xb2d23ca5d
20148.37,2.0,92,2,3,1,6,0xb2d5f40a
151029.11,1.0,92,3,2,1,6,0xb2d3bbedd
1000061.45,2.0,12,4,3,3,10,0xb2d6b4ef
705012.53,4.0,2,4,4,4,12,0xb2d5ad64
471125.88,3.0,4,4,4,4,12,0xb2d3a8e0
8939.51,1.0,184,2,2,1,5,0x3b9b482a
76735.2,1.0,0,3,2,4,9,0xb2d315b2
10385.32,1.0,21,2,2,2,6,0xb2d30021
1.39,1.0,57,1,2,2,5,0xb2d8dd0e
9989.46,1.0,0,2,2,4,8,0xb2d6f378
53799.07,2.0,74,3,3,1,7,0xb2d41f16
60269.44,1.0,0,3,2,4,9,0xb2d6369b
16115.99,1.0,0,2,2,4,8,0xb2d2112c
90000.95,3.0,34,3,4,2,9,0x3b9b29c1
17326.94,1.0,69,2,2,1,5,0xb2d5308d
188750.8,3.0,60,3,4,2,9,0xb2d36387
21267.78,1.0,0,2,2,4,8,0xb2d89ff7
100084.38,2.0,123,3,3,1,7,0xb2d25af6
417005.29,6.0,25,4,4,2,10,0xb2d80509d
758.38,1.0,22,1,2,2,5,0x3b9b43cb
1517.26,1.0,0,1,2,4,7,0xb2d69488d
105000.0,2.0,1,3,3,4,10,0xb2da55cc
1657.35,1.0,18,1,2,2,5,0xb2d191b2d
16.04,1.0,45,1,2,2,5,0xb2d20df5
860.25,1.0,23,1,2,2,5,0xb2d22d6c
7590.5,1.0,17,2,2,2,6,0xb2d64977
196327.9,1.0,155,3,2,1,6,0xb2d388cc
398.99,1.0,0,1,2,4,7,0xb2d305c9
43948.3,2.0,1,2,3,4,9,0xb2d41683
1763.59,1.0,184,1,2,1,4,0xb2d22d0c
25206.32,1.0,0,2,2,4,8,0xb2d18602
2030.52,1.0,92,1,2,1,4,0xb2d1f017
432405.69,6.0,0,4,4,4,12,0xb2d0dd5d
2083353.04,16.0,0,4,4,4,12,0xb2d175fd
50002.63,2.0,224,2,3,1,6,0xb2d2a25d
121264.85,3.0,0,3,4,4,11,0xb2d76b31
299789.58,4.0,1,3,4,4,11,0xb2d377a8
600006.39,4.0,90,4,4,1,9,0xb2d07744
160102.76,3.0,1,3,4,4,11,0xb2da04b3
177020.65,7.0,28,3,4,2,9,0xb2d3a901
17.11,1.0,57,1,2,2,5,0xb2d6b11a
7.92,1.0,30,1,2,2,5,0xb2d93be0
140002.32,5.0,0,3,4,4,11,0xb2d918dbd
202868.19,3.0,21,3,4,2,9,0x3b9b4693d
177655.73,4.0,18,3,4,2,9,0xb2d296ae
5036.21,1.0,184,2,2,1,5,0xb2d3eeb8
1007.67,1.0,12,1,2,3,6,0xb2d68622
11485.43,1.0,0,2,2,4,8,0xb2d458e6
307305.8,3.0,0,4,4,4,12,0xb2d29864d
540.61,1.0,1,1,2,4,7,0xb2d3191d
1444377.13,2.0,6,4,3,3,10,0xb2d06e77
402389.84,4.0,25,4,4,2,10,0xb2d2b78e
29.87,1.0,1,1,2,4,7,0xb2da019a
40034.36,2.0,10,2,3,3,8,0xb2d1a100
1933.57,1.0,0,1,2,4,7,0xb2d1d83d
2372.41,1.0,0,1,2,4,7,0xb2d30fdd
61.53,1.0,0,1,2,4,7,0xb2d33c16
2.51,1.0,63,1,2,2,5,0xb2d5fd38
397.94,1.0,0,1,2,4,7,0xb2d30e74
354186.46,4.0,0,4,4,4,12,0xb2d3dfab
33687.47,4.0,20,2,4,2,8,0xb2d22436
272750.2,3.0,12,3,4,3,10,0x3b9b38e2
1814795.05,4.0,11,4,4,3,11,0xb2d48e30
1048.42,1.0,2,1,2,4,7,0xb2d2e295
25002.95,2.0,27,2,3,2,7,0xb2d0f605
40000.84,2.0,66,2,3,2,7,0xb2d8ef5f
830339.51,6.0,2,4,4,4,12,0xb2d1617a
1054.61,1.0,92,1,2,1,4,0xb2d29a5c
3332.42,1.0,92,2,2,1,5,0xb2d0ac54
4062.23,1.0,184,2,2,1,5,0xb2d4098b
1077729.17,5.0,60,4,4,2,10,0xb2d14c58
8670.42,1.0,217,2,2,1,5,0xb2d435aad
132872.57,4.0,63,3,4,2,9,0xb2d40debd
1007.81,1.0,184,1,2,1,4,0xb2d3c0d2
1155012.86,7.0,95,4,4,1,9,0xb2d1ca66
1118.47,1.0,184,1,2,1,4,0xb2d0d00f
773796.92,11.0,1,4,4,4,12,0xb2d14ab8d
235783.78,3.0,0,3,4,4,11,0xb2d0a22e
343048.1,5.0,3,4,4,4,12,0xb2d0c2c9
400022.18,3.0,53,4,4,2,10,0xb2d477a7d
171017.63,5.0,47,3,4,2,9,0xb2d6d9ef
1240.98,1.0,1,1,2,4,7,0xb2d76526
332042.92,3.0,4,4,4,4,12,0xb2d87bee
200000.0,2.0,7,3,3,3,9,0xb2d96e8f
314318.59,3.0,11,4,4,3,11,0xb2d681a1
512067.21,4.0,26,4,4,2,10,0xb2d97e6e
556.71,1.0,0,1,2,4,7,0xb2d6b6dd
401420.83,2.0,39,4,3,2,9,0xb2d92bca
1.37,1.0,57,1,2,2,5,0xb2d5c44b
10000.11,2.0,6,2,3,3,8,0xb2da4cbd
333606.27,2.0,0,4,3,4,11,0xb2d6f104
389058.87,4.0,0,4,4,4,12,0xb2d2ba3dd
880010.4,11.0,4,4,4,4,12,0xb2d202d0
2691.18,1.0,92,1,2,1,4,0xb2d2f76a
10334.56,1.0,70,2,2,1,5,0xb2d59715
491192.22,2.0,20,4,3,2,9,0xb2d0a4db
64.88,3.0,2,1,4,4,9,0xb2d30621
254030.22,3.0,25,3,4,2,9,0xb2d1037d
211549.69,4.0,5,3,4,3,10,0xb2d06925
10001.53,2.0,8,2,3,3,8,0xb2da1c4b
210038.85,2.0,209,3,3,1,7,0xb2d3af43
110603.65,6.0,6,3,4,3,10,0xb2d61119
70006.82,2.0,200,3,3,1,7,0xb2d63df0
856709.03,12.0,0,4,4,4,12,0xb2d197f2
2791.5,1.0,10,1,2,3,6,0xb2d2e242d
305924.98,2.0,62,4,3,2,9,0xb2d30e94d
453974.15,4.0,31,4,4,2,10,0xb2d11a80
772736.12,6.0,4,4,4,4,12,0xb2d49187d
4442.18,1.0,10,2,2,3,7,0xb2d2ecee
10329.06,1.0,4,2,2,4,8,0xb2d5d55c
25326.03,1.0,44,2,2,2,6,0xb2d6a5c8
6943.72,1.0,13,2,2,3,7,0xb2d99e9a
3351.61,1.0,92,2,2,1,5,0xb2d13ffe
10028.45,2.0,107,2,3,1,6,0xb2d07a72
1360.95,1.0,1,1,2,4,7,0xb2d9e289
91.6,1.0,53,1,2,2,5,0xb2d67e72
370074.24,4.0,158,4,4,1,9,0xb2d29fe4
11442.47,1.0,1,2,2,4,8,0xb2d1d5c9
2224084.84,8.0,19,4,4,2,10,0xb2d0ec6f
1040.95,1.0,184,1,2,1,4,0xb2d2d805
430634.89,4.0,123,4,4,1,9,0xb2d53c38
1110089.29,4.0,11,4,4,3,11,0xb2d6d145
160.97,1.0,126,1,2,1,4,0xb2d1c70b
380006.4,7.0,32,4,4,2,10,0xb2d5badf
2259522.56,14.0,0,4,4,4,12,0x3b9b288f
796451.41,4.0,73,4,4,1,9,0xb2d3f89e
160151.47,1.0,84,3,2,1,6,0xb2d96dcb
503552.71,2.0,73,4,3,1,8,0xb2d9a569
470.91,1.0,10,1,2,3,6,0xb2d8796ad
302131.85,2.0,82,4,3,1,8,0xb2d98cdf
110457.67,1.0,0,3,2,4,9,0xb2d57297
310016.19,8.0,2,4,4,4,12,0xb2d4796f
1610183.29,9.0,42,4,4,2,10,0xb2d78ba2
2606.63,1.0,92,1,2,1,4,0xb2d357a8
51439.36,2.0,55,2,3,2,7,0xb2d4100e
3.48,1.0,52,1,2,2,5,0xb2d3f687
2400000.0,4.0,0,4,4,4,12,0xb2d3e664
16859.4,2.0,1,2,3,4,9,0xb2da1acf
20022.19,1.0,28,2,2,2,6,0xb2d6c4f8
400657.55,3.0,3,4,4,4,12,0xb2d57eaf
25493764.51,12.0,1,4,4,4,12,0xb2d180f2
44.25,1.0,5,1,2,3,6,0xb2d31052
475039.41,2.0,60,4,3,2,9,0xb2d6a4b9
60797.3,2.0,0,3,3,4,10,0xb2d61e71d
3.26,1.0,29,1,2,2,5,0xb2d60a16
202100.27,3.0,0,3,4,4,11,0xb2d4fc0fd
38.89,1.0,18,1,2,2,5,0xb2d5b272d
201421.32,2.0,27,3,3,2,8,0xb2d8cb6b
1075739.88,23.0,0,4,4,4,12,0xb2d6e161
200099.0,2.0,2,3,3,4,10,0xb2d97430
34269.7,1.0,9,2,2,3,7,0xb2d9014c
48801.39,1.0,16,2,2,2,6,0xb2d1e8f1
405540.42,4.0,1,4,4,4,12,0xb2d63144
2040.64,1.0,184,1,2,1,4,0xb2d28a99
171356.25,2.0,0,3,3,4,10,0xb2d5ab18
130006.97,2.0,231,3,3,1,7,0xb2d1740c
1068008.59,5.0,0,4,4,4,12,0xb2d12b74
16005.94,1.0,0,2,2,4,8,0xb2d6eec6
0.0,1.0,184,1,2,1,4,0xb2d2d92b
387328.5,13.0,18,4,4,2,10,0x3b9ade96
201553.86,2.0,1,3,3,4,10,0xb2d6508e
376139.81,4.0,37,4,4,2,10,0xb2d23d76
600114.61,4.0,0,4,4,4,12,0xb2d8d2af
50516.97,1.0,18,2,2,2,6,0xb2d692ad
75400.91,4.0,0,3,4,4,11,0xb2d8a828
751471.69,5.0,29,4,4,2,10,0xb2d78158
3052.56,1.0,0,2,2,4,8,0xb2d34076
4367.04,1.0,0,2,2,4,8,0xb2d50d92
6075.99,1.0,184,2,2,1,5,0xb2d117db
24112.83,1.0,34,2,2,2,6,0xb2d1d1d5
17736.29,1.0,25,2,2,2,6,0xb2d6c2ea
400036.87,3.0,13,4,4,3,11,0xb2d6c3de
265000.0,2.0,83,3,3,1,7,0xb2d98936
225965.18,2.0,2,3,3,4,10,0xb2d910cbd
538599.39,2.0,15,4,3,3,10,0xb2d0bbbf
560044.75,9.0,0,4,4,4,12,0xb2d1ffc7
100155.61,2.0,22,3,3,2,8,0xb2d588a5
71379.64,9.0,0,3,4,4,11,0x3b9adbd8d
3142.69,1.0,1,2,2,4,8,0xb2d558ec
475171.87,5.0,13,4,4,3,11,0xb2d185b4d
242901.3,4.0,0,3,4,4,11,0xb2d5874c
15.03,1.0,0,1,2,4,7,0xb2d4c95ad
530710.42,11.0,3,4,4,4,12,0xb2d688f0
300204.88,3.0,0,4,4,4,12,0xb2d6d0e7
200798.2,2.0,35,3,3,2,8,0xb2d6af56
358003.79,9.0,30,4,4,2,10,0xb2d21aaf
51.18,1.0,27,1,2,2,5,0xb2d452ea
1016.08,1.0,184,1,2,1,4,0xb2d2748e
8078.73,1.0,154,2,2,1,5,0xb2d4fdec
217.93,1.0,7,1,2,3,6,0xb2d680f8
1500.16,1.0,54,1,2,2,5,0xb2d69db7
90690.34,2.0,0,3,3,4,10,0xb2d610ea
18907761.13,2.0,0,4,3,4,11,0xb2d77f80
944804.19,6.0,3,4,4,4,12,0xb2d1c242
1628.94,1.0,4,1,2,4,7,0xb2d19314
716990.28,4.0,0,4,4,4,12,0xb2d1209f
9588.03,1.0,0,2,2,4,8,0xb2d81fd4d
521953.7,5.0,2,4,4,4,12,0xb2d602cd
153077.37,2.0,118,3,3,1,7,0xb2d6333a
250000.0,3.0,2,3,4,4,11,0xb2d6b825
6120.68,1.0,27,2,2,2,6,0xb2d4cdce
120686.8,2.0,239,3,3,1,7,0xb2d68880
50002.24,2.0,31,2,3,2,7,0xb2d5f594
18021.62,1.0,0,2,2,4,8,0xb2d6aa5f
412633.57,5.0,18,4,4,2,10,0x3b9b2336
479045.89,3.0,4,4,4,4,12,0xb2d50903
20351.83,1.0,247,2,2,1,5,0xb2d5bd9c
51028.15,2.0,92,2,3,1,6,0xb2d153e7
136879.57,2.0,97,3,3,1,7,0xb2d0f598
491.02,1.0,0,1,2,4,7,0xb2d4a987
620043.19,4.0,11,4,4,3,11,0xb2d5699cd
1845.11,2.0,0,1,3,4,8,0xb2d210ca
190688.65,6.0,0,3,4,4,11,0xb2d207cdd
100184.73,2.0,99,3,3,1,7,0xb2d64e23
1889.49,1.0,17,1,2,2,5,0xb2d95118
6.1,1.0,16,1,2,2,5,0xb2d581fc
4.27,2.0,5,1,3,3,7,0xb2d145c1
201311.98,2.0,0,3,3,4,10,0xb2d6a79e
851596.22,29.0,0,4,4,4,12,0xb2d1144e
101801.85,2.0,0,3,3,4,10,0xb2d3346e
84.62,2.0,22,1,3,2,6,0xb2d9ff95
121080.52,1.0,13,3,2,3,8,0xb2d56076d
1190224.87,2.0,14,4,3,3,10,0xb2d553b9
501875.44,3.0,22,4,4,2,10,0xb2d24a78
600052.55,4.0,6,4,4,3,11,0xb2d60532
1000002.15,5.0,19,4,4,2,10,0xb2d6294d
32575.04,1.0,0,2,2,4,8,0xb2d2183e
1695.63,1.0,6,1,2,3,6,0xb2d5836a
2046.74,1.0,92,1,2,1,4,0xb2d3abb9
44217.32,1.0,92,2,2,1,5,0xb2d177ad
24889.92,1.0,0,2,2,4,8,0xb2d28cec
20000.21,2.0,77,2,3,1,6,0xb2d99614
45710.15,1.0,29,2,2,2,6,0xb2d32a04
119558.62,3.0,0,3,4,4,11,0xb2d41e2c
60007.5,3.0,20,3,4,2,9,0xb2d68227
30000.85,3.0,34,2,4,2,8,0xb2d92081
20201357.34,2.0,20,4,3,2,9,0xb2d68076
500000.0,2.0,11,4,3,3,10,0xb2d9670c
17243.31,1.0,21,2,2,2,6,0xb2d4353c
200031.59,2.0,69,3,3,1,7,0xb2d1a14f
20301.42,2.0,186,2,3,1,6,0xb2d84e4cd
610031.51,13.0,4,4,4,4,12,0xb2d23b6d
307026.96,5.0,6,4,4,3,11,0xb2d43f7bd
200600.06,2.0,92,3,3,1,7,0xb2d5fbad
3.74,1.0,80,1,2,1,4,0xb2d8ce49d
502005.0,2.0,12,4,3,3,10,0xb2d6f9d8
439071.34,3.0,19,4,4,2,10,0xb2d40ed1
3619.87,1.0,92,2,2,1,5,0xb2d2b98ed
200043.05,2.0,5,3,3,3,9,0xb2d3a83c
3596.33,1.0,92,2,2,1,5,0xb2d40925
1756.47,1.0,96,1,2,1,4,0xb2d5e910
1590008.03,7.0,3,4,4,4,12,0xb2d11832
1861.62,1.0,208,1,2,1,4,0xb2d58cb4
318994.94,2.0,1,4,3,4,11,0xb2d1a3edd
167298.78,2.0,0,3,3,4,10,0x3b9b3e92
50044.83,2.0,143,2,3,1,6,0xb2d613ec
161599.05,2.0,2,3,3,4,10,0xb2d3ba16
489362.44,7.0,0,4,4,4,12,0xb2d16c7a
611.44,1.0,3,1,2,4,7,0xb2d39b83
1799999.0,4.0,1,4,4,4,12,0xb2d589bc
51110.46,4.0,0,2,4,4,10,0xb2d067ae
504443.37,5.0,3,4,4,4,12,0xb2d2d082
4027.31,1.0,92,2,2,1,5,0xb2d243f4
7343.66,1.0,184,2,2,1,5,0xb2d0d197
164003.46,2.0,24,3,3,2,8,0xb2d9481cd
177.39,1.0,2,1,2,4,7,0xb2d3e50f
6988.09,1.0,10,2,2,3,7,0xb2d3e957
2201.09,1.0,1,1,2,4,7,0xb2d7008e
30036.75,1.0,184,2,2,1,5,0xb2d25c88
4447.06,1.0,8,2,2,3,7,0xb2d5ef31
220020.86,4.0,3,3,4,4,11,0xb2d53484
11606.25,2.0,0,2,3,4,9,0xb2d54f42
153033.21,3.0,203,3,4,1,8,0x3b9b3864
21112.04,3.0,0,2,4,4,10,0x3b9af148
50001.06,2.0,158,2,3,1,6,0xb2d8ef4d
4.09,1.0,12,1,2,3,6,0xb2d13e60
896430.23,8.0,80,4,4,1,9,0xb2d18b27
188301.11,1.0,19,3,2,2,7,0x3b9ae020
14519.58,1.0,184,2,2,1,5,0xb2d24423
351779.86,6.0,39,4,4,2,10,0xb2d9d575
54.4,1.0,72,1,2,1,4,0xb2d2022a
250028.27,2.0,11,3,3,3,9,0xb2d69e8a
503552.79,2.0,75,4,3,1,8,0xb2d980ff
3.57,1.0,82,1,2,1,4,0xb2d42438
400000.0,2.0,1,4,3,4,11,0xb2d98135
88306.92,1.0,109,3,2,1,6,0xb2d57be5d
10216683.98,2.0,31,4,3,2,9,0xb2d628c5
975851.77,4.0,14,4,4,3,11,0xb2d61fe9
756.06,1.0,4,1,2,4,7,0xb2d166e3
124506.04,2.0,108,3,3,1,7,0x3b9b41dc
51236.58,1.0,55,2,2,2,6,0xb2d6d0be
501852.47,3.0,13,4,4,3,11,0xb2d8ce8e
3552.02,1.0,5,2,2,3,7,0xb2d68e26
200000.0,2.0,18,3,3,2,8,0xb2d92515
556681.92,4.0,0,4,4,4,12,0xb2d0d9eb
3135354.89,7.0,26,4,4,2,10,0xb2d40c57
2.42,1.0,192,1,2,1,4,0xb2d57a53
1499.47,1.0,9,1,2,3,6,0xb2d40df2
160242.21,4.0,0,3,4,4,11,0xb2d3984fd
388363.62,5.0,18,4,4,2,10,0xb2d49d63
116234.54,1.0,4,3,2,4,9,0xb2d3a4b7
2277759.81,2.0,10,4,3,3,10,0xb2d30d0c
2165813.56,4.0,58,4,4,2,10,0xb2d24405
4778.16,1.0,15,2,2,3,7,0xb2d7185e
407888.0,5.0,6,4,4,3,11,0xb2d2669a
1300.45,1.0,9,1,2,3,6,0xb2d318eb
20001.06,2.0,216,2,3,1,6,0xb2d67e38d
51051.06,1.0,4,2,2,4,8,0xb2d275dc
1625243.58,12.0,0,4,4,4,12,0xb2d5992f
1020.0,1.0,2,1,2,4,7,0xb2d54003
450008.68,3.0,14,4,4,3,11,0xb2d6adea
380004.01,2.0,32,4,3,2,9,0xb2da0313
1.68,1.0,70,1,2,1,4,0xb2d3b762
60463.9,1.0,8,3,2,3,8,0xb2d98b89
1351.76,1.0,279,1,2,1,4,0xb2d28b68
63.33,1.0,42,1,2,2,5,0xb2d8e0d8
2424.43,1.0,8,1,2,3,6,0xb2d2fa7b
10060.37,1.0,109,2,2,1,5,0xb2d16b02
5316.21,1.0,80,2,2,1,5,0xb2d2099f
8055.56,1.0,0,2,2,4,8,0xb2d3e60b
2170049.83,4.0,1,4,4,4,12,0xb2d24507
200917.47,4.0,5,3,4,3,10,0xb2d5ae49
608.98,1.0,0,1,2,4,7,0xb2d19862
488064.7,12.0,3,4,4,4,12,0xb2d156fd
700.31,1.0,0,1,2,4,7,0xb2d9215b
110059.2,3.0,11,3,4,3,10,0xb2d6408c
33000.35,2.0,6,2,3,3,8,0xb2da1597
258341.51,3.0,107,3,4,1,8,0xb2d1734d
501776.21,2.0,49,4,3,2,9,0xb2d9d4bc
257300.79,2.0,48,3,3,2,8,0xb2d1bcac
50000.0,1.0,0,2,2,4,8,0xb2d9ee80
174721.22,5.0,0,3,4,4,11,0xb2d29def
80117.72,2.0,28,3,3,2,8,0xb2d3be25
128075.79,2.0,18,3,3,2,8,0xb2d06e04
3378.78,1.0,8,2,2,3,7,0xb2d58e00
499.16,2.0,49,1,3,2,6,0xb2d516dc
918978.19,8.0,7,4,4,3,11,0xb2d28024
671372.34,2.0,70,4,3,1,8,0xb2d284e4
172200.19,2.0,1,3,3,4,10,0xb2d94d6d
151962.63,2.0,10,3,3,3,9,0xb2d5ff72
10600.19,2.0,0,2,3,4,9,0xb2d5dcf4
20000.63,2.0,151,2,3,1,6,0xb2d8fb83
106747.07,2.0,92,3,3,1,7,0xb2d3c08c
471.86,1.0,4,1,2,4,7,0xb2d5d2dd
2122175.27,6.0,8,4,4,3,11,0xb2d178da
216360.22,2.0,100,3,3,1,7,0xb2d3a32e
70551.34,2.0,0,3,3,4,10,0xb2d776a4
161136.28,2.0,0,3,3,4,10,0xb2d0a26bd
263028.2,5.0,38,3,4,2,9,0xb2d0c98e
400007.7,5.0,3,4,4,4,12,0xb2d9b68d
635115.74,1.0,0,4,2,4,10,0xb2d2fcbad
2131.72,1.0,17,1,2,2,5,0xb2d242c6
312969.4,3.0,0,4,4,4,12,0xb2d5f90f
971953.47,2.0,0,4,3,4,11,0xb2d9078d
759.1,1.0,9,1,2,3,6,0xb2d41ea6
3900495.76,4.0,0,4,4,4,12,0xb2d5edadd
500007.49,3.0,14,4,4,3,11,0xb2d8cd5f
1341.62,1.0,92,1,2,1,4,0xb2d315a0d
1295.49,1.0,184,1,2,1,4,0xb2d2f0f9
16706.92,1.0,11,2,2,3,7,0xb2d977af
626849.73,2.0,4,4,3,4,11,0xb2d48902
10227.53,1.0,49,2,2,2,6,0xb2d37c22
3464.19,1.0,92,2,2,1,5,0xb2d22b8f
108.29,1.0,3,1,2,4,7,0xb2d3438d
12132.01,1.0,184,2,2,1,5,0xb2d283af
800000.53,2.0,28,4,3,2,9,0xb2d9f87b
209253.38,2.0,103,3,3,1,7,0xb2d5f037
100002.11,2.0,11,3,3,3,9,0xb2da4128
1007676.28,7.0,0,4,4,4,12,0xb2d51887
13385.72,1.0,0,2,2,4,8,0xb2d443ba
500113.91,2.0,24,4,3,2,9,0xb2d99449
90000.0,2.0,0,3,3,4,10,0xb2d2b96a
320155.38,3.0,76,4,4,1,9,0xb2d18b3d
319687.8,14.0,2,4,4,4,12,0xb2d16cfa
520014.76,8.0,19,4,4,2,10,0xb2d63603
360234.01,2.0,39,4,3,2,9,0xb2d12a57
300000.0,2.0,28,3,3,2,8,0xb2da0d48
7784.85,1.0,31,2,2,2,6,0xb2d39b48
1011.21,1.0,5,1,2,3,6,0xb2d98506
80000110.03,4.0,33,4,4,2,10,0xb2d347ba
0.0,1.0,3,1,2,4,7,0xb2d18f99
380554.01,2.0,1,4,3,4,11,0xb2d99ea6
150078.44,2.0,160,3,3,1,7,0xb2d177f7
4536.19,1.0,7,2,2,3,7,0xb2d295f8
58882.8,1.0,34,3,2,2,7,0xb2d76326
50008.87,2.0,8,2,3,3,8,0xb2d0a44f
1462.52,1.0,10,1,2,3,6,0xb2d2a0ee
22351.97,1.0,184,2,2,1,5,0x3b9b17af
251748.45,2.0,3,3,3,4,10,0xb2d5a581d
362628.79,4.0,0,4,4,4,12,0xb2d4caf4
60113.74,2.0,50,3,3,2,8,0xb2d46fbc
567009.87,3.0,5,4,4,3,11,0xb2d5ef74
501776.04,2.0,40,4,3,2,9,0xb2d9f26d
16560.18,1.0,14,2,2,3,7,0xb2d97cb5
3072618.87,18.0,24,4,4,2,10,0xb2d586ac
702310.5,5.0,29,4,4,2,10,0xb2d3c551
350049.21,4.0,12,4,4,3,11,0xb2d117f0
577035.61,4.0,11,4,4,3,11,0xb2d685de
113002.66,3.0,157,3,4,1,8,0xb2d4a225
103952.65,2.0,14,3,3,3,9,0xb2d5b4d7
214760.15,2.0,33,3,3,2,8,0xb2d68c47
1838.37,1.0,41,1,2,2,5,0xb2d5c147
4.29,1.0,6,1,2,3,6,0xb2d5e42e
767273.37,2.0,10,4,3,3,10,0xb2d38304
201081.41,9.0,0,3,4,4,11,0x3b9b259b
101225.94,2.0,102,3,3,1,7,0xb2d6501b
200000.0,2.0,28,3,3,2,8,0xb2d94374
756907.86,4.0,83,4,4,1,9,0xb2d1de51
217088.87,2.0,4,3,3,4,10,0xb2da6135
10944.01,1.0,92,2,2,1,5,0xb2d21c67
11966.86,1.0,24,2,2,2,6,0xb2d645ec
410097.72,10.0,7,4,4,3,11,0xb2d6ccbf
150672.32,2.0,10,3,3,3,9,0x3b9b1b58d
1000011.09,3.0,27,4,4,2,10,0xb2d97268d
94996.12,2.0,3,3,3,4,10,0xb2d1c805
270.69,1.0,2,1,2,4,7,0xb2d19e30
29338.97,2.0,0,2,3,4,9,0xb2d5cf5a
470060.51,4.0,39,4,4,2,10,0xb2d0cc14
5066.06,1.0,5,2,2,3,7,0xb2d39195
6003.58,1.0,46,2,2,2,6,0xb2d7ef16
800780.44,4.0,13,4,4,3,11,0xb2d91861
580013.27,4.0,80,4,4,1,9,0x3b9b28fe
313006.66,2.0,10,4,3,3,10,0xb2d57b65
242868.89,4.0,52,3,4,2,9,0xb2d4fc3f
874017.75,6.0,27,4,4,2,10,0xb2d33d2cd
2943.68,1.0,108,2,2,1,5,0xb2d21f88
33196.23,3.0,0,2,4,4,10,0xb2d5539d
400000.15,3.0,9,4,4,3,11,0xb2d69d11
757760.53,8.0,6,4,4,3,11,0xb2d615af
14886.58,1.0,1,2,2,4,8,0xb2d8c8b7
66815.48,2.0,1,3,3,4,10,0xb2d2d0ff
153072.8,1.0,94,3,2,1,6,0xb2d6060f
8082.64,1.0,184,2,2,1,5,0xb2d2c67d
106214.54,2.0,179,3,3,1,7,0xb2d3f482
105238.16,2.0,80,3,3,1,7,0xb2d2c245
12896.91,1.0,14,2,2,3,7,0xb2d6ebd9
1.32,1.0,13,1,2,3,6,0xb2d957a4
207827.43,2.0,75,3,3,1,7,0xb2d631ab
2000063.35,3.0,17,4,4,2,10,0xb2d8fb5f
1544565.42,7.0,2,4,4,4,12,0xb2d07499d
801373.13,4.0,4,4,4,4,12,0xb2d37d3a
80.76,1.0,7,1,2,3,6,0xb2d2b3b3
2581.57,1.0,92,1,2,1,4,0xb2d11ea4
0.16,1.0,0,1,2,4,7,0xb2d648c2
1985.16,1.0,0,1,2,4,7,0xb2d1e5c3
4910.03,1.0,65,2,2,2,6,0xb2d2a214
1050.76,1.0,8,1,2,3,6,0xb2d5d5f7
4865.28,1.0,0,2,2,4,8,0xb2d5c587
40.43,1.0,2,1,2,4,7,0xb2d6dca7
170885.02,3.0,0,3,4,4,11,0xb2d6dd1b
266671.91,3.0,20,3,4,2,9,0xb2d3d099
1122.19,1.0,184,1,2,1,4,0xb2d1f4d8d
30021.28,1.0,8,2,2,3,7,0xb2d988d5
1245869.16,220.0,0,4,4,4,12,0xb2d11fd8
2016.57,1.0,92,1,2,1,4,0xb2d2d810
332683.14,2.0,25,4,3,2,9,0xb2d28735
20366.06,2.0,182,2,3,1,6,0xb2d603fa
2268.34,1.0,7,1,2,3,6,0xb2d6c1f9
206401.97,2.0,132,3,3,1,7,0xb2d6a628
600001.16,2.0,21,4,3,2,9,0xb2d9b994
672560.56,3.0,3,4,4,4,12,0x3b9b244b
8.46,1.0,9,1,2,3,6,0xb2d30c49d
38.12,2.0,0,1,3,4,8,0x3b9b25b1
719.17,3.0,0,1,4,4,9,0xb2d067dad
920000.46,6.0,2,4,4,4,12,0xb2d3bd89
162.87,1.0,27,1,2,2,5,0xb2d5ae62
4.33,1.0,4,1,2,4,7,0xb2d18cead
115038.67,14.0,52,3,4,2,9,0x3b9adb11
400000.0,3.0,3,4,4,4,12,0xb2d68638
561264.14,3.0,5,4,4,3,11,0xb2d22c30
21410.12,1.0,0,2,2,4,8,0xb2d6ab20
113.36,1.0,70,1,2,1,4,0xb2d5f018
138342.37,1.0,9,3,2,3,8,0xb2d64dc7
1003.91,1.0,25,1,2,2,5,0xb2d438fdd
402843.48,2.0,24,4,3,2,9,0xb2d20982
6989.71,1.0,138,2,2,1,5,0xb2d44d23
858811.28,2.0,168,4,3,1,8,0xb2d1c033d
14.19,1.0,11,1,2,3,6,0xb2d1cb47
160033.88,3.0,24,3,4,2,9,0xb2d0ed54
23.36,1.0,12,1,2,3,6,0xb2d6b995
1783.68,1.0,10,1,2,3,6,0xb2d2a046d
1974.9,1.0,7,1,2,3,6,0xb2d59493
60089.59,2.0,186,3,3,1,7,0xb2d5265dd
211275.11,4.0,0,3,4,4,11,0xb2d3550e
1298.92,1.0,184,1,2,1,4,0xb2d402d7
247207.09,2.0,4,3,3,4,10,0xb2d2c37cd
337071.43,5.0,1,4,4,4,12,0xb2d2b4bb
0.74,1.0,3,1,2,4,7,0xb2d4179a
2311.01,1.0,29,1,2,2,5,0xb2d6918e
6044.54,1.0,184,2,2,1,5,0xb2d3b351
7717.81,1.0,5,2,2,3,7,0xb2d60c08
420047.47,2.0,10,4,3,3,10,0xb2d6c7c4
50617.38,2.0,132,2,3,1,6,0xb2d6e08d
80581.92,2.0,108,3,3,1,7,0xb2d33a8b
1446.38,1.0,9,1,2,3,6,0xb2d3ef03
190080.38,4.0,87,3,4,1,8,0xb2d593ee
920064.01,21.0,10,4,4,3,11,0xb2d5ed76
1117.08,1.0,116,1,2,1,4,0xb2d69a9e
4042.87,1.0,184,2,2,1,5,0xb2d28277
2000000.0,1.0,0,4,2,4,10,0xb2da6aa7
10177.07,1.0,184,2,2,1,5,0xb2d0b200
24.67,1.0,19,1,2,2,5,0xb2d974b6
21.2,1.0,58,1,2,2,5,0xb2d5b8c6d
1650004.94,6.0,2,4,4,4,12,0xb2d575f0
9357.62,1.0,200,2,2,1,5,0xb2d6877d
40617.44,1.0,29,2,2,2,6,0xb2d588b7
770.14,2.0,54,1,3,2,6,0x3b9af0d4
432524.28,3.0,51,4,4,2,10,0xb2d52008
12126.21,1.0,15,2,2,3,7,0xb2d6d076d
90.26,1.0,64,1,2,2,5,0xb2d69927
1952.21,1.0,168,1,2,1,4,0xb2d344a6
300004.1,5.0,0,3,4,4,11,0xb2d61635
6002.45,1.0,18,2,2,2,6,0xb2d91e54
611.61,1.0,21,1,2,2,5,0xb2d0ca03
400020.88,3.0,45,4,4,2,10,0xb2d9e720
566795.01,4.0,62,4,4,2,10,0x3b9b1c2b
305573.42,2.0,11,4,3,3,10,0xb2d3fb41
50019.9,2.0,122,2,3,1,6,0xb2d2d954
0.13,1.0,81,1,2,1,4,0xb2d0cdfe
2126.3,1.0,70,1,2,1,4,0xb2d59a59
300000.0,3.0,18,3,4,2,9,0xb2d913da
540075.79,5.0,6,4,4,3,11,0xb2d620f8d
391449.85,5.0,0,4,4,4,12,0xb2d10b73
413062.84,1.0,1,4,2,4,10,0xb2d356e0d
739.93,1.0,5,1,2,3,6,0xb2d68327
51918.77,1.0,4,2,2,4,8,0xb2d612dc
200000.0,2.0,5,3,3,3,9,0xb2d123e5
608147.58,13.0,18,4,4,2,10,0xb2d439ee
292137.04,4.0,19,3,4,2,9,0xb2d57caa
561080.09,8.0,6,4,4,3,11,0xb2d43c69d
36598.3,1.0,22,2,2,2,6,0xb2d23623
650783.03,5.0,3,4,4,4,12,0xb2d3f78d
21.41,1.0,35,1,2,2,5,0xb2d21b17
5189.47,1.0,15,2,2,3,7,0xb2d96559
120183.07,1.0,2,3,2,4,9,0xb2d12aba
600031.25,2.0,9,4,3,3,10,0xb2d9f35c
9.58,1.0,18,1,2,2,5,0xb2d62d58
1028.42,1.0,184,1,2,1,4,0x3b9b3680
183073.03,5.0,10,3,4,3,10,0xb2d69a6a
5223.13,1.0,2,2,2,4,8,0xb2d9d984
3487.8,1.0,11,2,2,3,7,0xb2d1912f
5.08,1.0,9,1,2,3,6,0xb2d90e35
17916.04,3.0,115,2,4,1,7,0xb2d2dff0
103735.31,2.0,12,3,3,3,9,0xb2d60ca5
7.39,1.0,51,1,2,2,5,0xb2d8d081
350063.5,4.0,16,4,4,2,10,0xb2d3af5c
1185389.22,2.0,3,4,3,4,11,0xb2d3c610
0.0,1.0,7,1,2,3,6,0xb2d9105a
1578.94,1.0,5,1,2,3,6,0xb2d912e6
363139.7,2.0,39,4,3,2,9,0xb2d13cbdd
0.4,1.0,6,1,2,3,6,0xb2d4f2e5
550896.26,9.0,4,4,4,4,12,0xb2d24d58d
2750.7,1.0,8,1,2,3,6,0xb2d682f7
270992.13,2.0,0,3,3,4,10,0xb2d23642d
0.0,1.0,10,1,2,3,6,0xb2d9dd23
8942.9,1.0,184,2,2,1,5,0xb2d26520
22.84,1.0,75,1,2,1,4,0xb2d6e7e7
132045.98,3.0,18,3,4,2,9,0xb2d51266
6173.6,1.0,6,2,2,3,7,0xb2d2f20d
119126.33,2.0,0,3,3,4,10,0xb2d581a3
630648.42,1.0,0,4,2,4,10,0xb2d6afecd
4176.54,1.0,92,2,2,1,5,0xb2d0cd9e
278.25,1.0,8,1,2,3,6,0xb2d54805
3342.94,10.0,92,2,4,1,7,0xb2d0ca46
8222.87,1.0,5,2,2,3,7,0xb2d6c222
28418.15,1.0,15,2,2,3,7,0xb2d8c62f
206239.15,1.0,6,3,2,3,8,0xb2d4f424
12782.64,1.0,69,2,2,1,5,0xb2d6e4dd
110002.32,1.0,11,3,2,3,8,0xb2d96776d
6877.33,1.0,0,2,2,4,8,0xb2d69a4b
201481.29,2.0,23,3,3,2,8,0xb2d98045
1711.97,1.0,24,1,2,2,5,0xb2d31569
660101.59,8.0,11,4,4,3,11,0xb2d23b9f
103044.75,2.0,154,3,3,1,7,0xb2d1a49a
7.29,1.0,19,1,2,2,5,0xb2d62accd
3061.88,2.0,0,2,3,4,9,0xb2d1bbff
130537.72,1.0,184,3,2,1,6,0xb2d3d311
6.43,1.0,41,1,2,2,5,0xb2d56a61
200974.33,3.0,122,3,4,1,8,0xb2d6385f
105.65,1.0,1,1,2,4,7,0xb2d10703
80079.18,2.0,34,3,3,2,8,0xb2d593c7
302.05,1.0,5,1,2,3,6,0xb2d3a5c1
340013.68,4.0,62,4,4,2,10,0xb2d12350
7001.3,1.0,1,2,2,4,8,0xb2d824b5
350013.24,5.0,60,4,4,2,10,0xb2d31406
813006.51,7.0,5,4,4,3,11,0xb2d33d6e
620529.6,5.0,25,4,4,2,10,0xb2d18924
2833.31,1.0,45,1,2,2,5,0xb2d3b853
271430.02,3.0,74,3,4,1,8,0xb2d0fd41
4513.31,1.0,92,2,2,1,5,0xb2d406b4
643878.07,4.0,3,4,4,4,12,0xb2d08bfed
31840.0,2.0,8,2,3,3,8,0x3b9b3579
306653.77,7.0,1,4,4,4,12,0xb2d094cf
3.84,1.0,84,1,2,1,4,0xb2d59526
200050.0,2.0,1,3,3,4,10,0xb2d97ffc
109.49,1.0,67,1,2,1,4,0xb2d6fefe
374986.29,3.0,16,4,4,2,10,0xb2d65ea3
55.4,1.0,22,1,2,2,5,0xb2d2aaa3
458609.43,42.0,2,4,4,4,12,0x3b9b1919
8.85,2.0,7,1,3,3,7,0x3b9b3549
537018.86,3.0,217,4,4,1,9,0xb2d3b55f
43500.19,3.0,55,2,4,2,8,0xb2d5edc1
114001.2,2.0,35,3,3,2,8,0xb2d9f909
801130.22,2.0,167,4,3,1,8,0x3b9b298b
847.6,1.0,1,1,2,4,7,0xb2d9274d
318152.41,2.0,235,4,3,1,8,0xb2d30d52
15339.89,2.0,69,2,3,1,6,0xb2d5adf1
121910.99,2.0,29,3,3,2,8,0xb2d682c6
20451.74,1.0,0,2,2,4,8,0xb2d6e00a
10326.52,1.0,5,2,2,3,7,0xb2d3bb4c
7857.66,1.0,13,2,2,3,7,0xb2d9c5b1
121534.05,5.0,11,3,4,3,10,0xb2d5325a
150002.64,3.0,59,3,4,2,9,0xb2d8d53dd
302131.56,2.0,68,4,3,1,8,0xb2d9b0e3
338000.71,2.0,73,4,3,1,8,0xb2d17884
2.11,1.0,4,1,2,4,7,0xb2da4ba8
2342.97,1.0,9,1,2,3,6,0xb2d429a3
6.99,1.0,28,1,2,2,5,0xb2d40570
853372.27,39.0,0,4,4,4,12,0xb2d0634d
880008.27,7.0,35,4,4,2,10,0xb2d88eab
30105.04,1.0,92,2,2,1,5,0xb2d356c0
503262.56,3.0,6,4,4,3,11,0xb2d2601c
900044.43,3.0,6,4,4,3,11,0xb2d8f1c2
1000993.6,2.0,20,4,3,2,9,0xb2d94f06d
200305.05,2.0,13,3,3,3,9,0xb2d5fc2d
1107.45,1.0,184,1,2,1,4,0xb2d42451
321665.82,7.0,4,4,4,4,12,0xb2d09e5a
351806.76,2.0,1,4,3,4,11,0xb2d67e8c
500005.11,2.0,18,4,3,2,9,0xb2d6b774
213120.58,3.0,59,3,4,2,9,0xb2d170fb
17518.91,1.0,21,2,2,2,6,0xb2d6ddcb
1145.0,1.0,92,1,2,1,4,0xb2d26848
297117.16,3.0,7,3,4,3,10,0xb2d6161a
884043.24,12.0,5,4,4,3,11,0xb2d175e6
107117.81,5.0,31,3,4,2,9,0xb2d690d2
500010.56,2.0,66,4,3,2,9,0xb2d8efc1
10063.91,2.0,27,2,3,2,7,0xb2d5ef60d
95050.62,3.0,92,3,4,1,8,0xb2d34d66
28.76,1.0,116,1,2,1,4,0xb2d68bb9d
500083.52,3.0,1,4,4,4,12,0xb2d93c7d
10010.48,1.0,0,2,2,4,8,0xb2d16b54d
1743731.29,4.0,0,4,4,4,12,0xb2d7546ed
6.5,1.0,18,1,2,2,5,0xb2d5a881
34586.39,4.0,0,2,4,4,10,0x3b9b4581
280014.4,6.0,102,3,4,1,8,0xb2d3a5ff
36132.03,1.0,24,2,2,2,6,0xb2d2d39ed
1535694.12,5.0,8,4,4,3,11,0xb2d8fc4b
0.0,1.0,5,1,2,3,6,0xb2d690cf
2307.39,1.0,13,1,2,3,6,0xb2d3193c
0.98,2.0,7,1,3,3,7,0xb2d065cd
662598.6,1.0,0,4,2,4,10,0xb2d236fa
100011.06,2.0,45,3,3,2,8,0xb2d919d0
49.31,1.0,67,1,2,1,4,0xb2d44129
160021.52,3.0,5,3,4,3,10,0xb2d4d910
140.95,2.0,0,1,3,4,8,0xb2d38eb8
643071.41,4.0,25,4,4,2,10,0xb2d41786
84903.46,3.0,139,3,4,1,8,0xb2d57af0
0.0,1.0,6,1,2,3,6,0xb2d5ab95
1207.37,1.0,136,1,2,1,4,0xb2d6eb3b
106290.52,1.0,29,3,2,2,7,0xb2d5359c
20413.05,1.0,21,2,2,2,6,0xb2da074d
251878.92,4.0,83,3,4,1,8,0xb2d2e57a
79187.13,1.0,0,3,2,4,9,0xb2d5301e
450034.79,2.0,1,4,3,4,11,0xb2d85b5bd
341471.29,4.0,8,4,4,3,11,0xb2d42610
416.02,1.0,0,1,2,4,7,0xb2d6b5e0
5609.44,1.0,5,2,2,3,7,0xb2d2dddfd
0.0,12.0,0,1,4,4,9,0xb2d155c6
363050.69,3.0,108,4,4,1,9,0xb2d25680
265019.8,3.0,75,3,4,1,8,0xb2d45618
298010.53,7.0,34,3,4,2,9,0xb2d55a85
891000.3,11.0,1,4,4,4,12,0xb2d19145d
301904.81,2.0,21,4,3,2,9,0xb2d11c26
14.25,1.0,23,1,2,2,5,0xb2d93f7c
184067.94,2.0,249,3,3,1,7,0xb2d185a6d
1079.73,1.0,9,1,2,3,6,0xb2d925e9
4211.49,1.0,10,2,2,3,7,0xb2d93fb9
0.0,1.0,2,1,2,4,7,0xb2d59c52
1117.31,1.0,11,1,2,3,6,0xb2d68507
200083.5,3.0,0,3,4,4,11,0xb2d23804
1.64,1.0,46,1,2,2,5,0xb2d3bb81
200004.22,2.0,46,3,3,2,8,0xb2d9de13
0.25,1.0,14,1,2,3,6,0xb2d91c81
70838.16,2.0,24,3,3,2,8,0xb2d2790b
1040012.36,2.0,19,4,3,2,9,0xb2d44d78
4336.1,1.0,9,2,2,3,7,0xb2d6f4f6
81387.46,2.0,3,3,3,4,10,0xb2d313b1
220185.24,2.0,14,3,3,3,9,0xb2d64a28
10919.93,1.0,20,2,2,2,6,0xb2d9659b
1500.32,1.0,70,1,2,1,4,0xb2d482dc
50000.53,2.0,18,2,3,2,7,0xb2da2e49
1020000.81,5.0,1,4,4,4,12,0xb2d117dad
3189.39,2.0,0,2,3,4,9,0xb2d0d8e9
53444.1,1.0,0,3,2,4,9,0xb2d3ec08
247007.07,3.0,0,3,4,4,11,0xb2d06857
425.35,1.0,57,1,2,2,5,0xb2d2aadb
501776.06,2.0,41,4,3,2,9,0xb2d92523
26872.37,1.0,130,2,2,1,5,0xb2d24a5e
21948.13,1.0,60,2,2,2,6,0xb2d274ffd
210085.43,4.0,22,3,4,2,9,0xb2d3a69e
503552.59,2.0,68,4,3,1,8,0xb2d9b055
270011.93,5.0,20,3,4,2,9,0xb2da0446
250010.56,2.0,70,3,3,1,7,0xb2d9a2d7
5000.17,1.0,1,2,2,4,8,0xb2d81589
369405.83,2.0,0,4,3,4,11,0xb2d78838
3003.98,1.0,44,2,2,2,6,0xb2d5ffdd
3745.81,5.0,3,2,4,4,10,0x3b9af2c7
50614.97,14.0,0,2,4,4,10,0xb2d0e13a
402450.0,3.0,6,4,4,3,11,0xb2d459aa
24006.53,2.0,10,2,3,3,8,0xb2d692c6
312320.59,6.0,2,4,4,4,12,0xb2d167d0d
292528.92,3.0,11,3,4,3,10,0xb2d4d6e6
614.61,2.0,0,1,3,4,8,0x3b9b0e53
32790.16,5.0,0,2,4,4,10,0xb2d4f7c3
808.44,1.0,231,1,2,1,4,0xb2d23044
50226.51,2.0,48,2,3,2,7,0xb2d8f5e8
710211.38,3.0,4,4,4,4,12,0xb2d598ba
379208.4,4.0,20,4,4,2,10,0xb2d31b00
28155.71,1.0,0,2,2,4,8,0xb2d6c2b1
1974.3,1.0,213,1,2,1,4,0xb2d1637f
370007.6,4.0,0,4,4,4,12,0xb2d90710
340005.67,4.0,22,4,4,2,10,0xb2d8d18a
58071005.13,4.0,56,4,4,2,10,0x3b9aee2e
411136.73,3.0,31,4,4,2,10,0xb2d62a7f
700067.92,4.0,4,4,4,4,12,0xb2d7c60d
6232.03,1.0,2,2,2,4,8,0xb2d6e882
21599.55,1.0,92,2,2,1,5,0xb2d347c6
50003.71,2.0,6,2,3,3,8,0xb2d30f58
405335.9,3.0,41,4,4,2,10,0xb2d64c39
249451.26,2.0,184,3,3,1,7,0xb2d37246d
810368.13,3.0,20,4,4,2,10,0xb2d35432
548908.26,2.0,18,4,3,2,9,0xb2d504cc
391.75,1.0,9,1,2,3,6,0xb2d5884a
700053.49,3.0,10,4,4,3,11,0xb2d65ffc
1609.13,1.0,0,1,2,4,7,0xb2d5df6e
526.38,1.0,6,1,2,3,6,0xb2d202d8
2382.09,1.0,66,1,2,2,5,0xb2d1605a
305.98,1.0,16,1,2,2,5,0xb2d6bdd4
282902.93,1.0,0,3,2,4,9,0xb2d6a627
4715425.51,78.0,0,4,4,4,12,0x3b9af27a
4.35,1.0,6,1,2,3,6,0xb2d30b25
400008.44,2.0,31,4,3,2,9,0xb2d9391a
20354.96,2.0,80,2,3,1,6,0xb2d63f19
960280.01,4.0,8,4,4,3,11,0xb2d64b91
202931.94,2.0,53,3,3,2,8,0xb2d1e8a8
1505990.28,4.0,4,4,4,4,12,0xb2d627ea
622286.56,2.0,46,4,3,2,9,0xb2d9b5cd
6373.32,1.0,4,2,2,4,8,0xb2d59f3d
1026.55,1.0,27,1,2,2,5,0xb2d147ab
195971.77,3.0,0,3,4,4,11,0xb2d28993
1062261.73,3.0,27,4,4,2,10,0xb2d9357a
202153.27,2.0,75,3,3,1,7,0xb2d8fae7d
50377.51,5.0,3,2,4,4,10,0xb2d189cb
5563.73,1.0,184,2,2,1,5,0x3b9b22f3
200000.0,2.0,10,3,3,3,9,0xb2d9a7b0
110042.63,3.0,60,3,4,2,9,0xb2d17988
15116.19,2.0,47,2,3,2,7,0xb2d14f7d
250026.45,4.0,38,3,4,2,9,0xb2d6938e
588137.55,4.0,10,4,4,3,11,0xb2d213a6
11.93,1.0,53,1,2,2,5,0xb2d985a0
530552.18,5.0,6,4,4,3,11,0xb2d559b7d
500000.0,2.0,23,4,3,2,9,0xb2d9501ad
720000.0,6.0,9,4,4,3,11,0xb2d248c7
100019.46,2.0,56,3,3,2,8,0xb2d4ae19
3799.03,1.0,8,2,2,3,7,0xb2d26259d
7806.73,1.0,15,2,2,3,7,0xb2d6751c
2802.46,1.0,1,1,2,4,7,0xb2d700ea
701.09,1.0,0,1,2,4,7,0xb2d55d16
10000.11,2.0,56,2,3,2,7,0xb2d9c62b
218525.8,1.0,155,3,2,1,6,0xb2d48931
1002.54,1.0,92,1,2,1,4,0xb2d187a9
856.96,1.0,5,1,2,3,6,0xb2d96379
860005.39,4.0,4,4,4,4,12,0xb2d9d996
380000.0,1.0,1,4,2,4,10,0xb2da6620
0.0,1.0,8,1,2,3,6,0xb2d8c4b8d
600408.32,4.0,4,4,4,4,12,0xb2d6ef05
20239.14,2.0,69,2,3,1,6,0xb2d6babd
128.93,1.0,12,1,2,3,6,0xb2d940b9
304516.16,3.0,202,4,4,1,9,0xb2d28dd7
56.37,1.0,40,1,2,2,5,0xb2d99094
688.62,1.0,0,1,2,4,7,0xb2d781d8
57606.95,1.0,9,3,2,3,8,0xb2d28d7c
0.0,1.0,4,1,2,4,7,0xb2da5303
133.86,1.0,35,1,2,2,5,0xb2d8f5b9
302745.95,5.0,3,4,4,4,12,0xb2d0e0b7
5658.72,1.0,1,2,2,4,8,0xb2d3aa7b
130001.44,5.0,5,3,4,3,10,0xb2d1d385
583.39,1.0,7,1,2,3,6,0xb2d1d56f
384931.63,4.0,43,4,4,2,10,0xb2d4e709d
200070.77,3.0,10,3,4,3,10,0xb2d4f5a7
1878714.88,9.0,0,4,4,4,12,0xb2d20bf9
20087.72,1.0,101,2,2,1,5,0xb2d35551
20027.13,2.0,35,2,3,2,7,0xb2d9c569
458842.98,1.0,171,4,2,1,7,0xb2d81e1e
100003.17,2.0,87,3,3,1,7,0xb2d8c59a
10000.11,2.0,53,2,3,2,7,0xb2d9d09a
1599.5,1.0,184,1,2,1,4,0xb2d13b09
566881.9,8.0,5,4,4,3,11,0xb2d22157
20000.84,2.0,147,2,3,1,6,0xb2d900fe
5023.09,1.0,184,2,2,1,5,0xb2d5f7ae
4799.15,1.0,92,2,2,1,5,0xb2d1c703
477023.76,7.0,0,4,4,4,12,0xb2d1b5ae
190579.84,2.0,18,3,3,2,8,0xb2d3beb0
333285.4,4.0,80,4,4,1,9,0xb2d144c5
580.84,1.0,1,1,2,4,7,0xb2d2e887
445.97,1.0,49,1,2,2,5,0xb2d6e314
582601.25,12.0,0,4,4,4,12,0xb2d0d9a6
470557.82,4.0,5,4,4,3,11,0xb2d950eb
11815.89,1.0,184,2,2,1,5,0xb2d22b2e
133529.26,2.0,18,3,3,2,8,0xb2d3eaab
8204.22,1.0,153,2,2,1,5,0xb2d6aa50
1319.37,1.0,9,1,2,3,6,0xb2d95e8f
410028.57,7.0,1,4,4,4,12,0xb2d3176b
5010.14,1.0,184,2,2,1,5,0xb2d1e10dd
2270.42,1.0,1,1,2,4,7,0xb2d8d3de
250000.0,2.0,6,3,3,3,9,0xb2da0fb2
770040.77,2.0,2,4,3,4,11,0xb2d7577c
4000025.54,12.0,1,4,4,4,12,0xb2d08322
30038.03,2.0,11,2,3,3,8,0xb2d5ea44
4761.47,1.0,46,2,2,2,6,0xb2d34a41d
50059.13,2.0,27,2,3,2,7,0xb2d9328dd
3698.24,1.0,18,2,2,2,6,0xb2d92041
884905.25,5.0,15,4,4,3,11,0xb2d423b1
200710.49,2.0,19,3,3,2,8,0xb2d913a3
498441.43,4.0,3,4,4,4,12,0xb2d5e13b
400009.73,5.0,11,4,4,3,11,0xb2d23c95
2404013.33,22.0,0,4,4,4,12,0xb2d0c4f2d
380545.63,1.0,5,4,2,3,9,0xb2d2260c
1785.72,2.0,92,1,3,1,5,0xb2d19269
297679.5,3.0,0,3,4,4,11,0xb2d6328d
700000.97,4.0,1,4,4,4,12,0xb2d2d66d
46921.43,2.0,2,2,3,4,9,0xb2d67dbd
153691.04,5.0,1,3,4,4,11,0xb2d34228
248079.11,3.0,0,3,4,4,11,0xb2d163bc
2982.28,1.0,0,2,2,4,8,0xb2d6a8e1
200064.18,3.0,0,3,4,4,11,0xb2d23a26
140771.27,5.0,15,3,4,3,10,0xb2d074c3
99.42,2.0,52,1,3,2,6,0xb2d52829
652308.9,2.0,42,4,3,2,9,0xb2d92388
7062.83,1.0,0,2,2,4,8,0xb2d6b801
91500.23,2.0,143,3,3,1,7,0xb2d288fe
4867.43,1.0,92,2,2,1,5,0xb2d1f83d
3892.73,1.0,92,2,2,1,5,0xb2d225df
121.91,1.0,1,1,2,4,7,0xb2d5ba44
4599.36,1.0,18,2,2,2,6,0xb2d9794d
132.59,25.0,13,1,4,3,8,0xb2d1c8b1
15059377.82,4.0,11,4,4,3,11,0xb2d49651
1364818.07,3.0,3,4,4,4,12,0xb2d15519
11.4,1.0,60,1,2,2,5,0xb2d99533
71779.4,1.0,38,3,2,2,7,0xb2d403f0
500008.44,3.0,7,4,4,3,11,0xb2da4eb3
1027.16,1.0,295,1,2,1,4,0xb2d52ed3
45001.31,3.0,18,2,4,2,8,0xb2d70474
5208.05,1.0,21,2,2,2,6,0xb2d3e284
77.1,1.0,92,1,2,1,4,0xb2d96062
420286.08,4.0,9,4,4,3,11,0xb2d49297
3806.16,1.0,82,2,2,1,5,0xb2d2fa1b
3193.76,1.0,5,2,2,3,7,0xb2d28077
396.13,1.0,25,1,2,2,5,0xb2d42b3a
1758.12,2.0,28,1,3,2,6,0x3b9adbbad
1962.11,1.0,12,1,2,3,6,0xb2d1f545
87014.63,2.0,45,3,3,2,8,0xb2d54811
50002.11,2.0,63,2,3,2,7,0xb2d9b429
27921.69,1.0,1,2,2,4,8,0xb2d46663
1030.02,1.0,6,1,2,3,6,0xb2d94f6d
3130.63,2.0,0,2,3,4,9,0xb2d0d505
56493.15,1.0,7,3,2,3,8,0xb2d4231b
101276.85,4.0,3,3,4,4,11,0xb2d59dc6
101145.92,2.0,59,3,3,2,8,0xb2d5fcbe
919.22,1.0,8,1,2,3,6,0xb2d47d1d
569839.64,4.0,74,4,4,1,9,0xb2d6110c
1050.54,17.0,20,1,4,2,7,0xb2d171c8
95964.72,1.0,4,3,2,4,9,0xb2d30bf9
50264.79,2.0,27,2,3,2,7,0xb2d61344
1077193.48,7.0,0,4,4,4,12,0x3b9b217b
1443.81,1.0,69,1,2,1,4,0xb2d1a9e7
9212.31,2.0,0,2,3,4,9,0xb2d06a35
10121.86,2.0,47,2,3,2,7,0xb2d6d4aa
51609.87,2.0,132,2,3,1,6,0xb2d639cf
100044.66,2.0,60,3,3,2,8,0xb2d8d447
130009.5,2.0,60,3,3,2,8,0xb2d98f7f
193190.48,5.0,4,3,4,4,11,0xb2d3b8dad
8428.57,1.0,0,2,2,4,8,0xb2d6379c
802086.86,3.0,30,4,4,2,10,0xb2d8fa42d
10011.24,1.0,17,2,2,2,6,0xb2d68ed3
310610.94,3.0,5,4,4,3,11,0xb2d5dd26
101835.1,1.0,3,3,2,4,9,0xb2d64333
20000.0,2.0,6,2,3,3,8,0xb2da0f97
20877.43,1.0,0,2,2,4,8,0xb2d1eb4bd
3237.49,1.0,92,2,2,1,5,0xb2d0c8a9d
108923.47,1.0,14,3,2,3,8,0xb2d6a96d
700081.75,7.0,1,4,4,4,12,0xb2d55c3f
10.14,1.0,61,1,2,2,5,0xb2d7434f
108799.75,2.0,20,3,3,2,8,0xb2d3818c
9081.57,1.0,40,2,2,2,6,0xb2d98e10
4991.44,1.0,177,2,2,1,5,0xb2d29201
390274.06,13.0,0,4,4,4,12,0xb2d25fe0
550056.31,5.0,77,4,4,1,9,0xb2d140b1
1602319.27,4.0,34,4,4,2,10,0xb2d6e9f6
0.0,1.0,7,1,2,3,6,0xb2d5c8d0
50046.0,2.0,181,2,3,1,6,0xb2d5c1b0
534008.04,3.0,6,4,4,3,11,0xb2d92622d
403522.6,5.0,77,4,4,1,9,0xb2d609ea
221082.64,3.0,70,3,4,1,8,0xb2d54e0a
1113.7,1.0,2,1,2,4,7,0xb2d3b07f
12647.32,1.0,0,2,2,4,8,0xb2d28c6a
997.9,1.0,0,1,2,4,7,0xb2d3a44e
240209.31,5.0,6,3,4,3,10,0xb2d11557
426.99,1.0,0,1,2,4,7,0xb2d3470e
130093.62,1.0,3,3,2,4,9,0xb2d0be06
0.0,1.0,2,1,2,4,7,0xb2d0b94b
150641.99,2.0,116,3,3,1,7,0xb2d8f226
251370.7,4.0,9,3,4,3,10,0xb2d34779
111012.67,5.0,90,3,4,1,8,0x3b9b4380d
572785.58,3.0,39,4,4,2,10,0xb2d53885
27316.68,1.0,0,2,2,4,8,0xb2d33518
4.19,1.0,92,1,2,1,4,0xb2d191bfd
1628683.51,17.0,4,4,4,4,12,0xb2d0e2dc
121020.03,2.0,0,3,3,4,10,0xb2d20fbe
410000.0,1.0,0,4,2,4,10,0xb2da6b04
706224.17,4.0,6,4,4,3,11,0xb2d104dc
54279.89,2.0,73,3,3,1,7,0xb2d38644
5680.17,1.0,19,2,2,2,6,0xb2d57f1d
346174.72,5.0,0,4,4,4,12,0xb2d23c7fd
1506.61,1.0,184,1,2,1,4,0xb2d19838
17465.46,1.0,0,2,2,4,8,0xb2d604aa
45769.61,1.0,0,2,2,4,8,0xb2d33f6a
1929349.49,18.0,0,4,4,4,12,0xb2d224c0d
2523737.65,7.0,1,4,4,4,12,0x3b9b2f66
3731275.61,2.0,5,4,3,3,10,0xb2d1070a
750000.0,2.0,21,4,3,2,9,0xb2d9859f
25045.77,1.0,0,2,2,4,8,0xb2d34327
10035.0,1.0,28,2,2,2,6,0xb2d36cb6
559879.21,3.0,166,4,4,1,9,0xb2d0b123
12232.0,1.0,0,2,2,4,8,0xb2d3b7cb
360.31,1.0,3,1,2,4,7,0xb2d5da79
87842.89,1.0,6,3,2,3,8,0xb2d2da43
115000.0,2.0,1,3,3,4,10,0xb2da30bf
1380008.15,4.0,0,4,4,4,12,0xb2d5dc40
1194.98,1.0,9,1,2,3,6,0xb2d21c50
600091.92,3.0,60,4,4,2,10,0xb2d11069
520010.99,2.0,172,4,3,1,8,0xb2d8d4c7
100011.29,2.0,20,3,3,2,8,0xb2d464e2
10101.06,1.0,92,2,2,1,5,0xb2d286f0
652075.29,5.0,6,4,4,3,11,0xb2d64c12
293205.68,8.0,0,3,4,4,11,0x3b9af261d
15271.96,1.0,6,2,2,3,7,0xb2d74599
12225.07,2.0,4,2,3,4,9,0xb2d42272
4625.7,1.0,183,2,2,1,5,0xb2d60b98
153304.73,4.0,147,3,4,1,8,0xb2d61a59
336191.9,1.0,0,4,2,4,10,0xb2d5a5c1
161113.18,2.0,259,3,3,1,7,0xb2d652d0
500056.35,2.0,18,4,3,2,9,0xb2d69324
5523.61,1.0,184,2,2,1,5,0xb2d306db
340073.08,4.0,67,4,4,1,9,0xb2d50aae
70001.69,3.0,39,3,4,2,9,0xb2d6807e
206360.58,3.0,24,3,4,2,9,0xb2d39f91
171200.15,3.0,3,3,4,4,11,0xb2d071a5
830015.55,12.0,6,4,4,3,11,0xb2d3bda2
300174.23,2.0,7,4,3,3,10,0xb2d41dfd
106678.29,2.0,101,3,3,1,7,0xb2d39a81
2657.1,1.0,92,1,2,1,4,0xb2d2af9d
1563.82,1.0,73,1,2,1,4,0xb2d8de38
262879.52,9.0,0,3,4,4,11,0xb2d61893
43418.97,3.0,4,2,4,4,10,0x3b9b4076
3123.15,1.0,6,2,2,3,7,0xb2d4fe7e
3713.23,1.0,19,2,2,2,6,0xb2d83b70
10789.58,1.0,0,2,2,4,8,0xb2d341db
452225.99,5.0,0,4,4,4,12,0xb2d50b75d
1513.64,1.0,9,1,2,3,6,0xb2d8c8a7
50034.51,2.0,136,2,3,1,6,0xb2d4d961
18671.66,1.0,2,2,2,4,8,0xb2d23f04d
2868.92,1.0,12,1,2,3,6,0xb2d57fa6
832.52,1.0,0,1,2,4,7,0xb2d659ac
160067.23,2.0,24,3,3,2,8,0xb2d39a94
500052.15,2.0,20,4,3,2,9,0xb2d98c8a
14.72,1.0,45,1,2,2,5,0xb2d5da7a
5765.03,1.0,19,2,2,2,6,0xb2da0b43
12230.83,1.0,10,2,2,3,7,0xb2d2a4a6
300197.08,1.0,0,4,2,4,10,0xb2d31b2c
69.2,1.0,0,1,2,4,7,0xb2d0c840
320016.94,6.0,16,4,4,2,10,0xb2d58447
145076.47,2.0,113,3,3,1,7,0xb2d6eade
402817.19,2.0,0,4,3,4,11,0xb2d6b8dd
380000.0,15.0,0,4,4,4,12,0xb2d55128
2025.24,1.0,184,1,2,1,4,0xb2d267cc
2.07,1.0,75,1,2,1,4,0xb2d5eede
690021.91,2.0,6,4,3,3,10,0xb2d294ea
54505.82,2.0,108,3,3,1,7,0xb2d15aae
25.16,1.0,47,1,2,2,5,0xb2d6af9b
1000068.51,2.0,26,4,3,2,9,0xb2d6e1de
500043.05,4.0,31,4,4,2,10,0xb2d5ad35
3503.79,1.0,21,2,2,2,6,0xb2d6ddef
669.76,1.0,16,1,2,2,5,0xb2d6bb3c
260017.53,2.0,39,3,3,2,8,0xb2d60a6e
794870.82,7.0,18,4,4,2,10,0xb2d1b7ed
350474.63,5.0,34,4,4,2,10,0xb2d5ee27
8405.97,1.0,5,2,2,3,7,0xb2d252a6
1900001.03,2.0,22,4,3,2,9,0xb2d9d3cb
2090.79,1.0,184,1,2,1,4,0xb2d19895
15249.54,1.0,0,2,2,4,8,0xb2d420ee
3031.95,1.0,92,2,2,1,5,0xb2d0f8cc
155000.13,5.0,7,3,4,3,10,0xb2d2e9f2
1000.96,2.0,96,1,3,1,5,0xb2d24084
2226.6,1.0,0,1,2,4,7,0xb2d4f831
411260.06,4.0,33,4,4,2,10,0xb2d0b5f7
161005.1,2.0,31,3,3,2,8,0xb2d93582
100192.8,2.0,3,3,3,4,10,0xb2d97943
50002.64,2.0,34,2,3,2,7,0xb2d9f55c
73238.71,1.0,167,3,2,1,6,0xb2d41386d
7226.64,1.0,10,2,2,3,7,0xb2d8e439
147.79,1.0,9,1,2,3,6,0xb2d20d3c
272.33,3.0,0,1,4,4,9,0x3b9b18df
718922.95,4.0,11,4,4,3,11,0xb2d29f03d
200000.0,2.0,1,3,3,4,10,0xb2d8a160
0.0,1.0,63,1,2,2,5,0xb2d9ad3d
1900000.0,9.0,5,4,4,3,11,0xb2d629c6
27.44,1.0,60,1,2,2,5,0xb2d8dffd
301024.61,3.0,136,4,4,1,9,0xb2d537ca
5520.5,1.0,184,2,2,1,5,0xb2d2b0d9
20006.96,3.0,60,2,4,2,8,0xb2d25064
10066.82,2.0,200,2,3,1,6,0x3b9b246b
60.07,1.0,22,1,2,2,5,0xb2d68e9a
33001.55,2.0,130,2,3,1,6,0xb2d41928
74000.78,2.0,32,3,3,2,8,0xb2da01ef
50067.81,2.0,101,2,3,1,6,0xb2d5e566
693836.84,3.0,8,4,4,3,11,0xb2d304e2
180001.65,5.0,6,3,4,3,10,0xb2d39df7
1010153.63,3.0,196,4,4,1,9,0xb2d56931
1358.06,2.0,50,1,3,2,6,0xb2d1b5fc
300012.67,2.0,74,3,3,1,7,0xb2d997e1
7214.21,1.0,2,2,2,4,8,0xb2d39a8d
304554.66,3.0,16,4,4,2,10,0xb2d88191d
3163.78,1.0,10,2,2,3,7,0xb2d6a939
480000.0,4.0,5,4,4,3,11,0xb2da378e
20000.21,2.0,200,2,3,1,6,0xb2d61989
22.19,1.0,0,1,2,4,7,0xb2d48c44
50000.85,4.0,151,2,4,1,7,0xb2d6e9f0
7291.58,1.0,0,2,2,4,8,0xb2d470b9
435.43,1.0,11,1,2,3,6,0xb2d68f07
95.96,1.0,10,1,2,3,6,0xb2d2728bd
1670118.24,19.0,10,4,4,3,11,0xb2d107bd
1535825.69,11.0,6,4,4,3,11,0xb2d5f692
80002.85,2.0,92,3,3,1,7,0xb2d149c9
580022.15,3.0,108,4,4,1,9,0xb2d68a3dd
664.41,2.0,0,1,3,4,8,0xb2d09d88
530752.0,10.0,0,4,4,4,12,0xb2d11429
45171.21,2.0,4,2,3,4,9,0xb2d62fdc
108.13,4.0,0,1,4,4,9,0x3b9b100d
50009.96,2.0,92,2,3,1,6,0xb2d49f6f
1793.24,1.0,222,1,2,1,4,0xb2d2e7ab
350004.18,3.0,6,4,4,3,11,0xb2d500f7
4112.63,1.0,9,2,2,3,7,0xb2d4e130
4629.82,1.0,10,2,2,3,7,0xb2d2d9f7
141801.97,2.0,35,3,3,2,8,0xb2d91a50
513.03,1.0,0,1,2,4,7,0xb2d151f7
22145.93,1.0,3,2,2,4,8,0xb2d34327d
1073214.64,12.0,2,4,4,4,12,0xb2d310c1
12193.04,1.0,4,2,2,4,8,0xb2d242a5
17366.52,1.0,15,2,2,3,7,0xb2d94896
545680.0,3.0,14,4,4,3,11,0xb2d10ff9
100006.6,3.0,60,3,4,2,9,0xb2d5c76d
500000.0,2.0,7,4,3,3,10,0xb2d96f62
239.69,1.0,4,1,2,4,7,0xb2d67dd5
1036.26,1.0,184,1,2,1,4,0xb2d1da81
94.74,1.0,6,1,2,3,6,0xb2d26f3a
5267.81,1.0,92,2,2,1,5,0xb2d221b0
20108.62,2.0,0,2,3,4,9,0xb2d85835
6.31,1.0,6,1,2,3,6,0xb2d62f28
300007.5,2.0,21,3,3,2,8,0xb2d69314
104115.14,2.0,0,3,3,4,10,0xb2d549a6
1003.26,1.0,92,1,2,1,4,0xb2d5ebca
2.01,1.0,80,1,2,1,4,0xb2d91867
0.18,1.0,14,1,2,3,6,0xb2d67e97
29460365.17,28.0,18,4,4,2,10,0xb2d179f6
5682.52,1.0,21,2,2,2,6,0xb2d512e2
148897.82,4.0,4,3,4,4,11,0xb2d65e45
15577.82,1.0,1,2,2,4,8,0xb2d59911
70012.51,3.0,62,3,4,2,9,0xb2d5c03a
50001.06,2.0,39,2,3,2,7,0xb2d9e812
100008.97,3.0,55,3,4,2,9,0xb2d9a5bb
520018.46,4.0,12,4,4,3,11,0xb2d63895d
1505.17,1.0,9,1,2,3,6,0xb2d5647a
2056.72,1.0,184,1,2,1,4,0xb2d283c5
2.52,1.0,9,1,2,3,6,0xb2d4079b
1014.66,1.0,92,1,2,1,4,0xb2d13d42d
505054.58,2.0,27,4,3,2,9,0xb2d57066
371404.84,3.0,1,4,4,4,12,0xb2d0f1db
50040.57,2.0,101,2,3,1,6,0xb2d21879
60000.0,1.0,6,3,2,3,8,0xb2da2765
11890.56,1.0,21,2,2,2,6,0xb2d94fe5
1000054.14,3.0,259,4,4,1,9,0xb2d3f77d
6061.33,1.0,184,2,2,1,5,0xb2d2b282
0.0,1.0,1,1,2,4,7,0xb2d92e37
1466879.74,14.0,1,4,4,4,12,0xb2d12e27
332455.89,7.0,0,4,4,4,12,0xb2d59dc1
701848.04,4.0,4,4,4,4,12,0xb2d55e23
980002.55,4.0,66,4,4,2,10,0xb2d13378
2549664.69,3.0,256,4,4,1,9,0x3b9b26ed
136005.3,3.0,116,3,4,1,8,0xb2d5c589
831155.25,6.0,1,4,4,4,12,0xb2d5995b
261452.15,5.0,0,3,4,4,11,0x3b9b2fe4
120306.68,4.0,83,3,4,1,8,0xb2d5e821
230000.0,1.0,1,3,2,4,9,0xb2da5a97
872867.54,9.0,4,4,4,4,12,0xb2d0ecb8
3576.32,1.0,92,2,2,1,5,0xb2d48e5e
131450.52,1.0,7,3,2,3,8,0xb2d2158ad
21155.65,1.0,35,2,2,2,6,0xb2d3c4f0
8073.61,1.0,92,2,2,1,5,0xb2d2a883d
23987.2,1.0,6,2,2,3,7,0xb2d9d3e6
408540.62,6.0,6,4,4,3,11,0xb2d06729
1304572.05,4.0,99,4,4,1,9,0xb2d1b6a4
16568.49,2.0,32,2,3,2,7,0xb2d9f2d4
140000.0,1.0,1,3,2,4,9,0xb2d8c4f8d
634.15,1.0,1,1,2,4,7,0xb2d28f46
40000.0,3.0,4,2,4,4,10,0xb2d5c6ed
1236000.0,6.0,6,4,4,3,11,0xb2d0c6be
1460000.0,9.0,0,4,4,4,12,0xb2d78e6a
237.05,1.0,2,1,2,4,7,0xb2d685c2
124.92,1.0,0,1,2,4,7,0xb2d43e57
3328.49,1.0,184,2,2,1,5,0x3b9af413
2460.74,1.0,31,1,2,2,5,0xb2d657ead
4005.93,1.0,1,2,2,4,8,0xb2d70445d
300007.25,3.0,74,3,4,1,8,0xb2d0dbda
134622.71,1.0,4,3,2,4,9,0xb2d3aab5
508014.32,5.0,27,4,4,2,10,0xb2d6d5d1
2030.46,1.0,184,1,2,1,4,0xb2d25ffd
12.76,1.0,72,1,2,1,4,0xb2d91781
1.59,1.0,1,1,2,4,7,0xb2d8c3d9
2048.07,1.0,29,1,2,2,5,0xb2d1f36f
517.42,1.0,10,1,2,3,6,0xb2d086e6
200013.59,2.0,0,3,3,4,10,0xb2d935bf
50008.76,2.0,27,2,3,2,7,0xb2da04c6
61.96,1.0,7,1,2,3,6,0xb2d2e2b2
6137595.83,2.0,59,4,3,2,9,0xb2d55ae6
52135.98,2.0,33,2,3,2,7,0xb2d176da
7260.24,1.0,0,2,2,4,8,0xb2d324d6
17.9,1.0,86,1,2,1,4,0xb2d42c82
3744.05,2.0,18,2,3,2,7,0xb2d08138
3593.03,1.0,10,2,2,3,7,0xb2d68217
4545.29,1.0,11,2,2,3,7,0xb2d3bc53d
208430.79,2.0,23,3,3,2,8,0xb2d3525a
162325.15,6.0,4,3,4,4,11,0xb2d5c646
10001.51,2.0,18,2,3,2,7,0xb2d95870
220017.54,4.0,79,3,4,1,8,0xb2d59f59
50087.98,2.0,143,2,3,1,6,0xb2d2ff9b
39.37,1.0,10,1,2,3,6,0xb2d93350
11928.71,1.0,7,2,2,3,7,0xb2d5cefc
55167.54,2.0,3,3,3,4,10,0xb2d4f5d9
6952.81,1.0,133,2,2,1,5,0xb2d6ec47
1240.06,1.0,9,1,2,3,6,0xb2d350bb
300531.57,4.0,28,4,4,2,10,0xb2d1a740
110644.78,5.0,0,3,4,4,11,0xb2d06751d
4121.47,1.0,10,2,2,3,7,0xb2d39173
3003.86,1.0,27,2,2,2,6,0xb2d1b287
20906.94,1.0,10,2,2,3,7,0xb2d2eeb9
379075.45,5.0,55,4,4,2,10,0xb2d1ef86
3708.48,1.0,0,2,2,4,8,0xb2d956fd
391092.87,4.0,7,4,4,3,11,0xb2d86ec0
3861.08,3.0,5,2,4,3,9,0x3b9b17e7
200000.0,2.0,4,3,3,4,10,0xb2d9ffa8
50003.74,2.0,110,2,3,1,6,0xb2d63531
1903.64,1.0,178,1,2,1,4,0xb2d2754a
3.16,1.0,27,1,2,2,5,0xb2d6bcdc
12.67,1.0,77,1,2,1,4,0xb2d989cf
13410.14,1.0,25,2,2,2,6,0xb2d907c2d
50003.34,2.0,216,2,3,1,6,0xb2d1d25d
217895.78,4.0,69,3,4,1,8,0xb2d2bf67d
194996.63,1.0,92,3,2,1,6,0x3b9b268c
4218.58,1.0,1,2,2,4,8,0xb2d68c5dd
70115.71,4.0,27,3,4,2,9,0xb2d32571
216070.28,2.0,216,3,3,1,7,0xb2d22340
204.21,1.0,0,1,2,4,7,0xb2d8f933
350000.24,2.0,21,4,3,2,9,0xb2d90df7d
14056.52,1.0,92,2,2,1,5,0x3b9b3ed7
186001.97,3.0,25,3,4,2,9,0xb2d9cf2f
10000.32,2.0,53,2,3,2,7,0xb2d95127
452.23,3.0,15,1,4,3,8,0x3b9b12a6
180001.48,8.0,111,3,4,1,8,0xb2d63cc6
8.16,1.0,13,1,2,3,6,0xb2d63daa
467.04,1.0,39,1,2,2,5,0xb2d4c898
0.0,1.0,1,1,2,4,7,0xb2d563add
50022.65,1.0,1,2,2,4,8,0xb2da681a
310091.46,4.0,11,4,4,3,11,0xb2d931f8
3018.01,1.0,92,2,2,1,5,0xb2d30a6e
15160.08,1.0,0,2,2,4,8,0xb2d43a06d
560009.72,3.0,144,4,4,1,9,0xb2d63f3bd
372519.46,3.0,1,4,4,4,12,0xb2d5af83
200046.0,2.0,5,3,3,3,9,0xb2d59917
7386.78,2.0,4,2,3,4,9,0xb2d29649
1062007.01,7.0,3,4,4,4,12,0xb2d3a5f2
156004.65,3.0,19,3,4,2,9,0xb2d24ffe
1570102.23,4.0,15,4,4,3,11,0xb2d157d3
528039.85,2.0,30,4,3,2,9,0xb2d23114
356708.53,2.0,139,4,3,1,8,0xb2d67a48
10502.64,2.0,25,2,3,2,7,0xb2d9a8e2
450000.0,2.0,17,4,3,2,9,0xb2d9e0cf
450008.28,5.0,8,4,4,3,11,0xb2da0f68
10705.99,1.0,0,2,2,4,8,0xb2d68f37
400000.0,2.0,5,4,3,3,10,0xb2d97671
301162.79,2.0,27,4,3,2,9,0xb2d93ea2d
1250095.92,5.0,12,4,4,3,11,0xb2d55d80
208000.27,5.0,0,3,4,4,11,0xb2d5fd18
106545.47,2.0,35,3,3,2,8,0xb2d48ccd
179168.49,4.0,70,3,4,1,8,0xb2d39347
569159.6,8.0,17,4,4,2,10,0xb2d622b3
3830000.0,5.0,54,4,4,2,10,0xb2d6c805
1244.94,1.0,184,1,2,1,4,0xb2d38552
113553.29,2.0,82,3,3,1,7,0xb2d37ba1
11496.0,1.0,172,2,2,1,5,0xb2d2a752
6.79,1.0,48,1,2,2,5,0xb2d56d60
4042.09,1.0,184,2,2,1,5,0xb2d29cc9
1461.63,1.0,92,1,2,1,4,0xb2d4d0c3
1013.45,1.0,92,1,2,1,4,0xb2d3aece
510625.38,2.0,6,4,3,3,10,0xb2d31d9dd
479.8,1.0,8,1,2,3,6,0xb2d30149d
508368.26,7.0,8,4,4,3,11,0xb2d0ca5f
16427.87,2.0,15,2,3,3,8,0xb2d081e7d
5384.97,1.0,0,2,2,4,8,0xb2d48b3a
22.59,1.0,14,1,2,3,6,0xb2d51ca9
1072.19,10.0,92,1,4,1,6,0xb2d1e471
46926.56,1.0,0,2,2,4,8,0xb2d54b25
151541.33,3.0,0,3,4,4,11,0xb2d539e5
9.49,1.0,11,1,2,3,6,0xb2d37ceb
22.37,1.0,6,1,2,3,6,0xb2d9fc4c
2066.85,3.0,22,1,4,2,7,0x3b9b1ac5
60009.1,2.0,59,3,3,2,8,0xb2d34a55
3.34,1.0,44,1,2,2,5,0xb2d3b1cd
50000.53,2.0,83,2,3,1,6,0xb2d987c4
50000.57,2.0,25,2,3,2,7,0xb2da0f0d
116002.42,2.0,87,3,3,1,7,0xb2d233b5
405144.1,6.0,4,4,4,4,12,0xb2d6846d
500000.0,2.0,28,4,3,2,9,0xb2da0d6b
80461.82,2.0,108,3,3,1,7,0xb2d5099e
4003.3,1.0,62,2,2,2,6,0xb2d8f1a7
868008.53,7.0,1,4,4,4,12,0xb2d504f6d
22195.99,1.0,9,2,2,3,7,0xb2d4d1a8
75012.98,2.0,83,3,3,1,7,0xb2d2ad57
274457.49,5.0,18,3,4,2,9,0xb2d2794d
50605.12,2.0,59,2,3,2,7,0xb2d53f3c
601010.05,4.0,3,4,4,4,12,0xb2d91348d
200085.42,3.0,20,3,4,2,9,0xb2d2b146
279039.57,2.0,69,3,3,1,7,0xb2d0c441
395032.59,5.0,6,4,4,3,11,0xb2d6c6db
215.97,1.0,9,1,2,3,6,0xb2d55ef6
302331.56,2.0,18,4,3,2,9,0xb2d9b7d6
1315.59,1.0,6,1,2,3,6,0xb2d29235
133007.74,4.0,210,3,4,1,8,0xb2d56160d
31192.5,1.0,119,2,2,1,5,0xb2d56e53
30863.55,3.0,3,2,4,4,10,0xb2d2bd44
100005.28,2.0,56,3,3,2,8,0xb2d576b7
107.51,1.0,61,1,2,2,5,0xb2d4c23f
120001.27,2.0,8,3,3,3,9,0xb2da4a22
300011.08,2.0,144,3,3,1,7,0xb2d4c80d
244041.58,3.0,208,3,4,1,8,0xb2d23f53
6.59,1.0,8,1,2,3,6,0xb2d6318f
454025.97,3.0,7,4,4,3,11,0xb2d53c54
30000.32,2.0,27,2,3,2,7,0xb2d940e4
17.2,1.0,42,1,2,2,5,0xb2d2fffed
135.92,1.0,71,1,2,1,4,0xb2d5a773
130031.14,4.0,4,3,4,4,11,0xb2d23992
121296.39,2.0,12,3,3,3,9,0xb2d8f19e
251438.19,6.0,3,3,4,4,11,0xb2d29f22
1.58,1.0,88,1,2,1,4,0xb2d8c374
100004.22,2.0,21,3,3,2,8,0xb2da1afd
10002.16,2.0,59,2,3,2,7,0xb2d5dcd0
2885.08,1.0,168,1,2,1,4,0xb2d5cf9b
1000103.85,2.0,97,4,3,1,8,0xb2d158e6
105344.25,2.0,148,3,3,1,7,0xb2d4302e
60002.18,3.0,46,3,4,2,9,0xb2d4c98d
530083.76,4.0,6,4,4,3,11,0xb2d6c054
230077.93,2.0,16,3,3,2,8,0xb2da201a
20293.21,2.0,172,2,3,1,6,0xb2d5bcd5
14868.98,1.0,10,2,2,3,7,0xb2d4cf85d
12287.32,5.0,48,2,4,2,8,0xb2d910f9
30702.06,2.0,74,2,3,1,6,0xb2d5bb30
30001.58,2.0,33,2,3,2,7,0xb2d914ae
181720.83,3.0,11,3,4,3,10,0xb2d5a1cd
158.34,1.0,9,1,2,3,6,0xb2d593c3
174551.56,3.0,35,3,4,2,9,0xb2d5ad53
106.43,1.0,3,1,2,4,7,0xb2d68670
3056.22,1.0,14,2,2,3,7,0xb2d4bb35d
100086.15,2.0,147,3,3,1,7,0xb2d3cf02
3000155.4,3.0,25,4,4,2,10,0x3b9b4733d
1000000.72,15.0,0,4,4,4,12,0xb2d428a6
1179.64,1.0,92,1,2,1,4,0xb2d4e579
80001.69,2.0,67,3,3,1,7,0xb2d9add4
40002.21,2.0,92,2,3,1,6,0xb2d1aefe
20448.42,1.0,16,2,2,2,6,0xb2d59bb8
40000.42,2.0,92,2,3,1,6,0xb2d64336
760571.53,5.0,14,4,4,3,11,0xb2d124f4
0.0,1.0,1,1,2,4,7,0xb2d653fa
69.54,1.0,19,1,2,2,5,0xb2da0c39
536.55,1.0,7,1,2,3,6,0xb2d388ed
2.43,1.0,77,1,2,1,4,0xb2d16726
1222149.39,8.0,0,4,4,4,12,0xb2d329b7
5000000.0,2.0,0,4,3,4,11,0xb2da6c77
80042.96,2.0,136,3,3,1,7,0xb2d53c91
0.0,1.0,0,1,2,4,7,0xb2d937d0
217448.87,4.0,11,3,4,3,10,0xb2d0f2dc
412020.04,1.0,0,4,2,4,10,0xb2da0c6b
161.76,1.0,58,1,2,2,5,0xb2d787d4
263065.41,3.0,92,3,4,1,8,0xb2d57f74d
2045000.04,13.0,6,4,4,3,11,0xb2d6b6a2
36711.57,1.0,50,2,2,2,6,0xb2d6bb83
60053.63,2.0,35,3,3,2,8,0xb2d2dc28
500076.06,2.0,15,4,3,3,10,0xb2d9c997
13157.74,1.0,10,2,2,3,7,0xb2d327c0
51815.69,2.0,252,2,3,1,6,0xb2d2c2d2
125183.9,1.0,3,3,2,4,9,0xb2d102e0
100002.11,2.0,67,3,3,1,7,0xb2d9ad77
40956.4,1.0,18,2,2,2,6,0xb2d6bf71
110906.82,1.0,4,3,2,4,9,0xb2d37693
10000.11,2.0,76,2,3,1,6,0xb2d8dcbd
50007.31,2.0,82,2,3,1,6,0xb2d68128
33.79,1.0,59,1,2,2,5,0xb2d5be24
238041.56,4.0,19,3,4,2,9,0xb2d56f50
1038604.56,5.0,137,4,4,1,9,0xb2d0e607
527021.37,7.0,18,4,4,2,10,0xb2d60598
13330.28,1.0,9,2,2,3,7,0xb2d3192b
50001.75,2.0,80,2,3,1,6,0xb2d637c5d
580036.75,4.0,5,4,4,3,11,0xb2d6054f
413721.17,3.0,22,4,4,2,10,0xb2d9ce10
1720019.54,3.0,41,4,4,2,10,0xb2d0da8e
4490.23,1.0,101,2,2,1,5,0xb2d486dad
3373.05,1.0,2,2,2,4,8,0xb2d90805
50000.0,1.0,8,2,2,3,7,0xb2da5035
224316.58,10.0,0,3,4,4,11,0xb2d0a03f
1085.61,1.0,135,1,2,1,4,0xb2d3a623
585259.88,3.0,0,4,4,4,12,0xb2d6eef0
44565.29,3.0,0,2,4,4,10,0xb2d539ef
13663.29,1.0,21,2,2,2,6,0xb2d8ecec
7752.69,1.0,0,2,2,4,8,0xb2d6a770
43.82,1.0,61,1,2,2,5,0xb2d56110
1052347.94,2.0,1,4,3,4,11,0xb2d65c46d
211461.37,3.0,20,3,4,2,9,0xb2d6bcb1
126.31,2.0,62,1,3,2,6,0xb2d06d33
887.56,1.0,19,1,2,2,5,0xb2d69afc
22835.66,1.0,19,2,2,2,6,0xb2d58c79d
103952.4,2.0,4,3,3,4,10,0xb2d687fe
2000206.36,2.0,80,4,3,1,8,0xb2d29025d
555010.24,7.0,80,4,4,1,9,0xb2d20bd3
404408.05,3.0,1,4,4,4,12,0xb2d1539c
421979.39,3.0,0,4,4,4,12,0xb2d57408d
1556.98,1.0,3,1,2,4,7,0xb2d0c840d
502716.87,5.0,43,4,4,2,10,0xb2d765f6
1000624.58,4.0,5,4,4,3,11,0xb2d5cb6f
270923.68,4.0,20,3,4,2,9,0xb2d6e407
73.15,1.0,51,1,2,2,5,0xb2d6c4bc
832616.34,6.0,0,4,4,4,12,0xb2d8ee52
9457.54,1.0,0,2,2,4,8,0xb2d6bd7d
84479.28,6.0,1,3,4,4,11,0xb2d68a3f
2.85,1.0,24,1,2,2,5,0xb2d1ba8e
70032.25,2.0,62,3,3,2,8,0xb2d1b340
1.18,1.0,6,1,2,3,6,0xb2d56a3d
250005.29,6.0,161,3,4,1,8,0xb2d8e935
6529.32,1.0,96,2,2,1,5,0xb2d1bf90
68.13,1.0,7,1,2,3,6,0xb2d24532
3240075.22,17.0,7,4,4,3,11,0xb2d0cbc8
1250036.95,3.0,6,4,4,3,11,0xb2d8f9ddd
106081.04,35.0,104,3,4,1,8,0x3b9b4256
1646.72,1.0,8,1,2,3,6,0xb2d2c1dd
416058.1,2.0,172,4,3,1,8,0xb2d28433
1269.45,1.0,292,1,2,1,4,0xb2d5ca09
601052.64,7.0,6,4,4,3,11,0xb2d958c4
7488.66,1.0,17,2,2,2,6,0xb2d6c47a
28083.68,1.0,0,2,2,4,8,0xb2d5bf2e
132.15,1.0,7,1,2,3,6,0xb2d3dcc1
201421.04,2.0,37,3,3,2,8,0xb2d8f1de
264.92,1.0,45,1,2,2,5,0xb2d3133d
3879.46,1.0,0,2,2,4,8,0xb2d51b57
62.19,1.0,78,1,2,1,4,0xb2d14033
40000.84,2.0,92,2,3,1,6,0xb2d67dd0
320063.93,2.0,6,4,3,3,10,0xb2d0c63ad
10000.42,2.0,21,2,3,2,7,0xb2da1ac1
193887.81,3.0,186,3,4,1,8,0xb2d0ee84
250499.37,3.0,3,3,4,4,11,0xb2d96b07d
1994.59,1.0,184,1,2,1,4,0xb2d34358
215837.3,2.0,60,3,3,2,8,0xb2d3c4b0d
270476.47,5.0,6,3,4,3,10,0xb2d209e5
8.53,1.0,72,1,2,1,4,0xb2d58225d
50032.42,2.0,21,2,3,2,7,0xb2d45bd0
328166.93,3.0,32,4,4,2,10,0xb2d50a30
405918.18,8.0,18,4,4,2,10,0xb2d1812a
300006.33,2.0,53,3,3,2,8,0xb2d9ce31
280052.76,3.0,11,3,4,3,10,0xb2d9050a
511181.86,7.0,26,4,4,2,10,0xb2d395dd
251519.43,2.0,4,3,3,4,10,0xb2d0daac
5788.78,1.0,7,2,2,3,7,0xb2d23297d
650011.33,6.0,19,4,4,2,10,0xb2d1d68a
213763.02,2.0,21,3,3,2,8,0xb2d392ac
300000.0,2.0,20,3,3,2,8,0xb2d953f8
650017.52,3.0,14,4,4,3,11,0xb2d9bdcf
2042.17,1.0,21,1,2,2,5,0xb2d3b6de
2260095.8,4.0,0,4,4,4,12,0xb2d22db6
211570.87,2.0,143,3,3,1,7,0xb2d40fa2d
451787.84,3.0,10,4,4,3,11,0xb2d4ff8a
22775.16,1.0,10,2,2,3,7,0xb2d59a22
765034.02,8.0,0,4,4,4,12,0x3b9b17f7
97.46,1.0,7,1,2,3,6,0xb2d62627d
262085.06,4.0,101,3,4,1,8,0xb2d1a20b
34.86,6.0,22,1,4,2,7,0xb2d91b53
321361.5,3.0,43,4,4,2,10,0xb2d5c47c
530220.65,3.0,97,4,4,1,9,0xb2d378b2
52140.26,2.0,0,2,3,4,9,0xb2d2b77c
50006.69,3.0,90,2,4,1,7,0xb2d5b6f0
2645.09,1.0,92,1,2,1,4,0xb2d612ac
527274.65,5.0,24,4,4,2,10,0xb2d17ab5
2661.83,1.0,0,1,2,4,7,0xb2d6a684
5925.6,14.0,0,2,4,4,10,0xb2d073e6
400000.0,2.0,4,4,3,4,11,0xb2da5988
800972.88,5.0,13,4,4,3,11,0xb2d56385
80.6,1.0,17,1,2,2,5,0xb2d6c27a
0.0,1.0,6,1,2,3,6,0xb2d9036b
30000.64,2.0,192,2,3,1,6,0xb2d6a382
200896.49,2.0,22,3,3,2,8,0xb2d6a97f
806078.21,12.0,18,4,4,2,10,0xb2d65d51
300087.39,3.0,8,3,4,3,10,0xb2d9d4fb
1878.06,1.0,92,1,2,1,4,0xb2d31e1c
0.0,1.0,0,1,2,4,7,0xb2d957e1
11773.04,1.0,0,2,2,4,8,0xb2d5d79d
810016.03,5.0,1,4,4,4,12,0xb2d64171
93.4,1.0,32,1,2,2,5,0xb2d7ed9f
17672.64,1.0,0,2,2,4,8,0xb2d33db4
250335.22,5.0,3,3,4,4,11,0xb2d6d8c7
1028896.46,2.0,41,4,3,2,9,0xb2d567e6d
1681.11,1.0,19,1,2,2,5,0xb2d6c240
60023.69,2.0,69,3,3,1,7,0xb2d235ff
115017.99,3.0,31,3,4,2,9,0xb2d3ec04
420174.05,10.0,6,4,4,3,11,0xb2d08614d
1063.42,1.0,184,1,2,1,4,0x3b9b286e
65.61,1.0,80,1,2,1,4,0xb2d912f3
271.02,1.0,5,1,2,3,6,0xb2d8c455
815545.37,3.0,64,4,4,2,10,0xb2d6344c
0.0,1.0,1,1,2,4,7,0xb2d22372
81.54,1.0,0,1,2,4,7,0xb2d5a18ed
640764.32,4.0,25,4,4,2,10,0xb2d60ebc
63.32,1.0,1,1,2,4,7,0xb2d955cb
211.11,1.0,20,1,2,2,5,0xb2d94011
156004.31,6.0,17,3,4,2,9,0xb2d61f79
90050.62,2.0,76,3,3,1,7,0xb2d8d737
1315.6,1.0,267,1,2,1,4,0xb2d33985
4.04,1.0,41,1,2,2,5,0xb2d635d1
1270982.38,6.0,8,4,4,3,11,0xb2d6c417d
220004.32,5.0,42,3,4,2,9,0xb2d64a8f
1893571.96,6.0,6,4,4,3,11,0xb2d179d8
15.82,1.0,5,1,2,3,6,0xb2d213b5
1801073.32,10.0,13,4,4,3,11,0xb2d43ee1
102323.08,2.0,92,3,3,1,7,0xb2d68971
168053.1,5.0,24,3,4,2,9,0xb2d5e743
403302.49,2.0,67,4,3,1,8,0xb2d5c1dc
7217.11,1.0,0,2,2,4,8,0xb2d1deb8
500052.25,2.0,12,4,3,3,10,0xb2d9966c
250000.0,2.0,18,3,3,2,8,0xb2d95aab
474511.67,5.0,18,4,4,2,10,0xb2d1a667
600000.0,2.0,12,4,3,3,10,0xb2da48f0
155192.39,2.0,14,3,3,3,9,0xb2d504fd
5460.34,1.0,133,2,2,1,5,0xb2d26c0f
900004.7,3.0,3,4,4,4,12,0xb2d4491a
1891.94,1.0,179,1,2,1,4,0xb2d0cdbbd
76.67,1.0,14,1,2,3,6,0xb2d685c0
392917.68,3.0,22,4,4,2,10,0xb2d41076
4.27,1.0,20,1,2,2,5,0xb2d454b9
0.52,1.0,0,1,2,4,7,0xb2d8e8ae
30002.91,2.0,0,2,3,4,9,0xb2d8d5acd
16567.53,1.0,4,2,2,4,8,0xb2d71875
16267.11,3.0,40,2,4,2,8,0x3b9af486d
50011.93,2.0,41,2,3,2,7,0xb2d4c14bd
50002.11,2.0,92,2,3,1,6,0xb2d65d52
3.97,1.0,35,1,2,2,5,0xb2d48212
71007.7,4.0,73,3,4,1,8,0xb2d59325
80002.78,3.0,74,3,4,1,8,0xb2d6257c
1005.02,1.0,91,1,2,1,4,0xb2d65084
3436220.23,19.0,11,4,4,3,11,0xb2d5858fd
116168.14,3.0,7,3,4,3,10,0xb2d5cd2c
29066.68,1.0,0,2,2,4,8,0xb2d69039d
373.35,1.0,26,1,2,2,5,0xb2d2bfe3
796577.25,7.0,8,4,4,3,11,0xb2d6bdba
6.0,1.0,0,1,2,4,7,0xb2d3ebc8
490000.24,1.0,4,4,2,4,10,0xb2da2379
150020.6,2.0,2,3,3,4,10,0xb2d312c3
210988.98,5.0,0,3,4,4,11,0xb2d35f49
2.88,1.0,5,1,2,3,6,0xb2d991b3
14150.34,1.0,5,2,2,3,7,0xb2d3ab6a
12924.12,1.0,0,2,2,4,8,0xb2d6b69ed
2.77,1.0,73,1,2,1,4,0xb2d8c96b
6.15,1.0,57,1,2,2,5,0xb2d6e704
4186.95,1.0,0,2,2,4,8,0xb2d2036f
270.18,1.0,13,1,2,3,6,0xb2d68deb
16.1,1.0,16,1,2,2,5,0xb2d5e3d8
51029.03,2.0,122,2,3,1,6,0xb2d64059d
192918.85,3.0,172,3,4,1,8,0xb2d288ed
619.98,1.0,72,1,2,1,4,0xb2d2bc58
6196.73,1.0,1,2,2,4,8,0xb2d9ad9c
20662.16,1.0,48,2,2,2,6,0xb2d4f753
51.47,1.0,2,1,2,4,7,0xb2d68eca
500028.24,3.0,22,4,4,2,10,0xb2d94ecf
278174.54,13.0,0,3,4,4,11,0xb2d3eea3
300010.99,1.0,0,3,2,4,9,0xb2d5cc31
388012.05,6.0,66,4,4,2,10,0xb2d81635
500014.15,5.0,63,4,4,2,10,0xb2d080f7
106089.78,1.0,5,3,2,3,8,0xb2d0e625
6254.54,1.0,82,2,2,1,5,0xb2d96759
2017.59,1.0,92,1,2,1,4,0xb2d2b25b
210028.34,3.0,25,3,4,2,9,0xb2d43cdd
110089.74,2.0,101,3,3,1,7,0xb2d7ec14
7542.52,1.0,1,2,2,4,8,0xb2d2fd83
4688.25,1.0,17,2,2,2,6,0xb2d6c672
303321.45,8.0,3,4,4,4,12,0xb2d2425b
3.95,1.0,48,1,2,2,5,0xb2d0cd64
425073.18,2.0,4,4,3,4,11,0xb2d8d9a9
1284.16,1.0,186,1,2,1,4,0xb2d0efbe
53004.98,2.0,129,3,3,1,7,0xb2d288a2
1000432.89,2.0,80,4,3,1,8,0xb2d53d0c
900154.9,4.0,104,4,4,1,9,0xb2d174d8
29005.16,1.0,0,2,2,4,8,0xb2d331d6
1469855.57,4.0,2,4,4,4,12,0xb2d132a0
10000.53,2.0,30,2,3,2,7,0xb2d9cc85
366133.77,2.0,3,4,3,4,11,0xb2d86814d
831033.95,6.0,10,4,4,3,11,0xb2d113d5
21516.66,1.0,8,2,2,3,7,0xb2d9d2d9
307030.56,4.0,11,4,4,3,11,0xb2d46ea6d
1176124.49,9.0,87,4,4,1,9,0xb2d240d9
608572.26,3.0,83,4,4,1,9,0xb2d78c04
634.68,1.0,13,1,2,3,6,0xb2d64ac3
1103.51,1.0,230,1,2,1,4,0xb2d29ecc
261740.2,5.0,21,3,4,2,9,0xb2d246eb
1157.04,1.0,8,1,2,3,6,0xb2d36fd5
230000.0,2.0,15,3,3,3,9,0xb2d9afaf
11537.57,1.0,13,2,2,3,7,0xb2d8da52d
409945.52,3.0,0,4,4,4,12,0xb2d2380c
140466.28,1.0,3,3,2,4,9,0xb2d6060a
2.32,1.0,75,1,2,1,4,0xb2d8dd91
760.26,1.0,1,1,2,4,7,0xb2d23ad9
37.91,1.0,27,1,2,2,5,0xb2d349e7
1241.7,1.0,132,1,2,1,4,0xb2d5ac78
8400.0,1.0,18,2,2,2,6,0xb2d95992
451559.61,4.0,13,4,4,3,11,0xb2d62a82
55977.45,1.0,0,3,2,4,9,0xb2d696f7
286.91,1.0,0,1,2,4,7,0xb2d4c802
50010.96,2.0,175,2,3,1,6,0xb2d1ad9a
130122.94,3.0,83,3,4,1,8,0xb2d56a6a
1384.55,1.0,92,1,2,1,4,0xb2d2d521
785.65,2.0,35,1,3,2,6,0xb2d06ace
7991.0,1.0,0,2,2,4,8,0xb2d25ed5
10053.58,1.0,21,2,2,2,6,0xb2d220da
10141.64,1.0,184,2,2,1,5,0xb2d29957
8430000.0,2.0,40,4,3,2,9,0xb2d9d0a1
1563.4,1.0,184,1,2,1,4,0xb2d3326d
1800043.68,9.0,7,4,4,3,11,0xb2d0849ed
19045.88,1.0,84,2,2,1,5,0xb2d392c3d
470057.11,4.0,3,4,4,4,12,0xb2d0cc14d
0.0,1.0,5,1,2,3,6,0xb2d37c34
25.33,1.0,48,1,2,2,5,0xb2d97489
150012.77,2.0,173,3,3,1,7,0xb2d78635
200310.84,2.0,0,3,3,4,10,0xb2d8f725
2175.44,1.0,3,1,2,4,7,0xb2d30a91
550.13,2.0,92,1,3,1,5,0x3b9ae42f
230006.03,2.0,32,3,3,2,8,0xb2d23c41
60045.61,2.0,192,3,3,1,7,0xb2d3a8c2
23590.74,1.0,1,2,2,4,8,0xb2d31082
13924.94,1.0,4,2,2,4,8,0xb2d35812
2092.61,2.0,0,1,3,4,8,0xb2d07fb6
500085.35,2.0,25,4,3,2,9,0xb2d46837
461339.15,2.0,108,4,3,1,8,0xb2d6acf5
711571.49,4.0,0,4,4,4,12,0xb2d52ea5
10070.86,1.0,0,2,2,4,8,0xb2d4efd0
0.0,1.0,45,1,2,2,5,0xb2d5ad14
360079.6,2.0,74,4,3,1,8,0xb2d4f5ab
200000.0,2.0,12,3,3,3,9,0xb2d965ffd
8354.79,1.0,6,2,2,3,7,0xb2d627ce
7104.79,1.0,8,2,2,3,7,0xb2d8cd1b
10162.89,2.0,0,2,3,4,9,0xb2d09d85
210000.0,2.0,4,3,3,4,10,0xb2d97b61d
1335.57,1.0,95,1,2,1,4,0xb2d47cca
915241.21,3.0,148,4,4,1,9,0xb2d11a18
417613.33,2.0,13,4,3,3,10,0xb2d53f0ed
0.0,1.0,0,1,2,4,7,0xb2d62f57
896093.54,7.0,0,4,4,4,12,0xb2d2408b
30937.54,2.0,1,2,3,4,9,0xb2d5e994
500005.28,3.0,18,4,4,2,10,0xb2d40bf5
302131.86,2.0,82,4,3,1,8,0xb2d8d66e
111001.17,3.0,6,3,4,3,10,0xb2da4cc1
230045.94,2.0,147,3,3,1,7,0xb2d16f2dd
61.98,1.0,76,1,2,1,4,0xb2d22b96
17093.59,1.0,10,2,2,3,7,0xb2d4460f
500013.29,2.0,80,4,3,1,8,0xb2d9903c
863303.89,2.0,184,4,3,1,8,0x3b9b19d5
50011.37,2.0,208,2,3,1,6,0xb2d0cf2ad
99933.59,2.0,1,3,3,4,10,0xb2d93749
200192.0,2.0,0,3,3,4,10,0xb2da10e3
15077.9,1.0,184,2,2,1,5,0xb2d531ad
3.78,1.0,18,1,2,2,5,0xb2d36201
231018.21,1.0,119,3,2,1,6,0xb2d4f13d
190000.0,5.0,10,3,4,3,10,0xb2d63cc6d
20089.06,2.0,17,2,3,2,7,0xb2d5c88d
2047.0,1.0,0,1,2,4,7,0xb2d6f2c5
257.62,1.0,17,1,2,2,5,0xb2d251bd
3250.05,1.0,0,2,2,4,8,0xb2d8d990d
19374.34,1.0,25,2,2,2,6,0xb2d2585d
135124.95,7.0,11,3,4,3,10,0xb2d3cf4ed
1186.84,1.0,184,1,2,1,4,0xb2d2d620d
35572.04,1.0,5,2,2,3,7,0xb2d60fb8d
70000.13,2.0,3,3,3,4,10,0xb2d62193
302003.51,15.0,20,4,4,2,10,0xb2d07825d
100004.26,2.0,20,3,3,2,8,0xb2d29e72
200001.65,2.0,26,3,3,2,8,0xb2d727c7
5074.07,1.0,85,2,2,1,5,0xb2d6d5c5
200000.0,2.0,0,3,3,4,10,0xb2d9f733
840001.94,7.0,20,4,4,2,10,0xb2d16e68d
2885.4,1.0,0,1,2,4,7,0xb2d2ac2d
1312131.97,6.0,92,4,4,1,9,0x3b9b33b3
793023.9,5.0,0,4,4,4,12,0xb2d8ec99
250487.65,2.0,16,3,3,2,8,0xb2d65989
201421.19,2.0,80,3,3,1,7,0xb2d993eb
0.05,1.0,20,1,2,2,5,0xb2d60a0e
220000.0,2.0,4,3,3,4,10,0xb2da5de7
51578.64,2.0,216,2,3,1,6,0xb2d4ebca
1.69,1.0,80,1,2,1,4,0xb2d42e24
0.0,1.0,20,1,2,2,5,0xb2d95469
400583.5,3.0,1,4,4,4,12,0xb2d968cc
4059.97,2.0,10,2,3,3,8,0xb2d261e7
287017.48,8.0,0,3,4,4,11,0xb2d0e891
114598.77,1.0,8,3,2,3,8,0xb2d36671
12.45,1.0,11,1,2,3,6,0xb2d5a9fe
31065.09,4.0,111,2,4,1,7,0xb2d5a78f
200084.22,2.0,4,3,3,4,10,0xb2d947d1
1014.48,1.0,92,1,2,1,4,0xb2d14da3
330015.09,4.0,10,4,4,3,11,0xb2d6b341
214.62,1.0,76,1,2,1,4,0xb2d5ee94
253279.21,3.0,199,3,4,1,8,0xb2d0db96
1827.75,1.0,4,1,2,4,7,0xb2d5cfb7
819743.16,5.0,6,4,4,3,11,0xb2d60ab6
10010.49,1.0,62,2,2,2,6,0xb2d8f7c3
11141.73,1.0,236,2,2,1,5,0xb2d22292
200025.66,2.0,60,3,3,2,8,0xb2d59e13
229582.14,4.0,2,3,4,4,11,0xb2d56e8e
30005.22,2.0,196,2,3,1,6,0xb2d7b018d
66279.72,2.0,35,3,3,2,8,0xb2d5a496d
1649.73,4.0,92,1,4,1,6,0x3b9af517
6145.76,3.0,0,2,4,4,10,0xb2d1d450
3802.13,1.0,0,2,2,4,8,0xb2d6caa3
9375.84,1.0,1,2,2,4,8,0xb2d8e992
5030.38,1.0,92,2,2,1,5,0xb2d410eb
6177.22,1.0,0,2,2,4,8,0xb2d2ec89
6426.02,1.0,184,2,2,1,5,0xb2d27623
1201860.38,5.0,18,4,4,2,10,0xb2d1774c
10079.34,1.0,61,2,2,2,6,0xb2d0cd79
255873.33,1.0,70,3,2,1,6,0xb2d25032
16515.57,1.0,7,2,2,3,7,0xb2d5d4b2
322936.22,5.0,0,4,4,4,12,0xb2d1b01c
30001.58,2.0,55,2,3,2,7,0xb2d9c2fa
200000.0,2.0,8,3,3,3,9,0xb2da4fb4
200000.0,2.0,13,3,3,3,9,0xb2da4146
200710.43,2.0,42,3,3,2,8,0xb2d9243f
13944.1,1.0,6,2,2,3,7,0xb2d698e5
610737.8,5.0,11,4,4,3,11,0xb2d7c564d
100001.06,2.0,90,3,3,1,7,0xb2d8c4fd
188043.7,5.0,0,3,4,4,11,0xb2d171b4
7403308.2,4.0,2,4,4,4,12,0xb2d5186ed
94271.51,1.0,17,3,2,2,7,0xb2d3836e
501000.0,2.0,4,4,3,4,11,0xb2da5d79
6009493.16,8.0,0,4,4,4,12,0xb2d40e72
30001.58,2.0,62,2,3,2,7,0xb2d107db
252364.05,3.0,31,3,4,2,9,0xb2d63a4b
504168.14,1.0,1,4,2,4,10,0xb2d205d8
32815.98,10.0,28,2,4,2,8,0xb2d0992e
2158.9,1.0,1,1,2,4,7,0xb2d11ba7
9665.11,1.0,0,2,2,4,8,0xb2d78f2f
201178.71,3.0,10,3,4,3,10,0xb2d563b5
14763.08,2.0,16,2,3,2,7,0xb2d0b7fc
735159.65,5.0,39,4,4,2,10,0xb2d3af8f
4547.83,1.0,202,2,2,1,5,0xb2d19659
528738.83,4.0,5,4,4,3,11,0xb2d0cc61
1069.48,2.0,92,1,3,1,5,0xb2d1718d
200000.42,3.0,25,3,4,2,9,0xb2d9ce47
100001.0,2.0,1,3,3,4,10,0xb2da2d29
154949.61,2.0,5,3,3,3,9,0xb2d147b0
206402.95,2.0,116,3,3,1,7,0xb2d68f36
369.01,1.0,8,1,2,3,6,0xb2d5d269
1302.0,1.0,92,1,2,1,4,0xb2d3529b
200021.29,2.0,13,3,3,3,9,0xb2d8c716
1283.27,1.0,207,1,2,1,4,0xb2d5ad75
96.04,2.0,60,1,3,2,6,0xb2d555b2
22353.68,1.0,0,2,2,4,8,0xb2d6db33
65000.0,2.0,4,3,3,4,10,0xb2da5ae9
230001.46,3.0,7,3,4,3,10,0xb2d8f36f
4013.38,1.0,56,2,2,2,6,0xb2d25a33
117032.82,2.0,40,3,3,2,8,0xb2d52236
260000.0,2.0,7,3,3,3,9,0xb2da53cc
51553.69,2.0,2,2,3,4,9,0xb2d65586d
172128.22,1.0,94,3,2,1,6,0xb2d1744a
35124.16,1.0,168,2,2,1,5,0xb2d88eee
10078.82,1.0,197,2,2,1,5,0xb2d61f76
1801.01,1.0,31,1,2,2,5,0xb2d70221
240006.23,5.0,4,3,4,4,11,0xb2d99147
14259.09,2.0,175,2,3,1,6,0xb2d5e745d
15.86,1.0,7,1,2,3,6,0xb2d63618
300404.23,4.0,0,4,4,4,12,0xb2d8e8b9
200111.96,4.0,13,3,4,3,10,0xb2d3219a
250012.52,6.0,41,3,4,2,9,0xb2d59418
296608.49,10.0,0,3,4,4,11,0xb2d0689b
153.13,1.0,2,1,2,4,7,0xb2d6a6f2
10055.77,2.0,6,2,3,3,8,0xb2d60ab2
3404065.93,11.0,0,4,4,4,12,0xb2d217c6
6047.35,1.0,8,2,2,3,7,0xb2d1f2c2
2000000.0,2.0,15,4,3,3,10,0xb2da364a
1.27,2.0,18,1,3,2,6,0xb2d07d02d
400068.59,2.0,231,4,3,1,8,0xb2d2d252
300011.29,2.0,21,3,3,2,8,0xb2d21175
5352.63,1.0,9,2,2,3,7,0xb2d50f6cd
2001.54,1.0,82,1,2,1,4,0xb2d8d64d
171051.42,5.0,3,3,4,4,11,0xb2d5b6ff
10039.71,1.0,92,2,2,1,5,0xb2d1c2be
2250.01,1.0,20,1,2,2,5,0xb2d54bfa
2000130.54,1.0,0,4,2,4,10,0xb2d22093
200000.0,2.0,22,3,3,2,8,0xb2da225e
123065.43,7.0,1,3,4,4,11,0xb2d5ba38
6707.95,1.0,3,2,2,4,8,0xb2d99e0e
501861.79,2.0,31,4,3,2,9,0xb2d6545dd
275.1,1.0,0,1,2,4,7,0xb2d2f4d0
220004.38,2.0,13,3,3,3,9,0xb2d95ff5d
22.38,1.0,14,1,2,3,6,0xb2d9e2b4
50078.54,2.0,45,2,3,2,7,0xb2d54664
3007.03,1.0,176,2,2,1,5,0xb2d8d007
251483.5,9.0,10,3,4,3,10,0xb2d53d1b
38.51,1.0,3,1,2,4,7,0xb2d8f48f
5890.59,1.0,3,2,2,4,8,0xb2d601c6
60029.72,2.0,214,3,3,1,7,0xb2d563df
670154.05,11.0,0,4,4,4,12,0xb2d42b9b
3234.68,1.0,14,2,2,3,7,0xb2d327c6
519.38,1.0,10,1,2,3,6,0xb2d8fb6d
4037.53,1.0,10,2,2,3,7,0xb2d3f4ac
3510.22,1.0,2,2,2,4,8,0xb2d15282
4737.72,1.0,22,2,2,2,6,0xb2d2b2df
450008.43,3.0,63,4,4,2,10,0xb2d39d26
1100.35,1.0,6,1,2,3,6,0xb2d2b103
1026658.13,4.0,3,4,4,4,12,0xb2d64bc9
266962.79,3.0,42,3,4,2,9,0xb2d583ed
15077.9,1.0,184,2,2,1,5,0xb2d531b1
1974653.65,13.0,0,4,4,4,12,0xb2d10bfad
12958.94,1.0,78,2,2,1,5,0xb2d1bf80
1358.96,1.0,92,1,2,1,4,0xb2d386ed
13072.87,2.0,167,2,3,1,6,0xb2d78947
40462.65,1.0,2,2,2,4,8,0xb2d601e8
16319.31,1.0,67,2,2,1,5,0xb2d3abd7d
103008.82,3.0,77,3,4,1,8,0xb2d4907dd
482.46,1.0,20,1,2,2,5,0xb2d2f120
24.78,2.0,39,1,3,2,6,0xb2d22081
385011.0,3.0,154,4,4,1,9,0xb2d2c460
50026.49,1.0,23,2,2,2,6,0xb2d232fad
149252.91,3.0,10,3,4,3,10,0xb2d60f0a
150071.57,3.0,55,3,4,2,9,0xb2d2431d
220111.37,4.0,123,3,4,1,8,0xb2d3995fd
150017.42,3.0,11,3,4,3,10,0xb2d94bd0
252596.21,7.0,0,3,4,4,11,0xb2d5998fd
92.37,1.0,14,1,2,3,6,0xb2d6b322
4071.54,3.0,1,2,4,4,10,0xb2d2eaa5
250952.4,2.0,18,3,3,2,8,0xb2d7733e
15655.44,1.0,5,2,2,3,7,0xb2d8f515
301491.15,3.0,28,4,4,2,10,0xb2d65e04
18611.29,1.0,92,2,2,1,5,0xb2d28b51
50606.75,2.0,66,2,3,2,7,0xb2d6c079
61.92,1.0,8,1,2,3,6,0xb2d593f2
11546.61,1.0,8,2,2,3,7,0xb2d5f801
3284.02,1.0,92,2,2,1,5,0xb2d20339
4088.93,1.0,0,2,2,4,8,0xb2d9b309
311872.83,5.0,67,4,4,1,9,0xb2d69d7d
50000.34,2.0,11,2,3,3,8,0xb2d6ad27
235978.59,3.0,1,3,4,4,11,0xb2d27753
1003892.22,3.0,4,4,4,4,12,0xb2d99617
124.11,1.0,0,1,2,4,7,0xb2d1ca5f
1534.29,1.0,81,1,2,1,4,0xb2d0d4d3d
1516376.78,7.0,66,4,4,2,10,0xb2d08ba1d
7.11,2.0,11,1,3,3,7,0xb2d24dd0
8332.48,1.0,92,2,2,1,5,0x3b9ad03e
420780.07,3.0,28,4,4,2,10,0xb2d1b2f4d
68010.65,5.0,25,3,4,2,9,0xb2d5bf27
0.0,1.0,6,1,2,3,6,0xb2d396dd
340026.61,3.0,28,4,4,2,10,0xb2d063cc
6775.6,1.0,187,2,2,1,5,0xb2d183c1
40164.22,4.0,66,2,4,2,8,0xb2d65e97d
0.0,1.0,3,1,2,4,7,0xb2d490b4
100015.96,3.0,18,3,4,2,9,0x3b9b3836
200298.3,2.0,0,3,3,4,10,0xb2d200e1
365097.57,6.0,18,4,4,2,10,0xb2d10eba
1243.62,1.0,184,1,2,1,4,0xb2d2ed23
90.67,3.0,88,1,4,1,6,0xb2d0ffc8
504173.62,3.0,1,4,4,4,12,0xb2d35c44
1037139.63,4.0,67,4,4,1,9,0xb2d1547a
516829.4,4.0,0,4,4,4,12,0xb2d5e8e5
110050.3,7.0,11,3,4,3,10,0xb2d5903d
414502.21,7.0,10,4,4,3,11,0xb2d90b0b
260027.24,2.0,21,3,3,2,8,0xb2d6d9c7
300009.5,3.0,32,3,4,2,9,0xb2d9fa7b
46.92,2.0,0,1,3,4,8,0x3b9af2a0
1015.27,1.0,92,1,2,1,4,0xb2d1dad4
76019.21,3.0,101,3,4,1,8,0xb2d5638d
502578.57,2.0,1,4,3,4,11,0xb2d6fe75d
30322.37,1.0,184,2,2,1,5,0xb2d2a6b4d
222416.57,6.0,1,3,4,4,11,0xb2d2d325
202362.74,2.0,175,3,3,1,7,0xb2d3638b
402429.77,3.0,11,4,4,3,11,0xb2d30de4
2.02,1.0,16,1,2,2,5,0xb2d4805b
517.38,1.0,42,1,2,2,5,0xb2d2b06f
1003.86,1.0,170,1,2,1,4,0xb2d65241d
1383.78,1.0,2,1,2,4,7,0xb2d31624d
2258.29,1.0,138,1,2,1,4,0xb2d6e862
10611.6,2.0,92,2,3,1,6,0xb2d0fd43
12069.27,1.0,0,2,2,4,8,0xb2d43b98
1058.64,1.0,9,1,2,3,6,0xb2d78c1f
72651.58,1.0,11,3,2,3,8,0xb2d18ad8
356500.83,8.0,12,4,4,3,11,0xb2d6e619
101409.12,2.0,136,3,3,1,7,0x3b9b2d1e
2489.73,1.0,10,1,2,3,6,0xb2d69de1
10.95,1.0,24,1,2,2,5,0xb2d6c002d
14772.57,1.0,184,2,2,1,5,0xb2d428f9
19.73,2.0,70,1,3,1,5,0xb2d59ee4
112.27,1.0,6,1,2,3,6,0xb2d31c9d
294500.24,7.0,4,3,4,4,11,0x3b9b3bd6
260012.14,3.0,20,3,4,2,9,0xb2d7a608
65000.2,1.0,0,3,2,4,9,0xb2d918e9
670077.82,14.0,0,4,4,4,12,0xb2d5c226
361.59,1.0,85,1,2,1,4,0xb2d3ea46
3115253.5,6.0,20,4,4,2,10,0xb2d0948d
104824.77,1.0,0,3,2,4,9,0xb2d22325
57001.89,2.0,206,3,3,1,7,0xb2d3c2f1
90000.94,2.0,0,3,3,4,10,0xb2d94b23
12000.0,1.0,5,2,2,3,7,0xb2d13ae9
485048.88,3.0,104,4,4,1,9,0xb2d5af34
105262.04,2.0,52,3,3,2,8,0xb2d22513
210006.05,6.0,8,3,4,3,10,0xb2d584f8
61193.17,2.0,0,3,3,4,10,0xb2d6c0c4
660000.0,2.0,0,4,3,4,11,0xb2d97ba7
1733.29,1.0,184,1,2,1,4,0xb2d1e640
1586238.54,1.0,4,4,2,4,10,0xb2d212f5
2360.26,1.0,155,1,2,1,4,0xb2d29854
30666.26,3.0,1,2,4,4,10,0xb2d0a645d
933516.46,4.0,2,4,4,4,12,0xb2d1c78d
1291089.54,7.0,10,4,4,3,11,0xb2d44337
582776.23,5.0,1,4,4,4,12,0xb2d3d40c
40946.05,2.0,67,2,3,1,6,0xb2d6078a
861.09,1.0,0,1,2,4,7,0xb2d53025
16714.09,1.0,7,2,2,3,7,0xb2d6dea5d
5921.42,1.0,184,2,2,1,5,0xb2d2ca46
670631.56,5.0,1,4,4,4,12,0xb2d52f2e
50835.63,2.0,4,2,3,4,9,0xb2d248ef
419002.44,3.0,83,4,4,1,9,0xb2d3f94d
50003.47,2.0,97,2,3,1,6,0xb2d3ed9cd
2671.59,1.0,2,1,2,4,7,0xb2d6358c
301.3,1.0,92,1,2,1,4,0xb2d395eb
246007.82,7.0,0,3,4,4,11,0xb2d304ba
140005.49,3.0,60,3,4,2,9,0xb2d9b718
7640.87,1.0,0,2,2,4,8,0xb2d6aaf8
2.22,1.0,44,1,2,2,5,0xb2d98d73
87.59,1.0,112,1,2,1,4,0xb2d4ad5e
238600.0,11.0,2,3,4,4,11,0x3b9b40e1d
50000.53,2.0,108,2,3,1,6,0xb2d7a65c
20000.21,2.0,92,2,3,1,6,0xb2d6466f
23004.09,3.0,22,2,4,2,8,0xb2d3b09e
0.0,1.0,0,1,2,4,7,0xb2d430af
26129.18,1.0,6,2,2,3,7,0xb2d755c8
6.18,1.0,4,1,2,4,7,0xb2d8ceaf
2107.47,4.0,29,1,4,2,7,0xb2d2c8b5
50000.53,1.0,10,2,2,3,7,0xb2d96c7d
5387.2,1.0,0,2,2,4,8,0xb2d6c2bf
7155.28,1.0,184,2,2,1,5,0xb2d20cf5
10136.05,1.0,0,2,2,4,8,0xb2d5ec5d
58070.95,2.0,71,3,3,1,7,0xb2d17b0d
225007.14,2.0,143,3,3,1,7,0xb2d6e592d
248177.53,10.0,3,3,4,4,11,0xb2d62e3f
98975.72,2.0,2,3,3,4,10,0xb2d42d60d
6755.53,4.0,84,2,4,1,7,0xb2d0e0ee
1000000.0,2.0,27,4,3,2,9,0xb2d94552
46.49,2.0,31,1,3,2,6,0xb2d5b136
2.5,1.0,71,1,2,1,4,0xb2d65cec
1957.71,1.0,94,1,2,1,4,0xb2d2dde0d
1018.97,1.0,92,1,2,1,4,0xb2d0e0afd
2000000.0,3.0,8,4,4,3,11,0xb2da4f05
2365159.86,3.0,41,4,4,2,10,0xb2d234bc
204767.98,2.0,128,3,3,1,7,0xb2d3c051d
4317.63,2.0,92,2,3,1,6,0x3b9b1612
960.42,1.0,103,1,2,1,4,0xb2d40e6c
776.55,5.0,9,1,4,3,8,0xb2d2afd3
7067.45,1.0,92,2,2,1,5,0xb2d2b323
364668.0,2.0,0,4,3,4,11,0xb2d99b1d
60008.66,2.0,132,3,3,1,7,0xb2d1a95ad
156254.54,3.0,10,3,4,3,10,0xb2d5cbb7
953947.46,10.0,4,4,4,4,12,0x3b9b45e9
330000.0,2.0,4,4,3,4,11,0xb2da6392
136408.08,2.0,1,3,3,4,10,0xb2d0a704d
521403.97,2.0,0,4,3,4,11,0xb2d4e3f9
100185.04,2.0,111,3,3,1,7,0xb2d595fc
237352.9,1.0,0,3,2,4,9,0xb2d18164
1342964.79,3.0,3,4,4,4,12,0xb2d0d516
1414.08,1.0,82,1,2,1,4,0xb2d55ea3
670139.1,3.0,21,4,4,2,10,0xb2d2d243
7035.28,1.0,145,2,2,1,5,0xb2d5f451
254187.36,4.0,0,3,4,4,11,0xb2d2124b
176371.15,2.0,102,3,3,1,7,0xb2d25c2c
1143038.99,5.0,5,4,4,3,11,0xb2d6287d
17832.82,2.0,168,2,3,1,6,0xb2d225fb
638.62,1.0,46,1,2,2,5,0xb2d2f03e
202131.85,2.0,34,3,3,2,8,0xb2d879f8
270011.17,2.0,116,3,3,1,7,0xb2d6230c
25.56,1.0,3,1,2,4,7,0xb2d5cbde
24.28,1.0,89,1,2,1,4,0xb2d94e50d
340004.17,4.0,21,4,4,2,10,0xb2d8d18ad
0.0,1.0,1,1,2,4,7,0xb2d2633b
212242.51,2.0,35,3,3,2,8,0xb2d5a05a
1251095.61,4.0,42,4,4,2,10,0xb2d64432
0.0,1.0,31,1,2,2,5,0xb2d547e4
490001.89,3.0,0,4,4,4,12,0xb2d926ea
7.57,1.0,33,1,2,2,5,0xb2d3b645
415780.37,4.0,4,4,4,4,12,0xb2d178aad
1000.15,1.0,24,1,2,2,5,0xb2da1eb5
600006.05,2.0,6,4,3,3,10,0xb2d11b14d
10.52,3.0,1,1,4,4,9,0xb2d2bb37
6013.99,1.0,104,2,2,1,5,0xb2d3717c
50002.65,2.0,139,2,3,1,6,0xb2d6b825d
745511.76,15.0,0,4,4,4,12,0x3b9b124b
726.82,1.0,77,1,2,1,4,0xb2d63ae4
265033.61,1.0,25,3,2,2,7,0xb2d3316b
43594.26,1.0,6,2,2,3,7,0xb2d42392
7006.21,1.0,1,2,2,4,8,0xb2d6fd24
712453.58,3.0,26,4,4,2,10,0xb2d5c0c0
520092.86,6.0,55,4,4,2,10,0xb2d10b48d
1050064.36,4.0,11,4,4,3,11,0xb2d2f7f3
1382721.16,3.0,25,4,4,2,10,0xb2d19b3f
120710.22,6.0,3,3,4,4,11,0xb2d564f5
13590.51,1.0,1,2,2,4,8,0xb2d6a509
1742.05,1.0,2,1,2,4,7,0xb2d1acc4
104410.62,3.0,175,3,4,1,8,0xb2d4ce3c
310100.18,2.0,18,4,3,2,9,0xb2d911ee
1058.25,4.0,0,1,4,4,9,0x3b9af0d7
70005.8,2.0,63,3,3,2,8,0xb2d8e01b
8785.76,1.0,20,2,2,2,6,0xb2d9b639
500019.0,4.0,11,4,4,3,11,0xb2d9768d
7240.01,1.0,1,2,2,4,8,0xb2d41f76
50020.06,1.0,11,2,2,3,7,0xb2d9b9fb
0.11,1.0,63,1,2,2,5,0xb2d3566a
436113.49,2.0,24,4,3,2,9,0xb2d6e6f7
10978.68,1.0,0,2,2,4,8,0xb2d41cb3
217481.77,2.0,228,3,3,1,7,0xb2d07e7a
1711.07,1.0,235,1,2,1,4,0xb2d627a6
600550.94,3.0,3,4,4,4,12,0xb2d339a6
1003.9,1.0,184,1,2,1,4,0xb2d54bfb
51092.96,2.0,147,2,3,1,6,0xb2d0b292
160009.37,7.0,11,3,4,3,10,0xb2d08804
480192.68,2.0,55,4,3,2,9,0xb2d3b307
1278.58,1.0,260,1,2,1,4,0xb2d40693
204401.02,1.0,5,3,2,3,8,0xb2d8c518d
1450385.23,6.0,40,4,4,2,10,0xb2d32777
70008.65,3.0,62,3,4,2,9,0xb2d0ba4b
87015.64,3.0,25,3,4,2,9,0xb2d5a600
70730.89,2.0,126,3,3,1,7,0xb2d3d99b
50953.35,2.0,193,2,3,1,6,0xb2d64aa9
356572.94,4.0,3,4,4,4,12,0xb2d596eb
10000.32,2.0,74,2,3,1,6,0xb2d9999e
1300003.3,6.0,11,4,4,3,11,0xb2d7e03e
123110.03,2.0,10,3,3,3,9,0xb2d2532b
337843.78,9.0,0,4,4,4,12,0xb2d5e52a
83027.47,2.0,104,3,3,1,7,0xb2d1fa6ed
45115.09,1.0,9,2,2,3,7,0xb2d48dec
442475.87,3.0,39,4,4,2,10,0xb2d8f4cbd
21139.42,1.0,14,2,2,3,7,0xb2d32c01
740006.76,9.0,3,4,4,4,12,0xb2d347d8
390041.47,4.0,196,4,4,1,9,0xb2d41881
768403.48,6.0,0,4,4,4,12,0x3b9af28e
71420.76,3.0,5,3,4,3,10,0xb2d0d6c0
123.19,1.0,44,1,2,2,5,0xb2d6d900
100020.76,2.0,122,3,3,1,7,0xb2d61392
31.67,1.0,13,1,2,3,6,0xb2d1b8f5
10000.32,2.0,102,2,3,1,6,0xb2d961d1
11061.57,2.0,151,2,3,1,6,0xb2d5f60ed
530014.99,4.0,18,4,4,2,10,0xb2d9dd3c
202133.22,2.0,43,3,3,2,8,0xb2d80547
43605.67,3.0,0,2,4,4,10,0xb2d407cc
277677.47,3.0,98,3,4,1,8,0xb2d296ec
50002.11,2.0,20,2,3,2,7,0xb2d94ee4
19081.38,1.0,18,2,2,2,6,0xb2d2cb44
110004.64,2.0,42,3,3,2,8,0xb2d9e590
85007.39,4.0,53,3,4,2,9,0xb2d69e12
3264.88,1.0,154,2,2,1,5,0xb2d25808
41058.08,1.0,7,2,2,3,7,0xb2d90e1d
100101.61,3.0,31,3,4,2,9,0xb2d93974d
1355127.17,1.0,5,4,2,3,9,0xb2d1d2b8
100008.46,2.0,48,3,3,2,8,0xb2d370a2
3.41,1.0,51,1,2,2,5,0xb2d66a5a
4109.0,1.0,7,2,2,3,7,0xb2da3b8b
7951949.57,17.0,0,4,4,4,12,0xb2d114a9
10000.11,2.0,21,2,3,2,7,0xb2da06fb
63017.12,2.0,47,3,3,2,8,0xb2d60c6e
3.68,1.0,53,1,2,2,5,0xb2d267e1
5175.48,1.0,92,2,2,1,5,0xb2d305a4
49.52,1.0,133,1,2,1,4,0xb2d15dc7
121370.67,2.0,14,3,3,3,9,0xb2d4fc23
4.56,1.0,0,1,2,4,7,0xb2d68624
404043.36,2.0,13,4,3,3,10,0xb2d562b8d
12593.5,1.0,184,2,2,1,5,0xb2d1a4d3
200000.75,2.0,20,3,3,2,8,0xb2d5806c
236.2,1.0,1,1,2,4,7,0xb2d16fb6
246293.54,3.0,18,3,4,2,9,0xb2d0d2b5
300035.09,3.0,2,3,4,4,11,0xb2d576dc
20000.21,2.0,95,2,3,1,6,0xb2d5c22f
2043.28,1.0,126,1,2,1,4,0xb2d34b1f
10000.21,2.0,94,2,3,1,6,0xb2d63f4e
20759.62,1.0,306,2,2,1,5,0xb2d3cc3d
70013.95,3.0,256,3,4,1,8,0xb2d6004d
13020.45,1.0,159,2,2,1,5,0xb2d8f0c9d
0.0,1.0,68,1,2,1,4,0xb2d800bf
2071128.22,3.0,0,4,4,4,12,0xb2d6ec4e
125.38,1.0,10,1,2,3,6,0xb2d5ae66
96000.0,12.0,1,3,4,4,11,0xb2d157f1
2590.78,1.0,10,1,2,3,6,0xb2d7004c
211023.13,3.0,11,3,4,3,10,0xb2d63c82
0.0,1.0,21,1,2,2,5,0xb2d56884
3100.22,1.0,92,2,2,1,5,0xb2d1a48cd
17.21,1.0,59,1,2,2,5,0xb2d41898
650086.19,3.0,31,4,4,2,10,0xb2d65a3c
256078.63,6.0,80,3,4,1,8,0xb2d1d69f
182674.66,2.0,4,3,3,4,10,0xb2d08aba
0.24,1.0,75,1,2,1,4,0xb2d0a5bc
556037.21,4.0,11,4,4,3,11,0xb2d9264c
4820.64,1.0,13,2,2,3,7,0xb2d2831a
200004.75,4.0,74,3,4,1,8,0xb2d8c5fb
17172.48,1.0,11,2,2,3,7,0xb2d280ac
19.14,1.0,4,1,2,4,7,0xb2d4093d
11503.98,2.0,0,2,3,4,9,0x3b9b46fa
11105.5,1.0,92,2,2,1,5,0xb2d2cb52
20363.37,2.0,213,2,3,1,6,0xb2d5b114
43649.95,1.0,0,2,2,4,8,0xb2d93d29
500000.0,2.0,9,4,3,3,10,0xb2d9db5b
834004.77,10.0,1,4,4,4,12,0xb2d1b17d
530010.05,6.0,1,4,4,4,12,0xb2d7ec9b
1055.03,1.0,4,1,2,4,7,0xb2d434c2
302221.27,2.0,43,4,3,2,9,0xb2d70522d
18001.73,1.0,1,2,2,4,8,0xb2d579b8
50001.58,2.0,73,2,3,1,6,0xb2d8e0e2
1007473.97,2.0,32,4,3,2,9,0xb2d1ae07
410044.71,3.0,22,4,4,2,10,0xb2d68c0c
1317.46,1.0,92,1,2,1,4,0xb2d10ee3
510358.02,4.0,73,4,4,1,9,0xb2d60189
1015.25,1.0,13,1,2,3,6,0xb2d0d4df
179257.87,15.0,0,3,4,4,11,0x3b9b0e74
7806.39,1.0,14,2,2,3,7,0xb2d691ee
423421.9,6.0,1,4,4,4,12,0xb2d354e3
520950.83,5.0,0,4,4,4,12,0xb2d1a990
1637.18,1.0,1,1,2,4,7,0xb2d988e2
223989.65,3.0,92,3,4,1,8,0xb2d1a0eb
20088.4,1.0,92,2,2,1,5,0xb2d5038c
203554.06,4.0,122,3,4,1,8,0xb2d8ff31d
350017.1,5.0,0,4,4,4,12,0xb2d5658b
2072.21,3.0,74,1,4,1,6,0xb2d26cec
35207.83,2.0,9,2,3,3,8,0xb2d5f06f
225381.55,26.0,11,3,4,3,10,0x3b9b2579
183483.57,2.0,3,3,3,4,10,0xb2d6c290
1721.71,1.0,9,1,2,3,6,0xb2d16aa3
278.21,1.0,10,1,2,3,6,0xb2d9b2fa
250138.24,6.0,3,3,4,4,11,0xb2d0f2d5
641082.67,6.0,30,4,4,2,10,0xb2d3d3f3d
411380.89,2.0,84,4,3,1,8,0xb2d6bda4
600044.35,7.0,25,4,4,2,10,0x3b9b3b27
121437.71,1.0,0,3,2,4,9,0xb2d34a39
400000.0,2.0,13,4,3,3,10,0xb2da410b
1426.12,1.0,12,1,2,3,6,0xb2d34a3b
50019.6,2.0,3,2,3,4,9,0xb2d88f97
250000.0,2.0,0,3,3,4,10,0xb2da5cf5
11.19,1.0,14,1,2,3,6,0xb2d91832
36330.0,1.0,4,2,2,4,8,0xb2d512bc
177105.78,11.0,2,3,4,4,11,0xb2d211bd
1228957.4,7.0,0,4,4,4,12,0xb2d0d404
577.74,1.0,9,1,2,3,6,0xb2d9dc62
1668030.97,5.0,5,4,4,3,11,0xb2d626bc
36006.6,1.0,10,2,2,3,7,0xb2d2981d
256186.04,3.0,15,3,4,3,10,0xb2d1734dd
14.71,1.0,73,1,2,1,4,0xb2d3824d
150014.59,3.0,6,3,4,3,10,0xb2d92b30
0.11,1.0,0,1,2,4,7,0xb2d4b8fb
205079.63,5.0,13,3,4,3,10,0xb2d39fb4
433229.7,2.0,206,4,3,1,8,0xb2d0ffc1
4754.98,1.0,29,2,2,2,6,0xb2d9290e
810021.46,5.0,6,4,4,3,11,0xb2d21df4
500000.0,2.0,18,4,3,2,9,0xb2d9cc9e
17630.8,1.0,151,2,2,1,5,0xb2d0eaa4d
39.63,1.0,38,1,2,2,5,0xb2d8ef54
455119.27,4.0,8,4,4,3,11,0xb2d1a2b1
200022.47,2.0,189,3,3,1,7,0xb2d5c1ec
414011.67,4.0,12,4,4,3,11,0xb2d3e62b
157820.22,1.0,168,3,2,1,6,0xb2d3f78a
2341.39,1.0,0,1,2,4,7,0xb2d50d3b
1.62,1.0,1,1,2,4,7,0xb2d3b764
500000.0,2.0,0,4,3,4,11,0xb2d97d42
213077.98,6.0,8,3,4,3,10,0xb2d50146d
9873.7,1.0,0,2,2,4,8,0xb2d6ed95
14727.86,1.0,14,2,2,3,7,0xb2d2777e
2582.37,1.0,184,1,2,1,4,0xb2d16f6d
17.17,1.0,0,1,2,4,7,0xb2d4851d
187.39,1.0,1,1,2,4,7,0xb2d3be03
34124.58,5.0,92,2,4,1,7,0xb2d2467d
200000.0,2.0,7,3,3,3,9,0xb2da5154
572.06,1.0,0,1,2,4,7,0xb2d654bd
325010.76,4.0,49,4,4,2,10,0xb2d587a3
40004.69,3.0,6,2,4,3,9,0xb2d42b52
7643002.13,13.0,4,4,4,4,12,0x3b9b1915d
34169.11,1.0,18,2,2,2,6,0xb2d6a6e2
133031.0,5.0,3,3,4,4,11,0xb2d29f9a
176036.79,2.0,41,3,3,2,8,0xb2d580ed
13001.84,2.0,47,2,3,2,7,0xb2d8f53e
203.84,1.0,0,1,2,4,7,0xb2d960fe
107255.96,2.0,158,3,3,1,7,0xb2d36cb0d
17914.43,1.0,87,2,2,1,5,0xb2d37009
50000.0,1.0,0,2,2,4,8,0xb2d25ba1
3168.45,1.0,4,2,2,4,8,0xb2d5ad8d
154494.25,1.0,92,3,2,1,6,0xb2d11083
22721.01,1.0,41,2,2,2,6,0xb2d31eb7
1319.33,1.0,169,1,2,1,4,0xb2d767b9
130005.5,2.0,175,3,3,1,7,0xb2d8c5be
60000.63,2.0,21,3,3,2,8,0xb2da20c4
1940.52,1.0,173,1,2,1,4,0xb2d5d703
145290.44,3.0,53,3,4,2,9,0xb2d502b0
602977.98,4.0,41,4,4,2,10,0xb2d8935b
1953.2,1.0,184,1,2,1,4,0xb2d2e503d
168474.39,2.0,0,3,3,4,10,0xb2d5e71c
84353.58,3.0,21,3,4,2,9,0xb2d43717
100001.06,3.0,34,3,4,2,9,0xb2d9343b
157.75,1.0,9,1,2,3,6,0xb2d484f9
43.45,1.0,92,1,2,1,4,0xb2d2722e
481705.39,2.0,24,4,3,2,9,0xb2d691d9d
90079.73,2.0,210,3,3,1,7,0xb2d42ba5
3734.4,1.0,2,2,2,4,8,0xb2d8f08c
7101.33,1.0,188,2,2,1,5,0xb2d2cd55
1100020.02,3.0,12,4,4,3,11,0xb2d3c088
45165.65,1.0,10,2,2,3,7,0xb2d16bded
130006.32,5.0,87,3,4,1,8,0xb2d6002d
366191.86,3.0,1,4,4,4,12,0xb2d177b4d
100064.27,2.0,204,3,3,1,7,0xb2d24cd7
1700.69,1.0,0,1,2,4,7,0xb2d3c68b
46238.46,7.0,88,2,4,1,7,0x3b9ad55f
296.78,1.0,2,1,2,4,7,0xb2d8d5f9
300632.94,2.0,20,4,3,2,9,0xb2d6123c
306399.41,2.0,140,4,3,1,8,0xb2d7c62a
50280.13,2.0,53,2,3,2,7,0xb2d99e7c
2104470.48,4.0,7,4,4,3,11,0xb2d22550
44043.09,1.0,10,2,2,3,7,0xb2d98b04
114236.98,3.0,38,3,4,2,9,0xb2d1015bd
2795.86,1.0,8,1,2,3,6,0xb2d3482a
170007.2,2.0,92,3,3,1,7,0xb2d647a1
1083.51,1.0,0,1,2,4,7,0xb2d6fdd4
140098.71,3.0,1,3,4,4,11,0xb2d21c5d
50004.75,2.0,83,2,3,1,6,0xb2d983eb
2245.78,1.0,92,1,2,1,4,0xb2d0cfb0
1013.34,1.0,184,1,2,1,4,0xb2d1fe3f
1064.67,1.0,184,1,2,1,4,0xb2d444bd
51633.99,1.0,0,2,2,4,8,0xb2d37c9b
1016010.8,10.0,11,4,4,3,11,0xb2d53fb5
5.18,1.0,55,1,2,2,5,0xb2d0f69e
262155.62,3.0,70,3,4,1,8,0xb2d25a5b
7.0,1.0,20,1,2,2,5,0xb2d8fdee
88026.89,1.0,5,3,2,3,8,0xb2d31b45
106.99,1.0,10,1,2,3,6,0xb2d27ebb
179292.12,2.0,0,3,3,4,10,0xb2d135a8
1095356.86,5.0,11,4,4,3,11,0xb2d78f5c
20332.3,1.0,155,2,2,1,5,0xb2d5bd9cd
1020.59,1.0,92,1,2,1,4,0xb2d10d7f
10376.4,1.0,132,2,2,1,5,0xb2d5ea08
120022.61,3.0,123,3,4,1,8,0xb2d12eeb
110.37,1.0,9,1,2,3,6,0xb2d64a7e
663234.98,2.0,77,4,3,1,8,0xb2d36f25d
149003.94,3.0,6,3,4,3,10,0xb2d10bfd
107675.71,2.0,94,3,3,1,7,0xb2d3a020
11008.75,1.0,0,2,2,4,8,0xb2d8e6f2
0.0,1.0,6,1,2,3,6,0xb2da00db
14.75,1.0,64,1,2,2,5,0xb2d186c0
17.06,1.0,0,1,2,4,7,0xb2d239a5
11.72,1.0,5,1,2,3,6,0xb2d83b83
2814.53,1.0,111,1,2,1,4,0xb2d3e4b7
9.63,1.0,12,1,2,3,6,0xb2d6e611
1320007.26,10.0,0,4,4,4,12,0xb2d11296
315881.57,10.0,2,4,4,4,12,0xb2d210a5
650000.0,3.0,0,4,4,4,12,0xb2d97f5d
4691.91,1.0,92,2,2,1,5,0xb2d29338d
380302.74,3.0,5,4,4,3,11,0xb2d1066e
1101.6,2.0,0,1,3,4,8,0xb2d51f3bd
213436.51,3.0,32,3,4,2,9,0xb2d1ebff
1026649.73,15.0,0,4,4,4,12,0xb2d0e870
34.0,1.0,54,1,2,2,5,0xb2d6a884
257931.89,3.0,18,3,4,2,9,0xb2d58a5ad
16005.84,2.0,27,2,3,2,7,0xb2d1700c
166208.27,3.0,3,3,4,4,11,0xb2d5ae08
3.17,1.0,22,1,2,2,5,0xb2da1c93
2278.84,2.0,92,1,3,1,5,0xb2d0791d
3023885.33,4.0,4,4,4,4,12,0xb2d67987
41819.8,1.0,3,2,2,4,8,0xb2d56421
250000.0,2.0,8,3,3,3,9,0xb2da50d8
102276.75,1.0,3,3,2,4,9,0xb2d5728d
45.38,1.0,24,1,2,2,5,0xb2d2b77cd
377.38,1.0,31,1,2,2,5,0xb2d339ad
430001.0,1.0,0,4,2,4,10,0xb2da6ab2
42.51,1.0,26,1,2,2,5,0xb2d6213e
177895.48,6.0,14,3,4,3,10,0xb2d68752
550282.11,4.0,1,4,4,4,12,0x3b9b2e61
290018.39,4.0,92,3,4,1,8,0xb2d5ba2c
6169.88,1.0,10,2,2,3,7,0xb2d9622b
30024.92,2.0,161,2,3,1,6,0xb2d602b4
8122.29,1.0,0,2,2,4,8,0xb2d62f9c
471.52,1.0,39,1,2,2,5,0xb2d63265
740969.08,7.0,0,4,4,4,12,0x3b9b17f7d
143.53,1.0,9,1,2,3,6,0xb2d6dbcc
503561.7,2.0,6,4,3,3,10,0xb2d8e916
55000.59,3.0,24,3,4,2,9,0xb2d18357
261439.2,4.0,87,3,4,1,8,0xb2d2eab0
1598.56,1.0,6,1,2,3,6,0xb2d1d49c
500160.67,3.0,130,4,4,1,9,0xb2d54cb0
332488.86,2.0,63,4,3,2,9,0xb2d681e8
11.19,1.0,39,1,2,2,5,0xb2d45af0
750088.36,5.0,19,4,4,2,10,0xb2d075d0
512355.4,2.0,109,4,3,1,8,0xb2d5cf5d
200000.0,1.0,2,3,2,4,9,0xb2d97e33
920467.87,3.0,83,4,4,1,9,0xb2d6af32
402136.33,5.0,34,4,4,2,10,0xb2d5da36
12703.31,2.0,92,2,3,1,6,0x3b9b1972
2335.88,2.0,27,1,3,2,6,0xb2d83cb0d
150040.85,3.0,28,3,4,2,9,0xb2d39637
13.26,1.0,63,1,2,2,5,0xb2d8dd35
1716.84,1.0,5,1,2,3,6,0xb2d633b4
121.16,2.0,13,1,3,3,7,0xb2d59199
20692.75,1.0,308,2,2,1,5,0xb2d06a9c
900038.61,2.0,92,4,3,1,8,0xb2d51dc8
158.06,1.0,74,1,2,1,4,0xb2d49d89
12908.77,1.0,0,2,2,4,8,0xb2d95255
74.43,1.0,8,1,2,3,6,0xb2d8fab4
4600.72,1.0,19,2,2,2,6,0xb2d638fe
400001.48,3.0,18,4,4,2,10,0xb2da1b29
422756.86,3.0,43,4,4,2,10,0xb2d36a14
2.42,4.0,0,1,4,4,9,0x3b9b194f
5342.86,1.0,4,2,2,4,8,0xb2d27c55d
0.0,1.0,0,1,2,4,7,0xb2d9226a
40001.69,2.0,34,2,3,2,7,0xb2d92e4e
0.0,1.0,7,1,2,3,6,0xb2d83d4c
302841.93,4.0,110,4,4,1,9,0xb2d546ccd
106247.39,2.0,41,3,3,2,8,0xb2d5f092d
53381.75,1.0,0,3,2,4,9,0xb2d7c383
12355.21,1.0,95,2,2,1,5,0xb2d89469
2269.11,1.0,23,1,2,2,5,0xb2d30411
500000.0,2.0,25,4,3,2,9,0xb2d94a8c
157.27,1.0,0,1,2,4,7,0xb2d999b7
257000.0,2.0,20,3,3,2,8,0xb2d12293
6670.62,1.0,184,2,2,1,5,0x3b9adb56d
220700.24,3.0,0,3,4,4,11,0xb2d21362
1148.36,1.0,60,1,2,2,5,0xb2d0da4b
320006.69,12.0,0,4,4,4,12,0xb2d40cd4
16505.11,1.0,3,2,2,4,8,0xb2d5307b
420009.66,3.0,25,4,4,2,10,0xb2d24cea
7169.11,1.0,2,2,2,4,8,0xb2d27313
418084.27,2.0,104,4,3,1,8,0xb2d507fad
50096.94,2.0,193,2,3,1,6,0xb2d259a0
30175.53,1.0,10,2,2,3,7,0xb2d9388a
6154.11,1.0,53,2,2,2,6,0xb2d2de33
1544320.55,7.0,21,4,4,2,10,0xb2d1c34b
6008.75,5.0,213,2,4,1,7,0xb2d17ecf
2660887.2,5.0,26,4,4,2,10,0xb2d41c8a
209715.53,3.0,4,3,4,4,11,0xb2d425b9
1.11,1.0,27,1,2,2,5,0xb2d59f56
1792059.38,18.0,11,4,4,3,11,0xb2d48682
301162.44,2.0,18,4,3,2,9,0xb2d6f729
308.64,1.0,48,1,2,2,5,0xb2d3783f
1969.81,18.0,9,1,4,3,8,0xb2d27074
104024.47,2.0,139,3,3,1,7,0xb2d4b95a
486.74,1.0,35,1,2,2,5,0xb2d3ca5b
42.36,6.0,32,1,4,2,7,0xb2d5d180
2865.55,2.0,92,1,3,1,5,0x3b9b3410
1506.31,1.0,92,1,2,1,4,0xb2d3507fd
4.95,1.0,19,1,2,2,5,0xb2d437ec
230000.0,2.0,20,3,3,2,8,0xb2d953e8
307843.67,2.0,0,4,3,4,11,0xb2d62845
6073.59,4.0,0,2,4,4,10,0x3b9b183a
50030.92,2.0,1,2,3,4,9,0xb2d8fec8
60597.48,2.0,62,3,3,2,8,0xb2d6c3e4d
3712.67,1.0,2,2,2,4,8,0xb2d881f1
11.52,1.0,75,1,2,1,4,0xb2d2e1bb
192.86,1.0,10,1,2,3,6,0xb2d78b70
1561.69,1.0,10,1,2,3,6,0xb2d96744
79173.09,3.0,0,3,4,4,11,0xb2d09911d
403337.96,4.0,60,4,4,2,10,0xb2d8d792
50111.72,1.0,1,2,2,4,8,0xb2d9ed5e
5438.29,1.0,4,2,2,4,8,0xb2d2499f
50144.96,2.0,126,2,3,1,6,0xb2d17a0dd
20001.5,2.0,40,2,3,2,7,0xb2d6dfce
2018397.66,2.0,4,4,3,4,11,0xb2d1cb4e
500002.95,4.0,4,4,4,4,12,0xb2d9d19d
24586.66,1.0,92,2,2,1,5,0xb2d1f35ed
13790.51,1.0,11,2,2,3,7,0xb2d2b619
376090.28,3.0,10,4,4,3,11,0xb2d6122dd
144001.52,2.0,221,3,3,1,7,0xb2d7043e
47108.76,1.0,92,2,2,1,5,0xb2d33525
19786.13,1.0,0,2,2,4,8,0xb2d6f9c0
131034.82,7.0,28,3,4,2,9,0xb2d0edd0
442.5,1.0,0,1,2,4,7,0xb2d97e62
27605.38,1.0,23,2,2,2,6,0xb2d263b8
2476128.13,24.0,18,4,4,2,10,0xb2d12630
1578586.34,1.0,0,4,2,4,10,0xb2d5d478d
12262.48,2.0,117,2,3,1,6,0xb2d16e55
144213.83,2.0,224,3,3,1,7,0xb2d5871c
430032.93,7.0,26,4,4,2,10,0xb2d49581
667.39,1.0,6,1,2,3,6,0xb2d42312
20615.96,2.0,0,2,3,4,9,0xb2d210f2
150000.0,2.0,92,3,3,1,7,0xb2d18306
10048.72,1.0,197,2,2,1,5,0xb2d61a31
200000.74,2.0,12,3,3,3,9,0xb2d22356
1944124.88,6.0,25,4,4,2,10,0xb2d92190
50.67,1.0,3,1,2,4,7,0xb2d60a7f
1532.82,1.0,10,1,2,3,6,0xb2d4645a
216023.66,7.0,46,3,4,2,9,0xb2d0fa99
1311.11,1.0,10,1,2,3,6,0xb2d318ebd
290030.14,2.0,1,3,3,4,10,0xb2d6d925d
2.42,1.0,10,1,2,3,6,0xb2d945f1
1063067.92,3.0,0,4,4,4,12,0xb2d6bfef
7.86,1.0,9,1,2,3,6,0xb2d9ebea
17.96,1.0,71,1,2,1,4,0xb2d3ba99
13.98,1.0,62,1,2,2,5,0xb2d6aa2a
273006.87,3.0,104,3,4,1,8,0x3b9b38e2d
403560.85,3.0,143,4,4,1,9,0xb2d6c843
14858.66,1.0,1,2,2,4,8,0xb2d65466
602733.29,2.0,5,4,3,3,10,0xb2d69fda
24024.5,1.0,59,2,2,2,6,0xb2d37f2c
1043.57,1.0,0,1,2,4,7,0xb2d6bf04
41.49,1.0,10,1,2,3,6,0xb2d37579
6586.81,1.0,9,2,2,3,7,0xb2d34656
2200.14,3.0,0,1,4,4,9,0x3b9af223
1503563.29,3.0,25,4,4,2,10,0xb2d8e347
65002.38,2.0,2,3,3,4,10,0xb2d532c2
185000.8,2.0,0,3,3,4,10,0xb2d40c97d
160771.63,1.0,92,3,2,1,6,0xb2d23301
1020096.06,2.0,32,4,3,2,9,0xb2d2582e
200000.0,2.0,20,3,3,2,8,0xb2d95465
3014.0,3.0,184,2,4,1,7,0xb2d091af
20122.2,1.0,1,2,2,4,8,0xb2d9d424
140094.72,3.0,18,3,4,2,9,0xb2d6c16ad
751173.44,7.0,6,4,4,3,11,0xb2d24bb6
55.17,1.0,6,1,2,3,6,0xb2d51e78
3716.91,1.0,10,2,2,3,7,0xb2d3e844
20688.63,3.0,4,2,4,4,10,0xb2d54885d
252238.07,5.0,0,3,4,4,11,0xb2d68a95
480000.0,5.0,0,4,4,4,12,0xb2d16fe1
1040028.07,7.0,0,4,4,4,12,0xb2d45afc
5.12,1.0,77,1,2,1,4,0xb2d60dd0
146753.73,3.0,59,3,4,2,9,0xb2d576bb
5088.07,1.0,11,2,2,3,7,0xb2d251df
200000.0,2.0,29,3,3,2,8,0xb2da0bf4
43679.17,1.0,1,2,2,4,8,0xb2d903c4d
1162.2,1.0,18,1,2,2,5,0xb2d4e702
1190.34,1.0,10,1,2,3,6,0xb2d57811
5035.5,1.0,92,2,2,1,5,0xb2d5fe08
1090752.91,3.0,0,4,4,4,12,0xb2d7d587
40475.31,3.0,0,2,4,4,10,0xb2d090bfd
25.33,1.0,18,1,2,2,5,0xb2d9549d
1030071.48,6.0,23,4,4,2,10,0xb2d3a57d
80902.19,1.0,20,3,2,2,7,0xb2d283d1
160295.39,5.0,0,3,4,4,11,0xb2d18adad
4142.61,1.0,39,2,2,2,6,0xb2d23abd
500007.56,5.0,9,4,4,3,11,0xb2d5ee7dd
191140.37,2.0,1,3,3,4,10,0xb2d24c22d
653040.35,8.0,0,4,4,4,12,0xb2d231ce
780019.0,4.0,25,4,4,2,10,0xb2d56486
500016.1,2.0,73,4,3,1,8,0xb2d4f1ba
1692.45,1.0,52,1,2,2,5,0xb2d6b60d
71764.37,2.0,154,3,3,1,7,0xb2d5a9c9
120192.63,2.0,0,3,3,4,10,0xb2d5f35f
202131.91,2.0,99,3,3,1,7,0xb2d96e8fd
12705.37,1.0,11,2,2,3,7,0xb2d3731b
120301.61,5.0,54,3,4,2,9,0xb2d56072
521738.19,11.0,0,4,4,4,12,0xb2d0677c
500044.7,3.0,36,4,4,2,10,0xb2d1fac1
3659.21,1.0,91,2,2,1,5,0xb2d19d2c
12242.61,1.0,92,2,2,1,5,0xb2d3fe30
511493.53,3.0,28,4,4,2,10,0xb2d6ef54
1493.68,1.0,17,1,2,2,5,0xb2d5c94c
7800000.0,1.0,0,4,2,4,10,0xb2d9c225
17.89,1.0,1,1,2,4,7,0xb2d6dd0a
453729.58,3.0,41,4,4,2,10,0xb2d67eb1
10.94,1.0,14,1,2,3,6,0xb2d3e2d0
20000.63,2.0,94,2,3,1,6,0xb2d867ff
10502225.57,26.0,32,4,4,2,10,0xb2d5008a
13.73,1.0,7,1,2,3,6,0xb2d37caf
50001.06,2.0,66,2,3,2,7,0xb2d8f08e
764381.16,3.0,77,4,4,1,9,0xb2d40294
46967.12,1.0,8,2,2,3,7,0xb2d66534
1119054.65,14.0,8,4,4,3,11,0xb2d57063
3653.63,1.0,79,2,2,1,5,0xb2d51651d
87927.26,1.0,98,3,2,1,6,0xb2d2da43d
120052.0,3.0,32,3,4,2,9,0xb2d683de
1100000.0,2.0,3,4,3,4,11,0xb2d9b613
82.25,1.0,0,1,2,4,7,0xb2d643ec
60330.16,2.0,245,3,3,1,7,0xb2d62105
2.17,1.0,29,1,2,2,5,0xb2d6cef1
627365.66,3.0,175,4,4,1,9,0xb2d331cf
571843.53,4.0,5,4,4,3,11,0xb2d19d78
92031.45,4.0,0,3,4,4,11,0xb2d4d1a1d
30.66,2.0,28,1,3,2,6,0xb2d8393e
217149.12,4.0,0,3,4,4,11,0xb2d2e86a
20170.95,2.0,11,2,3,3,8,0xb2d6a4d2
1894.07,1.0,0,1,2,4,7,0xb2d15230
19062.57,1.0,4,2,2,4,8,0xb2d90d94
521000.0,14.0,0,4,4,4,12,0xb2d4ff88
230007.28,2.0,90,3,3,1,7,0xb2d8b3c5
230000.0,3.0,20,3,4,2,9,0xb2da29af
44810.52,1.0,2,2,2,4,8,0xb2d68cf7
4736.1,1.0,1,2,2,4,8,0xb2d3ca15
0.0,1.0,0,1,2,4,7,0xb2d69035d
7723.94,1.0,10,2,2,3,7,0xb2d5ad13
3849.5,1.0,1,2,2,4,8,0xb2d6e7e6
30081.68,2.0,168,2,3,1,6,0xb2d5a567d
100030.83,3.0,11,3,4,3,10,0xb2d61b40
144000.84,3.0,6,3,4,3,10,0xb2d967f9
22279.69,1.0,92,2,2,1,5,0xb2d3c418
122.6,1.0,4,1,2,4,7,0xb2d3ec96
18.08,1.0,20,1,2,2,5,0xb2d6094f
100064.86,2.0,27,3,3,2,8,0xb2d53cf5
123244.8,3.0,167,3,4,1,8,0xb2d2455f
0.14,1.0,11,1,2,3,6,0xb2d6802c
14448.75,1.0,4,2,2,4,8,0xb2d5683bd
300000.0,2.0,4,3,3,4,10,0xb2da60ff
35801.54,1.0,15,2,2,3,7,0xb2d68370
50000.53,2.0,32,2,3,2,7,0xb2d5ebef
5331.71,1.0,184,2,2,1,5,0xb2d2eebe
53397.82,1.0,60,3,2,2,7,0xb2d34472
741532.15,5.0,61,4,4,2,10,0xb2d22a55
23.9,1.0,14,1,2,3,6,0xb2d8d24e
519.23,1.0,11,1,2,3,6,0xb2d3ab74
59582.22,1.0,9,3,2,3,8,0xb2d5beb8
30030.02,3.0,139,2,4,1,7,0xb2d0aa8e
501.46,1.0,0,1,2,4,7,0xb2d71728
154723.59,2.0,73,3,3,1,7,0xb2d5d677
464.91,1.0,0,1,2,4,7,0xb2d53eb9
4.95,9.0,24,1,4,2,7,0xb2d22f4c
240211.22,3.0,4,3,4,4,11,0xb2d55704
90579.32,2.0,0,3,3,4,10,0xb2d3c544
866158.68,3.0,107,4,4,1,9,0xb2d4f8c4
0.0,1.0,1,1,2,4,7,0xb2d94648
32.19,1.0,74,1,2,1,4,0xb2d609a2
852500.04,8.0,7,4,4,3,11,0xb2d8ec7b
125.83,1.0,50,1,2,2,5,0xb2d37ad4
4.38,1.0,24,1,2,2,5,0xb2d63696
30704.29,10.0,0,2,4,4,10,0x3b9b264d
30000.63,2.0,8,2,3,3,8,0xb2da4681
10000.42,2.0,200,2,3,1,6,0xb2d78b28
600097.61,2.0,11,4,3,3,10,0xb2d588d7
0.0,2.0,21,1,3,2,6,0xb2d5a59d
50010.56,1.0,29,2,2,2,6,0xb2d94063d
21000000.0,2.0,6,4,3,3,10,0xb2d6a5bd
789184.91,5.0,1,4,4,4,12,0xb2d565a7
50000.53,2.0,249,2,3,1,6,0xb2d3a8c3
245013.35,6.0,42,3,4,2,9,0xb2d8ecae
1803.3,1.0,3,1,2,4,7,0xb2d6b369
100004.81,4.0,32,3,4,2,9,0xb2d39533
3574.37,1.0,0,2,2,4,8,0xb2d3efc4
8770.92,1.0,13,2,2,3,7,0xb2d5cf84
820256.9,20.0,19,4,4,2,10,0x3b9b46c3
4017476.78,3.0,186,4,4,1,9,0xb2d29238
282061.39,6.0,2,3,4,4,11,0xb2d8e325
155825.49,4.0,36,3,4,2,9,0xb2d10af1d
2091.34,1.0,3,1,2,4,7,0xb2d3b0f3
3985.13,1.0,5,2,2,3,7,0xb2d5f819d
942781.29,14.0,12,4,4,3,11,0xb2d0e111
0.37,1.0,3,1,2,4,7,0xb2d61b20
70001.48,2.0,206,3,3,1,7,0xb2d68c0b
136018.94,3.0,6,3,4,3,10,0xb2d5bf69
523629.39,2.0,4,4,3,4,11,0xb2d3788b
0.82,1.0,81,1,2,1,4,0xb2d5c528
280972.05,3.0,39,3,4,2,9,0xb2d4f6b9
80001.69,2.0,92,3,3,1,7,0xb2d64613
218735.71,1.0,247,3,2,1,6,0xb2d48931d
11613.29,1.0,53,2,2,2,6,0xb2d38125
20992.02,1.0,3,2,2,4,8,0xb2d17f9d
6106.65,2.0,6,2,3,3,8,0xb2d2cf34
471080.9,2.0,18,4,3,2,9,0xb2d5f468
61537.14,3.0,87,3,4,1,8,0xb2d0a421d
26.69,1.0,24,1,2,2,5,0xb2d60758
577368.58,6.0,12,4,4,3,11,0xb2d5071b
20001.6,2.0,60,2,3,2,7,0xb2d5b6e9
9017.12,1.0,54,2,2,2,6,0xb2d61bcf
0.75,1.0,87,1,2,1,4,0xb2d13f2a
2078.92,1.0,16,1,2,2,5,0xb2d1da3e
30000.32,3.0,6,2,4,3,9,0xb2d63811
45725.36,3.0,47,2,4,2,8,0xb2d97922
6821.49,1.0,13,2,2,3,7,0xb2d8cb2dd
15220.13,1.0,5,2,2,3,7,0xb2d7928e
45065.71,3.0,87,2,4,1,7,0xb2d32b21
1617.88,3.0,184,1,4,1,6,0x3b9b2a5c
260008.03,13.0,28,3,4,2,9,0xb2d8c59bd
1024123.41,3.0,47,4,4,2,10,0xb2d5e34ad
300021.11,2.0,10,3,3,3,9,0xb2d57c2f
20005.39,1.0,16,2,2,2,6,0xb2d9d60c
290000.0,3.0,4,3,4,4,11,0xb2d6d31b
1925000.0,10.0,0,4,4,4,12,0x3b9aeaec
163075.13,6.0,70,3,4,1,8,0xb2d38b7f
15000.23,1.0,0,2,2,4,8,0xb2d54be5
100000.0,1.0,2,3,2,4,9,0xb2da6555
1933.24,1.0,155,1,2,1,4,0xb2d5cdff
600031.73,2.0,195,4,3,1,8,0xb2d69ab0
500113.13,2.0,144,4,3,1,8,0xb2d4156d
300000.0,2.0,4,3,3,4,10,0xb2da5cd7
2023007.42,4.0,46,4,4,2,10,0xb2d43418
0.36,1.0,25,1,2,2,5,0xb2d7f512
106.68,1.0,0,1,2,4,7,0xb2d6b6d3
1103.27,1.0,10,1,2,3,6,0xb2d4a9da
0.47,1.0,6,1,2,3,6,0xb2d85bb5
5052.56,1.0,28,2,2,2,6,0xb2d88004
600000.0,2.0,8,4,3,3,10,0xb2da2d68
610.34,1.0,42,1,2,2,5,0xb2d2b93e
1200.17,1.0,92,1,2,1,4,0xb2d39683
300224.76,4.0,0,4,4,4,12,0xb2d284af
8775.21,1.0,92,2,2,1,5,0xb2d3ca6d
109875.0,2.0,7,3,3,3,9,0xb2da219f
101590.58,2.0,154,3,3,1,7,0xb2d5ddc9
200010.42,2.0,2,3,3,4,10,0xb2da060a
261025.15,2.0,109,3,3,1,7,0xb2d65a3a
304264.97,2.0,140,4,3,1,8,0xb2d6eee2
1849.44,1.0,0,1,2,4,7,0xb2d5834d
20580.17,2.0,3,2,3,4,9,0xb2d65083
3038.65,1.0,92,2,2,1,5,0xb2d19c05
1000065.78,2.0,4,4,3,4,11,0xb2d97a16
18.33,1.0,45,1,2,2,5,0xb2d67e06
16113.82,4.0,4,2,4,4,10,0xb2d5febbd
1950000.62,6.0,0,4,4,4,12,0xb2d2efbd
225327.33,5.0,13,3,4,3,10,0xb2d366b1
156.44,1.0,10,1,2,3,6,0xb2d56552
11657.8,1.0,9,2,2,3,7,0xb2d22d71
90001.9,2.0,186,3,3,1,7,0xb2d88067
30001.49,3.0,51,2,4,2,8,0xb2d491cb
600019.02,2.0,136,4,3,1,8,0xb2d6f2b3
52001.1,2.0,92,2,3,1,6,0xb2d5efd8
2044.06,1.0,10,1,2,3,6,0xb2d7a677
6.33,1.0,39,1,2,2,5,0xb2d9ed12
288.27,1.0,10,1,2,3,6,0xb2d2d442
78006.5,4.0,10,3,4,3,10,0xb2d50ca2
200000.0,2.0,5,3,3,3,9,0xb2da5e23
500772.49,1.0,21,4,2,2,8,0xb2d9a623
300256.11,2.0,26,4,3,2,9,0xb2d430cf
75009.24,2.0,27,3,3,2,8,0xb2da04fb
2523.4,1.0,4,1,2,4,7,0xb2d6b016
72052.66,1.0,27,3,2,2,7,0xb2d222d2
7756.42,1.0,0,2,2,4,8,0xb2d8f528
9770312.5,5.0,0,4,4,4,12,0xb2d35acb
69829.28,4.0,0,3,4,4,11,0xb2d212c4
9893.23,1.0,0,2,2,4,8,0xb2d35130
3327.49,1.0,92,2,2,1,5,0xb2d2e83c
150508.03,2.0,3,3,3,4,10,0xb2d1f020
606137.22,4.0,10,4,4,3,11,0xb2d52d96
15910.64,1.0,100,2,2,1,5,0xb2d2e466
202047.19,2.0,0,3,3,4,10,0x3b9ade55
1133.29,1.0,3,1,2,4,7,0xb2d27748
2323.37,1.0,184,1,2,1,4,0x3b9b1872d
1024.17,1.0,92,1,2,1,4,0xb2d0d027
50001.54,3.0,73,2,4,1,7,0xb2d63a2c
8000138.29,2.0,217,4,3,1,8,0xb2d64f92
584135.55,2.0,168,4,3,1,8,0xb2d4fe34
1886.18,1.0,92,1,2,1,4,0xb2d1c586
328784.92,1.0,10,4,2,3,9,0xb2d3b696
61564.96,1.0,49,3,2,2,7,0xb2d37c3e
7443.99,1.0,0,2,2,4,8,0xb2d5c904
1780.45,1.0,3,1,2,4,7,0xb2d39558
20000.63,2.0,199,2,3,1,6,0xb2d69681
453.43,1.0,0,1,2,4,7,0xb2d6b8c3
72995.58,2.0,90,3,3,1,7,0xb2d51c2d
2783.05,2.0,184,1,3,1,5,0xb2d0a43d
6089.73,1.0,22,2,2,2,6,0xb2d9bcdb
67000.92,3.0,1,3,4,4,11,0xb2d6b95e
134.1,1.0,0,1,2,4,7,0xb2d2c087
944.81,1.0,0,1,2,4,7,0xb2d65afd
5019.94,1.0,93,2,2,1,5,0xb2d4ea1bd
20000.42,2.0,11,2,3,3,8,0xb2da4357
17887.63,1.0,0,2,2,4,8,0xb2d329b2
2120.9,1.0,7,1,2,3,6,0xb2d48044
60092.42,2.0,209,3,3,1,7,0xb2d57f8d
11548.85,1.0,92,2,2,1,5,0xb2d24978
132978.13,2.0,1,3,3,4,10,0xb2d5eff4
3.98,1.0,3,1,2,4,7,0xb2d55278
895507.76,5.0,19,4,4,2,10,0xb2d15259
83095.78,2.0,87,3,3,1,7,0xb2d593d2
822097.79,8.0,10,4,4,3,11,0xb2d537ea
1.19,1.0,8,1,2,3,6,0xb2d527a1
940022.84,11.0,0,4,4,4,12,0xb2d5118c
310000.0,2.0,12,4,3,3,10,0xb2d962e4d
861078.99,3.0,19,4,4,2,10,0xb2d68362
240.0,1.0,0,1,2,4,7,0xb2d8c6d8
631059.57,3.0,108,4,4,1,9,0xb2d6396f
717537.23,5.0,0,4,4,4,12,0x3b9b0eeb
105494.88,2.0,13,3,3,3,9,0xb2d526bc
430072.03,3.0,11,4,4,3,11,0xb2d62186
383929.32,5.0,11,4,4,3,11,0xb2d707d1
530000.1,6.0,0,4,4,4,12,0x3b9b17f6d
28.93,1.0,0,1,2,4,7,0xb2d6ee01
674.17,1.0,0,1,2,4,7,0xb2d906c1
203047.16,4.0,14,3,4,3,10,0x3b9af101
281.31,1.0,71,1,2,1,4,0xb2d2edd0
2213.33,1.0,0,1,2,4,7,0xb2d2a888
77.45,2.0,23,1,3,2,6,0xb2d06d10
10323.84,1.0,141,2,2,1,5,0xb2d6237f
1050000.0,10.0,0,4,4,4,12,0xb2d1a193
2.5,1.0,0,1,2,4,7,0xb2d52c31
90058.2,2.0,13,3,3,3,9,0xb2d566b4
31.26,1.0,11,1,2,3,6,0xb2d40044
242065.11,3.0,78,3,4,1,8,0xb2d1066d
334000.29,7.0,0,4,4,4,12,0xb2d111ce
631.54,1.0,27,1,2,2,5,0xb2d98ed7
50000.53,2.0,56,2,3,2,7,0xb2d9c6fc
112549.76,2.0,104,3,3,1,7,0xb2d243f5
25747.48,1.0,20,2,2,2,6,0xb2d60a43
32316.62,1.0,57,2,2,2,6,0xb2d0b6f3
3866.36,1.0,300,2,2,1,5,0xb2d3aff3
760.55,1.0,2,1,2,4,7,0xb2d319b7
1350025.62,8.0,4,4,4,4,12,0xb2d3bc51
701.63,1.0,92,1,2,1,4,0xb2d438ae
308883.24,2.0,0,4,3,4,11,0xb2d6dfd5
27.33,1.0,45,1,2,2,5,0xb2d55390
15125.22,1.0,184,2,2,1,5,0xb2d0f0e1
44758.23,1.0,1,2,2,4,8,0xb2d8d8d7
1.27,1.0,40,1,2,2,5,0xb2d98a9e
270051.22,2.0,0,3,3,4,10,0xb2d1a46dd
17251.61,1.0,294,2,2,1,5,0xb2d5a170
166052.62,2.0,27,3,3,2,8,0xb2d1626c
181455.4,3.0,10,3,4,3,10,0xb2d1a482
10000.11,2.0,18,2,3,2,7,0xb2d9526b
486899.81,8.0,48,4,4,2,10,0xb2d4339f
903200.97,4.0,31,4,4,2,10,0xb2d242f9
1500008.52,3.0,136,4,4,1,9,0xb2d63345
1410178.2,7.0,4,4,4,4,12,0xb2d7fe91
1016.72,1.0,92,1,2,1,4,0xb2d18911
7805.05,1.0,4,2,2,4,8,0xb2d3d7f4
205562.52,2.0,12,3,3,3,9,0xb2d5ff98
2.9,1.0,60,1,2,2,5,0xb2d932f1
2.93,1.0,5,1,2,3,6,0xb2d8ede3
1003112.97,1.0,4,4,2,4,10,0xb2d6abbb
450019.63,2.0,16,4,3,2,9,0x3b9b49ce
142804.46,5.0,19,3,4,2,9,0xb2d535eb
1689184.03,5.0,27,4,4,2,10,0xb2d7ecba
8694.82,1.0,0,2,2,4,8,0xb2d38f21
70058.9,3.0,25,3,4,2,9,0xb2d92a8c
10.57,1.0,289,1,2,1,4,0xb2d26891d
10363.6,2.0,95,2,3,1,6,0xb2d62405
2.87,1.0,39,1,2,2,5,0xb2d9277c
5367.95,1.0,92,2,2,1,5,0xb2d614a7d
233.89,1.0,9,1,2,3,6,0xb2d3f2d7d
310432.73,4.0,0,4,4,4,12,0xb2d99d5f
1750.97,1.0,110,1,2,1,4,0xb2d5e55c
4264.39,1.0,184,2,2,1,5,0xb2d3243ed
300052.7,3.0,24,3,4,2,9,0xb2d5d989
56054.02,2.0,147,3,3,1,7,0xb2d0ec66
60009.61,2.0,21,3,3,2,8,0xb2d97321
0.79,1.0,8,1,2,3,6,0xb2d9d2bc
99.09,1.0,17,1,2,2,5,0xb2d5a715
370447.38,3.0,1,4,4,4,12,0xb2d20fbed
72.04,1.0,22,1,2,2,5,0xb2d8f73c
200078.67,2.0,14,3,3,3,9,0xb2d6e78e
400000.46,2.0,15,4,3,3,10,0xb2d23d6f
200002.88,2.0,7,3,3,3,9,0xb2d57bd6
254853.71,3.0,13,3,4,3,10,0xb2d69243
150006.9,4.0,27,3,4,2,9,0xb2d112b9
170.45,1.0,23,1,2,2,5,0xb2d6282f
104980.34,2.0,0,3,3,4,10,0xb2d32dda
280000.0,2.0,4,3,3,4,10,0xb2da5a1b
47228.99,1.0,0,2,2,4,8,0xb2d6ca37d
576.38,1.0,18,1,2,2,5,0xb2d262f0
110000.0,5.0,0,3,4,4,11,0xb2d35023
1015.43,1.0,184,1,2,1,4,0xb2d131f0
401536.8,3.0,8,4,4,3,11,0xb2d630cb
150071.85,2.0,0,3,3,4,10,0xb2d53687
504621.13,3.0,77,4,4,1,9,0xb2d96e71
90057.47,2.0,147,3,3,1,7,0xb2d41e0ad
1440.22,1.0,0,1,2,4,7,0xb2d6ecd5
216007.64,3.0,173,3,4,1,8,0xb2d4ac4bd
4199.56,1.0,92,2,2,1,5,0xb2d4a603
1.58,2.0,10,1,3,3,7,0xb2d17c34
31354.72,1.0,0,2,2,4,8,0xb2d69a78
507315.95,4.0,34,4,4,2,10,0xb2d4f366
2311.46,1.0,92,1,2,1,4,0xb2d274ef
1007.09,1.0,92,1,2,1,4,0xb2d33a1f
534875.87,3.0,24,4,4,2,10,0xb2d0c01f
15.14,1.0,23,1,2,2,5,0xb2d62414
42829.22,1.0,91,2,2,1,5,0xb2d1a51d
506065.97,2.0,41,4,3,2,9,0xb2d6e277d
61165.34,1.0,2,3,2,4,9,0xb2d5e8d6
2927.33,1.0,82,2,2,1,5,0xb2d64f9e
157249.74,2.0,266,3,3,1,7,0xb2d153ed
360067.28,2.0,0,4,3,4,11,0xb2d421fb
8336.05,1.0,0,2,2,4,8,0xb2d3ed30
950317.51,1.0,13,4,2,3,9,0xb2d6e8cb
280012.38,4.0,26,3,4,2,9,0xb2d8fb92
30000.32,2.0,137,2,3,1,6,0xb2d91baa
151038.67,3.0,1,3,4,4,11,0xb2d9f57d
200711.42,2.0,31,3,3,2,8,0xb2da095e
43568.44,1.0,0,2,2,4,8,0xb2d21a24
114606.2,3.0,150,3,4,1,8,0x3b9b28c3
41000.16,3.0,75,2,4,1,7,0xb2d65706
76725.74,1.0,90,3,2,1,6,0xb2d62b6f
80510.12,3.0,6,3,4,3,10,0xb2d170ba
330584.09,4.0,60,4,4,2,10,0xb2d0e71c
300017.82,2.0,6,3,3,3,9,0xb2d64837d
165318.47,2.0,67,3,3,1,7,0xb2d57e2d
1240136.55,6.0,5,4,4,3,11,0xb2d4cd7e
3622.11,1.0,0,2,2,4,8,0xb2d6a538
224.62,1.0,21,1,2,2,5,0xb2d78fe4
1279.39,1.0,184,1,2,1,4,0xb2d2e646
22916.14,1.0,0,2,2,4,8,0xb2d4bc5d
120086.19,2.0,63,3,3,2,8,0xb2d8e1f9
238401.3,4.0,0,3,4,4,11,0xb2d18022
1606048.54,6.0,5,4,4,3,11,0xb2d56ce7
1011.81,1.0,92,1,2,1,4,0xb2d1cce7
5005.47,1.0,21,2,2,2,6,0xb2d681c8
29431.07,1.0,6,2,2,3,7,0xb2d33d89
54.81,1.0,112,1,2,1,4,0xb2d25b76
116165.09,4.0,3,3,4,4,11,0xb2d604b3d
13.04,1.0,19,1,2,2,5,0xb2d2f84bd
4.64,1.0,4,1,2,4,7,0xb2d8924f
217306.06,1.0,0,3,2,4,9,0xb2d2e286
264012.18,3.0,12,3,4,3,10,0xb2d337ca
2.83,1.0,25,1,2,2,5,0xb2d82441
190002.01,3.0,18,3,4,2,9,0xb2da2e9e
109768.49,2.0,6,3,3,3,9,0xb2d54b7b
3685.46,1.0,10,2,2,3,7,0xb2d1ec0a
5756.54,2.0,92,2,3,1,6,0xb2d18f3a
1188334.45,2.0,4,4,3,4,11,0xb2d3a547
61.46,1.0,38,1,2,2,5,0xb2d95c18d
45381.74,1.0,30,2,2,2,6,0xb2d95ae3
100494.59,1.0,0,3,2,4,9,0xb2d59f3dd
1330114.51,6.0,87,4,4,1,9,0xb2d30780
203578.84,2.0,153,3,3,1,7,0xb2d1658d
1665018.62,4.0,83,4,4,1,9,0xb2d18a96
310000.0,2.0,0,4,3,4,11,0xb2d97238
4506.61,1.0,0,2,2,4,8,0xb2d6bf1e
18727.38,1.0,0,2,2,4,8,0xb2d66aa9
215002.77,5.0,87,3,4,1,8,0xb2d62535d
26551.92,1.0,0,2,2,4,8,0xb2d4c829
591468.9,5.0,43,4,4,2,10,0xb2d627fa
6942.44,4.0,184,2,4,1,7,0xb2d41dea
60002.53,2.0,80,3,3,1,7,0xb2d8d0f7
3830.84,1.0,0,2,2,4,8,0xb2d393c0
12911.58,1.0,4,2,2,4,8,0xb2d0bf47d
30008.53,1.0,0,2,2,4,8,0xb2d1b6ac
6007.64,1.0,18,2,2,2,6,0xb2d67b9d
20210.82,1.0,7,2,2,3,7,0xb2d6b43d
809.5,1.0,7,1,2,3,6,0xb2d1e12b
216632.31,7.0,0,3,4,4,11,0x3b9b2f30
337.09,1.0,4,1,2,4,7,0xb2d425cc
558.98,1.0,88,1,2,1,4,0xb2d2f20f
149536.67,1.0,0,3,2,4,9,0xb2d62e13
9902.05,1.0,16,2,2,2,6,0xb2d93dde
581741.56,5.0,7,4,4,3,11,0xb2d23af0
669809.58,7.0,0,4,4,4,12,0xb2d071e1
56925.02,1.0,18,3,2,2,7,0xb2d6c4c1
231.09,1.0,6,1,2,3,6,0xb2d9f010
300036.91,4.0,0,3,4,4,11,0xb2d975ee
127783.55,3.0,12,3,4,3,10,0xb2d3280d
25289.9,1.0,4,2,2,4,8,0xb2d56cd6
680025.69,7.0,47,4,4,2,10,0xb2d176f8
3.27,2.0,1,1,3,4,8,0xb2d63782
150001.58,2.0,77,3,3,1,7,0xb2d93c58
1683.58,1.0,83,1,2,1,4,0xb2d6009f
2172.25,1.0,184,1,2,1,4,0xb2d10317
7382.16,1.0,18,2,2,2,6,0xb2d52782
574154.92,9.0,3,4,4,4,12,0x3b9b4642
100030.04,2.0,1,3,3,4,10,0xb2d6e20f
1030135.76,3.0,139,4,4,1,9,0xb2d7e3aa
3901424.57,7.0,33,4,4,2,10,0x3b9b3e99
302136.17,3.0,41,4,4,2,10,0xb2d83469d
521000.04,13.0,8,4,4,3,11,0xb2d61162
1917.08,1.0,10,1,2,3,6,0xb2d44d9b
10998.89,1.0,0,2,2,4,8,0xb2d814e9
300012.67,2.0,69,3,3,1,7,0xb2d8e698
150336.14,3.0,80,3,4,1,8,0xb2d5579a
8022.95,3.0,92,2,4,1,7,0xb2d11e8a
269051.12,1.0,0,3,2,4,9,0xb2d26223
88760.5,2.0,92,3,3,1,7,0xb2d07efb
448299.88,5.0,2,4,4,4,12,0xb2d635cb
10112.9,2.0,6,2,3,3,8,0xb2d9412ed
392768.12,3.0,0,4,4,4,12,0xb2d6c2a5
500000.21,3.0,17,4,4,2,10,0xb2d58fbb
731083.51,7.0,20,4,4,2,10,0xb2d1083e
152210.02,1.0,104,3,2,1,6,0xb2d60ef5d
14.55,1.0,208,1,2,1,4,0xb2d16c1a
868868.6,5.0,116,4,4,1,9,0xb2d1181b
250010.56,2.0,69,3,3,1,7,0xb2d8e666
552027.17,5.0,14,4,4,3,11,0xb2d0b06e
280023.02,3.0,87,3,4,1,8,0xb2d0fa67
2610077.3,5.0,139,4,4,1,9,0xb2d5ff2d
2501.02,1.0,10,1,2,3,6,0xb2d786ce
57.51,1.0,13,1,2,3,6,0xb2d4917d
483549.33,4.0,11,4,4,3,11,0xb2d37061
905.53,1.0,34,1,2,2,5,0xb2d5fabf
135003.58,4.0,25,3,4,2,9,0xb2d283e8
9421.3,1.0,12,2,2,3,7,0xb2d24047
8039.95,1.0,97,2,2,1,5,0xb2d48c75
10006.36,2.0,27,2,3,2,7,0xb2d10253
4171.3,1.0,7,2,2,3,7,0xb2d3983d
4025.35,1.0,0,2,2,4,8,0xb2d9269f
255302.45,3.0,0,3,4,4,11,0xb2d2f2a3
110012.01,2.0,136,3,3,1,7,0xb2d6561f
500000.0,2.0,1,4,3,4,11,0xb2d9b784
4771566.44,18.0,0,4,4,4,12,0x3b9ae40e
8244.73,1.0,4,2,2,4,8,0xb2d9147d
500000.0,2.0,15,4,3,3,10,0xb2da3969
51786.76,1.0,0,2,2,4,8,0xb2d40dbc
100000.0,2.0,0,3,3,4,10,0xb2d97c94
160043.38,3.0,14,3,4,3,10,0xb2d25191
51630.74,2.0,27,2,3,2,7,0xb2d5e64b
2944.99,2.0,16,2,3,2,7,0x3b9b43b5
32541.9,1.0,208,2,2,1,5,0xb2d315d3d
35000.9,4.0,27,2,4,2,8,0xb2d9ce18
198.03,2.0,0,1,3,4,8,0xb2d9fdfc
300155.58,2.0,9,4,3,3,10,0xb2d5ae84
56934.48,2.0,94,3,3,1,7,0xb2d14927
500000.9,2.0,6,4,3,3,10,0xb2d655ea
1007486.54,2.0,78,4,3,1,8,0xb2d41088
6526.16,1.0,46,2,2,2,6,0xb2d47612
785688.95,8.0,0,4,4,4,12,0xb2d51251
50016.89,2.0,0,2,3,4,9,0xb2d9251c
30135.55,2.0,16,2,3,2,7,0x3b9b3efb
550891.4,3.0,32,4,4,2,10,0xb2d651a0
330910.44,2.0,34,4,3,2,9,0xb2d6af8b
95000.0,5.0,5,3,4,3,10,0xb2d51f06
3154.22,1.0,0,2,2,4,8,0xb2d8da51d
218071.33,3.0,14,3,4,3,10,0xb2d59f52
500031.62,3.0,6,4,4,3,11,0xb2d9a5b5
487422.4,4.0,24,4,4,2,10,0xb2d3819a
1150040.64,2.0,49,4,3,2,9,0xb2d9d26a
968.06,1.0,7,1,2,3,6,0xb2d210bc
70002.22,3.0,11,3,4,3,10,0xb2d56e8b
5217.51,1.0,150,2,2,1,5,0xb2d5aa11
1662.61,1.0,92,1,2,1,4,0xb2d15691
180007.65,2.0,221,3,3,1,7,0xb2d63dd5
302477.29,3.0,7,4,4,3,11,0xb2d680ca
25810.06,1.0,0,2,2,4,8,0xb2d4ad24
180025.98,3.0,2,3,4,4,11,0xb2d13f3c
200000.0,2.0,25,3,3,2,8,0xb2da147b
1638.99,1.0,0,1,2,4,7,0xb2d3c65e
80100.02,1.0,1,3,2,4,9,0xb2d5a195
4622.58,1.0,9,2,2,3,7,0xb2d5a5be
33555.07,1.0,1,2,2,4,8,0xb2d6bf8f
2908.09,1.0,0,2,2,4,8,0xb2d787a4
110025.48,3.0,0,3,4,4,11,0xb2d0ed60
2090059.53,6.0,11,4,4,3,11,0xb2d24cb3d
2311411.13,3.0,32,4,4,2,10,0xb2d56e46d
709091.15,10.0,1,4,4,4,12,0x3b9af27e
419197.19,9.0,4,4,4,4,12,0xb2d548b6
0.0,1.0,7,1,2,3,6,0xb2d5d3c5
8495.39,1.0,5,2,2,3,7,0xb2d6f411
290030.33,6.0,2,3,4,4,11,0x3b9b29b7
220000.0,2.0,0,3,3,4,10,0xb2da6a2e
69323.5,1.0,9,3,2,3,8,0xb2d59c44
596992.42,9.0,0,4,4,4,12,0xb2d0c71c
690083.9,8.0,7,4,4,3,11,0xb2d1a937d
125502.37,2.0,92,3,3,1,7,0xb2d330a6
320000.0,2.0,6,4,3,3,10,0xb2d9732dd
352.86,1.0,30,1,2,2,5,0xb2d56169
2180.39,1.0,19,1,2,2,5,0xb2d4637ed
42.16,1.0,1,1,2,4,7,0xb2d23e62
2278.78,1.0,0,1,2,4,7,0xb2d6809c
352906.71,2.0,13,4,3,3,10,0xb2d3a89b
201339.82,3.0,7,3,4,3,10,0xb2d63a3c
57004.56,1.0,16,3,2,2,7,0xb2da26b0
310743.25,4.0,144,4,4,1,9,0xb2d0862d
1743.59,1.0,184,1,2,1,4,0xb2d147c9d
2158.81,1.0,6,1,2,3,6,0xb2d47deb
143396.1,4.0,45,3,4,2,9,0xb2d0a223
1080853.87,5.0,1,4,4,4,12,0xb2d4bddd
56002.49,2.0,193,3,3,1,7,0xb2d5d1f1
10606.0,1.0,46,2,2,2,6,0xb2d6a55e
102496.59,3.0,6,3,4,3,10,0xb2d61991
3440816.19,1.0,0,4,2,4,10,0xb2d1ca0c
330333.11,2.0,0,4,3,4,11,0xb2d34ec9
4033.05,1.0,0,2,2,4,8,0xb2d69b32
3689.19,1.0,92,2,2,1,5,0xb2d2074f
177009.73,3.0,147,3,4,1,8,0xb2d146af
250916.06,4.0,0,3,4,4,11,0xb2d12b3f
429806.1,4.0,0,4,4,4,12,0xb2d23698
2.11,1.0,12,1,2,3,6,0xb2d91e74
4754.09,1.0,217,2,2,1,5,0xb2d26e5f
250000.0,2.0,6,3,3,3,9,0xb2da5c00
400056.99,4.0,1,4,4,4,12,0xb2d10e50
120978.09,1.0,10,3,2,3,8,0xb2d9f159
500000.04,2.0,7,4,3,3,10,0xb2d93005
15616.41,1.0,2,2,2,4,8,0xb2d32a4fd
1200367.72,2.0,16,4,3,2,9,0xb2d3b8b5
300008.02,6.0,4,3,4,4,11,0xb2d28062
121.39,1.0,43,1,2,2,5,0xb2d8e040
1143.84,1.0,92,1,2,1,4,0xb2d2f979
224337.54,2.0,7,3,3,3,9,0xb2d8d7afd
181.57,1.0,79,1,2,1,4,0xb2d2f831
10043.77,1.0,184,2,2,1,5,0xb2d5d7d4
11100.08,2.0,41,2,3,2,7,0xb2d9e276
883.09,1.0,7,1,2,3,6,0xb2d3750e
610019.34,2.0,151,4,3,1,8,0xb2d8fa10
671035.81,10.0,10,4,4,3,11,0xb2d61572
56000.0,4.0,0,3,4,4,11,0xb2d5a07b
289038.11,2.0,82,3,3,1,7,0xb2d382e6
3525.47,1.0,92,2,2,1,5,0xb2d44284
873289.96,3.0,38,4,4,2,10,0xb2d3b149
335000.0,2.0,6,4,3,3,10,0xb2da4ea5
3195.98,1.0,9,2,2,3,7,0xb2d69582
51518.33,2.0,196,2,3,1,6,0xb2d581c7d
827197.1,9.0,0,4,4,4,12,0xb2d43fca
47814.04,2.0,27,2,3,2,7,0xb2d26787d
600006.33,3.0,27,4,4,2,10,0xb2d9410d
89.32,1.0,7,1,2,3,6,0xb2d2e3e5
10000.11,2.0,83,2,3,1,6,0xb2d8d158d
990038.9,4.0,3,4,4,4,12,0xb2d405a3
20818.58,1.0,0,2,2,4,8,0xb2d405c2
19.79,1.0,88,1,2,1,4,0xb2d0cecd
2016.95,1.0,92,1,2,1,4,0xb2d2fdc7
17220.37,1.0,13,2,2,3,7,0xb2d8f059
618089.39,4.0,46,4,4,2,10,0xb2d16508
122840.33,2.0,45,3,3,2,8,0xb2d584d5
2010.93,1.0,0,1,2,4,7,0xb2d9d421
3301.34,1.0,0,2,2,4,8,0xb2d9ab68
12475.26,1.0,97,2,2,1,5,0xb2d430fe
162796.79,3.0,8,3,4,3,10,0xb2d117a8
71564.41,2.0,1,3,3,4,10,0xb2d6da45
1320.07,1.0,0,1,2,4,7,0xb2d30b11
869.43,2.0,0,1,3,4,8,0x3b9b4679
189.96,1.0,12,1,2,3,6,0xb2d96250
400002.35,3.0,13,4,4,3,11,0xb2d901f5
14366.02,1.0,0,2,2,4,8,0xb2d7a9e8
1107716.49,13.0,0,4,4,4,12,0x3b9af228d
329790.74,4.0,47,4,4,2,10,0xb2d53898d
327450.14,2.0,82,4,3,1,8,0xb2d5cca8
31282.45,1.0,0,2,2,4,8,0xb2d3971d
50000.0,2.0,0,2,3,4,9,0xb2d97c52d
26495981.9,1.0,3,4,2,4,10,0xb2d2a251
1513.4,1.0,60,1,2,2,5,0xb2d5df6c
102868.23,1.0,1,3,2,4,9,0xb2d2ba2b
5490.43,1.0,0,2,2,4,8,0xb2d443bd
210002.62,5.0,5,3,4,3,10,0xb2d59454
30001.87,2.0,20,2,3,2,7,0xb2d6b2ba
1338.56,1.0,15,1,2,3,6,0xb2d2cf4e
527.56,1.0,1,1,2,4,7,0xb2d410f6
40001.06,3.0,92,2,4,1,7,0xb2d9402ad
1400014.78,2.0,94,4,3,1,8,0xb2d88b19
208945.5,2.0,62,3,3,2,8,0xb2d8f723
230069.84,3.0,122,3,4,1,8,0xb2d6082d
50003.17,2.0,41,2,3,2,7,0xb2d90e9a
0.3,2.0,47,1,3,2,6,0xb2d97ee8d
1227888.29,6.0,53,4,4,2,10,0xb2d4e24f
7471.54,1.0,19,2,2,2,6,0xb2d3bbd3
57488.38,2.0,139,3,3,1,7,0xb2d2a687
27002.31,2.0,3,2,3,4,9,0xb2d3d976
4951.68,1.0,3,2,2,4,8,0xb2d91f57
19889.55,1.0,264,2,2,1,5,0xb2d41dcd
264.18,1.0,9,1,2,3,6,0xb2d23322
386685.12,15.0,0,4,4,4,12,0xb2d4e186d
110067.84,2.0,0,3,3,4,10,0xb2d0e72bd
169.14,1.0,10,1,2,3,6,0xb2d26a2d
255027.48,3.0,39,3,4,2,9,0xb2d9185ad
15100.82,1.0,9,2,2,3,7,0xb2d8cd69
50003.17,2.0,56,2,3,2,7,0xb2d9be0c
79.63,1.0,22,1,2,2,5,0xb2d8ee77
0.3,1.0,6,1,2,3,6,0xb2d2d10d
800083.69,2.0,18,4,3,2,9,0xb2d98611
2.22,1.0,27,1,2,2,5,0xb2d6a92b
1893.38,1.0,0,1,2,4,7,0xb2d38678
75003.5,1.0,1,3,2,4,9,0xb2d2ad57d
21.09,1.0,5,1,2,3,6,0xb2d69ebf
50000.53,2.0,10,2,3,3,8,0xb2d966ce
50459.02,1.0,196,2,2,1,5,0xb2d323b5
20615.15,1.0,0,2,2,4,8,0xb2d195b5
186836.39,3.0,47,3,4,2,9,0x3b9b3dbc
2550.61,1.0,5,1,2,3,6,0xb2d34a70d
31779.89,1.0,21,2,2,2,6,0xb2da06d5
205302.15,1.0,194,3,2,1,6,0xb2d2fedb
65013.07,3.0,116,3,4,1,8,0xb2d8df2ed
325442.62,1.0,0,4,2,4,10,0xb2d38e42
491565.7,6.0,18,4,4,2,10,0xb2d1ab22
244932.85,1.0,0,3,2,4,9,0xb2d86e64
1735.04,2.0,184,1,3,1,5,0x3b9b42f9
1759213.29,3.0,97,4,4,1,9,0xb2d0ced8
360270.55,6.0,28,4,4,2,10,0xb2d0dd4b
534.04,1.0,1,1,2,4,7,0xb2d6861dd
31652.44,1.0,14,2,2,3,7,0xb2d4f52d
522.13,2.0,0,1,3,4,8,0xb2d589b5
20312.89,2.0,256,2,3,1,6,0xb2d6098d
500006.95,2.0,5,4,3,3,10,0xb2d8f43a
1012044.81,1.0,45,4,2,2,8,0xb2d20f6c
333538.33,5.0,0,4,4,4,12,0xb2d3be0d
3733.24,1.0,0,2,2,4,8,0xb2d569ea
1135130.44,6.0,60,4,4,2,10,0xb2d1b6fc
1500000.04,3.0,13,4,4,3,11,0xb2d9e806
461000.0,3.0,5,4,4,3,11,0xb2d62149
803437.51,5.0,3,4,4,4,12,0xb2d126b8
15271.83,1.0,2,2,2,4,8,0xb2d5c7ffd
52139.78,1.0,0,2,2,4,8,0xb2d5b9aa
10336.67,2.0,6,2,3,3,8,0xb2d124e5
65.4,1.0,11,1,2,3,6,0xb2d5ff58
50854.34,2.0,153,2,3,1,6,0xb2d61c24
291312.55,6.0,11,3,4,3,10,0xb2d14cfe
95008.47,3.0,9,3,4,3,10,0xb2d930cad
6910.55,3.0,20,2,4,2,8,0x3b9b3e66
10000.42,2.0,35,2,3,2,7,0xb2d78f73
300084.3,2.0,122,3,3,1,7,0xb2d43365
400006.33,3.0,7,4,4,3,11,0xb2da14b7
1041507.48,2.0,21,4,3,2,9,0xb2d8689e
310200.6,5.0,6,4,4,3,11,0xb2d5ea7d
130186.95,2.0,41,3,3,2,8,0xb2d92026
2189038.22,3.0,0,4,4,4,12,0xb2d53d26d
200004.22,2.0,53,3,3,2,8,0xb2d9cc2b
3730.87,1.0,1,2,2,4,8,0xb2d289cf
114.84,1.0,9,1,2,3,6,0xb2d2d3f9
302424.75,2.0,52,4,3,2,9,0xb2d4ead2
603.16,1.0,18,1,2,2,5,0xb2d5d411
188281.56,1.0,0,3,2,4,9,0xb2d125c7d
83388.51,2.0,56,3,3,2,8,0xb2d5d056
14.36,1.0,19,1,2,2,5,0xb2d9438a
85045.1,8.0,0,3,4,4,11,0xb2d54a8c
63996.39,6.0,0,3,4,4,11,0xb2d0e2f1
566490.82,5.0,21,4,4,2,10,0xb2d56aa7
34434.97,3.0,3,2,4,4,10,0xb2d63a22
52228.2,1.0,1,3,2,4,9,0xb2d2be9b
601069.27,3.0,9,4,4,3,11,0xb2d68fd6
100002.11,2.0,31,3,3,2,8,0xb2d9397b
16.27,1.0,40,1,2,2,5,0xb2d98904
120002.54,3.0,123,3,4,1,8,0xb2d6f20ed
7098.63,1.0,15,2,2,3,7,0xb2d31de5
0.06,1.0,1,1,2,4,7,0xb2d3fe24
1202.02,1.0,152,1,2,1,4,0xb2d6fe2e
291211.69,4.0,24,3,4,2,9,0xb2d1f7cdd
2194.0,2.0,0,1,3,4,8,0xb2d08fd3
0.0,1.0,0,1,2,4,7,0xb2d3988f
60001.5,4.0,6,3,4,3,10,0xb2d53f94
107773.27,1.0,102,3,2,1,6,0xb2d2610d
505330.59,3.0,84,4,4,1,9,0xb2d6fb95
7.64,1.0,0,1,2,4,7,0xb2d2d2a0
486642.95,2.0,7,4,3,3,10,0xb2d2978f
5524.36,1.0,3,2,2,4,8,0xb2d2669d
31109.53,4.0,19,2,4,2,8,0xb2d0a2a1
177005.38,5.0,26,3,4,2,9,0xb2d12238
1035.64,1.0,10,1,2,3,6,0xb2d8146f
74655.56,2.0,6,3,3,3,9,0xb2d16c44
120183.27,3.0,4,3,4,4,11,0xb2d0f832
601182.6,5.0,26,4,4,2,10,0xb2d07dd3
1012.3,1.0,303,1,2,1,4,0xb2d3c212
178.35,1.0,8,1,2,3,6,0xb2d9360a
130000.0,1.0,7,3,2,3,8,0xb2d94434
17908.62,1.0,5,2,2,3,7,0xb2d6cd2c
600.0,1.0,0,1,2,4,7,0xb2d1bc77
153060.94,3.0,101,3,4,1,8,0xb2d503bb
500627.42,3.0,139,4,4,1,9,0xb2d695fc
620628.99,6.0,3,4,4,4,12,0xb2d61977
219154.53,6.0,1,3,4,4,11,0xb2d6374e
212956.34,1.0,1,3,2,4,9,0xb2d2c582
539.39,1.0,98,1,2,1,4,0xb2d104bc
202249.75,2.0,111,3,3,1,7,0xb2d1b94a
1021169.76,9.0,0,4,4,4,12,0xb2d50d27
963622.62,5.0,69,4,4,1,9,0xb2d265fa
700000.06,4.0,5,4,4,3,11,0xb2d6c5b7
990006.34,9.0,59,4,4,2,10,0xb2d34b29
115008635.84,9.0,13,4,4,3,11,0xb2d3f682
770077.98,6.0,13,4,4,3,11,0xb2d0b850
22680.73,2.0,25,2,3,2,7,0xb2d3539f
614635.85,3.0,11,4,4,3,11,0xb2d347f3
50107.74,1.0,214,2,2,1,5,0xb2d6b3ab
1473.51,1.0,92,1,2,1,4,0xb2d0cadc
72.33,1.0,10,1,2,3,6,0xb2d9f093
2440899.99,3.0,45,4,4,2,10,0xb2d1ae07d
239177.22,2.0,0,3,3,4,10,0xb2d1560d
97024.54,1.0,21,3,2,2,7,0xb2d27610d
5030.74,1.0,187,2,2,1,5,0xb2d5ba37
450018.68,2.0,4,4,3,4,11,0xb2d10afa
130012.93,2.0,0,3,3,4,10,0xb2d5d3ed
22308.04,6.0,0,2,4,4,10,0x3b9b1809d
44718.78,1.0,0,2,2,4,8,0xb2d5b772
490.85,1.0,67,1,2,1,4,0xb2d99b55
7287.8,1.0,3,2,2,4,8,0xb2d8fa39
338562.26,3.0,5,4,4,3,11,0xb2d27ef0
2250732.23,3.0,28,4,4,2,10,0xb2d5668f
505330.14,3.0,43,4,4,2,10,0xb2d7a70f
696.05,1.0,16,1,2,2,5,0xb2d208d6
341039.3,7.0,25,4,4,2,10,0xb2d579e5
10000.32,2.0,11,2,3,3,8,0xb2da3bf9
457707.12,4.0,123,4,4,1,9,0xb2d11a80d
102.21,1.0,0,1,2,4,7,0xb2d4323b
303000.0,2.0,1,4,3,4,11,0xb2d33ce4
401421.08,2.0,57,4,3,2,9,0xb2d9b9f6
420034.72,4.0,7,4,4,3,11,0xb2d22d73d
210003.27,4.0,18,3,4,2,9,0xb2d944da
265658.86,5.0,18,3,4,2,9,0x3b9b49f9d
12948.11,1.0,21,2,2,2,6,0xb2d37a91
60192.59,3.0,63,3,4,2,9,0xb2d7440bd
49865.44,7.0,0,2,4,4,10,0x3b9b3fd7
21.53,1.0,48,1,2,2,5,0xb2d8cc5e
167523.72,1.0,5,3,2,3,8,0xb2d2302f
450.39,1.0,0,1,2,4,7,0xb2d96c4c
172121.01,4.0,0,3,4,4,11,0xb2d3270c
418001.31,3.0,10,4,4,3,11,0xb2d6e0a4
159.86,1.0,0,1,2,4,7,0xb2d9f69c
584.19,3.0,110,1,4,1,6,0x3b9b440b
1374.89,1.0,119,1,2,1,4,0xb2d42cd2
34.3,1.0,36,1,2,2,5,0xb2d69e80
40.0,1.0,5,1,2,3,6,0xb2d9be36
150.23,1.0,23,1,2,2,5,0xb2d2dcd3
5801.26,4.0,0,2,4,4,10,0x3b9b3b15
3358.48,1.0,0,2,2,4,8,0xb2d6524e
6.92,1.0,40,1,2,2,5,0xb2d632df
527614.9,6.0,21,4,4,2,10,0xb2d478ead
500076.83,2.0,139,4,3,1,8,0xb2d473b2
251700.27,3.0,70,3,4,1,8,0xb2d5f3b6
1661.52,1.0,18,1,2,2,5,0xb2d4c84c
250005.28,2.0,38,3,3,2,8,0xb2d929e1
16483.05,1.0,92,2,2,1,5,0xb2d58a49
400307.49,4.0,0,4,4,4,12,0x3b9adbf2
51.62,1.0,84,1,2,1,4,0xb2d54bc1
1103116.9,3.0,3,4,4,4,12,0xb2d3b008
1991095.28,9.0,2,4,4,4,12,0xb2d39348d
5548.73,1.0,173,2,2,1,5,0xb2d3027f
503181.65,1.0,184,4,2,1,7,0xb2d2b6d5
43539.32,1.0,0,2,2,4,8,0xb2d6445a
1727.5,1.0,24,1,2,2,5,0xb2d2044c
73688.49,2.0,3,3,3,4,10,0xb2d0cd7d
385.2,1.0,75,1,2,1,4,0xb2d356f2
0.95,1.0,100,1,2,1,4,0xb2d6fd1d
31028.21,1.0,6,2,2,3,7,0xb2d5684ed
101809.27,2.0,3,3,3,4,10,0xb2d3b501d
4510.55,1.0,202,2,2,1,5,0xb2d3bc89
19250.26,1.0,15,2,2,3,7,0xb2d6d4b7
10083.25,2.0,147,2,3,1,6,0xb2d10706
60241.57,2.0,0,3,3,4,10,0xb2d5b2c3
664.12,1.0,4,1,2,4,7,0xb2d266b7
220000.5,2.0,5,3,3,3,9,0xb2d6a96c
5618.78,1.0,0,2,2,4,8,0xb2d2f6db
307005.41,2.0,15,4,3,3,10,0xb2d4d15c
403835.93,4.0,46,4,4,2,10,0xb2d6e6c6
25001.79,2.0,48,2,3,2,7,0xb2d825aa
13508.95,1.0,8,2,2,3,7,0xb2d57862
92003.43,5.0,20,3,4,2,9,0xb2d93c1f
166156.7,3.0,4,3,4,4,11,0xb2d5a454
951481.53,5.0,20,4,4,2,10,0xb2d1f6df
351097.5,4.0,14,4,4,3,11,0xb2d554a2
1301839.33,1.0,143,4,2,1,7,0xb2d6edd4
433661.29,2.0,13,4,3,3,10,0xb2d18664
200010.42,2.0,7,3,3,3,9,0xb2d90c4a
350192.48,3.0,8,4,4,3,11,0xb2d21319
27223.84,1.0,1,2,2,4,8,0xb2d37d4a
11081.09,1.0,0,2,2,4,8,0xb2d20878
438128.12,5.0,11,4,4,3,11,0xb2d8f9cf
2.11,1.0,79,1,2,1,4,0xb2d993f8
419.71,1.0,10,1,2,3,6,0xb2d966b6
9112.48,1.0,0,2,2,4,8,0xb2d6a663
39150.58,1.0,1,2,2,4,8,0xb2d2b030
2833.59,1.0,28,1,2,2,5,0xb2d6bda5
1102.39,5.0,0,1,4,4,9,0x3b9b482b
4757.54,1.0,19,2,2,2,6,0xb2d9ddfd
365661.18,3.0,0,4,4,4,12,0xb2d4648f
667043.29,3.0,66,4,4,2,10,0xb2d5e44f
1000000.11,5.0,2,4,4,4,12,0xb2d0c55c
60251.47,3.0,4,3,4,4,11,0xb2d2b5c5d
899277.21,4.0,27,4,4,2,10,0xb2d40f4d
394186.72,3.0,31,4,4,2,10,0xb2d1f800
200010.42,2.0,2,3,3,4,10,0xb2d92d32
40002.88,2.0,53,2,3,2,7,0xb2d5e93d
15615.38,1.0,24,2,2,2,6,0xb2d5c8a9
50413.53,2.0,122,2,3,1,6,0xb2d68282d
200865.94,2.0,30,3,3,2,8,0xb2d64d4e
31102.28,1.0,82,2,2,1,5,0xb2d63485d
30115.42,3.0,4,2,4,4,10,0xb2d9f7a3
140535.75,2.0,95,3,3,1,7,0xb2d62595
1063598.1,6.0,6,4,4,3,11,0xb2d2e42c
30435.18,2.0,40,2,3,2,7,0xb2d61747
482647.9,1.0,0,4,2,4,10,0xb2d4888c
81047.22,4.0,0,3,4,4,11,0xb2d16450
1505339.99,2.0,48,4,3,2,9,0xb2d8cb3ed
464891.61,3.0,3,4,4,4,12,0xb2d55778
3042.7,2.0,184,2,3,1,6,0xb2d08107
13405.92,1.0,3,2,2,4,8,0xb2d39927
1300072.42,2.0,144,4,3,1,8,0xb2d3f55f
17789.81,1.0,4,2,2,4,8,0xb2d6e775
3493.98,1.0,1,2,2,4,8,0xb2d3ee3b
50961.42,2.0,228,2,3,1,6,0xb2d57e52
550149.89,6.0,8,4,4,3,11,0xb2d5940a
8082.64,1.0,184,2,2,1,5,0xb2d2c67b
4861.97,1.0,196,2,2,1,5,0xb2d12289
47197.83,5.0,0,2,4,4,10,0xb2d2127a
200335.74,2.0,20,3,3,2,8,0xb2d8d1b9
25280.13,1.0,0,2,2,4,8,0xb2d29254
430049.96,6.0,117,4,4,1,9,0xb2d0e3ce
725005.08,27.0,21,4,4,2,10,0xb2d0de6dd
151172.92,4.0,31,3,4,2,9,0xb2d246ebd
439616.73,2.0,214,4,3,1,8,0xb2d121ca
64.11,1.0,22,1,2,2,5,0xb2d98e87
5.27,1.0,10,1,2,3,6,0xb2d64eeb
35005.24,2.0,47,2,3,2,7,0xb2d7884f
79947.44,1.0,11,3,2,3,8,0xb2d43664
3571.22,1.0,55,2,2,2,6,0xb2d315d7
405333.82,3.0,22,4,4,2,10,0xb2d6bc88
1.0,1.0,3,1,2,4,7,0xb2d62e12
11103.63,1.0,184,2,2,1,5,0xb2d2eaf9
150231.51,2.0,92,3,3,1,7,0xb2d636dc
26865.43,1.0,4,2,2,4,8,0xb2d52cc3
203561.0,2.0,32,3,3,2,8,0xb2d6d752
2020.68,1.0,92,1,2,1,4,0xb2d27dcb
150010.73,5.0,20,3,4,2,9,0xb2d1a580
696497.26,16.0,0,4,4,4,12,0xb2d2527c
1459.03,1.0,184,1,2,1,4,0xb2d2a130
200017.03,2.0,130,3,3,1,7,0xb2d6e1d1
300005.28,3.0,38,3,4,2,9,0xb2d928f7
550272.55,4.0,0,4,4,4,12,0xb2d59576
923.31,1.0,3,1,2,4,7,0xb2d29f84
0.58,1.0,6,1,2,3,6,0xb2d8d14f
150127.32,2.0,18,3,3,2,8,0xb2d5e9b2
230008.72,3.0,116,3,4,1,8,0xb2d53aa6
204920.83,2.0,213,3,3,1,7,0xb2d1f4e9
51348.78,2.0,20,2,3,2,7,0xb2d40f65
1841.79,1.0,8,1,2,3,6,0xb2d718b6
75.94,1.0,1,1,2,4,7,0xb2d28ff3
516.09,1.0,2,1,2,4,7,0xb2d58707
306345.02,2.0,16,4,3,2,9,0xb2d249e0
950068.71,2.0,4,4,3,4,11,0xb2d1f3d2
915000.31,8.0,5,4,4,3,11,0xb2d2a2a0d
3748.25,1.0,184,2,2,1,5,0xb2d15da4
21168.74,1.0,13,2,2,3,7,0xb2d6d7d6
593289.66,12.0,1,4,4,4,12,0x3b9b180b
530456.71,8.0,46,4,4,2,10,0xb2d4ef62d
2040.41,1.0,7,1,2,3,6,0xb2d78b0a
378.65,1.0,39,1,2,2,5,0xb2d1784a
6988.25,3.0,0,2,4,4,10,0xb2d0853d
4195.15,1.0,9,2,2,3,7,0xb2d65364
480020.27,2.0,97,4,3,1,8,0xb2d827a9
18041.41,1.0,92,2,2,1,5,0xb2d2f45ed
1006.36,1.0,92,1,2,1,4,0xb2d6217f
1803345.22,4.0,8,4,4,3,11,0xb2d9b2fd
53180.46,2.0,83,3,3,1,7,0xb2d1dc3a
11350.98,1.0,0,2,2,4,8,0xb2d2a611
149054.49,10.0,1,3,4,4,11,0xb2d217d2
10102.15,1.0,0,2,2,4,8,0xb2d5922b
300000.0,1.0,0,3,2,4,9,0xb2d98310
22.18,1.0,11,1,2,3,6,0xb2d7f32c
27297.12,1.0,27,2,2,2,6,0xb2d65951
1547189.32,2.0,111,4,3,1,8,0xb2d782cb
334740.12,2.0,4,4,3,4,11,0x3b9b4994
1466.87,1.0,16,1,2,2,5,0xb2d8c5b0
200440.95,4.0,11,3,4,3,10,0xb2d2d1b6d
783177.8,8.0,18,4,4,2,10,0xb2d46e70
1600000.0,3.0,3,4,4,4,12,0xb2d67e29d
100753.25,1.0,1,3,2,4,9,0xb2d5af86
200014.79,2.0,189,3,3,1,7,0xb2d7fcf2
20789.63,2.0,11,2,3,3,8,0xb2d631ee
25000574.12,2.0,14,4,3,3,10,0xb2d0f470
7944.79,1.0,0,2,2,4,8,0xb2d6b0f7
1001.16,1.0,120,1,2,1,4,0xb2d919fc
0.64,1.0,184,1,2,1,4,0xb2d2a8a5
30404.44,2.0,0,2,3,4,9,0xb2d6a5d9
1107.9,1.0,184,1,2,1,4,0xb2d40584
40000.0,1.0,6,2,2,3,7,0xb2d95301
150599.82,2.0,130,3,3,1,7,0xb2d42479
21147.29,1.0,26,2,2,2,6,0xb2d92011
20774.5,2.0,214,2,3,1,6,0xb2d55cf5
330014.68,4.0,34,4,4,2,10,0xb2d9d6ba
181701.66,3.0,24,3,4,2,9,0xb2d5f288
500002.59,3.0,18,4,4,2,10,0xb2d65a0a
47606.83,1.0,10,2,2,3,7,0xb2d916a8d
456.93,1.0,60,1,2,2,5,0xb2d58bbf
28019.91,1.0,0,2,2,4,8,0xb2d55fcb
10290.89,2.0,95,2,3,1,6,0xb2d64fab
450203.14,3.0,28,4,4,2,10,0xb2d50acf
2915106.67,13.0,0,4,4,4,12,0xb2d5ec48
696.77,1.0,0,1,2,4,7,0xb2d14e80
559.75,1.0,10,1,2,3,6,0xb2d5c398d
1836.02,1.0,0,1,2,4,7,0xb2d7c057
4412.26,1.0,184,2,2,1,5,0xb2d273f1
914696.25,1.0,0,4,2,4,10,0xb2d56b0e
100028.84,2.0,48,3,3,2,8,0xb2d5658c
404735.29,2.0,24,4,3,2,9,0xb2d25334
167.42,1.0,70,1,2,1,4,0xb2d24b5e
1374551.17,11.0,0,4,4,4,12,0xb2d069fed
4.55,2.0,17,1,3,2,6,0xb2d0b9d7
50005.06,2.0,189,2,3,1,6,0xb2d85705d
6050.87,1.0,45,2,2,2,6,0xb2d23699
3204.17,1.0,11,2,2,3,7,0xb2d304a6
393172.01,4.0,74,4,4,1,9,0xb2d1992d
7382.81,13.0,0,2,4,4,10,0xb2d0647fd
105302.95,2.0,32,3,3,2,8,0xb2d386ea
6158.2,1.0,21,2,2,2,6,0xb2d6b8e2
39.58,2.0,17,1,3,2,6,0xb2d9524a
340371.31,9.0,3,4,4,4,12,0xb2d62626
107798.89,3.0,4,3,4,4,11,0xb2d57998
4289.46,1.0,193,2,2,1,5,0xb2d0e2c1d
20079.83,1.0,22,2,2,2,6,0xb2d92859
810263.48,3.0,10,4,4,3,11,0xb2d0b9f4
500042.18,3.0,12,4,4,3,11,0xb2d55700
351593.31,3.0,32,4,4,2,10,0xb2d69e8cd
1173.57,7.0,56,1,4,2,7,0xb2d24ba2
80164.5,1.0,13,3,2,3,8,0xb2d2dcd3d
115000.0,5.0,6,3,4,3,10,0xb2d59087
600063.62,3.0,0,4,4,4,12,0xb2d6a246
441170.56,3.0,32,4,4,2,10,0xb2d56c90d
4410.19,1.0,14,2,2,3,7,0xb2d25812
1104.65,1.0,76,1,2,1,4,0xb2d3e821
460.01,1.0,0,1,2,4,7,0xb2d6b9b9
200088.75,2.0,77,3,3,1,7,0xb2d8d028
3785.92,1.0,81,2,2,1,5,0xb2d2929a
10003.69,2.0,11,2,3,3,8,0xb2d64a23
435.56,1.0,48,1,2,2,5,0xb2d52fda
26499.44,1.0,3,2,2,4,8,0xb2d600f9
114.38,1.0,0,1,2,4,7,0xb2d8d1cf
239870.03,2.0,0,3,3,4,10,0xb2d234aa
80187.63,4.0,25,3,4,2,9,0xb2d62f49
48.39,1.0,29,1,2,2,5,0xb2d9c36b
31.88,5.0,65,1,4,2,7,0xb2d48090
500592.84,2.0,5,4,3,3,10,0xb2d8e4f1
85015.71,1.0,9,3,2,3,8,0xb2d5090d
31642.03,1.0,14,2,2,3,7,0xb2d1e92a
101024.94,2.0,90,3,3,1,7,0xb2d4dfa2
100051.17,3.0,79,3,4,1,8,0xb2d4262e
523.6,1.0,2,1,2,4,7,0xb2d2b2be
3111.28,1.0,4,2,2,4,8,0xb2d3e994
175519.37,2.0,80,3,3,1,7,0xb2d5c705
3574.74,1.0,0,2,2,4,8,0xb2d463a0
100005.52,2.0,27,3,3,2,8,0xb2d6af66
950579.16,2.0,0,4,3,4,11,0xb2d0b708d
50571.25,2.0,11,2,3,3,8,0xb2d381c9
0.07,1.0,11,1,2,3,6,0xb2d5afc0
5387.07,1.0,122,2,2,1,5,0xb2d607f5
364617.86,6.0,1,4,4,4,12,0xb2d0b645
477237.5,4.0,0,4,4,4,12,0xb2d1bc9d
24089.97,2.0,0,2,3,4,9,0xb2d68ddd
4977.31,1.0,27,2,2,2,6,0xb2d28541
180004.64,4.0,32,3,4,2,9,0xb2d814c7
470021.32,3.0,0,4,4,4,12,0xb2d23b30
400604.25,2.0,0,4,3,4,11,0xb2d210f6
45713.52,1.0,10,2,2,3,7,0xb2d5d609
102.56,1.0,57,1,2,2,5,0xb2d7f080
180181.69,4.0,24,3,4,2,9,0xb2d2e903
200201.81,2.0,101,3,3,1,7,0xb2d2faeb
13.81,1.0,17,1,2,2,5,0xb2d6bd94
1020.47,1.0,92,1,2,1,4,0xb2d5d507
48541.64,1.0,10,2,2,3,7,0xb2d28962
173003.65,1.0,0,3,2,4,9,0xb2d59163d
104.13,1.0,60,1,2,2,5,0xb2d51cb3
27442.21,1.0,0,2,2,4,8,0xb2d0d6ec
350000.12,2.0,10,4,3,3,10,0xb2d929cc
2431.49,1.0,152,1,2,1,4,0xb2d1e5ac
3939.14,1.0,74,2,2,1,5,0xb2d40ccf
191.9,1.0,1,1,2,4,7,0xb2d2314f
82007.52,2.0,83,3,3,1,7,0xb2d59ef3
1446739.08,7.0,31,4,4,2,10,0xb2d145d5
5.09,1.0,75,1,2,1,4,0xb2d912f6
280000.0,2.0,24,3,3,2,8,0xb2d9cf30
4060.1,1.0,2,2,2,4,8,0xb2d6f5a0
513089.44,3.0,0,4,4,4,12,0xb2d8e91c
10003.15,2.0,95,2,3,1,6,0xb2d56f15
0.69,1.0,4,1,2,4,7,0xb2d26e1b
1022.22,1.0,184,1,2,1,4,0x3b9b3866
1431039.74,9.0,4,4,4,4,12,0xb2d12023
402992.3,2.0,54,4,3,2,9,0xb2d5f8bc
7098.76,1.0,0,2,2,4,8,0xb2d34349
319360.58,3.0,10,4,4,3,11,0xb2d3c058
300000.7,2.0,15,3,3,3,9,0xb2d68a7c
10295.45,1.0,34,2,2,2,6,0xb2d758c6d
1501776.34,7.0,6,4,4,3,11,0xb2d90550
10047.97,2.0,5,2,3,3,8,0xb2d607e6
200997.45,2.0,63,3,3,2,8,0xb2d23240d
313540.45,3.0,14,4,4,3,11,0xb2d0aa5e
1236.48,1.0,0,1,2,4,7,0xb2d7c2e7
52599.19,2.0,8,3,3,3,9,0xb2d5b989
300004.64,1.0,2,3,2,4,9,0xb2d4257a
43342.46,1.0,6,2,2,3,7,0xb2d5e6c5
8071.27,1.0,184,2,2,1,5,0xb2d110ec
160497.22,3.0,5,3,4,3,10,0xb2d98b64
23.43,1.0,70,1,2,1,4,0xb2d16f3c
400030.0,4.0,5,4,4,3,11,0xb2d6ceb8
110001.16,2.0,46,3,3,2,8,0xb2d9e238
54319.4,1.0,0,3,2,4,9,0xb2d6b84a
1232.55,1.0,11,1,2,3,6,0xb2d61b09
278515.45,2.0,48,3,3,2,8,0xb2d17029
240074.13,2.0,92,3,3,1,7,0xb2d59fc8
50002.53,2.0,10,2,3,3,8,0xb2d59426
130392.03,4.0,48,3,4,2,9,0xb2d69d29
69.58,1.0,74,1,2,1,4,0xb2d10e7a
2669.38,1.0,0,1,2,4,7,0xb2d6a774d
4182.22,2.0,184,2,3,1,6,0x3b9b1938
1921.79,1.0,0,1,2,4,7,0xb2d3e864
311000.0,2.0,0,4,3,4,11,0xb2d3bc6cd
5132.79,1.0,2,2,2,4,8,0xb2d1e628d
82.65,1.0,14,1,2,3,6,0xb2d4f50e
614.07,2.0,0,1,3,4,8,0x3b9af188
794930.09,3.0,6,4,4,3,11,0xb2d9b3ec
1014.09,1.0,92,1,2,1,4,0xb2d113b4
59201.76,1.0,184,3,2,1,6,0xb2d0e1d9
22733.6,1.0,265,2,2,1,5,0xb2d589efd
5447.07,1.0,0,2,2,4,8,0xb2d39e11
77051.79,3.0,80,3,4,1,8,0xb2d590e7
58.86,1.0,0,1,2,4,7,0xb2d56d74
6500126.66,7.0,1,4,4,4,12,0xb2d9f901
28.93,1.0,23,1,2,2,5,0xb2d4f9d7
65326.51,2.0,116,3,3,1,7,0xb2d51250
700960.29,2.0,52,4,3,2,9,0xb2d61095d
1280959.45,5.0,7,4,4,3,11,0xb2d7b111d
500037.29,3.0,83,4,4,1,9,0xb2d61898
906.14,1.0,0,1,2,4,7,0xb2d2f886
220302.45,4.0,1,3,4,4,11,0xb2d3a597
320013.43,4.0,1,4,4,4,12,0xb2d77fab
70001.48,2.0,74,3,3,1,7,0xb2d45ad0
4.72,3.0,1,1,4,4,9,0x3b9b288dd
255.96,1.0,9,1,2,3,6,0xb2d51719
280006.42,1.0,1,3,2,4,9,0xb2d42bf3
3078.44,1.0,184,2,2,1,5,0xb2d19932d
150001.58,2.0,6,3,3,3,9,0xb2d94261
30093.61,2.0,53,2,3,2,7,0xb2d6495a
1463.23,1.0,232,1,2,1,4,0xb2d620ec
118.28,1.0,5,1,2,3,6,0xb2d82987
808.34,4.0,2,1,4,4,9,0xb2d5290c
518.16,1.0,35,1,2,2,5,0xb2d30c90
100084.13,2.0,104,3,3,1,7,0xb2d3616d
470000.0,13.0,1,4,4,4,12,0xb2d603c0
454254.56,15.0,0,4,4,4,12,0xb2d60b76d
260086.52,3.0,74,3,4,1,8,0xb2d26264
470556.88,5.0,4,4,4,4,12,0xb2d6c6f3
1008.22,1.0,184,1,2,1,4,0xb2d31b57
16648.0,2.0,92,2,3,1,6,0x3b9b0f30
656346.9,9.0,4,4,4,4,12,0x3b9ad187
237060.57,5.0,9,3,4,3,10,0xb2d27627
291010.23,5.0,0,3,4,4,11,0xb2d8db22
42760.58,3.0,92,2,4,1,7,0x3b9b169b
542038.36,2.0,5,4,3,3,10,0xb2d16d0d
67863.63,1.0,1,3,2,4,9,0xb2d5d5cc
0.78,3.0,5,1,4,3,8,0xb2d0c2e8
11298.39,1.0,1,2,2,4,8,0xb2d521cf
16105.5,2.0,35,2,3,2,7,0xb2d2833b
415.73,3.0,0,1,4,4,9,0xb2d0a750
98212.14,1.0,3,3,2,4,9,0xb2d343ce
113471.94,1.0,0,3,2,4,9,0xb2d24471
7468.17,1.0,92,2,2,1,5,0xb2d30b9f
51784.22,2.0,129,2,3,1,6,0xb2d64272
865.75,1.0,0,1,2,4,7,0xb2d8e6f8
433697.41,3.0,11,4,4,3,11,0xb2d65449
650011.66,3.0,186,4,4,1,9,0xb2d3c7cf
15693.05,1.0,92,2,2,1,5,0xb2d0eea8
50016.87,2.0,95,2,3,1,6,0xb2d62165
69760.04,4.0,0,3,4,4,11,0xb2d5303b
470738.94,4.0,12,4,4,3,11,0xb2d2a83c
1793076.64,10.0,20,4,4,2,10,0x3b9ae3fe
203178.78,2.0,1,3,3,4,10,0xb2d0f701
100000.0,2.0,50,3,3,2,8,0xb2d69f32
10043.87,2.0,147,2,3,1,6,0xb2d85ca6d
749.6,1.0,3,1,2,4,7,0xb2d6d359
0.53,1.0,20,1,2,2,5,0xb2d950af
492.29,1.0,46,1,2,2,5,0xb2d36390
20000.21,2.0,87,2,3,1,6,0xb2d8cb07
470058.41,9.0,0,4,4,4,12,0x3b9b45f1d
22098.66,3.0,0,2,4,4,10,0xb2d91e58
20000.21,2.0,97,2,3,1,6,0xb2d856fa
225004.75,2.0,32,3,3,2,8,0xb2da01a9
1501609.15,3.0,1,4,4,4,12,0xb2d1fc45
10242.21,2.0,95,2,3,1,6,0xb2d59c8e
2922.46,1.0,92,2,2,1,5,0xb2d3f6fb
175983.45,3.0,6,3,4,3,10,0xb2d2381d
42699.37,1.0,21,2,2,2,6,0xb2d60a9d
5526.76,1.0,2,2,2,4,8,0xb2d23c40
6630.26,1.0,184,2,2,1,5,0xb2d13c2c
15604.31,1.0,5,2,2,3,7,0xb2da07b0
2186.41,1.0,1,1,2,4,7,0xb2d0e641
500011.17,7.0,39,4,4,2,10,0xb2d23f5c
203286.96,2.0,122,3,3,1,7,0xb2d62d1dd
77086.8,2.0,67,3,3,1,7,0xb2d64629
1724.76,1.0,157,1,2,1,4,0xb2d1863e
1.27,1.0,47,1,2,2,5,0xb2d9dc16
51.45,1.0,9,1,2,3,6,0xb2d6a3b5
0.67,1.0,13,1,2,3,6,0xb2d6a2e6
233836.72,2.0,228,3,3,1,7,0xb2d5868b
204257.96,2.0,108,3,3,1,7,0xb2d53c4d
403354.2,4.0,39,4,4,2,10,0xb2d15f14
454273.9,1.0,174,4,2,1,7,0xb2d2cd14
26.71,1.0,69,1,2,1,4,0xb2d33f30
176106.01,5.0,0,3,4,4,11,0xb2d12b2f
4034.79,1.0,12,2,2,3,7,0xb2d26a3a
1140052.99,5.0,8,4,4,3,11,0xb2d6d37c
461633.96,2.0,33,4,3,2,9,0xb2da0476
644671.79,5.0,96,4,4,1,9,0xb2d14e2ad
1021342.0,2.0,110,4,3,1,8,0xb2d787f6
3.98,1.0,31,1,2,2,5,0xb2d5dccd
201024.51,2.0,14,3,3,3,9,0xb2d7c1ad
282761.86,6.0,3,3,4,4,11,0xb2d3bbba
18.19,2.0,19,1,3,2,6,0xb2d3bb41
431102.06,3.0,4,4,4,4,12,0xb2d9cde7
505330.83,2.0,119,4,3,1,8,0xb2d944a2
1154726.92,5.0,77,4,4,1,9,0xb2d52e06
1171.45,1.0,0,1,2,4,7,0xb2d1a898
292565.88,7.0,4,3,4,4,11,0xb2d54c72
5902.42,1.0,10,2,2,3,7,0xb2d8f080
774.85,1.0,13,1,2,3,6,0xb2d6caba
813515.9,6.0,1,4,4,4,12,0xb2d550bc
1042.56,1.0,92,1,2,1,4,0xb2d40b57
201351.35,3.0,108,3,4,1,8,0x3b9b2d03d
2228.26,1.0,184,1,2,1,4,0xb2d2145fd
2102.56,1.0,0,1,2,4,7,0xb2d34d74
17550.9,1.0,9,2,2,3,7,0xb2d6e956d
8917.44,1.0,4,2,2,4,8,0xb2d407b4
28.74,4.0,24,1,4,2,7,0xb2d6085ed
11631.13,1.0,55,2,2,2,6,0xb2d3b7d5
667726.71,7.0,11,4,4,3,11,0xb2d21436
60105.38,2.0,5,3,3,3,9,0xb2d57ea6
8153.31,1.0,4,2,2,4,8,0xb2d3d6b2
4435.36,1.0,0,2,2,4,8,0xb2d43c8a
255825.61,5.0,92,3,4,1,8,0xb2d0bb9a
52022.55,2.0,151,2,3,1,6,0xb2d580c1
23418.85,1.0,92,2,2,1,5,0xb2d0fee3
60571.93,1.0,0,3,2,4,9,0xb2d347ce
2701.11,1.0,0,1,2,4,7,0xb2d6ffe8
2005.16,1.0,3,1,2,4,7,0xb2d6b6de
633.73,1.0,6,1,2,3,6,0xb2d6fafbd
196839.12,4.0,1,3,4,4,11,0xb2d175a9
3399.89,1.0,23,2,2,2,6,0xb2d9d404
503353.82,3.0,3,4,4,4,12,0xb2d8dd3e
285.07,1.0,74,1,2,1,4,0xb2d743d2
55897.98,1.0,2,3,2,4,9,0xb2d60c14d
1651525.17,10.0,1,4,4,4,12,0xb2d24f76
175.18,1.0,18,1,2,2,5,0xb2d33e3d
400030.84,3.0,2,4,4,4,12,0xb2d92b19
7924.64,1.0,20,2,2,2,6,0xb2d6a98b
60032.7,3.0,0,3,4,4,11,0xb2d55844
7641.48,1.0,209,2,2,1,5,0xb2d48774
132020.61,2.0,139,3,3,1,7,0xb2d62ed8
150000.53,3.0,0,3,4,4,11,0xb2d4c45dd
505000.0,2.0,1,4,3,4,11,0xb2da6677
25010.74,1.0,6,2,2,3,7,0xb2d5cefcd
1738031.0,14.0,0,4,4,4,12,0xb2d57970
307750.13,2.0,259,4,3,1,8,0xb2d0c5e3
5000513.81,3.0,21,4,4,2,10,0xb2d635f4
300003.17,2.0,90,3,3,1,7,0xb2d8c3f1
40351.38,3.0,66,2,4,2,8,0xb2d5f026
1750.1,1.0,184,1,2,1,4,0xb2d0ebc8
1211.04,1.0,48,1,2,2,5,0xb2d4cdf6
61087.82,2.0,92,3,3,1,7,0xb2d5a630
2127.71,1.0,184,1,2,1,4,0xb2d2be33d
224.51,1.0,41,1,2,2,5,0xb2d257e6
181.66,1.0,12,1,2,3,6,0xb2d11dd8
300012.67,2.0,56,3,3,2,8,0xb2d9c348
1100568.75,3.0,80,4,4,1,9,0xb2d1bf29
2980844.9,5.0,45,4,4,2,10,0xb2d12d35
51001.62,2.0,151,2,3,1,6,0xb2d8ed02
1118.64,1.0,92,1,2,1,4,0xb2d34d65
5328.01,1.0,53,2,2,2,6,0xb2d5e0f7
400000.0,1.0,0,4,2,4,10,0xb2da698c
492027.62,6.0,14,4,4,3,11,0xb2d3d29a
154237.44,2.0,59,3,3,2,8,0xb2d3496e
10361.35,5.0,111,2,4,1,7,0x3b9ae4f1
98.03,1.0,56,1,2,2,5,0xb2d69552
30481.21,1.0,0,2,2,4,8,0xb2d503c3
13218.65,1.0,14,2,2,3,7,0xb2d91a20
1000029.57,6.0,28,4,4,2,10,0xb2d91654
250002.64,2.0,10,3,3,3,9,0xb2d5bca5
125037.43,1.0,9,3,2,3,8,0xb2d78d6c
13213.8,1.0,92,2,2,1,5,0xb2d21f7b
58773.26,2.0,12,3,3,3,9,0xb2d177f4
38650.36,1.0,0,2,2,4,8,0xb2d5f20e
200618.01,4.0,0,3,4,4,11,0xb2d0b032
100056.57,2.0,25,3,3,2,8,0xb2d3fb10
200014.78,2.0,11,3,3,3,9,0xb2d95b2b
1092396.22,13.0,1,4,4,4,12,0xb2d14bf2
3000.62,1.0,0,2,2,4,8,0xb2d8fee3
450077.74,3.0,56,4,4,2,10,0xb2d1b44f
8697.3,2.0,0,2,3,4,9,0xb2d06f46
401420.93,2.0,47,4,3,2,9,0xb2d918c3
483000.0,2.0,3,4,3,4,11,0xb2d97e66
200104.66,2.0,74,3,3,1,7,0xb2d1541d
2661.57,1.0,6,1,2,3,6,0xb2d9640e
15047.07,1.0,92,2,2,1,5,0xb2d5f7ab
125887.91,1.0,0,3,2,4,9,0xb2d0b130
30793.01,1.0,0,2,2,4,8,0xb2d33184
50002.11,2.0,48,2,3,2,7,0xb2d90ff7
401971.71,4.0,1,4,4,4,12,0xb2d95757
1973059.91,6.0,35,4,4,2,10,0xb2d994dc
2.41,1.0,60,1,2,2,5,0xb2d31e97
6364.34,3.0,0,2,4,4,10,0x3b9af0c2
270000.0,2.0,3,3,3,4,10,0xb2d96ff3
100.04,1.0,42,1,2,2,5,0xb2d98fb1
15273.99,6.0,167,2,4,1,7,0xb2d1077e
2.85,1.0,27,1,2,2,5,0xb2d90b2c
0.0,1.0,3,1,2,4,7,0xb2d6adf8
90119.93,3.0,47,3,4,2,9,0xb2d6bb86
252133.25,5.0,62,3,4,2,9,0xb2d94ddd
2580920.31,10.0,14,4,4,3,11,0xb2d91b69
391826.53,2.0,4,4,3,4,11,0xb2d13383
6457.73,1.0,9,2,2,3,7,0xb2d6c059
100848.64,3.0,17,3,4,2,9,0xb2d56c78
1022195.07,7.0,25,4,4,2,10,0xb2d13a61
6288.16,1.0,184,2,2,1,5,0xb2d11a0d
26.65,1.0,0,1,2,4,7,0xb2d6dde9
1609.39,1.0,92,1,2,1,4,0xb2d5a81c
50000.53,2.0,6,2,3,3,8,0xb2d588f3
3.02,1.0,9,1,2,3,6,0xb2d313e3
66.47,1.0,79,1,2,1,4,0xb2d6373d
587010.13,2.0,44,4,3,2,9,0xb2d78b79
9655.07,1.0,13,2,2,3,7,0xb2d29a5e
21043.25,1.0,0,2,2,4,8,0xb2d51b5c
1476.26,1.0,3,1,2,4,7,0xb2d31189
5028.92,6.0,0,2,4,4,10,0x3b9af3a2
765137.52,4.0,97,4,4,1,9,0xb2d122b9
430.19,1.0,10,1,2,3,6,0xb2d98a47
1484135.15,3.0,3,4,4,4,12,0xb2d1a0ec
408951.55,8.0,0,4,4,4,12,0x3b9b17d3
2.83,1.0,74,1,2,1,4,0xb2d6c047
25654.67,1.0,62,2,2,2,6,0xb2d40a1c
404958.94,5.0,2,4,4,4,12,0xb2d2ec31
206142.05,1.0,3,3,2,4,9,0xb2d6c0b2
396787.72,7.0,0,4,4,4,12,0xb2d0e3d3
3953.06,1.0,92,2,2,1,5,0xb2d217cad
5308.11,1.0,0,2,2,4,8,0xb2d33db9
29.06,1.0,10,1,2,3,6,0xb2d61585
2375.74,1.0,230,1,2,1,4,0xb2d2020f
1004209.38,2.0,45,4,3,2,9,0xb2d91055
975785.22,7.0,19,4,4,2,10,0xb2d446e4
296012.53,2.0,39,3,3,2,8,0xb2d102f8
44392.01,1.0,21,2,2,2,6,0xb2d235d1
13279.57,1.0,193,2,2,1,5,0xb2d4061a
3.17,1.0,111,1,2,1,4,0xb2d94b00d
70036.21,3.0,1,3,4,4,11,0xb2d3d230
13.55,1.0,11,1,2,3,6,0xb2d8c3a9
836022.84,11.0,7,4,4,3,11,0xb2d107c2
2000078.53,13.0,4,4,4,4,12,0xb2d43ee1d
2817.37,1.0,11,1,2,3,6,0xb2d37cf8
7372.0,1.0,0,2,2,4,8,0xb2d6a1c5
248083.45,2.0,66,3,3,2,8,0xb2d5b9c2
12.0,1.0,38,1,2,2,5,0xb2d2f492
1720141.87,6.0,17,4,4,2,10,0xb2d78c01
212.09,1.0,8,1,2,3,6,0xb2d217d3
500052.1,2.0,8,4,3,3,10,0xb2d9acf5
439000.0,13.0,6,4,4,3,11,0xb2d4cf17
4264.6,1.0,102,2,2,1,5,0xb2d23c6c
1020.5,1.0,92,1,2,1,4,0xb2d23507
2407.91,2.0,92,1,3,1,5,0xb2d08eb7
100001.06,2.0,6,3,3,3,9,0xb2d96c41
230000.0,3.0,6,3,4,3,10,0xb2da53fa
140007.88,3.0,143,3,4,1,8,0xb2d24dad
141169.83,2.0,25,3,3,2,8,0xb2d29eab
58475.35,2.0,25,3,3,2,8,0xb2d17927
75835.44,1.0,5,3,2,3,8,0xb2d0d2af
604.49,1.0,0,1,2,4,7,0xb2d7eed3
500000.0,2.0,15,4,3,3,10,0xb2da3796
3.23,1.0,12,1,2,3,6,0xb2d37ab8
52162.5,1.0,1,3,2,4,9,0xb2d27fc1d
5257.32,1.0,28,2,2,2,6,0xb2d433c3
177.07,1.0,110,1,2,1,4,0xb2d2413e
206548.74,1.0,60,3,2,2,7,0xb2d4590f
20000.21,2.0,151,2,3,1,6,0xb2d9001c
1692329.52,4.0,14,4,4,3,11,0x3b9b368e
739.91,1.0,7,1,2,3,6,0xb2d2b815d
493.11,1.0,9,1,2,3,6,0xb2d4adf6
50568.26,2.0,20,2,3,2,7,0xb2d91e6b
200002.11,2.0,92,3,3,1,7,0xb2d65923
1499000.93,12.0,5,4,4,3,11,0xb2d28215d
8540.63,1.0,21,2,2,2,6,0xb2d39288
74000.78,3.0,27,3,4,2,9,0xb2d939fd
46354.17,1.0,4,2,2,4,8,0xb2d2a405
100922.2,2.0,10,3,3,3,9,0xb2d55434
2039.35,1.0,0,1,2,4,7,0xb2d41517
47.41,1.0,9,1,2,3,6,0xb2d27df5
373164.78,7.0,1,4,4,4,12,0xb2d87abc
16374.38,1.0,0,2,2,4,8,0xb2d65b1ad
50893.35,3.0,0,2,4,4,10,0xb2d20aa6
6.87,1.0,181,1,2,1,4,0xb2d4276a
793.56,1.0,24,1,2,2,5,0xb2d26ebc
200003.23,3.0,0,3,4,4,11,0xb2d249de
792920.1,9.0,1,4,4,4,12,0xb2d0ec11
9329.64,1.0,1,2,2,4,8,0xb2d382bcd
1473.51,1.0,8,1,2,3,6,0xb2d2fc28
500000.16,3.0,4,4,4,4,12,0xb2d8a866
32964.82,1.0,1,2,2,4,8,0xb2d3210d
100000.4,5.0,1,3,4,4,11,0xb2d8d286d
41422.21,2.0,18,2,3,2,7,0xb2d5e0ab
770537.67,3.0,13,4,4,3,11,0xb2d5c4ebd
6.42,1.0,42,1,2,2,5,0xb2d48e52d
406120.52,3.0,10,4,4,3,11,0xb2d59619
443062.5,3.0,5,4,4,3,11,0xb2d17f19d
150000.14,2.0,47,3,3,2,8,0xb2d55ccfd
250000.0,2.0,3,3,3,4,10,0xb2d97480
500006.58,3.0,11,4,4,3,11,0xb2d5d1fe
480064.56,3.0,14,4,4,3,11,0xb2d8d101
200000.0,2.0,29,3,3,2,8,0xb2da0cda
10543.65,2.0,172,2,3,1,6,0xb2d29145
11559.61,1.0,50,2,2,2,6,0xb2d0fd17
50015.74,2.0,52,2,3,2,7,0xb2d8f49e
2005.19,1.0,0,1,2,4,7,0xb2d0df3e
1857.39,1.0,69,1,2,1,4,0xb2d1f4c6
0.51,1.0,13,1,2,3,6,0xb2d57e2ad
9937.36,1.0,22,2,2,2,6,0xb2d320b4
698000.0,9.0,9,4,4,3,11,0xb2d57df7
200710.42,2.0,32,3,3,2,8,0xb2da065d
460000.0,3.0,4,4,4,4,12,0xb2d40098
115868.14,2.0,9,3,3,3,9,0xb2d49006
50251.04,2.0,0,2,3,4,9,0xb2d33435
314936.15,3.0,231,4,4,1,9,0xb2d43a19d
6067.52,1.0,52,2,2,2,6,0xb2d4e710
1004.02,1.0,92,1,2,1,4,0xb2d435ad
82174.64,5.0,13,3,4,3,10,0xb2d2bb09d
1901092.74,13.0,39,4,4,2,10,0xb2d24625
20205.94,1.0,3,2,2,4,8,0xb2d1f596
296.59,1.0,16,1,2,2,5,0xb2d8a725
2711.32,1.0,1,1,2,4,7,0xb2d7bfce
150048.47,6.0,12,3,4,3,10,0xb2d3bc2b
11364.55,1.0,2,2,2,4,8,0xb2d93237
50020.25,2.0,228,2,3,1,6,0xb2d6339c
143106.88,2.0,111,3,3,1,7,0xb2d2e2ed
80000.0,8.0,0,3,4,4,11,0xb2d45d13
14309.75,6.0,112,2,4,1,7,0xb2d43e2f
8.32,1.0,41,1,2,2,5,0xb2d1add9
372309.39,4.0,0,4,4,4,12,0xb2d91f16
700068.6,4.0,11,4,4,3,11,0xb2d4526bd
3800.43,1.0,7,2,2,3,7,0xb2d78655
897.12,1.0,3,1,2,4,7,0xb2d91a16
403393.85,1.0,138,4,2,1,7,0xb2d29297d
671.34,8.0,7,1,4,3,8,0x3b9af12b
435054.29,2.0,217,4,3,1,8,0xb2d69f5e
112.73,1.0,5,1,2,3,6,0xb2d6e4b6
34919.46,5.0,184,2,4,1,7,0xb2d32472
60002.53,2.0,62,3,3,2,8,0xb2d8f533d
326857.06,1.0,50,4,2,2,8,0xb2d3a089
585678.43,7.0,12,4,4,3,11,0xb2d5d7b0
140012.25,3.0,63,3,4,2,9,0xb2d9b008
165907.38,1.0,0,3,2,4,9,0xb2d3319d
1487.05,4.0,21,1,4,2,7,0x3b9b30d6
300053.45,2.0,52,3,3,2,8,0xb2d57588
10297.55,1.0,184,2,2,1,5,0x3b9b2d45
600000.0,9.0,6,4,4,3,11,0xb2d200d0
10110.54,1.0,184,2,2,1,5,0xb2d0ebaf
162965.5,4.0,59,3,4,2,9,0xb2d52dadd
51752.5,2.0,62,2,3,2,7,0xb2d5af54
10353.17,1.0,41,2,2,2,6,0xb2d3e99e
7312.42,2.0,184,2,3,1,6,0x3b9b2661
750000.0,2.0,4,4,3,4,11,0xb2d95410
6051.31,1.0,92,2,2,1,5,0xb2d31e29
250312.18,4.0,11,3,4,3,10,0xb2d25c5c
0.11,1.0,105,1,2,1,4,0xb2d95d8c
90064.58,2.0,112,3,3,1,7,0xb2d11eef
1767.87,1.0,45,1,2,2,5,0xb2d45a53
62.14,1.0,15,1,2,3,6,0xb2d1fe80
627000.12,10.0,3,4,4,4,12,0xb2d59874
400000.0,3.0,3,4,4,4,12,0xb2d907c6
4856.76,1.0,66,2,2,2,6,0xb2d9374f
100000.0,2.0,5,3,3,3,9,0xb2d54cc3
3263.79,1.0,92,2,2,1,5,0xb2d3e6dbd
440043.82,6.0,0,4,4,4,12,0xb2d2b397
42.42,2.0,61,1,3,2,6,0xb2d50a80
48003.99,1.0,5,2,2,3,7,0xb2d6c5f3
10359.94,2.0,80,2,3,1,6,0xb2d635db
5684.8,1.0,0,2,2,4,8,0xb2d408d6
4000.0,1.0,0,2,2,4,8,0xb2da598f
3684.99,1.0,13,2,2,3,7,0xb2d367d6
3968.37,3.0,0,2,4,4,10,0xb2d96869
1013.35,1.0,0,1,2,4,7,0xb2d2868a
1366.95,2.0,273,1,3,1,5,0x3b9b455e
1010013.85,2.0,99,4,3,1,8,0xb2d21765
500005.21,2.0,19,4,3,2,9,0xb2d78fbe
353022.28,2.0,22,4,3,2,9,0xb2d9d8a6
100007.75,2.0,132,3,3,1,7,0xb2d51cb3d
201436.1,2.0,75,3,3,1,7,0xb2d60248
5531.33,1.0,5,2,2,3,7,0xb2d26001
390485.33,4.0,0,4,4,4,12,0xb2d0c86c
517555.33,5.0,98,4,4,1,9,0xb2d07fa5
83079.6,4.0,41,3,4,2,9,0xb2d6a7af
3020456.36,13.0,10,4,4,3,11,0xb2d20052
69400.59,2.0,13,3,3,3,9,0xb2d92133d
180010.71,2.0,108,3,3,1,7,0xb2d691d3
980899.11,2.0,249,4,3,1,8,0xb2d3eb7c
550183.09,2.0,92,4,3,1,8,0xb2d2d6af
7299.22,1.0,15,2,2,3,7,0xb2d5e10dd
440042.25,9.0,9,4,4,3,11,0xb2d574c7d
402985.13,2.0,8,4,3,3,10,0xb2d484e2
19629.86,1.0,0,2,2,4,8,0xb2d6f378d
100403.01,2.0,18,3,3,2,8,0xb2d639cb
350044.76,3.0,15,4,4,3,11,0xb2d10760
13946.66,1.0,92,2,2,1,5,0xb2d1d9c6
1156332.04,10.0,4,4,4,4,12,0xb2d59c7a
100999.58,3.0,25,3,4,2,9,0xb2d9d492
507.47,1.0,70,1,2,1,4,0xb2d5098d
302014.55,6.0,4,4,4,4,12,0xb2d3dd16
364824.38,2.0,9,4,3,3,10,0xb2d24768
214568.1,1.0,12,3,2,3,8,0xb2d2f636
30.82,1.0,14,1,2,3,6,0xb2d63b73
18000.65,1.0,6,2,2,3,7,0xb2d2fdbe
3021672.22,2.0,0,4,3,4,11,0xb2d5da42
35121.7,1.0,184,2,2,1,5,0xb2d0dc43
157002.11,4.0,31,3,4,2,9,0xb2d62532
463712.36,5.0,6,4,4,3,11,0xb2d69b27
1.0,2.0,63,1,3,2,6,0xb2d448bf
12237.44,1.0,92,2,2,1,5,0xb2d1c3f3
926605.67,12.0,1,4,4,4,12,0xb2d5cf8e
955.58,1.0,67,1,2,1,4,0xb2d5fbb2
13985.79,1.0,0,2,2,4,8,0xb2d22325d
437649.88,4.0,118,4,4,1,9,0xb2d24eb3
664058.97,6.0,0,4,4,4,12,0xb2d6e613
1103.88,2.0,27,1,3,2,6,0xb2d06b4d
600790.12,7.0,55,4,4,2,10,0xb2d4d9ce
802141.1,6.0,17,4,4,2,10,0xb2d55c03
207841.84,2.0,11,3,3,3,9,0xb2d5ed85
1550.98,1.0,184,1,2,1,4,0xb2d41eb1
405954.54,2.0,18,4,3,2,9,0xb2d3a89bd
37809.34,1.0,0,2,2,4,8,0xb2d510ab
124812.81,2.0,0,3,3,4,10,0xb2d108ee
468028.25,4.0,18,4,4,2,10,0xb2d78996
412815.3,2.0,88,4,3,1,8,0xb2d68981
500005.53,2.0,6,4,3,3,10,0xb2d6e5b7d
51988.37,1.0,184,2,2,1,5,0xb2d4908f
3028.0,1.0,52,2,2,2,6,0xb2d27e4e
364929.89,8.0,18,4,4,2,10,0xb2d086be
265.31,7.0,1,1,4,4,9,0x3b9b4667
519321.45,3.0,133,4,4,1,9,0xb2d22fced
924313.33,4.0,0,4,4,4,12,0xb2d1a91f
93318.49,3.0,48,3,4,2,9,0xb2d1cd8dd
9021.71,1.0,137,2,2,1,5,0xb2d5e07ed
2360903.01,16.0,0,4,4,4,12,0xb2d3c5f8
60002.03,2.0,25,3,3,2,8,0xb2d5c4a2
0.58,1.0,6,1,2,3,6,0xb2d36674
714066.73,14.0,0,4,4,4,12,0xb2d294f3
230379.3,2.0,0,3,3,4,10,0x3b9b2e09
111745.8,3.0,20,3,4,2,9,0xb2d48611d
154008.33,4.0,20,3,4,2,9,0xb2d3b58b
83.86,1.0,12,1,2,3,6,0xb2d193f7d
618.51,1.0,6,1,2,3,6,0xb2d4ff0b
9782.86,1.0,4,2,2,4,8,0xb2d315fd
436023.86,6.0,10,4,4,3,11,0xb2d08ceed
320000.35,7.0,18,4,4,2,10,0xb2d17882d
2521.54,1.0,299,1,2,1,4,0xb2d34825
4126.69,3.0,13,2,4,3,9,0xb2d65d7bd
529.97,1.0,10,1,2,3,6,0xb2d78fe6
65006.1,5.0,11,3,4,3,10,0xb2d17480
200866.91,1.0,21,3,2,2,7,0xb2d8ff0a
278967.97,4.0,5,3,4,3,10,0x3b9b2317
6200.9,1.0,12,2,2,3,7,0xb2d3f9c2
400712.55,3.0,10,4,4,3,11,0xb2d92320d
960016.82,9.0,18,4,4,2,10,0xb2d6001c
5543.81,1.0,2,2,2,4,8,0xb2d94812
4.99,1.0,21,1,2,2,5,0xb2d2d708
10004.99,2.0,53,2,3,2,7,0xb2d65c05
41.77,1.0,19,1,2,2,5,0xb2d1b416
110470.95,2.0,83,3,3,1,7,0xb2d36c64
80002.53,2.0,74,3,3,1,7,0xb2d99a83
200000.0,2.0,15,3,3,3,9,0xb2da33d7
150410.28,3.0,12,3,4,3,10,0xb2d648ed
400711.27,6.0,1,4,4,4,12,0xb2d23423
1657.33,1.0,2,1,2,4,7,0xb2d67544
300000.02,2.0,14,3,3,3,9,0xb2d8e01f
0.0,1.0,1,1,2,4,7,0xb2d9771c
10182.38,1.0,3,2,2,4,8,0xb2d5b64c
210111.69,7.0,0,3,4,4,11,0x3b9af15b
60123.84,2.0,0,3,3,4,10,0xb2d5823c
36.78,1.0,70,1,2,1,4,0xb2d347c0
80001.09,2.0,18,3,3,2,8,0xb2d0bd32
20008.23,2.0,165,2,3,1,6,0xb2d8e381
51014.38,1.0,55,2,2,2,6,0xb2d4cb6ad
4.82,1.0,74,1,2,1,4,0xb2d17bbd
4778.91,1.0,17,2,2,2,6,0xb2d4a37b
200000.85,2.0,11,3,3,3,9,0xb2d8e6ea
5.53,1.0,19,1,2,2,5,0xb2d6bac2
3.7,20.0,82,1,4,1,6,0xb2d16573
0.9,1.0,20,1,2,2,5,0xb2d953b6
1116.15,1.0,10,1,2,3,6,0xb2d908b5
2357.53,1.0,204,1,2,1,4,0xb2d1ab7b
54280.16,2.0,165,3,3,1,7,0xb2d38644d
12536.96,1.0,14,2,2,3,7,0xb2d2831ad
800657.57,3.0,21,4,4,2,10,0xb2d36fa3
2016.78,1.0,92,1,2,1,4,0xb2d2db07
20695.35,1.0,123,2,2,1,5,0xb2d58c6cd
217767.48,3.0,122,3,4,1,8,0xb2d1395e
0.0,1.0,3,1,2,4,7,0xb2d62868
5397.98,1.0,6,2,2,3,7,0xb2d24ead
13.22,1.0,14,1,2,3,6,0xb2d683f4
1.0,1.0,7,1,2,3,6,0xb2d16882
32095.68,1.0,18,2,2,2,6,0xb2d5d2e9
524701.72,18.0,0,4,4,4,12,0xb2d12690
17380.65,1.0,9,2,2,3,7,0xb2d6cc03
50026.68,2.0,165,2,3,1,6,0xb2d11660
182070.86,3.0,209,3,4,1,8,0xb2d5b5f9
510265.21,6.0,25,4,4,2,10,0xb2d0cc2c
304496.23,27.0,0,4,4,4,12,0xb2d0f814
300010.42,7.0,5,3,4,3,10,0xb2d5b4d6
1787.62,2.0,2,1,3,4,8,0x3b9b0fb5
255827.06,3.0,43,3,4,2,9,0xb2d5d384
90012.05,3.0,119,3,4,1,8,0xb2d5f1fd
393426.2,4.0,21,4,4,2,10,0xb2d1e7bd
465075.78,6.0,47,4,4,2,10,0xb2d21dd5d
400031.34,3.0,9,4,4,3,11,0xb2d9a7e7
70436.22,2.0,8,3,3,3,9,0xb2d62cbed
166598.1,3.0,0,3,4,4,11,0xb2d0a6fa
519.6,1.0,0,1,2,4,7,0xb2d2645d
50357.22,2.0,159,2,3,1,6,0xb2d403f4
69665.37,1.0,0,3,2,4,9,0xb2d7c3dd
500026.39,2.0,87,4,3,1,8,0xb2d88eabd
80019.0,2.0,0,3,3,4,10,0xb2d0eb5d
16.38,1.0,92,1,2,1,4,0xb2d1e9c6d
486718.27,20.0,0,4,4,4,12,0xb2d104d8
231.44,1.0,1,1,2,4,7,0xb2d21d57
100088.95,2.0,216,3,3,1,7,0xb2d1758cd
2150119.64,15.0,13,4,4,3,11,0xb2d606ef
1470357.01,10.0,55,4,4,2,10,0xb2d3bf7f
873.01,1.0,15,1,2,3,6,0xb2d6f19c
13617.42,1.0,10,2,2,3,7,0xb2d563ec
712779.76,4.0,80,4,4,1,9,0xb2d23cf1
1327.25,1.0,10,1,2,3,6,0xb2d83407
1491609.63,6.0,0,4,4,4,12,0xb2d391d6
370026.36,3.0,27,4,4,2,10,0xb2d5635d
482047.48,2.0,181,4,3,1,8,0xb2d138d5
9636.81,1.0,53,2,2,2,6,0xb2d43b87
5.25,1.0,0,1,2,4,7,0xb2d4b6ff
0.77,1.0,68,1,2,1,4,0xb2d43999
1510.77,1.0,5,1,2,3,6,0xb2d215e0
20093.36,2.0,4,2,3,4,9,0xb2d31ee6
148.76,1.0,9,1,2,3,6,0xb2d6f055
158625.65,1.0,28,3,2,2,7,0xb2d18691d
5.93,1.0,29,1,2,2,5,0xb2d23822
105974.4,2.0,63,3,3,2,8,0xb2d2b1ac
30000.75,2.0,82,2,3,1,6,0xb2d5aab7
6746906.8,16.0,1,4,4,4,12,0xb2d218e8
200094.41,2.0,3,3,3,4,10,0xb2d62d4c
300010.85,3.0,5,3,4,3,10,0xb2d993ba
190063.0,5.0,3,3,4,4,11,0xb2d5b334
201600.69,3.0,18,3,4,2,9,0xb2d2b04f
230009.63,3.0,15,3,4,3,10,0xb2d18059
405228.59,11.0,1,4,4,4,12,0xb2d5aab1
2966.72,1.0,184,2,2,1,5,0xb2d2ea43d
30000.63,2.0,235,2,3,1,6,0xb2d6e6de
86952.51,2.0,10,3,3,3,9,0xb2d6982e
8508.52,3.0,20,2,4,2,8,0x3b9ae882
90006.77,2.0,39,3,3,2,8,0xb2d61f3cd
50184.43,3.0,3,2,4,4,10,0xb2d0e1e0
50.0,1.0,3,1,2,4,7,0xb2d85bff
210056.58,3.0,139,3,4,1,8,0xb2d5b060
610423.78,4.0,1,4,4,4,12,0xb2d96dad
5805.28,1.0,9,2,2,3,7,0xb2d3ebf3
1006.46,1.0,15,1,2,3,6,0xb2d633f8
300005.28,3.0,52,3,4,2,9,0xb2d783f1
12849.13,1.0,14,2,2,3,7,0xb2d5792b
420010.4,2.0,0,4,3,4,11,0xb2d65754d
8652.03,1.0,184,2,2,1,5,0xb2d17079d
40043.22,4.0,1,2,4,4,10,0xb2d5a80e
350606.49,7.0,7,4,4,3,11,0xb2d5675bd
66387.37,2.0,8,3,3,3,9,0xb2d10a0d
459201.09,3.0,92,4,4,1,9,0xb2d57281
1530044.74,8.0,27,4,4,2,10,0xb2d22df9
941370.36,18.0,3,4,4,4,12,0xb2d1aebd
302082.06,4.0,184,4,4,1,9,0xb2d26476
1327800.4,6.0,1,4,4,4,12,0xb2d1467f
50042.59,5.0,8,2,4,3,9,0xb2d618da
50000.0,3.0,53,2,4,2,8,0xb2d57c3e
115219.01,2.0,92,3,3,1,7,0xb2d0bf8d
100.35,1.0,20,1,2,2,5,0xb2d2fca4d
500000.0,3.0,9,4,4,3,11,0xb2d8eafc
8878.21,1.0,3,2,2,4,8,0xb2d4dcf1
100504.13,1.0,10,3,2,3,8,0xb2d9391b
678178.86,8.0,4,4,4,4,12,0xb2d291da
1270079.05,4.0,60,4,4,2,10,0xb2d18390
10570.22,1.0,5,2,2,3,7,0xb2d9447d
240000.0,2.0,25,3,3,2,8,0xb2da1ad3
5586.39,1.0,0,2,2,4,8,0xb2d3eb08
312298.95,4.0,48,4,4,2,10,0xb2d581aa
872054.27,6.0,4,4,4,4,12,0xb2d1fa97
335022.92,5.0,6,4,4,3,11,0xb2d0dc88
2656.02,1.0,184,1,2,1,4,0xb2d2699d
2712.19,1.0,0,1,2,4,7,0xb2d69b79d
10014.76,1.0,4,2,2,4,8,0xb2d5825e
10180.04,1.0,207,2,2,1,5,0xb2d5c1c2
88919.6,4.0,26,3,4,2,9,0xb2d0c9a0
681493.61,3.0,0,4,4,4,12,0xb2d54fba
402890.78,2.0,75,4,3,1,8,0xb2d3dd0c
453520.37,8.0,6,4,4,3,11,0xb2d4294d
14267.39,1.0,4,2,2,4,8,0xb2d68dc0
7.58,1.0,0,1,2,4,7,0xb2d51b54
517165.96,6.0,3,4,4,4,12,0x3b9ace80
9096.46,1.0,0,2,2,4,8,0xb2d33612
552215.27,5.0,19,4,4,2,10,0xb2d06309
1279.63,1.0,92,1,2,1,4,0xb2d3bfbb
17725.28,1.0,11,2,2,3,7,0xb2d2ebb9
19030.54,1.0,65,2,2,2,6,0xb2d68c66d
500015.3,2.0,1,4,3,4,11,0xb2da4794
50895.15,2.0,209,2,3,1,6,0xb2d5849f
1009.07,2.0,92,1,3,1,5,0xb2d1a739
11682.83,1.0,0,2,2,4,8,0xb2d69b5fd
20000.42,2.0,60,2,3,2,7,0xb2d9bea1
1000082.64,2.0,4,4,3,4,11,0xb2d2bd1b
1297875.14,4.0,46,4,4,2,10,0xb2d43637d
802.96,1.0,70,1,2,1,4,0xb2d1f86c
400088.49,2.0,7,4,3,3,10,0xb2d1c56e
6.77,1.0,60,1,2,2,5,0xb2d5c891
439039.04,11.0,4,4,4,4,12,0xb2d13f39d
915.08,1.0,3,1,2,4,7,0xb2d50d3bd
50002.18,2.0,32,2,3,2,7,0xb2d5a985
43410.53,1.0,2,2,2,4,8,0xb2d6b4a5
250153.04,3.0,7,3,4,3,10,0xb2d2d05c
284011.09,3.0,119,3,4,1,8,0xb2d19c27
31523.43,1.0,4,2,2,4,8,0xb2d6b995d
250888.02,2.0,35,3,3,2,8,0xb2d9c9a7
5150.35,1.0,92,2,2,1,5,0xb2d0c8c1
130144.6,2.0,57,3,3,2,8,0xb2d4194cd
55000.92,3.0,15,3,4,3,10,0xb2d9eeb6
267017.08,4.0,39,3,4,2,9,0xb2d2b2c3
81.73,1.0,6,1,2,3,6,0xb2d94c64
55985.8,1.0,3,3,2,4,9,0xb2d910e2
1377274.33,9.0,3,4,4,4,12,0xb2d32ee5
101317.41,1.0,123,3,2,1,6,0xb2d12d07
0.0,1.0,0,1,2,4,7,0xb2d630fa
53659.92,2.0,6,3,3,3,9,0xb2d3a5bc
190017.1,2.0,129,3,3,1,7,0xb2d0dc3dd
820008.67,2.0,104,4,3,1,8,0xb2d7f245
9334.41,1.0,10,2,2,3,7,0xb2d9e05b
1260063.66,4.0,2,4,4,4,12,0xb2d68ef1
7948.36,2.0,117,2,3,1,6,0xb2d29f36
1079.33,1.0,92,1,2,1,4,0xb2d19d08d
2018.01,1.0,16,1,2,2,5,0xb2d60b40
388169.91,2.0,201,4,3,1,8,0xb2d57858
15111.66,1.0,10,2,2,3,7,0xb2d1c6f9
24.01,1.0,10,1,2,3,6,0xb2d95ec1
1119.49,2.0,184,1,3,1,5,0xb2d0af86d
11605.16,1.0,47,2,2,2,6,0xb2d10b01
4489.33,1.0,103,2,2,1,5,0xb2d3a24f
936.57,1.0,11,1,2,3,6,0xb2d27c43
300022.13,2.0,1,3,3,4,10,0xb2d65222
202516.12,3.0,44,3,4,2,9,0xb2d15f14d
27.04,1.0,160,1,2,1,4,0xb2d3543f
650760.94,6.0,29,4,4,2,10,0xb2d2270d
71058.41,3.0,0,3,4,4,11,0xb2d4ff5d
897.23,1.0,45,1,2,2,5,0xb2d85c11
372668.6,3.0,41,4,4,2,10,0xb2d0677f
2410.83,1.0,0,1,2,4,7,0xb2d4e9d9
9.08,1.0,18,1,2,2,5,0xb2d4f2cfd
30799.86,1.0,17,2,2,2,6,0xb2d50038
10134.2,1.0,184,2,2,1,5,0xb2d22dbf
395747.13,5.0,6,4,4,3,11,0xb2d20637
3085000.0,11.0,0,4,4,4,12,0xb2d10a9f
130082.37,2.0,77,3,3,1,7,0xb2d2197ed
1.32,1.0,89,1,2,1,4,0xb2d14c4e
4591.36,1.0,6,2,2,3,7,0xb2d3bf4b
400106.33,3.0,18,4,4,2,10,0xb2d6c15a
333123.7,3.0,32,4,4,2,10,0xb2d0ed3a
256027.75,1.0,0,3,2,4,9,0xb2d5931c
450022.53,3.0,6,4,4,3,11,0xb2d622ab
50299.99,2.0,10,2,3,3,8,0xb2d5f609d
300005.28,3.0,0,3,4,4,11,0xb2d9ffb0
520342.71,5.0,17,4,4,2,10,0xb2d62221
108024.43,2.0,60,3,3,2,8,0xb2d68336
1530125.33,2.0,1,4,3,4,11,0xb2da3a71
1232.04,2.0,92,1,3,1,5,0x3b9b2309
683191.16,5.0,49,4,4,2,10,0xb2d42bc7
20008.23,1.0,48,2,2,2,6,0xb2d91739
2142.51,1.0,0,1,2,4,7,0xb2d0d711
1104035.05,6.0,11,4,4,3,11,0xb2d072d4
1386000.0,16.0,2,4,4,4,12,0xb2d629de
200000.0,2.0,10,3,3,3,9,0xb2d96cb7
980.29,1.0,0,1,2,4,7,0xb2d6ad01
13.91,1.0,14,1,2,3,6,0xb2d8c5f8
470782.56,3.0,10,4,4,3,11,0xb2d38814
89.62,1.0,67,1,2,1,4,0xb2d2ed8f
1268.46,1.0,6,1,2,3,6,0xb2d40db4
145.99,1.0,3,1,2,4,7,0xb2d6c638
209734.94,9.0,0,3,4,4,11,0xb2d14606
133000.42,6.0,70,3,4,1,8,0xb2d3e7d2
290716.46,5.0,25,3,4,2,9,0xb2d36ccc
71810.22,1.0,6,3,2,3,8,0xb2d22981
724.21,1.0,0,1,2,4,7,0xb2d5c8a3
600004.33,4.0,41,4,4,2,10,0xb2d5bdc8
305059.09,3.0,196,4,4,1,9,0xb2d3f31b
744.81,1.0,0,1,2,4,7,0xb2d41f70
67256.67,1.0,195,3,2,1,6,0xb2d1b540
10.86,1.0,77,1,2,1,4,0xb2d0c2f3
1363862.41,8.0,7,4,4,3,11,0xb2d65e34
145794.01,3.0,0,3,4,4,11,0xb2d553ab
619.37,1.0,6,1,2,3,6,0xb2d1f726
1.0,1.0,71,1,2,1,4,0xb2d682ba
574904.79,1.0,31,4,2,2,8,0xb2d3ed3c
310336.83,5.0,0,4,4,4,12,0xb2d629bc
220166.57,4.0,63,3,4,2,9,0xb2d16891
213834.36,6.0,39,3,4,2,9,0xb2d19bf7d
656403.5,2.0,0,4,3,4,11,0xb2d61898d
210069.43,4.0,6,3,4,3,10,0xb2d53060
500076.04,2.0,1,4,3,4,11,0xb2d9fffd
53862.76,2.0,136,3,3,1,7,0xb2d38588d
1063.13,1.0,10,1,2,3,6,0xb2d54ce4
4163.26,1.0,5,2,2,3,7,0xb2d621fc
112436.91,3.0,0,3,4,4,11,0x3b9af181
1015.37,1.0,184,1,2,1,4,0xb2d22d15
459.64,1.0,32,1,2,2,5,0xb2d8cd28
2049.08,1.0,20,1,2,2,5,0xb2d1b12a
1642.0,1.0,0,1,2,4,7,0xb2d6bd0d
700040.92,3.0,94,4,4,1,9,0xb2d12c9f
90186.48,2.0,0,3,3,4,10,0xb2d1b8be
930247.33,2.0,5,4,3,3,10,0xb2d925ed
303856.9,1.0,0,4,2,4,10,0xb2d54bc1d
2913.24,1.0,6,2,2,3,7,0xb2d93f94
10005.33,2.0,159,2,3,1,6,0xb2d59506
72105.66,3.0,108,3,4,1,8,0xb2d36c23
1.27,1.0,46,1,2,2,5,0xb2d91541
2000.84,1.0,0,1,2,4,7,0xb2d7010a
160003.8,3.0,116,3,4,1,8,0xb2d62b1c
10019.44,1.0,184,2,2,1,5,0xb2d1420b
3032.71,1.0,184,2,2,1,5,0xb2d27d77
1694.49,1.0,183,1,2,1,4,0xb2d64a10
504190.71,3.0,172,4,4,1,9,0xb2d596b1
34220.32,2.0,0,2,3,4,9,0xb2d25f49d
80015.31,5.0,40,3,4,2,9,0xb2d53b69
180106.46,4.0,27,3,4,2,9,0xb2d6eac9d
37285.56,2.0,18,2,3,2,7,0xb2d40c18
70374.76,3.0,27,3,4,2,9,0xb2d60921
92000.37,6.0,6,3,4,3,10,0xb2d27513
100041.61,2.0,112,3,3,1,7,0xb2d6a5c9
7982.96,1.0,184,2,2,1,5,0xb2d19112
588236.51,3.0,38,4,4,2,10,0xb2d25b46
1.47,1.0,8,1,2,3,6,0xb2d33093
100000.0,2.0,3,3,3,4,10,0xb2d97126
85778.23,2.0,18,3,3,2,8,0xb2d429b6
90683.16,3.0,0,3,4,4,11,0xb2d62f00
900043.97,2.0,0,4,3,4,11,0xb2d183c2
400063.73,2.0,12,4,3,3,10,0xb2d6f176
614001.35,6.0,0,4,4,4,12,0xb2d107d6
12218.19,1.0,11,2,2,3,7,0xb2d93713
4062.3,1.0,4,2,2,4,8,0xb2d0f52a
3.64,1.0,28,1,2,2,5,0xb2d6922b
1030.41,1.0,92,1,2,1,4,0xb2d0b567
403227.87,18.0,0,4,4,4,12,0xb2d2519fd
1400000.92,2.0,0,4,3,4,11,0xb2d925f9
5402800.3,83.0,0,4,4,4,12,0x3b9af27ad
2318.99,1.0,184,1,2,1,4,0xb2d1fec4
5215.38,1.0,11,2,2,3,7,0xb2d8db02
6153.38,1.0,3,2,2,4,8,0xb2d41fd5
450000.88,6.0,0,4,4,4,12,0xb2d1c096
13918.11,1.0,0,2,2,4,8,0xb2d6af2d
902.06,1.0,20,1,2,2,5,0xb2d6dd7f
200015.5,2.0,12,3,3,3,9,0xb2d96871
410.61,1.0,22,1,2,2,5,0xb2d1b2c0
302919.28,4.0,154,4,4,1,9,0xb2d3aa7e
390041.43,4.0,104,4,4,1,9,0xb2d41881d
1701048.42,3.0,0,4,4,4,12,0xb2d5c0d7
2039.12,1.0,92,1,2,1,4,0xb2d3a146
2343.26,1.0,131,1,2,1,4,0xb2d57964
301423.06,3.0,6,4,4,3,11,0xb2d9acbd
14.36,1.0,87,1,2,1,4,0xb2d537b9
10105.39,2.0,18,2,3,2,7,0xb2da29b9
130000.0,1.0,0,3,2,4,9,0xb2da6c48
105075.29,3.0,83,3,4,1,8,0xb2d13217
153328.28,1.0,6,3,2,3,8,0xb2d4dbf1
86685.62,2.0,3,3,3,4,10,0xb2d2846a
318097.34,1.0,38,4,2,2,8,0xb2d90586
300257.77,7.0,0,4,4,4,12,0xb2d0d539
450358.38,1.0,69,4,2,1,7,0xb2d9327e
2255.06,1.0,6,1,2,3,6,0xb2d5d757
191.37,1.0,25,1,2,2,5,0xb2d443bb
6191.39,1.0,2,2,2,4,8,0xb2d593f6
5439.08,1.0,0,2,2,4,8,0xb2d9423b
2944.07,8.0,184,2,4,1,7,0xb2d1644a
0.32,1.0,18,1,2,2,5,0xb2d9207e
1097.42,1.0,3,1,2,4,7,0xb2d5d30e
100146.6,3.0,20,3,4,2,9,0xb2d4c8d3
17.73,1.0,41,1,2,2,5,0xb2d91259
507106.28,3.0,93,4,4,1,9,0xb2d91228d
1218.84,1.0,18,1,2,2,5,0xb2d2d638
1894.46,1.0,5,1,2,3,6,0xb2d20372
20187.19,1.0,184,2,2,1,5,0xb2d2cf25
84004.33,7.0,11,3,4,3,10,0xb2d60dca
70309.75,1.0,17,3,2,2,7,0xb2d93d93
722021.79,6.0,49,4,4,2,10,0xb2d7825e
11.85,1.0,55,1,2,2,5,0xb2d2dfe7
401536.24,3.0,48,4,4,2,10,0xb2d6e8c2
20401.24,1.0,92,2,2,1,5,0xb2d54715
257128.07,3.0,122,3,4,1,8,0xb2d59a76d
1365.64,2.0,181,1,3,1,5,0x3b9b455ed
100877.14,3.0,52,3,4,2,9,0xb2d68d66
480000.71,4.0,19,4,4,2,10,0xb2d2cb8e
640818.4,4.0,7,4,4,3,11,0xb2d5eb50d
430841.88,3.0,5,4,4,3,11,0xb2d5ed86
7033.36,2.0,0,2,3,4,9,0xb2d08fe0
86.72,1.0,3,1,2,4,7,0xb2d912f4
92.11,1.0,25,1,2,2,5,0xb2d59820
2404165.68,3.0,25,4,4,2,10,0xb2d5ac17
34004.3,3.0,18,2,4,2,8,0xb2d55b16
8.41,3.0,15,1,4,3,8,0xb2d8de52
100002.56,2.0,28,3,3,2,8,0xb2d9f235
3022.53,1.0,184,2,2,1,5,0xb2d2e6d1
0.53,1.0,54,1,2,2,5,0xb2d68cb8
230219.07,3.0,167,3,4,1,8,0xb2d1b20d
346520.24,1.0,7,4,2,3,9,0xb2d58260d
503552.71,2.0,73,4,3,1,8,0xb2d9a56b
2482.96,1.0,143,1,2,1,4,0xb2d2c299
760009.69,4.0,1,4,4,4,12,0xb2d21df4d
6077.33,1.0,0,2,2,4,8,0xb2d6c1c7
50843.24,2.0,7,2,3,3,8,0xb2d697a8
638000.0,6.0,1,4,4,4,12,0xb2d32952
4476.34,1.0,92,2,2,1,5,0xb2d18f89
230000.0,2.0,27,3,3,2,8,0xb2d94555
200000.89,6.0,91,3,4,1,8,0xb2d43e86
0.0,1.0,8,1,2,3,6,0xb2d23f67
210070.1,3.0,1,3,4,4,11,0xb2d905d5d
267125.69,2.0,22,3,3,2,8,0xb2d125a1
366454.37,3.0,179,4,4,1,9,0xb2d13e00
590060.08,7.0,11,4,4,3,11,0xb2d14091
350389.69,5.0,0,4,4,4,12,0xb2d6c20d
1450.88,1.0,0,1,2,4,7,0xb2d33353
102911.0,1.0,3,3,2,4,9,0xb2d64f9ed
510000.0,5.0,0,4,4,4,12,0xb2d58ba4d
200.2,4.0,3,1,4,4,9,0xb2d195ee
196654.0,5.0,0,3,4,4,11,0xb2d3186ed
1014770.83,2.0,10,4,3,3,10,0xb2d6d7d3
230941.75,3.0,5,3,4,3,10,0xb2d1b4fd
42.92,2.0,80,1,3,1,5,0xb2d079e2
79.0,2.0,20,1,3,2,6,0xb2d0d5b4
9035.87,1.0,15,2,2,3,7,0xb2d85bd1
30956.76,1.0,6,2,2,3,7,0xb2d18d28
5911.95,1.0,7,2,2,3,7,0xb2d5e690d
35451.82,1.0,169,2,2,1,5,0xb2d3cbea
616.12,1.0,0,1,2,4,7,0xb2d8371f
1502.68,2.0,179,1,3,1,5,0xb2d5be9cd
1500010.56,3.0,11,4,4,3,11,0xb2da415c
287728.52,6.0,116,3,4,1,8,0xb2d14cfed
55685.19,4.0,62,3,4,2,9,0xb2d0a52b
6000087.25,4.0,66,4,4,2,10,0xb2d07ecd
61.25,1.0,45,1,2,2,5,0xb2d3cdce
86.49,1.0,0,1,2,4,7,0xb2d1dabd
573274.11,10.0,4,4,4,4,12,0xb2d469ccd
500.34,1.0,10,1,2,3,6,0xb2d4d415
2.81,1.0,28,1,2,2,5,0xb2d69225
30037.6,3.0,4,2,4,4,10,0xb2da032e
343419.34,2.0,59,4,3,2,9,0xb2d60eac
400000.0,3.0,0,4,4,4,12,0xb2d41dafd
230009.79,2.0,13,3,3,3,9,0xb2d5fbe5
360549.0,3.0,29,4,4,2,10,0xb2d6372a
100103.1,2.0,101,3,3,1,7,0xb2d649d0
357736.84,6.0,3,4,4,4,12,0xb2d23cf5
104.73,1.0,56,1,2,2,5,0xb2d880cd
450000.0,2.0,3,4,3,4,11,0xb2d97c8e
76.57,1.0,10,1,2,3,6,0xb2d989bf
1998907.75,1.0,0,4,2,4,10,0xb2d13952d
86747.31,6.0,3,3,4,4,11,0xb2d33522
3147694.17,9.0,0,4,4,4,12,0x3b9b132a
3.69,1.0,3,1,2,4,7,0xb2d0bbb1
6905.47,1.0,112,2,2,1,5,0xb2d12ae8
39004.98,1.0,10,2,2,3,7,0xb2d9e76e
61822.2,2.0,47,3,3,2,8,0xb2d5ca28
100001.06,2.0,34,3,3,2,8,0xb2d25d28
10009.72,2.0,108,2,3,1,6,0xb2d68d11
1872.97,3.0,92,1,4,1,6,0x3b9b18bf
15068.04,1.0,92,2,2,1,5,0xb2d50fc2
141766.06,4.0,55,3,4,2,9,0xb2d57f1b
4473329.44,5.0,6,4,4,3,11,0xb2d3a40f
33988.95,1.0,3,2,2,4,8,0xb2d263d8
587319.2,4.0,104,4,4,1,9,0xb2d3a0f3
1549045.88,8.0,28,4,4,2,10,0xb2d28967
133518.49,2.0,11,3,3,3,9,0xb2d3b12f
400018.07,2.0,119,4,3,1,8,0xb2d90cae
65002.74,2.0,14,3,3,3,9,0xb2da35cf
50014.57,2.0,171,2,3,1,6,0xb2d328fe
76496.64,4.0,0,3,4,4,11,0x3b9af2ef
70685.16,1.0,92,3,2,1,6,0xb2d11100
137.92,1.0,0,1,2,4,7,0xb2d32a20
6933.72,1.0,0,2,2,4,8,0xb2d92bcd
687004.4,16.0,5,4,4,3,11,0xb2d4f515
402843.45,3.0,11,4,4,3,11,0xb2d928cad
88017.25,1.0,0,3,2,4,9,0xb2d5383e
33777.63,1.0,140,2,2,1,5,0xb2d204be
377690.15,6.0,25,4,4,2,10,0xb2d104f0
7056.23,2.0,10,2,3,3,8,0xb2d1f7ca
82.88,1.0,76,1,2,1,4,0xb2d5a910
301068.72,2.0,23,4,3,2,9,0xb2d6e58a
14687.71,1.0,3,2,2,4,8,0xb2d2ddd7
2855341.16,5.0,31,4,4,2,10,0xb2d117a5
50014.58,3.0,4,2,4,4,10,0xb2da03e5
2939.4,1.0,9,2,2,3,7,0xb2d2959cd
470039.57,2.0,25,4,3,2,9,0xb2d93c99
3637.06,2.0,6,2,3,3,8,0xb2d09eee
100001.02,3.0,96,3,4,1,8,0xb2d2570b
7.27,1.0,21,1,2,2,5,0xb2d2e605
400011.74,4.0,59,4,4,2,10,0xb2d13f62
144771.85,2.0,1,3,3,4,10,0xb2d11c29
22936687.84,21.0,1,4,4,4,12,0xb2d171d5
528978.0,4.0,0,4,4,4,12,0xb2d48b58
36.77,1.0,116,1,2,1,4,0xb2d175a0
600032.23,9.0,13,4,4,3,11,0xb2d54e67
28359.78,5.0,39,2,4,2,8,0xb2d9836a
143.15,1.0,8,1,2,3,6,0xb2d20d3cd
40438.42,2.0,80,2,3,1,6,0xb2d67f92
300000.69,3.0,10,3,4,3,10,0xb2d91876
111354.92,3.0,18,3,4,2,9,0xb2d59bde
15158.22,1.0,184,2,2,1,5,0xb2d385bf
606.63,1.0,14,1,2,3,6,0xb2d1db0b
104045.92,2.0,129,3,3,1,7,0xb2d2f167
40057.44,2.0,73,2,3,1,6,0xb2d6d017
400713.77,3.0,18,4,4,2,10,0xb2d5ac5a
100650.25,2.0,77,3,3,1,7,0xb2d59ead
860732.33,4.0,4,4,4,4,12,0xb2d60a25
100000.0,1.0,2,3,2,4,9,0xb2da5fd6
14634.51,1.0,29,2,2,2,6,0xb2d3161b
0.0,2.0,32,1,3,2,6,0xb2d649ab
5026.99,1.0,14,2,2,3,7,0xb2d78c7c
2966.7,2.0,92,2,3,1,6,0x3b9b40ff
5194.08,1.0,184,2,2,1,5,0xb2d48fdcd
160052.7,2.0,168,3,3,1,7,0xb2d1b29b
400000.0,3.0,1,4,4,4,12,0xb2da411b
5.3,1.0,55,1,2,2,5,0xb2d6d393
192996.76,6.0,0,3,4,4,11,0xb2d0f2f7
1702000.0,9.0,0,4,4,4,12,0xb2d41355
500095.48,2.0,9,4,3,3,10,0xb2d0b435
100.49,1.0,165,1,2,1,4,0xb2d395b2d
623192.94,4.0,3,4,4,4,12,0xb2d0a85f
4009.23,1.0,70,2,2,1,5,0xb2d1535a
605011.04,3.0,70,4,4,1,9,0xb2d0ee15
1395.82,1.0,83,1,2,1,4,0xb2d101f1
4038.21,1.0,92,2,2,1,5,0xb2d29cc9d
91.68,1.0,11,1,2,3,6,0xb2d8e53e
53002.21,3.0,6,3,4,3,10,0xb2d075c2
22065.84,1.0,184,2,2,1,5,0xb2d2ff27
101329.93,4.0,0,3,4,4,11,0xb2d2efaf
740000.0,2.0,3,4,3,4,11,0xb2d5db5b
100007.35,5.0,55,3,4,2,9,0xb2d6520a
199333.38,19.0,5,3,4,3,10,0xb2d2e873
329.97,1.0,36,1,2,2,5,0xb2d571d5
61569.38,6.0,0,3,4,4,11,0xb2d5303c
291.78,1.0,15,1,2,3,6,0xb2d63a8f
1200000.0,2.0,13,4,3,3,10,0xb2da1ce6
322206.72,11.0,47,4,4,2,10,0xb2d10408
4184.65,1.0,10,2,2,3,7,0xb2d408c9
9185.15,1.0,9,2,2,3,7,0xb2d3a1ed
377.36,1.0,9,1,2,3,6,0xb2d25422
2850.84,1.0,184,1,2,1,4,0xb2d18d87d
186127.89,2.0,0,3,3,4,10,0xb2d317e7d
3152.0,1.0,0,2,2,4,8,0xb2d6b5b6
274019.23,3.0,67,3,4,1,8,0xb2d5ee04
332345.02,2.0,82,4,3,1,8,0xb2d98c24
400008.45,2.0,123,4,3,1,8,0xb2d9391ad
172141.98,2.0,25,3,3,2,8,0xb2d23e60
100049.22,2.0,0,3,3,4,10,0xb2d25341
10112.63,2.0,0,2,3,4,9,0xb2d5a68a
531148.92,6.0,5,4,4,3,11,0xb2d6db63
40009.59,3.0,15,2,4,3,9,0xb2d9af81
132034.04,1.0,4,3,2,4,9,0xb2d99eeb
911697.79,2.0,231,4,3,1,8,0xb2d1befb
486017.44,7.0,3,4,4,4,12,0xb2d65a11
200720.13,3.0,35,3,4,2,9,0xb2d4eb34
1325.18,1.0,84,1,2,1,4,0xb2d8cb65
50523.94,1.0,0,2,2,4,8,0xb2d92864
717942.76,5.0,30,4,4,2,10,0xb2d0dbc4
2495.28,1.0,21,1,2,2,5,0xb2d68e68
8138.81,1.0,10,2,2,3,7,0xb2d5cfa5
404021.49,2.0,139,4,3,1,8,0xb2d6d967
413004.86,10.0,1,4,4,4,12,0xb2d53a78d
3692.73,1.0,184,2,2,1,5,0xb2d2074fd
534091.29,6.0,0,4,4,4,12,0xb2d10eda
1085.91,1.0,184,1,2,1,4,0xb2d29e34
2289.99,1.0,92,1,2,1,4,0xb2d1b171d
1181411.72,5.0,93,4,4,1,9,0xb2d34747
355179.64,3.0,23,4,4,2,10,0xb2d5d530
300002.56,3.0,4,3,4,4,11,0xb2d9ecc0
151419.12,3.0,77,3,4,1,8,0xb2d0d2e5
0.56,1.0,35,1,2,2,5,0xb2d37f5e
288523.59,2.0,15,3,3,3,9,0xb2d4ed1a
450038.27,3.0,1,4,4,4,12,0xb2d8fa4b
200047.21,2.0,165,3,3,1,7,0xb2d776da
625004.06,4.0,24,4,4,2,10,0xb2d6aa2e
90000.8,4.0,1,3,4,4,11,0xb2d0dc38
600.0,1.0,0,1,2,4,7,0xb2d33500
2185486.56,14.0,0,4,4,4,12,0xb2d0d3bc
2056733.0,19.0,6,4,4,3,11,0xb2d5a6c8
2316.7,1.0,0,1,2,4,7,0xb2d6020a
6.02,2.0,17,1,3,2,6,0xb2d5d3e7
720033.02,3.0,19,4,4,2,10,0xb2d94772
300000.0,2.0,2,3,3,4,10,0xb2d97f50
321164.78,5.0,18,4,4,2,10,0xb2d26f63
50001.06,2.0,31,2,3,2,7,0xb2d939d0
50050.6,2.0,46,2,3,2,7,0xb2d5669b
4470.5,1.0,0,2,2,4,8,0xb2d9d5e9
1015.49,1.0,184,1,2,1,4,0xb2d14ac7d
1219.6,1.0,184,1,2,1,4,0xb2d0af01
70030.45,3.0,50,3,4,2,9,0xb2d7d074
1475407.8,3.0,2,4,4,4,12,0xb2d57287
23.9,1.0,34,1,2,2,5,0xb2d552d7
120000.32,3.0,24,3,4,2,9,0xb2d0d5fe
230016.91,8.0,20,3,4,2,9,0xb2d8c49b
7962.79,1.0,0,2,2,4,8,0xb2d1a3e8
605280.77,2.0,6,4,3,3,10,0xb2d607be
492100.0,4.0,0,4,4,4,12,0xb2d5137a
29375.6,3.0,28,2,4,2,8,0xb2d309e1
151300.76,1.0,92,3,2,1,6,0xb2d518fc
204307.67,2.0,27,3,3,2,8,0xb2d304f6d
55000.0,4.0,1,3,4,4,11,0xb2d61a2c
82878.03,2.0,133,3,3,1,7,0xb2d57af8
400847.4,2.0,14,4,3,3,10,0xb2d23b15
200117.64,4.0,27,3,4,2,9,0xb2d1bd38
1891280.15,6.0,63,4,4,2,10,0x3b9b2b5a
112006.33,4.0,64,3,4,2,9,0xb2d5963a
2215383.91,10.0,6,4,4,3,11,0xb2d51625d
70450.21,3.0,3,3,4,4,11,0x3b9ace14
5405.47,1.0,0,2,2,4,8,0xb2d63b80
439209.36,2.0,66,4,3,2,9,0xb2d1d58c
811012.05,16.0,1,4,4,4,12,0xb2d238ef
299000.0,2.0,23,3,3,2,8,0xb2d93077
750.6,2.0,6,1,3,3,7,0xb2d65a23
6742.56,1.0,0,2,2,4,8,0xb2d21fc5
797181.5,2.0,6,4,3,3,10,0xb2d2932c
1114.57,4.0,0,1,4,4,9,0x3b9b458c
1221.08,1.0,92,1,2,1,4,0xb2d56877d
408719.84,2.0,23,4,3,2,9,0xb2d50804
18.46,1.0,14,1,2,3,6,0xb2d3600e
107395.31,3.0,3,3,4,4,11,0xb2d54e9bd
31.12,1.0,35,1,2,2,5,0xb2d32782
1980.44,1.0,113,1,2,1,4,0xb2d5ee5b
84003.8,3.0,11,3,4,3,10,0xb2d90297
246089.49,3.0,17,3,4,2,9,0xb2d91493
9972.31,1.0,9,2,2,3,7,0xb2d419d7
242003.99,5.0,60,3,4,2,9,0xb2d5264d
31469.61,2.0,231,2,3,1,6,0xb2d37b88
382.16,1.0,17,1,2,2,5,0xb2d374cf
551428.39,3.0,68,4,4,1,9,0xb2d627c1
43.46,1.0,18,1,2,2,5,0xb2d12a4d
60001.51,4.0,96,3,4,1,8,0xb2d7783c
200051.33,4.0,104,3,4,1,8,0xb2d4368f
82869.67,4.0,125,3,4,1,8,0xb2d41a44
2109.77,1.0,6,1,2,3,6,0xb2d2fff3
5418.85,1.0,145,2,2,1,5,0xb2d651c4
32.94,1.0,54,1,2,2,5,0xb2d7915e
401422.1,2.0,34,4,3,2,9,0xb2d9de42
263038.17,13.0,4,3,4,4,11,0xb2d62d6d
531.71,1.0,0,1,2,4,7,0xb2d14fb3
2192.22,1.0,16,1,2,2,5,0xb2d14c17
6022.43,1.0,19,2,2,2,6,0xb2d1add3
781055.12,4.0,8,4,4,3,11,0xb2d4c064
793295.13,6.0,27,4,4,2,10,0xb2d08145
200087.02,2.0,21,3,3,2,8,0xb2d8f4c4
620058.55,2.0,34,4,3,2,9,0xb2d9322a
51401.28,2.0,2,2,3,4,9,0xb2d26d34
100001.06,2.0,20,3,3,2,8,0xb2d950a3
10.07,1.0,10,1,2,3,6,0xb2d9c10d
67.17,1.0,40,1,2,2,5,0xb2d6b30a
742813.69,3.0,0,4,4,4,12,0xb2d5931cd
107012.53,2.0,174,3,3,1,7,0xb2d2c81c
20127.34,2.0,92,2,3,1,6,0x3b9b3a61
38109.29,1.0,49,2,2,2,6,0xb2d37c0b
2385.51,1.0,0,1,2,4,7,0xb2d92bf6
500000.0,2.0,15,4,3,3,10,0xb2da3219
113965.05,2.0,1,3,3,4,10,0xb2d3fbe7
205452.33,2.0,69,3,3,1,7,0xb2d3f6df
3952.73,1.0,7,2,2,3,7,0xb2d35372
197584.89,3.0,90,3,4,1,8,0xb2d6ab77
15.52,1.0,54,1,2,2,5,0xb2d5f8b7
5402.1,1.0,6,2,2,3,7,0xb2d9481e
1858614.91,5.0,70,4,4,1,9,0xb2d56321
0.44,1.0,15,1,2,3,6,0xb2d28846d
500000.79,3.0,10,4,4,3,11,0xb2d92895
0.0,1.0,5,1,2,3,6,0xb2d528dd
360005.79,7.0,38,4,4,2,10,0xb2d33c37
1230.98,1.0,184,1,2,1,4,0xb2d12233
450000.0,3.0,1,4,4,4,12,0xb2d9b2c6
54865.04,3.0,184,3,4,1,8,0xb2d2eebf
10.18,1.0,17,1,2,2,5,0xb2d77660
54488.58,2.0,25,3,3,2,8,0xb2d39825d
260071.15,3.0,4,3,4,4,11,0xb2d1bccf
26199.84,3.0,21,2,4,2,8,0x3b9ae882d
423541.9,6.0,0,4,4,4,12,0xb2d2b47a
107492.93,2.0,122,3,3,1,7,0xb2d3a9fd
50049.32,1.0,49,2,2,2,6,0xb2d60488
3277.58,1.0,0,2,2,4,8,0xb2d6b8ce
1174617.02,5.0,38,4,4,2,10,0xb2d12bf3
20000.66,3.0,0,2,4,4,10,0xb2d78f21d
2122042.31,7.0,4,4,4,4,12,0xb2d59a9d
230007.9,2.0,10,3,3,3,9,0xb2d64404
2927.61,1.0,2,2,2,4,8,0xb2d2f206
8050.67,1.0,10,2,2,3,7,0xb2d6f0fa
171935.91,3.0,1,3,4,4,11,0x3b9b4244
368447.46,4.0,4,4,4,4,12,0xb2d37676
1780076.0,3.0,69,4,4,1,9,0xb2d2913b
858944.55,2.0,122,4,3,1,8,0xb2d2825e
1541194.02,5.0,1,4,4,4,12,0xb2d200c2
3110.4,1.0,92,2,2,1,5,0xb2d0ae98d
30618.72,1.0,48,2,2,2,6,0xb2d2e71b
1911.15,1.0,122,1,2,1,4,0xb2d48484
191.08,1.0,184,1,2,1,4,0xb2d424a7
1692.36,2.0,8,1,3,3,7,0xb2d0a4e8
20002.37,3.0,83,2,4,1,7,0xb2d14df1
115464.18,2.0,60,3,3,2,8,0xb2d6bbc5
150045.58,1.0,0,3,2,4,9,0xb2da096e
32359.18,2.0,21,2,3,2,7,0xb2d5cde3
1097886.6,8.0,1,4,4,4,12,0xb2d5df33
360081.07,4.0,10,4,4,3,11,0xb2d1bb13
18696.93,1.0,173,2,2,1,5,0xb2d3766c
2183.86,1.0,92,1,2,1,4,0xb2d1db75
3491.9,1.0,184,2,2,1,5,0xb2d31598d
501776.79,2.0,33,4,3,2,9,0xb2d28e47
1146.66,1.0,77,1,2,1,4,0xb2d6b8fc
10311.34,1.0,8,2,2,3,7,0xb2d5e443
437261.37,6.0,14,4,4,3,11,0xb2d3516c
51013.77,1.0,0,2,2,4,8,0xb2d43dc5
11.37,1.0,14,1,2,3,6,0xb2d965b5
3003.04,1.0,10,2,2,3,7,0xb2d8e412
1018.14,1.0,11,1,2,3,6,0xb2d20eef
755938.54,10.0,7,4,4,3,11,0xb2d40fcf
30000.0,2.0,4,2,3,4,9,0xb2da55a3
2366.29,1.0,46,1,2,2,5,0xb2d41c7b
20191.13,1.0,184,2,2,1,5,0xb2d2e409
761136.55,8.0,28,4,4,2,10,0xb2d4f45c
5823.27,1.0,184,2,2,1,5,0xb2d1ecbed
1873.37,1.0,10,1,2,3,6,0xb2d42071
7500.07,1.0,0,2,2,4,8,0xb2d3ee93
5.27,1.0,45,1,2,2,5,0xb2d6bad3
1607.04,1.0,12,1,2,3,6,0xb2d8ca76
320173.3,10.0,18,4,4,2,10,0xb2d3cf22
1.94,1.0,25,1,2,2,5,0xb2d43db6d
108704.06,3.0,11,3,4,3,10,0xb2d9d567
40278.88,2.0,157,2,3,1,6,0xb2d66984
600097.98,6.0,12,4,4,3,11,0xb2d957de
1244.0,1.0,0,1,2,4,7,0xb2d9f290
50001.06,2.0,155,2,3,1,6,0xb2d6269b
110006.88,3.0,104,3,4,1,8,0xb2d95a9f
1696570.33,6.0,184,4,4,1,9,0x3b9af5bc
4821.41,1.0,184,2,2,1,5,0xb2d0e3e6
1119.5,1.0,0,1,2,4,7,0xb2d34927
200000.84,2.0,11,3,3,3,9,0xb2d8e6cfd
27.3,1.0,10,1,2,3,6,0xb2d5c351
662178.81,23.0,0,4,4,4,12,0x3b9af2cb
721.25,1.0,10,1,2,3,6,0xb2d7fb79
1330001.02,5.0,84,4,4,1,9,0xb2d479cb
5949.98,1.0,140,2,2,1,5,0xb2d23b40
20320.53,2.0,32,2,3,2,7,0xb2d926d6
1138.54,1.0,209,1,2,1,4,0xb2d6486b
470013.05,6.0,31,4,4,2,10,0xb2d5940ad
5319.43,1.0,14,2,2,3,7,0xb2d2fb00
477699.23,7.0,4,4,4,4,12,0xb2d68fedd
102003.95,2.0,192,3,3,1,7,0xb2d5e0c8
2299.23,1.0,18,1,2,2,5,0xb2d6c48d
27000.0,2.0,11,2,3,3,8,0xb2d5488ed
2101.94,1.0,0,1,2,4,7,0xb2d2110e
33649.29,3.0,0,2,4,4,10,0xb2d2bd44d
5105.44,1.0,167,2,2,1,5,0xb2d32d8d
31001.33,2.0,39,2,3,2,7,0xb2d9c9d6
777835.23,3.0,63,4,4,2,10,0xb2d5e44fd
185.44,1.0,21,1,2,2,5,0xb2d6f402
14257.91,1.0,92,2,2,1,5,0xb2d25421
500000.0,2.0,21,4,3,2,9,0xb2da24d2
16000000.0,1.0,0,4,2,4,10,0xb2d97470
87.78,1.0,13,1,2,3,6,0xb2d34833d
2549.1,1.0,2,1,2,4,7,0xb2d41ca6
23.87,1.0,7,1,2,3,6,0xb2d59fe4
1017.44,1.0,92,1,2,1,4,0xb2d09fa9
11004.34,1.0,0,2,2,4,8,0xb2d2fccc
243749.45,9.0,1,3,4,4,11,0xb2d22a94d
157.51,1.0,10,1,2,3,6,0xb2d3899f
1586083.68,14.0,11,4,4,3,11,0x3b9ae3e9
2.9,1.0,14,1,2,3,6,0xb2d2baff
26772.22,1.0,92,2,2,1,5,0x3b9b2d50
1058.49,1.0,181,1,2,1,4,0xb2d39968
0.0,1.0,1,1,2,4,7,0xb2d95107
3565.96,1.0,19,2,2,2,6,0xb2d9cf0d
500095.7,2.0,6,4,3,3,10,0xb2d3679d
500000.0,2.0,19,4,3,2,9,0xb2d9126c
620.99,1.0,2,1,2,4,7,0xb2d78957
417009.21,4.0,73,4,4,1,9,0xb2d07b45
361103.64,2.0,77,4,3,1,8,0xb2d6a021
41777.41,1.0,0,2,2,4,8,0xb2d39de6
1088944.74,3.0,17,4,4,2,10,0xb2d117fc
125295.1,4.0,0,3,4,4,11,0xb2d06acb
20111.15,3.0,21,2,4,2,8,0xb2d5852e
163005.99,3.0,10,3,4,3,10,0xb2d26710
100484.75,2.0,21,3,3,2,8,0xb2d28d3f
1083.3,1.0,39,1,2,2,5,0xb2d5d548
1387.17,1.0,9,1,2,3,6,0xb2d83978
4170.9,1.0,57,2,2,2,6,0xb2d789f9
581.36,1.0,95,1,2,1,4,0xb2d621b2
12016.56,1.0,54,2,2,2,6,0xb2d6ba9a
2549.17,5.0,12,1,4,3,8,0x3b9af1c7
126.78,1.0,80,1,2,1,4,0xb2d5bbca
49015.86,3.0,39,2,4,2,8,0xb2d59c43
2.05,1.0,43,1,2,2,5,0xb2d2c9d8
517601.21,2.0,129,4,3,1,8,0xb2d56608
140025.47,1.0,0,3,2,4,9,0xb2d0be56
103007.75,2.0,228,3,3,1,7,0xb2d19ae9
200000.0,2.0,13,3,3,3,9,0xb2da3bde
20773.35,2.0,139,2,3,1,6,0xb2d50ad3
200100.28,2.0,88,3,3,1,7,0xb2d198b6
4168.51,1.0,1,2,2,4,8,0xb2d781c4
6495.44,1.0,0,2,2,4,8,0xb2d9138b
200004.54,2.0,7,3,3,3,9,0xb2d8f71b
5209.39,1.0,92,2,2,1,5,0xb2d2b2a1
203598.14,2.0,159,3,3,1,7,0xb2d69200
526.93,1.0,20,1,2,2,5,0xb2d321a1
390023.47,6.0,87,4,4,1,9,0x3b9b39c8
174215.14,5.0,5,3,4,3,10,0xb2d29defd
1181243.01,4.0,11,4,4,3,11,0xb2d417a3
394218.25,8.0,0,4,4,4,12,0x3b9b3891
1532484.45,6.0,0,4,4,4,12,0xb2d1b22a
1014.47,1.0,92,1,2,1,4,0xb2d14e32
664109.92,6.0,7,4,4,3,11,0xb2d08680
260055.87,2.0,224,3,3,1,7,0xb2d0ea98
11982.16,1.0,184,2,2,1,5,0xb2d31b78d
99.28,1.0,67,1,2,1,4,0xb2d61413
1421.72,1.0,14,1,2,3,6,0xb2d2ce25
509.02,1.0,0,1,2,4,7,0xb2d4ce2e
74.32,1.0,55,1,2,2,5,0xb2d6a268
250887.77,3.0,8,3,4,3,10,0xb2d58796
2037.83,1.0,184,1,2,1,4,0xb2d1cbfd
157943.91,1.0,0,3,2,4,9,0xb2d1bb4e
38874.82,1.0,1,2,2,4,8,0xb2d9c714
150.61,1.0,0,1,2,4,7,0xb2d2f0e9
10096.07,1.0,16,2,2,2,6,0xb2d62a09
6321.29,1.0,6,2,2,3,7,0xb2d754ca
7193.04,1.0,18,2,2,2,6,0xb2d6a9dc
603.13,1.0,8,1,2,3,6,0xb2d2a32a
0.0,1.0,0,1,2,4,7,0xb2d4fd6e
1985891.11,9.0,8,4,4,3,11,0xb2d5ec48d
61141.33,11.0,0,3,4,4,11,0xb2d270ddd
50085.79,2.0,6,2,3,3,8,0xb2d43ea9
8.82,1.0,28,1,2,2,5,0xb2d64efe
99.08,1.0,8,1,2,3,6,0xb2d2a5a1
200006.34,2.0,7,3,3,3,9,0xb2d900eed
404473.25,2.0,27,4,3,2,9,0xb2d9331e
1010042.68,2.0,133,4,3,1,8,0xb2d91226
1523.94,1.0,5,1,2,3,6,0xb2d2b75a
76485.5,2.0,112,3,3,1,7,0xb2d58de5
392034.37,2.0,1,4,3,4,11,0xb2d275a5
682.88,1.0,19,1,2,2,5,0xb2d5f803
129.47,1.0,12,1,2,3,6,0xb2d12924
287.7,1.0,4,1,2,4,7,0xb2d26c5f
10505.01,1.0,7,2,2,3,7,0xb2d2b023
649000.0,8.0,0,4,4,4,12,0xb2d6f110
4741.4,1.0,0,2,2,4,8,0xb2da0d4a
10000.42,2.0,20,2,3,2,7,0xb2d94e77d
24086.02,2.0,0,2,3,4,9,0xb2d0e615
540030.39,6.0,3,4,4,4,12,0xb2d55e94
1.94,1.0,31,1,2,2,5,0xb2d8fb80
3134.43,1.0,101,2,2,1,5,0xb2d10b51
1523039.0,9.0,6,4,4,3,11,0xb2d3bb87
551835.07,8.0,5,4,4,3,11,0xb2d209aed
1856.26,3.0,0,1,4,4,9,0xb2d06894
261439.62,4.0,179,3,4,1,8,0xb2d2eab0d
4265.99,2.0,15,2,3,3,8,0x3b9ace47
80097.74,1.0,0,3,2,4,9,0xb2d4de83
430016.98,3.0,22,4,4,2,10,0xb2d9cc60
300260.09,2.0,203,4,3,1,8,0xb2d0e79e
288.26,1.0,7,1,2,3,6,0xb2d6a6a0
200018.47,2.0,129,3,3,1,7,0xb2d41428
12410.0,1.0,184,2,2,1,5,0xb2d4c1e8
367175.25,5.0,6,4,4,3,11,0xb2d23483
150.9,1.0,10,1,2,3,6,0xb2d24b3d
10200.8,2.0,140,2,3,1,6,0xb2d52693
210003.38,3.0,67,3,4,1,8,0xb2d92bc6d
246819.84,2.0,10,3,3,3,9,0xb2d652ecd
757.18,1.0,11,1,2,3,6,0xb2d28358
749233.75,3.0,19,4,4,2,10,0xb2d367fd
30001.27,2.0,63,2,3,2,7,0xb2d5d397
13.49,1.0,131,1,2,1,4,0xb2d1510e
5821.68,1.0,0,2,2,4,8,0xb2d6c830
28736.03,1.0,184,2,2,1,5,0xb2d3e681
9242.21,1.0,10,2,2,3,7,0xb2d59d90
2000104.03,3.0,26,4,4,2,10,0xb2d1ff4a
7509.01,1.0,15,2,2,3,7,0xb2d5e0bad
470063.03,5.0,49,4,4,2,10,0xb2d62d48
339467.31,4.0,62,4,4,2,10,0xb2d16e87
500198.81,2.0,11,4,3,3,10,0xb2da37be
1014.96,1.0,92,1,2,1,4,0xb2d16ccd
134810.0,6.0,0,3,4,4,11,0xb2d0ead5
511000.0,2.0,26,4,3,2,9,0xb2d9498b
1143.23,1.0,87,1,2,1,4,0xb2d5fe16d
100314.73,2.0,151,3,3,1,7,0xb2d6e163
1.63,1.0,88,1,2,1,4,0xb2d0c203
53131.51,1.0,7,3,2,3,8,0xb2d4b355d
2825.92,1.0,92,1,2,1,4,0x3b9b2b2a
4092.92,1.0,77,2,2,1,5,0xb2d91e77
966294.1,3.0,9,4,4,3,11,0xb2d202a9
98.33,1.0,77,1,2,1,4,0xb2d4cb6b
545032.04,4.0,10,4,4,3,11,0xb2d20715
200361.3,2.0,3,3,3,4,10,0xb2d14d2a
2802.19,1.0,184,1,2,1,4,0xb2d44d17
156691.98,1.0,4,3,2,4,9,0xb2d601e0
818774.03,1.0,92,4,2,1,7,0xb2d2069d
50000.0,1.0,1,2,2,4,8,0xb2da662d
144001.85,8.0,0,3,4,4,11,0xb2d575f9
16369.94,2.0,2,2,3,4,9,0xb2d62441
10291.31,1.0,3,2,2,4,8,0xb2d47c6d
84208.62,1.0,6,3,2,3,8,0xb2d9522c
4745.3,1.0,2,2,2,4,8,0xb2d1fb31
9463.67,1.0,2,2,2,4,8,0xb2d17508
36071.0,1.0,87,2,2,1,5,0xb2d6db66
2293.9,2.0,92,1,3,1,5,0x3b9b37a8
406634.08,3.0,63,4,4,2,10,0xb2d64c42
206430.82,2.0,5,3,3,3,9,0xb2d5ff84
730165.73,3.0,29,4,4,2,10,0xb2d4f26ed
1150983.26,9.0,10,4,4,3,11,0x3b9b2831
157906.67,2.0,77,3,3,1,7,0xb2d1143c
2.84,1.0,15,1,2,3,6,0xb2d8ed26d
140179.99,2.0,19,3,3,2,8,0xb2d1ac14
15061.36,1.0,184,2,2,1,5,0xb2d59044
24651.89,1.0,0,2,2,4,8,0xb2d781b4
325688.07,2.0,27,4,3,2,9,0xb2d6b8cfd
0.57,1.0,88,1,2,1,4,0xb2d62a45
1542796.8,1.0,0,4,2,4,10,0xb2da2dda
915010.95,6.0,18,4,4,2,10,0xb2d5d458
16998.98,2.0,0,2,3,4,9,0x3b9af1ea
151856.12,3.0,33,3,4,2,9,0xb2d6d3a8
32468.97,2.0,18,2,3,2,7,0xb2d0a7cf
130000.0,1.0,0,3,2,4,9,0xb2d9288e
543.69,1.0,0,1,2,4,7,0xb2d5beac
811817.21,3.0,0,4,4,4,12,0xb2d68301d
900050.69,3.0,52,4,4,2,10,0xb2d7c6df
260063.64,4.0,8,3,4,3,10,0xb2d6ccbfd
12.19,1.0,9,1,2,3,6,0xb2d60670
70037.86,3.0,1,3,4,4,11,0xb2d61a1e
3430891.99,9.0,0,4,4,4,12,0x3b9af180
10127.93,1.0,119,2,2,1,5,0xb2d68193
1350118.04,2.0,21,4,3,2,9,0xb2d939c2
100003.17,2.0,10,3,3,3,9,0xb2d9600e
500048.0,3.0,110,4,4,1,9,0xb2d227dc
8.65,1.0,57,1,2,2,5,0xb2d975fe
440112.2,2.0,136,4,3,1,8,0xb2d288e9
2065911.33,6.0,125,4,4,1,9,0xb2d1a9a5
410498.07,7.0,0,4,4,4,12,0xb2d41055
509065.78,5.0,3,4,4,4,12,0xb2d14d18
500307.95,5.0,1,4,4,4,12,0x3b9adbf2d
42594.29,1.0,92,2,2,1,5,0xb2d41c9a
891158.32,8.0,7,4,4,3,11,0xb2d18479
1004463.1,5.0,46,4,4,2,10,0xb2d6433ad
188009.07,4.0,94,3,4,1,8,0xb2d5f5c5
31000.0,5.0,1,2,4,4,10,0xb2d0b5b9
36909.61,1.0,10,2,2,3,7,0xb2d2ebd0
150236.45,2.0,32,3,3,2,8,0xb2d891be
52413.6,1.0,73,3,2,1,6,0xb2d3229a
61748.66,2.0,0,3,3,4,10,0xb2d61887
24000001.0,2.0,92,4,3,1,8,0xb2d551ffd
87.82,1.0,9,1,2,3,6,0xb2d2f27a
160059.39,3.0,38,3,4,2,9,0xb2d5e13e
3140.69,1.0,0,2,2,4,8,0xb2d5b4c0
570.36,1.0,89,1,2,1,4,0xb2d3343f
16958.62,1.0,29,2,2,2,6,0xb2d92358
3481.33,1.0,12,2,2,3,7,0xb2d2c069
100036.04,2.0,80,3,3,1,7,0xb2d6b664
64044.19,2.0,231,3,3,1,7,0xb2d3ac22
1129.22,1.0,7,1,2,3,6,0xb2d5c912
2199.7,3.0,92,1,4,1,6,0x3b9addea
153246.74,3.0,59,3,4,2,9,0xb2d48945
565.84,2.0,1,1,3,4,8,0xb2d15819
152785.03,2.0,3,3,3,4,10,0xb2d57b64
3983480.42,8.0,4,4,4,4,12,0xb2d0ab6f
637324.54,4.0,91,4,4,1,9,0xb2d17034
147475.96,2.0,69,3,3,1,7,0xb2d0805c
1044.88,1.0,153,1,2,1,4,0xb2d3e900
206020.68,2.0,2,3,3,4,10,0xb2d62876
465108.78,6.0,0,4,4,4,12,0xb2d06487
901.19,1.0,92,1,2,1,4,0xb2d1b577
253164.96,4.0,90,3,4,1,8,0xb2d22f35
2014.43,1.0,0,1,2,4,7,0xb2d0d08a
0.62,1.0,76,1,2,1,4,0xb2d1dc3ad
39887.76,3.0,1,2,4,4,10,0xb2d54e1d
2.79,1.0,56,1,2,2,5,0xb2d5fd19
600.15,1.0,0,1,2,4,7,0xb2da3db6
200028.84,3.0,0,3,4,4,11,0xb2d6d0e7d
3001.16,1.0,24,2,2,2,6,0xb2d6f5d5
7.29,1.0,184,1,2,1,4,0xb2d1b46fd
120002.96,2.0,32,3,3,2,8,0xb2d9acfb
500083.54,3.0,53,4,4,2,10,0xb2d491bc
100059.69,2.0,23,3,3,2,8,0xb2d9d0b9
87.83,1.0,41,1,2,2,5,0xb2d91e41
1125882.64,2.0,1,4,3,4,11,0xb2d43ed5
156299.42,2.0,31,3,3,2,8,0xb2d472d9
150006.86,3.0,27,3,4,2,9,0xb2da03ab
233727.32,5.0,4,3,4,4,11,0xb2d64dbbd
14457.55,1.0,10,2,2,3,7,0xb2d6a3ec
301065.63,2.0,40,4,3,2,9,0xb2d9f198
85.3,1.0,0,1,2,4,7,0xb2d9d441
50330.72,1.0,3,2,2,4,8,0xb2d93564
524004.96,8.0,14,4,4,3,11,0x3b9b3c0a
12804.67,1.0,1,2,2,4,8,0xb2da3bb1
130001.69,3.0,14,3,4,3,10,0xb2d9b156
700030.07,3.0,1,4,4,4,12,0xb2d95298
15.17,1.0,16,1,2,2,5,0xb2d31390
1000022.92,4.0,0,4,4,4,12,0xb2d52b54
5.58,2.0,36,1,3,2,6,0xb2d9a970
51294.77,1.0,92,2,2,1,5,0xb2d36224
35004.78,3.0,13,2,4,3,9,0xb2d5e3a8
10373.09,1.0,9,2,2,3,7,0xb2d602da
501582.01,3.0,4,4,4,4,12,0xb2d8e1c6
50737.98,2.0,24,2,3,2,7,0xb2d451e3
38390.28,1.0,0,2,2,4,8,0xb2d17802
7085.93,1.0,5,2,2,3,7,0xb2d2b7aa
180619.0,2.0,1,3,3,4,10,0xb2d6962c
92.86,1.0,7,1,2,3,6,0xb2d0e70d
50967.06,2.0,0,2,3,4,9,0xb2d168f6d
474.38,1.0,48,1,2,2,5,0xb2d20d4d
5351.72,1.0,13,2,2,3,7,0xb2d912e5
121617.88,2.0,19,3,3,2,8,0xb2d2d779
1082.01,1.0,8,1,2,3,6,0xb2d9f2b1
1809.2,1.0,184,1,2,1,4,0xb2d14cc4d
342056.09,4.0,38,4,4,2,10,0xb2d0cdc5d
36.28,1.0,10,1,2,3,6,0xb2d2807d
2000027.53,3.0,10,4,4,3,11,0xb2d69b91
80202.53,2.0,5,3,3,3,9,0xb2d9268b
462019.32,4.0,27,4,4,2,10,0xb2d97eaa
558864.3,3.0,11,4,4,3,11,0xb2d65885
2734.14,1.0,37,1,2,2,5,0xb2d92c22
24580.43,1.0,6,2,2,3,7,0xb2d754d4
470469.35,1.0,9,4,2,3,9,0xb2d55f48
3668.89,1.0,18,2,2,2,6,0xb2d6bceb
202741.16,3.0,8,3,4,3,10,0xb2d1bcbb
510020.01,7.0,88,4,4,1,9,0xb2d54859
585015.67,2.0,200,4,3,1,8,0xb2d6b1db
480001.28,5.0,1,4,4,4,12,0xb2d941d1
500000.05,2.0,18,4,3,2,9,0xb2d9d23e
10.6,1.0,0,1,2,4,7,0xb2d0b450d
1450.24,1.0,92,1,2,1,4,0xb2d3676c
248.7,1.0,32,1,2,2,5,0xb2d963e0
317523.59,5.0,6,4,4,3,11,0xb2d42c85
50037.39,3.0,3,2,4,4,10,0xb2d082ab
91137.47,3.0,5,3,4,3,10,0xb2d6bb65
21259.36,1.0,32,2,2,2,6,0xb2d5d5b0
1.64,1.0,80,1,2,1,4,0xb2d23717
13.09,1.0,3,1,2,4,7,0xb2d48be8
3138.14,1.0,7,2,2,3,7,0xb2d224e2
0.84,1.0,1,1,2,4,7,0xb2d4c95e
1734.24,1.0,9,1,2,3,6,0xb2d45bff
502.8,1.0,14,1,2,3,6,0xb2d2df46
2400.83,1.0,14,1,2,3,6,0xb2d8ca75
1013295.92,5.0,0,4,4,4,12,0xb2d5c4b7
31567.72,1.0,0,2,2,4,8,0xb2d78dbc
28277.7,1.0,7,2,2,3,7,0xb2d2b5d3
310009.98,4.0,26,4,4,2,10,0xb2d3addd
130213.94,2.0,105,3,3,1,7,0xb2d1ec33
481826.05,2.0,16,4,3,2,9,0xb2d8ec7f
11834.04,1.0,0,2,2,4,8,0xb2d2ac66
1620.34,2.0,92,1,3,1,5,0xb2d5d72d
8376.29,1.0,2,2,2,4,8,0xb2d1d474
26193.64,1.0,18,2,2,2,6,0xb2d6bfd9
2141042.25,7.0,21,4,4,2,10,0xb2d3c3d7
339.64,1.0,11,1,2,3,6,0xb2d940e4d
846.67,1.0,62,1,2,2,5,0xb2d3f3add
61982.57,2.0,1,3,3,4,10,0xb2d93f2f
2337.62,1.0,6,1,2,3,6,0xb2d85773
2447.12,1.0,4,1,2,4,7,0xb2d625ba
4577.43,1.0,0,2,2,4,8,0xb2d6c722
500000.02,3.0,19,4,4,2,10,0xb2d68fda
95418.7,2.0,41,3,3,2,8,0xb2d3eb1f
209211.31,3.0,8,3,4,3,10,0xb2d4f017
2380119.07,14.0,0,4,4,4,12,0xb2d15428d
71937.15,7.0,3,3,4,4,11,0xb2d3d544
13189.98,1.0,19,2,2,2,6,0xb2d763d7
407518.37,2.0,31,4,3,2,9,0xb2d8fd45
410.49,1.0,5,1,2,3,6,0xb2d340fdd
23636.65,1.0,184,2,2,1,5,0xb2d11987
1816.14,1.0,299,1,2,1,4,0xb2d32d5c
320161.3,2.0,16,4,3,2,9,0xb2d65929
10000.21,2.0,18,2,3,2,7,0xb2d90384
230000.98,2.0,6,3,3,3,9,0xb2d9faa5
5385.91,1.0,2,2,2,4,8,0xb2d574af
243078.97,2.0,107,3,3,1,7,0xb2d56c4d
417989.27,6.0,67,4,4,1,9,0xb2d39289
160077.88,5.0,39,3,4,2,9,0xb2d416f6
1015.85,1.0,0,1,2,4,7,0xb2d914a4
3365.79,1.0,75,2,2,1,5,0xb2d4dbf1d
109310.08,2.0,108,3,3,1,7,0xb2d5bcfa
1149021.03,19.0,11,4,4,3,11,0xb2d1494c
784.38,1.0,10,1,2,3,6,0xb2d9185d
100000.0,2.0,142,3,3,1,7,0xb2d69f32d
308488.35,3.0,14,4,4,3,11,0xb2d649fd
0.97,1.0,1,1,2,4,7,0xb2d6f1c8
1224798.1,6.0,4,4,4,4,12,0xb2d30b3b
300005.28,3.0,42,3,4,2,9,0xb2d9e219
750000.11,3.0,18,4,4,2,10,0xb2d6e8d3
35010.24,2.0,132,2,3,1,6,0xb2d54a9b
306012.92,2.0,42,4,3,2,9,0xb2d9e5f0
109530.35,3.0,203,3,4,1,8,0xb2d265c3d
285.54,1.0,3,1,2,4,7,0xb2d19c97
18.9,1.0,45,1,2,2,5,0xb2d982e4
525460.83,4.0,34,4,4,2,10,0xb2d5c5ae
309.36,1.0,38,1,2,2,5,0xb2d59584
7632.72,1.0,1,2,2,4,8,0xb2d1dd7e
13457.37,1.0,8,2,2,3,7,0xb2d11fbc
410101.87,4.0,73,4,4,1,9,0xb2d5cbfd
50095.38,1.0,14,2,2,3,7,0xb2d5c39d
927.21,1.0,9,1,2,3,6,0xb2d48f5f
23274.5,2.0,41,2,3,2,7,0xb2d6d291d
20485.92,1.0,6,2,2,3,7,0xb2da0b6a
86048.28,4.0,27,3,4,2,9,0xb2d5b045
17570.68,1.0,250,2,2,1,5,0xb2d6be5bd
980.24,1.0,0,1,2,4,7,0xb2d6c2ca
1092041.97,7.0,0,4,4,4,12,0xb2d325a3
54.06,1.0,67,1,2,1,4,0xb2d6b1a0
365639.42,6.0,32,4,4,2,10,0xb2d29559
10006635.94,10.0,0,4,4,4,12,0xb2d2555d
3202027.84,8.0,6,4,4,3,11,0xb2d243c5
670015.18,8.0,8,4,4,3,11,0xb2d61988
47.37,1.0,13,1,2,3,6,0xb2d28d2f
4252.68,1.0,0,2,2,4,8,0xb2d69b82
1014.43,1.0,8,1,2,3,6,0xb2d8ff8d
812029.3,8.0,0,4,4,4,12,0xb2d20da2
51644.43,5.0,0,2,4,4,10,0xb2d5302c
310698.27,1.0,101,4,2,1,7,0xb2d4493e
63091.26,1.0,77,3,2,1,6,0xb2d656fb
1046107.52,7.0,19,4,4,2,10,0xb2d1234c
29.5,1.0,1,1,2,4,7,0xb2d2fa6c
500003.99,3.0,11,4,4,3,11,0xb2da2b9f
54506.31,2.0,200,3,3,1,7,0xb2d15aaed
84128.62,2.0,39,3,3,2,8,0xb2d1be70
200121.86,4.0,69,3,4,1,8,0xb2d101a2
4416.51,1.0,2,2,2,4,8,0xb2d39771
6846.41,1.0,20,2,2,2,6,0xb2d41b8cd
3472.07,1.0,92,2,2,1,5,0xb2d105d7
82635.73,1.0,11,3,2,3,8,0xb2d98ffb
0.0,2.0,0,1,3,4,8,0xb2d1dd23
102604.73,2.0,245,3,3,1,7,0xb2d22987d
2.11,1.0,157,1,2,1,4,0xb2d6d17c
9160.54,1.0,0,2,2,4,8,0xb2d6bfbb
331657.96,5.0,0,4,4,4,12,0xb2d5f231
1498.97,1.0,92,1,2,1,4,0xb2d43211
5782.71,1.0,2,2,2,4,8,0xb2d6bda7d
200056.72,5.0,70,3,4,1,8,0xb2d09f3d
11725.26,1.0,10,2,2,3,7,0xb2d3f731
1.99,1.0,3,1,2,4,7,0xb2d14875
1010.42,1.0,92,1,2,1,4,0xb2d14502
933.2,1.0,73,1,2,1,4,0xb2d5aab8
252720.52,5.0,35,3,4,2,9,0xb2d5a3c7
10602.91,1.0,1,2,2,4,8,0xb2d342fe
4193.36,1.0,0,2,2,4,8,0xb2d78d42
12507.84,1.0,0,2,2,4,8,0xb2d2fdb8
965.17,1.0,39,1,2,2,5,0xb2d39288d
1705.45,1.0,184,1,2,1,4,0xb2d5404a
3.62,1.0,56,1,2,2,5,0xb2d591b6
200000.47,2.0,4,3,3,4,10,0xb2d65b6c
112582.1,1.0,184,3,2,1,6,0xb2d3a32f
60062.52,2.0,60,3,3,2,8,0xb2d27dcd
934.53,1.0,9,1,2,3,6,0xb2d6be29
715675.73,10.0,0,4,4,4,12,0x3b9b187f
1725.11,1.0,6,1,2,3,6,0xb2d24ba8d
140413.33,4.0,97,3,4,1,8,0xb2d1fd5c
1510360.99,9.0,0,4,4,4,12,0xb2d0eec0
60022.48,2.0,92,3,3,1,7,0xb2d5f101
58546362.16,3.0,3,4,4,4,12,0xb2d0afa3
5617.9,1.0,10,2,2,3,7,0xb2d5f5e2
1.58,1.0,32,1,2,2,5,0xb2d9325d
360013.21,4.0,80,4,4,1,9,0xb2d7a608d
433.17,1.0,231,1,2,1,4,0xb2d5e962
26.23,2.0,69,1,3,1,5,0xb2d41f9e
99520.43,9.0,200,3,4,1,8,0xb2d40b46
50093.13,2.0,108,2,3,1,6,0xb2d1e478
0.0,1.0,5,1,2,3,6,0xb2d96560
1.6,1.0,25,1,2,2,5,0xb2d2866f
7571.96,1.0,87,2,2,1,5,0xb2d26e70
0.0,1.0,25,1,2,2,5,0xb2d59e81
6084.48,1.0,1,2,2,4,8,0xb2d3ab78
523712.69,3.0,11,4,4,3,11,0xb2d08a38
448109.51,10.0,10,4,4,3,11,0xb2d57388
14708.13,1.0,9,2,2,3,7,0xb2d17d20
14.25,1.0,14,1,2,3,6,0xb2d5a5f7
20363.3,2.0,206,2,3,1,6,0xb2d60872
3890.88,1.0,184,2,2,1,5,0xb2d65a6ad
102841.98,1.0,0,3,2,4,9,0xb2d3270dd
176064.74,4.0,73,3,4,1,8,0xb2d58121
2664.54,1.0,184,1,2,1,4,0xb2d2983e
101005.96,3.0,26,3,4,2,9,0xb2d8e483
9816.19,1.0,20,2,2,2,6,0xb2d60c53
1675.4,1.0,105,1,2,1,4,0xb2d243b5
128.79,1.0,0,1,2,4,7,0xb2d37d28
30061.77,2.0,189,2,3,1,6,0xb2d5cb44
328777.5,3.0,7,4,4,3,11,0xb2d3380e
10000.32,2.0,45,2,3,2,7,0xb2d91589d
5069.14,1.0,92,2,2,1,5,0xb2d0eb68
900750.02,11.0,14,4,4,3,11,0xb2d18c49
370020.66,7.0,0,4,4,4,12,0xb2d54ac5d
2009.83,1.0,92,1,2,1,4,0xb2d4ceb5
1001.16,1.0,120,1,2,1,4,0xb2d91a8d
250352.08,3.0,27,3,4,2,9,0xb2d27a67
1514.79,1.0,148,1,2,1,4,0xb2d42117
697321.67,5.0,136,4,4,1,9,0xb2d2dc91
87.58,1.0,6,1,2,3,6,0xb2d6f2c6
290007.28,3.0,32,3,4,2,9,0xb2d97233
11791.08,1.0,0,2,2,4,8,0xb2d9421b
653412.72,5.0,0,4,4,4,12,0x3b9b2fa8
3176.37,1.0,20,2,2,2,6,0xb2d62dd7
674090.67,5.0,108,4,4,1,9,0xb2d185cb
1082.12,1.0,184,1,2,1,4,0xb2d229e5d
130065.25,3.0,4,3,4,4,11,0xb2d9a7b5
5810.99,1.0,3,2,2,4,8,0xb2d40f0e
11598.77,1.0,10,2,2,3,7,0xb2d8d349
277337.92,4.0,0,3,4,4,11,0xb2d1218d
152685.86,1.0,29,3,2,2,7,0xb2d5c0fd
15841.76,1.0,3,2,2,4,8,0xb2d4ff23
8476.25,1.0,135,2,2,1,5,0xb2d4085c
2202.88,1.0,85,1,2,1,4,0xb2d4ba10
154838.07,3.0,11,3,4,3,10,0xb2d36a09
2895.36,1.0,10,2,2,3,7,0xb2d496d2
6275.75,1.0,19,2,2,2,6,0xb2d24f3d
134.54,2.0,0,1,3,4,8,0xb2d64cf3
150001.58,2.0,18,3,3,2,8,0xb2da317b
876601.9,11.0,0,4,4,4,12,0x3b9b0fc3
720030.4,2.0,14,4,3,3,10,0xb2da254a
9050.58,1.0,11,2,2,3,7,0xb2d78302
10.36,1.0,101,1,2,1,4,0xb2d49175
66.67,1.0,47,1,2,2,5,0xb2d5c39dd
11583.57,1.0,4,2,2,4,8,0xb2d805dd
365.28,1.0,22,1,2,2,5,0xb2d270aa
151782.53,4.0,0,3,4,4,11,0xb2d64c17d
1898.2,1.0,15,1,2,3,6,0xb2d6ed66
120183.01,1.0,10,3,2,3,8,0xb2d2e711
300000.0,2.0,4,3,3,4,10,0xb2da5318
46.87,1.0,24,1,2,2,5,0xb2d3606a
0.19,1.0,3,1,2,4,7,0xb2d4292d
100024.28,2.0,63,3,3,2,8,0xb2d6f8c9
105226.81,6.0,0,3,4,4,11,0x3b9af24a
204712.88,3.0,120,3,4,1,8,0xb2d445b7
440789.97,4.0,6,4,4,3,11,0xb2d90e80
380051.87,3.0,0,4,4,4,12,0xb2d57738
324.04,1.0,1,1,2,4,7,0xb2d71789
208562.1,2.0,21,3,3,2,8,0xb2d9898b
10575.21,1.0,32,2,2,2,6,0xb2d61149
48098.71,2.0,16,2,3,2,7,0xb2d60387
10.03,1.0,31,1,2,2,5,0xb2d37c8e
523825.41,2.0,1,4,3,4,11,0xb2d0cbd8
2100000.5,5.0,4,4,4,4,12,0xb2d468f0
800046.51,3.0,10,4,4,3,11,0xb2d6a2ea
139013.88,3.0,39,3,4,2,9,0xb2d6d4f4
17519.71,1.0,10,2,2,3,7,0xb2d2b5e1
1718.67,1.0,0,1,2,4,7,0xb2d47392
500137.98,4.0,27,4,4,2,10,0xb2d781d3
24376.46,5.0,0,2,4,4,10,0x3b9af0e2
655902.89,5.0,0,4,4,4,12,0xb2d1b5d9
4568.19,1.0,2,2,2,4,8,0xb2d34312
120002.05,3.0,6,3,4,3,10,0xb2d08fabd
61102.03,1.0,0,3,2,4,9,0xb2d34d61
109.45,1.0,0,1,2,4,7,0x3b9b22ecd
60000.83,2.0,98,3,3,1,7,0xb2d93841
301752.43,3.0,107,4,4,1,9,0xb2d568c1
65987.41,2.0,76,3,3,1,7,0xb2d26193
980.45,1.0,46,1,2,2,5,0xb2d2a804
347.22,1.0,24,1,2,2,5,0xb2d22889
120009.18,6.0,47,3,4,2,9,0xb2d603c6
720000.38,5.0,5,4,4,3,11,0xb2d3c72a
10113.57,1.0,92,2,2,1,5,0xb2d18859
26252.64,1.0,12,2,2,3,7,0xb2d3fe9b
70005.27,3.0,0,3,4,4,11,0xb2d16895
52177.93,1.0,31,3,2,2,7,0xb2d55dee
964.81,1.0,9,1,2,3,6,0xb2d59d9ad
1358014.35,10.0,32,4,4,2,10,0xb2d21aafd
400032.33,4.0,20,4,4,2,10,0xb2d1a45b
65030.82,1.0,40,3,2,2,7,0xb2d10803
401773.03,4.0,6,4,4,3,11,0xb2d08870
306111.8,3.0,5,4,4,3,11,0x3b9af22e
274128.19,2.0,18,3,3,2,8,0xb2d0e7cb
332126.26,7.0,38,4,4,2,10,0xb2d0ca58
1145.15,1.0,184,1,2,1,4,0xb2d5a0b2
1005.39,1.0,38,1,2,2,5,0xb2d5b2fa
1015.27,1.0,1,1,2,4,7,0xb2d2e00d
700000.0,3.0,2,4,4,4,12,0xb2d972c2
500008.29,2.0,114,4,3,1,8,0xb2d78f34
5135.34,1.0,1,2,2,4,8,0xb2d2c8c0
45.12,1.0,4,1,2,4,7,0xb2d4188a
18833.45,1.0,0,2,2,4,8,0xb2d6c0a6
420.06,1.0,7,1,2,3,6,0xb2d58a48d
15800.72,1.0,0,2,2,4,8,0xb2d24268
8645.97,1.0,9,2,2,3,7,0xb2da36b2
3127.06,1.0,92,2,2,1,5,0xb2d1104f
2001301.89,3.0,123,4,4,1,9,0xb2d9028a
10000.21,2.0,18,2,3,2,7,0xb2da29bb
32.67,1.0,9,1,2,3,6,0xb2d42a58
445034.89,5.0,15,4,4,3,11,0xb2d075df
50002.11,2.0,63,2,3,2,7,0xb2d9b410
100001.39,2.0,66,3,3,2,8,0xb2d5ef6f
220032.92,4.0,10,3,4,3,10,0x3b9b145ed
440001.28,10.0,77,4,4,1,9,0xb2d3c3a8
12037.36,1.0,15,2,2,3,7,0xb2d65756
185.56,1.0,16,1,2,2,5,0xb2d48c37
140004.43,2.0,53,3,3,2,8,0xb2d9c94c
1301.91,1.0,0,1,2,4,7,0xb2d372d3
60.26,2.0,60,1,3,2,6,0xb2d683bf
423025.21,3.0,13,4,4,3,11,0xb2d5a563
810099.35,2.0,0,4,3,4,11,0xb2d65da0
179.32,1.0,8,1,2,3,6,0xb2d6e4f9
9611.83,1.0,92,2,2,1,5,0xb2d15971
311766.35,2.0,18,4,3,2,9,0xb2d2c2f8
400111.35,2.0,92,4,3,1,8,0xb2d1248d
6509.7,1.0,1,2,2,4,8,0xb2d7896f
19094.75,1.0,0,2,2,4,8,0xb2d43237
180.44,1.0,1,1,2,4,7,0xb2d54ef7
150028.89,3.0,32,3,4,2,9,0xb2d22ef2
50031.46,3.0,62,2,4,2,8,0xb2d6c9c9
572230.38,4.0,122,4,4,1,9,0xb2d23792d
200009.94,2.0,158,3,3,1,7,0xb2d4284c
3848.59,1.0,9,2,2,3,7,0xb2d1a75b
388.21,1.0,0,1,2,4,7,0xb2d6b8fb
3957.03,1.0,1,2,2,4,8,0xb2d6c4b1
4641.74,1.0,0,2,2,4,8,0xb2d68954
16084.41,1.0,5,2,2,3,7,0xb2d8ebf1
1859.39,2.0,184,1,3,1,5,0x3b9b3fd9
155794.2,2.0,116,3,3,1,7,0xb2d56800d
424766.6,5.0,0,4,4,4,12,0xb2d424e4d
80007.72,3.0,4,3,4,4,11,0xb2d5275f
138.0,1.0,1,1,2,4,7,0xb2d26037
1088.43,1.0,184,1,2,1,4,0xb2d57ee0
3579.76,1.0,0,2,2,4,8,0xb2d48e5ed
2203.75,1.0,0,1,2,4,7,0xb2d4d0af
450000.0,3.0,10,4,4,3,11,0xb2d64159
0.6,1.0,25,1,2,2,5,0xb2d2d594
503553.15,2.0,23,4,3,2,9,0xb2d8d0d3
1030.74,1.0,213,1,2,1,4,0xb2d264a2d
2891703.9,78.0,0,4,4,4,12,0xb2d4a6d9
3277221.84,10.0,2,4,4,4,12,0x3b9b4976
2639213.53,7.0,26,4,4,2,10,0xb2d24f2d
9270.56,1.0,10,2,2,3,7,0xb2d55ef6d
50272.15,2.0,97,2,3,1,6,0xb2d790bd
222.09,1.0,184,1,2,1,4,0xb2d2d41ad
363116.41,3.0,6,4,4,3,11,0xb2d5f0a4
13598.48,4.0,166,2,4,1,7,0xb2d60a65d
12213.1,1.0,0,2,2,4,8,0xb2d93d53
2.96,1.0,40,1,2,2,5,0xb2d632d1
2094467.34,8.0,10,4,4,3,11,0xb2d395f6
60009.11,2.0,151,3,3,1,7,0xb2d34a55d
2406.91,1.0,12,1,2,3,6,0xb2d27531d
2246.1,1.0,10,1,2,3,6,0xb2d39feb
502.08,1.0,9,1,2,3,6,0xb2d783d8
161670.5,2.0,92,3,3,1,7,0xb2d20e04
610009.19,5.0,92,4,4,1,9,0xb2d9036dd
451987.74,4.0,0,4,4,4,12,0x3b9b2aa1d
120001.48,3.0,92,3,4,1,8,0xb2d970f5
912.73,1.0,10,1,2,3,6,0xb2d2d724
118117.2,1.0,4,3,2,4,9,0xb2d7828e
5415.31,1.0,75,2,2,1,5,0xb2d3ef48
50033.56,2.0,19,2,3,2,7,0xb2d59e15
101122.55,2.0,10,3,3,3,9,0xb2d3add7
407555.58,3.0,11,4,4,3,11,0xb2d1cff5
550000.0,3.0,3,4,4,4,12,0xb2d088fc
1802.44,1.0,9,1,2,3,6,0xb2d62c06
495205.43,4.0,80,4,4,1,9,0xb2d42f57d
3536.32,1.0,184,2,2,1,5,0xb2d184d5
204038.83,4.0,27,3,4,2,9,0xb2d51bc5d
240488.16,3.0,147,3,4,1,8,0xb2d41bb7
1000019.11,2.0,4,4,3,4,11,0xb2d96123d
72.55,1.0,22,1,2,2,5,0xb2d37be3
230000.0,3.0,5,3,4,3,10,0xb2d78b55
582017.83,5.0,20,4,4,2,10,0xb2d56fc3
52883.5,2.0,83,3,3,1,7,0xb2d3f5b0
79815.13,2.0,0,3,3,4,10,0xb2d7896fd
1327121.12,17.0,10,4,4,3,11,0xb2d58250
7001.79,1.0,29,2,2,2,6,0xb2d92cd3
822.97,1.0,10,1,2,3,6,0xb2d6ced7
30.49,1.0,0,1,2,4,7,0xb2d8d9ae
30000.95,2.0,80,2,3,1,6,0xb2d8d293
2270.16,1.0,184,1,2,1,4,0xb2d3a3e8
110000.0,3.0,3,3,4,4,11,0xb2d513d4
832657.33,6.0,10,4,4,3,11,0xb2d6ff89
200026.04,4.0,0,3,4,4,11,0xb2d4fcbf
7.28,1.0,53,1,2,2,5,0xb2d9d1cd
11614.46,1.0,91,2,2,1,5,0xb2d0e3ee
70266.16,1.0,6,3,2,3,8,0xb2d6b500
2514.26,1.0,3,1,2,4,7,0xb2d553dd
3435.8,1.0,32,2,2,2,6,0xb2d9d342
204061.9,3.0,35,3,4,2,9,0xb2d564c8
300875.82,3.0,37,4,4,2,10,0xb2d391a5
54079.82,2.0,0,3,3,4,10,0xb2d2e0f3
2648.21,1.0,92,1,2,1,4,0xb2d25d77
215340.62,2.0,139,3,3,1,7,0xb2d2a737
3901.86,1.0,7,2,2,3,7,0xb2d44b73
698.22,1.0,77,1,2,1,4,0xb2d23972
510639.65,5.0,102,4,4,1,9,0xb2d4c814
551989.6,4.0,2,4,4,4,12,0xb2d140eb
5039.85,1.0,14,2,2,3,7,0xb2d4114b
34282.35,1.0,6,2,2,3,7,0xb2d64465
657131.95,1.0,0,4,2,4,10,0xb2d4888cd
305156.24,2.0,37,4,3,2,9,0xb2d6c498
51560.0,2.0,67,2,3,1,6,0xb2d55f6e
350000.0,1.0,0,4,2,4,10,0xb2d1c171
500000.0,3.0,6,4,4,3,11,0xb2da0fbd
15013.97,2.0,15,2,3,3,8,0xb2d65703
13001.14,2.0,102,2,3,1,6,0xb2d96340
3901244.6,4.0,27,4,4,2,10,0xb2d39121
310037.39,2.0,17,4,3,2,9,0xb2d13d10
111.23,1.0,133,1,2,1,4,0xb2d6ec45
601417.13,11.0,1,4,4,4,12,0xb2d443e1d
250000.04,2.0,23,3,3,2,8,0xb2d985b1
890982.78,8.0,0,4,4,4,12,0xb2d23d1a
1287.32,1.0,86,1,2,1,4,0xb2d150f1
18420.91,1.0,71,2,2,1,5,0xb2d0f434
2.53,1.0,18,1,2,2,5,0xb2d94e72
248004.54,6.0,18,3,4,2,9,0xb2d402c2
817491.91,7.0,20,4,4,2,10,0xb2d1bd88
4.83,1.0,0,1,2,4,7,0xb2d48c77
21091.34,1.0,11,2,2,3,7,0xb2d1d1d5d
541728.38,6.0,1,4,4,4,12,0xb2d451fa
29000.0,2.0,5,2,3,3,8,0xb2d2b12b
390013.65,3.0,10,4,4,3,11,0xb2d620f2
10741.94,1.0,0,2,2,4,8,0xb2d2fd66
125.76,1.0,8,1,2,3,6,0xb2d2724f
1756569.19,3.0,1,4,4,4,12,0xb2d17a22
128073.14,4.0,11,3,4,3,10,0xb2d5b5f9d
9076.58,1.0,0,2,2,4,8,0xb2d8d5a9
1003576.67,2.0,5,4,3,3,10,0xb2d92799
36007.35,3.0,80,2,4,1,7,0xb2d5eda0
252777.77,2.0,18,3,3,2,8,0xb2d58bdb
867040.93,4.0,22,4,4,2,10,0xb2d57e96d
80030.46,2.0,144,3,3,1,7,0xb2d2453a
418673.01,6.0,0,4,4,4,12,0xb2d55279
500033.33,3.0,31,4,4,2,10,0xb2d56ad7
52385.45,2.0,153,3,3,1,7,0xb2d45ae2
10086.26,1.0,92,2,2,1,5,0xb2d2efd9
1912.3,1.0,3,1,2,4,7,0xb2d615b9
104224.31,2.0,34,3,3,2,8,0xb2d5847a
15699.21,1.0,10,2,2,3,7,0xb2d8fa2b
164804.56,2.0,74,3,3,1,7,0xb2d584d4
1561891.98,2.0,0,4,3,4,11,0xb2d158d4
1230.4,2.0,184,1,3,1,5,0x3b9acc6c
271120.46,6.0,19,3,4,2,9,0xb2d821a4d
4233.57,1.0,3,2,2,4,8,0xb2d8d7d9
62.25,1.0,25,1,2,2,5,0xb2d5cc0c
44.98,1.0,3,1,2,4,7,0xb2d30f11
30718.16,2.0,0,2,3,4,9,0xb2d613c5
270004.47,4.0,14,3,4,3,10,0xb2d90ba9
954.87,2.0,92,1,3,1,5,0x3b9b17de
1372.11,1.0,184,1,2,1,4,0xb2d40cb8
833.99,1.0,20,1,2,2,5,0xb2d5c32d
2127.32,2.0,184,1,3,1,5,0xb2d081a8
8001.56,1.0,10,2,2,3,7,0xb2d6298d
58000.0,2.0,1,3,3,4,10,0xb2d19266
50000.53,3.0,6,2,4,3,9,0xb2d903a0d
50541.62,1.0,52,2,2,2,6,0xb2d680fa
300012.95,4.0,98,3,4,1,8,0xb2d0830d
354049.7,6.0,10,4,4,3,11,0xb2d0c71cd
1201083.18,20.0,1,4,4,4,12,0xb2d366c2
174862.35,3.0,87,3,4,1,8,0xb2d24e65
4772.79,1.0,123,2,2,1,5,0xb2d1b920
1006.11,1.0,157,1,2,1,4,0xb2d6d1a1
142742.63,2.0,0,3,3,4,10,0xb2d117ef
1325.27,1.0,10,1,2,3,6,0xb2d41d52
234.53,1.0,48,1,2,2,5,0xb2d310ba
0.0,1.0,0,1,2,4,7,0xb2d95d64
5597.13,1.0,0,2,2,4,8,0xb2d356d1
152063.07,2.0,6,3,3,3,9,0xb2d61b1c
8871.44,1.0,0,2,2,4,8,0xb2d6da60
737096.74,8.0,11,4,4,3,11,0x3b9b3a64
350000.42,3.0,1,4,4,4,12,0xb2d9e24b
17.67,1.0,10,1,2,3,6,0xb2d70031
1800.33,1.0,34,1,2,2,5,0xb2d432fd
1742082.54,12.0,0,4,4,4,12,0xb2d650ec
5893.82,1.0,184,2,2,1,5,0xb2d08d9d
1100062.28,2.0,231,4,3,1,8,0xb2d17a8c
330622.55,3.0,0,4,4,4,12,0xb2d2eacb
562.64,1.0,4,1,2,4,7,0xb2d6c4da
16230.49,1.0,1,2,2,4,8,0xb2d68eb2
672053.72,1.0,194,4,2,1,7,0xb2d61158d
11548.04,1.0,6,2,2,3,7,0xb2d18f0dd
1018813.0,12.0,45,4,4,2,10,0xb2d50f1c
151865.74,2.0,24,3,3,2,8,0xb2d6d3c7d
6.67,1.0,78,1,2,1,4,0xb2d8e752
3561.26,1.0,5,2,2,3,7,0xb2d2dccb
1772.09,1.0,133,1,2,1,4,0xb2d1b3bcd
228002.97,4.0,39,3,4,2,9,0xb2d97a8b
81030.71,2.0,113,3,3,1,7,0xb2d4ea98
40841.99,1.0,10,2,2,3,7,0xb2d316b9
78.19,1.0,4,1,2,4,7,0xb2d6b485
91002.45,6.0,11,3,4,3,10,0xb2d52c3e
560005.26,3.0,10,4,4,3,11,0xb2d511db
56805.07,3.0,16,3,4,2,9,0xb2d93aee
484.73,1.0,23,1,2,2,5,0xb2d30817d
146174.28,11.0,0,3,4,4,11,0x3b9b12c2
3422.59,1.0,221,2,2,1,5,0xb2d1759b
803509.32,6.0,21,4,4,2,10,0xb2d06d06
307051.4,1.0,92,4,2,1,7,0xb2d3ac33
0.0,2.0,26,1,3,2,6,0xb2d5a009
34335.38,1.0,16,2,2,2,6,0xb2d1ce39d
402134.87,3.0,23,4,4,2,10,0xb2d988ba
780000.5,5.0,0,4,4,4,12,0xb2d54987
4262.88,1.0,1,2,2,4,8,0xb2da3bcb
260535.43,3.0,3,3,4,4,11,0xb2d6bfcd
2103.36,1.0,76,1,2,1,4,0xb2d68dd8
19.0,1.0,74,1,2,1,4,0xb2d610ce
33001.87,3.0,77,2,4,1,7,0xb2d1b4e6
3427227.97,24.0,0,4,4,4,12,0xb2d15552
79036.72,1.0,1,3,2,4,9,0xb2d9ecbb
2603.14,1.0,0,1,2,4,7,0xb2d92d7b
866.37,1.0,4,1,2,4,7,0xb2d6ca13
1006.54,1.0,2,1,2,4,7,0xb2d2077f
33.98,1.0,10,1,2,3,6,0xb2d293d7
0.0,1.0,5,1,2,3,6,0xb2d8f82f
504214.28,2.0,55,4,3,2,9,0xb2d6cf20
20060.36,2.0,187,2,3,1,6,0xb2d69fac
9660.43,1.0,45,2,2,2,6,0xb2d1db4a
1149.97,1.0,9,1,2,3,6,0xb2d32306
1092.31,1.0,0,1,2,4,7,0xb2d291d7
26026.2,2.0,4,2,3,4,9,0xb2d080cc
361278.84,2.0,47,4,3,2,9,0xb2d9e29b
1.67,1.0,46,1,2,2,5,0xb2d58073
13172.95,1.0,17,2,2,2,6,0xb2d35004
156138.4,1.0,0,3,2,4,9,0xb2d57521
20297.72,1.0,9,2,2,3,7,0xb2d40fc0
1113.97,1.0,92,1,2,1,4,0xb2d30f31
71787.08,3.0,11,3,4,3,10,0xb2d5cb49
259826.8,3.0,109,3,4,1,8,0xb2d6182a
330417.07,5.0,21,4,4,2,10,0xb2d0e7ec
50634.33,2.0,0,2,3,4,9,0xb2d521eb
34.62,1.0,9,1,2,3,6,0xb2d332fe
170591.11,3.0,0,3,4,4,11,0xb2d1b009
372879.31,5.0,0,4,4,4,12,0xb2d17861d
315524.45,9.0,0,4,4,4,12,0xb2d0a945
6144.82,5.0,184,2,4,1,7,0x3b9b12bf
60930.21,5.0,1,3,4,4,11,0xb2d2da4bd
6.65,1.0,88,1,2,1,4,0xb2d83545
350001.28,3.0,85,4,4,1,9,0xb2d17e15
1139.42,1.0,184,1,2,1,4,0xb2d29a51
3251.59,1.0,145,2,2,1,5,0xb2d4889c
9.15,1.0,25,1,2,2,5,0xb2d3fa97
80006.81,3.0,123,3,4,1,8,0xb2d86f51
3180.85,1.0,24,2,2,2,6,0xb2d6c864
672.45,1.0,0,1,2,4,7,0xb2d40017
72.23,1.0,40,1,2,2,5,0xb2d68ab0
1378.58,1.0,92,1,2,1,4,0xb2d35480
13.37,1.0,20,1,2,2,5,0xb2d6d597
204978.04,2.0,15,3,3,3,9,0xb2d4e841
6603.11,1.0,32,2,2,2,6,0xb2d38d09d
57488.85,2.0,231,3,3,1,7,0xb2d2a687d
5578.53,1.0,92,2,2,1,5,0xb2d1e9ef
120100.0,7.0,0,3,4,4,11,0xb2d3a12fd
10232.33,1.0,0,2,2,4,8,0xb2d4a38a
6.38,1.0,84,1,2,1,4,0xb2d594d3
258178.45,4.0,10,3,4,3,10,0xb2d51038
559.59,1.0,9,1,2,3,6,0xb2d4a5d5
588.79,1.0,6,1,2,3,6,0xb2d22685
2047873.12,2.0,3,4,3,4,11,0xb2d682f2
559000.0,3.0,1,4,4,4,12,0xb2d28751
345009.61,3.0,39,4,4,2,10,0xb2d9bd06
5758.47,1.0,0,2,2,4,8,0xb2d212f7
15560.67,2.0,5,2,3,3,8,0xb2d0af45d
34887.16,1.0,2,2,2,4,8,0xb2d1e18d
122001.53,4.0,10,3,4,3,10,0xb2d3f378
318008.98,3.0,0,4,4,4,12,0xb2d9cc4f
156.34,1.0,41,1,2,2,5,0xb2d2af39
9580.13,1.0,6,2,2,3,7,0xb2d35644
310462.6,3.0,0,4,4,4,12,0xb2d61538
946100.27,14.0,16,4,4,2,10,0xb2d21adb
843009.47,5.0,4,4,4,4,12,0xb2d25a28d
600057.38,3.0,8,4,4,3,11,0xb2d993e9
1191127.69,10.0,0,4,4,4,12,0xb2d222e4
17098.8,1.0,18,2,2,2,6,0xb2d5d4b9
1552.58,1.0,0,1,2,4,7,0xb2d2b7b9
265000.0,13.0,4,3,4,4,11,0xb2d13d27
221310.51,3.0,132,3,4,1,8,0xb2d43eefd
150006.33,2.0,62,3,3,2,8,0xb2d8f4c4d
70829.9,2.0,41,3,3,2,8,0xb2d25d5f
20000.63,2.0,80,2,3,1,6,0xb2d98976
390090.51,5.0,3,4,4,4,12,0xb2d1fee8
302131.72,2.0,15,4,3,3,10,0xb2d8e084
881.17,1.0,23,1,2,2,5,0xb2d2690e
8531.36,1.0,7,2,2,3,7,0xb2d9129e
5044.3,1.0,1,2,2,4,8,0xb2d407b4d
316002.28,3.0,19,4,4,2,10,0xb2d3a2a3
57749.79,1.0,7,3,2,3,8,0xb2d4e490
1220025.8,3.0,18,4,4,2,10,0xb2d79103
484741.11,4.0,76,4,4,1,9,0xb2d3ee7b
1021673.51,7.0,1,4,4,4,12,0xb2d109ae
81590.95,2.0,3,3,3,4,10,0xb2d16e37
34184.79,2.0,184,2,3,1,6,0xb2d1f0a1
410.52,1.0,5,1,2,3,6,0xb2d24aae
2217442.09,8.0,10,4,4,3,11,0xb2d0c450d
106630.83,3.0,18,3,4,2,9,0xb2d31d21d
19553.71,1.0,13,2,2,3,7,0xb2d8da5b
1200048.85,2.0,206,4,3,1,8,0xb2d5beb5d
13090.26,1.0,2,2,2,4,8,0xb2d90041
256501.88,2.0,37,3,3,2,8,0xb2d11fc0
120045.01,3.0,214,3,4,1,8,0xb2d25a2c
10096.8,1.0,184,2,2,1,5,0xb2d2ef3d
60002.44,2.0,224,3,3,1,7,0xb2d657c1
400002.19,3.0,10,4,4,3,11,0xb2d54b02
260015.83,3.0,69,3,4,1,8,0xb2d5d3e4
1583421.62,3.0,0,4,4,4,12,0xb2d2b694
100002.84,2.0,24,3,3,2,8,0xb2d28d3fd
12704.74,1.0,0,2,2,4,8,0xb2d0d550
1067.45,1.0,92,1,2,1,4,0xb2d0a720
10004.31,2.0,67,2,3,1,6,0xb2d9811e
80015.07,2.0,118,3,3,1,7,0xb2d1f294d
7314276.91,2.0,1,4,3,4,11,0xb2d62c14
85294.16,3.0,7,3,4,3,10,0xb2d59811
205689.42,2.0,34,3,3,2,8,0xb2d651d7
3851.05,1.0,20,2,2,2,6,0xb2d9b943
41.31,1.0,4,1,2,4,7,0xb2d1cb7b
1.09,2.0,22,1,3,2,6,0xb2d0ada3
111331.89,5.0,1,3,4,4,11,0xb2d42d57
1376047.6,9.0,1,4,4,4,12,0xb2d5c4b7d
501812.41,2.0,53,4,3,2,9,0xb2d6bb75
3852.73,1.0,10,2,2,3,7,0xb2d27a53
124007.68,1.0,18,3,2,2,7,0xb2d6a8e3
200002.11,2.0,175,3,3,1,7,0xb2d8d010
330244.61,2.0,15,4,3,3,10,0xb2d653c8
168710.93,3.0,157,3,4,1,8,0xb2d60cd1
39339.37,1.0,26,2,2,2,6,0xb2d37c30
110029.59,3.0,164,3,4,1,8,0xb2d5cec6
9236.34,1.0,10,2,2,3,7,0xb2d3a152
52925.33,2.0,216,3,3,1,7,0xb2d5ab30
270000.0,2.0,5,3,3,3,9,0xb2d975c9
0.55,1.0,20,1,2,2,5,0xb2d1a3fb
257798.17,5.0,110,3,4,1,8,0xb2d06d8dd
70001.8,4.0,119,3,4,1,8,0xb2d6d496
686083.29,9.0,4,4,4,4,12,0xb2d1261ed
360045.36,8.0,0,4,4,4,12,0xb2d62ec8
10310.91,2.0,24,2,3,2,7,0xb2d5b865
100007.11,5.0,14,3,4,3,10,0xb2d41c3b
56652.93,2.0,122,3,3,1,7,0xb2d39661
4743.15,1.0,106,2,2,1,5,0xb2d3bbf8
202006.45,2.0,74,3,3,1,7,0xb2d1095d
2849.05,1.0,18,1,2,2,5,0xb2d26adb
4239.64,1.0,184,2,2,1,5,0xb2d311e5d
2554370.99,5.0,6,4,4,3,11,0xb2d6080f
2.17,1.0,11,1,2,3,6,0xb2d94d0d
780000.0,2.0,4,4,3,4,11,0xb2da55cf
20179.72,2.0,193,2,3,1,6,0xb2d58224
290.98,2.0,12,1,3,3,7,0xb2d607bed
25244.78,1.0,8,2,2,3,7,0xb2d1b85b
17111.28,1.0,2,2,2,4,8,0xb2d429b8
615942.22,2.0,9,4,3,3,10,0xb2d38304d
50353.96,2.0,0,2,3,4,9,0xb2d1c395
30000.63,3.0,94,2,4,1,7,0xb2d87d2cd
13334.36,1.0,92,2,2,1,5,0x3b9adb55
400375.59,3.0,0,4,4,4,12,0xb2d3a802
1699.11,1.0,93,1,2,1,4,0xb2d8cead
12148.44,1.0,21,2,2,2,6,0xb2d61b39
693.07,1.0,18,1,2,2,5,0xb2d2e606
500000.0,3.0,26,4,4,2,10,0xb2d948f3
60686.49,5.0,0,3,4,4,11,0x3b9b48f2
2118.65,1.0,0,1,2,4,7,0xb2d6a4a2
1235.81,1.0,10,1,2,3,6,0xb2d65244
670111.67,12.0,5,4,4,3,11,0x3b9b1803d
48723.92,1.0,6,2,2,3,7,0xb2da14ce
50108.49,2.0,140,2,3,1,6,0xb2d9072d
1015.67,1.0,184,1,2,1,4,0xb2d5ec55
39901.6,1.0,0,2,2,4,8,0xb2d55fcbd
1.12,1.0,5,1,2,3,6,0xb2d30b15
475628.48,3.0,3,4,4,4,12,0xb2d3e021
68.33,1.0,4,1,2,4,7,0xb2d4ccb7
553564.91,7.0,24,4,4,2,10,0x3b9b181d
300236.82,6.0,53,4,4,2,10,0xb2d4cacb
16.18,1.0,19,1,2,2,5,0xb2d263c3
22966.0,1.0,0,2,2,4,8,0xb2d96acd
10306.52,1.0,97,2,2,1,5,0xb2d5d81b
67126.54,1.0,21,3,2,2,7,0xb2d34ff6
38.0,1.0,0,1,2,4,7,0xb2d94042
100000.0,1.0,1,3,2,4,9,0xb2da687e
365319.43,2.0,4,4,3,4,11,0xb2d210f6d
4171.88,1.0,12,2,2,3,7,0xb2d354e6
7699.29,1.0,92,2,2,1,5,0xb2d3fa21
66.23,1.0,41,1,2,2,5,0xb2d0baf8
50151.23,1.0,279,2,2,1,5,0xb2d2a8a1
1494.52,1.0,28,1,2,2,5,0xb2d0b145
10000.32,2.0,6,2,3,3,8,0xb2d957c1
751563.01,7.0,10,4,4,3,11,0xb2d5de78d
50439.12,2.0,234,2,3,1,6,0xb2d61307d
300057.54,2.0,214,3,3,1,7,0xb2d18c46
200010.56,1.0,14,3,2,3,8,0xb2d9327ed
14078.34,1.0,1,2,2,4,8,0xb2d48c02
70120.6,5.0,27,3,4,2,9,0xb2d8f525
3351.56,1.0,0,2,2,4,8,0xb2d57ee2
0.2,2.0,1,1,3,4,8,0xb2d15dd8
7089.94,1.0,0,2,2,4,8,0xb2d2df34d
30011.51,2.0,122,2,3,1,6,0xb2d535c3
264.77,1.0,0,1,2,4,7,0xb2d3aade
207124.74,2.0,197,3,3,1,7,0xb2d5edf5
630.37,1.0,12,1,2,3,6,0xb2d9136e
150077.53,3.0,203,3,4,1,8,0xb2d3ea33
1699219.46,13.0,3,4,4,4,12,0xb2d07b5d
70.91,1.0,9,1,2,3,6,0xb2d432a9
380380.47,5.0,4,4,4,4,12,0xb2d548c8
12.49,1.0,47,1,2,2,5,0xb2d57a13
44428.13,1.0,7,2,2,3,7,0xb2d3b3bb
385545.39,3.0,4,4,4,4,12,0xb2d31627
40479.56,1.0,76,2,2,1,5,0xb2d5f8c8
2462.65,1.0,89,1,2,1,4,0xb2d60468
120020.32,2.0,59,3,3,2,8,0xb2d6b777
630004.43,4.0,16,4,4,2,10,0xb2d5b1f6
100023.81,2.0,2,3,3,4,10,0xb2d99f9b
7244.59,1.0,0,2,2,4,8,0xb2d2ab2d
950040.52,6.0,0,4,4,4,12,0xb2d0e708d
140184.06,8.0,0,3,4,4,11,0xb2d0d47f
150000.0,1.0,4,3,2,4,9,0xb2d96e16
207116.93,2.0,92,3,3,1,7,0xb2d5ec2c
154864.6,2.0,116,3,3,1,7,0xb2d41381
200005.14,2.0,0,3,3,4,10,0xb2d6ad6c
130005.86,5.0,4,3,4,4,11,0xb2d31921d
386757.11,3.0,1,4,4,4,12,0xb2d4eb0e
508188.18,13.0,16,4,4,2,10,0xb2d4d104
439000.0,3.0,8,4,4,3,11,0xb2d70837
1164155.89,6.0,4,4,4,4,12,0x3b9b2450
0.0,1.0,10,1,2,3,6,0xb2d297c1
20.35,1.0,39,1,2,2,5,0xb2d1634d
6860.62,1.0,184,2,2,1,5,0xb2d1717ed
100065.35,2.0,181,3,3,1,7,0xb2d45edd
1191.26,1.0,92,1,2,1,4,0xb2d25be4
6363.87,1.0,2,2,2,4,8,0xb2d22603
203067.51,3.0,18,3,4,2,9,0xb2d41436
31.67,1.0,31,1,2,2,5,0xb2d92c73
2400157.19,2.0,31,4,3,2,9,0xb2d634c0
810017.12,2.0,151,4,3,1,8,0xb2d8fcdb
3024.13,1.0,9,2,2,3,7,0xb2d4d3bb
30758.63,3.0,92,2,4,1,7,0xb2d0907e
100108.16,2.0,122,3,3,1,7,0xb2d17eeb
593.9,1.0,30,1,2,2,5,0xb2d94f2e
200007.71,2.0,21,3,3,2,8,0xb2d9ce60
750130.31,2.0,24,4,3,2,9,0xb2d56fadd
13137.2,1.0,92,2,2,1,5,0xb2d0f4f1
82184.59,2.0,245,3,3,1,7,0xb2d49605
100405.28,2.0,10,3,3,3,9,0xb2d9d448
736422.52,7.0,0,4,4,4,12,0xb2d17ce1
101272.1,2.0,50,3,3,2,8,0xb2d4131d
213596.29,3.0,15,3,4,3,10,0xb2d69c6e
4662.98,1.0,12,2,2,3,7,0xb2d2ae55
953.39,1.0,13,1,2,3,6,0xb2d81ee1
50000.53,2.0,47,2,3,2,7,0xb2d91779
15063.28,1.0,1,2,2,4,8,0xb2d6b997
555.83,16.0,0,1,4,4,9,0xb2d1f8d8
805684.15,2.0,37,4,3,2,9,0xb2d20603
2206.55,1.0,11,1,2,3,6,0xb2d8f39e
31543.69,8.0,0,2,4,4,10,0xb2d0f34c
6269.73,1.0,4,2,2,4,8,0xb2d17e67
29.76,1.0,36,1,2,2,5,0xb2d22bbb
308.75,2.0,0,1,3,4,8,0x3b9b4650
5902.01,1.0,20,2,2,2,6,0xb2d99f50
200001.27,2.0,10,3,3,3,9,0xb2d205c7
2008.04,1.0,92,1,2,1,4,0xb2d303fb
265007.86,6.0,4,3,4,4,11,0xb2d63b3b
200031.45,2.0,0,3,3,4,10,0xb2d97bd5
129088.66,1.0,5,3,2,3,8,0xb2d2564c
6.2,1.0,41,1,2,2,5,0xb2d63583
53.74,1.0,8,1,2,3,6,0xb2d53110
450890.35,2.0,164,4,3,1,8,0xb2d2fd3f
4146.92,1.0,187,2,2,1,5,0xb2d293ecd
26544.44,1.0,0,2,2,4,8,0xb2d8e7dad
10710.13,1.0,1,2,2,4,8,0xb2d5edeed
200002.11,2.0,80,3,3,1,7,0xb2d98c2d
13734.54,1.0,11,2,2,3,7,0xb2d6389d
100003.41,2.0,87,3,3,1,7,0xb2d65377
2298000.0,37.0,1,4,4,4,12,0xb2d2a5f7
69.61,1.0,14,1,2,3,6,0xb2d1f854
960011.45,3.0,0,4,4,4,12,0xb2d0de20
100393.4,2.0,35,3,3,2,8,0xb2d5293c
80120.56,1.0,0,3,2,4,9,0xb2d8c731
317.42,1.0,29,1,2,2,5,0xb2d29f4b
1875.52,1.0,6,1,2,3,6,0xb2d9890b
344022.7,7.0,15,4,4,3,11,0xb2d11b23
1639600.05,23.0,0,4,4,4,12,0xb2d299c4
630020.0,1.0,0,4,2,4,10,0xb2d93b2f
2000021.11,1.0,11,4,2,3,9,0xb2da46d3
107127.92,3.0,95,3,4,1,8,0xb2d2560c
20401771.57,2.0,52,4,3,2,9,0xb2d6d4cb
20000.0,3.0,1,2,4,4,10,0xb2d386e7
302988.12,3.0,18,4,4,2,10,0xb2d0febb
0.0,1.0,3,1,2,4,7,0xb2d93124d
360404.44,5.0,0,4,4,4,12,0xb2d288e3
4709.14,1.0,184,2,2,1,5,0xb2d35f2bd
56.26,2.0,2,1,3,4,8,0xb2d5125d
815.56,1.0,2,1,2,4,7,0xb2d5a0d5
7.74,1.0,32,1,2,2,5,0xb2d279b4
4453.38,1.0,266,2,2,1,5,0xb2d14b56
57.04,1.0,19,1,2,2,5,0xb2d32e11
314397.37,23.0,8,4,4,3,11,0xb2d24d57
3.76,1.0,11,1,2,3,6,0xb2d34813
65.37,1.0,14,1,2,3,6,0xb2d977eb
200000.0,2.0,21,3,3,2,8,0xb2da2783
1203.76,1.0,92,1,2,1,4,0xb2d58e11
150040.0,2.0,8,3,3,3,9,0xb2da315c
70003.69,2.0,27,3,3,2,8,0xb2da07cc
922732.7,3.0,13,4,4,3,11,0xb2d0fa2dd
8547.36,1.0,6,2,2,3,7,0xb2d6fa0c
809.76,1.0,7,1,2,3,6,0xb2d355be
4291.14,1.0,13,2,2,3,7,0xb2d9a4cc
211.55,1.0,112,1,2,1,4,0xb2d23231d
2079.62,1.0,3,1,2,4,7,0xb2d35d14
1943.34,1.0,184,1,2,1,4,0xb2d2e4a0
11506.99,1.0,184,2,2,1,5,0xb2d142f8
1686353.31,6.0,25,4,4,2,10,0xb2d4fee8
853634.07,6.0,0,4,4,4,12,0xb2d13966
403290.08,3.0,0,4,4,4,12,0xb2d50acfd
20218.21,2.0,3,2,3,4,9,0xb2d574cbd
93.39,1.0,13,1,2,3,6,0xb2d5d3eb
205768.36,2.0,26,3,3,2,8,0xb2d5ff84d
930280.28,19.0,14,4,4,3,11,0xb2d0cf72
6497.66,1.0,245,2,2,1,5,0xb2d5dbf4
220942.18,2.0,10,3,3,3,9,0xb2d553af
300199.06,2.0,11,4,3,3,10,0xb2d802b5
105.27,1.0,74,1,2,1,4,0xb2d361ff
30064.89,2.0,216,2,3,1,6,0xb2d5685f
52398.78,1.0,0,3,2,4,9,0xb2d391f8
260054.05,4.0,0,3,4,4,11,0xb2d2b39d
1245.69,1.0,16,1,2,2,5,0xb2d22dd3d
50341.28,2.0,9,2,3,3,8,0xb2d38bc9
256.14,1.0,39,1,2,2,5,0xb2d4a564
20000.21,2.0,38,2,3,2,7,0xb2d92cbf
630811.7,4.0,6,4,4,3,11,0xb2d40cb0
1887215.01,11.0,22,4,4,2,10,0xb2d5139e
50000.16,2.0,112,2,3,1,6,0xb2d5c81c
20101.46,2.0,12,2,3,3,8,0xb2d64e29d
995.63,1.0,0,1,2,4,7,0xb2d31162d
2193547.15,11.0,0,4,4,4,12,0xb2d56da0d
102589.24,2.0,67,3,3,1,7,0xb2d17ece
51712.15,1.0,60,2,2,2,6,0xb2d5dbf6
71481.07,2.0,3,3,3,4,10,0xb2d155c9
182246.26,3.0,4,3,4,4,11,0xb2d17935
55041.27,1.0,4,3,2,4,9,0xb2d5d678
60008.63,2.0,69,3,3,1,7,0xb2d2dd70d
832278.52,2.0,26,4,3,2,9,0xb2d0d589d
285056.13,4.0,92,3,4,1,8,0xb2d694d8
201122.47,2.0,6,3,3,3,9,0xb2d6a409
689.39,1.0,8,1,2,3,6,0xb2d21d54
260018.75,2.0,98,3,3,1,7,0xb2d630bb
1000158.97,3.0,23,4,4,2,10,0x3b9b45cc
350015.82,2.0,27,4,3,2,9,0xb2d2047b
2759.68,1.0,92,1,2,1,4,0xb2d20d2c
20157.82,1.0,92,2,2,1,5,0xb2d2efe1
699000.0,4.0,1,4,4,4,12,0xb2d2927a
228609.31,2.0,126,3,3,1,7,0xb2d651d3
154532.7,2.0,235,3,3,1,7,0xb2d206a6
59144.95,1.0,92,3,2,1,6,0xb2d0e1d9d
737000.0,6.0,3,4,4,4,12,0xb2d8f1c0
13810.55,1.0,14,2,2,3,7,0xb2d942d3
789.74,1.0,10,1,2,3,6,0xb2d3efc6
97001.23,3.0,24,3,4,2,9,0xb2d945c2
25348.94,3.0,0,2,4,4,10,0xb2d1fd20
3.95,1.0,81,1,2,1,4,0xb2d5904f
14761.78,1.0,63,2,2,2,6,0xb2d5389a
52218.62,1.0,0,3,2,4,9,0xb2d58f9c
18.43,1.0,77,1,2,1,4,0xb2d94373
202923.13,2.0,145,3,3,1,7,0xb2d2b347
983.58,1.0,0,1,2,4,7,0xb2d0fe56
701889.17,3.0,15,4,4,3,11,0xb2d55984
1097.33,1.0,92,1,2,1,4,0xb2d293d0
110720.06,3.0,6,3,4,3,10,0xb2d5ff19
239113.33,2.0,5,3,3,3,9,0xb2d58b64
7345.25,1.0,11,2,2,3,7,0xb2d37172d
1.7,1.0,55,1,2,2,5,0xb2d6d818
61.1,1.0,124,1,2,1,4,0xb2d11868
200153.99,3.0,18,3,4,2,9,0xb2d3cd36
2743.3,1.0,136,1,2,1,4,0xb2d8dc5e
9939.2,1.0,1,2,2,4,8,0xb2d21333
501776.04,2.0,32,4,3,2,9,0xb2d9c188
1285745.87,12.0,0,4,4,4,12,0x3b9b0fc1
52.62,1.0,11,1,2,3,6,0xb2d23742d
51447.14,4.0,101,2,4,1,7,0xb2d5527e
3.01,1.0,25,1,2,2,5,0xb2d6081e
55000.58,2.0,139,3,3,1,7,0xb2d6ef23
2.13,1.0,12,1,2,3,6,0xb2d598d9
232889.16,5.0,67,3,4,1,8,0xb2d14d25
0.74,1.0,2,1,2,4,7,0xb2d0d517
100061.93,2.0,147,3,3,1,7,0xb2d2acc1
6362084.25,15.0,0,4,4,4,12,0xb2d114a9d
519082.16,3.0,196,4,4,1,9,0xb2d19565
1585.28,1.0,167,1,2,1,4,0xb2d2c0a4
60070.0,3.0,45,3,4,2,9,0xb2d8e094
200278.21,5.0,55,3,4,2,9,0xb2d66b3f
65.61,1.0,44,1,2,2,5,0xb2d2fb35
321782.98,1.0,0,4,2,4,10,0xb2d210e8
142411.15,2.0,164,3,3,1,7,0xb2d44c02
511254.46,3.0,4,4,4,4,12,0xb2d64add
281415.13,8.0,5,3,4,3,10,0xb2d5d9c3
100880.75,2.0,6,3,3,3,9,0xb2d42caf
14.26,1.0,157,1,2,1,4,0xb2d6ce16
74001.67,2.0,25,3,3,2,8,0xb2d93adbd
72317.01,2.0,8,3,3,3,9,0xb2d10812
103498.82,2.0,1,3,3,4,10,0xb2d0ed8e
7290.08,1.0,92,2,2,1,5,0xb2d10ea9
1017.05,2.0,25,1,3,2,6,0xb2d0a49ad
51353.4,2.0,42,2,3,2,7,0xb2d60af0
300175.22,3.0,108,4,4,1,9,0xb2d50d81
210867.84,2.0,22,3,3,2,8,0xb2d95bffd
6342.96,1.0,21,2,2,2,6,0xb2d965ab
2015.83,1.0,150,1,2,1,4,0xb2d56a81
315.32,1.0,0,1,2,4,7,0xb2d784b2
3330.69,1.0,184,2,2,1,5,0xb2d2e83cd
5059.84,1.0,15,2,2,3,7,0xb2d96a73
9963.09,1.0,0,2,2,4,8,0xb2d6c1aa
230126.25,3.0,27,3,4,2,9,0xb2d1a8ca
1000000.1,2.0,7,4,3,3,10,0xb2d92e97
9755.92,1.0,15,2,2,3,7,0xb2d3c28b
120002.53,2.0,74,3,3,1,7,0xb2d9994b
201299.99,2.0,6,3,3,3,9,0xb2d252a4
245.08,1.0,7,1,2,3,6,0xb2d94c25
20773.76,2.0,122,2,3,1,6,0xb2d55cf5d
2004000.0,22.0,0,4,4,4,12,0xb2d1f8dc
485.95,1.0,3,1,2,4,7,0xb2d96715
5487.44,1.0,223,2,2,1,5,0xb2d6b9d5
201556.56,2.0,48,3,3,2,8,0xb2d646b1
327850.41,7.0,5,4,4,3,11,0xb2d37504
1949.23,1.0,21,1,2,2,5,0xb2d6a5a7
102004.13,2.0,74,3,3,1,7,0xb2d28972
110.17,1.0,22,1,2,2,5,0xb2d3985c
10020.91,1.0,207,2,2,1,5,0xb2d65304
1790.64,2.0,184,1,3,1,5,0x3b9b45a2
816.39,1.0,6,1,2,3,6,0xb2d9f06d
1380.19,1.0,92,1,2,1,4,0xb2d3e6d2
1662.35,1.0,10,1,2,3,6,0xb2d62475
20580.13,1.0,28,2,2,2,6,0xb2d9544d
4204.69,1.0,7,2,2,3,7,0xb2d8f754
235205.65,4.0,18,3,4,2,9,0xb2d1b9ba
520000.04,2.0,13,4,3,3,10,0xb2d6f461
505921.88,9.0,11,4,4,3,11,0xb2d2389e
135052.28,2.0,172,3,3,1,7,0xb2d5bcbe
20166.97,1.0,92,2,2,1,5,0xb2d204e7
93701.28,1.0,2,3,2,4,9,0xb2d8fb33
0.0,1.0,0,1,2,4,7,0xb2d92431
13550.0,1.0,0,2,2,4,8,0xb2d6bace
51557.25,2.0,3,2,3,4,9,0xb2d53028
508115.84,2.0,35,4,3,2,9,0xb2d31f72
597033.71,6.0,7,4,4,3,11,0xb2d81f3b
110.83,1.0,6,1,2,3,6,0xb2d39b6d
1561016.48,2.0,80,4,3,1,8,0xb2d8d799
192216.22,6.0,0,3,4,4,11,0xb2d29ca7
50002.06,2.0,39,2,3,2,7,0xb2d6314e
831000.78,6.0,0,4,4,4,12,0xb2d4bdaf
30000.95,2.0,92,2,3,1,6,0xb2d67cc1
1.12,2.0,81,1,3,1,5,0x3b9b2931
2530007.17,2.0,8,4,3,3,10,0xb2d70021
7732.54,1.0,92,2,2,1,5,0xb2d2fab6
9977.53,2.0,258,2,3,1,6,0xb2d6059f
500000.0,2.0,3,4,3,4,11,0xb2d975f4
5152.61,1.0,0,2,2,4,8,0xb2d6b8f4
6481779.15,14.0,0,4,4,4,12,0xb2d31b19
855645.85,4.0,9,4,4,3,11,0xb2d1214e
80815.92,1.0,49,3,2,2,7,0xb2d39216
0.0,1.0,76,1,2,1,4,0xb2d78b42
1879.31,1.0,92,1,2,1,4,0xb2d0679d
100003.17,2.0,24,3,3,2,8,0xb2d944cd
700352.36,2.0,48,4,3,2,9,0xb2d2e806
624021.09,1.0,15,4,2,3,9,0xb2d2419c
1000391.02,5.0,5,4,4,3,11,0xb2d59813
108860.7,2.0,20,3,3,2,8,0xb2d28763
230000.0,2.0,7,3,3,3,9,0xb2d96f2b
147522.01,2.0,0,3,3,4,10,0xb2d06553
928.89,1.0,8,1,2,3,6,0xb2d259c1d
11173.34,2.0,0,2,3,4,9,0xb2d09bd3
365294.72,1.0,5,4,2,3,9,0xb2d2f64ed
1065.35,1.0,28,1,2,2,5,0xb2d3074e
3920.73,1.0,92,2,2,1,5,0xb2d60c2d
870189.27,8.0,6,4,4,3,11,0xb2d1bcb0
53378.45,2.0,14,3,3,3,9,0xb2d42e02
300040.02,2.0,1,3,3,4,10,0xb2d96c78
750000.0,7.0,0,4,4,4,12,0xb2d5348c
13.07,1.0,79,1,2,1,4,0xb2d3bb2f
80386.32,4.0,13,3,4,3,10,0xb2d56f41
531789.39,2.0,2,4,3,4,11,0xb2d9f653
1283.37,1.0,0,1,2,4,7,0xb2d67ddb
25121.98,2.0,66,2,3,2,7,0xb2d6bed9
472738.47,3.0,35,4,4,2,10,0xb2d5795c
670.33,1.0,53,1,2,2,5,0xb2d2c367
183.86,1.0,3,1,2,4,7,0xb2d9643d
371.25,2.0,11,1,3,3,7,0xb2d9eeec
33000.6,3.0,25,2,4,2,8,0xb2d9d76b
359895.45,9.0,0,4,4,4,12,0x3b9af11e
50000.53,2.0,8,2,3,3,8,0xb2da4bad
509378.98,4.0,18,4,4,2,10,0xb2d6543b
201925.79,2.0,50,3,3,2,8,0xb2d18c6b
400016.89,2.0,70,4,3,1,8,0xb2d9a46e
134.16,3.0,12,1,4,3,8,0xb2d23245d
76004.11,2.0,40,3,3,2,8,0xb2d91376
1541.28,3.0,10,1,4,3,8,0xb2d8c88b
1586708.94,14.0,11,4,4,3,11,0xb2d0b964
46000.0,4.0,0,2,4,4,10,0xb2d65981
53461.9,1.0,1,3,2,4,9,0xb2d1c32e
43120.88,1.0,0,2,2,4,8,0xb2d226d1
293521.59,2.0,83,3,3,1,7,0xb2d5251ed
663850.79,3.0,1,4,4,4,12,0xb2d278bed
2500042.28,5.0,157,4,4,1,9,0xb2d44ca6
20712.45,2.0,76,2,3,1,6,0xb2d63a28
1007298.31,7.0,39,4,4,2,10,0x3b9b2a77
7870.48,1.0,0,2,2,4,8,0xb2d4ac67
201421.36,3.0,77,3,4,1,8,0xb2d09c0d
6.08,1.0,46,1,2,2,5,0xb2d6a744
4860.09,1.0,55,2,2,2,6,0xb2d36ff5
100008.45,2.0,112,3,3,1,7,0xb2d8daf2
151.21,1.0,55,1,2,2,5,0xb2d631ce
250893.34,2.0,44,3,3,2,8,0xb2d91331
276647.86,1.0,0,3,2,4,9,0xb2d6ba01
500000.0,2.0,21,4,3,2,9,0xb2da2640
839595.88,3.0,55,4,4,2,10,0xb2d09c59
50003.26,2.0,77,2,3,1,6,0xb2d3d219
315623.05,20.0,0,4,4,4,12,0x3b9b185a
550796.68,3.0,31,4,4,2,10,0xb2d627c1d
7763.11,1.0,0,2,2,4,8,0xb2d3f22b
18.78,1.0,41,1,2,2,5,0xb2d6835a
800950.27,14.0,11,4,4,3,11,0xb2d1bd40d
255002.85,6.0,82,3,4,1,8,0xb2d7fbb7
1413025.59,10.0,1,4,4,4,12,0xb2d5ce13
90007.87,2.0,196,3,3,1,7,0xb2d403d4d
220038.78,3.0,24,3,4,2,9,0xb2d59e47
1454.72,1.0,98,1,2,1,4,0xb2d643e1
11680.05,2.0,20,2,3,2,7,0xb2d61b5a
3470.33,1.0,140,2,2,1,5,0xb2d6f18f
271189.76,4.0,13,3,4,3,10,0xb2d63eca
4006.9,1.0,31,2,2,2,6,0xb2d2fcccd
720045.84,4.0,22,4,4,2,10,0xb2d40272
23002.58,2.0,11,2,3,3,8,0xb2d5bf58
8706.99,1.0,80,2,2,1,5,0xb2d836cad
311645.03,4.0,18,4,4,2,10,0xb2d26554
2466.28,1.0,184,1,2,1,4,0xb2d5420b
1208.53,1.0,228,1,2,1,4,0xb2d6eb3bd
230008.8,4.0,80,3,4,1,8,0xb2d38c7e
270000.0,4.0,4,3,4,4,11,0xb2d07f85
588920.09,367.0,0,4,4,4,12,0xb2d2d73a
636921.24,5.0,0,4,4,4,12,0xb2d53f00d
93001.98,5.0,20,3,4,2,9,0xb2d6a7afd
41156.14,1.0,7,2,2,3,7,0xb2d62266
19709.36,1.0,92,2,2,1,5,0xb2d30d87
201421.15,2.0,77,3,3,1,7,0xb2d998e6
300078.72,2.0,138,3,3,1,7,0xb2d0d372
248085.66,4.0,10,3,4,3,10,0xb2d25e87d
2.7,1.0,10,1,2,3,6,0xb2d9b1f2
120026.27,2.0,192,3,3,1,7,0xb2d69c75d
13902.84,1.0,1,2,2,4,8,0xb2d91158
5143.22,2.0,39,2,3,2,7,0xb2d0db1a
5762.42,1.0,0,2,2,4,8,0xb2d6b8e6
10811.68,1.0,0,2,2,4,8,0xb2d2284e
610613.31,4.0,16,4,4,2,10,0xb2d3ca19d
20001.83,2.0,97,2,3,1,6,0xb2d58dc8
29970.59,3.0,0,2,4,4,10,0xb2d7f3c3
138724.75,1.0,193,3,2,1,6,0xb2d42e2d
201413.97,2.0,19,3,3,2,8,0xb2d4b34f
1181372.36,10.0,7,4,4,3,11,0xb2d5e16a
30796.84,2.0,154,2,3,1,6,0xb2d5ce60
15.61,1.0,86,1,2,1,4,0xb2d5618b
6622.03,1.0,0,2,2,4,8,0xb2d0d6a8
21211.9,1.0,184,2,2,1,5,0xb2d2f764d
5007.66,1.0,8,2,2,3,7,0xb2d2d83a
106013.55,2.0,3,3,3,4,10,0xb2d433e8
3355.31,1.0,98,2,2,1,5,0xb2d1f111
111044.81,1.0,184,3,2,1,6,0xb2d234ea
551847.91,1.0,184,4,2,1,7,0xb2d3f8d6
250024.37,3.0,74,3,4,1,8,0xb2d6d75a
350136.78,5.0,20,4,4,2,10,0xb2d60b69
250000.0,2.0,2,3,3,4,10,0xb2da3184
836470.49,4.0,4,4,4,4,12,0xb2d10fb6
10000.37,2.0,10,2,3,3,8,0xb2d95d32
100.46,6.0,39,1,4,2,7,0xb2d21672d
47.35,1.0,67,1,2,1,4,0xb2d5f2aad
2015092.44,5.0,1,4,4,4,12,0xb2d57a8b
460166.68,3.0,4,4,4,4,12,0xb2d0d107
490225.35,2.0,18,4,3,2,9,0xb2d6b8fe
80399.2,2.0,0,3,3,4,10,0xb2d64fb5
80046.23,4.0,39,3,4,2,9,0xb2d4bd3c
15.04,1.0,8,1,2,3,6,0xb2d6a3a1
50001.89,2.0,42,2,3,2,7,0xb2d6c038
100045.2,2.0,139,3,3,1,7,0xb2d358e1
275.28,3.0,7,1,4,3,8,0xb2d266b3
1000000.0,2.0,0,4,3,4,11,0xb2d98199
0.21,1.0,105,1,2,1,4,0xb2d95d51
7263.05,1.0,92,2,2,1,5,0xb2d1197d
50.6,1.0,3,1,2,4,7,0xb2d6cd97
79333.01,1.0,11,3,2,3,8,0xb2d1f783
90010.85,2.0,10,3,3,3,9,0xb2d9ca96
1704.21,9.0,22,1,4,2,7,0xb2d41134
58026.89,1.0,0,3,2,4,9,0xb2d6445ad
4478.52,1.0,12,2,2,3,7,0xb2d3192bd
72452.76,3.0,53,3,4,2,9,0xb2d22ae4
49.03,1.0,10,1,2,3,6,0xb2d9926f
1.82,1.0,51,1,2,2,5,0xb2d3981b
10015531.35,3.0,0,4,4,4,12,0xb2d783cc
13160.26,3.0,6,2,4,3,9,0xb2d06520d
100280.11,1.0,73,3,2,1,6,0xb2d6a914
310010.89,3.0,0,4,4,4,12,0xb2d39c81
1113.88,1.0,13,1,2,3,6,0xb2d2bae8
700093.68,4.0,0,4,4,4,12,0xb2d55e23d
9054.68,1.0,3,2,2,4,8,0xb2d3c50b
102.99,1.0,10,1,2,3,6,0xb2d6e467
15.5,1.0,66,1,2,2,5,0xb2d6adacd
100.68,1.0,7,1,2,3,6,0xb2d8820a
218034.11,6.0,2,3,4,4,11,0x3b9af12d
267739.58,2.0,0,3,3,4,10,0xb2d6a21c
896718.06,5.0,6,4,4,3,11,0xb2d0e042
1014.4,1.0,92,1,2,1,4,0xb2d22d15d
30232.1,1.0,43,2,2,2,6,0xb2d3036d
6423.52,1.0,29,2,2,2,6,0xb2d92901
151639.78,2.0,75,3,3,1,7,0xb2d4e74b
201092.98,2.0,180,3,3,1,7,0xb2d69dff
56001.91,3.0,92,3,4,1,8,0xb2d585b3
5350.99,1.0,184,2,2,1,5,0xb2d2456d
880079.03,5.0,92,4,4,1,9,0xb2d962fad
873000.26,7.0,0,4,4,4,12,0xb2d1bcb1
18110.67,1.0,13,2,2,3,7,0xb2d78302d
1270091.88,6.0,0,4,4,4,12,0x3b9b3924
6228.83,2.0,184,2,3,1,6,0xb2d158a5
50082.79,2.0,60,2,3,2,7,0xb2d153a7
300036.58,2.0,6,3,3,3,9,0xb2d96076d
17749.18,1.0,0,2,2,4,8,0xb2d5381e
30187.22,2.0,143,2,3,1,6,0xb2d13b0b
30068.67,2.0,11,2,3,3,8,0xb2d68160d
315508.8,2.0,122,4,3,1,8,0xb2d8eb71
404625.39,2.0,13,4,3,3,10,0xb2d1c8cbd
4193.72,1.0,10,2,2,3,7,0xb2d2aafed
150003.99,2.0,74,3,3,1,7,0xb2d179a6
556082.34,7.0,69,4,4,1,9,0xb2d11e4b
1416000.55,8.0,76,4,4,1,9,0xb2d253e7
54.9,1.0,0,1,2,4,7,0xb2d4372b
27029.33,2.0,41,2,3,2,7,0xb2d63cc0
87517.74,1.0,4,3,2,4,9,0xb2d2a2d7
5154.14,1.0,92,2,2,1,5,0xb2d1dbcf
0.09,1.0,184,1,2,1,4,0xb2d3c734
51778.82,1.0,14,2,2,3,7,0xb2d61b6a
61230.22,3.0,122,3,4,1,8,0xb2d5715c
38.91,1.0,33,1,2,2,5,0xb2d4a9eb
571391.83,17.0,1,4,4,4,12,0xb2d619aa
82900.72,3.0,6,3,4,3,10,0xb2d15b18
60007.51,3.0,112,3,4,1,8,0xb2d68227d
16484.69,2.0,54,2,3,2,7,0xb2d07f5c
3.17,1.0,80,1,2,1,4,0xb2d95534
2823.66,1.0,4,1,2,4,7,0xb2d3f4f9
1056938.09,10.0,0,4,4,4,12,0xb2d097fe
9487.45,2.0,184,2,3,1,6,0xb2d087ad
65707.52,2.0,0,3,3,4,10,0xb2d3ba0c
12955.58,1.0,0,2,2,4,8,0xb2d62d99
30379.1,1.0,22,2,2,2,6,0xb2d6828a
8929171.74,18.0,0,4,4,4,12,0x3b9b354a
0.01,2.0,77,1,3,1,5,0xb2d1fe3a
1900145.56,4.0,34,4,4,2,10,0xb2d55bfa
10303.74,1.0,68,2,2,1,5,0xb2d457a3
26141.33,3.0,1,2,4,4,10,0xb2d14f57
40192.3,2.0,11,2,3,3,8,0xb2d5ce7c
3731.57,1.0,206,2,2,1,5,0xb2d60a59
405752.07,2.0,30,4,3,2,9,0xb2d3ee42
1092.09,1.0,0,1,2,4,7,0xb2d96605
5153.0,2.0,37,2,3,2,7,0xb2d0a3dd
65093.29,1.0,132,3,2,1,6,0xb2d10803d
32.31,1.0,29,1,2,2,5,0xb2d57fc3
90.57,2.0,0,1,3,4,8,0xb2d64be4
1031314.87,10.0,0,4,4,4,12,0x3b9af17f
16.09,1.0,39,1,2,2,5,0xb2d65b10
4227.72,1.0,89,2,2,1,5,0xb2d40b4d
224657.33,6.0,15,3,4,3,10,0xb2d6033a
754.08,1.0,19,1,2,2,5,0xb2d6d717
22097.14,1.0,0,2,2,4,8,0xb2d7a79e
210000.0,2.0,13,3,3,3,9,0xb2da4398
100006.51,2.0,130,3,3,1,7,0xb2d5b0a7
102881.52,2.0,63,3,3,2,8,0xb2d64829
65882.71,3.0,4,3,4,4,11,0xb2d5d0a0
481717.21,6.0,0,4,4,4,12,0xb2d1a418
9374.2,1.0,0,2,2,4,8,0xb2d6f282
1075261.95,3.0,9,4,4,3,11,0xb2d257d8
7561.96,1.0,112,2,2,1,5,0xb2d23deb
474765.47,5.0,0,4,4,4,12,0xb2d473f7d
1200112.31,5.0,18,4,4,2,10,0xb2d218da
14093.25,3.0,7,2,4,3,9,0xb2d08c1e
500490.8,2.0,18,4,3,2,9,0xb2d24fbc
171797.64,4.0,0,3,4,4,11,0x3b9b45c2
6296.87,1.0,10,2,2,3,7,0xb2d9ba58
100004.22,2.0,217,3,3,1,7,0xb2d71609
1268.34,1.0,2,1,2,4,7,0xb2d2c025
4683.25,1.0,15,2,2,3,7,0xb2d20e87
14371.24,2.0,99,2,3,1,6,0xb2d0a1c9
129.7,1.0,0,1,2,4,7,0x3b9b444d
744434.24,3.0,60,4,4,2,10,0xb2d49e9b
380734.54,6.0,0,4,4,4,12,0x3b9af14ad
1291.77,1.0,184,1,2,1,4,0xb2d37d45
200001.26,2.0,18,3,3,2,8,0xb2d78fc2
151184.85,3.0,104,3,4,1,8,0xb2d5a3c7d
30876.11,2.0,98,2,3,1,6,0xb2d5808d
36000.68,1.0,2,2,2,4,8,0xb2d8e752d
303109.94,3.0,116,4,4,1,9,0xb2d253e6d
40008.6,3.0,55,2,4,2,8,0x3b9b4105
50138.32,2.0,25,2,3,2,7,0xb2d283b6d
611.87,1.0,7,1,2,3,6,0xb2d2bb66
1410.84,1.0,184,1,2,1,4,0xb2d46b6a
325003.43,2.0,83,4,3,1,8,0xb2d98762
1246.31,1.0,92,1,2,1,4,0xb2d15ecb
65261.93,1.0,3,3,2,4,9,0xb2d2bd30
1416.92,1.0,0,1,2,4,7,0xb2d8cdde
10410.46,1.0,3,2,2,4,8,0xb2d99e43
5045654.42,1.0,4,4,2,4,10,0xb2d2aebcd
120018.53,3.0,25,3,4,2,9,0xb2d92e5a
140011.91,2.0,193,3,3,1,7,0xb2d2aae4
212000.16,2.0,22,3,3,2,8,0xb2d9102a
260018.29,6.0,80,3,4,1,8,0xb2d63d93
300043.58,4.0,132,3,4,1,8,0xb2d24d81
407846.68,3.0,96,4,4,1,9,0xb2d69ae9
1791.52,1.0,130,1,2,1,4,0xb2d2e7abd
61.14,1.0,10,1,2,3,6,0xb2d61992
15417.1,1.0,21,2,2,2,6,0xb2d9646a
655100.01,3.0,38,4,4,2,10,0xb2d20a5a
21183.91,2.0,3,2,3,4,9,0xb2d0a422d
1505305.96,7.0,5,4,4,3,11,0xb2d5e4a3
37110.73,1.0,92,2,2,1,5,0xb2d0a21a
3449.77,1.0,43,2,2,2,6,0xb2d6daddd
79.04,1.0,7,1,2,3,6,0xb2d0d985
500000.0,2.0,0,4,3,4,11,0xb2da612e
435004.59,2.0,158,4,3,1,8,0xb2d8f20e
159006.15,3.0,14,3,4,3,10,0xb2d551a0
100049.69,2.0,121,3,3,1,7,0xb2d62308
576222.59,3.0,20,4,4,2,10,0xb2d10487
60163.64,1.0,3,3,2,4,9,0xb2d5ad90
13886.6,1.0,3,2,2,4,8,0xb2d99e23
9460.45,1.0,0,2,2,4,8,0xb2d21119d
160069.31,2.0,83,3,3,1,7,0xb2d1541dd
340000.0,5.0,0,4,4,4,12,0xb2d65a17
43.35,1.0,24,1,2,2,5,0xb2d68ebc
3109.9,1.0,7,2,2,3,7,0xb2d60b30
200037.02,2.0,91,3,3,1,7,0xb2d548cf
6374.57,1.0,5,2,2,3,7,0xb2d9bc77
550.24,1.0,14,1,2,3,6,0xb2d1f8b7
132853.45,4.0,3,3,4,4,11,0xb2d1a3bd
1676260.97,13.0,1,4,4,4,12,0xb2d5679b
200002.11,1.0,6,3,2,3,8,0xb2d96582d
91054.47,2.0,0,3,3,4,10,0xb2d5fbde
815.25,1.0,0,1,2,4,7,0xb2d6854e
571526.92,6.0,28,4,4,2,10,0xb2d61a26
402949.77,4.0,18,4,4,2,10,0xb2d91d29d
3056.07,3.0,1,2,4,4,10,0xb2d9b411
13461.11,2.0,27,2,3,2,7,0xb2d6d494
500010.56,4.0,21,4,4,2,10,0xb2d10df4
55001.2,2.0,19,3,3,2,8,0xb2d52ea0
7.39,1.0,60,1,2,2,5,0xb2d9ac88
202979.56,2.0,17,3,3,2,8,0xb2d18b3fd
17.17,1.0,62,1,2,2,5,0xb2d632b3
14990.55,4.0,12,2,4,3,9,0xb2d34461
301060.66,2.0,62,4,3,2,9,0xb2d5f031
130720.65,2.0,39,3,3,2,8,0xb2d6e20fd
596428.14,13.0,35,4,4,2,10,0xb2d7891d
1091275.09,5.0,18,4,4,2,10,0xb2d5cf46
12892.36,1.0,0,2,2,4,8,0xb2d787b5
5196.31,2.0,92,2,3,1,6,0x3b9b4925
200000.0,1.0,0,3,2,4,9,0xb2d1f838
26761.47,1.0,2,2,2,4,8,0xb2d56ed1
4005.24,1.0,9,2,2,3,7,0xb2d94363
115.96,1.0,6,1,2,3,6,0xb2d83b01
965.8,1.0,70,1,2,1,4,0xb2d42632
665336.2,4.0,0,4,4,4,12,0xb2d5effe
303538.79,2.0,92,4,3,1,8,0xb2d6e1c1d
220056.34,2.0,193,3,3,1,7,0xb2d64a63d
10718.69,1.0,184,2,2,1,5,0x3b9b195bd
257112.43,2.0,13,3,3,3,9,0xb2d648af
4043.54,1.0,0,2,2,4,8,0xb2d6fb55
266000.53,3.0,7,3,4,3,10,0xb2d12eb7
1.52,1.0,33,1,2,2,5,0xb2d28228
1481.72,1.0,2,1,2,4,7,0xb2d5313a
49951.67,2.0,147,2,3,1,6,0xb2d290dc
7547.14,7.0,0,2,4,4,10,0x3b9b4646
869.17,1.0,8,1,2,3,6,0xb2d2f150
100934.7,3.0,62,3,4,2,9,0xb2d6a4f5
400000.0,2.0,19,4,3,2,9,0xb2d95710
92596.15,1.0,74,3,2,1,6,0xb2d3e83a
45763.69,1.0,21,2,2,2,6,0xb2d2ba98
828068.62,18.0,6,4,4,3,11,0x3b9adcd8
350518.8,11.0,0,4,4,4,12,0x3b9af264
36740.4,1.0,184,2,2,1,5,0xb2d3d819
448558.93,5.0,32,4,4,2,10,0xb2d5ad38
405.52,1.0,65,1,2,2,5,0xb2d47eb3
50041.04,2.0,216,2,3,1,6,0xb2d4fe82
1601.13,1.0,9,1,2,3,6,0xb2d7c870
107.96,1.0,13,1,2,3,6,0xb2d48c12
143462.83,1.0,17,3,2,2,7,0xb2d1fbdc
500013.27,3.0,11,4,4,3,11,0xb2d9034d
379483.83,5.0,10,4,4,3,11,0xb2d4b90e
111685.84,2.0,10,3,3,3,9,0xb2d91f6f
6.92,1.0,184,1,2,1,4,0xb2d28e68
73452.53,2.0,80,3,3,1,7,0xb2d50c01
656.77,1.0,0,1,2,4,7,0xb2d8eb3f
450300.52,3.0,14,4,4,3,11,0xb2d9112b
36652.5,2.0,3,2,3,4,9,0x3b9b4153
207127.02,2.0,4,3,3,4,10,0xb2d4b31d
292.78,1.0,19,1,2,2,5,0xb2d25d08
1215.68,5.0,51,1,4,2,7,0xb2d16c13
170851.12,4.0,2,3,4,4,11,0xb2d2aca3
765.36,2.0,20,1,3,2,6,0xb2d1c25a
194.29,1.0,55,1,2,2,5,0xb2d69d95d
667053.27,3.0,5,4,4,3,11,0xb2d1db7c
402924.97,8.0,41,4,4,2,10,0xb2d0f803
757438.25,6.0,1,4,4,4,12,0xb2d1e2d5
9636.92,1.0,0,2,2,4,8,0xb2d6c010
2556.44,1.0,105,1,2,1,4,0xb2d6195cd
560039.07,3.0,157,4,4,1,9,0xb2d30d3d
1280.16,1.0,9,1,2,3,6,0xb2d37455
204.57,1.0,9,1,2,3,6,0xb2d6d51f
29292.18,2.0,92,2,3,1,6,0x3b9b4782
4427.27,1.0,12,2,2,3,7,0xb2d8d02cd
260924.24,2.0,48,3,3,2,8,0xb2d6ef87
100600.26,4.0,0,3,4,4,11,0xb2d534b3
456066.57,11.0,32,4,4,2,10,0xb2d526af
364015.42,4.0,76,4,4,1,9,0xb2d10781
200638.5,2.0,11,3,3,3,9,0xb2d281f7
140125.97,2.0,1,3,3,4,10,0xb2d62ceb
100139.21,2.0,81,3,3,1,7,0xb2d1fc0e
423.0,1.0,7,1,2,3,6,0xb2d1d29f
21207.39,1.0,1,2,2,4,8,0xb2d6f597
457.68,2.0,0,1,3,4,8,0xb2d1190e
76.34,1.0,35,1,2,2,5,0xb2d9303d
238835.86,6.0,0,3,4,4,11,0xb2d3a8be
657.39,1.0,2,1,2,4,7,0xb2d8f6ae
223139.55,11.0,5,3,4,3,10,0xb2d064b5
225493.17,4.0,97,3,4,1,8,0xb2d1a533
40192.64,2.0,25,2,3,2,7,0xb2d0f4ea
510399.0,4.0,0,4,4,4,12,0x3b9b49ca
14810.92,1.0,92,2,2,1,5,0xb2d3e448
2464.02,2.0,22,1,3,2,6,0xb2d0a54f
794005.53,7.0,0,4,4,4,12,0xb2d255b4
70289.34,3.0,22,3,4,2,9,0xb2d99aef
12173.55,1.0,4,2,2,4,8,0xb2d4fcf2
1121.83,1.0,1,1,2,4,7,0xb2d1f7c6
3.8,1.0,72,1,2,1,4,0xb2d3ab30
345000.0,6.0,1,4,4,4,12,0xb2d2e9f2d
60014.77,12.0,31,3,4,2,9,0xb2d09fc5
500038.36,3.0,27,4,4,2,10,0xb2d16060
4154.93,1.0,0,2,2,4,8,0xb2d6b599
10001.15,2.0,259,2,3,1,6,0xb2d5e7ef
1157.21,2.0,92,1,3,1,5,0xb2d313d6d
10168.67,1.0,77,2,2,1,5,0xb2d1f07e
160181.92,3.0,87,3,4,1,8,0xb2d2e6c4
8737.03,1.0,92,2,2,1,5,0xb2d42ccd
512.6,1.0,12,1,2,3,6,0xb2d35f59
450000.0,7.0,0,4,4,4,12,0xb2d3f1f5
1515.61,1.0,126,1,2,1,4,0xb2d68cd3
509515.06,1.0,0,4,2,4,10,0xb2d0c6f5
12000.38,1.0,1,2,2,4,8,0xb2d95304
20056.15,1.0,12,2,2,3,7,0xb2d65465
45669.22,1.0,11,2,2,3,7,0xb2d34316
16678.95,1.0,112,2,2,1,5,0xb2d6bd30
30001.27,2.0,83,2,3,1,6,0xb2d8cccf
60007.96,2.0,39,3,3,2,8,0xb2d3491a
4.8,1.0,11,1,2,3,6,0xb2d7f46e
1213.91,1.0,92,1,2,1,4,0xb2d27117
400002.22,5.0,78,4,4,1,9,0xb2d626d1
49717.03,2.0,0,2,3,4,9,0x3b9b468b
8.88,1.0,26,1,2,2,5,0xb2d5bf2d
3138.67,1.0,92,2,2,1,5,0x3b9b1350d
10075.6,1.0,2,2,2,4,8,0xb2d21317
500021.13,2.0,104,4,3,1,8,0xb2d7bd69
328.43,1.0,54,1,2,2,5,0xb2d28122
2260541.48,5.0,90,4,4,1,9,0xb2d0d6c7
60249.09,3.0,18,3,4,2,9,0xb2d80160
101923.9,1.0,3,3,2,4,9,0xb2d6b3c8
5018.23,1.0,7,2,2,3,7,0xb2d3435d
1860000.0,2.0,0,4,3,4,11,0xb2d78f28
546.34,1.0,0,1,2,4,7,0xb2d390fb
6238.31,2.0,0,2,3,4,9,0x3b9b425c
1394.6,1.0,92,1,2,1,4,0xb2d1977a
12262.19,1.0,0,2,2,4,8,0xb2d4039f
386043.39,4.0,0,4,4,4,12,0x3b9b3338
90426.43,1.0,11,3,2,3,8,0xb2d2c1ed
250116.39,2.0,147,3,3,1,7,0xb2d2df42
151674.44,2.0,8,3,3,3,9,0xb2d1e8b8
1107.62,1.0,92,1,2,1,4,0xb2d540df
140034.42,2.0,97,3,3,1,7,0xb2d4238e
300131.43,2.0,18,4,3,2,9,0xb2d8d505d
70146.94,1.0,5,3,2,3,8,0xb2d903d7
1128.23,1.0,179,1,2,1,4,0xb2d3b9fb
622.5,1.0,0,1,2,4,7,0xb2d3f2ff
1001.57,1.0,22,1,2,2,5,0xb2d1a6c4
11029.88,2.0,60,2,3,2,7,0xb2d69a49
22878.04,1.0,298,2,2,1,5,0xb2d64f4b
1732.73,1.0,184,1,2,1,4,0xb2d22528
3.14,1.0,76,1,2,1,4,0xb2d55209
1723.38,1.0,0,1,2,4,7,0xb2d6f638
90901.93,2.0,7,3,3,3,9,0x3b9b4648d
30000.63,2.0,67,2,3,1,6,0xb2d9a9ab
105.37,1.0,11,1,2,3,6,0xb2d78366
153375.78,3.0,0,3,4,4,11,0xb2d2522e
561539.48,6.0,52,4,4,2,10,0xb2d14091d
866.9,1.0,5,1,2,3,6,0xb2d510abd
1849.05,1.0,1,1,2,4,7,0xb2d5bf7f
620055.28,2.0,235,4,3,1,8,0xb2d1c4b5
113615.22,2.0,188,3,3,1,7,0xb2d23a7e
9.31,1.0,55,1,2,2,5,0xb2d8d3c8
6141.79,1.0,122,2,2,1,5,0xb2d3f34cd
259.27,1.0,12,1,2,3,6,0xb2d7ee02
713046.06,6.0,0,4,4,4,12,0xb2d565a7d
64144.62,4.0,4,3,4,4,11,0xb2d5e2f4
456192.83,5.0,58,4,4,2,10,0xb2d17909
220081.0,2.0,19,3,3,2,8,0xb2d69a09
4437.92,1.0,92,2,2,1,5,0xb2d1b1df
587000.0,18.0,9,4,4,3,11,0xb2d13228
4799.91,1.0,184,2,2,1,5,0xb2d2f16dd
6920.12,1.0,11,2,2,3,7,0xb2d2374f
1221.51,1.0,27,1,2,2,5,0xb2d74b01d
300450.66,2.0,9,4,3,3,10,0xb2d28a33
402458.85,1.0,15,4,2,3,9,0xb2d14399
2.85,1.0,83,1,2,1,4,0xb2d3afc6
609415.57,6.0,21,4,4,2,10,0xb2d18083
723776.53,2.0,10,4,3,3,10,0xb2d1f89d
3678.15,1.0,113,2,2,1,5,0xb2d4d0a0
10000.95,2.0,19,2,3,2,7,0xb2da1b67
177009.86,3.0,63,3,4,2,9,0xb2d69fdd
300000.0,4.0,4,3,4,4,11,0xb2da4e7e
109286.22,3.0,92,3,4,1,8,0xb2d09065
13608.59,1.0,0,2,2,4,8,0xb2d37c2e
2109.11,1.0,38,1,2,2,5,0xb2d2a4d7
600006.33,2.0,28,4,3,2,9,0xb2da0ba2
200152.81,2.0,1,3,3,4,10,0xb2d8d3b0
150007.4,9.0,11,3,4,3,10,0xb2d11dad
0.01,1.0,54,1,2,2,5,0xb2d5a604
43258.77,1.0,60,2,2,2,6,0xb2d93619
27507.96,1.0,2,2,2,4,8,0xb2d43a65
0.0,1.0,5,1,2,3,6,0xb2d58c58
282343.77,3.0,5,3,4,3,10,0xb2d53903
150795.65,2.0,60,3,3,2,8,0xb2d28b63
997.58,1.0,11,1,2,3,6,0xb2d8d0b5
5175.06,1.0,12,2,2,3,7,0xb2d3c98b
61676.88,2.0,104,3,3,1,7,0xb2d5dbc6
1035651.46,1.0,31,4,2,2,8,0xb2d65c75
140079.86,3.0,266,3,4,1,8,0x3b9adcff
0.01,1.0,75,1,2,1,4,0xb2d6eeba
4022.93,1.0,32,2,2,2,6,0xb2d9d3ca
22667.71,1.0,10,2,2,3,7,0xb2d9d00e
1122.59,1.0,41,1,2,2,5,0xb2d5f219d
60021.83,1.0,1,3,2,4,9,0xb2d63007
1612.48,2.0,183,1,3,1,5,0xb2d06ffb
139000.01,3.0,31,3,4,2,9,0xb2d20f21d
2335001.67,1.0,0,4,2,4,10,0xb2d91fee
611390.38,4.0,67,4,4,1,9,0xb2d30a0f
47968.91,1.0,10,2,2,3,7,0xb2d95535
364329.09,14.0,1,4,4,4,12,0xb2d5349a
4860.22,1.0,10,2,2,3,7,0xb2d40950
10905.55,1.0,92,2,2,1,5,0x3b9b2489d
106668.93,1.0,184,3,2,1,6,0xb2d133c3
24934.33,1.0,0,2,2,4,8,0xb2da0394
1579043.36,6.0,10,4,4,3,11,0xb2d26688
27425.16,1.0,7,2,2,3,7,0xb2d6bae6
96058.38,2.0,181,3,3,1,7,0xb2d22bb0
3185.63,1.0,5,2,2,3,7,0xb2d6876e
85084.14,3.0,18,3,4,2,9,0xb2d2c1af
10466.85,1.0,75,2,2,1,5,0xb2d633dd
5108.56,1.0,92,2,2,1,5,0xb2d5746f
317125.85,3.0,6,4,4,3,11,0xb2d5fb3fd
1370000.93,15.0,3,4,4,4,12,0xb2d4d31ad
718.74,1.0,0,1,2,4,7,0xb2d923dd
200000.0,2.0,0,3,3,4,10,0xb2d92b36
280421.7,4.0,53,3,4,2,9,0xb2d63516
360088.59,4.0,4,4,4,4,12,0xb2d5ea87
90934.76,2.0,97,3,3,1,7,0xb2d2b4c1
2028458.11,9.0,0,4,4,4,12,0xb2d132b5
15009.16,2.0,41,2,3,2,7,0xb2d92313
410000.09,4.0,7,4,4,3,11,0xb2d52ed9
322682.2,3.0,17,4,4,2,10,0xb2d16ae3
217074.73,11.0,1,3,4,4,11,0xb2d0683a
200710.43,2.0,42,3,3,2,8,0xb2d97ca6
200001.38,2.0,4,3,3,4,10,0xb2d80d4e
860018.16,2.0,32,4,3,2,9,0xb2da04e7
7375.25,1.0,14,2,2,3,7,0xb2d8ce08
50001.06,2.0,11,2,3,3,8,0xb2da437e
300005.64,2.0,11,3,3,3,9,0xb2d12955
4.02,1.0,21,1,2,2,5,0xb2d3565f
6014.99,1.0,1,2,2,4,8,0xb2d40596d
10000.0,1.0,0,2,2,4,8,0xb2d58c8e
858.75,1.0,0,1,2,4,7,0xb2d1768f
534127.14,3.0,6,4,4,3,11,0xb2d19903
246.64,1.0,3,1,2,4,7,0xb2d6263ad
112.46,1.0,6,1,2,3,6,0xb2d26982
10676.45,1.0,6,2,2,3,7,0xb2d9486e
685034.88,7.0,0,4,4,4,12,0xb2d56074
1001.92,1.0,10,1,2,3,6,0xb2d9b7c7
0.0,1.0,8,1,2,3,6,0xb2da3d2b
1531.24,1.0,92,1,2,1,4,0xb2d1ec99d
4999.95,2.0,0,2,3,4,9,0xb2d0eb63
2255.15,1.0,76,1,2,1,4,0xb2d5dbd7
1544.65,1.0,62,1,2,2,5,0xb2d6a475d
480078.91,3.0,53,4,4,2,10,0xb2d5ee74
96190.82,2.0,157,3,3,1,7,0xb2d2cdec
2358.15,1.0,7,1,2,3,6,0xb2d214e5d
500000.19,2.0,17,4,3,2,9,0xb2d8da0a
513622.86,6.0,20,4,4,2,10,0xb2d26c48
6805.3,1.0,92,2,2,1,5,0xb2d21d02
476.3,1.0,10,1,2,3,6,0xb2d6f14a
211277.51,1.0,184,3,2,1,6,0xb2d1fcf8
10.5,1.0,89,1,2,1,4,0xb2d3bf0e
2806.85,1.0,7,1,2,3,6,0xb2d8f6b7d
50124.24,1.0,92,2,2,1,5,0xb2d53da9
3069937.21,9.0,33,4,4,2,10,0xb2d5986f
100108.12,1.0,1,3,2,4,9,0xb2d9a4f9
350067.42,3.0,129,4,4,1,9,0xb2d13718
1.64,1.0,78,1,2,1,4,0xb2d581d2
501776.04,2.0,4,4,3,4,11,0xb2d92ba1
80002.22,3.0,3,3,4,4,11,0xb2d959a3d
500005.0,2.0,11,4,3,3,10,0xb2da301e
205574.62,4.0,74,3,4,1,8,0xb2d61cdf
216072.67,3.0,60,3,4,2,9,0x3b9b47b9
15276.63,3.0,2,2,4,4,10,0x3b9b288cd
227421.55,3.0,10,3,4,3,10,0xb2d112c9
2000.64,1.0,92,1,2,1,4,0xb2d29aa5
205808.13,1.0,7,3,2,3,8,0xb2d64b5d
366250.72,2.0,1,4,3,4,11,0xb2d9d86d
200105.28,2.0,56,3,3,2,8,0xb2d5bd9e
302694.62,1.0,15,4,2,3,9,0xb2d2f3df
2384000.93,11.0,8,4,4,3,11,0x3b9b26d6d
3065.59,1.0,184,2,2,1,5,0xb2d0be9cd
139.12,2.0,21,1,3,2,6,0xb2d64ea7
29837.62,1.0,230,2,2,1,5,0xb2d6108c
1030037.06,12.0,6,4,4,3,11,0xb2d13220
157000.0,7.0,10,3,4,3,10,0xb2d0a736
1594158.49,10.0,7,4,4,3,11,0xb2d508f7
50073.52,2.0,119,2,3,1,6,0xb2d0fd9a
82136.68,2.0,52,3,3,2,8,0xb2d59fbb
500016.68,2.0,46,4,3,2,9,0xb2d6cec8
1288176.55,2.0,3,4,3,4,11,0xb2d146c5d
400765.43,8.0,13,4,4,3,11,0xb2d1dfead
0.53,1.0,68,1,2,1,4,0xb2d367f7
200614.97,6.0,0,3,4,4,11,0x3b9af2f8
500025.05,2.0,4,4,3,4,11,0xb2d9ff74
410088.96,3.0,0,4,4,4,12,0xb2d2f0a9
196080.14,3.0,4,3,4,4,11,0xb2d148eb
300000.42,2.0,5,3,3,3,9,0xb2d28518
103603.71,3.0,3,3,4,4,11,0xb2d5f845
146.87,2.0,16,1,3,2,6,0xb2d5e7d7
345000.36,14.0,0,4,4,4,12,0xb2d603e7d
36.74,1.0,0,1,2,4,7,0xb2d2dd3a
211884.61,4.0,14,3,4,3,10,0xb2d40fbc
164777.63,3.0,3,3,4,4,11,0xb2d67cad
300062.61,2.0,17,3,3,2,8,0xb2d6e58c
1365520.09,9.0,8,4,4,3,11,0xb2d5e358
200003.71,2.0,9,3,3,3,9,0xb2d92368
120736.21,3.0,39,3,4,2,9,0xb2d6443fd
338030.47,4.0,3,4,4,4,12,0xb2d3b6bc
288242.05,3.0,21,3,4,2,9,0xb2d1c34c
161657.08,7.0,0,3,4,4,11,0x3b9ae040d
492717.93,20.0,0,4,4,4,12,0x3b9b0e2e
48.76,1.0,98,1,2,1,4,0xb2d5dd96d
690.92,1.0,19,1,2,2,5,0xb2d3b220
120002.53,2.0,31,3,3,2,8,0xb2d9393a
550087.53,4.0,16,4,4,2,10,0xb2d611b2
63099.1,3.0,43,3,4,2,9,0xb2d5512d
2451.25,1.0,1,1,2,4,7,0xb2d1e19f
249599.43,3.0,0,3,4,4,11,0xb2d09c83
100062.61,2.0,181,3,3,1,7,0xb2d2819b
17.48,1.0,11,1,2,3,6,0xb2d94ea9
221000.0,4.0,3,3,4,4,11,0xb2d90513
76343.06,4.0,277,3,4,1,8,0xb2d09ddc
201475.71,2.0,60,3,3,2,8,0xb2d672e5
428490.43,1.0,0,4,2,4,10,0xb2d3cbcb
102150.09,2.0,10,3,3,3,9,0xb2d7f500
983.11,1.0,88,1,2,1,4,0xb2d1f73b
850080.83,2.0,14,4,3,3,10,0xb2da3494
55208.71,2.0,92,3,3,1,7,0xb2d40fe0
6040.8,1.0,21,2,2,2,6,0xb2d609b2
30194.47,1.0,92,2,2,1,5,0xb2d38309
1184.11,2.0,4,1,3,4,8,0xb2d9918f
50070.83,2.0,10,2,3,3,8,0xb2d5eb4c
448.73,1.0,27,1,2,2,5,0xb2d39cd0
30561.73,2.0,0,2,3,4,9,0xb2d65883
6763.02,4.0,26,2,4,2,8,0xb2d0e0eed
29026.82,15.0,92,2,4,1,7,0x3b9ada99
10.24,1.0,34,1,2,2,5,0xb2d3a656
1414814.38,21.0,11,4,4,3,11,0xb2d087b8
216787.84,5.0,0,3,4,4,11,0xb2d5635f
30000.32,2.0,95,2,3,1,6,0xb2d59537
200000.0,3.0,0,3,4,4,11,0xb2d974c0d
2500145.62,2.0,35,4,3,2,9,0xb2d55237
225021.59,2.0,31,3,3,2,8,0xb2d605af
280038.66,2.0,1,3,3,4,10,0xb2d5f200
1460.84,1.0,184,1,2,1,4,0xb2d28699
3.53,1.0,48,1,2,2,5,0xb2d94dd8
2642.37,2.0,0,1,3,4,8,0x3b9b4396
953634.26,7.0,0,4,4,4,12,0xb2d0f7d0
152353.48,2.0,129,3,3,1,7,0xb2d1c07e
51827.36,2.0,52,2,3,2,7,0xb2d6d4c6
1173441.74,7.0,0,4,4,4,12,0xb2d173ad
5028.46,1.0,9,2,2,3,7,0xb2d45a0f
13931.1,1.0,10,2,2,3,7,0xb2d6e90cd
1745.36,1.0,31,1,2,2,5,0xb2d2822e
53867.45,1.0,1,3,2,4,9,0xb2d56c0e
350184.68,2.0,0,4,3,4,11,0xb2d9d774
233378.11,4.0,0,3,4,4,11,0xb2d69e86d
82911.38,2.0,13,3,3,3,9,0xb2d605b4
14803.2,1.0,13,2,2,3,7,0xb2d8c8ee
11890.63,1.0,1,2,2,4,8,0xb2d6bf7bd
20472.2,1.0,3,2,2,4,8,0xb2d60d99
423138.66,8.0,0,4,4,4,12,0xb2d2fc19
0.95,1.0,41,1,2,2,5,0xb2d7900a
130521.9,2.0,32,3,3,2,8,0xb2d39c27d
5278.98,1.0,92,2,2,1,5,0xb2d171cf
269154.25,3.0,108,3,4,1,8,0xb2d22c00d
8577.52,1.0,10,2,2,3,7,0xb2d91381
60003.18,2.0,8,3,3,3,9,0xb2d2166b
0.0,1.0,0,1,2,4,7,0xb2d433d2d
111037.65,6.0,2,3,4,4,11,0xb2d0a084
304501.41,2.0,7,4,3,3,10,0xb2d527da
1005.96,1.0,184,1,2,1,4,0xb2d4ba7e
300039.08,2.0,74,3,3,1,7,0xb2d36a15
10191.61,2.0,69,2,3,1,6,0xb2d65614
56806.44,1.0,7,3,2,3,8,0xb2d37f38
316014.56,8.0,20,4,4,2,10,0xb2d3e660
13053.54,1.0,0,2,2,4,8,0xb2d2d156
15260.66,1.0,29,2,2,2,6,0xb2d6d555
1521.97,1.0,10,1,2,3,6,0xb2d3f0bc
5.59,1.0,81,1,2,1,4,0xb2d80e92
330000.02,4.0,12,4,4,3,11,0xb2d0cba7d
2.1,1.0,19,1,2,2,5,0xb2d6c584
103.44,1.0,77,1,2,1,4,0xb2d14550
3910.0,2.0,92,2,3,1,6,0xb2d21b4d
171029.02,3.0,60,3,4,2,9,0xb2d8e512
200017.1,2.0,4,3,3,4,10,0xb2d95849
2.74,1.0,32,1,2,2,5,0xb2d9f563
20.89,1.0,11,1,2,3,6,0xb2d8fa2bd
0.01,1.0,93,1,2,1,4,0xb2d8ff73
1477058.72,14.0,3,4,4,4,12,0xb2d19d84
300007.49,3.0,12,3,4,3,10,0xb2d8048c
100914.34,1.0,1,3,2,4,9,0xb2d17328
2.96,1.0,39,1,2,2,5,0xb2d926a2d
0.55,1.0,5,1,2,3,6,0xb2d61252
109016.88,1.0,7,3,2,3,8,0xb2d2cde3
0.74,1.0,14,1,2,3,6,0xb2d61bfe
236796.11,5.0,0,3,4,4,11,0xb2d210f8
305670.71,2.0,1,4,3,4,11,0xb2d51736
72629.45,1.0,166,3,2,1,6,0xb2d31419
818.74,1.0,78,1,2,1,4,0xb2d62322
459893.75,4.0,4,4,4,4,12,0xb2d0e9e2
1052494.9,7.0,1,4,4,4,12,0xb2d170b3
88.97,1.0,10,1,2,3,6,0xb2d534ef
957.02,1.0,10,1,2,3,6,0xb2d2e2a9
307.53,1.0,28,1,2,2,5,0xb2d29fc8
41.68,1.0,13,1,2,3,6,0xb2d8e21d
685779.84,4.0,41,4,4,2,10,0xb2d296a2
73.43,1.0,22,1,2,2,5,0xb2d8dcf6
54.77,1.0,9,1,2,3,6,0xb2d94743
2285802.32,3.0,0,4,4,4,12,0xb2d0adee
31920.54,1.0,0,2,2,4,8,0xb2d6221b
40007.8,2.0,206,2,3,1,6,0xb2d5ac6e
100002.19,2.0,35,3,3,2,8,0xb2d5109fd
0.0,1.0,84,1,2,1,4,0xb2d55f57
1046.56,1.0,161,1,2,1,4,0xb2d81fa6
40004.67,2.0,92,2,3,1,6,0xb2d655d8
69.67,1.0,0,1,2,4,7,0xb2d906de
8791.85,2.0,16,2,3,2,7,0x3b9b2530
51.66,1.0,0,1,2,4,7,0xb2d306b2
140050.29,2.0,11,3,3,3,9,0xb2d2611f
1.95,1.0,77,1,2,1,4,0xb2d8215e
14.4,1.0,15,1,2,3,6,0xb2d99160
25192.91,1.0,0,2,2,4,8,0xb2d42899
1300389.55,13.0,3,4,4,4,12,0xb2d5e33c
371729.51,1.0,139,4,2,1,7,0xb2d3d339
176.86,1.0,0,1,2,4,7,0xb2d4a5d6d
1691.85,1.0,246,1,2,1,4,0xb2d4c288d
440272.03,4.0,53,4,4,2,10,0xb2d2507c
100001.06,2.0,32,3,3,2,8,0xb2da02f6
2153083.13,12.0,0,4,4,4,12,0xb2d0ffc0
19.01,1.0,71,1,2,1,4,0xb2d1ee68
0.28,1.0,2,1,2,4,7,0xb2d9b73b
50062.42,2.0,38,2,3,2,7,0xb2d62aefd
16895.91,1.0,3,2,2,4,8,0xb2d31b50
400045.36,2.0,5,4,3,3,10,0xb2d8f201
302.81,1.0,21,1,2,2,5,0xb2d22125
237.29,1.0,6,1,2,3,6,0xb2d6948a
472091.48,3.0,0,4,4,4,12,0xb2d09841
89923.23,2.0,0,3,3,4,10,0xb2d2f918
50120.36,2.0,122,2,3,1,6,0xb2d63b33d
2979.71,1.0,6,2,2,3,7,0xb2d7452f
91.34,1.0,9,1,2,3,6,0xb2d5b42f
20685.75,1.0,1,2,2,4,8,0xb2d9761f
1588389.06,7.0,92,4,4,1,9,0xb2d621bf
315417.71,3.0,49,4,4,2,10,0xb2d64141
110127.78,2.0,145,3,3,1,7,0xb2d46589
1522.59,1.0,92,1,2,1,4,0xb2d11c7a
33.39,13.0,0,1,4,4,9,0xb2d689df
2000042.22,2.0,46,4,3,2,9,0xb2d9df18
57871.94,2.0,3,3,3,4,10,0x3b9b1017
0.0,1.0,299,1,2,1,4,0xb2d69021
820029.58,5.0,11,4,4,3,11,0xb2d367fa
8533.19,1.0,12,2,2,3,7,0xb2d69a4f
0.0,2.0,60,1,3,2,6,0xb2d8f7a9
935.53,1.0,10,1,2,3,6,0xb2d6fea7
100002.02,2.0,6,3,3,3,9,0xb2d12914
5209.94,2.0,92,2,3,1,6,0xb2d0779e
455139.36,2.0,0,4,3,4,11,0xb2d3adc8
702099.49,4.0,8,4,4,3,11,0xb2d217ce
50462.14,2.0,77,2,3,1,6,0xb2d330a4d
3101.31,1.0,27,2,2,2,6,0xb2d5f000
1147089.49,6.0,1,4,4,4,12,0xb2d3bd46
556699.09,3.0,1,4,4,4,12,0xb2d6af3f
950062.99,5.0,49,4,4,2,10,0xb2d62747
363071.11,10.0,11,4,4,3,11,0xb2d634a8d
60219.24,3.0,0,3,4,4,11,0xb2d51ec7
100002.11,2.0,67,3,3,1,7,0xb2d9adf6
12342.07,1.0,11,2,2,3,7,0xb2d8ca6d
676.77,1.0,23,1,2,2,5,0xb2d6af20
720148.95,5.0,6,4,4,3,11,0xb2d96eec
104725.68,2.0,104,3,3,1,7,0xb2d48ccdd
201000.04,2.0,14,3,3,3,9,0xb2da3056
80812.84,2.0,94,3,3,1,7,0xb2d60e75
520022.7,8.0,3,4,4,4,12,0xb2d5dbead
1423.35,1.0,95,1,2,1,4,0xb2d3c14c
154073.82,3.0,0,3,4,4,11,0xb2d5921b
21.8,1.0,0,1,2,4,7,0xb2d5ffd5
7337.25,1.0,2,2,2,4,8,0xb2d2e9d1
60031.61,4.0,0,3,4,4,11,0xb2d63eaa
4832.66,1.0,19,2,2,2,6,0xb2d9def4
1015.54,1.0,92,1,2,1,4,0xb2d0f1aad
585031.64,3.0,0,4,4,4,12,0xb2d649e7
10257.64,2.0,25,2,3,2,7,0xb2d43371d
1812.48,1.0,10,1,2,3,6,0xb2d41bedd
10164.25,2.0,129,2,3,1,6,0xb2d2ad0d
500063.42,2.0,26,4,3,2,9,0xb2d92da4
301158.62,1.0,0,4,2,4,10,0xb2d313e7
407115.54,2.0,5,4,3,3,10,0xb2d55c72
206009.81,3.0,4,3,4,4,11,0xb2d366b0
6.52,1.0,57,1,2,2,5,0xb2d5e538
200084.42,2.0,73,3,3,1,7,0xb2d45d00d
250039.16,2.0,7,3,3,3,9,0xb2d4f8b6
105.41,1.0,70,1,2,1,4,0xb2d2b245
70786.76,6.0,0,3,4,4,11,0xb2d21344
94052.27,5.0,0,3,4,4,11,0xb2d281abd
520046.65,5.0,0,4,4,4,12,0xb2d553bf
173133.18,3.0,38,3,4,2,9,0xb2d0d4c5
1157002.32,44.0,1,4,4,4,12,0xb2d23e9a
7600080.25,2.0,10,4,3,3,10,0xb2d635f4d
3102.93,1.0,1,2,2,4,8,0xb2d409b2
503254.27,6.0,7,4,4,3,11,0xb2d627aa
301198.58,2.0,3,4,3,4,11,0xb2d88e5f
400000.0,2.0,23,4,3,2,9,0xb2d986c6
23202.03,1.0,256,2,2,1,5,0xb2d62e97
800103.51,3.0,8,4,4,3,11,0xb2d1b51d
1001.18,1.0,129,1,2,1,4,0xb2d26c79
14.55,1.0,38,1,2,2,5,0xb2d340d6
109000.0,2.0,0,3,3,4,10,0xb2d97c76
2638.37,1.0,14,1,2,3,6,0xb2d22cbd
350000.13,2.0,11,4,3,3,10,0xb2d5890fd
189378.67,1.0,8,3,2,3,8,0xb2d57fce
120015.48,1.0,9,3,2,3,8,0xb2d2b9ab
3938.91,1.0,32,2,2,2,6,0xb2d9d30f
50002.41,4.0,141,2,4,1,7,0xb2d699d4
950000.35,3.0,13,4,4,3,11,0xb2d16b56
69.9,1.0,55,1,2,2,5,0xb2d20b52
500000.0,2.0,3,4,3,4,11,0xb2da6584
20045.16,2.0,123,2,3,1,6,0xb2d5f111
15.29,1.0,33,1,2,2,5,0xb2d580aa
800000.0,2.0,22,4,3,2,9,0xb2da20f6
1106.61,2.0,11,1,3,3,7,0xb2d1abdc
38.73,1.0,28,1,2,2,5,0xb2d8fa1e
205313.91,8.0,7,3,4,3,10,0xb2d19889
860093.21,5.0,53,4,4,2,10,0x3b9b265cd
1010610.12,6.0,4,4,4,4,12,0xb2d57de1
2000265.55,1.0,8,4,2,3,9,0xb2d50d01d
1092.56,1.0,184,1,2,1,4,0xb2d31d0c
250888.16,2.0,22,3,3,2,8,0xb2d6eb0c
311805.4,2.0,32,4,3,2,9,0xb2d37644d
21.11,1.0,41,1,2,2,5,0xb2d566e8
953375.01,2.0,55,4,3,2,9,0xb2d9cd93
1400584.88,6.0,27,4,4,2,10,0xb2d22010
559.39,1.0,5,1,2,3,6,0xb2d2b3cf
81478.43,2.0,90,3,3,1,7,0xb2d475ff
216789.19,2.0,14,3,3,3,9,0xb2d9537f
325519.94,4.0,21,4,4,2,10,0xb2d5e0fb
400004.22,2.0,235,4,3,1,8,0xb2d6e9ea
1.86,1.0,63,1,2,2,5,0xb2d704eb
430000.43,2.0,21,4,3,2,9,0xb2d9c653
145007.2,4.0,27,3,4,2,9,0xb2d079ea
117143.01,2.0,0,3,3,4,10,0xb2d3a663
1022.95,1.0,197,1,2,1,4,0xb2d19b5b
201085.61,3.0,18,3,4,2,9,0xb2d58a40d
14021.96,2.0,92,2,3,1,6,0xb2d07dcc
74007.27,2.0,1,3,3,4,10,0xb2d34f6e
7833.57,1.0,0,2,2,4,8,0xb2d6a7d6
960107.67,3.0,87,4,4,1,9,0xb2d0c1c7
1889121.16,4.0,14,4,4,3,11,0xb2d119c7
310335.11,3.0,3,4,4,4,12,0xb2d3704ad
318144.54,4.0,93,4,4,1,9,0xb2d2d41f
6343.9,1.0,0,2,2,4,8,0xb2d3b45e
2152.67,1.0,12,1,2,3,6,0xb2d3f9dd
10953.55,1.0,0,2,2,4,8,0xb2d6a7bc
16249195.65,3.0,56,4,4,2,10,0xb2d55ae6d
547308.16,4.0,4,4,4,4,12,0xb2d23bb0
500000.0,2.0,18,4,3,2,9,0xb2da3361
40000.42,2.0,41,2,3,2,7,0xb2d91ebb
45953.57,1.0,9,2,2,3,7,0xb2d3736a
80002.38,3.0,24,3,4,2,9,0xb2d0815c
402263.91,4.0,0,4,4,4,12,0xb2d45a8b
992.03,1.0,9,1,2,3,6,0xb2d2bc5d
1702.47,1.0,74,1,2,1,4,0xb2d63f4a
550003.03,6.0,80,4,4,1,9,0xb2d10e3b
7131.52,1.0,2,2,2,4,8,0xb2d27036
1737346.69,42.0,0,4,4,4,12,0xb2d082b7
10.36,1.0,47,1,2,2,5,0xb2d5b42b
16777.1,1.0,3,2,2,4,8,0xb2d300d2
4327.83,1.0,10,2,2,3,7,0xb2d3f9d6
80953.68,2.0,60,3,3,2,8,0xb2d65356
170.67,1.0,4,1,2,4,7,0xb2d2ce79
1007105.13,2.0,67,4,3,1,8,0xb2d9b27c
44.62,2.0,11,1,3,3,7,0xb2d95f32
10000.32,2.0,221,2,3,1,6,0xb2d6fe38
7.6,1.0,42,1,2,2,5,0xb2d98cf4
270.56,1.0,11,1,2,3,6,0xb2d41005
300331.68,2.0,8,4,3,3,10,0xb2d8e6f3
36.5,1.0,80,1,2,1,4,0xb2d50e76
2203.1,1.0,81,1,2,1,4,0xb2d591ac
253004.75,3.0,27,3,4,2,9,0xb2d90bde
80025.54,2.0,94,3,3,1,7,0xb2d1c2d8
40566.86,3.0,7,2,4,3,9,0xb2d395fb
79177.44,1.0,19,3,2,2,7,0xb2d2cd58
900066.84,4.0,18,4,4,2,10,0xb2d6092f
741884.15,11.0,0,4,4,4,12,0xb2d357e3
100002.11,2.0,67,3,3,1,7,0xb2d9ac5a
80121.7,2.0,139,3,3,1,7,0xb2d32b05
3268.55,1.0,92,2,2,1,5,0xb2d30b18
250072.86,4.0,21,3,4,2,9,0xb2d1a6eb
492354.08,2.0,2,4,3,4,11,0xb2d23cf6
21585.9,1.0,184,2,2,1,5,0xb2d29166
25124.51,1.0,10,2,2,3,7,0xb2d6f627
8816.96,1.0,8,2,2,3,7,0xb2d0841f
780078.8,3.0,11,4,4,3,11,0xb2d254cb
500056.37,2.0,19,4,3,2,9,0xb2d693c2
843816.44,3.0,80,4,4,1,9,0xb2d1a8a2d
150032.6,2.0,101,3,3,1,7,0xb2d11105
10004.48,2.0,214,2,3,1,6,0xb2d64308
565350.85,7.0,0,4,4,4,12,0xb2d0f6e0
351374.65,2.0,0,4,3,4,11,0xb2d68e37
4000.92,1.0,4,2,2,4,8,0xb2d8053b
126.19,1.0,4,1,2,4,7,0xb2d439ff
127.82,1.0,0,1,2,4,7,0xb2d6d112
50000.53,2.0,13,2,3,3,8,0xb2d95d1bd
404.66,1.0,8,1,2,3,6,0xb2d3119ad
15100.79,1.0,92,2,2,1,5,0xb2d5c588
325.78,1.0,24,1,2,2,5,0xb2d5d69f
200962.59,3.0,0,3,4,4,11,0xb2d4b8fad
37827.49,4.0,0,2,4,4,10,0xb2d0952a
406913.02,5.0,3,4,4,4,12,0xb2d64d67
100001.06,2.0,6,3,3,3,9,0xb2da4a76
1296.3,1.0,11,1,2,3,6,0xb2d54bc6
11104.31,1.0,4,2,2,4,8,0xb2d781ad
54621.46,2.0,53,3,3,2,8,0xb2d12134
558021.51,13.0,25,4,4,2,10,0xb2d57e26d
0.0,1.0,28,1,2,2,5,0xb2d29a7ed
350000.0,7.0,3,4,4,4,12,0xb2d5d2cb
11.65,1.0,1,1,2,4,7,0xb2d9b9c1
10.57,1.0,81,1,2,1,4,0xb2d85d80
389603.28,5.0,6,4,4,3,11,0xb2d1723a
0.06,1.0,206,1,2,1,4,0xb2d290d1
190481.18,1.0,81,3,2,1,6,0xb2d4e993
19268.69,1.0,0,2,2,4,8,0xb2d6aa11
503238.48,5.0,74,4,4,1,9,0xb2d1c8db
19309.06,1.0,28,2,2,2,6,0xb2d48bf3d
57.28,1.0,71,1,2,1,4,0xb2d2e4cb
2462893.71,4.0,0,4,4,4,12,0xb2d589bcd
6905.02,1.0,21,2,2,2,6,0xb2d25aa2
819221.36,11.0,2,4,4,4,12,0xb2d143d7
3104.0,3.0,6,2,4,3,9,0xb2d610bc
70000.3,2.0,0,3,3,4,10,0xb2d62f5b
300000.0,6.0,1,3,4,4,11,0xb2d0ccab
10060.78,1.0,10,2,2,3,7,0xb2d8cd69d
187305.53,4.0,160,3,4,1,8,0xb2d59e5b
275132.08,3.0,74,3,4,1,8,0xb2d52dbe
51476.82,2.0,6,2,3,3,8,0xb2d5dbf6d
16.02,1.0,8,1,2,3,6,0xb2d52f1b
301065.65,2.0,42,4,3,2,9,0xb2d9221b
28.11,1.0,87,1,2,1,4,0xb2d63335
12436.95,1.0,2,2,2,4,8,0xb2d787c6
90071.42,2.0,228,3,3,1,7,0xb2d65477
18451.66,1.0,25,2,2,2,6,0xb2d2bd1f
210994.18,5.0,92,3,4,1,8,0xb2d35f49d
0.48,9.0,0,1,4,4,9,0xb2d935a0
1959.65,1.0,121,1,2,1,4,0xb2d57477
382617.65,4.0,0,4,4,4,12,0xb2d5b1e5d
10001.41,2.0,6,2,3,3,8,0xb2d2fa6e
1350014.25,2.0,98,4,3,1,8,0xb2d96fbb
679.57,1.0,9,1,2,3,6,0xb2d56471
13.56,1.0,3,1,2,4,7,0xb2d6adc3
507.84,1.0,0,1,2,4,7,0xb2d93a1b
2222343.71,59.0,0,4,4,4,12,0xb2d2b121
400045.97,2.0,15,4,3,3,10,0xb2d6f73c
90206.87,1.0,4,3,2,4,9,0xb2d58446
4935.15,1.0,15,2,2,3,7,0xb2d8eb8bd
201137.39,2.0,11,3,3,3,9,0xb2d6038a
210617.31,2.0,10,3,3,3,9,0xb2d2d187
4072.95,1.0,0,2,2,4,8,0xb2d61bf3
1015.26,1.0,184,1,2,1,4,0xb2d15965d
383.44,1.0,80,1,2,1,4,0xb2d59e61
3110.83,1.0,0,2,2,4,8,0xb2d5d2e7
1140100.55,7.0,1,4,4,4,12,0xb2d2acc0
502.64,1.0,0,1,2,4,7,0xb2d48c77d
55180.66,2.0,92,3,3,1,7,0xb2d3f1fc
643.2,1.0,3,1,2,4,7,0xb2d57890
300525.71,2.0,4,4,3,4,11,0xb2d6d993d
81289.95,2.0,118,3,3,1,7,0xb2d64427
101018.16,2.0,210,3,3,1,7,0xb2d628b5
111.26,2.0,12,1,3,3,7,0x3b9b3d41
100003.17,3.0,18,3,4,2,9,0xb2d6e591
204722.7,2.0,7,3,3,3,9,0xb2d3a543
497023.34,8.0,8,4,4,3,11,0xb2d1b5aed
2553105.21,7.0,10,4,4,3,11,0xb2d0961c
2.99,1.0,50,1,2,2,5,0xb2d286a8
100105.56,1.0,110,3,2,1,6,0xb2d95af4
500000.0,4.0,0,4,4,4,12,0xb2d9b434
50000.53,2.0,38,2,3,2,7,0xb2d58772d
944000.0,9.0,4,4,4,4,12,0xb2d0b9d0
50606.71,2.0,144,2,3,1,6,0xb2d6d791
201714.85,2.0,19,3,3,2,8,0xb2d6948d
80001.38,5.0,20,3,4,2,9,0xb2d86837
20000.21,2.0,35,2,3,2,7,0xb2d9f964
15944.7,1.0,0,2,2,4,8,0xb2d6481f
1000000.0,2.0,24,4,3,2,9,0xb2d94eef
500000.0,2.0,5,4,3,3,10,0xb2d94d1a
29.24,1.0,55,1,2,2,5,0xb2d9afad
653011.84,6.0,12,4,4,3,11,0xb2d96778
16820.09,1.0,5,2,2,3,7,0xb2d29d49
53152.6,2.0,90,3,3,1,7,0xb2d42b1b
503552.83,2.0,76,4,3,1,8,0xb2d99c0f
678.4,1.0,2,1,2,4,7,0xb2d9ba41
5267.73,1.0,184,2,2,1,5,0xb2d171d0
6836.64,1.0,0,2,2,4,8,0xb2d6a7d0
4.22,1.0,159,1,2,1,4,0xb2d8ed92d
180009.67,2.0,6,3,3,3,9,0xb2d78c69
84.13,1.0,1,1,2,4,7,0xb2d1faf5
404263.92,3.0,33,4,4,2,10,0xb2d766f9d
1050000.53,3.0,4,4,4,4,12,0xb2d931df
2659.25,1.0,10,1,2,3,6,0xb2d985a1
1791.26,2.0,2,1,3,4,8,0xb2d0a317d
300005.29,3.0,165,3,4,1,8,0xb2d8dcf5
546762.22,2.0,25,4,3,2,9,0xb2d3ade6
6801.17,4.0,4,2,4,4,10,0x3b9b4640
1860.26,1.0,42,1,2,2,5,0xb2d6c9a9
27.54,1.0,16,1,2,2,5,0xb2d5d172
10000.11,2.0,6,2,3,3,8,0xb2da3a58
2564.04,1.0,6,1,2,3,6,0xb2d1dc42
4939.58,2.0,3,2,3,4,9,0xb2d8eb44
2045.24,1.0,218,1,2,1,4,0xb2d34b1fd
128977.04,2.0,3,3,3,4,10,0xb2d3497cd
310071.57,7.0,64,4,4,2,10,0xb2d4ff28
4781.96,1.0,19,2,2,2,6,0xb2d5c7c7
4.73,1.0,20,1,2,2,5,0xb2d6bbaf
403359.82,2.0,4,4,3,4,11,0xb2d5bbd1
50.55,1.0,86,1,2,1,4,0xb2d63909
5937.67,1.0,15,2,2,3,7,0xb2d1e033
183004.66,1.0,0,3,2,4,9,0xb2d2ba3e
13.3,1.0,25,1,2,2,5,0xb2d9c74a
1242.65,1.0,210,1,2,1,4,0xb2d0ecde
90001.9,3.0,21,3,4,2,9,0xb2da0803
5.57,1.0,71,1,2,1,4,0x3b9ace14d
6.05,1.0,89,1,2,1,4,0xb2d59db1
153.63,2.0,10,1,3,3,7,0xb2d944d6
405686.29,2.0,136,4,3,1,8,0xb2d9212cd
470965.48,3.0,49,4,4,2,10,0xb2d97d34
160017.37,2.0,20,3,3,2,8,0xb2d5eeded
102711.23,3.0,28,3,4,2,9,0xb2d3c3fa
1.06,1.0,36,1,2,2,5,0xb2d943bd
30037.24,3.0,37,2,4,2,8,0xb2d69c8bd
50088.29,4.0,33,2,4,2,8,0xb2d5a191
80000.53,3.0,4,3,4,4,11,0xb2d9d987
42333.1,1.0,10,2,2,3,7,0xb2d5cf0f
128024.37,3.0,1,3,4,4,11,0xb2d51ee0
419.13,1.0,15,1,2,3,6,0xb2d6af62
370000.0,2.0,12,4,3,3,10,0xb2da46d0
107056.64,2.0,208,3,3,1,7,0xb2d3b389
0.42,1.0,2,1,2,4,7,0xb2d8f07b
400000.0,2.0,25,4,3,2,9,0xb2da1c28
72364.42,93.0,1,3,4,4,11,0xb2d4a6e0d
0.56,2.0,39,1,3,2,6,0xb2d1f9d5
20894.1,1.0,3,2,2,4,8,0xb2d6739a
409049.78,4.0,0,4,4,4,12,0xb2d5e478d
2565.14,1.0,10,1,2,3,6,0xb2d3e969
602131.26,4.0,33,4,4,2,10,0xb2da0373
540000.0,2.0,3,4,3,4,11,0xb2d97e26
974164.84,5.0,0,4,4,4,12,0x3b9b2a77d
637902.65,3.0,92,4,4,1,9,0x3b9ade4b
80100.77,3.0,34,3,4,2,9,0xb2d09f72
101247.21,1.0,182,3,2,1,6,0xb2d637df
2.96,1.0,78,1,2,1,4,0xb2d98b08
4030.65,1.0,3,2,2,4,8,0xb2d5055f
71893.28,3.0,8,3,4,3,10,0xb2d62b8c
10001.27,2.0,92,2,3,1,6,0xb2d62eaf
15585.27,1.0,0,2,2,4,8,0xb2d4cf0b
7700.39,1.0,52,2,2,2,6,0xb2d5ffa2
327000.42,3.0,25,4,4,2,10,0xb2da0a07
170045.08,3.0,73,3,4,1,8,0xb2d2e393
10.6,1.0,17,1,2,2,5,0xb2d41251d
37146.49,1.0,184,2,2,1,5,0x3b9ade60
21792.4,3.0,0,2,4,4,10,0xb2d930e1
543425.3,4.0,11,4,4,3,11,0xb2d4f6d0
314508.19,1.0,8,4,2,3,9,0xb2da23d8
561200.59,5.0,24,4,4,2,10,0xb2d5f12a
600101.7,3.0,27,4,4,2,10,0xb2d3e486d
2.87,1.0,184,1,2,1,4,0xb2d288b4
2690959.68,4.0,1,4,4,4,12,0xb2d23808
16489.42,1.0,139,2,2,1,5,0xb2d8c9a0
3301.08,1.0,7,2,2,3,7,0xb2d698ab
239418.7,1.0,82,3,2,1,6,0xb2d3b45c
8288.82,1.0,184,2,2,1,5,0xb2d32843
22473.83,1.0,0,2,2,4,8,0xb2d3d6b2d
55.33,1.0,1,1,2,4,7,0xb2d61f61
35116.07,3.0,18,2,4,2,8,0xb2d1b239
1919.07,1.0,0,1,2,4,7,0xb2d91240
1470044.12,3.0,42,4,4,2,10,0xb2d9cc3f
1206.93,1.0,92,1,2,1,4,0xb2d2babd
16.77,1.0,6,1,2,3,6,0xb2d59c31
40.12,2.0,53,1,3,2,6,0xb2d0e47c
13303.72,1.0,3,2,2,4,8,0xb2d6bdbf
666702.26,4.0,27,4,4,2,10,0xb2d46350
9505.52,1.0,0,2,2,4,8,0xb2d6da65
3203.67,1.0,73,2,2,1,5,0xb2d8cd3c
812319.06,2.0,6,4,3,3,10,0xb2d4cab3d
320060.05,4.0,12,4,4,3,11,0xb2d9daf0
1250.26,1.0,184,1,2,1,4,0xb2d2f3c6
104485.78,3.0,60,3,4,2,9,0xb2d1d0b6
500041.07,2.0,13,4,3,3,10,0xb2d3c7dd
2394.6,1.0,53,1,2,2,5,0xb2d2748f
151705.34,2.0,33,3,3,2,8,0xb2d95d81
2963175.35,6.0,70,4,4,1,9,0xb2d339c6
2.56,1.0,81,1,2,1,4,0xb2d6b546
80102.61,2.0,73,3,3,1,7,0xb2d8dfa6
8952.95,1.0,0,2,2,4,8,0xb2d2fe89
13422.84,1.0,20,2,2,2,6,0xb2d8d98a
24369.82,1.0,1,2,2,4,8,0xb2d4f168
260043.39,3.0,8,3,4,3,10,0xb2d142ee
110000.0,9.0,0,3,4,4,11,0xb2d9825b
102.98,1.0,11,1,2,3,6,0xb2d2f9d8
40027.14,2.0,4,2,3,4,9,0xb2d5f6e4
515391.76,19.0,25,4,4,2,10,0xb2d2847b
4677.74,1.0,25,2,2,2,6,0xb2d9c2fc
600006.33,2.0,76,4,3,1,8,0xb2d8d9bc
1416.46,1.0,9,1,2,3,6,0xb2d24f21
4126.92,1.0,0,2,2,4,8,0xb2d6c3f4
5201.31,2.0,184,2,3,1,6,0x3b9b4925d
10314.51,1.0,0,2,2,4,8,0xb2d781b4d
164.2,1.0,10,1,2,3,6,0xb2d262c1
38342.02,1.0,2,2,2,4,8,0xb2d6c218
1946.87,1.0,0,1,2,4,7,0xb2d8de2b
1679598.18,83.0,0,4,4,4,12,0x3b9b12b9
422015.41,6.0,19,4,4,2,10,0xb2d6c821
1092.52,1.0,182,1,2,1,4,0xb2d30fbe
201391.54,1.0,5,3,2,3,8,0xb2d6512fd
26698.41,3.0,10,2,4,3,9,0xb2d43053
10269.63,2.0,48,2,3,2,7,0xb2d5d4a9
111015.21,4.0,104,3,4,1,8,0xb2d5d25b
146.33,1.0,2,1,2,4,7,0xb2d6b3e8
90045.4,4.0,0,3,4,4,11,0xb2d5774ad
2262.22,1.0,49,1,2,2,5,0xb2d6294e
1254.28,1.0,184,1,2,1,4,0xb2d21456
284425.79,2.0,87,3,3,1,7,0xb2d31684
1998997.56,15.0,7,4,4,3,11,0xb2d6591c
209255.79,2.0,76,3,3,1,7,0xb2d5ec2cd
150000.0,2.0,3,3,3,4,10,0xb2d97ac4
4.91,1.0,28,1,2,2,5,0xb2d6a63e
233832.68,2.0,179,3,3,1,7,0xb2d122d7
1118386.33,7.0,2,4,4,4,12,0xb2d2bc40
50039.02,3.0,95,2,4,1,7,0xb2d082abd
3678.83,1.0,17,2,2,2,6,0xb2d264ff
208800.0,2.0,0,3,3,4,10,0xb2da6c6c
2545581.59,5.0,62,4,4,2,10,0xb2d42df7
2756.32,4.0,0,1,4,4,9,0x3b9b184c
8023252.1,2.0,34,4,3,2,9,0xb2d4279e
12295.65,1.0,0,2,2,4,8,0xb2d97a5f
20016.09,2.0,27,2,3,2,7,0xb2d5c051
65.24,1.0,35,1,2,2,5,0xb2d689b0
153100.2,3.0,136,3,4,1,8,0xb2d2050b
3376.6,16.0,4,2,4,4,10,0xb2d0a00b
66688.67,1.0,0,3,2,4,9,0xb2d32479
320383.4,4.0,49,4,4,2,10,0xb2d4643ed
3246.23,1.0,184,2,2,1,5,0xb2d1e43ad
136118.51,6.0,1,3,4,4,11,0xb2d16f1f
85.59,1.0,43,1,2,2,5,0xb2d77f0a
84.42,1.0,0,1,2,4,7,0xb2d2b617
1536988.46,4.0,3,4,4,4,12,0xb2d3b47b
91.72,1.0,3,1,2,4,7,0xb2d96eb4
221618.05,2.0,34,3,3,2,8,0xb2d6d69e
100017.67,3.0,6,3,4,3,10,0xb2d9312a
111619.37,2.0,200,3,3,1,7,0xb2d5757bd
7803.54,1.0,0,2,2,4,8,0xb2d93cdc
85440.0,1.0,0,3,2,4,9,0xb2d1de42
244478.08,3.0,189,3,4,1,8,0xb2d3f1d3
60410.75,2.0,139,3,3,1,7,0xb2d4c81f
205689.89,2.0,135,3,3,1,7,0xb2d6ce18
11404.9,1.0,28,2,2,2,6,0xb2d23dd3
755028.43,7.0,102,4,4,1,9,0xb2d41085
30563.33,2.0,11,2,3,3,8,0xb2d5ba07d
290012.17,2.0,0,3,3,4,10,0xb2d17ff0
3174296.75,13.0,9,4,4,3,11,0xb2d1c8d5
310003.27,3.0,43,4,4,2,10,0xb2d9d3ef
472009.77,12.0,0,4,4,4,12,0xb2d58710
2454.8,1.0,1,1,2,4,7,0xb2d3ea53
47.39,1.0,20,1,2,2,5,0xb2d78503
494339.23,5.0,10,4,4,3,11,0xb2d51171
15009.78,1.0,19,2,2,2,6,0xb2d68efb
200711.52,2.0,46,3,3,2,8,0xb2d9e1a9
8607.32,1.0,14,2,2,3,7,0xb2d95d86
400000.5,2.0,0,4,3,4,11,0xb2da6ac0
356815.44,6.0,3,4,4,4,12,0xb2d23362
150001.58,2.0,49,3,3,2,8,0xb2d9d7d3
921007.86,12.0,0,4,4,4,12,0xb2d58675
2781.94,1.0,25,1,2,2,5,0xb2d304d5
419.04,1.0,0,1,2,4,7,0xb2d305e9
50006.11,1.0,13,2,2,3,7,0xb2d9c6c6
32.25,1.0,61,1,2,2,5,0xb2d7bd2dd
835675.37,9.0,11,4,4,3,11,0xb2d242d7d
238250.1,3.0,75,3,4,1,8,0xb2d1f0df
822.18,1.0,18,1,2,2,5,0xb2d5f34b
100088.72,2.0,108,3,3,1,7,0xb2d572b9
440076.49,4.0,5,4,4,3,11,0xb2d42469
2.71,1.0,54,1,2,2,5,0xb2d16d12
217381.0,5.0,1,3,4,4,11,0xb2d4e5c8d
497.31,1.0,5,1,2,3,6,0xb2d69c2e
535855.4,2.0,0,4,3,4,11,0xb2d8faf2
8.16,2.0,4,1,3,4,8,0xb2d5823d
2.64,1.0,82,1,2,1,4,0xb2d62395
55510.42,2.0,208,3,3,1,7,0xb2d287a4
150007.29,3.0,102,3,4,1,8,0xb2d3a83b
49558.9,1.0,133,2,2,1,5,0xb2d3616e
44.33,1.0,10,1,2,3,6,0xb2d955df
69.8,1.0,1,1,2,4,7,0xb2d775de
200584.69,7.0,0,3,4,4,11,0xb2d1ba50
887.28,1.0,9,1,2,3,6,0xb2d2e24c
438.06,1.0,0,1,2,4,7,0xb2d38a4b
42289.82,1.0,112,2,2,1,5,0xb2d60d9d
561079.5,5.0,0,4,4,4,12,0xb2d43a88
3762.41,1.0,13,2,2,3,7,0xb2d30716
101251.85,3.0,32,3,4,2,9,0xb2d3a8fc
40000.42,2.0,6,2,3,3,8,0xb2d6404dd
101896.99,1.0,1,3,2,4,9,0xb2d8cf21
2197.28,1.0,0,1,2,4,7,0xb2d906dd
120001.9,2.0,96,3,3,1,7,0xb2d96e65
2.81,1.0,15,1,2,3,6,0xb2d3f50fd
14813.08,1.0,14,2,2,3,7,0xb2d6bda1
150100.45,2.0,28,3,3,2,8,0xb2d613e2
38729.42,2.0,20,2,3,2,7,0xb2d4ad8a
0.04,1.0,83,1,2,1,4,0xb2d64242
88.61,1.0,119,1,2,1,4,0xb2d5ccba
21825.58,1.0,1,2,2,4,8,0xb2d9f30f
26.68,1.0,0,1,2,4,7,0xb2d681e1
233009.58,3.0,150,3,4,1,8,0xb2d0e8aa
300005.86,3.0,123,3,4,1,8,0xb2d5bd82
10000.42,2.0,94,2,3,1,6,0xb2d858bd
5009.19,1.0,144,2,2,1,5,0xb2d904ce
4438.91,1.0,0,2,2,4,8,0xb2d6d06c
98150.97,2.0,3,3,3,4,10,0xb2d64e8ad
260055.67,4.0,21,3,4,2,9,0xb2d9c5ff
421.81,1.0,2,1,2,4,7,0xb2d6c654
110437.45,4.0,4,3,4,4,11,0xb2d68748
672506.18,2.0,0,4,3,4,11,0xb2d5e0a8
752025.06,4.0,3,4,4,4,12,0xb2d0d659
160442.83,1.0,1,3,2,4,9,0xb2d58cd9
213000.0,5.0,0,3,4,4,11,0xb2d637c3
1866.72,1.0,92,1,2,1,4,0x3b9b2303
10000.11,2.0,18,2,3,2,7,0xb2d958c0
963.21,1.0,9,1,2,3,6,0xb2d3b66d
129949.77,9.0,14,3,4,3,10,0x3b9b1a05
52476.26,2.0,129,3,3,1,7,0xb2d2aa82
100001.59,3.0,130,3,4,1,8,0xb2d87a10
903023.21,10.0,6,4,4,3,11,0xb2d62f15
53555.37,2.0,228,3,3,1,7,0xb2d3e618
370003.59,4.0,6,4,4,3,11,0xb2da3987
1626160.17,4.0,10,4,4,3,11,0xb2d14fed
807003.16,14.0,2,4,4,4,12,0xb2d1722fd
6079.85,1.0,3,2,2,4,8,0xb2d2de98
9314.89,1.0,0,2,2,4,8,0xb2d6c1aad
10000.21,2.0,110,2,3,1,6,0xb2d90384d
8200000.0,2.0,1,4,3,4,11,0xb2da65b6
2661246.44,30.0,0,4,4,4,12,0xb2d138cd
41052.77,3.0,24,2,4,2,8,0xb2d5ce7cd
303.08,1.0,1,1,2,4,7,0xb2d60d24
2911.47,1.0,0,2,2,4,8,0xb2d5bde3d
250290.53,2.0,7,3,3,3,9,0xb2d33fe8
3047.24,1.0,21,2,2,2,6,0xb2d699f1
2497858.42,5.0,4,4,4,4,12,0xb2d178ce
120000.0,3.0,1,3,4,4,11,0xb2d8c9b3
71382.23,1.0,0,3,2,4,9,0xb2d5707e
74037.72,2.0,10,3,3,3,9,0xb2d9a653
30011.4,1.0,46,2,2,2,6,0xb2d9e429
6631.69,1.0,0,2,2,4,8,0xb2d6bb19
23.26,1.0,82,1,2,1,4,0xb2d62537
36057.4,1.0,19,2,2,2,6,0xb2d5d459
1564638.81,3.0,1,4,4,4,12,0xb2d20607
360644.19,4.0,59,4,4,2,10,0xb2d78521
292.58,2.0,10,1,3,3,7,0xb2d17920
401544.47,3.0,20,4,4,2,10,0xb2d16d9c
400003.34,5.0,14,4,4,3,11,0xb2d9232fd
1329947.77,5.0,111,4,4,1,9,0xb2d5611b
30011.2,1.0,1,2,2,4,8,0xb2d6bd2ad
3711.26,1.0,4,2,2,4,8,0xb2d3f1da
200068.87,2.0,7,3,3,3,9,0xb2d9d347
16077.8,2.0,304,2,3,1,6,0xb2d07bc6
62106.31,2.0,196,3,3,1,7,0xb2d53778
2499.02,1.0,0,1,2,4,7,0xb2d1d03b
2586.64,1.0,2,1,2,4,7,0xb2d9372e
44831.21,1.0,76,2,2,1,5,0xb2d99e05
27143.88,3.0,1,2,4,4,10,0xb2d101ad
119.18,1.0,4,1,2,4,7,0xb2d374cfd
103002.15,4.0,212,3,4,1,8,0xb2d6efb2
0.0,1.0,184,1,2,1,4,0xb2d6061f
1172.29,1.0,92,1,2,1,4,0xb2d27237
357203.53,4.0,61,4,4,2,10,0xb2d697b8
380000.0,2.0,48,4,3,2,9,0xb2d9dd21
60.36,1.0,18,1,2,2,5,0xb2d9acae
1007417.02,4.0,3,4,4,4,12,0xb2d695c4
134510.13,2.0,143,3,3,1,7,0xb2d637e2
440309.43,3.0,42,4,4,2,10,0xb2d42769
600007.92,2.0,0,4,3,4,11,0xb2d97480d
364474.91,12.0,32,4,4,2,10,0xb2d07146
703.93,1.0,7,1,2,3,6,0xb2d6f55a
1361.2,1.0,1,1,2,4,7,0xb2d2f7cd
254375.44,2.0,4,3,3,4,10,0xb2d53033
433886.58,2.0,6,4,3,3,10,0xb2d14943
919.92,1.0,0,1,2,4,7,0xb2d692add
2.32,1.0,10,1,2,3,6,0xb2d92865
51091.91,2.0,55,2,3,2,7,0xb2d0b292d
350069.03,3.0,80,4,4,1,9,0xb2d5ef75
170036.5,3.0,6,3,4,3,10,0xb2d0832b
6326.26,1.0,7,2,2,3,7,0xb2d4a97d
2331.37,1.0,287,1,2,1,4,0xb2d41a66
547325.31,2.0,92,4,3,1,8,0xb2d65609
1470665.45,10.0,6,4,4,3,11,0xb2d3bf7fd
493045.03,4.0,1,4,4,4,12,0xb2d23d76d
1270000.05,2.0,20,4,3,2,9,0xb2d78c77
2197.61,1.0,1,1,2,4,7,0xb2d931ff
11309.96,1.0,5,2,2,3,7,0xb2d24d1f
244.56,5.0,4,1,4,4,9,0xb2d86ee3
0.23,1.0,32,1,2,2,5,0xb2d9099bd
249000.82,3.0,13,3,4,3,10,0xb2d95d0d
1125982.35,5.0,11,4,4,3,11,0xb2d0b623
508090.35,7.0,12,4,4,3,11,0xb2d12aa7
6548.15,1.0,1,2,2,4,8,0xb2d629f6
435.87,1.0,20,1,2,2,5,0xb2d65998
60685.44,1.0,0,3,2,4,9,0xb2d72488
4983.63,1.0,3,2,2,4,8,0xb2d08707
367713.9,1.0,5,4,2,3,9,0xb2d4fa51d
100260.46,2.0,101,3,3,1,7,0xb2d0f1a8
1468733.83,8.0,39,4,4,2,10,0xb2d13d6e
1124019.96,5.0,10,4,4,3,11,0xb2d17ddb
93002.94,3.0,80,3,4,1,8,0xb2d6f9c2
3276.93,1.0,0,2,2,4,8,0xb2d57a89
40912.15,3.0,4,2,4,4,10,0x3b9b4581d
595798.33,6.0,18,4,4,2,10,0xb2d4684a
240039.69,5.0,31,3,4,2,9,0xb2d57e30
603.03,4.0,0,1,4,4,9,0xb2d090fe
23000.0,1.0,2,2,2,4,8,0xb2d4ec1f
220028.87,2.0,15,3,3,3,9,0xb2da1610
15810.11,1.0,0,2,2,4,8,0xb2d68ede
2012.17,1.0,18,1,2,2,5,0xb2d38a9b
25329.06,1.0,0,2,2,4,8,0xb2d905aa
473194.52,10.0,6,4,4,3,11,0xb2d377eb
652.55,1.0,28,1,2,2,5,0xb2d434f2
600849.02,4.0,5,4,4,3,11,0xb2d69086
561114.78,1.0,6,4,2,3,9,0xb2d5aac8
8295.26,4.0,92,2,4,1,7,0xb2d381f8d
43220.32,1.0,92,2,2,1,5,0xb2d30864d
1256.6,1.0,92,1,2,1,4,0xb2d25124
220039.63,4.0,66,3,4,2,9,0xb2d56f9a
236009.96,3.0,69,3,4,1,8,0xb2d8e673
1201987.77,7.0,13,4,4,3,11,0xb2d6aba8
5134.7,1.0,25,2,2,2,6,0xb2d67d8dd
33094.21,3.0,0,2,4,4,10,0xb2d51f27d
40757.71,1.0,6,2,2,3,7,0xb2d92bfbd
5296.59,1.0,0,2,2,4,8,0xb2d90d69
21311.78,1.0,3,2,2,4,8,0xb2d6fdb7
278720.8,2.0,26,3,3,2,8,0xb2d11292
191562.42,12.0,1,3,4,4,11,0xb2d9fac1
10363.11,1.0,133,2,2,1,5,0xb2d3e99ed
1091.99,1.0,67,1,2,1,4,0xb2d5d224
3059.93,1.0,0,2,2,4,8,0xb2d52734
198022.63,4.0,70,3,4,1,8,0xb2d1500c
167400.0,8.0,0,3,4,4,11,0xb2d066b5
19.13,1.0,14,1,2,3,6,0xb2da0061
521354.24,2.0,120,4,3,1,8,0xb2d5a761d
2.8,1.0,36,1,2,2,5,0xb2d53590
2.84,1.0,31,1,2,2,5,0xb2d2cf20
200009.5,3.0,41,3,4,2,9,0xb2d9e4f3
756106.11,1.0,0,4,2,4,10,0xb2d6aba7
240003.66,3.0,12,3,4,3,10,0xb2d59a64
55024.82,1.0,10,3,2,3,8,0xb2d6da42d
0.0,1.0,0,1,2,4,7,0xb2d0d62c
8096.81,1.0,7,2,2,3,7,0xb2d9ffca
5.36,1.0,10,1,2,3,6,0xb2d32bec
1541.08,2.0,0,1,3,4,8,0x3b9b45c0
725429.13,13.0,0,4,4,4,12,0xb2d43c49
230017.75,4.0,97,3,4,1,8,0xb2d11c94
1708.99,1.0,92,1,2,1,4,0xb2d3464b
724668.4,4.0,0,4,4,4,12,0xb2d3f751
20966.47,1.0,3,2,2,4,8,0xb2d35b6f
105459.56,2.0,235,3,3,1,7,0xb2d547fa
107601.69,5.0,0,3,4,4,11,0xb2d4a3fb
150006.44,2.0,10,3,3,3,9,0xb2d415e6
3204.19,1.0,45,2,2,2,6,0xb2d8c5ca
10136.47,1.0,184,2,2,1,5,0xb2d2333c
10016.95,1.0,28,2,2,2,6,0xb2d2b6bed
30001.3,3.0,33,2,4,2,8,0xb2d0fcc0
30191.36,1.0,92,2,2,1,5,0xb2d405a2
18640.93,1.0,1,2,2,4,8,0xb2d1c20e
10334.35,1.0,70,2,2,1,5,0xb2d5d462
498084.09,10.0,1,4,4,4,12,0xb2d14440
760009.89,8.0,7,4,4,3,11,0xb2d5b72d
170.02,1.0,25,1,2,2,5,0xb2d305c0
17534.71,1.0,10,2,2,3,7,0xb2d6f37c
1390.54,2.0,184,1,3,1,5,0x3b9b4678d
203554.26,2.0,129,3,3,1,7,0xb2d8f1ded
490709.02,11.0,76,4,4,1,9,0xb2d1a782
3022.01,1.0,0,2,2,4,8,0xb2d7c1ae
1000005.48,3.0,23,4,4,2,10,0xb2d6f2dc
624488.01,5.0,0,4,4,4,12,0xb2d21113
31951.21,1.0,12,2,2,3,7,0xb2d6c8ab
5655.66,1.0,75,2,2,1,5,0xb2d2f55c
828187.94,3.0,3,4,4,4,12,0xb2d590ae
110330.86,3.0,53,3,4,2,9,0xb2d6396a
9822.07,2.0,20,2,3,2,7,0xb2d573d3
1329570.88,5.0,2,4,4,4,12,0xb2d1ca3c
549464.78,2.0,92,4,3,1,8,0xb2d2d126
4662.03,1.0,5,2,2,3,7,0xb2d94340
216675.71,1.0,9,3,2,3,8,0xb2d315ac
204547.61,2.0,27,3,3,2,8,0xb2d4170a
102.11,1.0,49,1,2,2,5,0xb2d3afee
100003.27,3.0,31,3,4,2,9,0xb2d38085d
280814.94,3.0,133,3,4,1,8,0xb2d2572c
358.31,1.0,2,1,2,4,7,0xb2d5302b
220010.52,4.0,97,3,4,1,8,0xb2d20136d
1323.75,1.0,92,1,2,1,4,0xb2d1c9fe
6528.4,1.0,18,2,2,2,6,0xb2d5cf32
22930.48,1.0,14,2,2,3,7,0xb2d6d7d6d
502106.76,3.0,26,4,4,2,10,0xb2d64dc6
461818.53,3.0,3,4,4,4,12,0xb2d502ae
133000.0,6.0,65,3,4,2,9,0xb2d3e7d2d
109907.49,8.0,13,3,4,3,10,0xb2d09239
130.47,1.0,4,1,2,4,7,0xb2d26cbe
2.97,1.0,127,1,2,1,4,0xb2d43fe4
1346820.48,3.0,80,4,4,1,9,0xb2d53767
1599.35,1.0,24,1,2,2,5,0xb2d1e078
6.33,1.0,60,1,2,2,5,0xb2d9b90d
19837.67,1.0,10,2,2,3,7,0xb2d374ab
0.0,1.0,7,1,2,3,6,0xb2d3933e
29722.28,1.0,20,2,2,2,6,0xb2d6aa83
742441.66,6.0,7,4,4,3,11,0xb2d19e77
380584.46,4.0,20,4,4,2,10,0xb2d458c9
442658.91,2.0,0,4,3,4,11,0xb2d067cd
0.01,1.0,10,1,2,3,6,0xb2d2b191d
54204.94,2.0,228,3,3,1,7,0xb2d2e9fc
1066.28,1.0,21,1,2,2,5,0xb2d187ba
5937.34,1.0,15,2,2,3,7,0xb2d9b401
158000.0,3.0,0,3,4,4,11,0xb2d52029
69492.55,2.0,8,3,3,3,9,0xb2d0ed2b
4068.49,1.0,12,2,2,3,7,0xb2d23c2a
1531.44,1.0,12,1,2,3,6,0xb2d2abcd
50000.53,2.0,24,2,3,2,7,0xb2d94b93
265764.29,2.0,0,3,3,4,10,0xb2d646b8
10.13,1.0,50,1,2,2,5,0xb2d98f64
200711.42,2.0,7,3,3,3,9,0xb2d9fc12
1982407.63,8.0,3,4,4,4,12,0xb2d1806c
465007.65,4.0,5,4,4,3,11,0xb2d57999
120003.8,2.0,27,3,3,2,8,0xb2d9401b
559.25,1.0,27,1,2,2,5,0xb2d9328e
967.92,1.0,56,1,2,2,5,0xb2d34472d
439246.23,6.0,1,4,4,4,12,0xb2d1a0a2
320020.98,3.0,92,4,4,1,9,0xb2d59701
1161.68,1.0,184,1,2,1,4,0xb2d271b0
4438.68,1.0,10,2,2,3,7,0xb2d20862d
630000.0,3.0,1,4,4,4,12,0xb2d9c7a9
10100.39,2.0,213,2,3,1,6,0xb2d62fd6d
9513.42,1.0,0,2,2,4,8,0xb2d8ddd1
502137.93,5.0,56,4,4,2,10,0xb2d5da45
101080.83,2.0,216,3,3,1,7,0xb2d5fff9
110747.35,3.0,14,3,4,3,10,0xb2d59dff
72209.92,9.0,0,3,4,4,11,0x3b9af27d
100005.28,2.0,97,3,3,1,7,0xb2d65346
105459.12,2.0,143,3,3,1,7,0xb2d547fad
13026.54,1.0,0,2,2,4,8,0xb2d311ae
946025.72,7.0,9,4,4,3,11,0xb2d6be39d
307470.67,2.0,235,4,3,1,8,0xb2d5b73d
1073.22,1.0,9,1,2,3,6,0xb2d2b961
1000000.19,2.0,6,4,3,3,10,0xb2d6cb55
230847.56,5.0,6,3,4,3,10,0xb2d326df
38.0,1.0,25,1,2,2,5,0xb2da0954
19611.71,1.0,20,2,2,2,6,0xb2d319a3
3810.26,1.0,0,2,2,4,8,0xb2d7c54ad
44.63,1.0,9,1,2,3,6,0xb2d3898f
62903.64,1.0,1,3,2,4,9,0xb2d402f0
111053.48,2.0,104,3,3,1,7,0xb2d55c3e
650017.82,2.0,14,4,3,3,10,0xb2d9a101
581102.47,3.0,25,4,4,2,10,0xb2d9a660
1002018.37,4.0,13,4,4,3,11,0xb2d8df2f
131876.11,3.0,63,3,4,2,9,0xb2d2670c
172601.36,3.0,6,3,4,3,10,0xb2d231b8
30000.95,2.0,228,2,3,1,6,0xb2d6f385
50831.22,3.0,21,2,4,2,8,0xb2d2b0f9d
5961.18,1.0,21,2,2,2,6,0xb2d412f0
300083.7,3.0,0,3,4,4,11,0xb2d0a876
36.69,1.0,0,1,2,4,7,0xb2d1e8c2
140000.0,2.0,1,3,3,4,10,0xb2da5e69
11737.79,1.0,12,2,2,3,7,0xb2d4f256
252341.66,2.0,80,3,3,1,7,0xb2d321e7
7538.46,1.0,11,2,2,3,7,0xb2d2d0cc
24532.74,1.0,0,2,2,4,8,0xb2d39381
51097.15,3.0,4,2,4,4,10,0xb2d19a36
3862.65,1.0,208,2,2,1,5,0xb2d3aff3d
43.28,1.0,33,1,2,2,5,0xb2d62826
389557.64,4.0,0,4,4,4,12,0xb2d0ea35
203932.06,2.0,1,3,3,4,10,0xb2d61cc1
254306.85,2.0,84,3,3,1,7,0xb2d68e3bd
3327394.79,26.0,0,4,4,4,12,0x3b9b0e5f
3203.72,1.0,1,2,2,4,8,0xb2d2f98b
50132.77,1.0,21,2,2,2,6,0xb2d745f2
410000.32,1.0,0,4,2,4,10,0xb2d5b772d
20010.64,2.0,56,2,3,2,7,0xb2d69e8f
1081129.36,3.0,3,4,4,4,12,0xb2d48189
4165549.36,7.0,4,4,4,4,12,0xb2d5d70e
100283.15,1.0,92,3,2,1,6,0xb2d5b303
929.03,1.0,28,1,2,2,5,0xb2d42390
2.49,1.0,15,1,2,3,6,0xb2d67de3d
589031.46,6.0,0,4,4,4,12,0xb2d3c624
19138.71,1.0,9,2,2,3,7,0xb2d975a0
166.02,1.0,6,1,2,3,6,0xb2d3c1d5
7882.35,1.0,0,2,2,4,8,0xb2d6d202
160003.3,4.0,27,3,4,2,9,0xb2d63a5d
6.32,2.0,13,1,3,3,7,0xb2d0e9e6
20000.74,2.0,35,2,3,2,7,0xb2d9f7de
11448.82,2.0,0,2,3,4,9,0xb2d426a3
150506.49,2.0,24,3,3,2,8,0xb2d5fd09
7583.15,1.0,184,2,2,1,5,0xb2d250e2
490081.05,2.0,10,4,3,3,10,0xb2d99f73
251442.79,3.0,63,3,4,2,9,0xb2d573ad
576922.74,12.0,1,4,4,4,12,0xb2d22e9a
306966.1,4.0,0,4,4,4,12,0xb2d1fcfed
600003.81,2.0,11,4,3,3,10,0xb2d588d7d
8317.85,1.0,22,2,2,2,6,0xb2d218f3
2437.61,1.0,1,1,2,4,7,0xb2d1d897
101455.29,1.0,1,3,2,4,9,0xb2d623bd
11.59,1.0,48,1,2,2,5,0xb2d933d4
1.77,1.0,10,1,2,3,6,0xb2d97f82
115006.81,3.0,196,3,4,1,8,0xb2d239eed
250004.22,3.0,14,3,4,3,10,0xb2da1b16
35552.55,3.0,3,2,4,4,10,0xb2da4e68
500038.65,2.0,123,4,3,1,8,0xb2d62c19
159.85,1.0,9,1,2,3,6,0xb2d2ead6
51828.56,1.0,106,2,2,1,5,0xb2d61b6ad
84770.71,2.0,21,3,3,2,8,0xb2d06920
130611.53,1.0,5,3,2,3,8,0xb2d187e7
1074.76,2.0,207,1,3,1,5,0x3b9b23da
87944.18,7.0,0,3,4,4,11,0xb2d161b9
55536.0,2.0,25,3,3,2,8,0xb2d31bbe
530438.48,3.0,1,4,4,4,12,0xb2d0fb63
4022.03,1.0,9,2,2,3,7,0xb2d6eeef
409335.53,2.0,2,4,3,4,11,0xb2d20346
261.8,1.0,6,1,2,3,6,0xb2d9344f
550326.2,5.0,3,4,4,4,12,0xb2d61a18
18625.46,1.0,22,2,2,2,6,0xb2d21332d
848031.32,10.0,25,4,4,2,10,0xb2d3d2d9
296037.68,24.0,0,3,4,4,11,0x3b9b2604
92468.3,2.0,0,3,3,4,10,0xb2d6044cd
2429.97,1.0,14,1,2,3,6,0xb2d8c809
50321.88,2.0,19,2,3,2,7,0xb2d6a679
10000.0,2.0,8,2,3,3,8,0xb2da2073
997.66,1.0,5,1,2,3,6,0xb2d8e704
48764.8,1.0,16,2,2,2,6,0xb2d2d902
13.48,1.0,14,1,2,3,6,0xb2d6fb21
50012.12,2.0,147,2,3,1,6,0xb2d8ebce
1106388.76,9.0,1,4,4,4,12,0xb2d18006d
5.28,1.0,8,1,2,3,6,0xb2d5374c
280005.91,2.0,48,3,3,2,8,0xb2d91204
879.53,2.0,0,1,3,4,8,0xb2d1dd17
31180.67,1.0,17,2,2,2,6,0xb2d5ca2a
1158599.97,4.0,70,4,4,1,9,0xb2d22d02
932014.43,7.0,21,4,4,2,10,0xb2d25cd2
335348.88,5.0,11,4,4,3,11,0xb2d16fca
964900.93,5.0,4,4,4,4,12,0xb2d2b5a1d
68.64,1.0,25,1,2,2,5,0xb2d10837
1484.85,1.0,22,1,2,2,5,0xb2d30a58
9426.42,1.0,92,2,2,1,5,0xb2d4663a
11427.98,1.0,3,2,2,4,8,0xb2d34367d
4918.77,2.0,92,2,3,1,6,0x3b9b356e
650032.19,3.0,69,4,4,1,9,0xb2d97f5dd
270022.36,2.0,4,3,3,4,10,0xb2d6ac7b
13000.56,2.0,36,2,3,2,7,0xb2d616ca
1.16,1.0,9,1,2,3,6,0xb2d570ad
95390.24,4.0,3,3,4,4,11,0xb2d5daaa
392429.94,7.0,0,4,4,4,12,0xb2d36b46
0.0,1.0,7,1,2,3,6,0xb2d926c3
32.25,1.0,21,1,2,2,5,0xb2d2a4c0
63014.0,2.0,122,3,3,1,7,0xb2d1d6c3d
1029.67,1.0,145,1,2,1,4,0xb2d28a86d
92.25,1.0,9,1,2,3,6,0xb2d69773
605692.55,4.0,80,4,4,1,9,0xb2d594b1
340839.73,4.0,83,4,4,1,9,0xb2d3f60d
1814.4,1.0,10,1,2,3,6,0xb2d4f7ec
1300027.44,2.0,31,4,3,2,9,0xb2d939c2d
115310.72,4.0,13,3,4,3,10,0xb2d4db65
37001.37,6.0,7,2,4,3,9,0xb2d53f17
1816068.53,4.0,8,4,4,3,11,0xb2d93a6ad
14014.59,5.0,105,2,4,1,7,0xb2d25aa7
19902.3,1.0,1,2,2,4,8,0xb2d535d1
342501.54,4.0,0,4,4,4,12,0xb2d62704
273011.63,6.0,33,3,4,2,9,0xb2d47270d
52518.79,2.0,73,3,3,1,7,0xb2d20a98
22.76,1.0,5,1,2,3,6,0xb2d1d090
204346.25,2.0,22,3,3,2,8,0xb2d56b03
2341987.15,9.0,11,4,4,3,11,0xb2d64eed
100004.22,2.0,42,3,3,2,8,0xb2d9e58e
257353.31,1.0,81,3,2,1,6,0xb2d65eb8
500265.51,4.0,12,4,4,3,11,0xb2da0e05
5603703.17,14.0,0,4,4,4,12,0x3b9b287d
850000.48,6.0,0,4,4,4,12,0xb2d2279d
7632.46,2.0,0,2,3,4,9,0xb2d2f694
1031.07,1.0,0,1,2,4,7,0xb2d3453fd
8402.4,1.0,11,2,2,3,7,0xb2d8da63
220001.27,2.0,0,3,3,4,10,0xb2d6423b
450803.32,3.0,21,4,4,2,10,0xb2d8252c
978.63,1.0,9,1,2,3,6,0xb2d58dcd
9553.65,1.0,4,2,2,4,8,0xb2d38a1e
18.23,2.0,2,1,3,4,8,0xb2d16f82
50873.38,2.0,192,2,3,1,6,0xb2d5db8f
150001.59,3.0,70,3,4,1,8,0xb2d911c7
69.82,1.0,2,1,2,4,7,0xb2d28379
6893.42,1.0,77,2,2,1,5,0xb2d430de
20001.12,2.0,66,2,3,2,7,0xb2d69e8fd
16605.31,10.0,0,2,4,4,10,0xb2d190fd
4013.68,1.0,3,2,2,4,8,0xb2d6efca
150002.54,3.0,108,3,4,1,8,0xb2d0b3e1
500007.0,3.0,22,4,4,2,10,0xb2d957a4d
16448.52,1.0,15,2,2,3,7,0xb2d75a92
55293.15,1.0,33,3,2,2,7,0xb2d11aca
436436.47,3.0,0,4,4,4,12,0xb2d1a63d
571010.78,12.0,18,4,4,2,10,0xb2d52cded
1.63,1.0,19,1,2,2,5,0xb2d3aed9d
13720.06,1.0,0,2,2,4,8,0xb2d42130
300000.0,2.0,21,3,3,2,8,0xb2d95239
401406.93,5.0,158,4,4,1,9,0xb2d06d3ad
160004.96,4.0,42,3,4,2,9,0xb2d6fcd1
204.43,1.0,10,1,2,3,6,0xb2d2f5fed
484145.02,4.0,168,4,4,1,9,0xb2d167cb
141961.86,4.0,179,3,4,1,8,0xb2d24a72
1297.53,1.0,2,1,2,4,7,0xb2d20852
461208.26,7.0,1,4,4,4,12,0xb2d3a546
180146.08,3.0,47,3,4,2,9,0xb2d2c290
100003.59,4.0,76,3,4,1,8,0xb2d6c9bd
1735.83,1.0,184,1,2,1,4,0xb2d162c0
25000.26,2.0,6,2,3,3,8,0xb2da4d61
310273.8,3.0,199,4,4,1,9,0xb2d0827c
260.19,1.0,25,1,2,2,5,0xb2d97329
669.46,1.0,0,1,2,4,7,0xb2d41e5e
5271.11,1.0,95,2,2,1,5,0xb2d1537c
49555.92,2.0,0,2,3,4,9,0xb2d315bb
1003552.57,2.0,24,4,3,2,9,0xb2d9d48a
200049.55,3.0,1,3,4,4,11,0xb2d614bad
0.25,1.0,0,1,2,4,7,0xb2d28cf7d
97503.98,1.0,92,3,2,1,6,0xb2d269b2
8084.89,1.0,184,2,2,1,5,0xb2d249cd
5.88,1.0,9,1,2,3,6,0xb2d37a6c
101006.93,3.0,118,3,4,1,8,0xb2d8e483d
1695072.21,34.0,0,4,4,4,12,0xb2d5877a
58000.61,2.0,119,3,3,1,7,0xb2d8e339
3763.56,1.0,2,2,2,4,8,0xb2d4eb52
200000.0,6.0,3,3,4,4,11,0xb2d4f875
3270033.1,9.0,41,4,4,2,10,0xb2d0887f
25227.34,1.0,92,2,2,1,5,0xb2d4d3bd
496121.59,3.0,0,4,4,4,12,0xb2d4a929
579642.5,3.0,0,4,4,4,12,0xb2d0a90e
1789.66,1.0,0,1,2,4,7,0xb2d31064
10319.52,1.0,204,2,2,1,5,0xb2d5a2bf
99.46,2.0,0,1,3,4,8,0xb2d08d46d
100000.0,1.0,0,3,2,4,9,0xb2da6ba7
200000.0,2.0,4,3,3,4,10,0xb2da631d
9004.51,1.0,10,2,2,3,7,0xb2d5604d
41.18,1.0,0,1,2,4,7,0xb2d69748
7.92,1.0,41,1,2,2,5,0xb2d9cc1a
8099.0,1.0,22,2,2,2,6,0xb2d6804d
1357.76,1.0,92,1,2,1,4,0xb2d42fc4
16367.12,2.0,4,2,3,4,9,0xb2d1add3d
153015.98,3.0,27,3,4,2,9,0xb2d8d86b
50824.27,1.0,101,2,2,1,5,0xb2d2a1f2
778732.67,6.0,13,4,4,3,11,0xb2d1a92e
925.54,1.0,21,1,2,2,5,0xb2d3226ad
200710.42,2.0,4,3,3,4,10,0xb2d935d9
174407.61,4.0,3,3,4,4,11,0xb2d4d147
200002.11,2.0,17,3,3,2,8,0xb2d99053
130000.0,1.0,7,3,2,3,8,0xb2d95ec1d
2001.75,1.0,47,1,2,2,5,0xb2d918dd
12524.14,1.0,0,2,2,4,8,0xb2d1e75c
1418.6,1.0,184,1,2,1,4,0xb2d071e9
1360058.73,5.0,20,4,4,2,10,0xb2d63712
500000.24,2.0,7,4,3,3,10,0xb2d8ef3a
194002.7,3.0,18,3,4,2,9,0xb2d92c71
767792.94,5.0,9,4,4,3,11,0xb2d217ced
4508.14,1.0,10,2,2,3,7,0xb2d426ac
207320.02,4.0,0,3,4,4,11,0xb2d17707
17.3,1.0,43,1,2,2,5,0xb2d432c1
217103.7,15.0,3,3,4,4,11,0xb2d55a13
603557.85,3.0,62,4,4,2,10,0xb2d9b2a2
53417.69,2.0,118,3,3,1,7,0xb2d3e48bd
1502.69,1.0,11,1,2,3,6,0xb2d5e116
580069.75,4.0,164,4,4,1,9,0xb2d248da
4781.73,1.0,184,2,2,1,5,0xb2d29cff
64110.12,1.0,74,3,2,1,6,0xb2d160da
61002.44,6.0,3,3,4,4,11,0xb2d4ded6
89222.09,3.0,18,3,4,2,9,0xb2d12516
37110.84,1.0,92,2,2,1,5,0x3b9ade60d
22391.89,2.0,22,2,3,2,7,0xb2d694c8
0.0,1.0,95,1,2,1,4,0xb2d0e2ea
13.71,1.0,1,1,2,4,7,0xb2d94ce2
1362195.79,1.0,184,4,2,1,7,0xb2d10abb
150.04,1.0,28,1,2,2,5,0xb2d438cd
297163.07,4.0,139,3,4,1,8,0xb2d6dcc5
60.85,1.0,7,1,2,3,6,0xb2d4fd40
50009.44,3.0,143,2,4,1,7,0xb2d2d56a
4041.56,1.0,1,2,2,4,8,0xb2d78d7d
45.77,1.0,6,1,2,3,6,0xb2d27313d
119101.61,4.0,0,3,4,4,11,0xb2d07a0f
248.85,1.0,20,1,2,2,5,0xb2d2e024
125001.32,3.0,151,3,4,1,8,0xb2d7636f
2978624.28,24.0,0,4,4,4,12,0x3b9b0e5fd
500000.8,3.0,6,4,4,3,11,0xb2d998d3
2375.63,1.0,184,1,2,1,4,0xb2d1fa5a
1100.79,1.0,1,1,2,4,7,0xb2d3b07a
1671.33,2.0,0,1,3,4,8,0xb2d1bbffd
102911.0,1.0,3,3,2,4,9,0xb2d6545b
524.3,2.0,39,1,3,2,6,0x3b9b298bd
100743.69,2.0,18,3,3,2,8,0xb2d346fc
459001.39,5.0,27,4,4,2,10,0xb2d4e20d
1000036.13,2.0,125,4,3,1,8,0xb2d214edd
1589.44,1.0,184,1,2,1,4,0xb2d5e5ba
2.19,1.0,20,1,2,2,5,0xb2d78b16
260000.0,2.0,14,3,3,3,9,0xb2d95c88
225303.48,3.0,16,3,4,2,9,0xb2d4927c
207803.55,2.0,147,3,3,1,7,0xb2d454b2
141135.89,2.0,24,3,3,2,8,0xb2d6b5f0
7057.67,1.0,18,2,2,2,6,0xb2d35c76
138220.03,2.0,186,3,3,1,7,0xb2d433e3
1745.45,1.0,78,1,2,1,4,0xb2d3c5d7
65423.71,1.0,19,3,2,2,7,0xb2d31098d
4218571.08,4.0,7,4,4,3,11,0xb2d6992c
101160.78,2.0,76,3,3,1,7,0xb2d42b73
567007.9,5.0,46,4,4,2,10,0xb2d5c47cd
10340.97,1.0,199,2,2,1,5,0xb2d456ead
690650.58,3.0,179,4,4,1,9,0xb2d600d9
5249.38,1.0,9,2,2,3,7,0xb2d69bc7
183301.87,1.0,92,3,2,1,6,0xb2d3e6d0d
50410.27,2.0,111,2,3,1,6,0xb2d6af72
300009.5,2.0,32,3,3,2,8,0xb2d5fe2f
56184.39,2.0,23,3,3,2,8,0xb2d17e4d
505330.08,2.0,105,4,3,1,8,0xb2d7ec72
29.58,2.0,72,1,3,1,5,0xb2d2d231
10008.82,2.0,10,2,3,3,8,0xb2d9f58f
18461.56,2.0,0,2,3,4,9,0xb2d2bef3
25097.42,2.0,37,2,3,2,7,0xb2d97a62
11179.1,1.0,3,2,2,4,8,0xb2d1a50b
2014216.22,2.0,37,4,3,2,9,0xb2d2e1e7
154008.57,3.0,132,3,4,1,8,0xb2d2903b
5318.29,1.0,9,2,2,3,7,0xb2d56c94d
10000.27,2.0,19,2,3,2,7,0xb2da1e92
2056968.92,12.0,0,4,4,4,12,0xb2d14e37
8265.33,1.0,4,2,2,4,8,0xb2d1d086
1348438.96,9.0,167,4,4,1,9,0xb2d1490c
5.99,1.0,64,1,2,2,5,0xb2d223a5
2374.27,1.0,92,1,2,1,4,0xb2d083ead
205287.26,2.0,40,3,3,2,8,0xb2d6a7c6
103568.45,1.0,21,3,2,2,7,0xb2d60ccd
1642.88,1.0,9,1,2,3,6,0xb2d8dc06
917348.08,3.0,2,4,4,4,12,0xb2d534b2
290.17,1.0,1,1,2,4,7,0xb2d2b05b
50000.0,1.0,4,2,2,4,8,0xb2d8e0f6
3297.5,2.0,92,2,3,1,6,0xb2d3c574
139021.26,3.0,47,3,4,2,9,0xb2d10cfd
461.28,1.0,0,1,2,4,7,0xb2d5d3bb
22000.43,4.0,49,2,4,2,8,0xb2d5735e
324.61,1.0,0,1,2,4,7,0xb2d6d8a2
210000.0,2.0,21,3,3,2,8,0xb2d98c21
550065.17,5.0,73,4,4,1,9,0xb2d55a36d
292677.9,6.0,39,3,4,2,9,0xb2d16a33
1068.73,1.0,92,1,2,1,4,0xb2d20221
2651.28,1.0,0,1,2,4,7,0xb2d64c52
45005.46,2.0,35,2,3,2,7,0xb2d198a1
573.6,1.0,1,1,2,4,7,0xb2d45dff
41855.1,1.0,144,2,2,1,5,0xb2d316b0
185935.45,1.0,0,3,2,4,9,0xb2d3155d
210003.22,2.0,80,3,3,1,7,0xb2d8d889
400002.63,3.0,1,4,4,4,12,0xb2d2f5ed
18103.58,1.0,75,2,2,1,5,0xb2d7c0b2
50748.97,2.0,175,2,3,1,6,0xb2d11b1b
2738300.2,14.0,0,4,4,4,12,0x3b9b2b7dd
60983.93,1.0,0,3,2,4,9,0xb2d3c503
1906.15,1.0,0,1,2,4,7,0xb2d43935
428.56,1.0,5,1,2,3,6,0xb2d81dc7d
2914.24,1.0,3,2,2,4,8,0xb2d8a945
92.23,1.0,53,1,2,2,5,0xb2d5d1c1
275499.16,11.0,0,3,4,4,11,0xb2d069da
5750238.4,12.0,20,4,4,2,10,0xb2d395e1
50316.26,2.0,182,2,3,1,6,0xb2d57a97
111510.01,6.0,0,3,4,4,11,0xb2d0b99b
342807.16,6.0,0,4,4,4,12,0xb2d0947a
80263.52,1.0,7,3,2,3,8,0xb2d64e65
191194.71,2.0,80,3,3,1,7,0xb2d35437
50617.19,2.0,15,2,3,3,8,0xb2d49b6fd
20711.06,1.0,7,2,2,3,7,0xb2d62580
1206525.9,3.0,4,4,4,4,12,0xb2d8ff9d
200000.0,2.0,17,3,3,2,8,0xb2d9973e
440076.75,5.0,69,4,4,1,9,0xb2d1afe6
14.93,1.0,78,1,2,1,4,0xb2d92b73
200000.27,2.0,7,3,3,3,9,0xb2d60c13
4476.33,1.0,0,2,2,4,8,0xb2d973a0
3750.74,1.0,8,2,2,3,7,0xb2d6bcfc
38953.47,1.0,9,2,2,3,7,0xb2d9249b
3.17,1.0,62,1,2,2,5,0xb2d24d02d
6.21,1.0,20,1,2,2,5,0xb2d1d0f0
403451.03,3.0,239,4,4,1,9,0xb2d2b13d
120108.71,3.0,0,3,4,4,11,0xb2d4e1ed
4036045.72,6.0,12,4,4,3,11,0xb2d0a2a3
694634.99,4.0,37,4,4,2,10,0xb2d14f75
55162.04,1.0,1,3,2,4,9,0xb2d06a53
1557.32,1.0,184,1,2,1,4,0xb2d21dcdd
20196.17,1.0,9,2,2,3,7,0xb2d61e7ed
53210.52,2.0,63,3,3,2,8,0xb2d44997
57.0,1.0,48,1,2,2,5,0xb2d9d3b7
2540536.33,7.0,6,4,4,3,11,0xb2d37541
501838.84,2.0,32,4,3,2,9,0xb2d5b50b
102828.13,8.0,0,3,4,4,11,0xb2d11ac6d
530070.91,2.0,60,4,3,2,9,0xb2d3d190
130115.66,3.0,2,3,4,4,11,0xb2d6b27d
1026.45,1.0,184,1,2,1,4,0xb2d1db12
60001.74,3.0,0,3,4,4,11,0xb2d9effb
413952.01,6.0,53,4,4,2,10,0xb2d6300e
100005.28,2.0,41,3,3,2,8,0xb2d9e416
3377.31,1.0,0,2,2,4,8,0xb2d45447
810013.88,4.0,87,4,4,1,9,0xb2d59bbc
69.27,1.0,184,1,2,1,4,0xb2d246acd
663365.58,8.0,11,4,4,3,11,0xb2d63f6a
130586.32,3.0,12,3,4,3,10,0xb2d56ece
300015.89,3.0,18,3,4,2,9,0xb2d636a8
217823.12,2.0,3,3,3,4,10,0xb2d3ba1d
2.04,1.0,53,1,2,2,5,0xb2d6028b
5072.01,1.0,41,2,2,2,6,0xb2d9786c
3486.74,1.0,0,2,2,4,8,0xb2d4a3bc
411.98,1.0,9,1,2,3,6,0xb2d92a76
500163.26,2.0,11,4,3,3,10,0xb2d6bd6e
20488.34,1.0,5,2,2,3,7,0xb2d98a28
20062.56,3.0,29,2,4,2,8,0xb2d920bfd
187.67,1.0,29,1,2,2,5,0xb2d1eb19
9101.36,1.0,0,2,2,4,8,0xb2d6bb6bd
55407.07,2.0,73,3,3,1,7,0xb2d1bb6cd
1481959.56,2.0,0,4,3,4,11,0xb2d65350
481014.7,4.0,41,4,4,2,10,0xb2d4fe4c
130218.0,5.0,0,3,4,4,11,0xb2d3eb3e
31006.91,2.0,17,2,3,2,7,0xb2d41888d
500020.06,2.0,12,4,3,3,10,0xb2d95ccd
2561625.18,9.0,0,4,4,4,12,0x3b9ada4a
217444.82,2.0,21,3,3,2,8,0xb2d108fc
14732.45,1.0,92,2,2,1,5,0xb2d42e0a
2297167.98,3.0,228,4,4,1,9,0xb2d3e131
1093.02,1.0,184,1,2,1,4,0xb2d3332f
51405.83,2.0,0,2,3,4,9,0xb2d5b526
163008.11,11.0,27,3,4,2,9,0xb2d56bd5
80126.79,2.0,143,3,3,1,7,0xb2d08779
2179.32,1.0,47,1,2,2,5,0xb2d68619d
1052253.27,1.0,0,4,2,4,10,0xb2d62391
20211.58,3.0,111,2,4,1,7,0xb2d5c081d
54106.89,2.0,179,3,3,1,7,0xb2d39a64
1934.55,1.0,0,1,2,4,7,0xb2d4b352
120027.65,4.0,206,3,4,1,8,0xb2d4fe4b
641.69,1.0,1,1,2,4,7,0xb2d53a3c
224278.58,3.0,60,3,4,2,9,0xb2d1811f
5189.73,1.0,1,2,2,4,8,0xb2d699c9
1170028.59,3.0,0,4,4,4,12,0xb2d3bd76d
600888.2,9.0,19,4,4,2,10,0xb2d6c4c8
12479.23,1.0,133,2,2,1,5,0xb2d553be
196521.41,3.0,0,3,4,4,11,0xb2d21293
52787.66,4.0,0,3,4,4,11,0xb2d11b77
870059.42,5.0,5,4,4,3,11,0xb2d107f8
258349.71,2.0,87,3,3,1,7,0xb2d1332c
37544.07,1.0,27,2,2,2,6,0xb2d85cc5
2003583.75,3.0,33,4,4,2,10,0xb2d2b8f1
13522.31,2.0,154,2,3,1,6,0x3b9b2e69
3462.03,1.0,10,2,2,3,7,0xb2d92100d
13000042.67,4.0,1,4,4,4,12,0xb2d415e1
633000.0,6.0,9,4,4,3,11,0xb2d55b4d
17268.03,2.0,184,2,3,1,6,0xb2d11a84
1125568.97,5.0,0,4,4,4,12,0xb2d5d98ed
911164.15,2.0,39,4,3,2,9,0xb2d224dd
436939.92,3.0,73,4,4,1,9,0xb2d1a35f
7699.61,1.0,11,2,2,3,7,0xb2d5e104
24177.69,1.0,1,2,2,4,8,0xb2d947d8
893.47,1.0,0,1,2,4,7,0xb2d21112d
50109.46,1.0,201,2,2,1,5,0xb2d4e8edd
556128.7,3.0,39,4,4,2,10,0xb2d3a461
0.32,1.0,14,1,2,3,6,0xb2d528d0
1745.73,1.0,80,1,2,1,4,0xb2d27a49
183073.1,4.0,0,3,4,4,11,0xb2d68500d
1150087.56,8.0,1,4,4,4,12,0xb2d2e5bbd
305544.82,3.0,26,4,4,2,10,0x3b9af1d3
6761.18,1.0,29,2,2,2,6,0xb2d92271
200000.0,2.0,73,3,3,1,7,0xb2d8e660
3781.01,1.0,92,2,2,1,5,0xb2d13fd2
1064.4,4.0,184,1,4,1,6,0x3b9b35c1
500000.2,3.0,5,4,4,3,11,0xb2d5e98c
898434.97,11.0,0,4,4,4,12,0xb2d13f26d
1154734.22,4.0,29,4,4,2,10,0xb2d21b3ad
101.02,1.0,10,1,2,3,6,0xb2d9bf40
4623.82,1.0,0,2,2,4,8,0xb2d5d487
567720.46,4.0,54,4,4,2,10,0xb2d4f144
80052.69,2.0,6,3,3,3,9,0xb2d13c80
16085.52,2.0,6,2,3,3,8,0xb2d9f5a4
352000.0,3.0,2,4,4,4,12,0xb2d681d0
8084.88,1.0,17,2,2,2,6,0xb2d0e0ffd
120019.28,2.0,235,3,3,1,7,0xb2d1cb10d
1038.5,1.0,162,1,2,1,4,0xb2d6fa6e
0.31,1.0,1,1,2,4,7,0xb2d3cae5
5413.65,1.0,53,2,2,2,6,0xb2d651c4d
72747.61,1.0,28,3,2,2,7,0xb2d25b49
200006.44,2.0,80,3,3,1,7,0xb2d44d2e
173524.26,5.0,31,3,4,2,9,0xb2d3470d
32369.16,1.0,8,2,2,3,7,0xb2d93672
10473002.33,9.0,87,4,4,1,9,0x3b9add8c
1081.97,1.0,184,1,2,1,4,0xb2d21a4c
4.21,1.0,19,1,2,2,5,0xb2d6fd7d
100006.46,2.0,90,3,3,1,7,0xb2d20cbd
5.29,1.0,173,1,2,1,4,0xb2d8d502
10004.63,1.0,20,2,2,2,6,0xb2d564c1
97657.99,1.0,8,3,2,3,8,0xb2d35e75
215881.05,4.0,80,3,4,1,8,0xb2d1082f
23367.95,1.0,15,2,2,3,7,0xb2d6e878
380000.0,2.0,1,4,3,4,11,0xb2d9206e
101.83,1.0,48,1,2,2,5,0xb2d7583b
50001.79,3.0,59,2,4,2,8,0xb2d87047
3821.5,1.0,94,2,2,1,5,0xb2d6b917
20000.42,2.0,10,2,3,3,8,0xb2d96328
1301.56,1.0,75,1,2,1,4,0xb2d68dd8d
0.0,1.0,68,1,2,1,4,0xb2d0bea4
254972.43,2.0,117,3,3,1,7,0xb2d0e1f9
240.08,1.0,56,1,2,2,5,0xb2d628b2
50025.38,2.0,216,2,3,1,6,0xb2d5f5dd
4586.82,1.0,8,2,2,3,7,0xb2d2211d
17151.61,1.0,4,2,2,4,8,0xb2d52ca4
246002.3,8.0,58,3,4,2,9,0xb2d65c13
103611.18,3.0,125,3,4,1,8,0xb2d3bcd5
200024.65,3.0,118,3,4,1,8,0xb2d2751ed
2000074.27,2.0,10,4,3,3,10,0xb2d429f2
0.0,1.0,7,1,2,3,6,0xb2d96c19
4634.84,1.0,1,2,2,4,8,0xb2d6d2c1d
37.82,1.0,0,1,2,4,7,0xb2d8d181
73000.77,2.0,6,3,3,3,9,0xb2d96c74
1605693.82,5.0,27,4,4,2,10,0xb2d40a35
4239.85,1.0,191,2,2,1,5,0xb2d5f1db
1222.15,1.0,92,1,2,1,4,0xb2d2dc8c
132032.8,3.0,31,3,4,2,9,0xb2d636ed
260798.0,3.0,125,3,4,1,8,0xb2d69e87
21.6,1.0,31,1,2,2,5,0xb2d93899
536047.54,9.0,9,4,4,3,11,0xb2d67e12d
0.42,1.0,92,1,2,1,4,0xb2d2a742
274973.27,2.0,35,3,3,2,8,0xb2d93329
405010.88,3.0,60,4,4,2,10,0xb2d97e15
38463.45,3.0,123,2,4,1,7,0xb2d229a4
62.73,3.0,83,1,4,1,6,0xb2d23596
50011.45,2.0,90,2,3,1,6,0xb2d3a01c
185047.52,2.0,92,3,3,1,7,0xb2d4e993d
0.0,5.0,1,1,4,4,9,0xb2d18199
70140.7,2.0,4,3,3,4,10,0xb2d5eb26
2390028.93,5.0,0,4,4,4,12,0xb2d39a6c
170609.52,3.0,55,3,4,2,9,0xb2d6c618
296903.64,10.0,0,3,4,4,11,0x3b9af287
224922.16,3.0,6,3,4,3,10,0xb2d2a986
11.73,1.0,39,1,2,2,5,0xb2d14c73
200000.84,2.0,16,3,3,2,8,0xb2d99a89
1.58,1.0,92,1,2,1,4,0xb2d2a25b
1842.17,1.0,184,1,2,1,4,0xb2d528c0
0.0,1.0,1,1,2,4,7,0xb2d4263e
92.76,1.0,117,1,2,1,4,0xb2d5648c
25000.82,2.0,11,2,3,3,8,0xb2da3b6d
1387.66,2.0,0,1,3,4,8,0xb2d23544
1880085.67,6.0,11,4,4,3,11,0xb2d57a34
410079.48,2.0,59,4,3,2,9,0xb2d230b1
1229.21,1.0,0,1,2,4,7,0xb2d55990
234.16,1.0,15,1,2,3,6,0xb2d16edc
3114.9,2.0,92,2,3,1,6,0x3b9b1685
1947.15,2.0,9,1,3,3,7,0x3b9b2be9
2653.5,1.0,104,1,2,1,4,0xb2d593f1
51273.43,2.0,210,2,3,1,6,0xb2d5df77d
320029.91,4.0,157,4,4,1,9,0xb2d1ccec
514820.54,2.0,76,4,3,1,8,0xb2d5fcf2
31401.47,1.0,92,2,2,1,5,0xb2d3a413d
2242.18,1.0,5,1,2,3,6,0xb2d27af7
215029.64,7.0,179,3,4,1,8,0xb2d08e3c
650136.13,5.0,1,4,4,4,12,0x3b9b2fa8d
8003.51,1.0,9,2,2,3,7,0xb2d60234
30006.02,2.0,23,2,3,2,7,0xb2d9d485
16932.98,1.0,18,2,2,2,6,0xb2d98c89
60860.08,2.0,0,3,3,4,10,0xb2d91c53d
472127.28,2.0,5,4,3,3,10,0xb2d178d9
153584.78,2.0,2,3,3,4,10,0xb2d97b06
1098.15,1.0,24,1,2,2,5,0xb2d25b6a
638032.84,4.0,214,4,4,1,9,0xb2d0e719d
200093.16,3.0,221,3,4,1,8,0xb2d43a7ed
4028.85,1.0,0,2,2,4,8,0xb2d382b5
212130.1,2.0,20,3,3,2,8,0xb2d254fbd
30000.95,2.0,32,2,3,2,7,0xb2d9f62f
242980.0,4.0,1,3,4,4,11,0xb2d4ea03
14642.0,1.0,184,2,2,1,5,0xb2d19c11
200596.07,3.0,19,3,4,2,9,0xb2d1c39d
60086.97,2.0,67,3,3,1,7,0xb2d54190d
660000.34,5.0,0,4,4,4,12,0xb2d531a8
32552.8,1.0,15,2,2,3,7,0xb2d6018a
262.75,1.0,5,1,2,3,6,0xb2d2f72d
463757.24,4.0,11,4,4,3,11,0xb2d637f5
2.07,1.0,13,1,2,3,6,0xb2d59b22
705001.12,6.0,14,4,4,3,11,0x3b9b3245
116.14,1.0,10,1,2,3,6,0xb2d5819a
378.89,1.0,6,1,2,3,6,0xb2d90dacd
179023.85,2.0,31,3,3,2,8,0xb2d10f12d
50001.14,2.0,25,2,3,2,7,0xb2d93b93d
4416.91,1.0,184,2,2,1,5,0xb2d0f0c8
87.39,1.0,11,1,2,3,6,0xb2d2590f
479009.47,2.0,0,4,3,4,11,0xb2d299c8
59.92,1.0,33,1,2,2,5,0xb2d2ae6b
67.17,1.0,14,1,2,3,6,0xb2d28712
40627.43,1.0,8,2,2,3,7,0xb2d3395b
82002.15,5.0,24,3,4,2,9,0xb2d4f160
180013.46,2.0,18,3,3,2,8,0xb2d13e78d
28.31,1.0,8,1,2,3,6,0x3b9b42b5
1370398.94,10.0,4,4,4,4,12,0x3b9adb4e
49086.04,1.0,0,2,2,4,8,0xb2d69739
570.47,1.0,10,1,2,3,6,0xb2d5d5c1
1230.53,2.0,12,1,3,3,7,0xb2d0a4e8d
2720.22,1.0,0,1,2,4,7,0xb2d5be54
500000.67,3.0,9,4,4,3,11,0xb2d92895d
55527.49,3.0,0,3,4,4,11,0xb2d54fa1
31302.98,1.0,2,2,2,4,8,0xb2d6b812d
172918.39,2.0,10,3,3,3,9,0xb2d2e248
1048.96,1.0,10,1,2,3,6,0xb2d57b8c
14.88,1.0,34,1,2,2,5,0xb2d9bf44
200020.85,2.0,7,3,3,3,9,0xb2d9a716
502317.14,3.0,116,4,4,1,9,0xb2d27fc0
46001.31,3.0,76,2,4,1,7,0xb2d8d993
20007.15,2.0,13,2,3,3,8,0xb2d5ad74
305313.21,2.0,133,4,3,1,8,0xb2d63e0a
340086.02,2.0,27,4,3,2,9,0xb2d1f87c
751450.53,8.0,47,4,4,2,10,0xb2d2285b
5219.62,1.0,131,2,2,1,5,0xb2d3591d
210371.88,7.0,35,3,4,2,9,0x3b9b2529d
100001.06,2.0,87,3,3,1,7,0xb2d8ccae
4432.47,1.0,137,2,2,1,5,0xb2d6e4a5
2104.92,1.0,10,1,2,3,6,0xb2d98a2a
923.63,1.0,10,1,2,3,6,0xb2d55a96
820093.26,5.0,80,4,4,1,9,0xb2d60728
270009.45,3.0,8,3,4,3,10,0xb2d36e8b
2.15,1.0,105,1,2,1,4,0xb2d9431a
20069.12,1.0,92,2,2,1,5,0xb2d5cc50
4.72,1.0,124,1,2,1,4,0xb2d643a4
20001.06,2.0,13,2,3,3,8,0xb2d95bce
4.85,1.0,10,1,2,3,6,0xb2d9dc9d
140102.97,2.0,18,3,3,2,8,0xb2d95414
350.48,1.0,11,1,2,3,6,0xb2d2d49a
55.05,1.0,19,1,2,2,5,0xb2d609cd
1710.6,1.0,92,1,2,1,4,0xb2d34b16
2709.15,1.0,184,1,2,1,4,0xb2d25612
4528.27,1.0,22,2,2,2,6,0xb2da1174
312559.03,5.0,48,4,4,2,10,0xb2d629bcd
197.11,1.0,22,1,2,2,5,0xb2d7835b
1200000.61,4.0,1,4,4,4,12,0xb2d09788
60001.63,4.0,52,3,4,2,9,0xb2d13fd3
102122.84,1.0,301,3,2,1,6,0xb2d5be2f
303198.25,2.0,111,4,3,1,8,0xb2d9577f
4152.53,1.0,5,2,2,3,7,0xb2d62c44
1046375.46,8.0,69,4,4,1,9,0xb2d313ed
1043.13,1.0,18,1,2,2,5,0xb2d4b92e
122616.66,2.0,60,3,3,2,8,0xb2d2313f
51044.17,2.0,35,2,3,2,7,0xb2d3a8c5
1530069.69,7.0,11,4,4,3,11,0xb2d3c1de
102055.47,3.0,24,3,4,2,9,0xb2d5f3b6d
111.89,1.0,44,1,2,2,5,0xb2d69414
200710.46,2.0,15,3,3,3,9,0xb2d91facd
503.94,1.0,4,1,2,4,7,0xb2d48f7f
150005.26,2.0,98,3,3,1,7,0xb2d576fe
200332.18,13.0,6,3,4,3,10,0xb2d69c80
420717.62,4.0,4,4,4,4,12,0xb2d393c1d
1054.67,2.0,105,1,3,1,5,0xb2d415c1
501052.6,2.0,3,4,3,4,11,0xb2d9a791
3020.2,1.0,5,2,2,3,7,0xb2d9126f
57.79,1.0,3,1,2,4,7,0xb2d8c641
50719.23,3.0,11,2,4,3,9,0xb2d12382
207700.96,2.0,15,3,3,3,9,0xb2d154a1
133531.75,2.0,143,3,3,1,7,0xb2d20936
1540782.75,71.0,0,4,4,4,12,0x3b9b12b9d
25987.76,1.0,8,2,2,3,7,0xb2d20ff1d
60001.9,3.0,22,3,4,2,9,0xb2d5345dd
60059.69,2.0,213,3,3,1,7,0xb2d22d70d
1204356.28,9.0,2,4,4,4,12,0xb2d5cb7e
500025.78,2.0,83,4,3,1,8,0xb2d28e6c
93.4,2.0,32,1,3,2,6,0xb2d16792
419428.88,3.0,36,4,4,2,10,0xb2d25497
510025.5,9.0,1,4,4,4,12,0xb2d17bc5d
450098.53,2.0,19,4,3,2,9,0xb2d9d076
300031.38,2.0,6,3,3,3,9,0xb2d9aff9
200093.12,2.0,110,3,3,1,7,0xb2d1e76e
197000.1,14.0,1,3,4,4,11,0xb2d681fb
7887.15,1.0,259,2,2,1,5,0xb2d3f8fe
318.41,1.0,3,1,2,4,7,0xb2d6966c
31.61,1.0,23,1,2,2,5,0xb2d6ca0a
76235.49,3.0,8,3,4,3,10,0xb2d6a3ead
600128.16,3.0,10,4,4,3,11,0xb2d52c61
80387.15,2.0,164,3,3,1,7,0xb2d1e1a8
1252.35,1.0,184,1,2,1,4,0xb2d3953f
4087.69,1.0,4,2,2,4,8,0xb2d0f52ad
5811.0,2.0,48,2,3,2,7,0xb2d19ec6
3003.74,1.0,128,2,2,1,5,0xb2d2b929
430000.4,2.0,20,4,3,2,9,0xb2d9d6ab
50064.91,2.0,3,2,3,4,9,0xb2d290a0
248.22,1.0,78,1,2,1,4,0xb2d55e0f
80406.79,6.0,10,3,4,3,10,0xb2d28e86
505693.93,3.0,98,4,4,1,9,0xb2d6a962
94331.12,5.0,69,3,4,1,8,0xb2d58361
170003.59,2.0,11,3,3,3,9,0xb2da412d
854.49,1.0,0,1,2,4,7,0xb2d2a15f
1000.0,1.0,0,1,2,4,7,0xb2d20da8
7419.35,1.0,25,2,2,2,6,0xb2d90ab1
390137.28,5.0,2,4,4,4,12,0xb2d19ef3
0.49,1.0,92,1,2,1,4,0xb2d5e6f3
24007.73,1.0,126,2,2,1,5,0xb2d34649
1.3,1.0,12,1,2,3,6,0xb2d2b3cd
332022.22,3.0,59,4,4,2,10,0xb2d5d169
24498.63,1.0,0,2,2,4,8,0xb2d2f4ba
1366593.12,4.0,4,4,4,4,12,0xb2d56ee9
503958.73,3.0,112,4,4,1,9,0xb2d60e95d
3375.67,1.0,3,2,2,4,8,0xb2d194ec
8539.43,1.0,11,2,2,3,7,0xb2d5b0c0
950027.24,3.0,10,4,4,3,11,0xb2d90a16
5011.52,1.0,228,2,2,1,5,0xb2d64463
48307.16,1.0,0,2,2,4,8,0xb2d175f5
1106.41,1.0,0,1,2,4,7,0xb2d53046
68608.09,1.0,0,3,2,4,9,0xb2d376e4
3015.92,1.0,5,2,2,3,7,0xb2d6849e
720.51,1.0,10,1,2,3,6,0xb2d78f47
16000.84,2.0,55,2,3,2,7,0xb2d9bf20
503778.61,6.0,92,4,4,1,9,0xb2d152e7
3.96,1.0,7,1,2,3,6,0xb2d3525e
25185.78,1.0,2,2,2,4,8,0xb2d26675
4177.68,1.0,1,2,2,4,8,0xb2d8d7e8
12887.53,1.0,6,2,2,3,7,0xb2d60ae9
240849.77,4.0,13,3,4,3,10,0xb2d2978c
1300.55,1.0,92,1,2,1,4,0xb2d370f1
220004.44,3.0,32,3,4,2,9,0xb2d99481
109906.32,2.0,92,3,3,1,7,0xb2d24519
50001.06,2.0,46,2,3,2,7,0xb2d9df8c
943047.37,7.0,6,4,4,3,11,0xb2d4ff56d
68.59,1.0,3,1,2,4,7,0xb2d31d70
374.06,1.0,9,1,2,3,6,0xb2d9e788
785187.84,5.0,69,4,4,1,9,0xb2d3b1d6
551608.27,3.0,27,4,4,2,10,0xb2d599d6
450055.14,5.0,11,4,4,3,11,0xb2d1e71e
120596.83,5.0,0,3,4,4,11,0xb2d51b6e
82.51,1.0,38,1,2,2,5,0xb2d0c2a5
25050.42,2.0,39,2,3,2,7,0xb2d5ccd1
0.44,1.0,71,1,2,1,4,0xb2d38376
500028.22,2.0,22,4,3,2,9,0xb2d950a9
205.28,1.0,8,1,2,3,6,0xb2da2248
51.42,1.0,39,1,2,2,5,0xb2d575f3
164643.7,2.0,74,3,3,1,7,0xb2d20e04d
40640.45,3.0,54,2,4,2,8,0xb2d06b9e
268.35,1.0,10,1,2,3,6,0xb2d9699f
61164.38,3.0,27,3,4,2,9,0x3b9b46aa
137771.8,3.0,14,3,4,3,10,0xb2d0c2b0
1086.56,1.0,184,1,2,1,4,0xb2d350ed
2105.58,1.0,0,1,2,4,7,0xb2d57f98
17218.55,1.0,0,2,2,4,8,0xb2d912c6
89117.36,4.0,0,3,4,4,11,0xb2d07a0fd
613107.02,2.0,0,4,3,4,11,0xb2d683b3
106.68,1.0,8,1,2,3,6,0xb2d6b249
700045.01,3.0,3,4,4,4,12,0xb2d2d872
3462.43,1.0,14,2,2,3,7,0xb2d60b8d
100.57,1.0,11,1,2,3,6,0xb2d2ce79d
73006.33,3.0,3,3,4,4,11,0xb2d084a2
3976.79,2.0,92,2,3,1,6,0x3b9b3902
1210822.04,6.0,13,4,4,3,11,0xb2d4cec5
95123.2,1.0,41,3,2,2,7,0xb2d230a8
58289.52,2.0,0,3,3,4,10,0xb2d171fe
350007.39,2.0,8,4,3,3,10,0xb2da4898
660014.12,4.0,0,4,4,4,12,0xb2d28cac
218.87,1.0,4,1,2,4,7,0xb2d1ceded
200032.16,2.0,166,3,3,1,7,0xb2d787d2d
605694.96,2.0,0,4,3,4,11,0xb2d58246
250891.84,2.0,32,3,3,2,8,0xb2da0808
5434.48,1.0,184,2,2,1,5,0xb2d3ab42
12619.43,1.0,1,2,2,4,8,0xb2d3d26b
976.7,1.0,3,1,2,4,7,0xb2d5747b
21621.51,1.0,0,2,2,4,8,0xb2d393dd
500000.0,3.0,20,4,4,2,10,0xb2da1c71
1686.84,1.0,8,1,2,3,6,0xb2d347ed
1106.94,1.0,7,1,2,3,6,0xb2d408e5
2561.16,1.0,3,1,2,4,7,0xb2d6e971
33038.47,3.0,0,2,4,4,10,0xb2d6f7a3
309540.22,12.0,13,4,4,3,11,0xb2d0ebb9
1465059.9,5.0,3,4,4,4,12,0xb2d94e7c
506.14,1.0,4,1,2,4,7,0xb2d1bf89
521025.57,1.0,5,4,2,3,9,0xb2d2f6cf
305009.96,6.0,69,4,4,1,9,0xb2d8f78d
500000.0,2.0,68,4,3,1,8,0xb2d9b0db
14.57,1.0,30,1,2,2,5,0xb2d9046d
21705.17,1.0,21,2,2,2,6,0xb2d69b2a
71030.07,2.0,221,3,3,1,7,0xb2d55839
1040.22,1.0,184,1,2,1,4,0xb2d405f0
1009.7,1.0,184,1,2,1,4,0xb2d2b1dd
1060243.96,9.0,4,4,4,4,12,0xb2d288ab
336008.9,3.0,1,4,4,4,12,0xb2d171e9
1006.43,1.0,184,1,2,1,4,0xb2d65ec6
117098.73,1.0,9,3,2,3,8,0xb2d2c464
770178.01,6.0,4,4,4,4,12,0xb2d90ab7
2190314.81,4.0,56,4,4,2,10,0xb2d24507d
205997.28,1.0,2,3,2,4,9,0xb2d0f666
1132.19,1.0,92,1,2,1,4,0xb2d21613
259113.57,6.0,25,3,4,2,9,0xb2d4fef8
440015.12,6.0,0,4,4,4,12,0xb2d67169
200019.69,3.0,26,3,4,2,9,0xb2d614c4
102007.42,2.0,7,3,3,3,9,0xb2d69872
200000.0,2.0,19,3,3,2,8,0xb2d95806
20581.89,1.0,3,2,2,4,8,0xb2d623e3
4178.59,1.0,15,2,2,3,7,0xb2d9a49d
2.27,1.0,1,1,2,4,7,0xb2d717b1
483313.76,2.0,0,4,3,4,11,0xb2d48f94
264922.86,6.0,0,3,4,4,11,0xb2d1a9e1
5886.29,2.0,0,2,3,4,9,0xb2d2e6fc
258005.2,3.0,5,3,4,3,10,0xb2d5ad19
45.01,1.0,14,1,2,3,6,0xb2d69b62
140006.67,3.0,10,3,4,3,10,0xb2d68438
216142.15,5.0,3,3,4,4,11,0xb2d11f15
90002.23,7.0,0,3,4,4,11,0xb2d682abd
9266.89,1.0,19,2,2,2,6,0xb2d1f064
1852.92,1.0,146,1,2,1,4,0xb2d2f2de
2743.63,1.0,184,1,2,1,4,0xb2d3501bd
6870.34,1.0,11,2,2,3,7,0xb2d8b27b
2.11,1.0,110,1,2,1,4,0xb2d95890d
850067.47,5.0,6,4,4,3,11,0xb2d8d03a
10000.21,2.0,18,2,3,2,7,0xb2d953ef
720.76,2.0,9,1,3,3,7,0xb2d30247
300016.91,2.0,67,3,3,1,7,0xb2d704efd
108613.48,1.0,32,3,2,2,7,0xb2d2bbfe
355.22,1.0,0,1,2,4,7,0xb2d6a376
584.97,8.0,11,1,4,3,8,0xb2d6b51e
2034538.71,3.0,10,4,4,3,11,0xb2d6d09c
48907.24,60.0,0,2,4,4,10,0xb2d13bbed
280077.89,4.0,4,3,4,4,11,0xb2d69faa
11974.4,1.0,10,2,2,3,7,0xb2d42330
23058.72,1.0,0,2,2,4,8,0xb2d27f2a
602440.23,4.0,24,4,4,2,10,0xb2d39ef6
753091.28,5.0,42,4,4,2,10,0xb2d6e57a
62021.91,1.0,1,3,2,4,9,0xb2d3b3aa
20002.91,4.0,46,2,4,2,8,0xb2d15dd8d
50050.65,2.0,55,2,3,2,7,0xb2d5e407
40004.71,3.0,20,2,4,2,8,0xb2d0d8dbd
370040.88,7.0,32,4,4,2,10,0xb2d57939
34055.95,1.0,92,2,2,1,5,0xb2d2564cd
286150.02,14.0,0,3,4,4,11,0xb2d30e3f
460000.0,2.0,2,4,3,4,11,0xb2d95529
240001.21,7.0,4,3,4,4,11,0xb2d62a07d
50000.53,2.0,35,2,3,2,7,0xb2d9f988
0.0,3.0,4,1,4,4,9,0xb2d193c8
3664.97,1.0,16,2,2,2,6,0xb2d6c246
925046.27,14.0,11,4,4,3,11,0xb2d60814
871.38,4.0,0,1,4,4,9,0xb2d0a7e4
67.01,1.0,8,1,2,3,6,0xb2d587a2
9.37,1.0,4,1,2,4,7,0xb2d1eb5e
80000.0,2.0,3,3,3,4,10,0xb2d5e3f6d
115.87,1.0,9,1,2,3,6,0xb2d2f45a
60000.63,2.0,20,3,3,2,8,0xb2d95088
633002.51,3.0,18,4,4,2,10,0xb2d41166
511126.89,4.0,123,4,4,1,9,0xb2d2409e
80000110.14,4.0,125,4,4,1,9,0xb2d347bad
459539.9,5.0,14,4,4,3,11,0xb2d5f378d
269432.68,3.0,196,3,4,1,8,0xb2d12bbe
8511.82,1.0,9,2,2,3,7,0xb2d6a2e8
136003.86,4.0,32,3,4,2,9,0xb2d9c7dc
51004.54,2.0,125,2,3,1,6,0xb2d557c9
4.12,1.0,11,1,2,3,6,0xb2d94e4b
52357.74,2.0,160,3,3,1,7,0xb2d3f776
642.91,2.0,66,1,3,2,6,0xb2d45e0e
200058.2,2.0,47,3,3,2,8,0xb2d0e941
79.91,1.0,0,1,2,4,7,0xb2d5c2d0
5370.51,1.0,4,2,2,4,8,0xb2d5c930
131326.31,3.0,4,3,4,4,11,0xb2d34812
200000.0,2.0,18,3,3,2,8,0xb2d959d4
2.62,2.0,35,1,3,2,6,0xb2d08f34
0.42,1.0,3,1,2,4,7,0xb2d51b3a
2747.45,1.0,153,1,2,1,4,0xb2d46e35
270716.73,11.0,11,3,4,3,10,0xb2d416f2
2868.83,1.0,14,1,2,3,6,0xb2d6d53dd
1180.38,1.0,15,1,2,3,6,0xb2d2df70
477076.67,3.0,25,4,4,2,10,0xb2d063c5
3206.13,1.0,9,2,2,3,7,0xb2d93e42
126310.59,1.0,4,3,2,4,9,0xb2d39358
1961.0,1.0,2,1,2,4,7,0xb2d30dee
2257.66,1.0,22,1,2,2,5,0xb2d45954
266049.06,5.0,70,3,4,1,8,0xb2d65859
4427.38,2.0,0,2,3,4,9,0xb2d31860
16828.58,1.0,15,2,2,3,7,0xb2d5d395d
240485.32,1.0,92,3,2,1,6,0xb2d3fb6e
11040.9,1.0,6,2,2,3,7,0xb2d6b4cfd
361682.6,3.0,20,4,4,2,10,0xb2d0f5a4
4137.78,1.0,92,2,2,1,5,0x3b9b1348d
1181131.01,10.0,8,4,4,3,11,0xb2d17cfc
103659.22,1.0,106,3,2,1,6,0xb2d619c0
11659.81,1.0,92,2,2,1,5,0xb2d3f102
50006.33,1.0,21,2,2,2,6,0xb2d95286
276011.23,3.0,5,3,4,3,10,0xb2d9264cd
50002.21,3.0,125,2,4,1,7,0xb2d70973
168754.33,3.0,3,3,4,4,11,0xb2d63b24
1845.67,10.0,92,1,4,1,6,0x3b9b2a57
60003.4,2.0,231,3,3,1,7,0xb2d3ecd9
1446.86,1.0,16,1,2,2,5,0xb2d2f8bd
1379.52,3.0,16,1,4,2,7,0x3b9ad189
333211.91,3.0,60,4,4,2,10,0xb2d57a1f
4218.0,1.0,0,2,2,4,8,0xb2d29270
101835.53,1.0,1,3,2,4,9,0xb2d227b3
289.68,1.0,21,1,2,2,5,0xb2d36a72
1713.7,1.0,20,1,2,2,5,0xb2d15f3a
5.22,1.0,4,1,2,4,7,0xb2d0d0f6
1838.85,1.0,12,1,2,3,6,0xb2d31b3c
3017350.18,14.0,1,4,4,4,12,0xb2d148f1d
200083.88,2.0,209,3,3,1,7,0xb2d6071a
26322.45,14.0,0,2,4,4,10,0xb2d119f7
450520.71,7.0,28,4,4,2,10,0xb2d3c944
8282083.18,4.0,155,4,4,1,9,0xb2d1e271
150143.85,2.0,0,3,3,4,10,0xb2d66640
24079.32,2.0,4,2,3,4,9,0xb2d141c9
4.65,1.0,32,1,2,2,5,0xb2d9246b
121162.64,2.0,9,3,3,3,9,0xb2d8ec80
500191.89,1.0,8,4,2,3,9,0xb2d08055
237667.35,3.0,74,3,4,1,8,0xb2d5e345
127.81,1.0,9,1,2,3,6,0xb2d3eb9e
50729.88,3.0,92,2,4,1,7,0xb2d6109e
500164.98,2.0,39,4,3,2,9,0xb2d42887
400000.04,3.0,15,4,4,3,11,0xb2d6c12a
209.96,1.0,13,1,2,3,6,0xb2d3d32a
9508.42,2.0,158,2,3,1,6,0xb2d39f77
42000.0,3.0,5,2,4,3,9,0xb2d0d3b7
7561.04,1.0,0,2,2,4,8,0xb2d3fe38
658030.04,6.0,31,4,4,2,10,0xb2d28946d
222120.33,5.0,4,3,4,4,11,0xb2d22a20
103939.03,2.0,184,3,3,1,7,0xb2d2a484
2403.86,1.0,92,1,2,1,4,0xb2d1651a
200000.0,2.0,27,3,3,2,8,0xb2d94644
265097.26,5.0,6,3,4,3,10,0xb2d573ff
5747.01,3.0,0,2,4,4,10,0x3b9b4688
785869.48,4.0,2,4,4,4,12,0xb2d65871
739024.33,4.0,17,4,4,2,10,0xb2d61bf4d
2021.15,1.0,92,1,2,1,4,0x3b9add31
14.84,1.0,1,1,2,4,7,0xb2d69aa1
150019.84,2.0,77,3,3,1,7,0xb2d518d4
300134.46,2.0,14,4,3,3,10,0xb2d99b29
120002.53,2.0,73,3,3,1,7,0xb2d8e1f9d
6632.11,1.0,0,2,2,4,8,0xb2d78310
1004.25,1.0,92,1,2,1,4,0xb2d54200
1000000.0,5.0,0,4,4,4,12,0xb2d3357cd
297.45,1.0,0,1,2,4,7,0xb2d2ebfc
37267.09,2.0,6,2,3,3,8,0xb2d81e6c
71367.79,2.0,80,3,3,1,7,0xb2d5cd2cd
3150089.15,15.0,6,4,4,3,11,0xb2d0cbc8d
1616.02,1.0,0,1,2,4,7,0xb2d39046
253.28,1.0,42,1,2,2,5,0xb2d3871d
220988.82,1.0,0,3,2,4,9,0xb2d18163
5000000.0,1.0,0,4,2,4,10,0xb2da6b6f
2133.08,1.0,3,1,2,4,7,0xb2d2bc39
2397.41,1.0,2,1,2,4,7,0xb2d6f5f6
48505.21,1.0,0,2,2,4,8,0xb2d39967
408068.67,4.0,7,4,4,3,11,0xb2d24cc2
61463.52,1.0,10,3,2,3,8,0xb2d480db
14203.56,1.0,0,2,2,4,8,0xb2d5409b
3485.44,1.0,0,2,2,4,8,0xb2d7aea4
24712.07,1.0,14,2,2,3,7,0xb2d0afa0
60030.92,2.0,175,3,3,1,7,0xb2d1fc13
500030.96,3.0,3,4,4,4,12,0xb2d20ba6d
129844.58,5.0,0,3,4,4,11,0xb2d2adbd
1500147.27,3.0,24,4,4,2,10,0xb2d60616
500026.57,3.0,16,4,4,2,10,0xb2d5adff
51814.51,1.0,6,2,2,3,7,0xb2d6f5e8
272069.26,5.0,0,3,4,4,11,0xb2d4ff20
108456.18,2.0,136,3,3,1,7,0xb2d32940
70647.58,2.0,34,3,3,2,8,0xb2d651c2d
273146.07,3.0,86,3,4,1,8,0xb2d0ae21
1754.7,2.0,1,1,3,4,8,0xb2d21669d
229.08,1.0,3,1,2,4,7,0xb2da0072
7241.35,1.0,7,2,2,3,7,0xb2d305a1
15725.19,1.0,2,2,2,4,8,0xb2d64ef4
200710.42,2.0,37,3,3,2,8,0xb2d64245
2174.39,1.0,23,1,2,2,5,0xb2d0eb7c
8411.44,1.0,0,2,2,4,8,0xb2d6d38e
1142.45,2.0,0,1,3,4,8,0x3b9af22ed
272.62,1.0,56,1,2,2,5,0xb2d47d1dd
500076.07,2.0,19,4,3,2,9,0xb2d9d7b8
2000200.56,3.0,46,4,4,2,10,0xb2d9525d
4025.99,1.0,92,2,2,1,5,0xb2d3f334
304014.65,3.0,80,4,4,1,9,0xb2d4f1c6
16.1,1.0,46,1,2,2,5,0xb2d422b3
20147300.91,4.0,34,4,4,2,10,0xb2d1932f
63409.55,2.0,179,3,3,1,7,0xb2d4876f
1318.58,1.0,6,1,2,3,6,0xb2d5788c
227494.94,3.0,31,3,4,2,9,0xb2d58412
51052.39,1.0,184,2,2,1,5,0xb2d381dd
0.0,1.0,10,1,2,3,6,0xb2d23256
21149.63,1.0,39,2,2,2,6,0xb2d26fc0
600038.43,4.0,3,4,4,4,12,0xb2d6d6f5
1368.78,1.0,9,1,2,3,6,0xb2d9dfab
110316.38,3.0,0,3,4,4,11,0xb2d4ba4c
12404.67,1.0,92,2,2,1,5,0xb2d15670
260000.66,6.0,1,3,4,4,11,0xb2d6fd74
774.19,1.0,19,1,2,2,5,0xb2d5f49c
50992.2,2.0,48,2,3,2,7,0xb2d6d0dbd
1873.29,1.0,184,1,2,1,4,0xb2d23031
630000.02,12.0,1,4,4,4,12,0xb2d315ae
53605.92,2.0,0,3,3,4,10,0xb2d075c2d
503602.92,3.0,0,4,4,4,12,0xb2d8dd3ed
724.16,1.0,21,1,2,2,5,0xb2d2ffed
4214.08,1.0,16,2,2,2,6,0xb2d6c1a8
80.4,1.0,83,1,2,1,4,0xb2d5a974
431060.3,3.0,0,4,4,4,12,0xb2d8d4bd
5.28,1.0,42,1,2,2,5,0xb2d6e94a
1078439.97,5.0,32,4,4,2,10,0xb2d06d53
0.84,1.0,14,1,2,3,6,0xb2da3820
2.32,1.0,208,1,2,1,4,0xb2d781a0
749.99,2.0,92,1,3,1,5,0x3b9b0fe3
100005.91,2.0,213,3,3,1,7,0xb2d0ffa0
227116.73,2.0,14,3,3,3,9,0xb2d28473
1374103.4,7.0,0,4,4,4,12,0xb2d83483
5310.56,1.0,119,2,2,1,5,0xb2d2b25e
4479.16,1.0,181,2,2,1,5,0xb2d4a5b2
50001.79,2.0,75,2,3,1,6,0xb2d78d8e
539438.68,2.0,60,4,3,2,9,0xb2d35268
10044.91,2.0,118,2,3,1,6,0xb2d14378
200004.78,3.0,39,3,4,2,9,0xb2d619b1
600005.75,4.0,3,4,4,4,12,0xb2d07bc9
100009.5,2.0,83,3,3,1,7,0xb2d9840c
3594.87,1.0,175,2,2,1,5,0xb2d25f5b
11269.27,1.0,83,2,2,1,5,0xb2d2f0abd
125.53,1.0,8,1,2,3,6,0xb2d8f9ec
4221.73,1.0,184,2,2,1,5,0xb2d322ea
12.19,1.0,19,1,2,2,5,0xb2d06ef9
225.64,2.0,5,1,3,3,7,0xb2d94198
4.75,1.0,82,1,2,1,4,0xb2d93b84d
26042.96,2.0,9,2,3,3,8,0xb2d41069
80167.13,3.0,10,3,4,3,10,0xb2d196c2d
833000.65,6.0,0,4,4,4,12,0xb2d58e39d
508713.23,4.0,0,4,4,4,12,0xb2d2669ad
401556.84,1.0,3,4,2,4,10,0xb2d90f94
450097.62,3.0,14,4,4,3,11,0xb2d5e3a9
8537.64,1.0,92,2,2,1,5,0xb2d1a57e
202845.19,2.0,41,3,3,2,8,0xb2d11817
5489.62,1.0,15,2,2,3,7,0xb2d6c4ba
503138.92,4.0,15,4,4,3,11,0xb2d6e258
320057.38,2.0,18,4,3,2,9,0xb2d64f50d
204852.78,2.0,146,3,3,1,7,0xb2d17ce9
387.82,1.0,6,1,2,3,6,0xb2d20493
730188.62,3.0,1,4,4,4,12,0xb2d59cad
409047.88,2.0,87,4,3,1,8,0xb2d1b093
151768.71,3.0,0,3,4,4,11,0xb2d16b1f
140052.53,7.0,82,3,4,1,8,0xb2d5494ed
536927.14,3.0,24,4,4,2,10,0xb2d37855
7290.38,1.0,15,2,2,3,7,0xb2da0810
36308.65,4.0,0,2,4,4,10,0xb2d3048e
50063.75,1.0,49,2,2,2,6,0xb2d63777
502365.52,5.0,11,4,4,3,11,0xb2d39733
100001.06,2.0,35,3,3,2,8,0xb2d9e08d
76282.56,4.0,185,3,4,1,8,0xb2d09ddcd
561172.2,5.0,0,4,4,4,12,0xb2d2252a
346568.51,1.0,0,4,2,4,10,0xb2d6c6ee
411601.19,5.0,27,4,4,2,10,0xb2d7bf57
311.0,1.0,161,1,2,1,4,0xb2d6d5d3
1057.47,1.0,65,1,2,2,5,0xb2d6b83a
192662.48,2.0,2,3,3,4,10,0xb2d155d5d
25.1,1.0,10,1,2,3,6,0xb2d5866d
70072.78,4.0,26,3,4,2,9,0xb2d918ec
3047.72,1.0,10,2,2,3,7,0xb2d63004
537.8,1.0,4,1,2,4,7,0xb2d4e580
5007.64,1.0,1,2,2,4,8,0xb2d573ac
642040.1,8.0,0,4,4,4,12,0xb2d2c408d
26587.84,1.0,3,2,2,4,8,0xb2d344f2
12714.34,1.0,15,2,2,3,7,0xb2d2f3fb
545781.32,5.0,16,4,4,2,10,0xb2d64208
903.83,1.0,6,1,2,3,6,0xb2d63286
79.06,1.0,19,1,2,2,5,0xb2d5658fd
30017.21,1.0,23,2,2,2,6,0xb2d8e5c6
100022.73,5.0,7,3,4,3,10,0xb2d57516
50991.85,3.0,0,2,4,4,10,0xb2d11ae3d
211903.49,3.0,5,3,4,3,10,0xb2d07b3fd
600031.66,2.0,77,4,3,1,8,0xb2d97a2f
26.23,1.0,16,1,2,2,5,0xb2d3db40
3089048.13,3.0,116,4,4,1,9,0xb2d5668fd
90404.35,2.0,0,3,3,4,10,0xb2d2e08c
156515.33,16.0,21,3,4,2,9,0xb2d38325
390247.7,4.0,27,4,4,2,10,0xb2d596bf
17.05,1.0,10,1,2,3,6,0xb2d6c6ed
2412000.0,17.0,1,4,4,4,12,0xb2d1c422
919.95,1.0,9,1,2,3,6,0xb2d1da00
102412.1,4.0,104,3,4,1,8,0xb2d06c9a
3020370.4,19.0,0,4,4,4,12,0x3b9b0e20
166006.71,2.0,46,3,3,2,8,0xb2d2a698d
50439.78,1.0,92,2,2,1,5,0xb2d331f4
793.76,1.0,7,1,2,3,6,0xb2d27425
22.17,1.0,33,1,2,2,5,0xb2d8ef6f
3.96,1.0,4,1,2,4,7,0xb2d0d711d
400000.0,2.0,21,4,3,2,9,0xb2da25de
104888.25,1.0,60,3,2,2,7,0xb2d3e3ead
13868.9,1.0,3,2,2,4,8,0xb2d343cd
9103.32,1.0,28,2,2,2,6,0xb2d657e0
8.31,1.0,24,1,2,2,5,0xb2d3c43f
735573.89,7.0,0,4,4,4,12,0x3b9af133
10256.25,1.0,13,2,2,3,7,0xb2d8cb27
505340.79,2.0,18,4,3,2,9,0xb2d1c09c
10006.38,1.0,5,2,2,3,7,0xb2d60a82
17002.66,1.0,28,2,2,2,6,0xb2d2e3f5
15063.43,1.0,92,2,2,1,5,0xb2d531add
5495.13,1.0,4,2,2,4,8,0xb2d8fce9
2035525.49,4.0,31,4,4,2,10,0xb2d64e85
287225.93,4.0,0,3,4,4,11,0xb2d6561c
20125.55,2.0,30,2,3,2,7,0xb2d91255
70003.7,3.0,14,3,4,3,10,0xb2da2a17
7198.7,2.0,184,2,3,1,6,0x3b9b199e
1809.91,1.0,10,1,2,3,6,0xb2d6c5c6
150009.18,3.0,6,3,4,3,10,0xb2d23482
100000.0,1.0,0,3,2,4,9,0xb2d983a6
32098.14,3.0,80,2,4,1,7,0xb2d63176
1263.76,1.0,0,1,2,4,7,0xb2d1b5ec
340020.35,2.0,164,4,3,1,8,0xb2d168c4
89637.0,1.0,0,3,2,4,9,0xb2d6c130
10.33,1.0,24,1,2,2,5,0xb2d790a8
1588338.54,7.0,0,4,4,4,12,0xb2d621bfd
426.03,1.0,0,1,2,4,7,0xb2d9131e
0.49,1.0,2,1,2,4,7,0xb2d6bdea
560000.0,3.0,2,4,4,4,12,0xb2d5bdf9
2199.01,2.0,82,1,3,1,5,0xb2d1b01f
271043.79,8.0,12,3,4,3,10,0xb2d50fe7
266.77,1.0,15,1,2,3,6,0xb2d48c56
400000.71,2.0,13,4,3,3,10,0xb2d6a4ab
1104.98,1.0,184,1,2,1,4,0xb2d5af06
137007.54,4.0,41,3,4,2,9,0xb2d32bfd
561.79,1.0,0,1,2,4,7,0xb2d3ec82
508192.49,2.0,249,4,3,1,8,0xb2d2a083
2013203.37,1.0,0,4,2,4,10,0xb2d378cc
12948.93,1.0,184,2,2,1,5,0xb2d3046e
223678.4,6.0,35,3,4,2,9,0x3b9b38c3
150006.47,2.0,4,3,3,4,10,0xb2d62169
33001.0,3.0,8,2,4,3,9,0x3b9b3077
593568.13,7.0,0,4,4,4,12,0xb2d1d2a8d
123.23,1.0,25,1,2,2,5,0xb2d1ef63
600000.0,2.0,21,4,3,2,9,0xb2d952a9
16139.04,1.0,53,2,2,2,6,0xb2d441ec
24.78,1.0,29,1,2,2,5,0xb2d8a6a7
50837.76,2.0,217,2,3,1,6,0xb2d621cf
701405.93,3.0,11,4,4,3,11,0xb2d1a9ae
375.18,1.0,30,1,2,2,5,0xb2d30a8c
19.57,1.0,13,1,2,3,6,0xb2d6c4dc
10000.48,2.0,21,2,3,2,7,0xb2da1d30
150000.0,1.0,5,3,2,3,8,0xb2d54056
200753.68,2.0,66,3,3,2,8,0x3b9b39d5d
40066.78,3.0,26,2,4,2,8,0xb2d210e5
1067928.85,6.0,34,4,4,2,10,0x3b9ae041
11745.2,1.0,21,2,2,2,6,0xb2d9675c
1008905.57,3.0,18,4,4,2,10,0xb2d59f05
19.89,1.0,22,1,2,2,5,0xb2d6b453
331.01,1.0,1,1,2,4,7,0xb2d6cc70
230007.29,2.0,182,3,3,1,7,0xb2d8b3c5d
64.76,1.0,0,1,2,4,7,0xb2d3b97d
7329.39,4.0,1,2,4,4,10,0xb2d06514
11.81,1.0,8,1,2,3,6,0xb2d98d57
1925.51,1.0,126,1,2,1,4,0xb2d0bfac
2076721.17,11.0,28,4,4,2,10,0xb2d255ad
422743.47,2.0,16,4,3,2,9,0xb2d34f79
17.74,1.0,9,1,2,3,6,0xb2d75b51
120066.76,3.0,15,3,4,3,10,0xb2d926fa
102266.22,2.0,86,3,3,1,7,0xb2d2af68d
3982.67,1.0,26,2,2,2,6,0xb2d4b6f6
3099.0,1.0,118,2,2,1,5,0xb2d46144
0.0,5.0,6,1,4,3,8,0xb2d178ced
11878.81,1.0,5,2,2,3,7,0xb2d933f5
2324.76,1.0,0,1,2,4,7,0xb2d3039c
2213316.38,10.0,8,4,4,3,11,0xb2d473d8d
3116.38,1.0,83,2,2,1,5,0xb2d2a251d
16.33,1.0,0,1,2,4,7,0xb2d31d3d
10341.22,1.0,300,2,2,1,5,0xb2d238b3
1241.28,1.0,9,1,2,3,6,0xb2d37ffe
300000.63,2.0,18,3,3,2,8,0xb2d9d5f3
248.01,1.0,104,1,2,1,4,0xb2d11229
513571.16,4.0,16,4,4,2,10,0xb2d19b3cd
3793.68,1.0,10,2,2,3,7,0xb2d5657d
9074.27,3.0,184,2,4,1,7,0xb2d2c530
1623.09,1.0,92,1,2,1,4,0xb2d561b8d
46207.48,3.0,0,2,4,4,10,0xb2d54e03
131123.95,5.0,0,3,4,4,11,0xb2d21280
410112.09,5.0,47,4,4,2,10,0xb2d4b424
181589.42,4.0,69,3,4,1,8,0xb2d43cf1
19027.7,1.0,19,2,2,2,6,0xb2d2cb44d
984698.55,7.0,5,4,4,3,11,0xb2d5fe42
639003.46,5.0,0,4,4,4,12,0xb2d1bef3d
240000.0,4.0,0,3,4,4,11,0xb2d0e17d
747016.92,9.0,10,4,4,3,11,0xb2d086fe
3000000.79,4.0,2,4,4,4,12,0xb2d97a15
100005.28,3.0,41,3,4,2,9,0xb2d967a8
82089.63,5.0,0,3,4,4,11,0xb2d182a3
86.56,1.0,13,1,2,3,6,0xb2d3bb5d
2049.48,1.0,3,1,2,4,7,0xb2d3431f
37.65,1.0,1,1,2,4,7,0xb2d60d12
51495.12,2.0,69,2,3,1,6,0xb2d3a9ca
0.21,1.0,7,1,2,3,6,0xb2d151f7d
2777.63,3.0,182,1,4,1,6,0x3b9b2302
130065.37,2.0,7,3,3,3,9,0xb2d95aa2
5486.62,1.0,9,2,2,3,7,0xb2d5f8bd
400129.24,3.0,4,4,4,4,12,0xb2d6d621d
508000.02,10.0,4,4,4,4,12,0xb2d19efed
14485.97,1.0,21,2,2,2,6,0xb2d69dd8
309122.0,19.0,0,4,4,4,12,0x3b9af2d1
66347.74,1.0,6,3,2,3,8,0xb2d1856d
2869517.55,13.0,11,4,4,3,11,0xb2d288e0
39371.06,2.0,184,2,3,1,6,0x3b9b40dcd
15266.7,1.0,8,2,2,3,7,0xb2d3c258
12196.53,1.0,7,2,2,3,7,0xb2d3a21bd
57.49,1.0,59,1,2,2,5,0xb2d568d0
4669.61,1.0,20,2,2,2,6,0xb2d62e45
400950.21,3.0,8,4,4,3,11,0xb2d56572
11310000.0,7.0,0,4,4,4,12,0xb2d3555d
874923.04,5.0,17,4,4,2,10,0xb2d6bfc8
820344.93,3.0,4,4,4,4,12,0xb2d11b3dd
250598.15,3.0,143,3,4,1,8,0xb2d52158d
505329.52,3.0,93,4,4,1,9,0xb2d9823cd
100106.66,2.0,125,3,3,1,7,0xb2d10637
301409.3,2.0,8,4,3,3,10,0xb2d8ca5ed
166.03,1.0,7,1,2,3,6,0xb2d2ab6f
60775.12,1.0,1,3,2,4,9,0xb2d100d7
14201.2,1.0,0,2,2,4,8,0xb2d99c9a
100695.41,2.0,4,3,3,4,10,0xb2d2fb59
1014.54,1.0,92,1,2,1,4,0xb2d1481e
6689.74,1.0,7,2,2,3,7,0xb2d2a9b3
300064.29,2.0,4,3,3,4,10,0xb2d62a90
729215.66,2.0,7,4,3,3,10,0xb2d14e7d
87119.11,1.0,8,3,2,3,8,0xb2d7457c
400108.1,4.0,10,4,4,3,11,0xb2d8cffa
97.83,1.0,0,1,2,4,7,0xb2d586c8
306479.82,4.0,27,4,4,2,10,0xb2d6072d
61654.15,2.0,17,3,3,2,8,0xb2d391f8d
80003.27,2.0,46,3,3,2,8,0xb2d78680d
2010.93,1.0,184,1,2,1,4,0xb2d5f223
11744.21,1.0,0,2,2,4,8,0xb2d347ced
230002.53,3.0,11,3,4,3,10,0xb2d81089
3160.84,1.0,20,2,2,2,6,0xb2d2afaa
1642.76,2.0,92,1,3,1,5,0x3b9b1249
847.61,3.0,0,1,4,4,9,0xb2d394aed
2498.82,1.0,27,1,2,2,5,0xb2d8c89f
600309.16,5.0,39,4,4,2,10,0xb2d20aec
1009837.68,2.0,0,4,3,4,11,0xb2d26748
2401.01,1.0,0,1,2,4,7,0xb2d70193
500000.0,2.0,0,4,3,4,11,0xb2d982f0
11074.65,1.0,0,2,2,4,8,0xb2d695f5
1007325.37,3.0,23,4,4,2,10,0xb2d92053
50522.77,1.0,184,2,2,1,5,0xb2d3eb6a
1796.59,1.0,18,1,2,2,5,0xb2d6c634
207.07,1.0,23,1,2,2,5,0xb2d5cc66
2765.63,1.0,184,1,2,1,4,0xb2d1d775
171443.65,4.0,0,3,4,4,11,0xb2d6b202
150003.51,4.0,3,3,4,4,11,0xb2d3fe0b
570000.0,5.0,6,4,4,3,11,0xb2d6261f
0.0,1.0,4,1,2,4,7,0xb2d9319e
3615.97,1.0,92,2,2,1,5,0xb2d0da53
11274.39,1.0,0,2,2,4,8,0xb2d1d72e
201627.51,2.0,1,3,3,4,10,0xb2d0bc5b
1113.35,1.0,9,1,2,3,6,0xb2d69715
100275.77,2.0,154,3,3,1,7,0xb2d5db8e
1865.14,1.0,4,1,2,4,7,0xb2d258bb
150294.39,3.0,10,3,4,3,10,0xb2d5cbf4
120091.34,1.0,42,3,2,2,7,0xb2d623f0
549.92,1.0,89,1,2,1,4,0xb2d2b872
736.91,1.0,16,1,2,2,5,0xb2d2fc12
400027.11,2.0,50,4,3,2,9,0xb2d354fb
41631.92,1.0,0,2,2,4,8,0xb2d50dd9d
390238.52,4.0,1,4,4,4,12,0xb2d39dd8
12399.52,1.0,2,2,2,4,8,0xb2d6a7b3
1433.27,1.0,3,1,2,4,7,0xb2d5c450
55580.43,1.0,92,3,2,1,6,0xb2d285a2
15.39,2.0,124,1,3,1,5,0x3b9b0e39
60038.53,2.0,31,3,3,2,8,0xb2d20a87
1966134.52,3.0,8,4,4,3,11,0xb2d49160
11361.18,1.0,38,2,2,2,6,0xb2d14704d
94.14,1.0,19,1,2,2,5,0xb2d6b7e2
2000731.4,3.0,4,4,4,4,12,0xb2d6f78a
80.07,1.0,34,1,2,2,5,0xb2d42c04
4897.16,1.0,3,2,2,4,8,0xb2d1f56a
18730.58,1.0,6,2,2,3,7,0xb2d7849e
1011600.01,20.0,0,4,4,4,12,0x3b9b25d5
30781.88,1.0,6,2,2,3,7,0xb2d1e0ff
400005.88,3.0,0,4,4,4,12,0xb2d5fe5e
512443.58,2.0,34,4,3,2,9,0xb2d686a3
397096.79,6.0,1,4,4,4,12,0xb2d17c3f
10055.41,2.0,88,2,3,1,6,0xb2d112b1
3004.43,1.0,38,2,2,2,6,0xb2d8053bd
170095.41,3.0,8,3,4,3,10,0xb2d1e330
202157.42,2.0,23,3,3,2,8,0xb2d601a4
8000.84,1.0,4,2,2,4,8,0xb2d930ac
2425.04,1.0,92,1,2,1,4,0xb2d2d61f
58.19,1.0,131,1,2,1,4,0xb2d1fe80d
2949.76,1.0,92,2,2,1,5,0xb2d23338
10000.45,3.0,25,2,4,2,8,0xb2d53b0cd
41921.78,2.0,20,2,3,2,7,0xb2d06920d
111231.88,3.0,184,3,4,1,8,0xb2d15d22
462.1,1.0,12,1,2,3,6,0xb2d2785d
8475.74,1.0,2,2,2,4,8,0xb2d24632
500037.23,2.0,74,4,3,1,8,0xb2d62c2ad
288247.94,6.0,47,3,4,2,9,0xb2d14f94
731502.2,5.0,15,4,4,3,11,0xb2d5eb52
450078.89,4.0,4,4,4,4,12,0xb2d511c9
1010.49,1.0,184,1,2,1,4,0xb2d2bb53
451098.52,3.0,16,4,4,2,10,0xb2d593bed
10.39,1.0,17,1,2,2,5,0xb2d7ec2a
1040012.81,4.0,19,4,4,2,10,0xb2d6e5da
4638.85,1.0,184,2,2,1,5,0xb2d25655
10000000.0,3.0,184,4,4,1,9,0xb2d392b1
200000.0,2.0,52,3,3,2,8,0xb2d950da
1963878.52,14.0,11,4,4,3,11,0xb2d15743d
36007.11,2.0,77,2,3,1,6,0xb2d64d45
20000.42,2.0,200,2,3,1,6,0xb2d78fe7
100090.59,3.0,80,3,4,1,8,0xb2d19d31
83329.71,5.0,12,3,4,3,10,0xb2d6d32f
72.28,1.0,10,1,2,3,6,0xb2d34080
10.1,1.0,19,1,2,2,5,0xb2d2b679
214724.44,1.0,0,3,2,4,9,0xb2d489d6
5073697.49,5.0,0,4,4,4,12,0xb2d485cf
1523.87,1.0,92,1,2,1,4,0xb2d14692d
426808.53,3.0,118,4,4,1,9,0xb2d6bab6
1405.18,1.0,112,1,2,1,4,0xb2d6aee8
1274306.35,5.0,20,4,4,2,10,0xb2d16b3a
230847.64,7.0,1,3,4,4,11,0xb2d59b0a
161.74,1.0,12,1,2,3,6,0xb2d5387a
7.02,1.0,12,1,2,3,6,0xb2d2dace
115513.97,5.0,17,3,4,2,9,0xb2d53f54
148052.6,1.0,28,3,2,2,7,0xb2d6214d
0.0,1.0,3,1,2,4,7,0xb2d9386f
31272.75,2.0,2,2,3,4,9,0xb2da3765
200047.25,2.0,13,3,3,3,9,0xb2d58a91
400000.0,2.0,15,4,3,3,10,0xb2da376a
120073.54,2.0,206,3,3,1,7,0xb2d60df0
64.63,1.0,13,1,2,3,6,0xb2d64a90
500626.82,3.0,47,4,4,2,10,0xb2d695fcd
391061.66,4.0,22,4,4,2,10,0xb2d86ec0d
65.67,1.0,27,1,2,2,5,0xb2d6b3f4
683392.08,3.0,5,4,4,3,11,0xb2d9217c
3.97,1.0,19,1,2,2,5,0xb2d28f8e
17000000.0,2.0,92,4,3,1,8,0xb2d0b6a9
4120.64,1.0,10,2,2,3,7,0xb2d90820
9261.51,1.0,1,2,2,4,8,0xb2d6ab8c
743131.29,6.0,39,4,4,2,10,0xb2d23d6dd
43921.33,1.0,17,2,2,2,6,0xb2d0bd40
60190.81,2.0,16,3,3,2,8,0xb2d6f1dad
406374.23,2.0,95,4,3,1,8,0xb2d6dc59
200033.08,2.0,3,3,3,4,10,0xb2d78dd2
140475.55,6.0,8,3,4,3,10,0xb2d5ae31
956212.89,3.0,0,4,4,4,12,0xb2d62845d
3172.45,1.0,181,2,2,1,5,0xb2d5badb
4046.53,1.0,0,2,2,4,8,0xb2d6bb1c
320.46,1.0,0,1,2,4,7,0xb2d2cc0f
20000.99,3.0,6,2,4,3,9,0xb2d07e80d
255102.14,3.0,75,3,4,1,8,0xb2d0bf4c
1590.26,7.0,27,1,4,2,7,0xb2d64358
80303.24,3.0,164,3,4,1,8,0xb2d420b6
516186.37,3.0,8,4,4,3,11,0xb2d6ffba
600174.34,2.0,24,4,3,2,9,0xb2d92a3b
538607.92,11.0,3,4,4,4,12,0xb2d51de5
1639.72,1.0,14,1,2,3,6,0xb2d3159e
0.65,1.0,74,1,2,1,4,0xb2d6466fd
100005.7,3.0,34,3,4,2,9,0xb2d93b7e
614.74,1.0,26,1,2,2,5,0xb2d787a7
300012.67,2.0,70,3,3,1,7,0xb2d9a455
540017.52,1.0,0,4,2,4,10,0xb2d3e445
232.24,1.0,28,1,2,2,5,0xb2d89f1d
11.33,1.0,30,1,2,2,5,0xb2d90a10
506930.38,3.0,7,4,4,3,11,0xb2d8e29e
1981.28,1.0,184,1,2,1,4,0xb2d5e496
204.9,1.0,9,1,2,3,6,0xb2d11322
34686.2,1.0,1,2,2,4,8,0xb2d38ef3
247465.12,2.0,3,3,3,4,10,0xb2d1e902
4.77,1.0,89,1,2,1,4,0xb2d2979d
3586.79,1.0,181,2,2,1,5,0xb2d5cf76
20000.84,2.0,41,2,3,2,7,0xb2d91fc4
764.12,1.0,8,1,2,3,6,0xb2d1d90e
56649.92,1.0,7,3,2,3,8,0xb2d52c96
2254.39,1.0,0,1,2,4,7,0xb2d6bb7e
32.19,1.0,0,1,2,4,7,0xb2d1a895
100001.06,2.0,70,3,3,1,7,0xb2d9a5fc
0.0,1.0,0,1,2,4,7,0xb2d27fe8
605752.36,9.0,116,4,4,1,9,0xb2d0d1a8
182038.93,1.0,0,3,2,4,9,0xb2d5ce8f
2007318.01,4.0,4,4,4,4,12,0xb2d86b62
5510.25,1.0,0,2,2,4,8,0xb2d1057a
50829.56,2.0,139,2,3,1,6,0xb2d620d1d
6528.66,3.0,0,2,4,4,10,0xb2d6b279
30000.32,2.0,41,2,3,2,7,0xb2d9224d
402929.27,3.0,32,4,4,2,10,0xb2d48f7dd
3829.39,1.0,208,2,2,1,5,0xb2d593b6
44689.74,1.0,14,2,2,3,7,0xb2d441f6
314.44,1.0,59,1,2,2,5,0xb2d152ba
3522.32,1.0,1,2,2,4,8,0xb2d8c880
10.47,1.0,76,1,2,1,4,0xb2d355f1
30254.42,1.0,8,2,2,3,7,0xb2d419a6
66961.24,1.0,184,3,2,1,6,0xb2d250fd
150014.74,2.0,8,3,3,3,9,0xb2d929ed
4.33,1.0,17,1,2,2,5,0xb2d22207
1180867.39,2.0,71,4,3,1,8,0xb2d421c3
6568.73,1.0,184,2,2,1,5,0xb2d2f55ad
3525280.08,2.0,7,4,3,3,10,0xb2da469b
55511.4,5.0,24,3,4,2,9,0xb2d5def8
6347.98,1.0,1,2,2,4,8,0xb2d3e7b4
66509.13,2.0,66,3,3,2,8,0xb2d63e25
69548.48,1.0,1,3,2,4,9,0xb2da0974
100255.13,1.0,251,3,2,1,6,0xb2d67d2b
23442.87,1.0,14,2,2,3,7,0xb2d1ec39
2149.15,3.0,0,1,4,4,9,0x3b9b3679
135058.59,1.0,1,3,2,4,9,0xb2d94edd
1338906.98,3.0,0,4,4,4,12,0xb2da14b1
716050.99,4.0,10,4,4,3,11,0xb2d6ef5f
500214.64,4.0,147,4,4,1,9,0xb2d596a2
2065705.0,9.0,1,4,4,4,12,0xb2d32120
1064.97,1.0,171,1,2,1,4,0xb2d58116d
2009.97,1.0,184,1,2,1,4,0xb2d22562
4774.25,1.0,92,2,2,1,5,0xb2d128e5
751.09,1.0,18,1,2,2,5,0xb2d40451
3797.69,37.0,184,2,4,1,7,0xb2d218e7
5.56,1.0,15,1,2,3,6,0xb2d6a5d0
543.38,1.0,42,1,2,2,5,0xb2d2068e
340309.72,5.0,11,4,4,3,11,0xb2d1bfde
1400069.89,5.0,60,4,4,2,10,0xb2d66536
107967.6,5.0,1,3,4,4,11,0xb2d6457a
939.47,1.0,0,1,2,4,7,0xb2d1ca60
200141.8,3.0,62,3,4,2,9,0xb2d41aabd
100004.22,2.0,217,3,3,1,7,0xb2d7049f
51324.05,1.0,190,2,2,1,5,0xb2d62e8e
254027.04,6.0,12,3,4,3,10,0xb2d30e08
323.17,1.0,0,1,2,4,7,0xb2d21a23
80100.87,3.0,126,3,4,1,8,0xb2d09f72d
2926.87,1.0,92,2,2,1,5,0xb2d2331c
832263.63,4.0,78,4,4,1,9,0xb2d5c0a1
50002.64,2.0,34,2,3,2,7,0xb2d9f7e8
22.45,1.0,9,1,2,3,6,0xb2d2d295
52015.19,4.0,1,2,4,4,10,0xb2d0c54d
306046.29,3.0,10,4,4,3,11,0xb2d55a37d
4090.28,1.0,14,2,2,3,7,0xb2d62b1e
30010.45,1.0,15,2,2,3,7,0xb2d9a79c
525042.8,3.0,24,4,4,2,10,0xb2d45c70
2041.08,1.0,184,1,2,1,4,0xb2d3a146d
1235889.25,5.0,13,4,4,3,11,0xb2d33334d
175871.03,2.0,10,3,3,3,9,0xb2d5fcf6
990993.72,3.0,0,4,4,4,12,0xb2da1176
400235.74,4.0,4,4,4,4,12,0xb2d40c7a
3250106.89,6.0,6,4,4,3,11,0xb2d530ef
300042.49,4.0,83,3,4,1,8,0xb2d11f0e
132987.8,2.0,196,3,3,1,7,0xb2d1c4e9
3143.32,1.0,92,2,2,1,5,0xb2d0f69f
17271.96,1.0,20,2,2,2,6,0xb2d2be67
400210.92,4.0,6,4,4,3,11,0xb2d6ceb8d
1550031.77,9.0,28,4,4,2,10,0xb2d193bc
10593.27,1.0,3,2,2,4,8,0xb2d8db34
377001.7,9.0,6,4,4,3,11,0xb2d0c102
2312.0,1.0,32,1,2,2,5,0xb2d38538
876020.73,7.0,24,4,4,2,10,0xb2d20c06
620070.69,5.0,75,4,4,1,9,0xb2d28c7d
420000.0,4.0,0,4,4,4,12,0xb2d3b5b6
110582.79,5.0,0,3,4,4,11,0xb2d569f9
10099.64,1.0,1,2,2,4,8,0xb2d63587
38.41,1.0,75,1,2,1,4,0xb2d2328c
5461.65,1.0,73,2,2,1,5,0xb2d40fc7
110001.65,2.0,32,3,3,2,8,0xb2d5f956
10024.4,2.0,19,2,3,2,7,0xb2d0c2f3d
1569853.11,4.0,3,4,4,4,12,0xb2d16c31
3169.67,1.0,121,2,2,1,5,0xb2d298d8
110089.08,2.0,104,3,3,1,7,0xb2d578e2d
123042.42,2.0,53,3,3,2,8,0xb2d22388d
623023.03,3.0,8,4,4,3,11,0xb2d69c41
3231.43,1.0,2,2,2,4,8,0xb2d517e9
37378.21,5.0,0,2,4,4,10,0xb2d0b91dd
33.86,1.0,51,1,2,2,5,0xb2d60596d
50.53,1.0,40,1,2,2,5,0xb2d68e71
1301086.75,8.0,18,4,4,2,10,0xb2d78157
17.98,1.0,18,1,2,2,5,0xb2d36034
41092.72,4.0,0,2,4,4,10,0x3b9b456e
247196.08,2.0,0,3,3,4,10,0xb2d226ac
50025.33,1.0,24,2,2,2,6,0xb2d9cc7f
4241.99,1.0,9,2,2,3,7,0xb2d75c09d
2091.38,1.0,22,1,2,2,5,0xb2d2844c
2170492.31,4.0,3,4,4,4,12,0xb2d6effa
7.33,1.0,46,1,2,2,5,0xb2d227bd
302035.27,3.0,66,4,4,2,10,0xb2d2405b
1009951.73,2.0,18,4,3,2,9,0xb2d62d53
2008213.21,5.0,1,4,4,4,12,0xb2d63cfe
650000.0,2.0,20,4,3,2,9,0xb2d98c38
87072.38,2.0,104,3,3,1,7,0xb2d5256b
210102.7,2.0,80,3,3,1,7,0xb2d58109d
2716202.12,6.0,1,4,4,4,12,0xb2d5f068
60002.53,2.0,63,3,3,2,8,0xb2d9b2ed
302005.36,5.0,154,4,4,1,9,0xb2d125c3
425908.31,3.0,0,4,4,4,12,0xb2d5b425
419887.45,10.0,0,4,4,4,12,0xb2d212e8
3.75,1.0,2,1,2,4,7,0xb2d69723
501776.3,2.0,24,4,3,2,9,0xb2d90592d
360006.97,3.0,39,4,4,2,10,0xb2d97341
118271.16,1.0,146,3,2,1,6,0xb2d240e6
364730.24,4.0,0,4,4,4,12,0xb2d4addd
31299.31,2.0,4,2,3,4,9,0xb2d69cbc
6010.07,1.0,168,2,2,1,5,0xb2d6b96f
517442.23,12.0,0,4,4,4,12,0xb2d1f4fc
14.75,1.0,92,1,2,1,4,0xb2d2b181
441.0,1.0,10,1,2,3,6,0xb2d48085
170.97,1.0,10,1,2,3,6,0xb2d5a6a6
34235.57,1.0,92,2,2,1,5,0xb2d2dc19
2661.98,1.0,92,1,2,1,4,0xb2d2983ed
190064.4,5.0,95,3,4,1,8,0xb2d0779f
11.64,1.0,31,1,2,2,5,0xb2d100d6
110004.13,2.0,143,3,3,1,7,0xb2d54825d
7602.64,1.0,8,2,2,3,7,0xb2d68656
125912.79,1.0,12,3,2,3,8,0xb2d2d7ded
84.15,1.0,21,1,2,2,5,0xb2d65178
430013.39,5.0,60,4,4,2,10,0xb2d17977
50348.55,1.0,0,2,2,4,8,0xb2d570b4
2.33,1.0,0,1,2,4,7,0xb2d69223
300022.17,2.0,83,3,3,1,7,0xb2d98504
1223.32,1.0,184,1,2,1,4,0xb2d2dc8cd
4020.43,1.0,5,2,2,3,7,0xb2d69c2c
502068.32,2.0,44,4,3,2,9,0xb2d4b303
7773.08,1.0,149,2,2,1,5,0xb2d43ab3d
200000.0,2.0,11,3,3,3,9,0xb2d81200d
130004.03,3.0,49,3,4,2,9,0xb2d3d4e4
85050.97,2.0,92,3,3,1,7,0xb2d3d9c5
735.36,2.0,10,1,3,3,7,0x3b9b18f8
52010.77,2.0,263,2,3,1,6,0xb2d24fa3
392763.03,3.0,67,4,4,1,9,0xb2d3aba8
3.65,1.0,8,1,2,3,6,0xb2d33810
1302.62,1.0,117,1,2,1,4,0xb2d41cc6d
90427.67,1.0,38,3,2,2,7,0xb2d8d61bd
2539.65,1.0,1,1,2,4,7,0xb2d23f38
112550.29,2.0,196,3,3,1,7,0xb2d243f5d
30006.74,2.0,24,2,3,2,7,0xb2d10c88
442253.2,3.0,5,4,4,3,11,0xb2d6d094
1050000.79,8.0,3,4,4,4,12,0xb2d6067b
2.69,1.0,2,1,2,4,7,0xb2d96898
12038.55,1.0,92,2,2,1,5,0xb2d4b696
2475.24,1.0,184,1,2,1,4,0xb2d1ac22d
10003086.98,3.0,12,4,4,3,11,0xb2d31b5a
426.19,2.0,17,1,3,2,6,0xb2d24cb9
860000.0,1.0,0,4,2,4,10,0xb2d96207
262495.32,2.0,34,3,3,2,8,0xb2d58da4
460550.74,5.0,168,4,4,1,9,0xb2d41f77
1002.43,1.0,3,1,2,4,7,0xb2d6cfad
844.45,1.0,84,1,2,1,4,0xb2d8c61a
257354.72,4.0,0,3,4,4,11,0xb2d1f9b2
2342037.59,12.0,0,4,4,4,12,0xb2d1030c
2252.8,1.0,184,1,2,1,4,0xb2d2c193
290003.86,9.0,13,3,4,3,10,0xb2d78167
55000.85,3.0,14,3,4,3,10,0xb2d9adcf
10808.49,1.0,18,2,2,2,6,0xb2d98920
1903.22,2.0,155,1,3,1,5,0xb2d43fa6d
260031.75,13.0,20,3,4,2,9,0xb2d3bc76d
91201.85,6.0,3,3,4,4,11,0xb2d5746b
401454.2,3.0,35,4,4,2,10,0xb2d63396
1198.68,1.0,14,1,2,3,6,0xb2d69ae4
18268.19,1.0,92,2,2,1,5,0xb2d24dd2
56.69,1.0,48,1,2,2,5,0xb2d94b15
11202.44,2.0,174,2,3,1,6,0xb2d78ef3
5925.58,1.0,10,2,2,3,7,0xb2d6c566
300096.89,2.0,12,3,3,3,9,0xb2d65c5b
297015.68,2.0,35,3,3,2,8,0xb2d9f410
151213.88,4.0,3,3,4,4,11,0xb2d3939d
35750.27,10.0,0,2,4,4,10,0x3b9af287d
1003584.02,1.0,0,4,2,4,10,0xb2d62605
1479.69,7.0,4,1,4,4,9,0x3b9af122
661357.75,3.0,5,4,4,3,11,0xb2d22a6a
20501.05,3.0,104,2,4,1,7,0xb2d6706b
81.07,1.0,34,1,2,2,5,0xb2d8f9e5
31531.76,1.0,13,2,2,3,7,0xb2d7c33b
279588.2,2.0,5,3,3,3,9,0xb2d42855
104985.18,2.0,18,3,3,2,8,0xb2d257a0
117.81,1.0,7,1,2,3,6,0xb2d43a31
80001.38,3.0,35,3,4,2,9,0xb2d95c85
5101.54,1.0,10,2,2,3,7,0xb2d6befe
100399.32,5.0,3,3,4,4,11,0xb2d20681
1720091.45,6.0,21,4,4,2,10,0xb2d78c01d
20040.24,2.0,52,2,3,2,7,0xb2d58cb9
2406.17,1.0,184,1,2,1,4,0xb2d1651ad
8196.53,1.0,0,2,2,4,8,0xb2d502b2
100280.9,2.0,132,3,3,1,7,0xb2d1931a
7284.46,1.0,9,2,2,3,7,0xb2d42a7b
30000.58,2.0,144,2,3,1,6,0xb2d5d2dc
186289.74,2.0,0,3,3,4,10,0xb2d4477e
772592.96,2.0,25,4,3,2,9,0xb2d1479c
120078.22,4.0,0,3,4,4,11,0xb2d3b3ea
3286.47,1.0,15,2,2,3,7,0xb2d94d45
20.72,1.0,35,1,2,2,5,0xb2d69281
100000.0,2.0,4,3,3,4,10,0xb2d9cd0d
6511.0,3.0,92,2,4,1,7,0xb2d0ce96
508000.0,15.0,0,4,4,4,12,0xb2d0ed02
300000.0,3.0,0,3,4,4,11,0xb2d97e58
59000.45,2.0,0,3,3,4,10,0xb2d54b71d
10.11,1.0,1,1,2,4,7,0xb2d21167
45700.31,1.0,18,2,2,2,6,0xb2d5d4b5
1604.57,1.0,92,1,2,1,4,0xb2d62ab8d
15098.47,1.0,0,2,2,4,8,0xb2d70457
5417.35,4.0,184,2,4,1,7,0xb2d07f42
13116.04,1.0,45,2,2,2,6,0xb2d7f06f
1192152.86,15.0,25,4,4,2,10,0xb2d12d23
3553.43,1.0,184,2,2,1,5,0xb2d32c9d
13.44,1.0,3,1,2,4,7,0xb2d65a38
10959.91,1.0,0,2,2,4,8,0xb2d867d0
3.69,1.0,15,1,2,3,6,0xb2d681ca
7323.75,17.0,92,2,4,1,7,0xb2d204b7
300089.95,3.0,13,3,4,3,10,0xb2d958a1
7021.31,1.0,298,2,2,1,5,0xb2d692a5
451024.87,7.0,104,4,4,1,9,0xb2d287da
2493816.99,20.0,1,4,4,4,12,0xb2d5fca4
0.0,1.0,49,1,2,2,5,0xb2d35a4b
0.0,3.0,3,1,4,4,9,0xb2d069ced
580.22,1.0,0,1,2,4,7,0xb2d88bb3
304439.33,3.0,28,4,4,2,10,0xb2d0dc42
101221.14,3.0,3,3,4,4,11,0xb2d08403
3268.94,1.0,184,2,2,1,5,0xb2d1ae01
9355.09,2.0,0,2,3,4,9,0xb2d1d92f
7.93,1.0,37,1,2,2,5,0xb2d3226b
546.14,1.0,26,1,2,2,5,0xb2d3b8b5d
60002.75,6.0,19,3,4,2,9,0xb2d2a5be
0.09,12.0,0,1,4,4,9,0xb2d1aaab
19.94,1.0,56,1,2,2,5,0xb2d584fd
5.11,1.0,20,1,2,2,5,0xb2d5e8e3d
8.75,1.0,17,1,2,2,5,0xb2d25c1c
1.28,1.0,20,1,2,2,5,0xb2d69837
34.2,1.0,6,1,2,3,6,0xb2d613b2
100001.06,2.0,83,3,3,1,7,0xb2d8d188
400008.33,3.0,0,4,4,4,12,0xb2d98cb4
1002.89,1.0,5,1,2,3,6,0xb2d5bfb5d
816024.96,3.0,13,4,4,3,11,0xb2d6c201
3992.58,1.0,13,2,2,3,7,0xb2d434db
923194.48,34.0,0,4,4,4,12,0x3b9af141
120014.38,2.0,67,3,3,1,7,0xb2d24141
5582.28,1.0,7,2,2,3,7,0xb2d5d891
905318.04,20.0,5,4,4,3,11,0xb2d2527cd
30081.15,1.0,266,2,2,1,5,0xb2d36328
325862.65,3.0,92,4,4,1,9,0x3b9b1bb0
600000.91,2.0,11,4,3,3,10,0xb2da36e7
438344.64,2.0,7,4,3,3,10,0xb2d117b1
561789.81,2.0,16,4,3,2,9,0xb2d26c46d
128878.43,4.0,4,3,4,4,11,0xb2d34a61
100069.98,2.0,235,3,3,1,7,0xb2d3e703
4319.95,2.0,184,2,3,1,6,0x3b9b1612d
7196.29,1.0,4,2,2,4,8,0xb2d6a9b1
567015.04,6.0,14,4,4,3,11,0xb2d55378
2671.7,1.0,0,1,2,4,7,0xb2d858c8
14948.5,2.0,0,2,3,4,9,0xb2d9ed71
20026.37,2.0,59,2,3,2,7,0xb2d2b569
35134.85,1.0,111,2,2,1,5,0xb2d5be5e
70955.68,2.0,6,3,3,3,9,0xb2d561b3
150460.06,1.0,10,3,2,3,8,0xb2d867d8
92.55,1.0,26,1,2,2,5,0xb2d92ccc
122890.88,8.0,0,3,4,4,11,0x3b9b2f8f
100314.43,2.0,59,3,3,2,8,0xb2d6e163d
20.41,1.0,37,1,2,2,5,0xb2d922dd
5.78,1.0,15,1,2,3,6,0xb2d996e5
174252.54,2.0,92,3,3,1,7,0xb2d15ecc
140017.54,11.0,11,3,4,3,10,0xb2d48766
82718.29,2.0,130,3,3,1,7,0xb2d0b3be
5455.74,1.0,6,2,2,3,7,0xb2d4a97dd
20094.37,2.0,175,2,3,1,6,0xb2d5911c
72000.76,2.0,18,3,3,2,8,0xb2da3023
438.82,1.0,4,1,2,4,7,0xb2d1d1c0
3946209.57,3.0,5,4,4,3,11,0xb2d37bd4
2955.15,1.0,4,2,2,4,8,0xb2d59632
193832.21,1.0,0,3,2,4,9,0xb2d6a54ad
59231.41,1.0,0,3,2,4,9,0xb2d28b3f
5702650.37,6.0,11,4,4,3,11,0xb2d6861c
166205.8,2.0,4,3,3,4,10,0xb2d20024
8606.06,1.0,0,2,2,4,8,0xb2d51f26
71.98,1.0,54,1,2,2,5,0xb2d42f7a
50373.49,3.0,60,2,4,2,8,0xb2d614f4
353.03,2.0,6,1,3,3,7,0x3b9b3100d
0.0,1.0,6,1,2,3,6,0xb2d22f6c
500000.0,3.0,85,4,4,1,9,0xb2d9854d
240000.81,3.0,4,3,4,4,11,0xb2d5b9b6
8001.5,1.0,14,2,2,3,7,0xb2d9d043
258517.79,6.0,0,3,4,4,11,0x3b9b32e2
280120.3,3.0,13,3,4,3,10,0xb2d423d3
24739.51,1.0,1,2,2,4,8,0xb2d1b85bd
78.74,1.0,9,1,2,3,6,0xb2d790fa
1032367.4,13.0,0,4,4,4,12,0xb2d0c210
1043.96,1.0,12,1,2,3,6,0xb2d1b56bd
33569.81,1.0,1,2,2,4,8,0xb2d6cc55
300052.55,2.0,15,3,3,3,9,0xb2d509f2
2.72,1.0,49,1,2,2,5,0xb2d28628
941.99,9.0,12,1,4,3,8,0xb2d2334f
341873.14,3.0,0,4,4,4,12,0xb2d51e30
46.41,1.0,1,1,2,4,7,0xb2d8c846
44446.53,1.0,2,2,2,4,8,0xb2d33184d
60002.53,2.0,34,3,3,2,8,0xb2d93070
1260049.19,10.0,27,4,4,2,10,0xb2d0bd49
507256.44,2.0,47,4,3,2,9,0xb2d4cc23
9472.69,1.0,107,2,2,1,5,0xb2d6ddf2
102.11,1.0,0,1,2,4,7,0xb2d437ebd
50011.84,2.0,239,2,3,1,6,0xb2d53009
12105.09,2.0,0,2,3,4,9,0xb2d697bfd
17834.83,1.0,10,2,2,3,7,0xb2d1dd59d
66.77,1.0,19,1,2,2,5,0xb2d65af9
13564.77,1.0,2,2,2,4,8,0xb2d8a91f
1269.55,1.0,184,1,2,1,4,0xb2d0e9c4d
81934.66,2.0,83,3,3,1,7,0xb2d2a972
34.23,1.0,84,1,2,1,4,0xb2d4070a
2115.69,1.0,184,1,2,1,4,0xb2d12f9c
30536.12,1.0,173,2,2,1,5,0xb2d41422
240852.56,3.0,30,3,4,2,9,0xb2d8cce2
1188.11,1.0,122,1,2,1,4,0xb2d54a9a
8250.78,1.0,10,2,2,3,7,0xb2d7f42d
0.0,1.0,6,1,2,3,6,0xb2d6ab52
22.11,1.0,0,1,2,4,7,0xb2d39399d
1814.3,1.0,81,1,2,1,4,0xb2d3f376
100011.07,2.0,80,3,3,1,7,0xb2d8d742
888000.72,11.0,0,4,4,4,12,0xb2d076e3
576009.47,3.0,2,4,4,4,12,0xb2d364d7
55409.03,1.0,1,3,2,4,9,0xb2d42725
55819.77,1.0,0,3,2,4,9,0xb2d228de
20126.67,6.0,104,2,4,1,7,0xb2d1276e
3661.68,1.0,92,2,2,1,5,0xb2d1024e
314013.66,4.0,118,4,4,1,9,0xb2d11a2c
856754.6,5.0,25,4,4,2,10,0xb2d1af38
24002.67,1.0,10,2,2,3,7,0xb2d58939
116405.15,1.0,0,3,2,4,9,0xb2d0fc1c
73223.01,1.0,0,3,2,4,9,0xb2d29aba
159597.19,2.0,24,3,3,2,8,0xb2d416a6
18926.88,1.0,18,2,2,2,6,0xb2d83b70d
461016.77,5.0,0,4,4,4,12,0xb2d17909d
5118.76,1.0,184,2,2,1,5,0xb2d291d9
30874.03,2.0,143,2,3,1,6,0xb2d6270e
5037.25,1.0,184,2,2,1,5,0xb2d34b3ed
20008.18,2.0,94,2,3,1,6,0xb2d586d3
990714.06,11.0,19,4,4,2,10,0xb2d5b05c
438022.68,3.0,19,4,4,2,10,0xb2d1a5ee
900021.42,6.0,0,4,4,4,12,0xb2d982f4
2256.15,1.0,0,1,2,4,7,0xb2d3e81b
104809.21,2.0,80,3,3,1,7,0xb2d4f1c6d
111413.06,1.0,4,3,2,4,9,0xb2d23bb6
126563.74,2.0,171,3,3,1,7,0xb2d12079d
11629.33,1.0,11,2,2,3,7,0xb2d8b14e
149.35,1.0,20,1,2,2,5,0xb2d9e346
1700767.42,10.0,6,4,4,3,11,0xb2d5ee30
2961306.35,5.0,35,4,4,2,10,0xb2d23b4ad
302537.03,2.0,8,4,3,3,10,0xb2d6a627d
500000.0,2.0,8,4,3,3,10,0xb2d5ba46
1013309.26,5.0,1,4,4,4,12,0xb2d0d8d7
415043.14,5.0,11,4,4,3,11,0xb2d5c0ed
2260.64,1.0,3,1,2,4,7,0xb2d4667e
10037.36,1.0,0,2,2,4,8,0xb2d8f0c1
2201.34,1.0,1,1,2,4,7,0xb2d8cd1c
20.44,1.0,12,1,2,3,6,0xb2d221b0d
51952.16,1.0,184,2,2,1,5,0xb2d2b9c8
251655.59,5.0,0,3,4,4,11,0xb2d5e1a7
20746.66,1.0,103,2,2,1,5,0xb2d61269
215035.17,2.0,101,3,3,1,7,0xb2d18f26
2164.32,1.0,1,1,2,4,7,0xb2d56085
757113.98,5.0,15,4,4,3,11,0xb2d21dc2d
215397.63,3.0,69,3,4,1,8,0x3b9b2d2e
40033.15,2.0,41,2,3,2,7,0xb2d19ec4
2786.82,2.0,22,1,3,2,6,0xb2d963cbd
364841.76,5.0,0,4,4,4,12,0xb2d0f2ca
1423.29,1.0,158,1,2,1,4,0xb2d41b18
321462.17,3.0,111,4,4,1,9,0xb2d24033
351066.78,4.0,15,4,4,3,11,0xb2d61e45
82.49,1.0,0,1,2,4,7,0xb2d6c5c4
557.53,1.0,0,1,2,4,7,0xb2d2a16e
19115.11,1.0,0,2,2,4,8,0xb2d973e5
921823.31,7.0,32,4,4,2,10,0xb2d2669b
20001.9,1.0,18,2,2,2,6,0xb2d95b5c
5443.06,1.0,1,2,2,4,8,0xb2d2beef
302131.76,2.0,78,4,3,1,8,0xb2d99758
4033.37,1.0,10,2,2,3,7,0xb2d97c27
120007.92,2.0,76,3,3,1,7,0xb2d5cc1dd
2.92,2.0,25,1,3,2,6,0xb2d67e6a
159.6,1.0,62,1,2,2,5,0xb2d956c6
636576.52,2.0,184,4,3,1,8,0x3b9ae085
350187.4,4.0,0,4,4,4,12,0xb2d688d7
12088.57,2.0,6,2,3,3,8,0xb2d68201d
108.06,1.0,9,1,2,3,6,0xb2d42472
1334.49,1.0,0,1,2,4,7,0xb2d27b62
461866.61,6.0,10,4,4,3,11,0xb2d5f122
320.5,1.0,15,1,2,3,6,0xb2d2e216
50054.0,1.0,8,2,2,3,7,0xb2da493d
9990.94,1.0,14,2,2,3,7,0xb2d5cabd
29.53,1.0,15,1,2,3,6,0xb2d269cf
23.76,1.0,10,1,2,3,6,0xb2d9acbc
834.93,1.0,14,1,2,3,6,0xb2d704ce
327.84,1.0,17,1,2,2,5,0xb2d3aaa6
306013.56,7.0,10,4,4,3,11,0xb2d6819ed
1293.8,1.0,9,1,2,3,6,0xb2d3c1cc
96.47,1.0,15,1,2,3,6,0xb2d9e08e
36074.73,2.0,19,2,3,2,7,0xb2d64a32d
1051.53,1.0,7,1,2,3,6,0xb2d5b2e1
500748.78,7.0,66,4,4,2,10,0xb2d4387cd
180019.82,4.0,3,3,4,4,11,0xb2d5795ad
29940.45,1.0,10,2,2,3,7,0xb2d58bfb
582.35,1.0,10,1,2,3,6,0xb2d6befc
510034.42,5.0,21,4,4,2,10,0xb2d34c6b
9.01,1.0,3,1,2,4,7,0xb2d87dcd
4004.6,1.0,96,2,2,1,5,0xb2d8042f
87072.45,2.0,196,3,3,1,7,0xb2d5256bd
314829.09,3.0,83,4,4,1,9,0xb2d3b329
30045.62,1.0,153,2,2,1,5,0xb2d68dc7
530012.83,7.0,94,4,4,1,9,0xb2d0b9c8
330000.0,2.0,20,4,3,2,9,0xb2d9579e
2263.02,1.0,9,1,2,3,6,0xb2d8fd22
0.97,1.0,52,1,2,2,5,0xb2d25c3d
260890.91,2.0,7,3,3,3,9,0xb2d53797
20.25,1.0,39,1,2,2,5,0xb2d1b6acd
111232.78,2.0,5,3,3,3,9,0xb2d6e446
450003.92,3.0,12,4,4,3,11,0xb2d6b360
546473.51,2.0,80,4,3,1,8,0xb2d1bb17
1902.57,1.0,137,1,2,1,4,0xb2d6f01f
100015.04,2.0,73,3,3,1,7,0xb2d2a5b5
483442.74,3.0,18,4,4,2,10,0xb2d17fc2
799.7,1.0,14,1,2,3,6,0xb2d15482
259435.53,3.0,0,3,4,4,11,0xb2d2794dd
300018.48,4.0,6,3,4,3,10,0xb2d948d5
108007.48,3.0,63,3,4,2,9,0xb2d45630
104943.58,1.0,144,3,2,1,6,0xb2d46433
191088.68,12.0,1,3,4,4,11,0xb2d5a4d7
4.17,1.0,32,1,2,2,5,0xb2d9266d
965120.24,3.0,11,4,4,3,11,0xb2d16157
230125.02,12.0,4,3,4,4,11,0xb2d43124
30089.38,1.0,92,2,2,1,5,0xb2d4246c
50144.75,1.0,92,2,2,1,5,0xb2d5ecd7
24760.38,1.0,33,2,2,2,6,0xb2d80364
523425.41,2.0,8,4,3,3,10,0xb2d0f068
650000.0,6.0,7,4,4,3,11,0xb2d6f04a
113073.45,3.0,18,3,4,2,9,0xb2d52b62
91039.09,1.0,47,3,2,2,7,0xb2d91063
40511.45,1.0,51,2,2,2,6,0xb2d5f8c8d
105328.85,1.0,3,3,2,4,9,0xb2d1b1f3
460718.63,5.0,5,4,4,3,11,0xb2d17241
5159.2,1.0,92,2,2,1,5,0xb2d3e847
57643.75,1.0,0,3,2,4,9,0xb2d3313e
15697.68,1.0,62,2,2,2,6,0xb2d36e30
7853.36,1.0,0,2,2,4,8,0xb2d17d9f
100018.66,3.0,39,3,4,2,9,0xb2d5e7bd
23634.9,1.0,25,2,2,2,6,0xb2d28278
50875.22,2.0,108,2,3,1,6,0xb2d3a69c
320134.73,2.0,70,4,3,1,8,0xb2d25217
47498.2,1.0,0,2,2,4,8,0xb2d85a67
168855.3,4.0,0,3,4,4,11,0xb2d18dcfd
4692.89,1.0,92,2,2,1,5,0x3b9b29d4
10069.43,1.0,5,2,2,3,7,0xb2d23923
101710.44,2.0,256,3,3,1,7,0xb2d60936
105065.63,1.0,145,3,2,1,6,0xb2d4c0ab
9.53,2.0,71,1,3,1,5,0x3b9b3376
7.34,1.0,5,1,2,3,6,0xb2d31259
119038.73,6.0,10,3,4,3,10,0xb2d0c11d
200023.9,2.0,1,3,3,4,10,0xb2da6694
5244.99,1.0,10,2,2,3,7,0xb2d5cfd1
49.5,1.0,41,1,2,2,5,0xb2d57590
700000.0,5.0,8,4,4,3,11,0xb2d1ae83
20014.65,1.0,2,2,2,4,8,0xb2d6a032
3468000.65,10.0,4,4,4,4,12,0xb2d56ce3
81001.71,2.0,67,3,3,1,7,0xb2d9acd6
300035.01,1.0,3,3,2,4,9,0xb2d6d787d
2267.05,1.0,92,1,2,1,4,0xb2d161b2d
201426.47,2.0,75,3,3,1,7,0xb2d98c57
7.9,1.0,64,1,2,2,5,0xb2d69c9fd
169875.08,4.0,91,3,4,1,8,0xb2d250ee
505.85,1.0,10,1,2,3,6,0xb2d41e44
3309.64,2.0,0,2,3,4,9,0xb2d0eb63d
90.75,1.0,3,1,2,4,7,0xb2d38097d
7601.16,1.0,8,2,2,3,7,0xb2d9f345
200000.0,2.0,7,3,3,3,9,0xb2d7048b
150003.8,3.0,18,3,4,2,9,0xb2d6072a
300787.41,2.0,105,4,3,1,8,0xb2d5bfff
1631044.67,14.0,0,4,4,4,12,0xb2d6a8ae
10509.03,1.0,54,2,2,2,6,0xb2d6c6b3d
17251.76,3.0,46,2,4,2,8,0x3b9b1972d
1455000.0,16.0,1,4,4,4,12,0xb2d5b46c
2179.86,1.0,0,1,2,4,7,0xb2d55815
7577.15,2.0,184,2,3,1,6,0xb2d28705
100003.76,2.0,192,3,3,1,7,0xb2d527bc
50011.05,2.0,0,2,3,4,9,0xb2d3c5a0
13.76,1.0,43,1,2,2,5,0xb2d2b181d
7109.78,1.0,5,2,2,3,7,0xb2d36d29
4201.53,4.0,92,2,4,1,7,0xb2d3fa59
470320.24,5.0,4,4,4,4,12,0xb2d0a9bc
366559.17,4.0,9,4,4,3,11,0xb2d0680e
386.53,1.0,3,1,2,4,7,0xb2d6a747
17929.87,1.0,0,2,2,4,8,0xb2d58483
280046.05,2.0,139,3,3,1,7,0xb2d6df96
900106.27,3.0,22,4,4,2,10,0xb2d904ed
850601.77,6.0,14,4,4,3,11,0xb2d1dc92
62.49,1.0,1,1,2,4,7,0xb2d92699
20681.67,1.0,0,2,2,4,8,0xb2d39f15
200026.59,2.0,1,3,3,4,10,0xb2d17f23
300029.09,2.0,60,3,3,2,8,0xb2d3f791
805152.12,6.0,8,4,4,3,11,0xb2d5b071
1086500.41,3.0,95,4,4,1,9,0xb2d48189d
105691.5,2.0,56,3,3,2,8,0xb2d4ea48
86290.97,21.0,0,3,4,4,11,0x3b9b36b3d
53570.7,1.0,1,3,2,4,9,0xb2d8d09c
6019.71,1.0,158,2,2,1,5,0xb2d5d9be
114.71,1.0,29,1,2,2,5,0xb2d37cb9
4391110.67,17.0,0,4,4,4,12,0xb2d09fde
190339.28,2.0,206,3,3,1,7,0xb2d285c3d
2564.68,1.0,2,1,2,4,7,0xb2d69d1c
70493.55,1.0,19,3,2,2,7,0xb2d3956e
3252.96,1.0,15,2,2,3,7,0xb2d6c2fa
136894.63,2.0,122,3,3,1,7,0xb2d147b1
334063.09,11.0,0,4,4,4,12,0xb2d8ed52d
35417.8,1.0,77,2,2,1,5,0xb2d3cbead
26466.12,1.0,92,2,2,1,5,0xb2d215eed
123847.55,2.0,20,3,3,2,8,0xb2d2fd9d
963.36,1.0,17,1,2,2,5,0xb2d1ab7a
60000.0,2.0,6,3,3,3,9,0xb2d5eb59
600014.95,4.0,19,4,4,2,10,0xb2d77fea
60.66,2.0,31,1,3,2,6,0xb2d09508
110713.8,4.0,4,3,4,4,11,0xb2d62958
33449.92,2.0,18,2,3,2,7,0xb2d682aa
10017.24,1.0,0,2,2,4,8,0xb2d0debe
101826.31,1.0,6,3,2,3,8,0xb2d128da
48470.14,4.0,0,2,4,4,10,0xb2d1bee1
51937.64,1.0,5,2,2,3,7,0xb2d33071
360006.99,4.0,0,4,4,4,12,0x3b9b3bc9
254473.31,3.0,0,3,4,4,11,0xb2d337dcd
100083.49,2.0,129,3,3,1,7,0xb2d63654d
6140.71,1.0,1,2,2,4,8,0xb2d3e28b
1243330.47,7.0,0,4,4,4,12,0xb2d5292e
380004.22,5.0,1,4,4,4,12,0xb2d5813a
10000.21,2.0,40,2,3,2,7,0xb2d97096
222195.87,3.0,11,3,4,3,10,0xb2d91299
280.84,1.0,0,1,2,4,7,0xb2d41ea9
320071.36,2.0,0,4,3,4,11,0xb2d9c13a
120590.47,1.0,6,3,2,3,8,0xb2d1a744
1803.12,1.0,92,1,2,1,4,0xb2d404ca
314460.88,2.0,186,4,3,1,8,0xb2d51df6
3051.27,1.0,9,2,2,3,7,0xb2d70769
442041.75,3.0,0,4,4,4,12,0xb2d30b3bd
65279.54,1.0,11,3,2,3,8,0xb2d2aecc
78.83,1.0,139,1,2,1,4,0xb2d60144d
3231.09,1.0,0,2,2,4,8,0xb2d8eb29
580000.2,4.0,3,4,4,4,12,0xb2d93694
0.0,1.0,0,1,2,4,7,0xb2d37882
4854.16,1.0,15,2,2,3,7,0xb2d1d87b
22.69,1.0,84,1,2,1,4,0xb2d6be5d
414000.0,6.0,0,4,4,4,12,0xb2d1a674
717079.68,16.0,4,4,4,4,12,0xb2d52477
161085.66,9.0,3,3,4,4,11,0xb2d31646
1091256.9,12.0,76,4,4,1,9,0xb2d12748
350974.26,4.0,18,4,4,2,10,0xb2d084ecd
204004.12,2.0,84,3,3,1,7,0xb2d2f519
599.52,1.0,1,1,2,4,7,0xb2d5d5c9
95639.33,1.0,6,3,2,3,8,0xb2d56395
120153.6,2.0,60,3,3,2,8,0xb2d3ecddd
5616.39,2.0,92,2,3,1,6,0xb2d070e0
1203539.53,4.0,0,4,4,4,12,0xb2d4ac55
1445835.24,6.0,3,4,4,4,12,0xb2d6d279
665416.68,6.0,0,4,4,4,12,0x3b9b31e0d
12.95,1.0,46,1,2,2,5,0xb2d64d2e
28780000.0,2.0,42,4,3,2,9,0xb2d5030cd
74338.62,2.0,104,3,3,1,7,0xb2d12bf7
50625.2,2.0,17,2,3,2,7,0xb2d0909a
1264.2,1.0,92,1,2,1,4,0xb2d1011a
770000.15,3.0,0,4,4,4,12,0xb2d6abf8
3794.66,1.0,7,2,2,3,7,0xb2d5dc63
1949.12,1.0,4,1,2,4,7,0xb2d60a35
100003.63,2.0,40,3,3,2,8,0xb2d8e1a8
35488.22,1.0,0,2,2,4,8,0xb2d64735
200007.96,4.0,110,3,4,1,8,0xb2d6d7d4
24374.73,3.0,0,2,4,4,10,0x3b9b1876
68334.71,1.0,0,3,2,4,9,0xb2d8225d
291724.13,5.0,6,3,4,3,10,0xb2d0a22c
388.73,1.0,75,1,2,1,4,0xb2d53fa8
2023.7,1.0,92,1,2,1,4,0xb2d3645d
1020130.5,2.0,101,4,3,1,8,0xb2d64a9e
400019.17,3.0,83,4,4,1,9,0xb2d17a81
1253.16,1.0,2,1,2,4,7,0xb2d41f73
858006.35,8.0,25,4,4,2,10,0xb2d52b59
22230.11,1.0,1,2,2,4,8,0xb2d6cc77
9332.57,1.0,7,2,2,3,7,0xb2d3ab74d
30391.85,3.0,0,2,4,4,10,0xb2d1345e
1840003.48,3.0,12,4,4,3,11,0xb2d80061
500002.96,3.0,102,4,4,1,9,0xb2d3630bd
801097.36,10.0,0,4,4,4,12,0xb2d2889b
200064.94,3.0,27,3,4,2,9,0xb2d26ff6
200003.63,3.0,3,3,4,4,11,0xb2d4f795
550041.29,1.0,0,4,2,4,10,0xb2da4883
529.19,1.0,4,1,2,4,7,0xb2d6bd7c
530.21,1.0,18,1,2,2,5,0xb2d90ca9d
524.48,1.0,3,1,2,4,7,0xb2d92243
272.86,1.0,9,1,2,3,6,0xb2d50e3a
2103.2,1.0,0,1,2,4,7,0xb2d3491b
100000.54,3.0,18,3,4,2,9,0xb2d5ba7ad
500000.0,2.0,27,4,3,2,9,0xb2d944a0d
6972.77,1.0,9,2,2,3,7,0xb2d967a1
5496.02,1.0,134,2,2,1,5,0xb2d40619
206049.33,3.0,256,3,4,1,8,0x3b9b4755
20.5,1.0,1,1,2,4,7,0xb2d92876
4195.19,1.0,0,2,2,4,8,0xb2d2abc1
1015.89,1.0,184,1,2,1,4,0xb2d60fc4
1071245.57,9.0,4,4,4,4,12,0xb2d5b72dd
29595.16,1.0,26,2,2,2,6,0xb2d64210
5814.63,1.0,92,2,2,1,5,0xb2d23cbe
20086.99,1.0,58,2,2,2,6,0xb2d7009e
1191.97,3.0,14,1,4,3,8,0xb2d5cc65
5545.8,1.0,17,2,2,2,6,0xb2d0b6f3d
9401.92,1.0,14,2,2,3,7,0xb2d29b9b
120007.41,3.0,98,3,4,1,8,0xb2d59669d
497081.47,5.0,93,4,4,1,9,0xb2d44a69
2401.99,2.0,184,1,3,1,5,0xb2d0d5cb
49.39,1.0,9,1,2,3,6,0xb2d3c04a
5486100.16,17.0,2,4,4,4,12,0xb2d6ce97
204133.68,2.0,96,3,3,1,7,0xb2d96f38
21.54,1.0,6,1,2,3,6,0xb2d4072e
604442.1,6.0,22,4,4,2,10,0xb2d281f3
5015.21,1.0,39,2,2,2,6,0xb2d21dca
200000.0,2.0,4,3,3,4,10,0xb2d926b5
759544.33,1.0,92,4,2,1,7,0xb2d3a353
51632.31,2.0,119,2,3,1,6,0xb2d5e64bd
211209.82,10.0,0,3,4,4,11,0xb2d28188
1012.7,1.0,184,1,2,1,4,0xb2d0e306
200059.86,2.0,13,3,3,3,9,0xb2d6f8e8
1038780.82,22.0,4,4,4,4,12,0xb2d3b6ed
2931000.69,4.0,2,4,4,4,12,0xb2d5ec4c
309924.28,2.0,92,4,3,1,8,0xb2d4e8e9
18018.29,1.0,5,2,2,3,7,0xb2d95cfd
4031.21,1.0,1,2,2,4,8,0xb2d3118f
15390.31,1.0,136,2,2,1,5,0xb2d19bb0
300000.0,2.0,4,3,3,4,10,0xb2d236b9
150003.17,2.0,39,3,3,2,8,0xb2d9eeba
13431.91,1.0,14,2,2,3,7,0xb2d6bd1a
30357.21,2.0,69,2,3,1,6,0xb2d6bbc2
359994.92,3.0,35,4,4,2,10,0xb2d398fb
1230.27,1.0,184,1,2,1,4,0xb2d2722f
137062.52,2.0,0,3,3,4,10,0xb2d21a39
20117.21,1.0,0,2,2,4,8,0xb2d4cc14
120000.0,3.0,0,3,4,4,11,0xb2d970f5d
9554.3,2.0,0,2,3,4,9,0x3b9b43aa
1008.91,1.0,184,1,2,1,4,0xb2d1aa1e
0.0,1.0,10,1,2,3,6,0xb2d5cec2d
998.44,1.0,1,1,2,4,7,0xb2d575a9
10.01,2.0,60,1,3,2,6,0xb2d9ae56
200000.0,2.0,15,3,3,3,9,0xb2da3817
110000.33,2.0,159,3,3,1,7,0xb2d1fc2a
96725462.99,12.0,32,4,4,2,10,0xb2d07933
4939.95,1.0,184,2,2,1,5,0xb2d1bed6
700049.5,3.0,45,4,4,2,10,0xb2d642f7
6636.06,1.0,49,2,2,2,6,0xb2d902d9
2074.11,1.0,10,1,2,3,6,0xb2d46e8dd
2.19,7.0,39,1,4,2,7,0xb2d227bf
1.88,1.0,11,1,2,3,6,0xb2d923d8
784.93,1.0,10,1,2,3,6,0xb2d342fd
419.95,1.0,71,1,2,1,4,0xb2d2b662
545358.3,3.0,42,4,4,2,10,0xb2d262a3
51103.36,1.0,5,2,2,3,7,0xb2d8c383
43809.34,1.0,19,2,2,2,6,0xb2d68c59
80.1,1.0,20,1,2,2,5,0xb2d68abd
208680.71,2.0,130,3,3,1,7,0xb2d57125
30902.1,1.0,3,2,2,4,8,0xb2d62179
1456162.97,7.0,0,4,4,4,12,0xb2d10bded
1011501.92,2.0,0,4,3,4,11,0xb2d3b995
400599.4,2.0,38,4,3,2,9,0xb2d0fb9d
400173.54,3.0,16,4,4,2,10,0xb2d6f24c
634070.03,2.0,17,4,3,2,9,0xb2d97e5b
527004.36,12.0,2,4,4,4,12,0xb2d59b14
90018.84,4.0,0,3,4,4,11,0xb2d1c2c3
200085.88,2.0,11,3,3,3,9,0xb2d548cfd
21820.83,1.0,10,2,2,3,7,0xb2d5cf28
51043.68,2.0,83,2,3,1,6,0xb2d63ca8
95980.0,1.0,0,3,2,4,9,0xb2d96020
24200.69,1.0,0,2,2,4,8,0xb2d2ac1c
0.0,1.0,8,1,2,3,6,0xb2d46e8f
428100.0,2.0,0,4,3,4,11,0xb2da5d68
3074.88,1.0,1,2,2,4,8,0xb2d63b9a
17631.75,1.0,0,2,2,4,8,0xb2d28651
330003.16,3.0,2,4,4,4,12,0xb2d9383e
8646.37,1.0,6,2,2,3,7,0xb2d97d4a
266385.14,4.0,0,3,4,4,11,0xb2d25769
492.22,1.0,24,1,2,2,5,0xb2d27b91
500968.43,1.0,10,4,2,3,9,0xb2d478c7
782256.51,4.0,7,4,4,3,11,0xb2d945e3
2003.98,1.0,179,1,2,1,4,0xb2d178b3
356466.25,1.0,0,4,2,4,10,0xb2d68eebd
8753.38,1.0,9,2,2,3,7,0xb2d571c1
648717.13,2.0,118,4,3,1,8,0xb2d3637c
6538.16,2.0,0,2,3,4,9,0xb2d4aa1a
102999.75,2.0,122,3,3,1,7,0xb2d41dfed
210010.56,2.0,6,3,3,3,9,0xb2d8db49
200002.17,2.0,60,3,3,2,8,0xb2d629d3
79672.87,1.0,4,3,2,4,9,0xb2d1c931d
201454.37,2.0,116,3,3,1,7,0xb2d67dc5
946098.51,1.0,1,4,2,4,10,0xb2d6dc1bd
32.73,1.0,0,1,2,4,7,0xb2d250dc
694904.4,6.0,2,4,4,4,12,0xb2d51b2c
400115.59,2.0,52,4,3,2,9,0xb2d0de83
15222.07,1.0,1,2,2,4,8,0xb2d21a77
7514.74,1.0,1,2,2,4,8,0xb2d32205
23368.89,1.0,116,2,2,1,5,0xb2d59eba
3.6,1.0,1,1,2,4,7,0xb2d24af6
28.93,1.0,11,1,2,3,6,0xb2d8d4e2
150015.34,2.0,136,3,3,1,7,0xb2d593e6
3013.86,1.0,184,2,2,1,5,0xb2d59b37
64688.74,3.0,134,3,4,1,8,0xb2d6103a
369440.09,2.0,0,4,3,4,11,0xb2d64967
123147.62,1.0,26,3,2,2,7,0xb2d256e0
581423.9,3.0,2,4,4,4,12,0xb2d6caef
33901.61,1.0,22,2,2,2,6,0xb2d6b0cd
200000.0,2.0,1,3,3,4,10,0xb2d9820a
64.73,1.0,54,1,2,2,5,0xb2d86d61
64.76,1.0,65,1,2,2,5,0xb2d20e6fd
50002.11,2.0,92,2,3,1,6,0xb2d63559
216928.36,3.0,73,3,4,1,8,0xb2d441d5
57.95,1.0,22,1,2,2,5,0xb2d69e41
200808.94,2.0,24,3,3,2,8,0xb2d9a6c1
33665.06,1.0,137,2,2,1,5,0xb2d33a2d
81030.16,3.0,3,3,4,4,11,0xb2d4fbf7
3787.99,1.0,0,2,2,4,8,0xb2d67ebe
2135.16,1.0,92,1,2,1,4,0xb2d23ed8
800004.75,2.0,25,4,3,2,9,0xb2da0f02
437.16,1.0,11,1,2,3,6,0xb2d471d3
5593.1,5.0,0,2,4,4,10,0xb2d1c5e4
5326.59,1.0,92,2,2,1,5,0xb2d2eebed
8799.71,1.0,4,2,2,4,8,0xb2d6f282d
1505.17,1.0,0,1,2,4,7,0xb2d6f2a9
51184.83,5.0,3,2,4,4,10,0xb2d42dd3
208788.53,20.0,0,3,4,4,11,0xb2d124ced
1010660.66,2.0,110,4,3,1,8,0xb2d95b29d
705656.99,3.0,150,4,4,1,9,0xb2d2b3da
3823.21,1.0,200,2,2,1,5,0xb2d26067
0.0,1.0,1,1,2,4,7,0xb2d68bd7
408291.08,3.0,0,4,4,4,12,0xb2d210b7
100608.57,2.0,0,3,3,4,10,0xb2d78ff4
70006.51,3.0,2,3,4,4,11,0xb2d312d4d
4075.72,1.0,9,2,2,3,7,0xb2d41c80d
34.71,4.0,18,1,4,2,7,0x3b9b446b
80014.59,2.0,5,3,3,3,9,0xb2d3e41e
1.46,1.0,12,1,2,3,6,0xb2d9b370
875.8,1.0,22,1,2,2,5,0xb2d29a44
598790.66,13.0,3,4,4,4,12,0xb2d1882e
250645.24,4.0,104,3,4,1,8,0xb2d3b573
301200.95,2.0,40,4,3,2,9,0xb2d258f8
200000.43,2.0,15,3,3,3,9,0xb2d9184e
3754.61,1.0,9,2,2,3,7,0xb2d28480
4020.26,1.0,10,2,2,3,7,0xb2d342f2
337015.28,6.0,39,4,4,2,10,0xb2d6c1bf
4283.65,16.0,0,2,4,4,10,0xb2d1f8d8d
2528231.57,2.0,0,4,3,4,11,0xb2d6cfa3
74863.23,2.0,15,3,3,3,9,0xb2d55a2a
180052.36,3.0,18,3,4,2,9,0xb2d5d4f7
521404.14,1.0,3,4,2,4,10,0xb2d0d790
300052.65,2.0,2,3,3,4,10,0xb2d6275b
46.2,1.0,3,1,2,4,7,0xb2d1f8b4
60077.54,2.0,0,3,3,4,10,0xb2d6d77b
535120.55,4.0,139,4,4,1,9,0xb2d1c247
400046.68,4.0,18,4,4,2,10,0x3b9b49e3
70613.5,3.0,108,3,4,1,8,0xb2d5ebd4
0.0,1.0,4,1,2,4,7,0xb2d8f828
21202.76,1.0,0,2,2,4,8,0xb2d0cdde
186103.69,4.0,4,3,4,4,11,0xb2d5f233
604.88,1.0,9,1,2,3,6,0xb2d50f7b
1900.56,1.0,0,1,2,4,7,0xb2d33f57
120003.38,3.0,87,3,4,1,8,0xb2d6ab17d
4920.88,1.0,3,2,2,4,8,0xb2d3ca8b
9442.5,1.0,10,2,2,3,7,0xb2d31909
50190.52,2.0,234,2,3,1,6,0xb2d2ae28d
70002.44,4.0,48,3,4,2,9,0xb2d6a7c7
542293.97,2.0,4,4,3,4,11,0xb2d1031d
141157.66,12.0,11,3,4,3,10,0xb2d60034
180003.59,5.0,49,3,4,2,9,0xb2d105c9
100002.11,2.0,97,3,3,1,7,0xb2d84eee
102106.77,3.0,1,3,4,4,11,0xb2d1039a
17956.69,1.0,7,2,2,3,7,0xb2d2ebd1
510013.54,7.0,27,4,4,2,10,0xb2d68e3f
710634.97,5.0,6,4,4,3,11,0xb2d1f3d7d
557122.14,5.0,12,4,4,3,11,0xb2d672fd
60.04,1.0,9,1,2,3,6,0xb2d8c534
10.76,1.0,0,1,2,4,7,0xb2d5d2ca
1148708.37,6.0,13,4,4,3,11,0xb2d2e42cd
29383.29,1.0,184,2,2,1,5,0xb2d283bb
911287.92,3.0,9,4,4,3,11,0xb2d7002bd
2809.59,1.0,32,1,2,2,5,0xb2d340c9
500665.32,2.0,11,4,3,3,10,0xb2d78805
92.61,1.0,10,1,2,3,6,0xb2d6f47a
1713.26,2.0,92,1,3,1,5,0x3b9acd4e
1220.23,1.0,27,1,2,2,5,0xb2d60af8
90126.18,1.0,14,3,2,3,8,0xb2d512b6
7252.99,1.0,92,2,2,1,5,0xb2d25544
50008.27,1.0,0,2,2,4,8,0xb2d64616
945.62,1.0,16,1,2,2,5,0xb2d2990cd
500005.27,4.0,21,4,4,2,10,0xb2d8d531
724586.55,6.0,25,4,4,2,10,0xb2d66536d
153780.41,1.0,0,3,2,4,9,0xb2d2f3f2
1208.33,1.0,2,1,2,4,7,0xb2d1ead5d
412205.7,3.0,104,4,4,1,9,0xb2d62653
521891.56,5.0,31,4,4,2,10,0xb2d247b7d
2181.16,1.0,39,1,2,2,5,0xb2d3008d
25.69,1.0,21,1,2,2,5,0xb2d9ab02
100634.65,2.0,27,3,3,2,8,0xb2d52ff0
810.64,1.0,10,1,2,3,6,0xb2d5d134
80047.15,3.0,7,3,4,3,10,0xb2d06ba2
20117.69,2.0,92,2,3,1,6,0xb2d85835d
2699.21,1.0,6,1,2,3,6,0xb2d39a21
612.55,2.0,0,1,3,4,8,0xb2d5a45f
1015.57,1.0,92,1,2,1,4,0xb2d0f630
637835.59,4.0,10,4,4,3,11,0xb2d17724
400013.95,3.0,0,4,4,4,12,0xb2d1bfe1
0.53,1.0,18,1,2,2,5,0xb2d956a0
550064.38,4.0,0,4,4,4,12,0xb2d1c1ff
12.55,1.0,19,1,2,2,5,0xb2da0a23
956802.72,3.0,63,4,4,2,10,0xb2d43e98
2007.25,1.0,184,1,2,1,4,0xb2d5f8aad
287570.44,1.0,3,3,2,4,9,0xb2d7010f
12009.41,1.0,22,2,2,2,6,0xb2d1c484
1484780.04,8.0,2,4,4,4,12,0xb2d59763
10011.61,2.0,22,2,3,2,7,0xb2da15e5
1000540.94,2.0,56,4,3,2,9,0xb2d8f112
4.81,1.0,8,1,2,3,6,0xb2d5f3c6
300070.65,2.0,0,3,3,4,10,0xb2d4047d
8289.87,1.0,3,2,2,4,8,0xb2d532c2d
246584.45,3.0,3,3,4,4,11,0xb2d1dc46
818175.76,10.0,1,4,4,4,12,0xb2d53c25
2810.6,2.0,184,1,3,1,5,0xb2d115c7
3090.05,1.0,92,2,2,1,5,0xb2d2aec1d
249.76,2.0,9,1,3,3,7,0xb2d45ab0
7.28,1.0,69,1,2,1,4,0xb2d98782
49056.6,3.0,12,2,4,3,9,0xb2d4e795
200000.85,2.0,7,3,3,3,9,0xb2d23538
361008.23,6.0,6,4,4,3,11,0xb2d2a36b
411205.69,3.0,0,4,4,4,12,0xb2d9ddaf
300000.0,2.0,4,3,3,4,10,0xb2d59425
96045.99,1.0,9,3,2,3,8,0xb2d6d207
274293.68,1.0,0,3,2,4,9,0xb2d52cc4
22.29,1.0,1,1,2,4,7,0xb2d21561
80297.27,1.0,148,3,2,1,6,0xb2d11676
1346.52,1.0,12,1,2,3,6,0xb2d55d2d
244473.78,3.0,97,3,4,1,8,0xb2d3f1d3d
466.97,1.0,70,1,2,1,4,0xb2d78eef
4949.5,1.0,0,2,2,4,8,0xb2d972e6
2002.56,1.0,184,1,2,1,4,0xb2d29aa5d
6997.31,1.0,0,2,2,4,8,0xb2d6bffc
202855.21,2.0,17,3,3,2,8,0xb2d636bb
440229.53,5.0,6,4,4,3,11,0xb2d64eca
21148.63,1.0,184,2,2,1,5,0xb2d2361dd
360094.79,3.0,73,4,4,1,9,0xb2d5e96f
720000.0,18.0,9,4,4,3,11,0xb2d1d938d
18030.85,1.0,14,2,2,3,7,0xb2d55370d
103626.75,2.0,47,3,3,2,8,0xb2d102bd
200002.11,2.0,202,3,3,1,7,0xb2d69509
30000.86,2.0,35,2,3,2,7,0xb2d5fdaa
170195.91,3.0,55,3,4,2,9,0xb2d1b866
67.09,1.0,101,1,2,1,4,0xb2d60869
200716.81,2.0,38,3,3,2,8,0xb2d60c13d
62.73,1.0,9,1,2,3,6,0xb2d45771
7483.27,1.0,92,2,2,1,5,0xb2d24a54
500099.45,3.0,83,4,4,1,9,0xb2d6e7a6
8276.27,2.0,0,2,3,4,9,0xb2d0d505d
143023.79,2.0,39,3,3,2,8,0xb2d5d59c
140533.3,2.0,3,3,3,4,10,0xb2d62595d
1318592.84,5.0,0,4,4,4,12,0xb2d609c9
57.21,1.0,13,1,2,3,6,0xb2d985f0
250665.69,3.0,25,3,4,2,9,0xb2d189c2
0.81,1.0,1,1,2,4,7,0xb2d9a358
650022.38,4.0,172,4,4,1,9,0xb2d1ffad
17384.11,1.0,6,2,2,3,7,0xb2d91381d
50665.25,2.0,26,2,3,2,7,0xb2d379b6d
200000.0,2.0,4,3,3,4,10,0xb2d87de2d
1301372.86,4.0,7,4,4,3,11,0xb2d1b6a4d
5247.05,1.0,92,2,2,1,5,0xb2d25e88d
979.04,2.0,2,1,3,4,8,0xb2d1aea1
7.55,16.0,25,1,4,2,7,0xb2d6e166
111.13,2.0,26,1,3,2,6,0xb2d8d915
1.28,1.0,20,1,2,2,5,0xb2d78e79
146920.94,9.0,0,3,4,4,11,0xb2d2237b
873895.18,6.0,77,4,4,1,9,0xb2d3b456
664.13,1.0,0,1,2,4,7,0xb2d28e62d
22851.53,2.0,186,2,3,1,6,0xb2d2712b
123059.34,3.0,6,3,4,3,10,0xb2d3fe01
153470.63,3.0,32,3,4,2,9,0xb2d5969c
100039.37,2.0,182,3,3,1,7,0xb2d6016a
12318.18,1.0,11,2,2,3,7,0xb2d935f6
852.06,1.0,10,1,2,3,6,0xb2d41907d
1214000.75,38.0,0,4,4,4,12,0xb2d0d04b
30002.93,2.0,11,2,3,3,8,0xb2d3bbb6
5414.59,2.0,4,2,3,4,9,0xb2d0b3e7
500025.5,4.0,1,4,4,4,12,0xb2da64b0
10.53,1.0,18,1,2,2,5,0xb2d601f8
3.64,2.0,42,1,3,2,6,0xb2d28179
5214.94,2.0,184,2,3,1,6,0xb2d0779ed
8261.64,1.0,0,2,2,4,8,0xb2d29d91
50030.71,2.0,60,2,3,2,7,0xb2d6d156
400000.4,2.0,5,4,3,3,10,0xb2d0a39c
2732481.45,25.0,3,4,4,4,12,0x3b9b2318
389025.7,7.0,0,4,4,4,12,0xb2d0689d
1277569.55,5.0,3,4,4,4,12,0xb2d13fad
155626.97,1.0,12,3,2,3,8,0xb2d2ba98d
200328.39,5.0,92,3,4,1,8,0xb2d5bd1c
670.99,1.0,11,1,2,3,6,0xb2d1d591
50023.04,2.0,258,2,3,1,6,0xb2d2986d
2575.86,1.0,46,1,2,2,5,0xb2d3dca9
4.01,1.0,10,1,2,3,6,0xb2d6e16d
27673.53,4.0,0,2,4,4,10,0xb2d092a1
100004.96,2.0,14,3,3,3,9,0xb2d85a56
30.15,1.0,3,1,2,4,7,0xb2d6cad1
645212.26,5.0,157,4,4,1,9,0xb2d15d3e
0.07,1.0,7,1,2,3,6,0xb2d36186
3124.89,1.0,0,2,2,4,8,0xb2d985e2
1270.05,1.0,158,1,2,1,4,0xb2d54cf4
147.65,1.0,36,1,2,2,5,0xb2d332fed
520.1,1.0,25,1,2,2,5,0xb2d28077d
638.59,2.0,3,1,3,4,8,0xb2d696af
282820.8,8.0,1,3,4,4,11,0xb2d091e3
327045.47,3.0,11,4,4,3,11,0xb2d614e0
29268.94,1.0,4,2,2,4,8,0xb2d26ca0d
1204112.54,3.0,49,4,4,2,10,0xb2d6dc07
321113.77,4.0,0,4,4,4,12,0xb2d09a8c
100643.56,3.0,31,3,4,2,9,0xb2d0c331
5000.6,1.0,0,2,2,4,8,0xb2d1356f
2458515.37,3.0,13,4,4,3,11,0xb2d57dc5
50002.02,7.0,31,2,4,2,8,0xb2d10e1f
1269.86,1.0,2,1,2,4,7,0xb2d9addc
602.65,3.0,0,1,4,4,9,0xb2d0648e
7118.3,1.0,184,2,2,1,5,0xb2d0db89
308010.77,4.0,8,4,4,3,11,0xb2d12da9
480019.72,3.0,10,4,4,3,11,0xb2d69134
1284.9,1.0,51,1,2,2,5,0xb2d53049
4344.37,1.0,92,2,2,1,5,0xb2d342bc
200000.0,2.0,0,3,3,4,10,0xb2d98346
1089.65,1.0,184,1,2,1,4,0xb2d24e09
841545.47,3.0,5,4,4,3,11,0xb2d6d69ed
1031506.51,7.0,34,4,4,2,10,0xb2d56491d
207472.22,2.0,12,3,3,3,9,0xb2d68075d
83.64,1.0,16,1,2,2,5,0xb2d6c27ad
30050.77,1.0,15,2,2,3,7,0xb2d8f29b
3000203.18,2.0,172,4,3,1,8,0xb2d62723
10614.76,1.0,19,2,2,2,6,0xb2d30b8a
337329.87,3.0,0,4,4,4,12,0xb2d26d2c
41236.05,1.0,76,2,2,1,5,0xb2d655d8d
1604.32,1.0,3,1,2,4,7,0xb2d9a643
306.77,1.0,75,1,2,1,4,0xb2d29151
50527.8,2.0,185,2,3,1,6,0xb2d5d48e
2908.01,1.0,10,2,2,3,7,0xb2d6ba0f
11.02,1.0,80,1,2,1,4,0xb2d14430
7862.2,2.0,0,2,3,4,9,0xb2d2124e
339842.3,5.0,3,4,4,4,12,0xb2d4274a
205.47,1.0,0,1,2,4,7,0xb2d2cd32
60117.66,1.0,11,3,2,3,8,0xb2d2b5f9
663.14,1.0,3,1,2,4,7,0xb2d19d2cd
560000.95,2.0,6,4,3,3,10,0xb2d551b4
8035.08,1.0,92,2,2,1,5,0xb2d50f92
530019.79,5.0,69,4,4,1,9,0xb2d129da
1810861.27,4.0,66,4,4,2,10,0xb2d32722
81180.75,2.0,39,3,3,2,8,0xb2d8d517
258258.07,10.0,0,3,4,4,11,0x3b9b1806
300145.76,2.0,13,4,3,3,10,0xb2d8c729
3.51,1.0,9,1,2,3,6,0xb2d6b7cf
140.01,1.0,1,1,2,4,7,0xb2d36451
400031.68,4.0,8,4,4,3,11,0xb2d2a9e5d
20995.42,1.0,0,2,2,4,8,0xb2d448d9
679000.0,2.0,7,4,3,3,10,0xb2d92fbf
282.64,1.0,7,1,2,3,6,0xb2d27d6b
723.66,1.0,25,1,2,2,5,0xb2d6d9bb
270.05,1.0,5,1,2,3,6,0xb2d2e839
45615.13,1.0,204,2,2,1,5,0xb2d588cdd
4573.5,1.0,1,2,2,4,8,0xb2d38fbd
560000.0,10.0,4,4,4,4,12,0xb2d5e93a
737032.55,6.0,0,4,4,4,12,0xb2d3b5ebd
788687.96,3.0,1,4,4,4,12,0xb2d3c5f5
201125.61,2.0,0,3,3,4,10,0xb2d96359
2025.17,1.0,20,1,2,2,5,0xb2d297cf
50003.27,4.0,55,2,4,2,8,0xb2d8f525d
493716.08,9.0,3,4,4,4,12,0xb2d2dfabd
297473.05,11.0,0,3,4,4,11,0x3b9af0ecd
862931.67,2.0,252,4,3,1,8,0xb2d4eec4
1251502.68,10.0,28,4,4,2,10,0xb2d42db7
512443.77,3.0,35,4,4,2,10,0xb2d6856a
500005.28,2.0,66,4,3,2,9,0xb2d8f084
90001.9,2.0,186,3,3,1,7,0xb2d879be
0.0,1.0,7,1,2,3,6,0xb2d8fb8a
480330.65,3.0,3,4,4,4,12,0xb2d51df9
1726383.05,3.0,107,4,4,1,9,0xb2d6c814
400762.21,4.0,20,4,4,2,10,0xb2d0a2b6d
50099.15,2.0,92,2,3,1,6,0xb2d94032d
7.76,1.0,5,1,2,3,6,0xb2d26652
12811.83,1.0,33,2,2,2,6,0xb2d5308dd
3.58,1.0,55,1,2,2,5,0xb2d8d2dc
71.97,1.0,11,1,2,3,6,0xb2d6359f
10211.39,2.0,171,2,3,1,6,0xb2d1a5b0
10178.82,2.0,104,2,3,1,6,0xb2d53df1
4658900.98,9.0,4,4,4,4,12,0xb2d5bda1d
550918.19,2.0,13,4,3,3,10,0xb2d420a8
2509.2,1.0,67,1,2,1,4,0xb2d34069
2006.38,1.0,184,1,2,1,4,0xb2d0f198
3090268.93,3.0,92,4,4,1,9,0x3b9af33e
15070.76,1.0,29,2,2,2,6,0xb2d6d3c9
81.76,1.0,0,1,2,4,7,0xb2d68a8d
289.23,1.0,10,1,2,3,6,0xb2d956d9
40829.61,3.0,0,2,4,4,10,0xb2d33007
4842.57,1.0,0,2,2,4,8,0xb2d6a1dd
1156.85,1.0,203,1,2,1,4,0xb2d2dbec
2886.64,1.0,19,1,2,2,5,0xb2d2fbe3
1187923.24,5.0,63,4,4,2,10,0xb2d0cb6f
2953781.2,5.0,0,4,4,4,12,0xb2d20c9e
15218.49,1.0,6,2,2,3,7,0xb2d5e672
33415.08,1.0,137,2,2,1,5,0xb2d222b5
556189.27,2.0,202,4,3,1,8,0xb2d2962b
353158.76,3.0,11,4,4,3,11,0xb2d54869
10080.73,1.0,11,2,2,3,7,0xb2d5a68ad
22586.72,1.0,14,2,2,3,7,0xb2d8d50e
1328921.76,2.0,31,4,3,2,9,0xb2d22f4a
4850.31,1.0,49,2,2,2,6,0xb2d89ee9
25446.0,2.0,53,2,3,2,7,0xb2d685ac
28782.28,4.0,4,2,4,4,10,0xb2d64dfd
123801.12,5.0,6,3,4,3,10,0xb2d51e76
100004.8,2.0,6,3,3,3,9,0xb2d1708c
1795054.99,8.0,16,4,4,2,10,0xb2d1f897
3.06,1.0,44,1,2,2,5,0xb2d5b620
440.59,1.0,14,1,2,3,6,0xb2d21dfa
39306.7,1.0,26,2,2,2,6,0xb2d8e21bd
515743.4,5.0,37,4,4,2,10,0x3b9ae51fd
43.88,1.0,19,1,2,2,5,0xb2d68779
105742.08,1.0,39,3,2,2,7,0xb2d51c72
123.39,1.0,6,1,2,3,6,0xb2d2441c
11.54,1.0,1,1,2,4,7,0xb2d567a0
100011.79,2.0,60,3,3,2,8,0xb2d9a599
20544.83,1.0,184,2,2,1,5,0xb2d1932a
1972.01,1.0,92,1,2,1,4,0xb2d0de98
200100.13,5.0,18,3,4,2,9,0xb2d54e5ed
711736.29,4.0,34,4,4,2,10,0xb2d628e0
101.48,1.0,19,1,2,2,5,0xb2d6fec2
1300000.57,2.0,5,4,3,3,10,0xb2d6b72b
15005.03,2.0,16,2,3,2,7,0xb2d933db
2.75,1.0,31,1,2,2,5,0xb2d5db4e
18538.15,1.0,130,2,2,1,5,0xb2d2e4b1d
3222.91,1.0,4,2,2,4,8,0xb2d10a4e
2615.78,1.0,123,1,2,1,4,0xb2d5f3dd
5676.45,1.0,17,2,2,2,6,0xb2d30912
54001.71,2.0,192,3,3,1,7,0xb2d6a160
1271.06,1.0,92,1,2,1,4,0xb2d13a2c
93838.76,1.0,10,3,2,3,8,0xb2d4f352
10001.06,2.0,83,2,3,1,6,0xb2d96165
5.73,1.0,28,1,2,2,5,0xb2d92aad
629.89,1.0,15,1,2,3,6,0xb2d203a6
3782.52,1.0,18,2,2,2,6,0xb2d36914
61047.93,2.0,143,3,3,1,7,0xb2d6279c
231846.86,1.0,110,3,2,1,6,0xb2d4ff04
295124.73,2.0,200,3,3,1,7,0xb2d33190
466555.33,5.0,0,4,4,4,12,0xb2d2669f
64053.48,1.0,13,3,2,3,8,0xb2d594ae
3.01,1.0,17,1,2,2,5,0xb2d2450a
3.8,1.0,74,1,2,1,4,0xb2d957c7
1.16,1.0,83,1,2,1,4,0xb2d8cece
230086.09,4.0,53,3,4,2,9,0xb2d5cb58
19651.69,1.0,26,2,2,2,6,0xb2d2bd1fd
718150.28,16.0,1,4,4,4,12,0xb2d3bd7f
501112.95,3.0,3,4,4,4,12,0xb2d277fa
3150000.0,2.0,92,4,3,1,8,0xb2d5a009d
120686.14,2.0,147,3,3,1,7,0xb2d68880d
496021.73,4.0,4,4,4,4,12,0xb2d1bb0b
596939.86,2.0,1,4,3,4,11,0xb2d53adf
6306.73,4.0,18,2,4,2,8,0x3b9b15f5d
72026.86,3.0,101,3,4,1,8,0xb2d1ac42
1810.57,1.0,251,1,2,1,4,0xb2d6bd07
500062.24,2.0,17,4,3,2,9,0xb2d8d004
124.0,1.0,18,1,2,2,5,0xb2d1c81a
70025.86,2.0,6,3,3,3,9,0xb2d58249
41811.9,4.0,0,2,4,4,10,0x3b9b3493
3108.22,1.0,92,2,2,1,5,0xb2d601c7
1940.49,1.0,11,1,2,3,6,0xb2d3689e
208.95,1.0,54,1,2,2,5,0xb2d5facd
30024.14,1.0,0,2,2,4,8,0xb2d6bd92
324989.92,2.0,11,4,3,3,10,0xb2d138a2
50000.0,2.0,4,2,3,4,9,0xb2da583e
80344.61,2.0,10,3,3,3,9,0xb2d3bd41d
19.59,1.0,41,1,2,2,5,0xb2d2dfa5
1213.92,1.0,184,1,2,1,4,0xb2d227b4
2801.85,1.0,0,1,2,4,7,0xb2d26c9dd
18443.13,1.0,138,2,2,1,5,0xb2d30536d
660121.96,4.0,6,4,4,3,11,0xb2d61390
4039.86,1.0,11,2,2,3,7,0xb2d36187
500811.8,5.0,10,4,4,3,11,0xb2d192ff
8363.23,1.0,11,2,2,3,7,0xb2d9e513
300023.25,2.0,182,3,3,1,7,0xb2d7fc9d
10.27,1.0,81,1,2,1,4,0xb2d5ee7e
50000.53,2.0,42,2,3,2,7,0xb2d9e90a
5892.51,1.0,137,2,2,1,5,0xb2d37ca2
40128.25,2.0,3,2,3,4,9,0xb2d4f1d2
10408.63,1.0,5,2,2,3,7,0xb2d5df17
612173.7,2.0,32,4,3,2,9,0xb2d9aa2c
674480.04,4.0,5,4,4,3,11,0xb2d24782
117.68,1.0,9,1,2,3,6,0xb2d8d66c
400000.42,3.0,5,4,4,3,11,0xb2d9fcf5
940079.01,5.0,25,4,4,2,10,0xb2d34d01d
3682.94,1.0,3,2,2,4,8,0xb2d23cdc
1051.12,1.0,184,1,2,1,4,0xb2d07269
11640.16,1.0,3,2,2,4,8,0xb2d57a16
62.1,1.0,98,1,2,1,4,0xb2d14157
42173.9,1.0,2,2,2,4,8,0xb2d990f4
17249.89,5.0,1,2,4,4,10,0xb2d783ccd
222008.12,5.0,92,3,4,1,8,0xb2d12536d
50002.64,2.0,48,2,3,2,7,0xb2d5368d
130004.12,2.0,235,3,3,1,7,0xb2d1945b
35318.44,1.0,92,2,2,1,5,0xb2d392c4d
1432.79,1.0,92,1,2,1,4,0xb2d2315c
21.02,1.0,5,1,2,3,6,0xb2d99bf8
301066.33,2.0,31,4,3,2,9,0xb2d8f105d
1721197.71,4.0,57,4,4,2,10,0xb2d240b2d
303127.34,11.0,0,4,4,4,12,0xb2d06727
279015.8,4.0,0,3,4,4,11,0xb2d07fbf
269768.35,1.0,183,3,2,1,6,0xb2d4f577
41026.73,2.0,10,2,3,3,8,0xb2d53028d
28670.13,1.0,202,2,2,1,5,0xb2d1a3d0d
333.0,1.0,0,1,2,4,7,0xb2d964de
26.02,1.0,230,1,2,1,4,0xb2d6de61
170457.33,5.0,0,3,4,4,11,0xb2d62ec0
0.68,1.0,35,1,2,2,5,0xb2d6af00
560000.0,3.0,1,4,4,4,12,0xb2da0efe
500000.11,2.0,16,4,3,2,9,0xb2d999c2
3371.6,2.0,0,2,3,4,9,0x3b9b4584
18.53,1.0,74,1,2,1,4,0xb2d8cff9
122.27,1.0,26,1,2,2,5,0xb2d6ecf4
33.11,1.0,5,1,2,3,6,0xb2d8c955
403009.32,3.0,13,4,4,3,11,0xb2d6e212
1889799.1,10.0,12,4,4,3,11,0xb2d1049ed
3973.88,1.0,9,2,2,3,7,0xb2d31826
134.83,1.0,216,1,2,1,4,0xb2d1897b
622202.68,3.0,35,4,4,2,10,0xb2d9a915
4793.65,1.0,6,2,2,3,7,0xb2d2d9da
2256.12,1.0,46,1,2,2,5,0xb2d6e862d
1015.94,1.0,184,1,2,1,4,0xb2d12264
496.0,1.0,18,1,2,2,5,0xb2d1779f
2419.81,1.0,14,1,2,3,6,0xb2d26150d
14588.01,1.0,0,2,2,4,8,0xb2d3324a
1104.59,1.0,9,1,2,3,6,0xb2d98ab1
310026.02,11.0,35,4,4,2,10,0xb2d52e3f
10238.19,1.0,184,2,2,1,5,0xb2d0aa7a
482712.4,14.0,27,4,4,2,10,0xb2d58f42
28003.42,2.0,98,2,3,1,6,0xb2d5775b
225992.8,2.0,0,3,3,4,10,0xb2d2ec89d
2.78,1.0,42,1,2,2,5,0x3b9b4503
6113.52,1.0,3,2,2,4,8,0xb2d68c7e
100029.81,2.0,27,3,3,2,8,0xb2d906f3d
852904.28,3.0,214,4,4,1,9,0xb2d34985
949.32,1.0,9,1,2,3,6,0xb2d4c86b
519.29,1.0,9,1,2,3,6,0xb2d94039
91126.51,2.0,69,3,3,1,7,0xb2d17f52
611477.49,2.0,2,4,3,4,11,0xb2d6c845
15141.83,1.0,92,2,2,1,5,0xb2d2bf31
1.06,1.0,32,1,2,2,5,0xb2d59dde
1.58,1.0,65,1,2,2,5,0xb2d58a15
434741.97,1.0,5,4,2,3,9,0xb2d3b388
2987.5,1.0,11,2,2,3,7,0xb2d36648
15.29,1.0,18,1,2,2,5,0xb2d603a6
210067.01,3.0,0,3,4,4,11,0xb2d1b29dd
170506.11,1.0,0,3,2,4,9,0xb2d566b3
202169.03,3.0,8,3,4,3,10,0xb2d5c4b9
530073.73,6.0,4,4,4,4,12,0xb2d1a990d
4010.22,1.0,48,2,2,2,6,0xb2d5e868
131393.4,1.0,5,3,2,3,8,0xb2da0627
30.08,1.0,32,1,2,2,5,0xb2d9fdd6
11.44,1.0,8,1,2,3,6,0xb2d24d5f
50007.61,2.0,6,2,3,3,8,0xb2d95993
300012.67,2.0,14,3,3,3,9,0xb2da2afa
46152.02,4.0,1,2,4,4,10,0x3b9b18dbd
2368.32,1.0,92,1,2,1,4,0xb2d58a26
30142.99,1.0,37,2,2,2,6,0xb2d6d4e5
500109.38,5.0,32,4,4,2,10,0xb2d3a802d
670008.66,4.0,53,4,4,2,10,0xb2d96e94
182230.72,1.0,184,3,2,1,6,0xb2d41654d
556030.47,4.0,175,4,4,1,9,0xb2d1182b
43.12,1.0,39,1,2,2,5,0xb2d505cd
300000.4,2.0,25,3,3,2,8,0xb2d4b3df
620531.11,9.0,71,4,4,1,9,0xb2d3d838
507.52,1.0,0,1,2,4,7,0xb2d9513c
900182.75,4.0,0,4,4,4,12,0xb2d697b6
40428.0,1.0,20,2,2,2,6,0xb2d6810dd
500081.74,2.0,59,4,3,2,9,0xb2d95725
638.48,1.0,1,1,2,4,7,0xb2d2dce6
5903.3,1.0,0,2,2,4,8,0xb2d6acee
51043.57,2.0,10,2,3,3,8,0xb2d68d0e
160512.98,2.0,40,3,3,2,8,0xb2d398f4
18430.41,1.0,3,2,2,4,8,0xb2d2c607
469488.17,2.0,5,4,3,3,10,0xb2d5c4f1
130150.12,3.0,31,3,4,2,9,0xb2d57e01
623231.12,7.0,1,4,4,4,12,0xb2d5e493
1647.51,1.0,17,1,2,2,5,0xb2d68ee0
2059.81,1.0,92,1,2,1,4,0xb2d5f005
151606.17,5.0,0,3,4,4,11,0xb2d210f1
252.78,1.0,27,1,2,2,5,0xb2d3ef65
70729.69,1.0,0,3,2,4,9,0xb2d2cd4d
1195862.18,10.0,1,4,4,4,12,0xb2d195ccd
20338.38,1.0,146,2,2,1,5,0xb2d3d413
1723.24,1.0,4,1,2,4,7,0xb2d15eff
100006.33,2.0,13,3,3,3,9,0xb2d958e6
1.06,1.0,60,1,2,2,5,0xb2d9bc47
1161.33,1.0,92,1,2,1,4,0xb2d1a6cd
91.1,1.0,17,1,2,2,5,0xb2d6cf78
1450250.93,22.0,4,4,4,4,12,0xb2d401d4
1066215.46,4.0,3,4,4,4,12,0xb2d10f52
400031.26,3.0,19,4,4,2,10,0xb2d5621f
2500017.94,3.0,1,4,4,4,12,0xb2d995f1
69.3,1.0,67,1,2,1,4,0xb2d44131
450000.24,3.0,25,4,4,2,10,0xb2d78187
3113.1,1.0,10,2,2,3,7,0xb2d8d104
4187.52,1.0,77,2,2,1,5,0xb2d94354
700024.26,3.0,90,4,4,1,9,0xb2d1ab12
521160.59,3.0,7,4,4,3,11,0xb2d61955
127864.08,2.0,168,3,3,1,7,0xb2d4294a
3166.62,1.0,3,2,2,4,8,0xb2d39597
167000.0,1.0,1,3,2,4,9,0xb2d6b9ee
7228.24,1.0,92,2,2,1,5,0xb2d2f8da
37.39,1.0,12,1,2,3,6,0xb2d6df28
99558.79,1.0,3,3,2,4,9,0xb2d62c7a
100014.8,3.0,0,3,4,4,11,0xb2d4e9af
618708.82,5.0,94,4,4,1,9,0xb2d4e752d
606396.07,2.0,76,4,3,1,8,0xb2d951fa
1490.56,1.0,1,1,2,4,7,0xb2d3cbd8
1798.7,1.0,1,1,2,4,7,0xb2d91663
700000.02,4.0,16,4,4,2,10,0xb2d6987a
539652.27,6.0,19,4,4,2,10,0xb2d22fc8
1800366.98,2.0,63,4,3,2,9,0xb2d8e87fd
236.52,1.0,5,1,2,3,6,0xb2d6a57e
301371.08,2.0,0,4,3,4,11,0xb2d584b7
95.29,2.0,1,1,3,4,8,0x3b9b32f9
306399.66,2.0,203,4,3,1,8,0xb2d693b8
300012.67,2.0,95,3,3,1,7,0xb2d970eb
12972.64,1.0,0,2,2,4,8,0xb2d6aa5b
28486.4,2.0,15,2,3,3,8,0xb2d3ad3c
3.27,1.0,38,1,2,2,5,0xb2d424d4
20070.61,1.0,0,2,2,4,8,0xb2d604aad
5443.6,2.0,0,2,3,4,9,0xb2d6eadd
358.89,1.0,61,1,2,2,5,0xb2d823b0
758.41,1.0,10,1,2,3,6,0xb2d24cb2
6524.46,1.0,0,2,2,4,8,0xb2d21570d
4623.85,1.0,4,2,2,4,8,0xb2d9967d
400200.76,2.0,2,4,3,4,11,0xb2d9670e
598.57,14.0,0,1,4,4,9,0xb2d06658
1795.05,1.0,92,1,2,1,4,0xb2d2c667
58.04,1.0,28,1,2,2,5,0xb2d6f771
2797491.21,6.0,83,4,4,1,9,0xb2d34db9
74403.82,3.0,73,3,4,1,8,0xb2d52e09
17013.97,1.0,1,2,2,4,8,0xb2d9a8d7
17952027.31,5.0,80,4,4,1,9,0x3b9af42d
47699.0,1.0,1,2,2,4,8,0xb2da3d19
20813.81,1.0,12,2,2,3,7,0xb2d2755e
365391.16,5.0,39,4,4,2,10,0xb2d5751a
125000.06,2.0,130,3,3,1,7,0x3b9b26ea
597719.85,19.0,0,4,4,4,12,0x3b9b0e5e
434526.1,6.0,1,4,4,4,12,0xb2d15286
3321096.43,4.0,24,4,4,2,10,0xb2d617af
10006.21,2.0,4,2,3,4,9,0xb2d5b6dc
1038.07,1.0,184,1,2,1,4,0xb2d12ab2
90001.58,3.0,46,3,4,2,9,0xb2d96052
10168.35,1.0,21,2,2,2,6,0xb2d9642f
101185.81,2.0,66,3,3,2,8,0xb2d6c5de
50004.86,2.0,39,2,3,2,7,0xb2d5ddc7
60001.9,2.0,59,3,3,2,8,0xb2d8f9bc
7657.48,2.0,0,2,3,4,9,0x3b9af225
490877.97,5.0,0,4,4,4,12,0xb2d184ed
412707.59,3.0,14,4,4,3,11,0xb2d1b5af
9052.95,1.0,27,2,2,2,6,0xb2d3a847
116.86,1.0,27,1,2,2,5,0xb2d188a3
257148.9,8.0,0,3,4,4,11,0xb2d08504d
420015.86,3.0,4,4,4,4,12,0xb2d10695
50000.53,2.0,41,2,3,2,7,0xb2d923de
1374651.78,7.0,0,4,4,4,12,0xb2d34e4b
248.97,1.0,10,1,2,3,6,0xb2d78bbd
60060.25,1.0,7,3,2,3,8,0xb2d6287a
453018.49,2.0,100,4,3,1,8,0xb2d6d366
0.05,2.0,25,1,3,2,6,0xb2d6836c
114004.54,2.0,24,3,3,2,8,0xb2d5f334
2052.63,3.0,26,1,4,2,7,0x3b9adf37
230400.42,4.0,0,3,4,4,11,0xb2d6349a
1178387.35,3.0,1,4,4,4,12,0xb2d1e018
60040.5,2.0,126,3,3,1,7,0xb2d6d0f3
1581.99,1.0,23,1,2,2,5,0xb2d36a39
1546169.63,13.0,0,4,4,4,12,0xb2d5a6c8d
50070.9,2.0,102,2,3,1,6,0xb2d5eb4cd
1307.1,1.0,180,1,2,1,4,0xb2d2fb27
1058.49,1.0,184,1,2,1,4,0xb2d261de
910490.92,6.0,14,4,4,3,11,0xb2d38eaa
106658.79,2.0,179,3,3,1,7,0xb2d5033d
733827.21,4.0,6,4,4,3,11,0xb2d0b45f
584013.03,6.0,136,4,4,1,9,0xb2d43644d
375255.66,7.0,20,4,4,2,10,0xb2d2282d
1001.38,1.0,56,1,2,2,5,0xb2d91fb8
15145.83,1.0,0,2,2,4,8,0xb2d8e9ee
415.01,1.0,12,1,2,3,6,0xb2d9681d
60.26,1.0,56,1,2,2,5,0xb2d28c4f
20592.43,1.0,5,2,2,3,7,0xb2da0ea4
533151.23,2.0,97,4,3,1,8,0xb2d40a18
403746.19,2.0,1,4,3,4,11,0xb2d260f7d
2800000.0,1.0,0,4,2,4,10,0xb2d5d040
1141.22,1.0,0,1,2,4,7,0xb2d413d6
1445.2,1.0,161,1,2,1,4,0xb2d1a9e7d
13548.31,1.0,18,2,2,2,6,0xb2d70518
2251.71,1.0,2,1,2,4,7,0xb2d222eed
120003.57,3.0,59,3,4,2,9,0xb2d60b82
509016.03,2.0,84,4,3,1,8,0xb2d1791a
3627.89,1.0,14,2,2,3,7,0xb2d97c98
14.46,1.0,68,1,2,1,4,0xb2d968bc
5439.09,2.0,84,2,3,1,6,0xb2d521f3
300000.92,2.0,1,3,3,4,10,0xb2d6d72ad
2422.33,1.0,9,1,2,3,6,0xb2d44b73d
32314.16,1.0,0,2,2,4,8,0xb2d6aade
6778.7,1.0,7,2,2,3,7,0xb2d6ece4
85188.88,3.0,0,3,4,4,11,0xb2d3651a
2509.88,1.0,0,1,2,4,7,0xb2d75415
301527.54,1.0,4,4,2,4,10,0xb2d6c6eed
800974.71,3.0,11,4,4,3,11,0xb2d6e452d
10708.49,1.0,77,2,2,1,5,0xb2d2579d
316405.32,3.0,18,4,4,2,10,0xb2d5da5a
304012.32,7.0,34,4,4,2,10,0xb2d6abadd
50009.24,2.0,21,2,3,2,7,0xb2d280e0
130.46,1.0,3,1,2,4,7,0xb2d521a8
610.47,5.0,0,1,4,4,9,0xb2d30098
0.42,2.0,42,1,3,2,6,0xb2d49107
1034617.75,8.0,1,4,4,4,12,0xb2d1a9e2
900023.23,5.0,35,4,4,2,10,0xb2d087f3
430805.23,3.0,11,4,4,3,11,0xb2d69a69
890121.88,5.0,38,4,4,2,10,0xb2d32da8
6981.26,1.0,18,2,2,2,6,0xb2d6c052
53950.7,1.0,184,3,2,1,6,0xb2d24c4f
770021.11,6.0,0,4,4,4,12,0xb2d7911a
390007.82,4.0,3,4,4,4,12,0xb2d5cf5f
20095.6,2.0,101,2,3,1,6,0xb2d2d629
547198.16,6.0,98,4,4,1,9,0xb2d06f22
54328.45,1.0,0,3,2,4,9,0xb2d51ed8d
1748.42,1.0,4,1,2,4,7,0xb2d5832c
62.04,1.0,9,1,2,3,6,0xb2d35608
5199.25,1.0,0,2,2,4,8,0xb2d78e15
201816.64,3.0,195,3,4,1,8,0xb2d2cf7c
516793.97,13.0,5,4,4,3,11,0xb2d214a3
175084.15,3.0,206,3,4,1,8,0xb2d3dc37
250024.15,4.0,66,3,4,2,9,0xb2d41b37
502004.38,2.0,28,4,3,2,9,0xb2d7722b
301157.92,2.0,26,4,3,2,9,0xb2d0cff8
11152.56,1.0,10,2,2,3,7,0xb2d76be2
10034.19,1.0,92,2,2,1,5,0xb2d43ee7d
2082.02,1.0,92,1,2,1,4,0xb2d1f44ed
2002.11,1.0,19,1,2,2,5,0xb2d6b8a2
1259.56,6.0,0,1,4,4,9,0x3b9af0ee
21238.62,1.0,7,2,2,3,7,0xb2d69274
2049181.89,2.0,4,4,3,4,11,0xb2d6522f
633836.66,3.0,48,4,4,2,10,0xb2d178e0
284011.08,3.0,27,3,4,2,9,0xb2d19c27d
110002.33,3.0,95,3,4,1,8,0xb2d948e5
250.58,1.0,28,1,2,2,5,0xb2d38701
290000.0,2.0,15,3,3,3,9,0xb2da37e9
70004.19,2.0,93,3,3,1,7,0xb2d3afd3
372.71,1.0,0,1,2,4,7,0xb2d786ad
130122.06,3.0,10,3,4,3,10,0xb2d5fca2
1049.64,1.0,0,1,2,4,7,0xb2d3e96f
41615.89,1.0,0,2,2,4,8,0xb2d24263
240011.05,4.0,8,3,4,3,10,0xb2d9eac0
300592.44,5.0,6,4,4,3,11,0xb2d18606
665073.76,23.0,0,4,4,4,12,0x3b9af2cbd
3255.86,3.0,184,2,4,1,7,0xb2d10ed3
1865.56,1.0,102,1,2,1,4,0xb2d2de9e
1181477.85,9.0,6,4,4,3,11,0xb2d41274
130384.93,1.0,92,3,2,1,6,0xb2d61526
38324.41,2.0,2,2,3,4,9,0xb2d0b59e
10000.0,2.0,1,2,3,4,9,0xb2da6114
0.0,1.0,36,1,2,2,5,0xb2d259af
37629.24,7.0,5,2,4,3,9,0x3b9b12c5
531931.91,6.0,0,4,4,4,12,0xb2d0a941
1604.02,1.0,68,1,2,1,4,0xb2d8ee49
4700019.9,47.0,5,4,4,3,11,0xb2d10331
7331.29,1.0,18,2,2,2,6,0xb2d6c2aa
100004.35,3.0,62,3,4,2,9,0xb2d57927
1908.72,1.0,12,1,2,3,6,0xb2d1b0b8
847.43,1.0,75,1,2,1,4,0xb2d5598b
560013.08,7.0,3,4,4,4,12,0xb2d23b9fd
401420.85,3.0,41,4,4,2,10,0xb2d9eef8
39005.33,3.0,111,2,4,1,7,0xb2d6539c
41295.35,2.0,18,2,3,2,7,0xb2d68a82
50113.64,2.0,2,2,3,4,9,0xb2d92ff0
189.2,1.0,30,1,2,2,5,0xb2d2e3e5d
89408.86,1.0,0,3,2,4,9,0xb2d3b24e
2560025.0,95.0,0,4,4,4,12,0xb2d170a6
250074.87,3.0,15,3,4,3,10,0xb2d1922c
60003.06,2.0,3,3,3,4,10,0xb2d15076
626.77,3.0,60,1,4,2,7,0xb2d24788
898.23,1.0,1,1,2,4,7,0xb2d5a24c
102973.24,2.0,107,3,3,1,7,0xb2d5c5fa
20003.28,2.0,199,2,3,1,6,0xb2d5b27b
52742.18,2.0,18,3,3,2,8,0xb2d4ff70
400000.68,3.0,3,4,4,4,12,0xb2d9b642
1021.97,1.0,105,1,2,1,4,0xb2d19b5bd
0.0,1.0,3,1,2,4,7,0xb2da1546
289168.11,5.0,0,3,4,4,11,0xb2d69ad4
1433010.16,9.0,3,4,4,4,12,0xb2d3eb3ed
30119.75,1.0,46,2,2,2,6,0xb2d619afd
103041.83,2.0,62,3,3,2,8,0xb2d1a49ad
40310.64,1.0,21,2,2,2,6,0xb2d31cd3
23312.15,1.0,12,2,2,3,7,0xb2d38b89
15000.16,2.0,92,2,3,1,6,0xb2d641b9d
41.84,1.0,10,1,2,3,6,0xb2d9c681
5984.52,1.0,0,2,2,4,8,0xb2d33bac
500008.26,6.0,53,4,4,2,10,0xb2d45923
0.46,1.0,0,1,2,4,7,0xb2d5d53a
86595.03,3.0,122,3,4,1,8,0xb2d4016d
930332.99,10.0,1,4,4,4,12,0xb2d16a92
40006.02,2.0,3,2,3,4,9,0xb2d6037d
2.22,1.0,20,1,2,2,5,0xb2d95089
525010.98,4.0,24,4,4,2,10,0xb2d14acb
216728.0,5.0,12,3,4,3,10,0xb2d62300
6901.79,2.0,184,2,3,1,6,0xb2d254d7
1608792.98,4.0,21,4,4,2,10,0xb2d94201
2854.94,1.0,10,1,2,3,6,0xb2d48174
366448.18,3.0,87,4,4,1,9,0xb2d13e00d
504.84,4.0,7,1,4,3,8,0xb2d6e2b3
311393.0,3.0,221,4,4,1,9,0xb2d15d1a
579.84,1.0,10,1,2,3,6,0xb2d65b6d
3969.48,1.0,0,2,2,4,8,0xb2d33db5
960579.53,7.0,11,4,4,3,11,0xb2d5523d
6877.09,1.0,0,2,2,4,8,0xb2d6943ed
270000.47,4.0,3,3,4,4,11,0xb2d2a3a5
3009168.13,6.0,5,4,4,3,11,0xb2d8e4b8
0.53,1.0,19,1,2,2,5,0xb2d9550c
609516.86,6.0,67,4,4,1,9,0xb2d16a41
825.83,1.0,20,1,2,2,5,0xb2d57daf
352679.58,2.0,22,4,3,2,9,0xb2d1f7bb
50005.33,2.0,67,2,3,1,6,0xb2d3dabf
1800249.96,3.0,0,4,4,4,12,0xb2d5fb65
105045.9,2.0,118,3,3,1,7,0xb2d4148f
0.0,1.0,5,1,2,3,6,0xb2d18782
323341.77,5.0,59,4,4,2,10,0xb2d14a75
211213.22,2.0,101,3,3,1,7,0xb2d64a04
13868.88,1.0,0,2,2,4,8,0xb2d55bc1
200017.88,3.0,20,3,4,2,9,0xb2d1a843
80.25,4.0,11,1,4,3,8,0xb2d3e1bf
434.91,1.0,11,1,2,3,6,0xb2d213ac
920012.49,5.0,3,4,4,4,12,0xb2d8a43d
20025.1,3.0,151,2,4,1,7,0xb2d6f8b5
10.64,1.0,92,1,2,1,4,0xb2d2fbbe
317.28,1.0,7,1,2,3,6,0xb2d3a203d
650235.0,2.0,0,4,3,4,11,0xb2d8d7aa
9271.24,1.0,0,2,2,4,8,0xb2d906b1
396.9,1.0,9,1,2,3,6,0xb2d278da
60079.13,6.0,0,3,4,4,11,0xb2d54c42
9.99,1.0,81,1,2,1,4,0xb2d3ae46
89433.14,1.0,0,3,2,4,9,0xb2d210a6
360243.97,5.0,0,4,4,4,12,0xb2d6d295
137395.2,5.0,4,3,4,4,11,0xb2d659c5d
326.92,1.0,8,1,2,3,6,0xb2d231c0
322173.75,1.0,0,4,2,4,10,0xb2d2e6d5
50559.25,2.0,27,2,3,2,7,0xb2d93311d
50171.13,2.0,191,2,3,1,6,0xb2d6d7a8d
28002.16,2.0,92,2,3,1,6,0xb2d5b05d
992.84,1.0,3,1,2,4,7,0xb2d8f59f
3150.19,1.0,184,2,2,1,5,0xb2d24946
4963.28,1.0,31,2,2,2,6,0xb2d31cca
18038.01,1.0,15,2,2,3,7,0xb2d5e0ad
84235.06,3.0,13,3,4,3,10,0xb2d1921d
205123.96,2.0,33,3,3,2,8,0xb2d34f6f
500899.03,4.0,19,4,4,2,10,0xb2d3171c
376745.51,4.0,34,4,4,2,10,0xb2d30d73
1110100.8,6.0,12,4,4,3,11,0xb2d1d901
3053.72,1.0,184,2,2,1,5,0x3b9b2544
594012.59,6.0,12,4,4,3,11,0xb2d2d003
647.28,1.0,9,1,2,3,6,0xb2d64cab
1263.93,1.0,184,1,2,1,4,0xb2d27119
1599000.0,21.0,4,4,4,4,12,0xb2d1106b
16000.21,2.0,76,2,3,1,6,0xb2d69494
1221.21,1.0,3,1,2,4,7,0xb2d2e050
3960.42,1.0,12,2,2,3,7,0xb2d1dd9c
6016.22,1.0,114,2,2,1,5,0xb2d688fd
33.36,1.0,46,1,2,2,5,0xb2d438c7
41419.35,1.0,11,2,2,3,7,0xb2d408ef
23.89,1.0,30,1,2,2,5,0xb2d52f24
2809.96,1.0,14,1,2,3,6,0xb2d4d102
81.51,1.0,8,1,2,3,6,0xb2d6b0c9
70453.72,3.0,42,3,4,2,9,0xb2d60a2d
142008.61,3.0,105,3,4,1,8,0xb2d606e6
300105.34,2.0,1,4,3,4,11,0xb2d96099
7876.17,1.0,153,2,2,1,5,0xb2d25e34
200001.34,4.0,32,3,4,2,9,0xb2d2625a
36294.48,1.0,0,2,2,4,8,0xb2d246db
31.67,1.0,60,1,2,2,5,0xb2d9bf8b
70545.13,1.0,4,3,2,4,9,0xb2d58133
23311.39,1.0,0,2,2,4,8,0xb2d11047
1470985.59,18.0,0,4,4,4,12,0x3b9ae3f1
30000.32,2.0,98,2,3,1,6,0xb2d6e96b
2293.41,1.0,10,1,2,3,6,0xb2d6c4df
923.5,1.0,0,1,2,4,7,0xb2d4569b
150000.0,14.0,0,3,4,4,11,0x3b9b0e38
8.28,1.0,60,1,2,2,5,0xb2d60308
1200003.84,2.0,18,4,3,2,9,0xb2d8d794
21532.9,1.0,14,2,2,3,7,0xb2d8cd64
517124.02,7.0,34,4,4,2,10,0xb2d11bfa
63.47,1.0,6,1,2,3,6,0xb2d6b77a
1087.07,1.0,0,1,2,4,7,0xb2d6c1f1
0.0,1.0,184,1,2,1,4,0xb2d30ae6d
46.19,1.0,10,1,2,3,6,0xb2d14569
244410.92,3.0,42,3,4,2,9,0xb2d38f98
100006.92,2.0,13,3,3,3,9,0xb2d573be
510224.33,3.0,116,4,4,1,9,0x3b9b4923
1735.57,4.0,0,1,4,4,9,0xb2d22f3a
521111.45,4.0,18,4,4,2,10,0xb2d65adb
150000.48,2.0,6,3,3,3,9,0xb2d576fed
51410.83,1.0,0,2,2,4,8,0xb2d8d251d
98818.73,1.0,9,3,2,3,8,0xb2d1cb7bd
32.38,1.0,18,1,2,2,5,0xb2d5e108
4780.35,1.0,1,2,2,4,8,0x3b9b2f46
236940.65,1.0,7,3,2,3,8,0xb2d395e4
30087.14,2.0,67,2,3,1,6,0xb2d23fbc
0.0,1.0,3,1,2,4,7,0xb2d324a0
0.58,1.0,14,1,2,3,6,0xb2d9967f
1540016.26,3.0,5,4,4,3,11,0xb2d909c8
1724.54,1.0,92,1,2,1,4,0xb2d5f863
1915709.49,5.0,91,4,4,1,9,0xb2d6b9e9
650016.1,4.0,34,4,4,2,10,0xb2d38b93d
121019.09,2.0,83,3,3,1,7,0xb2d619acd
111001.17,2.0,62,3,3,2,8,0xb2d8f61c
147.23,1.0,4,1,2,4,7,0xb2d58cd1
20.6,1.0,77,1,2,1,4,0xb2d30821
40985.41,3.0,80,2,4,1,7,0xb2d44118
5515.2,1.0,92,2,2,1,5,0xb2d2b0d9d
104.43,2.0,67,1,3,1,5,0xb2d43a8e
0.84,1.0,25,1,2,2,5,0xb2d9eff6
183096.09,4.0,11,3,4,3,10,0xb2d45b12
23105.2,1.0,11,2,2,3,7,0xb2d932fe
70650.39,3.0,33,3,4,2,9,0x3b9b2a35d
100001.06,2.0,66,3,3,2,8,0xb2d8f1e6
1979.84,1.0,17,1,2,2,5,0xb2d92f97
56968.83,2.0,0,3,3,4,10,0xb2d252cf
5111.9,1.0,92,2,2,1,5,0xb2d65a76
20608.05,1.0,95,2,2,1,5,0xb2d652d9
30487.66,1.0,16,2,2,2,6,0xb2d1fd60
640107.67,4.0,4,4,4,4,12,0xb2d26f57d
3604.59,1.0,189,2,2,1,5,0xb2d65961
11.34,1.0,0,1,2,4,7,0xb2d8c37b
500245.92,2.0,17,4,3,2,9,0xb2d1e742
2814.09,1.0,161,1,2,1,4,0xb2d54e68
300007.51,5.0,27,3,4,2,9,0xb2d6c867
437.68,1.0,1,1,2,4,7,0xb2d62356
5473015.66,3.0,143,4,4,1,9,0xb2d22d17
1994.8,1.0,92,1,2,1,4,0xb2d2a73e
37718.87,1.0,181,2,2,1,5,0xb2d2dd24d
739.51,1.0,8,1,2,3,6,0xb2d6debb
132.59,1.0,8,1,2,3,6,0xb2d60ad4
1003845.46,5.0,0,4,4,4,12,0x3b9af2d9
0.0,1.0,8,1,2,3,6,0xb2d4b6fcd
600011.61,12.0,6,4,4,3,11,0xb2d1b8e1
260098.71,6.0,11,3,4,3,10,0xb2d190f5
208135.96,2.0,179,3,3,1,7,0xb2d2bf84
50008.99,2.0,231,2,3,1,6,0xb2d4108d
200006.34,2.0,116,3,3,1,7,0xb2d945d8d
120005.07,2.0,27,3,3,2,8,0xb2d93684
140230.85,2.0,7,3,3,3,9,0xb2d3d20b
16120.73,1.0,0,2,2,4,8,0xb2d3fa24
822922.84,5.0,1,4,4,4,12,0xb2d249c6
4122.0,1.0,9,2,2,3,7,0xb2d6e232
310060.93,4.0,55,4,4,2,10,0xb2d65c29
421879.41,4.0,11,4,4,3,11,0xb2d4de80
890.76,1.0,60,1,2,2,5,0xb2d31440
20046.96,2.0,0,2,3,4,9,0xb2d600e3
499.74,1.0,11,1,2,3,6,0xb2d8f854
53436.41,1.0,3,3,2,4,9,0xb2d645ded
200000.0,2.0,22,3,3,2,8,0xb2da208c
583.25,1.0,9,1,2,3,6,0xb2d41b38
200000.3,2.0,13,3,3,3,9,0xb2d3c5eb
9286.23,1.0,0,2,2,4,8,0xb2d428e0
155004.77,2.0,8,3,3,3,9,0xb2d683d0
110044.55,3.0,39,3,4,2,9,0xb2d208d3
2021092.76,6.0,18,4,4,2,10,0xb2d69e0f
96.61,1.0,17,1,2,2,5,0xb2d5e563
2230796.06,12.0,0,4,4,4,12,0x3b9b17f1d
90004.95,1.0,1,3,2,4,9,0xb2d912d3
574907.66,9.0,76,4,4,1,9,0x3b9b405a
0.48,2.0,17,1,3,2,6,0xb2d523bb
140406.91,2.0,0,3,3,4,10,0xb2d102cc
4.52,1.0,25,1,2,2,5,0xb2d43e90
676675.0,4.0,107,4,4,1,9,0xb2d18884
11449.9,1.0,2,2,2,4,8,0xb2d93d7a
72.3,1.0,15,1,2,3,6,0xb2d35394
807027.73,3.0,90,4,4,1,9,0xb2d89008
13000.14,2.0,38,2,3,2,7,0xb2d92b63
60017.6,4.0,19,3,4,2,9,0xb2d14b62
20612.57,1.0,92,2,2,1,5,0xb2d5c5fc
491925.48,6.0,4,4,4,4,12,0xb2d6ecbd
150611.68,3.0,0,3,4,4,11,0xb2d0675d
303615.82,3.0,85,4,4,1,9,0xb2d6bb16
84506.1,1.0,184,3,2,1,6,0xb2d0f1ec
80003.22,3.0,95,3,4,1,8,0xb2d09eae
306810.31,32.0,1,4,4,4,12,0xb2d4e96f
2080000.52,2.0,0,4,3,4,11,0xb2d35a83
130023.48,2.0,79,3,3,1,7,0xb2d8c465
3529.48,1.0,301,2,2,1,5,0xb2d2b467
18853.61,1.0,0,2,2,4,8,0xb2d906a1d
167.78,1.0,13,1,2,3,6,0xb2d69104
364.25,1.0,23,1,2,2,5,0xb2d9bf2e
105.56,1.0,8,1,2,3,6,0xb2da4736
78.58,1.0,92,1,2,1,4,0xb2d2a5fb
10100.19,1.0,24,2,2,2,6,0xb2d8c958
53123.3,1.0,67,3,2,1,6,0xb2d20a98d
570011.41,2.0,14,4,3,3,10,0xb2d58e5b
442276.48,3.0,39,4,4,2,10,0xb2d99e19
1392.68,1.0,3,1,2,4,7,0xb2d15864
511340.69,13.0,10,4,4,3,11,0xb2d12402
601354.52,1.0,0,4,2,4,10,0xb2d643b2
4597.53,1.0,5,2,2,3,7,0xb2d8f374d
1403.14,1.0,92,1,2,1,4,0xb2d20009d
126038.86,11.0,32,3,4,2,9,0xb2d43646
671075.47,1.0,1,4,2,4,10,0xb2d5a606
3158.31,1.0,184,2,2,1,5,0xb2d2c053
250000.0,2.0,14,3,3,3,9,0xb2da3b9f
100033.69,1.0,4,3,2,4,9,0xb2d6bf4e
1611923.19,2.0,0,4,3,4,11,0xb2d41a7b
101.3,1.0,60,1,2,2,5,0xb2d60812
589.3,1.0,62,1,2,2,5,0xb2d6154e
842634.54,6.0,0,4,4,4,12,0xb2d14e00
444978.1,3.0,0,4,4,4,12,0xb2d6e51dd
260369.72,1.0,0,3,2,4,9,0xb2d2d72b
2261784.93,2.0,60,4,3,2,9,0xb2d1d95e
80021.33,5.0,11,3,4,3,10,0xb2d5d3a3
378.3,1.0,24,1,2,2,5,0xb2d2e6cc
12036.69,1.0,103,2,2,1,5,0xb2d5e3c2
561.96,1.0,0,1,2,4,7,0xb2d9ce8e
6.05,1.0,9,1,2,3,6,0xb2d65ecc
383047.49,7.0,0,4,4,4,12,0xb2d09c74d
300315.31,2.0,20,4,3,2,9,0xb2d3f590
4231.84,1.0,0,2,2,4,8,0xb2d6b73e
211644.72,5.0,0,3,4,4,11,0xb2d06766
550000.0,19.0,4,4,4,4,12,0xb2d21fa5
425522.74,5.0,3,4,4,4,12,0xb2d256dc
450.36,1.0,84,1,2,1,4,0xb2d6b30b
404690.94,3.0,108,4,4,1,9,0xb2d5681b
62.37,2.0,19,1,3,2,6,0xb2d92b0b
93492.99,2.0,203,3,3,1,7,0xb2d24fb7
3370.32,1.0,0,2,2,4,8,0xb2d6b737
1093.57,1.0,274,1,2,1,4,0xb2d30fbed
788.52,4.0,0,1,4,4,9,0xb2d0680c
40001.34,2.0,52,2,3,2,7,0xb2d5ce74d
5140205.42,1.0,0,4,2,4,10,0xb2d26d98
49107.26,2.0,129,2,3,1,6,0xb2d5c954
9.93,1.0,60,1,2,2,5,0xb2d78d7a
8743.77,2.0,60,2,3,2,7,0xb2d522bd
430758.88,3.0,108,4,4,1,9,0xb2d3617cd
754214.38,6.0,126,4,4,1,9,0xb2d2afa8d
3.4,1.0,53,1,2,2,5,0xb2d289e8
204680.41,2.0,34,3,3,2,8,0xb2d4ed5a
675.21,1.0,3,1,2,4,7,0xb2d4c955
658921.34,10.0,73,4,4,1,9,0x3b9ada1a
2084.75,2.0,184,1,3,1,5,0xb2d286ff
54163.19,1.0,13,3,2,3,8,0xb2d1f0b5
16224.33,1.0,11,2,2,3,7,0xb2d37170d
568651.23,5.0,8,4,4,3,11,0xb2d2aa9e
11261.22,1.0,14,2,2,3,7,0xb2d91335
200000.0,2.0,1,3,3,4,10,0xb2da663b
120005.13,3.0,31,3,4,2,9,0xb2d5f35fd
100004.29,3.0,199,3,4,1,8,0xb2d5aca6
2665181.58,7.0,4,4,4,4,12,0xb2d24eeb
302061.55,1.0,0,4,2,4,10,0xb2d13c38
9.5,1.0,77,1,2,1,4,0xb2d98dd7
46.54,1.0,34,1,2,2,5,0xb2d59119
240201.59,5.0,0,3,4,4,11,0xb2d402f9
100000.5,3.0,2,3,4,4,11,0xb2d0d479
50724.24,2.0,3,2,3,4,9,0xb2d5e39f
300094.55,4.0,13,3,4,3,10,0xb2d26b04
617.01,1.0,9,1,2,3,6,0xb2d54ae4
1193254.07,6.0,1,4,4,4,12,0xb2d06436
1309077.55,5.0,4,4,4,4,12,0xb2d2b688
1122.37,1.0,9,1,2,3,6,0xb2d68e34
840003.37,4.0,5,4,4,3,11,0xb2d7fe91d
1704.03,1.0,9,1,2,3,6,0xb2d17f80
0.0,1.0,4,1,2,4,7,0xb2d987dc
150002.95,3.0,48,3,4,2,9,0xb2d580bd
85.07,1.0,0,1,2,4,7,0xb2d49e58d
510023.54,3.0,1,4,4,4,12,0xb2d91061
7175.58,1.0,12,2,2,3,7,0xb2d1fc1b
97199.31,6.0,1,3,4,4,11,0xb2d07bed
263342.45,4.0,60,3,4,2,9,0xb2d0dfbe
930709.4,5.0,0,4,4,4,12,0xb2d27e21
33056.04,1.0,58,2,2,2,6,0xb2d1e709
33220.47,1.0,41,2,2,2,6,0xb2d5f161
164545.13,3.0,4,3,4,4,11,0xb2d39e8e
216050.14,10.0,5,3,4,3,10,0xb2d19889d
7614.62,1.0,11,2,2,3,7,0xb2d906ca
193.07,1.0,75,1,2,1,4,0xb2d6a93ed
381115.06,3.0,70,4,4,1,9,0xb2d2ba99
23339.23,1.0,10,2,2,3,7,0xb2d597c2
60.74,1.0,73,1,2,1,4,0xb2d21a5e
408.7,1.0,1,1,2,4,7,0xb2d938af
7.32,1.0,70,1,2,1,4,0xb2d98eca
1000000.0,2.0,12,4,3,3,10,0xb2d9632b
0.79,1.0,18,1,2,2,5,0xb2d8c614
714000.1,2.0,16,4,3,2,9,0xb2d6bf69
35.22,1.0,25,1,2,2,5,0xb2d5aa44
6.34,1.0,60,1,2,2,5,0xb2d8ee9a
315865.38,2.0,109,4,3,1,8,0xb2d407a3
110295.34,6.0,0,3,4,4,11,0xb2d2113c
365473.69,2.0,10,4,3,3,10,0xb2d2cd82
1102107.8,7.0,3,4,4,4,12,0xb2d07fbe
254044.69,2.0,133,3,3,1,7,0xb2d5b417
2233.98,1.0,0,1,2,4,7,0xb2d8d391
18.58,1.0,3,1,2,4,7,0xb2d91315
146025.4,3.0,19,3,4,2,9,0xb2d2e1f5
200000.0,2.0,10,3,3,3,9,0xb2d8d3df
533124.33,5.0,12,4,4,3,11,0xb2d4069f
100000.0,2.0,6,3,3,3,9,0xb2da4f27
50009.0,2.0,0,2,3,4,9,0xb2d97b49
400.76,1.0,9,1,2,3,6,0xb2d5ac64
121138.53,2.0,192,3,3,1,7,0xb2d2c7c4
450000.0,2.0,22,4,3,2,9,0xb2da2047
10151.47,1.0,184,2,2,1,5,0xb2d3cd1b
3500218.68,3.0,8,4,4,3,11,0xb2d3a0a0
250017.39,4.0,74,3,4,1,8,0xb2d260fcd
45295.14,2.0,0,2,3,4,9,0x3b9af274
200010.52,2.0,12,3,3,3,9,0xb2d9ccc8
219691.46,1.0,184,3,2,1,6,0xb2d3a682d
117277.89,1.0,6,3,2,3,8,0xb2d92ffad
254.56,1.0,15,1,2,3,6,0xb2d8fec9
23733.14,1.0,29,2,2,2,6,0xb2d6d316
118601.65,3.0,165,3,4,1,8,0x3b9b4553
301065.84,2.0,59,4,3,2,9,0xb2d9010b
1011.26,1.0,184,1,2,1,4,0xb2d249df
16.42,1.0,0,1,2,4,7,0xb2d2411c
20726.54,1.0,11,2,2,3,7,0xb2d614cd
16907.65,1.0,15,2,2,3,7,0xb2d2ca9c
52.91,1.0,14,1,2,3,6,0xb2d61055
510117.63,2.0,13,4,3,3,10,0xb2d68393
50007.39,2.0,3,2,3,4,9,0xb2d94be3
1576.71,1.0,173,1,2,1,4,0xb2d2fabf
406927.99,4.0,25,4,4,2,10,0xb2d22709
894.63,1.0,42,1,2,2,5,0xb2d2c2f8d
979.14,1.0,30,1,2,2,5,0xb2d3a8f5
1409.33,1.0,0,1,2,4,7,0xb2d6e1b4d
5018.85,1.0,18,2,2,2,6,0xb2d98968
18124.2,2.0,171,2,3,1,6,0xb2d07e4c
171560.54,2.0,48,3,3,2,8,0xb2d6de8e
50000.0,2.0,7,2,3,3,8,0xb2da4f1c
0.0,1.0,3,1,2,4,7,0xb2d6bdab
145.54,1.0,45,1,2,2,5,0xb2d200c4
1457005.85,11.0,52,4,4,2,10,0xb2d2dd2d
1685.2,1.0,175,1,2,1,4,0xb2d6009fd
2616.88,1.0,7,1,2,3,6,0xb2d9c0fe
435848.32,8.0,0,4,4,4,12,0xb2d1de65
443.47,1.0,42,1,2,2,5,0xb2d6c6d8
210.07,1.0,36,1,2,2,5,0xb2d3b6d8
75.23,1.0,9,1,2,3,6,0xb2d58770
526000.0,4.0,7,4,4,3,11,0xb2d65495
3802.71,2.0,63,2,3,2,7,0xb2d50837
185060.74,4.0,0,3,4,4,11,0xb2d5ff0fd
555713.22,11.0,5,4,4,3,11,0xb2d64a5e
19.84,1.0,0,1,2,4,7,0xb2d69f0d
200002.11,2.0,47,3,3,2,8,0xb2d9151a
1895.68,1.0,184,1,2,1,4,0xb2d17401
506267.55,4.0,8,4,4,3,11,0xb2d4d039d
265432.36,9.0,20,3,4,2,9,0xb2d1850ed
20000.21,2.0,13,2,3,3,8,0xb2d95ece
1011.34,1.0,92,1,2,1,4,0xb2d3a908
90045.85,2.0,67,3,3,1,7,0xb2d547f9d
22611.29,1.0,0,2,2,4,8,0xb2d0fa65
723242.08,3.0,6,4,4,3,11,0xb2d5af38
100484.4,1.0,14,3,2,3,8,0xb2d220a9
520925.96,2.0,1,4,3,4,11,0xb2d3fe9a
102498.65,1.0,184,3,2,1,6,0xb2d35f76
416236.1,4.0,0,4,4,4,12,0xb2d3a89d
28734.34,1.0,3,2,2,4,8,0xb2d23b26
30109.53,2.0,0,2,3,4,9,0xb2d88d9dd
10447.66,1.0,90,2,2,1,5,0xb2d2acfa
4634.4,1.0,92,2,2,1,5,0xb2d25655d
7956.59,1.0,28,2,2,2,6,0xb2d9215bd
200000.0,2.0,25,3,3,2,8,0xb2da1bf0
450042.74,5.0,172,4,4,1,9,0xb2d229b0
53414.28,1.0,194,3,2,1,6,0xb2d38ccb
68009.14,1.0,9,3,2,3,8,0xb2d2df27
26137.46,1.0,3,2,2,4,8,0xb2d4c0a6
4220.42,2.0,19,2,3,2,7,0xb2d0bf01
900000.0,3.0,2,4,4,4,12,0xb2d981e0
81372.25,2.0,231,3,3,1,7,0xb2d62b0e
10154.43,1.0,59,2,2,2,6,0xb2d6aaab
180042.12,6.0,11,3,4,3,10,0xb2d5a214
1195072.04,6.0,28,4,4,2,10,0xb2d10a9b
60002.21,3.0,18,3,4,2,9,0xb2d9b111
200000.0,2.0,8,3,3,3,9,0xb2da5200
400045.0,3.0,116,4,4,1,9,0xb2d18c34
560135.9,3.0,3,4,4,4,12,0xb2d473a6d
160034.47,4.0,25,3,4,2,9,0xb2d5b160d
1257.63,1.0,8,1,2,3,6,0xb2d906d0
1.49,1.0,30,1,2,2,5,0xb2d998d1
50542.22,5.0,8,2,4,3,9,0xb2d58646
524.97,44.0,5,1,4,3,8,0xb2d123ca
17235.05,1.0,202,2,2,1,5,0xb2d5a170d
150007.11,4.0,56,3,4,2,9,0xb2d2aa6c
21.61,1.0,0,1,2,4,7,0xb2d599a2
283035.99,8.0,1,3,4,4,11,0xb2d331c0d
100478.64,2.0,65,3,3,2,8,0xb2d20e1e
24.78,1.0,0,1,2,4,7,0xb2d7904e
251639.68,3.0,129,3,4,1,8,0xb2d63b7f
300089.8,5.0,0,3,4,4,11,0xb2d229df
131275.51,1.0,1,3,2,4,9,0xb2d6c0b2d
19022.23,1.0,10,2,2,3,7,0xb2d35c62d
670045.24,5.0,0,4,4,4,12,0xb2d25fc8
1810046.89,3.0,143,4,4,1,9,0xb2d23b87
1015.56,1.0,92,1,2,1,4,0xb2d0f6f2
43044.07,4.0,3,2,4,4,10,0xb2d9f459
18855.44,2.0,210,2,3,1,6,0x3b9b3682d
2118.29,1.0,0,1,2,4,7,0xb2d34d73
220000.86,6.0,1,3,4,4,11,0xb2d45212
1101353.93,2.0,29,4,3,2,9,0xb2d1c394
656579.47,5.0,19,4,4,2,10,0xb2d39f0a
100019.41,2.0,4,3,3,4,10,0xb2da5431
1015.94,1.0,184,1,2,1,4,0xb2d1223b
50522.42,3.0,31,2,4,2,8,0xb2d4b9e7
64054.51,2.0,15,3,3,3,9,0xb2d22534
3189.87,1.0,0,2,2,4,8,0xb2d2a10f
223.23,1.0,9,1,2,3,6,0xb2d53b7b
4282.28,1.0,0,2,2,4,8,0xb2d7c3f9
75466.64,2.0,94,3,3,1,7,0xb2d5d3d9
202.89,1.0,37,1,2,2,5,0xb2d8d73cd
2015.03,1.0,148,1,2,1,4,0xb2d2fd6d
1687.91,1.0,12,1,2,3,6,0xb2d575e0
900000.0,2.0,18,4,3,2,9,0xb2d95a52
605332.11,3.0,75,4,4,1,9,0xb2d95d61d
190131.41,1.0,74,3,2,1,6,0xb2d61073
35000.37,2.0,42,2,3,2,7,0xb2d9e8dd
734796.34,3.0,36,4,4,2,10,0xb2d96ec2
91679.72,4.0,2,3,4,4,11,0xb2d55f09
2414.07,1.0,1,1,2,4,7,0xb2d5337e
2040000.88,5.0,0,4,4,4,12,0xb2d0bbee
201420.96,2.0,43,3,3,2,8,0xb2d5dea4
140999.01,4.0,101,3,4,1,8,0xb2d64782
0.0,1.0,7,1,2,3,6,0xb2d989c3
13.03,2.0,62,1,3,2,6,0xb2d9173c
32.57,1.0,24,1,2,2,5,0xb2d38de8
183.2,1.0,5,1,2,3,6,0xb2d5d9f3
100181.47,2.0,53,3,3,2,8,0xb2d08b6c
50024.91,2.0,10,2,3,3,8,0xb2d4f6bd
1774.58,1.0,184,1,2,1,4,0xb2d1a276
342.24,1.0,60,1,2,2,5,0xb2d2f0cc
4461.11,1.0,92,2,2,1,5,0xb2d43856
340062.28,5.0,22,4,4,2,10,0xb2d5a362
180088.43,2.0,61,3,3,2,8,0xb2d2bb50
1626.59,1.0,208,1,2,1,4,0xb2d2f825
21646.33,4.0,45,2,4,2,8,0xb2d4e558
241028.09,3.0,139,3,4,1,8,0xb2d62e19
1010.48,1.0,184,1,2,1,4,0xb2d0c846
480073.6,3.0,18,4,4,2,10,0xb2d18051
147.13,1.0,0,1,2,4,7,0xb2d2b0cf
4946.59,1.0,0,2,2,4,8,0xb2d6b8ee
151895.53,1.0,10,3,2,3,8,0xb2d3310d
1148561.95,4.0,42,4,4,2,10,0xb2d5ce1c
56738.55,1.0,6,3,2,3,8,0xb2d5e363
103442.9,3.0,116,3,4,1,8,0xb2d5d40d
0.0,2.0,21,1,3,2,6,0xb2da1b10
207566.9,7.0,64,3,4,2,9,0xb2d3e47bd
901140.14,4.0,15,4,4,3,11,0xb2d526e5
1.69,1.0,20,1,2,2,5,0xb2d7bf38
100001.06,2.0,231,3,3,1,7,0xb2d6f0e3
2.26,1.0,15,1,2,3,6,0xb2d6570e
686181.95,4.0,28,4,4,2,10,0xb2d3e67ed
420062.19,2.0,179,4,3,1,8,0xb2d35076
962.57,1.0,0,1,2,4,7,0xb2d31b4c
1270.15,1.0,77,1,2,1,4,0xb2d11b56
5676.18,1.0,6,2,2,3,7,0xb2d2370b
11817.23,1.0,0,2,2,4,8,0xb2d717ea
791699.96,5.0,0,4,4,4,12,0xb2d1ae0d
213241.98,4.0,21,3,4,2,9,0xb2d4c84d
378000.0,15.0,8,4,4,3,11,0xb2d2f68c
80061.08,2.0,0,3,3,4,10,0xb2d406a6d
27898.55,1.0,92,2,2,1,5,0xb2d340e6
1280170.49,3.0,0,4,4,4,12,0xb2d3ada2
123176.63,2.0,179,3,3,1,7,0xb2d62116
70000.74,2.0,167,3,3,1,7,0xb2d7abfe
1202489.46,4.0,27,4,4,2,10,0xb2d60cf1d
105238.39,2.0,172,3,3,1,7,0xb2d2c245d
27345.33,1.0,0,2,2,4,8,0xb2d09e5f
9.56,1.0,43,1,2,2,5,0xb2d51e57
14459.96,1.0,0,2,2,4,8,0xb2d906b1d
234437.32,2.0,54,3,3,2,8,0xb2d2c0bad
250047.73,3.0,74,3,4,1,8,0xb2d458c9d
575123.87,6.0,64,4,4,2,10,0xb2d2be30
400098.7,4.0,0,4,4,4,12,0xb2d65317
7118.57,1.0,0,2,2,4,8,0xb2d4cde7
221251.66,3.0,18,3,4,2,9,0xb2d5d4c9
12086.23,1.0,19,2,2,2,6,0xb2d271fc
1460088.56,5.0,116,4,4,1,9,0xb2d251b0
5022.78,1.0,184,2,2,1,5,0xb2d1a36c
280905.99,6.0,3,3,4,4,11,0xb2d1abc6d
135.13,1.0,0,1,2,4,7,0xb2d4fbf9
94.44,1.0,9,1,2,3,6,0xb2d35f11
1408.82,1.0,7,1,2,3,6,0xb2d1d20d
324.89,1.0,4,1,2,4,7,0xb2d34a2ed
20000.0,3.0,3,2,4,4,10,0xb2d5e9d5
101781.43,2.0,92,3,3,1,7,0xb2d56bb0
88547.45,2.0,5,3,3,3,9,0x3b9b33d4
100002.3,2.0,0,3,3,4,10,0xb2d8483a
2112151.52,4.0,39,4,4,2,10,0xb2d44c85
109082.84,4.0,83,3,4,1,8,0xb2d6dba7
360035.17,6.0,12,4,4,3,11,0xb2d64eb4
3477.61,2.0,4,2,3,4,9,0xb2d4b1d6
10517.39,1.0,14,2,2,3,7,0xb2d1558d
134683.49,1.0,6,3,2,3,8,0xb2d5fa6c
433115.67,4.0,0,4,4,4,12,0xb2d0f9dd
183125.3,1.0,13,3,2,3,8,0xb2d3b703
6193.81,1.0,20,2,2,2,6,0xb2d9435c
431032.88,8.0,63,4,4,2,10,0xb2d07b85
1887.58,1.0,1,1,2,4,7,0xb2d2b58a
1721840.33,8.0,1,4,4,4,12,0xb2d1b636
676.13,1.0,10,1,2,3,6,0xb2d903bf
101453.33,5.0,17,3,4,2,9,0xb2d08037
4416.44,1.0,10,2,2,3,7,0xb2d6219c
100583.91,3.0,13,3,4,3,10,0xb2d8ecaf
433061.0,3.0,67,4,4,1,9,0xb2d953de
1004230.67,2.0,4,4,3,4,11,0xb2d51263
1.73,1.0,26,1,2,2,5,0xb2d3cd47d
1500.82,1.0,62,1,2,2,5,0xb2d629e6
16609.32,1.0,0,2,2,4,8,0xb2da036a
280016.55,8.0,13,3,4,3,10,0xb2d60545
50001.06,2.0,11,2,3,3,8,0xb2da436a
71091.71,1.0,38,3,2,2,7,0xb2d1c96d
9.73,1.0,1,1,2,4,7,0xb2d6c3e1
50753.02,1.0,7,2,2,3,7,0xb2d177d9
11371.7,1.0,0,2,2,4,8,0xb2d7fc6f
10000.11,2.0,92,2,3,1,6,0xb2d65950d
5.23,1.0,0,1,2,4,7,0xb2d6a7ec
2420000.0,1.0,0,4,2,4,10,0xb2d19e81d
110001.98,4.0,24,3,4,2,9,0xb2d45bb3
38870.88,1.0,14,2,2,3,7,0xb2d4bb3ad
2584.94,1.0,8,1,2,3,6,0xb2d4841f
130088.34,2.0,139,3,3,1,7,0xb2d4c0c8
4258.29,1.0,184,2,2,1,5,0xb2d232d2
360012.87,4.0,25,4,4,2,10,0xb2d1f995
570928.93,4.0,125,4,4,1,9,0xb2d22b27
1131.85,1.0,131,1,2,1,4,0xb2d77812
2121.92,1.0,4,1,2,4,7,0xb2d2c6f9
930145.34,11.0,1,4,4,4,12,0xb2d23d1ad
300716.23,3.0,20,4,4,2,10,0xb2da033e
270011.16,2.0,24,3,3,2,8,0xb2d6230cd
53019.43,1.0,0,3,2,4,9,0xb2d69f35
1300001.05,2.0,1,4,3,4,11,0xb2d4649c
260102.06,3.0,0,3,4,4,11,0xb2d21fc4
696099.26,4.0,175,4,4,1,9,0xb2d1f8efd
2461.56,1.0,19,1,2,2,5,0xb2d281c2
446902.78,4.0,29,4,4,2,10,0xb2d550d4
7124.15,1.0,184,2,2,1,5,0xb2d24008
606.06,1.0,17,1,2,2,5,0xb2d55719
688628.24,5.0,4,4,4,4,12,0xb2d1ab23
2017004.96,16.0,1,4,4,4,12,0xb2d24df8d
3450093.26,9.0,83,4,4,1,9,0xb2d26032
986230.12,8.0,8,4,4,3,11,0xb2d4739a
95617.32,1.0,0,3,2,4,9,0xb2d18105d
0.11,1.0,46,1,2,2,5,0xb2d8dc64
38.69,1.0,74,1,2,1,4,0xb2d638d3
945.39,1.0,36,1,2,2,5,0xb2d31952
100039.72,2.0,4,3,3,4,10,0xb2d26398
300064.65,3.0,11,3,4,3,10,0xb2d2840f
4000006.63,9.0,4,4,4,4,12,0xb2d6fa89
1253122.13,31.0,0,4,4,4,12,0xb2d42b37d
887.06,1.0,7,1,2,3,6,0xb2d31d2f
10002.59,2.0,184,2,3,1,6,0xb2d0cdc4
10938.51,1.0,92,2,2,1,5,0xb2d324e0
2659.26,1.0,0,1,2,4,7,0xb2d8edbc
40533.57,2.0,202,2,3,1,6,0xb2d5c6f6d
70000.73,3.0,1,3,4,4,11,0xb2d54af9
54167.65,1.0,57,3,2,2,7,0xb2d609e9
524.86,1.0,0,1,2,4,7,0xb2d3b8ed
660429.85,5.0,0,4,4,4,12,0xb2d27e21d
0.0,1.0,5,1,2,3,6,0xb2d4d65a
2252.33,1.0,0,1,2,4,7,0xb2d5a7ec
321007.91,4.0,25,4,4,2,10,0xb2d9477a
6.34,1.0,173,1,2,1,4,0xb2d8d20ad
806093.23,193.0,0,4,4,4,12,0xb2d11fd8d
470000.0,3.0,0,4,4,4,12,0xb2da32d6
50606.22,2.0,66,2,3,2,7,0xb2d6c14f
3900.52,1.0,0,2,2,4,8,0xb2d6c6a3
717872.25,5.0,0,4,4,4,12,0xb2d2f245
672292.43,5.0,1,4,4,4,12,0xb2d15cf0
184.67,1.0,0,1,2,4,7,0xb2d82447
94917.71,2.0,74,3,3,1,7,0xb2d3bca6
12.92,2.0,48,1,3,2,6,0x3b9b3c42d
257385.24,10.0,0,3,4,4,11,0xb2d064ee
511811.87,8.0,76,4,4,1,9,0xb2d39289d
4.49,1.0,47,1,2,2,5,0xb2d695ab
5573.97,1.0,10,2,2,3,7,0xb2d6ecd0d
28.53,1.0,4,1,2,4,7,0xb2d6ce8d
16381.15,8.0,1,2,4,4,10,0x3b9ae3f4
3328.1,1.0,19,2,2,2,6,0xb2d22c09
501776.1,2.0,30,4,3,2,9,0xb2d9845b
523.85,1.0,0,1,2,4,7,0xb2d34836
18570.58,1.0,184,2,2,1,5,0xb2d1228a
19780.14,1.0,11,2,2,3,7,0xb2d97807
4965.57,1.0,0,2,2,4,8,0xb2d38282
460145.17,4.0,3,4,4,4,12,0xb2d63c67
2918.78,1.0,0,2,2,4,8,0xb2d288d9
672690.0,6.0,1,4,4,4,12,0xb2d649e1
12.0,1.0,78,1,2,1,4,0xb2d7ae9a
230020.81,4.0,19,3,4,2,9,0xb2d626e9
90057.66,4.0,0,3,4,4,11,0xb2d60e65
29.51,1.0,9,1,2,3,6,0xb2d2b2e3
51734.86,1.0,0,2,2,4,8,0xb2d621df
17135.36,1.0,93,2,2,1,5,0xb2d382b4
82021.33,4.0,18,3,4,2,9,0xb2d618c6
1.37,1.0,13,1,2,3,6,0xb2d78d1f
18697.45,1.0,0,2,2,4,8,0xb2d6a63d
176005.15,2.0,7,3,3,3,9,0xb2d592ee
350.39,1.0,1,1,2,4,7,0xb2d631da
104840.41,3.0,189,3,4,1,8,0xb2d4b8b4
100605.42,2.0,27,3,3,2,8,0xb2d634ec
220011.21,2.0,5,3,3,3,9,0xb2da07a9
4813.97,1.0,0,2,2,4,8,0xb2d6bc94
450019.04,2.0,195,4,3,1,8,0xb2d69c28d
3040518.92,8.0,11,4,4,3,11,0x3b9b19bd
2.2,1.0,62,1,2,2,5,0xb2d689f4
611136.67,4.0,4,4,4,4,12,0xb2d9aef2
2.49,1.0,57,1,2,2,5,0xb2d591db
1130.79,1.0,11,1,2,3,6,0xb2d2bf5c
300010.61,4.0,108,3,4,1,8,0xb2d5bba1
812037.88,3.0,76,4,4,1,9,0xb2d22232d
28477.67,1.0,0,2,2,4,8,0xb2d17605
5101.1,1.0,15,2,2,3,7,0xb2d9b378
20535.05,1.0,0,2,2,4,8,0xb2d0ec60d
1422.48,4.0,6,1,4,3,8,0xb2d2b680
80497.35,3.0,21,3,4,2,9,0xb2d9dfb3
12407.97,1.0,89,2,2,1,5,0xb2d656fbd
539354.13,2.0,214,4,3,1,8,0xb2d2c739
575627.5,4.0,0,4,4,4,12,0xb2d34aa0
230007.4,5.0,5,3,4,3,10,0xb2d5b0a0d
1.04,7.0,6,1,4,3,8,0xb2d35d06d
284.51,2.0,2,1,3,4,8,0x3b9acf2d
227.0,1.0,11,1,2,3,6,0xb2d6c979
662334.78,4.0,42,4,4,2,10,0x3b9b467a
402066.7,3.0,27,4,4,2,10,0xb2d235b4
1026.17,1.0,203,1,2,1,4,0xb2d52ed3d
101565.99,1.0,106,3,2,1,6,0xb2d57932d
2767.67,1.0,19,1,2,2,5,0xb2d683dd
478.43,1.0,0,1,2,4,7,0xb2d3f957
150000.0,1.0,0,3,2,4,9,0xb2d8ce37d
271239.0,3.0,122,3,4,1,8,0xb2d08cd1
132.85,1.0,1,1,2,4,7,0xb2d56842
66.44,1.0,21,1,2,2,5,0xb2d5dc54
541600.0,13.0,1,4,4,4,12,0x3b9ae61a
1771.13,2.0,17,1,3,2,6,0xb2d59dce
989186.57,10.0,35,4,4,2,10,0xb2d07bac
4492911.67,1.0,10,4,2,3,9,0xb2d565d0
417.88,1.0,8,1,2,3,6,0xb2d30a61
509755.5,8.0,2,4,4,4,12,0xb2d0d539d
8821.3,1.0,1,2,2,4,8,0xb2d321df
1495635.97,9.0,4,4,4,4,12,0xb2d3ffcf
130031.23,3.0,11,3,4,3,10,0xb2d42e31
232133.34,4.0,13,3,4,3,10,0xb2d78e27
2387.36,1.0,92,1,2,1,4,0xb2d0f2a3
320907.81,1.0,12,4,2,3,9,0xb2d3018b
617868.9,2.0,97,4,3,1,8,0xb2d5d238
20084.62,2.0,167,2,3,1,6,0xb2d6185f
111408.82,4.0,0,3,4,4,11,0x3b9b44bd
7.25,1.0,37,1,2,2,5,0xb2d124e2
80206.0,2.0,4,3,3,4,10,0xb2da2a75
6423151.52,2.0,52,4,3,2,9,0xb2d5dcfe
4253250.16,10.0,1,4,4,4,12,0xb2d1e733
3950.82,1.0,184,2,2,1,5,0xb2d21125
4584.38,1.0,6,2,2,3,7,0xb2d2361a
300001.06,3.0,20,3,4,2,9,0xb2d94c28d
100009.78,5.0,143,3,4,1,8,0xb2d06342
1.37,1.0,110,1,2,1,4,0xb2d95784
392366.72,4.0,196,4,4,1,9,0xb2d151c7
2099.78,1.0,132,1,2,1,4,0xb2d2f301
200000.0,2.0,15,3,3,3,9,0xb2da3a22
880.05,2.0,82,1,3,1,5,0xb2d06ccb
130978.78,5.0,4,3,4,4,11,0xb2d69064
3015.44,1.0,11,2,2,3,7,0xb2d0acad
100141.71,2.0,77,3,3,1,7,0xb2d253a9
2844.1,1.0,129,1,2,1,4,0xb2d58d09
40317.14,2.0,0,2,3,4,9,0xb2d28aea
3627.24,1.0,291,2,2,1,5,0xb2d5d4a5
120077.42,3.0,1,3,4,4,11,0xb2d60660
1932.13,1.0,27,1,2,2,5,0xb2d42437
267116.27,3.0,111,3,4,1,8,0xb2d56e98
260045.55,4.0,14,3,4,3,10,0xb2d9604a
1005340.31,3.0,53,4,4,2,10,0xb2d94f31
614.56,1.0,21,1,2,2,5,0xb2d2eee5
5541.29,1.0,8,2,2,3,7,0xb2d8f69b
285847.97,2.0,199,3,3,1,7,0xb2d5945a
256359.56,5.0,0,3,4,4,11,0xb2d33729
17.98,1.0,28,1,2,2,5,0xb2d24ba3d
200049.88,2.0,1,3,3,4,10,0xb2d596ad
500081.77,3.0,11,4,4,3,11,0xb2d6217d
55831.84,1.0,4,3,2,4,9,0xb2d2b22f
243203.15,4.0,7,3,4,3,10,0xb2d4b8e5
10131.46,1.0,92,2,2,1,5,0xb2d1f1f7
24561.06,2.0,105,2,3,1,6,0xb2d19b17
222126.11,2.0,3,3,3,4,10,0xb2d3aff5
22270.86,1.0,39,2,2,2,6,0xb2d7f42dd
703.89,1.0,39,1,2,2,5,0xb2d956ec
11845.33,1.0,29,2,2,2,6,0xb2d9be5c
4332.31,1.0,19,2,2,2,6,0xb2d68e5e
177.54,1.0,0,1,2,4,7,0xb2d6ec8d
240014.26,2.0,32,3,3,2,8,0xb2d3c425
23821.9,1.0,9,2,2,3,7,0xb2d32f4d
200012.53,2.0,22,3,3,2,8,0xb2d59640d
200101.06,2.0,8,3,3,3,9,0xb2da4a53
240487.69,3.0,55,3,4,2,9,0xb2d41bb7d
373940.43,2.0,208,4,3,1,8,0xb2d22f59
560084.17,4.0,25,4,4,2,10,0xb2d4f7cf
600041.76,10.0,83,4,4,1,9,0xb2d54e67d
350003.69,2.0,95,4,3,1,8,0xb2d78bc5
81203.22,4.0,31,3,4,2,9,0xb2d4637d
573240.23,10.0,0,4,4,4,12,0xb2d46f91
1070127.02,3.0,0,4,4,4,12,0xb2d1e785
550140.89,3.0,0,4,4,4,12,0xb2d9d85e
447.22,1.0,2,1,2,4,7,0xb2d56d3c
235025.15,3.0,80,3,4,1,8,0xb2d5e345d
1.17,1.0,20,1,2,2,5,0xb2d15aa3
0.96,1.0,6,1,2,3,6,0xb2d3e8ccd
2547961.25,19.0,35,4,4,2,10,0xb2d1ca23
1782.46,1.0,92,1,2,1,4,0xb2d53a07
5755.88,1.0,138,2,2,1,5,0xb2d6f2f4
30891.5,3.0,0,2,4,4,10,0xb2d537a1
1719.07,1.0,10,1,2,3,6,0xb2d94df3
574007.87,9.0,0,4,4,4,12,0xb2d12137
6824.67,2.0,0,2,3,4,9,0xb2d18f87
815884.72,8.0,1,4,4,4,12,0xb2d1aee0
227033.18,2.0,66,3,3,2,8,0xb2d60259
410020.4,3.0,24,4,4,2,10,0xb2d3cc36
1000004.77,4.0,3,4,4,4,12,0xb2d5dbe2
3958.64,1.0,10,2,2,3,7,0xb2d55215
45985.45,1.0,20,2,2,2,6,0xb2d4877e
679661.52,15.0,0,4,4,4,12,0xb2d48265
18.06,1.0,120,1,2,1,4,0xb2d298f9
27500.0,2.0,0,2,3,4,9,0xb2d55b16d
160007.3,5.0,19,3,4,2,9,0xb2d17841
66.61,1.0,46,1,2,2,5,0xb2d78be5
246000.3,2.0,0,3,3,4,10,0xb2d560f9
26710.73,2.0,7,2,3,3,8,0xb2d952d2
490085.18,5.0,80,4,4,1,9,0xb2d0d2d3
30416.52,1.0,184,2,2,1,5,0xb2d204c9
50003.17,2.0,56,2,3,2,7,0xb2d9bc20
366345.28,3.0,1,4,4,4,12,0xb2d5c4ca
672718.02,17.0,1,4,4,4,12,0xb2d60b27
200573.86,3.0,11,3,4,3,10,0xb2d93994d
15150.78,1.0,92,2,2,1,5,0xb2d28bf9
0.0,1.0,9,1,2,3,6,0xb2d32549
30380.95,2.0,82,2,3,1,6,0xb2d5c3aa
3420.84,2.0,184,2,3,1,6,0xb2d09501
118613.33,3.0,0,3,4,4,11,0xb2d25239d
0.1,1.0,8,1,2,3,6,0xb2d77317d
80530.45,3.0,20,3,4,2,9,0xb2d60928
6919.53,1.0,291,2,2,1,5,0xb2d35407d
11598.97,1.0,0,2,2,4,8,0xb2d369e2
177021.73,4.0,52,3,4,2,9,0xb2d1d24c
443569.84,1.0,0,4,2,4,10,0xb2d643b2d
3878.07,1.0,36,2,2,2,6,0xb2d8fd39
223702.89,3.0,1,3,4,4,11,0xb2d631f9
50026.07,2.0,56,2,3,2,7,0xb2d9b17c
100982.44,1.0,92,3,2,1,6,0xb2d2b96d
431.35,1.0,11,1,2,3,6,0xb2d159cc
3711.87,5.0,11,2,4,3,9,0xb2d1f84dd
1011842.98,13.0,0,4,4,4,12,0xb2d5e670
205654.75,1.0,0,3,2,4,9,0xb2d5a5c5
0.0,2.0,50,1,3,2,6,0xb2d9d108
3484.98,1.0,11,2,2,3,7,0xb2d4fde4
587028.3,7.0,27,4,4,2,10,0xb2d0b439
2183.41,1.0,25,1,2,2,5,0xb2d9514a
20683.93,2.0,3,2,3,4,9,0xb2d9857d
650001.86,4.0,0,4,4,4,12,0xb2d69ab9
7900.98,1.0,157,2,2,1,5,0xb2d64576
220036.86,2.0,0,3,3,4,10,0xb2d5683c
48.24,1.0,2,1,2,4,7,0xb2d48fea
8557.28,1.0,20,2,2,2,6,0xb2d68e2c
0.87,1.0,5,1,2,3,6,0xb2d67ddcd
180004.42,2.0,76,3,3,1,7,0xb2d56bc2
14721.0,1.0,0,2,2,4,8,0xb2d12abad
149.58,1.0,2,1,2,4,7,0xb2d20d06
1414.85,1.0,92,1,2,1,4,0xb2d5bfb6
20001.19,2.0,43,2,3,2,7,0xb2d9283f
211450.53,8.0,0,3,4,4,11,0xb2d307bcd
22782.49,1.0,1,2,2,4,8,0xb2d6cca0
350168.58,2.0,111,4,3,1,8,0xb2d4127d
211007.39,8.0,63,3,4,2,9,0xb2d5a6ca
1051802.81,3.0,8,4,4,3,11,0xb2d12d8b
18.49,1.0,74,1,2,1,4,0xb2d54e0b
8401.67,1.0,11,2,2,3,7,0xb2da3c30
5989.42,1.0,0,2,2,4,8,0xb2d62c42
828261.29,7.0,1,4,4,4,12,0xb2d3c973
20204.12,1.0,11,2,2,3,7,0xb2d951ca
222581.1,2.0,0,3,3,4,10,0xb2d6bb0a
210001.88,2.0,2,3,3,4,10,0xb2d9b5fb
120068.99,4.0,132,3,4,1,8,0xb2d3fd89
40000.42,2.0,45,2,3,2,7,0xb2d91b82
0.32,1.0,8,1,2,3,6,0xb2d691eed
0.53,1.0,110,1,2,1,4,0xb2d956a0d
14930.77,1.0,184,2,2,1,5,0xb2d410ec
200085.3,2.0,19,3,3,2,8,0xb2d64a50
722990.9,6.0,19,4,4,2,10,0xb2d289c8
170116.51,7.0,3,3,4,4,11,0xb2d15717
222.31,1.0,9,1,2,3,6,0xb2d705af
301089.98,6.0,0,4,4,4,12,0xb2d20c0b
500010.43,6.0,70,4,4,1,9,0x3b9b39b0
6832.24,1.0,4,2,2,4,8,0xb2d2a486
651845.38,7.0,18,4,4,2,10,0x3b9b4575d
44736.35,1.0,0,2,2,4,8,0xb2d82442
227741.49,4.0,18,3,4,2,9,0xb2d12a43d
18778.96,1.0,184,2,2,1,5,0xb2d3fb4e
10323.2,2.0,25,2,3,2,7,0xb2d68bf8
40455.54,1.0,0,2,2,4,8,0xb2d413d1
400004.22,3.0,0,4,4,4,12,0xb2da1b3e
2422.84,1.0,23,1,2,2,5,0xb2d2bd31
110044.12,8.0,14,3,4,3,10,0xb2d5ac44
4158.31,1.0,101,2,2,1,5,0xb2d1e5b8
16.46,1.0,69,1,2,1,4,0xb2d68808
120000.0,2.0,82,3,3,1,7,0xb2d6b777d
42000.03,3.0,6,2,4,3,9,0xb2d331e0
1594.0,1.0,184,1,2,1,4,0xb2d4c69b
0.6,2.0,6,1,3,3,7,0xb2d19b6c
1526307.24,6.0,63,4,4,2,10,0xb2d56e51d
44.38,1.0,0,1,2,4,7,0xb2d6b709
0.43,1.0,70,1,2,1,4,0xb2d5b2e6d
3000000.0,1.0,0,4,2,4,10,0xb2da4e83
1000094.42,3.0,18,4,4,2,10,0x3b9b1832
313.93,1.0,0,1,2,4,7,0xb2d57e6fd
180084.71,2.0,13,3,3,3,9,0xb2d196b4
1116.53,1.0,4,1,2,4,7,0xb2d45177
580479.75,9.0,5,4,4,3,11,0xb2d25c00
2023364.53,5.0,18,4,4,2,10,0xb2d178dad
2577.13,1.0,168,1,2,1,4,0xb2d5ea8d
3509.45,1.0,0,2,2,4,8,0xb2d8f701
129.65,1.0,0,1,2,4,7,0xb2d2e207
706.18,1.0,75,1,2,1,4,0xb2d59b77
937.41,1.0,10,1,2,3,6,0xb2d9f5f6
90083.54,4.0,12,3,4,3,10,0xb2d5edc7
3422.64,1.0,18,2,2,2,6,0xb2d78fe4d
100088.74,2.0,102,3,3,1,7,0xb2d2f3c5
2230.47,1.0,5,1,2,3,6,0xb2d906c6
3158055.23,1.0,1,4,2,4,10,0xb2d2f380
371733.13,4.0,48,4,4,2,10,0xb2d1558b
4055.46,3.0,92,2,4,1,7,0xb2d06a0c
790027.58,6.0,8,4,4,3,11,0xb2d6d0ac
7341.41,1.0,35,2,2,2,6,0xb2d90d03
201699.3,3.0,221,3,4,1,8,0xb2d520c5
1581.55,1.0,9,1,2,3,6,0xb2d2c7a5
22.01,1.0,4,1,2,4,7,0xb2d6ef66
50628.99,1.0,6,2,2,3,7,0xb2d62e67
703003.51,3.0,18,4,4,2,10,0xb2d8e9fe
9320.01,1.0,16,2,2,2,6,0xb2d6e651
51226.41,2.0,192,2,3,1,6,0xb2d0fa1e
3557.5,1.0,2,2,2,4,8,0xb2d312f6
300020.09,7.0,31,3,4,2,9,0xb2d5514b
500010.56,2.0,73,4,3,1,8,0xb2d8e206
0.0,1.0,2,1,2,4,7,0xb2d8b355
1963.26,1.0,14,1,2,3,6,0xb2d23842d
614632.78,6.0,2,4,4,4,12,0xb2d6cd72
200000.0,2.0,48,3,3,2,8,0xb2d9dde3
10575.42,1.0,92,2,2,1,5,0xb2d59f47
202.91,1.0,50,1,2,2,5,0xb2d57d1f
9952.92,1.0,0,2,2,4,8,0xb2d4369b
29130.49,1.0,11,2,2,3,7,0xb2d6f5ab
5360.18,1.0,196,2,2,1,5,0xb2d1d086d
396615.47,5.0,13,4,4,3,11,0xb2d1b62e
511390.32,5.0,18,4,4,2,10,0xb2d6fccf
13748.53,1.0,3,2,2,4,8,0xb2d3aae7
1502.01,1.0,0,1,2,4,7,0xb2d92605
200004.66,2.0,11,3,3,3,9,0xb2d5a22b
50094.19,2.0,9,2,3,3,8,0xb2d3b5b8
1280071.34,6.0,10,4,4,3,11,0xb2d62f97
371283.93,3.0,10,4,4,3,11,0xb2d40a0b
118781.34,3.0,79,3,4,1,8,0xb2d3cbf5
301094.78,2.0,19,4,3,2,9,0xb2d5b1ff
17639.03,1.0,29,2,2,2,6,0xb2d6c81c
111248.39,4.0,20,3,4,2,9,0xb2d4299cd
6.57,1.0,14,1,2,3,6,0xb2d69ab0d
150004.12,3.0,0,3,4,4,11,0xb2d9b74d
1714.28,1.0,92,1,2,1,4,0xb2d2130b
201757.07,3.0,55,3,4,2,9,0xb2d2a601
174009.2,2.0,92,3,3,1,7,0xb2d65ba6
81314.78,2.0,122,3,3,1,7,0xb2d645f3
500026.74,2.0,76,4,3,1,8,0xb2d0dd86
50633.59,1.0,4,2,2,4,8,0xb2d954a5
481710.31,2.0,12,4,3,3,10,0xb2d8ec7fd
967.51,1.0,43,1,2,2,5,0xb2d3ab79
2584482.85,3.0,25,4,4,2,10,0xb2d1ad82
90.64,2.0,0,1,3,4,8,0xb2d3a90e
200008.78,2.0,20,3,3,2,8,0xb2d4387dd
1568605.94,6.0,0,4,4,4,12,0xb2d57462
460896.9,3.0,9,4,4,3,11,0xb2d6d0c1d
202884.37,2.0,0,3,3,4,10,0xb2d61e3d
120000.0,2.0,0,3,3,4,10,0xb2d98009
694619.92,5.0,83,4,4,1,9,0xb2d13860
2.22,1.0,63,1,2,2,5,0xb2d99702
104.9,1.0,21,1,2,2,5,0xb2d2631a
1503.89,1.0,137,1,2,1,4,0xb2d31577
3.39,1.0,89,1,2,1,4,0xb2d2381f
201060.8,3.0,7,3,4,3,10,0xb2d68b4c
111015.2,4.0,12,3,4,3,10,0xb2d5d25bd
10090.69,2.0,0,2,3,4,9,0xb2d6cf9f
200000.43,2.0,24,3,3,2,8,0xb2d9ca39
750006.88,3.0,20,4,4,2,10,0xb2d6b3de
300536.48,3.0,9,4,4,3,11,0xb2d57274
19675.79,1.0,0,2,2,4,8,0xb2d6b2fed
600010.52,3.0,1,4,4,4,12,0xb2d9790e
250062.65,4.0,181,3,4,1,8,0xb2d1c558
5497.7,1.0,9,2,2,3,7,0xb2d4763e
17730.02,1.0,7,2,2,3,7,0xb2d27f82
1901.5,1.0,25,1,2,2,5,0xb2d27287
1011.85,1.0,0,1,2,4,7,0xb2d4b64f
356.88,1.0,9,1,2,3,6,0xb2d96f2c
670.57,1.0,20,1,2,2,5,0xb2d1bcacd
300065.63,2.0,4,3,3,4,10,0xb2d9ecbc
7928.34,1.0,0,2,2,4,8,0xb2d6f266
71614.52,1.0,184,3,2,1,6,0xb2d47d94
178005.62,1.0,2,3,2,4,9,0xb2d2dc61
21727.82,1.0,0,2,2,4,8,0xb2d0dd13
1000000.0,1.0,2,4,2,4,10,0xb2da65a9
372538.41,5.0,97,4,4,1,9,0xb2d4002c
502128.0,2.0,23,4,3,2,9,0xb2d6e3b9
18.08,1.0,12,1,2,3,6,0xb2d8eba1
50776.54,1.0,78,2,2,1,5,0xb2d177d9d
160154.0,5.0,1,3,4,4,11,0xb2d417d6d
460081.21,3.0,1,4,4,4,12,0xb2d5f56d
10570.16,1.0,11,2,2,3,7,0xb2d5b6b3
40001.27,2.0,18,2,3,2,7,0xb2da24bf
420410.01,1.0,0,4,2,4,10,0xb2d1e629
38441.79,1.0,18,2,2,2,6,0xb2d1190c
5416.02,1.0,0,2,2,4,8,0xb2d3a667
480029.05,6.0,4,4,4,4,12,0xb2d1459e
30000990.68,6.0,7,4,4,3,11,0xb2d0ef41
2015.32,1.0,0,1,2,4,7,0xb2d2c3d5
266.29,1.0,12,1,2,3,6,0xb2d6e428
28762.89,1.0,49,2,2,2,6,0xb2d5cf49
175338.01,3.0,0,3,4,4,11,0xb2d21239
29355.09,1.0,92,2,2,1,5,0xb2d283bbd
5426.14,1.0,1,2,2,4,8,0xb2d4351d
2842.86,2.0,92,1,3,1,5,0xb2d095f8
300009.99,4.0,77,3,4,1,8,0xb2d1a628
142098.51,5.0,73,3,4,1,8,0xb2d163d4
100096.31,3.0,102,3,4,1,8,0xb2d1a9c2
246.84,1.0,13,1,2,3,6,0xb2d3ec7a
8170.2,1.0,0,2,2,4,8,0xb2d78b13
428242.33,4.0,13,4,4,3,11,0xb2d5108e
1995.05,1.0,2,1,2,4,7,0xb2d551f0
11.61,1.0,4,1,2,4,7,0xb2da33af
1622.62,1.0,12,1,2,3,6,0xb2d91919
2929800.0,15.0,8,4,4,3,11,0xb2da3dc9
40068.42,2.0,80,2,3,1,6,0xb2d464bb
82822.15,2.0,0,3,3,4,10,0xb2d2483c
79370.49,1.0,92,3,2,1,6,0xb2d361f4d
4069.88,1.0,0,2,2,4,8,0xb2d4ce3b
100000.0,2.0,3,3,3,4,10,0xb2d976f6
20195.0,1.0,5,2,2,3,7,0xb2da5e30
3532.65,1.0,92,2,2,1,5,0xb2d5a235
27136.72,1.0,0,2,2,4,8,0xb2d6bb07
1131115.14,5.0,18,4,4,2,10,0x3b9b35c0
152603.12,1.0,140,3,2,1,6,0xb2d63b55
5734.04,1.0,10,2,2,3,7,0xb2d5d765
1356000.7,7.0,0,4,4,4,12,0x3b9b1bde
300003.05,7.0,21,3,4,2,9,0xb2d4fad0
560447.11,3.0,44,4,4,2,10,0xb2d177b2
340000.0,7.0,4,4,4,4,12,0xb2d3d2d1
0.78,1.0,5,1,2,3,6,0xb2d7c6e5
38.96,1.0,74,1,2,1,4,0xb2d3da1d
654.75,1.0,61,1,2,2,5,0xb2d67835
12288.86,1.0,6,2,2,3,7,0xb2d472b3
428531.38,2.0,119,4,3,1,8,0xb2d3be38
310012.78,3.0,18,4,4,2,10,0xb2d9099c
161722.43,4.0,0,3,4,4,11,0xb2d10742
500026.72,2.0,133,4,3,1,8,0xb2d6c63f
885247.65,2.0,10,4,3,3,10,0xb2d2cb62
550001.13,3.0,20,4,4,2,10,0xb2d0dd72
74335.46,1.0,232,3,2,1,6,0xb2d1dc57
36.72,2.0,2,1,3,4,8,0xb2d2ce71
211103.26,5.0,18,3,4,2,9,0xb2d5b70b
223461.65,3.0,4,3,4,4,11,0xb2d686f3
37283.97,1.0,0,2,2,4,8,0xb2d85b2e
1918.34,4.0,92,1,4,1,6,0xb2d22f72
570000.87,4.0,6,4,4,3,11,0xb2d209d2d
19511.25,1.0,9,2,2,3,7,0xb2d8023c
280001.69,3.0,25,3,4,2,9,0xb2da1348
4264.16,1.0,4,2,2,4,8,0xb2d941dc
10000.0,1.0,0,2,2,4,8,0xb2d51e5c
350108.06,7.0,154,4,4,1,9,0xb2d5a74b
150070.66,2.0,19,3,3,2,8,0xb2d68e07
754246.9,9.0,26,4,4,2,10,0x3b9b45e9d
9528.98,1.0,14,2,2,3,7,0xb2d94218d
309057.76,4.0,119,4,4,1,9,0xb2d1c326d
0.64,1.0,92,1,2,1,4,0xb2d2a8a5d
44359.16,1.0,5,2,2,3,7,0xb2d32ed2
139.38,1.0,92,1,2,1,4,0xb2d2a3cf
64618.76,5.0,35,3,4,2,9,0xb2d60b2f
2843.71,1.0,92,1,2,1,4,0xb2d1531e
300007.61,5.0,4,3,4,4,11,0xb2d0e7ecd
180215.9,4.0,56,3,4,2,9,0xb2d5f669
632969.1,14.0,0,4,4,4,12,0xb2d0d4b0
0.3,1.0,7,1,2,3,6,0xb2d935c1
20061.49,1.0,92,2,2,1,5,0xb2d39c7a
1090896.22,6.0,55,4,4,2,10,0xb2d57a11
446003.45,7.0,5,4,4,3,11,0xb2d657d9
387043.61,5.0,1,4,4,4,12,0xb2d20c6f
16.77,1.0,66,1,2,2,5,0xb2d6dc6a
156002.16,3.0,0,3,4,4,11,0xb2d4dcda
1320000.0,10.0,0,4,4,4,12,0xb2d546db
100009.51,1.0,18,3,2,2,7,0xb2d229d1
51000.0,3.0,1,2,4,4,10,0xb2d62d85
8074.88,1.0,92,2,2,1,5,0xb2d2c67dd
700111.64,4.0,13,4,4,3,11,0xb2da1fef
206799.18,2.0,186,3,3,1,7,0xb2d24efd
13146.78,2.0,0,2,3,4,9,0xb2d0a63b
0.0,1.0,1,1,2,4,7,0xb2d97bb3
2150340.0,4.0,1,4,4,4,12,0xb2d973cd
0.65,4.0,60,1,4,2,7,0xb2d4ec33
10091.39,1.0,92,2,2,1,5,0xb2d19e56
3006.99,1.0,184,2,2,1,5,0xb2d3953b
10002.16,1.0,21,2,2,2,6,0xb2d96948
1006.73,1.0,92,1,2,1,4,0xb2d2e346
50625.71,1.0,28,2,2,2,6,0xb2d39fab
4735.78,2.0,0,2,3,4,9,0xb2d2124ed
402000.0,6.0,5,4,4,3,11,0xb2d0a83a
150108.32,3.0,77,3,4,1,8,0xb2d57ea6d
30623.09,3.0,3,2,4,4,10,0xb2d567da
600019.63,5.0,28,4,4,2,10,0xb2d95e46
1180.05,1.0,18,1,2,2,5,0xb2d273c7
100001.04,3.0,32,3,4,2,9,0xb2d5fe12
1988.42,1.0,184,1,2,1,4,0xb2d36927
510.33,1.0,16,1,2,2,5,0xb2d69eb6
34903.07,2.0,0,2,3,4,9,0xb2d6a67c
10109.62,2.0,193,2,3,1,6,0xb2d6e47b
500020.0,3.0,5,4,4,3,11,0xb2d9a6ea
600864.65,3.0,11,4,4,3,11,0xb2d89ff9
50000.0,2.0,4,2,3,4,9,0xb2da5c06
282051.57,6.0,4,3,4,4,11,0xb2d50fa0
342.46,1.0,75,1,2,1,4,0xb2d31a98
584.46,1.0,0,1,2,4,7,0xb2d6b10e
107006.5,5.0,10,3,4,3,10,0xb2d5a95ad
958183.65,17.0,0,4,4,4,12,0xb2d23409
124753.81,4.0,18,3,4,2,9,0xb2d3e4e3d
8086.19,1.0,20,2,2,2,6,0xb2d32109
1036.81,1.0,0,1,2,4,7,0xb2d6c4d2
893.87,1.0,8,1,2,3,6,0xb2d8c3b5
61092.46,5.0,4,3,4,4,11,0xb2d53d6ad
165133.15,3.0,80,3,4,1,8,0xb2d5881d
92.64,1.0,10,1,2,3,6,0xb2d38f10
453586.65,3.0,19,4,4,2,10,0xb2d6e595
1661.48,1.0,0,1,2,4,7,0xb2d2fe9e
50803.74,3.0,41,2,4,2,8,0xb2d61051
183007.16,4.0,27,3,4,2,9,0xb2d438ee
1122093.77,11.0,1,4,4,4,12,0xb2d645ced
361762.83,3.0,80,4,4,1,9,0xb2d3f6f7
2000042.97,2.0,15,4,3,3,10,0xb2d69ce8
259.57,1.0,10,1,2,3,6,0xb2d41005d
1016.48,1.0,184,1,2,1,4,0xb2d0fbe5d
118589.47,1.0,1,3,2,4,9,0xb2d5bdf2
200010.43,2.0,24,3,3,2,8,0xb2d9cc5d
53.46,1.0,9,1,2,3,6,0xb2d2d3ee
406912.21,2.0,7,4,3,3,10,0xb2d560e2
1675054.48,13.0,0,4,4,4,12,0xb2d1531a
220037.49,4.0,0,3,4,4,11,0xb2d401e5
107563.39,3.0,172,3,4,1,8,0xb2d30079
372.29,1.0,0,1,2,4,7,0xb2d47d68
640000.02,4.0,19,4,4,2,10,0xb2d780c2
10.87,1.0,27,1,2,2,5,0xb2d43534
36.93,1.0,28,1,2,2,5,0xb2d6c607
1112453.87,5.0,0,4,4,4,12,0xb2d19861
20333.49,2.0,3,2,3,4,9,0xb2d5c31c
535.75,1.0,3,1,2,4,7,0xb2d90202
5609.6,1.0,92,2,2,1,5,0xb2d2c894
1320.3,2.0,92,1,3,1,5,0xb2d0a669
236416.03,2.0,27,3,3,2,8,0xb2d135f2
330109.59,3.0,18,4,4,2,10,0xb2d9d60e
86.95,1.0,13,1,2,3,6,0xb2d285e5
24753.84,2.0,0,2,3,4,9,0xb2d2ea73
150417.57,3.0,231,3,4,1,8,0xb2d6e9bb
0.0,1.0,9,1,2,3,6,0xb2d97e69
200004.22,2.0,34,3,3,2,8,0xb2d9301c
87.66,1.0,25,1,2,2,5,0xb2d6c4b6
1837827.71,3.0,71,4,4,1,9,0xb2d638fa
154887.09,4.0,77,3,4,1,8,0x3b9b3c80
137003.86,7.0,3,3,4,4,11,0xb2d3baf7
35361.61,1.0,0,2,2,4,8,0xb2d2c8ed
10000.77,2.0,69,2,3,1,6,0xb2d587a5
52219.69,1.0,5,3,2,3,8,0xb2d5974e
431091.9,8.0,6,4,4,3,11,0xb2d07b85d
11225.65,2.0,0,2,3,4,9,0xb2d5749cd
48466.49,1.0,1,2,2,4,8,0xb2d62dd3
6542.61,1.0,49,2,2,2,6,0xb2d6a91c
3009527.81,1.0,1,4,2,4,10,0xb2d6a46e
1630729.5,3.0,0,4,4,4,12,0xb2d78994
60847.72,5.0,49,3,4,2,9,0xb2d67cea
405002.03,6.0,20,4,4,2,10,0xb2d22b9a
1996.83,2.0,92,1,3,1,5,0x3b9b3e25
10324.67,1.0,28,2,2,2,6,0xb2d68de7
193677.77,4.0,0,3,4,4,11,0xb2d139ea
50040.61,2.0,193,2,3,1,6,0xb2d21879d
48.7,1.0,9,1,2,3,6,0xb2d919b3
35917.37,2.0,80,2,3,1,6,0xb2d3c7b0
25705.58,3.0,8,2,4,3,9,0xb2d55106
19.42,1.0,9,1,2,3,6,0xb2d9145b
20000.0,2.0,4,2,3,4,9,0xb2da533f
306400.12,2.0,202,4,3,1,8,0xb2d78757d
200025.19,2.0,21,3,3,2,8,0xb2d601a4d
46125.63,3.0,18,2,4,2,8,0xb2d5ca02
264000.14,4.0,48,3,4,2,9,0xb2d605cb
21565.19,1.0,92,2,2,1,5,0xb2d29166d
3881.16,1.0,9,2,2,3,7,0xb2d555b3
450026.3,4.0,6,4,4,3,11,0xb2d5813ad
105.26,1.0,54,1,2,2,5,0xb2d2f9a8
50000.26,3.0,90,2,4,1,7,0xb2d57c3ed
3200283.64,2.0,108,4,3,1,8,0xb2d48078
202842.83,2.0,123,3,3,1,7,0xb2d93ee7
50294.07,4.0,52,2,4,2,8,0xb2d63354
2341.82,1.0,20,1,2,2,5,0xb2d2e096
416101.93,6.0,53,4,4,2,10,0xb2d0e628d
6405.1,1.0,0,2,2,4,8,0xb2d3ee93d
50001.26,3.0,11,2,4,3,9,0xb2d8e30f
500017.95,3.0,18,4,4,2,10,0xb2d92476
10376.06,2.0,184,2,3,1,6,0x3b9b33df
30001.8,2.0,5,2,3,3,8,0xb2d61561
22022.76,1.0,13,2,2,3,7,0xb2d6a9f6
27.1,1.0,41,1,2,2,5,0xb2d78a0f
4639.82,1.0,9,2,2,3,7,0xb2d358aa
40000.63,3.0,24,2,4,2,8,0xb2d947ded
1545.01,1.0,92,1,2,1,4,0xb2d4590fd
6151.2,1.0,8,2,2,3,7,0xb2d6d781
86.02,1.0,23,1,2,2,5,0xb2d9aba4
200006.33,2.0,74,3,3,1,7,0xb2d999f8
2014589.68,2.0,70,4,3,1,8,0xb2d5901f
2405.86,1.0,92,1,2,1,4,0xb2d6512a
1018.87,1.0,184,1,2,1,4,0xb2d3890b
235.63,1.0,14,1,2,3,6,0xb2d6fdb2
10247.93,2.0,0,2,3,4,9,0xb2d0686e
53741.58,1.0,0,3,2,4,9,0xb2d2f538
2745.71,1.0,0,1,2,4,7,0xb2d6ddf3
508265.74,3.0,19,4,4,2,10,0xb2d5b4d5
686520.47,3.0,210,4,4,1,9,0xb2d534fc
500133.9,3.0,157,4,4,1,9,0xb2d07721d
21538.07,1.0,50,2,2,2,6,0xb2d2073a
11.11,1.0,15,1,2,3,6,0xb2d3fa25d
260008.9,4.0,17,3,4,2,9,0xb2d22ca3
120001.27,2.0,95,3,3,1,7,0xb2d977f0
0.22,1.0,0,1,2,4,7,0xb2d420c4
2716.5,1.0,32,1,2,2,5,0xb2d5c8e9
330034.55,5.0,27,4,4,2,10,0xb2d3f5b3
79550.68,3.0,49,3,4,2,9,0x3b9b3c3bd
0.33,2.0,29,1,3,2,6,0xb2da05b2
8193.12,1.0,6,2,2,3,7,0xb2d18f5a
12301.35,1.0,15,2,2,3,7,0xb2d93a85
1417.24,1.0,92,1,2,1,4,0xb2d071e9d
37544.46,1.0,0,2,2,4,8,0xb2d43667
18.18,1.0,16,1,2,2,5,0xb2d6f8e0d
70000.74,2.0,94,3,3,1,7,0xb2d88ec3
2311.75,1.0,2,1,2,4,7,0xb2d6e5df
24430.51,1.0,19,2,2,2,6,0xb2d1f463
24603.2,1.0,10,2,2,3,7,0xb2d5d1a2d
2549664.05,3.0,164,4,4,1,9,0x3b9b26edd
13.17,1.0,2,1,2,4,7,0xb2d2cf8d
60008.22,2.0,80,3,3,1,7,0xb2d9384a
500021.06,3.0,16,4,4,2,10,0xb2d99a0b
2.27,1.0,37,1,2,2,5,0xb2d6e765
10.63,1.0,111,1,2,1,4,0xb2d5c976
358784.29,4.0,14,4,4,3,11,0xb2d0f69b
111307.96,15.0,8,3,4,3,10,0xb2d0ea13
1868.57,1.0,12,1,2,3,6,0xb2d28545
2296.05,1.0,184,1,2,1,4,0xb2d43be0
68.07,1.0,0,1,2,4,7,0xb2d8db8e
5.44,1.0,184,1,2,1,4,0xb2d2930f
40347.38,3.0,3,2,4,4,10,0xb2d45c22
53.66,1.0,35,1,2,2,5,0xb2d52268
722.69,1.0,0,1,2,4,7,0xb2d6c1bc
423731.55,3.0,17,4,4,2,10,0xb2d7c014
347886.77,9.0,1,4,4,4,12,0x3b9b2950
209620.27,2.0,1,3,3,4,10,0xb2d5d6b9
3003.97,1.0,14,2,2,3,7,0xb2d4f178
17894.64,1.0,42,2,2,2,6,0xb2d5786d
1885917.76,8.0,19,4,4,2,10,0xb2d5a562
601274.94,4.0,23,4,4,2,10,0xb2d60032d
4.75,1.0,42,1,2,2,5,0xb2d9de8e
2361.67,1.0,10,1,2,3,6,0xb2d92600
514223.8,2.0,129,4,3,1,8,0xb2d6d768
320816.56,4.0,33,4,4,2,10,0xb2d37c01
230793.07,4.0,6,3,4,3,10,0xb2d24eda
30227.27,1.0,92,2,2,1,5,0xb2d413c1
107729.18,1.0,0,3,2,4,9,0xb2d78bbc
3757.32,1.0,77,2,2,1,5,0xb2d37667
3997360.21,12.0,4,4,4,4,12,0xb2d0e108
1386.12,2.0,0,1,3,4,8,0x3b9b3e27
754534.88,6.0,3,4,4,4,12,0xb2d09748d
48.06,1.0,20,1,2,2,5,0xb2d691a2
4415.46,1.0,184,2,2,1,5,0xb2d16c3e
420230.52,3.0,105,4,4,1,9,0xb2d1afa2
43.41,1.0,39,1,2,2,5,0xb2d0f696
103331.53,1.0,7,3,2,3,8,0xb2d52af0
104839.99,1.0,19,3,2,2,7,0xb2d4f914d
50027.91,2.0,139,2,3,1,6,0xb2d622a2
300162.44,3.0,6,4,4,3,11,0xb2d23b33
20168.26,1.0,184,2,2,1,5,0xb2d22a67
5323.83,1.0,13,2,2,3,7,0xb2d48802
6799.41,1.0,0,2,2,4,8,0xb2d6c1e4
10.04,2.0,12,1,3,3,7,0xb2d8e187
409986.3,3.0,47,4,4,2,10,0xb2d6ef42
847062.22,4.0,1,4,4,4,12,0xb2d44f01
54864.27,3.0,92,3,4,1,8,0xb2d2eebfd
926713.38,12.0,7,4,4,3,11,0xb2d58675d
5043.04,3.0,92,2,4,1,7,0x3b9b35db
120220.74,2.0,70,3,3,1,7,0xb2d3e6efd
410093.59,4.0,1,4,4,4,12,0xb2d10c10
458024.41,3.0,15,4,4,3,11,0xb2d0a79f
2964.34,1.0,0,2,2,4,8,0xb2d5c58a
264156.9,4.0,4,3,4,4,11,0xb2d41144
650450.83,8.0,4,4,4,4,12,0xb2d5e942d
60546.73,2.0,19,3,3,2,8,0xb2d6288f
201183.16,2.0,9,3,3,3,9,0xb2d5d6b7
510065.82,5.0,10,4,4,3,11,0xb2d129dad
3853.98,1.0,2,2,2,4,8,0xb2d2dced
5691.23,1.0,4,2,2,4,8,0xb2d91f3e
50001.06,2.0,25,2,3,2,7,0xb2da10b2
612.63,1.0,0,1,2,4,7,0xb2d27783
4306.16,2.0,176,2,3,1,6,0xb2d27187
202241.53,2.0,42,3,3,2,8,0xb2d9106f
53.07,1.0,74,1,2,1,4,0xb2d2caca
33.62,1.0,14,1,2,3,6,0xb2d6a362
10276.0,4.0,50,2,4,2,8,0xb2d9a456
1216.49,1.0,0,1,2,4,7,0xb2d29c33
150016.93,2.0,210,3,3,1,7,0xb2d709d4
4763.74,5.0,92,2,4,1,7,0xb2d0af8c
407800.55,3.0,21,4,4,2,10,0xb2d22a91
239650.74,1.0,2,3,2,4,9,0xb2d4d888
1312216.41,13.0,0,4,4,4,12,0x3b9b3b11
7517.49,1.0,9,2,2,3,7,0xb2d22ed8
50.29,1.0,0,1,2,4,7,0xb2d11992
1100029.81,5.0,27,4,4,2,10,0xb2d1236b
99215.64,3.0,45,3,4,2,9,0xb2d255d8d
926938.94,3.0,47,4,4,2,10,0xb2d385ac
62486.97,1.0,1,3,2,4,9,0xb2d31309
10.93,1.0,12,1,2,3,6,0x3b9b4695
58.69,1.0,25,1,2,2,5,0xb2d64be4d
828541.81,7.0,0,4,4,4,12,0xb2d3679ed
40002.41,3.0,101,2,4,1,7,0xb2d5d54a
150317.2,2.0,0,3,3,4,10,0xb2d0edc9d
2691.43,1.0,4,1,2,4,7,0xb2d36c12
1865992.52,3.0,67,4,4,1,9,0xb2d216ad
124840.32,2.0,106,3,3,1,7,0xb2d4cefa
19000.4,2.0,256,2,3,1,6,0xb2d6c9de
995481.95,1.0,92,4,2,1,7,0xb2d2a0e9d
18.84,1.0,11,1,2,3,6,0xb2d90e74
446.57,1.0,1,1,2,4,7,0xb2d2bdce
3534.99,1.0,11,2,2,3,7,0xb2d1f580
201179.84,3.0,102,3,4,1,8,0xb2d563b5d
1888.02,1.0,145,1,2,1,4,0xb2d3962a
350000.0,3.0,5,4,4,3,11,0xb2d8f50c
2.11,1.0,55,1,2,2,5,0xb2d36f29
12.57,1.0,9,1,2,3,6,0xb2d6a9b6
520153.01,3.0,2,4,4,4,12,0xb2d62b12
13492.96,1.0,0,2,2,4,8,0xb2d6ed21d
60001.9,2.0,213,3,3,1,7,0xb2d683e8d
460033.96,2.0,0,4,3,4,11,0xb2d59b1e
1031.04,1.0,26,1,2,2,5,0xb2d97ff7
16.3,1.0,25,1,2,2,5,0xb2d26b8b
299994.91,6.0,0,3,4,4,11,0x3b9b46a9
6530.17,1.0,7,2,2,3,7,0xb2d6b640
18358.76,1.0,40,2,2,2,6,0xb2d589bd
351887.13,5.0,3,4,4,4,12,0x3b9b315a
1451.31,1.0,55,1,2,2,5,0xb2d30e54
1157.96,1.0,295,1,2,1,4,0xb2d2dbecd
21490.15,1.0,18,2,2,2,6,0xb2d58fc4
510035.42,8.0,0,4,4,4,12,0xb2d5e87d
522043.41,3.0,52,4,4,2,10,0xb2d204e2
831.79,1.0,10,1,2,3,6,0xb2d30d83d
101154.44,2.0,35,3,3,2,8,0xb2d90a49
43296.91,1.0,0,2,2,4,8,0xb2d51eec
184753.91,8.0,1,3,4,4,11,0xb2d57275d
9181.36,2.0,0,2,3,4,9,0xb2d4f810
87.14,1.0,21,1,2,2,5,0xb2d224e0
2270.34,1.0,0,1,2,4,7,0xb2d78758
127.6,2.0,16,1,3,2,6,0xb2d2e22b
9.36,1.0,28,1,2,2,5,0xb2d30da9d
1825.55,1.0,22,1,2,2,5,0xb2d654c4
11060011.61,3.0,18,4,4,2,10,0xb2d9303dd
1017055.48,7.0,0,4,4,4,12,0xb2d1a9bf
2006063.25,7.0,0,4,4,4,12,0xb2d3ea89
51019.73,2.0,136,2,3,1,6,0xb2d626a9
174988.0,2.0,38,3,3,2,8,0xb2d1035ed
500132.83,2.0,196,4,3,1,8,0xb2d26b74
2170.19,1.0,13,1,2,3,6,0xb2d8c35ed
390205.99,2.0,6,4,3,3,10,0xb2d0e700
133.55,1.0,5,1,2,3,6,0xb2d23796
502870.3,3.0,130,4,4,1,9,0xb2d4a938d
4.22,1.0,51,1,2,2,5,0xb2d2880a
1942001.18,6.0,2,4,4,4,12,0xb2d6de32
5768.17,1.0,223,2,2,1,5,0xb2d60d60
1134.9,1.0,16,1,2,2,5,0xb2d4f634
300723.24,3.0,39,4,4,2,10,0xb2d636fe
2365.55,1.0,119,1,2,1,4,0xb2d17d27
39991.06,1.0,10,2,2,3,7,0xb2d3c35c
1025.46,1.0,92,1,2,1,4,0xb2d1db12d
210023.85,2.0,8,3,3,3,9,0xb2d43f88
2517.9,1.0,3,1,2,4,7,0xb2d55413
6639.89,1.0,5,2,2,3,7,0xb2d6a158
858050.69,15.0,10,4,4,3,11,0xb2d11492
2341.34,1.0,0,1,2,4,7,0xb2d6be78
120003.59,2.0,129,3,3,1,7,0xb2d6eae1d
4.37,1.0,78,1,2,1,4,0xb2d141e9
298255.94,2.0,56,3,3,2,8,0xb2d419c9
32502.66,1.0,92,2,2,1,5,0xb2d3eee2
800054.08,2.0,231,4,3,1,8,0xb2d42ddd
103505.08,2.0,179,3,3,1,7,0xb2d4f6d2
3876.62,1.0,0,2,2,4,8,0xb2d94bba
20000.21,2.0,231,2,3,1,6,0xb2d6ef99
170828.08,1.0,0,3,2,4,9,0xb2d0bf54
2817.23,1.0,203,1,2,1,4,0xb2d3e4b7d
523010.18,10.0,0,4,4,4,12,0xb2d5b6fa
23179.76,1.0,164,2,2,1,5,0xb2d62e97d
6987.0,1.0,5,2,2,3,7,0xb2d9158a
60891.17,3.0,6,3,4,3,10,0xb2d6b548
300609.08,5.0,0,4,4,4,12,0x3b9b45da
736.78,1.0,8,1,2,3,6,0xb2d2073c
0.35,2.0,60,1,3,2,6,0xb2d3ad45
50562.91,2.0,41,2,3,2,7,0xb2d6e9e0
5253.78,1.0,0,2,2,4,8,0xb2d6c242
6196.43,1.0,128,2,2,1,5,0xb2d2478e
227477.87,2.0,136,3,3,1,7,0xb2d56c86
90526.51,1.0,47,3,2,2,7,0xb2d1757a
45032.04,2.0,9,2,3,3,8,0xb2d4cefe
170005.23,2.0,228,3,3,1,7,0xb2d61600
400797.47,3.0,2,4,4,4,12,0xb2d956e1
124518.81,2.0,73,3,3,1,7,0xb2d35bbe
98049.74,1.0,4,3,2,4,9,0xb2d1ee3fd
5581.1,1.0,1,2,2,4,8,0xb2d8fce9d
60403.58,3.0,161,3,4,1,8,0xb2d2b316
1598.19,1.0,9,1,2,3,6,0xb2d6d83d
112874.81,2.0,90,3,3,1,7,0xb2d15d2b
200000.0,2.0,7,3,3,3,9,0xb2d96eb1
364052.03,2.0,0,4,3,4,11,0xb2d571ee
177.66,1.0,10,1,2,3,6,0xb2d6a850
11.38,1.0,7,1,2,3,6,0xb2d3b201
183291.94,3.0,5,3,4,3,10,0xb2d576a7
2100.99,1.0,15,1,2,3,6,0xb2d93625
80046.59,2.0,136,3,3,1,7,0xb2d61b25
1554.13,1.0,184,1,2,1,4,0xb2d5720b
6007.81,1.0,3,2,2,4,8,0xb2d33c8c
861.37,1.0,10,1,2,3,6,0xb2d65e80
0.0,1.0,0,1,2,4,7,0xb2d2be9cd
4976.8,1.0,11,2,2,3,7,0xb2d43426
504355.49,3.0,19,4,4,2,10,0xb2d176d1
1324.02,1.0,10,1,2,3,6,0xb2d5a5bed
560000.14,4.0,0,4,4,4,12,0xb2d9c08f
72.32,1.0,12,1,2,3,6,0xb2d33216
335617.83,5.0,20,4,4,2,10,0x3b9af25e
41038.27,5.0,3,2,4,4,10,0xb2d384af
301390.49,2.0,9,4,3,3,10,0xb2d687cf
330009.38,5.0,11,4,4,3,11,0xb2d68298
164.34,1.0,27,1,2,2,5,0xb2d6f6c5
386.8,1.0,10,1,2,3,6,0xb2d9576b
151275.56,1.0,0,3,2,4,9,0xb2d57ae7
66.39,1.0,13,1,2,3,6,0xb2d0e264
260022.02,1.0,12,3,2,3,8,0xb2d5afc3
80018.71,2.0,93,3,3,1,7,0xb2d13d95
132.41,1.0,26,1,2,2,5,0xb2d96208
29300.0,2.0,62,2,3,2,7,0xb2d9bd1b
303090.66,10.0,18,4,4,2,10,0xb2d5fb9c
33706.04,1.0,4,2,2,4,8,0xb2d2b5e3
70030.87,1.0,5,3,2,3,8,0xb2d8ddab
1739.52,1.0,92,1,2,1,4,0xb2d60c54
28.44,1.0,20,1,2,2,5,0xb2d57aab
13820.74,1.0,4,2,2,4,8,0xb2d9466b
37.48,1.0,67,1,2,1,4,0xb2d21bba
1561.38,1.0,3,1,2,4,7,0xb2d2b79f
1574.29,1.0,0,1,2,4,7,0xb2d35781d
65.1,1.0,104,1,2,1,4,0xb2d58094d
100782.92,3.0,0,3,4,4,11,0x3b9b1807d
4738.6,1.0,14,2,2,3,7,0xb2d3bbf8d
100026.95,2.0,193,3,3,1,7,0xb2d500cf
593023.59,9.0,20,4,4,2,10,0xb2d4f8f0d
9.79,1.0,18,1,2,2,5,0xb2d482c3
757010.87,9.0,12,4,4,3,11,0xb2d63eb3d
474794.78,2.0,57,4,3,2,9,0xb2d29b4b
497371.59,2.0,18,4,3,2,9,0xb2d15a11
754372.1,3.0,0,4,4,4,12,0xb2d5c19cd
902684.25,8.0,8,4,4,3,11,0xb2d1eba0
1504.41,1.0,62,1,2,2,5,0xb2d6c67f
405358.86,18.0,0,4,4,4,12,0xb2d638cf
251065.62,4.0,70,3,4,1,8,0xb2d507e0
4.58,1.0,55,1,2,2,5,0xb2d6be9e
6900.04,1.0,169,2,2,1,5,0xb2d430ded
274949.06,3.0,4,3,4,4,11,0xb2d43d9f
598.54,1.0,7,1,2,3,6,0xb2d5588b
74.48,1.0,4,1,2,4,7,0xb2d3b49d
8679.75,1.0,0,2,2,4,8,0xb2d5f6a0
153.42,1.0,110,1,2,1,4,0xb2d58208
10000.11,2.0,28,2,3,2,7,0xb2da003f
600001.3,3.0,28,4,4,2,10,0xb2d6b3d2
164.21,2.0,34,1,3,2,6,0xb2d23811
34.36,1.0,11,1,2,3,6,0xb2d0ac0a
51796.12,1.0,168,2,2,1,5,0xb2d2d6ac
3526604.82,17.0,1,4,4,4,12,0xb2d1adb0
8362.48,2.0,54,2,3,2,7,0xb2d0d29d
76114.59,5.0,12,3,4,3,10,0xb2d40e5e
435291.69,3.0,13,4,4,3,11,0xb2d0f828
4828.32,1.0,2,2,2,4,8,0xb2d1fd8e
613976.38,5.0,0,4,4,4,12,0xb2d65638
15979.34,9.0,0,2,4,4,10,0x3b9b2345
581974.83,6.0,3,4,4,4,12,0xb2d5ac00
225.42,1.0,14,1,2,3,6,0xb2d52ae3
15212.78,1.0,4,2,2,4,8,0xb2d1f76f
1014.04,1.0,92,1,2,1,4,0xb2d1571e
1151.15,1.0,92,1,2,1,4,0x3b9b3c56d
262318.59,3.0,63,3,4,2,9,0xb2d11b80
505342.05,2.0,111,4,3,1,8,0xb2d60ce8
9514.08,1.0,10,2,2,3,7,0xb2d8264d
46013.57,2.0,70,2,3,1,6,0xb2d5f10a
28.46,1.0,11,1,2,3,6,0xb2d964b8
80004.91,2.0,90,3,3,1,7,0xb2d554bb
336198.65,2.0,142,4,3,1,8,0xb2d290bfd
10064.99,2.0,17,2,3,2,7,0xb2d3a8c9
70004.8,4.0,11,3,4,3,10,0xb2d326dd
20681.7,1.0,3,2,2,4,8,0xb2d8e9fb
493.52,1.0,7,1,2,3,6,0xb2d3202a
30001.58,2.0,165,2,3,1,6,0xb2d63cc7
10003.41,2.0,18,2,3,2,7,0xb2d93440d
8.87,1.0,54,1,2,2,5,0xb2d176ad
1810.08,1.0,0,1,2,4,7,0xb2d47d68d
106120.34,2.0,47,3,3,2,8,0xb2d6b126d
550000.0,5.0,5,4,4,3,11,0xb2d6d31bd
7581.98,3.0,92,2,4,1,7,0x3b9ade70
69766.97,4.0,0,3,4,4,11,0xb2d07727
223447.19,6.0,1,3,4,4,11,0xb2d11815
986.47,2.0,9,1,3,3,7,0x3b9b29c9
405113.52,3.0,90,4,4,1,9,0xb2d42aff
101093.54,2.0,48,3,3,2,8,0xb2d6d960
32032.69,1.0,6,2,2,3,7,0xb2d16c6dd
613967.39,3.0,53,4,4,2,10,0xb2d60bfa
600045.89,3.0,11,4,4,3,11,0xb2d68ab1
371036.15,3.0,20,4,4,2,10,0xb2d108d0d
110431.28,2.0,45,3,3,2,8,0xb2d6c987d
12849.43,1.0,18,2,2,2,6,0xb2d6d9f3
353642.06,1.0,0,4,2,4,10,0xb2d26df0
2168941.68,2.0,67,4,3,1,8,0xb2d3c504
6.75,1.0,76,1,2,1,4,0xb2d8d5b8
8863.13,1.0,14,2,2,3,7,0xb2d8d049
43372.14,1.0,0,2,2,4,8,0xb2d320fd
140005.92,3.0,105,3,4,1,8,0xb2d95877
17940.58,1.0,92,2,2,1,5,0xb2d34466
215.81,1.0,17,1,2,2,5,0xb2d9a846
600074.32,4.0,83,4,4,1,9,0x3b9b375a
565338.91,8.0,21,4,4,2,10,0xb2d19b94
18776.88,1.0,0,2,2,4,8,0xb2d32ed1
231000.9,3.0,0,3,4,4,11,0xb2d60fb2
50960.45,1.0,92,2,2,1,5,0xb2d518f3
50006.77,2.0,74,2,3,1,6,0xb2d50e73
91071.44,1.0,46,3,2,2,7,0xb2d6cfc0
258761.69,3.0,3,3,4,4,11,0xb2d2471a
480507.0,3.0,4,4,4,4,12,0xb2d5d5e0
15602.23,1.0,8,2,2,3,7,0xb2d69a98
556013.44,1.0,1,4,2,4,10,0xb2d8cd5c
1507.53,1.0,10,1,2,3,6,0xb2d9037f
11106.94,1.0,15,2,2,3,7,0xb2d8fc6e
17328.47,1.0,21,2,2,2,6,0xb2d9679d
1307008.07,5.0,6,4,4,3,11,0xb2d123b1
56536.37,2.0,24,3,3,2,8,0xb2d6f4d6
500047.67,4.0,70,4,4,1,9,0xb2d8f6ec
1132531.81,8.0,4,4,4,4,12,0xb2d0b68f
430045.82,4.0,97,4,4,1,9,0xb2d23da3
189003.46,5.0,49,3,4,2,9,0xb2d62532d
36689.6,1.0,1,2,2,4,8,0xb2d7c6d7
54816.0,1.0,2,3,2,4,9,0xb2d2e466d
1571362.95,16.0,7,4,4,3,11,0xb2d5b46cd
57413.71,4.0,21,3,4,2,9,0xb2d36ec1
52910.82,7.0,0,3,4,4,11,0x3b9b28e5d
3824.09,1.0,92,2,2,1,5,0xb2d392c7
764658.8,7.0,95,4,4,1,9,0xb2d5e37d
5526.65,1.0,92,2,2,1,5,0xb2d425f8
939.04,2.0,35,1,3,2,6,0xb2d4587f
9613.02,1.0,6,2,2,3,7,0xb2d94296
12888.56,1.0,20,2,2,2,6,0xb2d77f5d
20004.82,3.0,6,2,4,3,9,0xb2d77fc8
159151.54,1.0,14,3,2,3,8,0xb2d5de66
700721.12,3.0,4,4,4,4,12,0xb2d8ecb3
56448.74,5.0,83,3,4,1,8,0xb2d5dde4
54123.14,2.0,3,3,3,4,10,0xb2d5da54
1670.01,2.0,20,1,3,2,6,0xb2d41d1cd
120000.69,3.0,0,3,4,4,11,0xb2d24da8
132052.27,3.0,6,3,4,3,10,0xb2d41086
13.65,4.0,10,1,4,3,8,0x3b9b45a1
591877.03,2.0,90,4,3,1,8,0xb2d0b81a
10.8,1.0,11,1,2,3,6,0xb2d6be2b
387.92,1.0,29,1,2,2,5,0xb2da0779
602923.33,3.0,206,4,4,1,9,0xb2d1b243
1673.94,4.0,0,1,4,4,9,0x3b9b48d0d
256010.17,4.0,172,3,4,1,8,0xb2d14760
3190.49,2.0,1,2,3,4,9,0x3b9b27dd
394058.88,14.0,0,4,4,4,12,0x3b9af153
215885.17,4.0,2,3,4,4,11,0xb2d6877bd
3743.87,1.0,6,2,2,3,7,0xb2d43333
870004.21,5.0,4,4,4,4,12,0xb2d443cd
127795.46,2.0,157,3,3,1,7,0xb2d31166
280186.7,2.0,18,3,3,2,8,0xb2d5675e
1000017.22,2.0,23,4,3,2,9,0xb2d6bbde
97.06,1.0,1,1,2,4,7,0xb2d342b2
220001.79,2.0,0,3,3,4,10,0xb2d9e327
100440.51,7.0,32,3,4,2,9,0xb2d3547c
2064.41,1.0,184,1,2,1,4,0xb2d2c58e
0.53,1.0,6,1,2,3,6,0xb2d6c9d2
186.37,1.0,4,1,2,4,7,0xb2d4f6a7
0.0,1.0,62,1,2,2,5,0xb2d6b51a
367488.86,8.0,0,4,4,4,12,0xb2d626e7
10585.58,1.0,184,2,2,1,5,0xb2d59f47d
103510.25,2.0,25,3,3,2,8,0xb2d69089
200074.62,2.0,1,3,3,4,10,0xb2d64753
500009.45,3.0,21,4,4,2,10,0xb2d0b914
1405.16,1.0,92,1,2,1,4,0xb2d28a9c
460031.73,3.0,13,4,4,3,11,0xb2d57616
150009.44,3.0,129,3,4,1,8,0xb2d2e9f7
200068.05,2.0,93,3,3,1,7,0xb2d7f4b6
170206.24,4.0,0,3,4,4,11,0xb2d1b43b
485000.0,24.0,0,4,4,4,12,0x3b9b2607
285054.7,4.0,0,3,4,4,11,0xb2d694d8d
152815.34,2.0,143,3,3,1,7,0xb2d5fc18
10236.28,1.0,10,2,2,3,7,0xb2d27c4b
143749.87,66.0,0,3,4,4,11,0x3b9b1864
830008.02,3.0,23,4,4,2,10,0xb2d9cb1a
100027.34,6.0,20,3,4,2,9,0xb2d5806e
16145.58,1.0,10,2,2,3,7,0xb2d717b9
455444.25,1.0,92,4,2,1,7,0xb2d2a1ad
502129.98,4.0,9,4,4,3,11,0xb2d55150d
200031.34,2.0,20,3,3,2,8,0xb2d95064
1090061.17,4.0,235,4,4,1,9,0xb2d3b303
400040.83,4.0,3,4,4,4,12,0xb2d1c86bd
200015.83,2.0,70,3,3,1,7,0xb2d5ee7ed
236547.36,3.0,94,3,4,1,8,0xb2d5aca8
4440000.0,2.0,3,4,3,4,11,0xb2d95e83
250083.41,3.0,34,3,4,2,9,0xb2d17d83
1101088.93,5.0,5,4,4,3,11,0xb2d2193a
2811.51,1.0,184,1,2,1,4,0xb2d21ff8d
10617.09,1.0,0,2,2,4,8,0xb2d204f3
2000.59,1.0,0,1,2,4,7,0xb2d3c65ed
1786.13,1.0,73,1,2,1,4,0xb2d8d365
335001.85,3.0,18,4,4,2,10,0xb2d5d3fb
1791.74,1.0,184,1,2,1,4,0xb2d0d68b
112470.66,3.0,27,3,4,2,9,0xb2d5295a
435792.82,4.0,0,4,4,4,12,0xb2d48f8d
2.87,1.0,57,1,2,2,5,0xb2d60aabd
8007.49,1.0,77,2,2,1,5,0xb2d319ab
770007.79,4.0,4,4,4,4,12,0xb2d931d8
38748.95,1.0,0,2,2,4,8,0xb2d43a32
10273.29,1.0,10,2,2,3,7,0xb2d2d451d
1274413.65,8.0,0,4,4,4,12,0xb2d1b3f5
1810.36,2.0,5,1,3,3,7,0xb2d1c44a
18.02,7.0,15,1,4,3,8,0xb2d17193
160007.7,2.0,62,3,3,2,8,0xb2d261fa
1871.36,1.0,34,1,2,2,5,0xb2d9e83e
1248374.3,3.0,104,4,4,1,9,0xb2d1192f
230006.0,6.0,1,3,4,4,11,0xb2d48ff2
32835.45,1.0,131,2,2,1,5,0xb2d6d2a8
584.67,1.0,1,1,2,4,7,0xb2d68ee3
14166.99,1.0,6,2,2,3,7,0xb2d9694c
704.75,1.0,157,1,2,1,4,0xb2d4f120
8014.38,1.0,14,2,2,3,7,0xb2d319b8
0.0,1.0,10,1,2,3,6,0xb2d68fdb
2182.28,1.0,92,1,2,1,4,0xb2d3a14a
37.19,2.0,78,1,3,1,5,0xb2d39ad1
705010.8,4.0,0,4,4,4,12,0xb2d58dd9
1096813.42,9.0,14,4,4,3,11,0xb2d5e09dd
523000.98,13.0,1,4,4,4,12,0xb2d5f6bd
78.62,1.0,20,1,2,2,5,0xb2d5d232
36492.75,2.0,47,2,3,2,7,0xb2d583bc
200002.0,2.0,14,3,3,3,9,0xb2d954ead
281001.46,2.0,30,3,3,2,8,0xb2d94154
500052.71,2.0,12,4,3,3,10,0xb2d9a0db
20000000.0,5.0,1,4,4,4,12,0xb2d33252
50130.82,3.0,39,2,4,2,8,0xb2d7819e
103633.74,1.0,11,3,2,3,8,0xb2d613f4d
158.01,1.0,5,1,2,3,6,0xb2d2c287
351314.61,3.0,10,4,4,3,11,0xb2d105f6
565.76,1.0,22,1,2,2,5,0xb2d24b3e
10104.98,2.0,92,2,3,1,6,0xb2d18082
118.45,1.0,5,1,2,3,6,0xb2d4a3f2
25351.28,1.0,22,2,2,2,6,0xb2d43237d
35.44,1.0,6,1,2,3,6,0xb2d56ca1
130064.09,2.0,67,3,3,1,7,0xb2d4dbd6
311827.76,4.0,75,4,4,1,9,0xb2d45f57
450500.01,2.0,4,4,3,4,11,0xb2d9678c
90003.8,2.0,21,3,3,2,8,0xb2da1ae2
7282.04,1.0,0,2,2,4,8,0xb2d4da22
4800.69,1.0,22,2,2,2,6,0xb2d622aa
48321.64,1.0,8,2,2,3,7,0xb2d60a88
50354.17,1.0,95,2,2,1,5,0xb2d11136
220026.62,2.0,124,3,3,1,7,0xb2d52677d
4994.49,3.0,92,2,4,1,7,0xb2d5a11a
432312.59,3.0,125,4,4,1,9,0xb2d3b07d
23.35,1.0,19,1,2,2,5,0xb2d2c6f4
176389.73,2.0,217,3,3,1,7,0xb2d69f20
100001.06,2.0,59,3,3,2,8,0xb2d90009
57.5,1.0,47,1,2,2,5,0xb2d78433
1007106.53,3.0,58,4,4,2,10,0xb2d2406fd
100296.39,2.0,34,3,3,2,8,0xb2d65974
100005.28,3.0,40,3,4,2,9,0xb2d26aa0
747.59,1.0,15,1,2,3,6,0xb2d6803d
740084.22,2.0,66,4,3,2,9,0xb2d5b819
7266.0,1.0,138,2,2,1,5,0xb2d778a2
316.28,1.0,25,1,2,2,5,0xb2d21856
271.72,2.0,6,1,3,3,7,0xb2d27710
214780.1,4.0,53,3,4,2,9,0xb2d295af
236515.74,12.0,0,3,4,4,11,0x3b9b0e1d
930080.91,4.0,111,4,4,1,9,0x3b9b4075
18.01,4.0,11,1,4,3,8,0xb2d4fd07
20009.18,1.0,3,2,2,4,8,0xb2d14b7b
1105135.07,6.0,31,4,4,2,10,0xb2d520df
417.12,1.0,38,1,2,2,5,0xb2d77fcc
1020460.65,9.0,28,4,4,2,10,0xb2d0f8ab
400715.15,3.0,7,4,4,3,11,0xb2d92b19d
25361.42,3.0,0,2,4,4,10,0xb2d2da70
37.94,1.0,0,1,2,4,7,0xb2d6e7ad
405689.35,7.0,3,4,4,4,12,0xb2d30290
1881.21,1.0,92,1,2,1,4,0xb2d32ae9
280420.73,4.0,6,3,4,3,10,0xb2d64708
99732.63,1.0,141,3,2,1,6,0xb2d391f6
523880.04,2.0,16,4,3,2,9,0xb2d64725
335121.76,2.0,12,4,3,3,10,0xb2d2ebfa
994.14,1.0,8,1,2,3,6,0xb2d10c1a
300.77,1.0,53,1,2,2,5,0xb2d2efdc
132.3,1.0,82,1,2,1,4,0xb2d61369
925.84,1.0,19,1,2,2,5,0xb2d3a6ebd
33000.96,2.0,3,2,3,4,9,0xb2d2613d
692.71,3.0,0,1,4,4,9,0xb2d07fd3
4142.31,1.0,84,2,2,1,5,0xb2d6f5eb
1027.18,1.0,95,1,2,1,4,0xb2d78558
51047.25,2.0,129,2,3,1,6,0xb2d6262d
5.42,1.0,39,1,2,2,5,0xb2d41c3bd
240000.73,8.0,0,3,4,4,11,0xb2d36fd6
1443.97,1.0,90,1,2,1,4,0xb2d57373
210892.6,3.0,25,3,4,2,9,0xb2d42435
23212.44,2.0,9,2,3,3,8,0x3b9acff4
9932.18,1.0,11,2,2,3,7,0xb2d08e0e
168.91,1.0,89,1,2,1,4,0xb2d3f63e
2787.3,1.0,0,1,2,4,7,0xb2d42772
222.62,1.0,0,1,2,4,7,0xb2d299b2
2.49,1.0,60,1,2,2,5,0xb2d6e710
160001.34,1.0,1,3,2,4,9,0xb2d96177
830662.81,6.0,5,4,4,3,11,0xb2d3bd92
103253.94,2.0,47,3,3,2,8,0xb2d9bdff
9.64,1.0,65,1,2,2,5,0xb2d6cc2f
1399.29,2.0,92,1,3,1,5,0xb2d07199
492.59,2.0,5,1,3,3,7,0xb2d923f5
2033.99,1.0,19,1,2,2,5,0xb2d29b5d
606109.04,4.0,18,4,4,2,10,0xb2d60a67
3.88,1.0,77,1,2,1,4,0xb2d59764d
350143.79,2.0,8,4,3,3,10,0xb2d1fe42
35675.49,2.0,0,2,3,4,9,0xb2d5066f
50006.56,4.0,53,2,4,2,8,0xb2d1005ad
60001.9,2.0,10,3,3,3,9,0xb2d96134
102.81,1.0,67,1,2,1,4,0xb2d8cfc8
1003790.12,2.0,0,4,3,4,11,0xb2d2b882
615015.33,9.0,0,4,4,4,12,0xb2d5e081
23.54,1.0,42,1,2,2,5,0xb2d94fe9
160000.0,2.0,3,3,3,4,10,0xb2d97353d
5038.81,1.0,7,2,2,3,7,0xb2d3195b
50002.95,6.0,8,2,4,3,9,0xb2d9183d
240167.53,5.0,0,3,4,4,11,0xb2d4ba82
23.86,1.0,93,1,2,1,4,0xb2d784fc
1313392.35,5.0,184,4,4,1,9,0x3b9b33b3d
210470.18,2.0,245,3,3,1,7,0xb2d2ae31
312280.6,3.0,6,4,4,3,11,0xb2d19618
280004.16,4.0,0,3,4,4,11,0xb2d63b8c
3.15,1.0,10,1,2,3,6,0xb2d9759c
11667.56,1.0,2,2,2,4,8,0xb2d333aa
242796.89,2.0,0,3,3,4,10,0xb2d58c42
20043.22,1.0,98,2,2,1,5,0xb2d62f36
10032.75,1.0,92,2,2,1,5,0xb2d547fe
550000.0,6.0,7,4,4,3,11,0xb2d1af0b
6019.07,1.0,210,2,2,1,5,0xb2d5c89ed
1439263.66,7.0,10,4,4,3,11,0xb2d3cf71
30000.32,2.0,98,2,3,1,6,0xb2d96ec6
424264.15,3.0,5,4,4,3,11,0xb2d87943
475.43,4.0,0,1,4,4,9,0x3b9af477
3947.03,1.0,92,2,2,1,5,0xb2d21125d
20000.66,2.0,25,2,3,2,7,0xb2da1098
888.06,1.0,0,1,2,4,7,0xb2d48d9d
6111.53,1.0,9,2,2,3,7,0xb2d36a5e
54823.67,2.0,76,3,3,1,7,0xb2d0bfb0
61045.21,2.0,57,3,3,2,8,0xb2d62e19d
4147.29,1.0,14,2,2,3,7,0xb2d8caad
449500.0,4.0,0,4,4,4,12,0x3b9b29e3
271239.23,3.0,214,3,4,1,8,0xb2d08cd1d
13405.27,1.0,76,2,2,1,5,0xb2d5d0d1d
160338.11,3.0,90,3,4,1,8,0xb2d40bb3
2000074.34,2.0,102,4,3,1,8,0xb2d429f2d
253047.28,3.0,6,3,4,3,10,0xb2d5a5c4
4354249.17,4.0,1,4,4,4,12,0xb2d3a5f3
10001.48,2.0,13,2,3,3,8,0xb2d62196
650037.02,2.0,0,4,3,4,11,0xb2d5aacb
1203640.98,8.0,0,4,4,4,12,0xb2d1eba0d
10154.79,2.0,143,2,3,1,6,0xb2d6e8bdd
30088.6,2.0,8,2,3,3,8,0xb2d18bc2
40001.26,2.0,192,2,3,1,6,0xb2d6a12ad
480204.09,2.0,63,4,3,2,9,0xb2d5675ed
352518.96,5.0,97,4,4,1,9,0xb2d0e45f
103646.84,2.0,165,3,3,1,7,0xb2d58477
68022.99,3.0,17,3,4,2,9,0xb2d60d1f
304425.52,4.0,62,4,4,2,10,0xb2d99bf5
80069.85,4.0,12,3,4,3,10,0xb2d06f50
7473.03,1.0,184,2,2,1,5,0xb2d407be
2132.15,1.0,184,1,2,1,4,0xb2d0e8df
205000.0,2.0,18,3,3,2,8,0xb2da32e2
9011.71,1.0,7,2,2,3,7,0xb2d6b72a
140053.2,1.0,0,3,2,4,9,0xb2d0fe4a
3566.57,1.0,14,2,2,3,7,0x3b9b32f2
1690.52,1.0,0,1,2,4,7,0xb2d342e7
234559.98,4.0,0,3,4,4,11,0xb2d50f16
105526.66,4.0,0,3,4,4,11,0xb2d33140
300009.5,2.0,87,3,3,1,7,0xb2d8c609
3.62,1.0,25,1,2,2,5,0xb2d2506c
291923.23,6.0,21,3,4,2,9,0xb2d196e6
508879.38,4.0,14,4,4,3,11,0xb2d31796d
390000.31,2.0,6,4,3,3,10,0xb2d9f6fe
1044.62,1.0,3,1,2,4,7,0xb2d27947
276134.43,5.0,112,3,4,1,8,0xb2d6656c
1738.51,1.0,184,1,2,1,4,0xb2d0dec2
402014.54,5.0,11,4,4,3,11,0xb2d9e7f3
142025.19,2.0,92,3,3,1,7,0xb2d208bc
570188.45,3.0,16,4,4,2,10,0xb2d0d035
410001.93,4.0,11,4,4,3,11,0xb2d67390
1.65,1.0,20,1,2,2,5,0xb2d37bfc
50001.06,2.0,46,2,3,2,7,0xb2d9dfba
17512.83,1.0,184,2,2,1,5,0xb2d2c3cf
6440.53,1.0,15,2,2,3,7,0xb2d9b300
800033.61,4.0,0,4,4,4,12,0xb2d9a162
200210.44,2.0,14,3,3,3,9,0xb2d9e52b
600000.0,3.0,9,4,4,3,11,0xb2d2e71a
40285.46,1.0,92,2,2,1,5,0xb2d39c59
50000.0,2.0,3,2,3,4,9,0xb2d97804
60101.23,2.0,139,3,3,1,7,0xb2d2490cd
321020.37,2.0,235,4,3,1,8,0xb2d34efc
50530.62,2.0,171,2,3,1,6,0xb2d5e43d
3700000.0,2.0,0,4,3,4,11,0xb2d959f8
483000.0,2.0,1,4,3,4,11,0xb2d97e66d
10000.21,2.0,73,2,3,1,6,0xb2d8e2e6
15541.09,1.0,0,2,2,4,8,0xb2d93dc2
100004.11,4.0,139,3,4,1,8,0xb2d6e11d
416159.79,3.0,87,4,4,1,9,0xb2d0a59c
434.99,1.0,16,1,2,2,5,0xb2d6eb35
280633.72,3.0,59,3,4,2,9,0xb2d29490
381549.1,5.0,4,4,4,4,12,0xb2d0ee5e
94310.94,2.0,98,3,3,1,7,0xb2d61036
114.4,1.0,8,1,2,3,6,0xb2d3e77a
1567.58,1.0,184,1,2,1,4,0xb2d27b05
100389.1,3.0,87,3,4,1,8,0xb2d58201
289964.56,2.0,184,3,3,1,7,0xb2d65712
477223.91,1.0,0,4,2,4,10,0xb2d51930
864.67,1.0,18,1,2,2,5,0xb2d37fe9
2552.61,1.0,184,1,2,1,4,0xb2d30ee7
27788.42,2.0,11,2,3,3,8,0xb2d19a45
605037.77,6.0,0,4,4,4,12,0xb2d4684ad
11453.67,1.0,11,2,2,3,7,0xb2d95b16
10190.36,2.0,208,2,3,1,6,0xb2d63103d
10348.22,1.0,74,2,2,1,5,0xb2d5e905
118126.45,6.0,28,3,4,2,9,0xb2d62d88
481956.52,10.0,0,4,4,4,12,0x3b9b1b78
62471.85,1.0,92,3,2,1,6,0xb2d269e6d
439.77,1.0,9,1,2,3,6,0xb2d5f9de
11821.39,1.0,184,2,2,1,5,0xb2d080c0
4.87,1.0,10,1,2,3,6,0xb2d9dbc9
1363224.46,6.0,0,4,4,4,12,0xb2d50d21
800023.22,4.0,6,4,4,3,11,0xb2d9c038
306595.5,7.0,42,4,4,2,10,0x3b9b31c4
6602.74,1.0,4,2,2,4,8,0xb2d5d2d6
280680.62,22.0,42,3,4,2,9,0xb2d0ff41
15000459.84,2.0,92,4,3,1,8,0xb2d550d1d
32.48,1.0,7,1,2,3,6,0xb2d39a72
1514.94,1.0,0,1,2,4,7,0xb2d559a8
329103.9,2.0,75,4,3,1,8,0xb2d6cc14d
207826.54,2.0,124,3,3,1,7,0xb2d651ec
26000.0,1.0,0,2,2,4,8,0xb2d65899d
334011.49,3.0,11,4,4,3,11,0xb2d3c3b2
26.81,1.0,12,1,2,3,6,0xb2d2e31e
1517.16,1.0,1,1,2,4,7,0xb2d6b0a8
119105.02,1.0,92,3,2,1,6,0xb2d2729d
210490.44,2.0,6,3,3,3,9,0xb2d6039dd
1156312.81,5.0,10,4,4,3,11,0xb2d417f2
31116.23,1.0,1,2,2,4,8,0xb2d641f7
130159.95,2.0,14,3,3,3,9,0xb2d12200
28692.14,1.0,2,2,2,4,8,0xb2d62cf2
42765.78,7.0,0,2,4,4,10,0xb2d06274
210278.23,2.0,119,3,3,1,7,0xb2d69847
67.6,1.0,13,1,2,3,6,0xb2d17f98
206073.53,2.0,260,3,3,1,7,0xb2d6c028
62732.19,1.0,184,3,2,1,6,0xb2d22307
27372.02,2.0,3,2,3,4,9,0xb2d78a64
413092.05,4.0,141,4,4,1,9,0xb2d1212b
59095.63,3.0,137,3,4,1,8,0xb2d14036
74066.74,2.0,132,3,3,1,7,0xb2d351e7
6.36,1.0,9,1,2,3,6,0xb2d6fd8dd
2212.27,1.0,0,1,2,4,7,0xb2d8eb99
1600016.89,2.0,32,4,3,2,9,0xb2da00d6
125026.48,2.0,92,3,3,1,7,0x3b9b31e9
6306.72,1.0,92,2,2,1,5,0x3b9acf08
2900.6,1.0,0,2,2,4,8,0xb2d6902a
6592.35,1.0,15,2,2,3,7,0xb2da05c0
9.57,1.0,9,1,2,3,6,0xb2d893c8
38003.96,3.0,42,2,4,2,8,0xb2d5d976d
1111893.49,3.0,16,4,4,2,10,0xb2d5f931
380008.02,3.0,13,4,4,3,11,0xb2d7bd9b
9149.2,1.0,25,2,2,2,6,0xb2d28648
2000021.11,2.0,55,4,3,2,9,0xb2d90393
2.33,1.0,15,1,2,3,6,0xb2d2fa6ed
259.11,1.0,41,1,2,2,5,0xb2d918b3
2994.36,1.0,3,2,2,4,8,0xb2d4f53f
2836.89,1.0,92,1,2,1,4,0xb2d3515a
147.0,5.0,84,1,4,1,6,0xb2d0d906
440069.16,4.0,87,4,4,1,9,0xb2d0f995
1922.0,2.0,31,1,3,2,6,0xb2d6da9f
4529.69,1.0,0,2,2,4,8,0xb2d763ae
20108.77,3.0,5,2,4,3,9,0xb2d5f398
1.38,1.0,20,1,2,2,5,0xb2d391e2
3287.17,1.0,184,2,2,1,5,0xb2d20339d
51655.54,1.0,9,2,2,3,7,0xb2d4339e
188.93,1.0,3,1,2,4,7,0xb2d22fafd
1442.62,1.0,92,1,2,1,4,0xb2d1ff10
2925.51,1.0,9,2,2,3,7,0xb2d33a26
762119.19,2.0,221,4,3,1,8,0xb2d63730d
30168.63,2.0,20,2,3,2,7,0xb2d64d22d
10093.5,1.0,92,2,2,1,5,0xb2d200c7
6619.97,1.0,7,2,2,3,7,0xb2d906ce
5007.5,1.0,152,2,2,1,5,0xb2d85768
126559.74,6.0,18,3,4,2,9,0xb2d585c8
0.0,2.0,8,1,3,3,7,0xb2da465d
877.85,1.0,0,1,2,4,7,0xb2d392a4
393037.31,2.0,1,4,3,4,11,0xb2d5c55c
260063.84,2.0,4,3,3,4,10,0xb2d61b3d
190013.64,5.0,11,3,4,3,10,0xb2d23ba0
133077.35,4.0,0,3,4,4,11,0xb2d687fed
971501.16,5.0,11,4,4,3,11,0xb2d1f6dfd
689.03,1.0,17,1,2,2,5,0xb2d330d2
24386.62,2.0,47,2,3,2,7,0xb2d56c56
152744.52,4.0,35,3,4,2,9,0xb2d58fddd
290064.69,2.0,80,3,3,1,7,0xb2d5a561
503456.48,7.0,8,4,4,3,11,0xb2d59567d
320196.01,2.0,6,4,3,3,10,0xb2d49d89d
201006.02,8.0,10,3,4,3,10,0xb2d4a5b0
30564.04,2.0,92,2,3,1,6,0xb2d5c33f
15469.27,1.0,29,2,2,2,6,0xb2d98d67
1000018.7,5.0,8,4,4,3,11,0xb2d5b9d5
290055.81,6.0,67,3,4,1,8,0xb2d0b111d
200105.01,2.0,18,3,3,2,8,0xb2d6596a
2098000.93,16.0,0,4,4,4,12,0xb2d198aa
506000.0,16.0,1,4,4,4,12,0xb2d0cd40
122023.09,3.0,104,3,4,1,8,0xb2d33ca3
340000.0,6.0,0,4,4,4,12,0xb2d0b471
185769.88,2.0,208,3,3,1,7,0xb2d1a4ae
61245.16,1.0,5,3,2,3,8,0xb2d6bd04
101910.34,1.0,0,3,2,4,9,0xb2d3942d
501.3,1.0,21,1,2,2,5,0xb2d4f021
2673.81,1.0,10,1,2,3,6,0xb2d6bfbf
283200.48,2.0,0,3,3,4,10,0xb2d3b202
7080.06,1.0,184,2,2,1,5,0xb2d111b4
258422.39,6.0,0,3,4,4,11,0x3b9b17e8
120880.67,2.0,1,3,3,4,10,0xb2d2d262
234111.02,5.0,118,3,4,1,8,0xb2d07ead
11823.86,1.0,1,2,2,4,8,0xb2d584b1
99.13,1.0,21,1,2,2,5,0xb2d65177
52263.85,1.0,184,3,2,1,6,0xb2d3b46f
140383.52,1.0,2,3,2,4,9,0xb2d43139
40538.59,4.0,0,2,4,4,10,0xb2d930e1d
20100.21,2.0,6,2,3,3,8,0xb2d18bad
2.29,1.0,60,1,2,2,5,0xb2d50bca
150112.59,3.0,67,3,4,1,8,0xb2d669b0
50997.16,2.0,119,2,3,1,6,0xb2d53fc1
51000.77,2.0,0,2,3,4,9,0xb2d6ac19
137.28,1.0,0,1,2,4,7,0xb2d8d094
13667.22,1.0,1,2,2,4,8,0xb2d46618
0.92,1.0,0,1,2,4,7,0xb2d47f1d
102663.43,7.0,0,3,4,4,11,0xb2d4b96ed
20192.39,1.0,92,2,2,1,5,0xb2d25c34
200000.0,2.0,26,3,3,2,8,0xb2d9ca04
1167143.72,10.0,1,4,4,4,12,0xb2d1fef5
95320.52,1.0,0,3,2,4,9,0xb2d2bd30d
100076.22,3.0,8,3,4,3,10,0xb2d0f218
6217608.18,2.0,172,4,3,1,8,0xb2d50296
1632.66,1.0,6,1,2,3,6,0xb2d6815c
11.04,1.0,0,1,2,4,7,0xb2d1bb2a
2721.07,1.0,216,1,2,1,4,0xb2d32248d
51514.08,1.0,50,2,2,2,6,0xb2d95d5e
1473490.26,7.0,1,4,4,4,12,0xb2d17739
6846.94,1.0,0,2,2,4,8,0xb2d327ef
600000.86,4.0,3,4,4,4,12,0xb2d8e862
2516465.97,2.0,3,4,3,4,11,0xb2d6e26f
7339.94,1.0,1,2,2,4,8,0xb2d6be89
15152.7,1.0,28,2,2,2,6,0xb2d34c81
22.5,1.0,9,1,2,3,6,0xb2d53fc5
90263.87,2.0,4,3,3,4,10,0xb2d5e342
289742.45,2.0,19,3,3,2,8,0xb2d0c6f7
95021.99,5.0,10,3,4,3,10,0xb2d39bc5
4486.44,1.0,19,2,2,2,6,0xb2d6bc7a
1651.91,1.0,184,1,2,1,4,0xb2d17185
52001997.4,3.0,0,4,4,4,12,0x3b9aeb3c
155089.22,2.0,0,3,3,4,10,0xb2d2821f
421525.69,3.0,26,4,4,2,10,0xb2d64f6f
342.16,2.0,8,1,3,3,7,0xb2da05d1
26.08,1.0,7,1,2,3,6,0xb2d43c2e
201421.05,2.0,69,3,3,1,7,0xb2d9ae32
4300.37,1.0,14,2,2,3,7,0xb2d698ed
100007.93,2.0,39,3,3,2,8,0xb2d24381
51676.19,1.0,10,2,2,3,7,0xb2d9c878
453292.52,2.0,71,4,3,1,8,0xb2d598a4
1173.67,2.0,0,1,3,4,8,0xb2d1dd17d
150004.75,2.0,209,3,3,1,7,0xb2d689f6
270006.49,2.0,3,3,3,4,10,0xb2d3c10a
0.0,1.0,11,1,2,3,6,0xb2d6101d
71.86,1.0,11,1,2,3,6,0xb2d6b4ad
37169.42,4.0,2,2,4,4,10,0xb2d54e0c
650418.55,3.0,0,4,4,4,12,0xb2d65ac0
10301.76,1.0,160,2,2,1,5,0xb2d5ea6b
1038122.07,9.0,0,4,4,4,12,0xb2d3170e
110090.18,3.0,4,3,4,4,11,0xb2d0e608d
154.44,1.0,56,1,2,2,5,0xb2d87d6bd
61.68,1.0,22,1,2,2,5,0xb2d199e6d
1064000.92,5.0,14,4,4,3,11,0xb2d458bb
60001.9,2.0,92,3,3,1,7,0xb2d639c9
50043.74,2.0,101,2,3,1,6,0xb2d5d404
937.55,1.0,0,1,2,4,7,0xb2d5d914
700193.96,2.0,9,4,3,3,10,0xb2d0afa7
80046.25,2.0,25,3,3,2,8,0xb2d51b07
571281.58,3.0,95,4,4,1,9,0xb2d58b5ed
231037.81,3.0,21,3,4,2,9,0xb2d58412d
404379.59,2.0,19,4,3,2,9,0xb2d7fc86
1.02,1.0,13,1,2,3,6,0xb2d53d1c
34488.4,1.0,10,2,2,3,7,0xb2d3c721
1409.49,1.0,92,1,2,1,4,0xb2d46b6ad
54019.74,1.0,2,3,2,4,9,0xb2d5b141
1293662.79,3.0,18,4,4,2,10,0xb2d132a0d
52388.18,3.0,21,3,4,2,9,0xb2d13bc9
1514.42,1.0,26,1,2,2,5,0xb2d315b5
699456.94,4.0,0,4,4,4,12,0xb2d0d9c3
4996.22,1.0,6,2,2,3,7,0xb2d79173
68.95,1.0,0,1,2,4,7,0xb2d6cb58
63625.24,6.0,0,3,4,4,11,0x3b9b17f3
410487.15,7.0,70,4,4,1,9,0xb2d24fb3
1802076.31,2.0,175,4,3,1,8,0xb2d3c592
260012.65,3.0,210,3,4,1,8,0xb2d5d4e7d
1.76,1.0,59,1,2,2,5,0xb2d63f26
643100.0,19.0,6,4,4,3,11,0xb2d1cc51
1286.11,1.0,10,1,2,3,6,0xb2d3f829
2000000.0,2.0,3,4,3,4,11,0xb2d97933
30002.85,2.0,90,2,3,1,6,0xb2d6bb65d
266.26,1.0,5,1,2,3,6,0xb2d393c0d
501427.51,5.0,34,4,4,2,10,0xb2d4cb4d
590685.82,6.0,10,4,4,3,11,0xb2d176c1
585210.05,6.0,1,4,4,4,12,0xb2d4f803
3361.47,1.0,24,2,2,2,6,0xb2d94472
200013.72,2.0,53,3,3,2,8,0xb2d69c87
3.7,1.0,18,1,2,2,5,0xb2d7ae1f
880616.64,11.0,0,4,4,4,12,0x3b9b26ab
7464.74,1.0,0,2,2,4,8,0xb2d599c4
40501.68,1.0,10,2,2,3,7,0xb2d9cff8
12107.34,1.0,2,2,2,4,8,0xb2d267ab
4871.84,1.0,184,2,2,1,5,0xb2d11757
265933.69,3.0,92,3,4,1,8,0xb2d38666
30010.28,4.0,11,2,4,3,9,0xb2d426d8
7304.18,1.0,184,2,2,1,5,0xb2d42369
150098.88,4.0,7,3,4,3,10,0xb2d2c4d9
960107.77,3.0,179,4,4,1,9,0xb2d0c1c7d
460003.81,6.0,14,4,4,3,11,0xb2d7bd9bd
55120.73,2.0,139,3,3,1,7,0xb2d41d7dd
7498.35,5.0,0,2,4,4,10,0xb2d06761
267885.83,3.0,8,3,4,3,10,0xb2d69d88
550000.0,2.0,0,4,3,4,11,0xb2da5656
11064.04,2.0,172,2,3,1,6,0xb2d11054
65.58,2.0,101,1,3,1,5,0x3b9b295b
38831.52,1.0,5,2,2,3,7,0xb2d34316d
35.68,1.0,71,1,2,1,4,0xb2d2e0f0
4048.3,1.0,7,2,2,3,7,0xb2d42652
910.43,1.0,14,1,2,3,6,0xb2d67e8f
50974.57,2.0,2,2,3,4,9,0xb2d6298c
700018.23,2.0,1,4,3,4,11,0xb2d606bb
1301072.7,3.0,147,4,4,1,9,0xb2d25e3ad
1890450.86,4.0,22,4,4,2,10,0xb2d14cf4
20.3,1.0,6,1,2,3,6,0xb2d9d6ae
860881.32,7.0,0,4,4,4,12,0xb2d1bcb0d
357011.38,2.0,10,4,3,3,10,0xb2d95ff3d
917.11,1.0,0,1,2,4,7,0xb2d3e852
2826.75,1.0,5,1,2,3,6,0xb2d6b376
241.25,1.0,4,1,2,4,7,0xb2d55f1f
28.13,1.0,7,1,2,3,6,0xb2d4ce1b
402842.23,2.0,75,4,3,1,8,0xb2d9a107
343725.97,5.0,0,4,4,4,12,0xb2d3151c
64060.52,1.0,11,3,2,3,8,0xb2d94b17
122595.63,1.0,19,3,2,2,7,0xb2d17bb9
1174124.01,5.0,8,4,4,3,11,0xb2d3b76b
254091.76,7.0,21,3,4,2,9,0xb2d41c20
167.89,1.0,0,1,2,4,7,0xb2d4cdca
332158.07,3.0,11,4,4,3,11,0xb2d28899
40005.2,2.0,14,2,3,3,8,0xb2d5a984d
111420.16,2.0,4,3,3,4,10,0xb2d94a92
300006.34,2.0,19,3,3,2,8,0xb2d95055
3058.75,1.0,92,2,2,1,5,0xb2d33094
3578.17,1.0,184,2,2,1,5,0xb2d2019a
171.38,1.0,9,1,2,3,6,0xb2d2ad35
50011.31,2.0,53,2,3,2,7,0xb2d64e9e
800000.07,4.0,1,4,4,4,12,0xb2d2507f
19.51,2.0,53,1,3,2,6,0xb2d0ee9ed
36772.99,2.0,0,2,3,4,9,0xb2d906cdd
1762.69,1.0,92,1,2,1,4,0xb2d29ab0
1385039.24,10.0,22,4,4,2,10,0xb2d5272b
320000.0,3.0,1,4,4,4,12,0xb2d5a6af
100003.17,2.0,95,3,3,1,7,0xb2d974b0d
1534.98,1.0,9,1,2,3,6,0xb2d69fb8
86641.46,3.0,42,3,4,2,9,0xb2d2248b
2618.06,1.0,8,1,2,3,6,0xb2d32f4dd
4006.77,1.0,6,2,2,3,7,0xb2d79251
177.56,1.0,2,1,2,4,7,0xb2d77fa2
449419.02,2.0,159,4,3,1,8,0xb2d0f05c
10000.32,2.0,10,2,3,3,8,0xb2d961d1d
3440.82,1.0,18,2,2,2,6,0xb2d6c2aad
132003.85,6.0,63,3,4,2,9,0xb2d64423
903023.6,4.0,7,4,4,3,11,0xb2d24409
88915.99,3.0,0,3,4,4,11,0xb2d12516d
134047.26,4.0,7,3,4,3,10,0xb2d52a3f
50407.46,2.0,90,2,3,1,6,0xb2d59cd8
410019.88,2.0,46,4,3,2,9,0xb2d3d553
57019.24,2.0,6,3,3,3,9,0xb2d21831
3296.69,1.0,184,2,2,1,5,0x3b9b2f9c
332.33,8.0,59,1,4,2,7,0xb2d309db
35.25,1.0,0,1,2,4,7,0xb2d2080fd
80.16,1.0,20,1,2,2,5,0xb2d40483
103866.87,1.0,92,3,2,1,6,0xb2d3d931
2483.45,1.0,1,1,2,4,7,0xb2d6519c
26845.18,1.0,133,2,2,1,5,0xb2d7f0cc
140461.32,3.0,8,3,4,3,10,0xb2d33512
5300.58,1.0,92,2,2,1,5,0xb2d1f88e
280006.89,3.0,11,3,4,3,10,0xb2d1ac34
51032.39,2.0,124,2,3,1,6,0xb2d3df9b
7634.15,1.0,117,2,2,1,5,0xb2d48774d
248.41,1.0,71,1,2,1,4,0xb2d60953
51723.63,2.0,199,2,3,1,6,0xb2d4d5cd
102.83,1.0,10,1,2,3,6,0xb2d93877
1003.55,1.0,18,1,2,2,5,0xb2d64813
7224.32,1.0,0,2,2,4,8,0xb2d37562d
468854.91,5.0,0,4,4,4,12,0xb2d58a93
212600.34,2.0,24,3,3,2,8,0xb2d9466a
2834.12,1.0,92,1,2,1,4,0xb2d3161e
36125.28,1.0,0,2,2,4,8,0xb2d6da5dd
1201.32,1.0,184,1,2,1,4,0xb2d39683d
1026.84,1.0,184,1,2,1,4,0xb2d08772
11.58,1.0,10,1,2,3,6,0xb2d3a22a
40000.0,1.0,0,2,2,4,8,0xb2d96e31
930.37,1.0,5,1,2,3,6,0xb2d7675a
665312.93,4.0,69,4,4,1,9,0xb2d1d3ff
361190.23,2.0,2,4,3,4,11,0xb2d067db
2178.72,1.0,16,1,2,2,5,0xb2d92541
271083.5,4.0,0,3,4,4,11,0xb2d3d517
203524.33,3.0,171,3,4,1,8,0xb2d5b2abd
50006.26,2.0,31,2,3,2,7,0xb2d21438
26.09,1.0,0,1,2,4,7,0xb2d44aa5
248706.18,6.0,0,3,4,4,11,0x3b9b2c6e
29166.24,1.0,184,2,2,1,5,0xb2d14bfdd
235000.0,2.0,25,3,3,2,8,0xb2da1380
100002.03,2.0,32,3,3,2,8,0xb2d904ec
539485.02,6.0,5,4,4,3,11,0xb2d3b6eb
476000.0,8.0,8,4,4,3,11,0xb2d7ceddd
1138.33,1.0,92,1,2,1,4,0xb2d29a51d
133000.0,7.0,6,3,4,3,10,0xb2d24535
430012.38,6.0,10,4,4,3,11,0xb2d139f5
67507.62,1.0,24,3,2,2,7,0xb2d5ee93
1725.72,1.0,3,1,2,4,7,0xb2d2dcd5
3854.17,1.0,183,2,2,1,5,0xb2d19699d
2000023.24,1.0,0,4,2,4,10,0xb2d8fce1
705533.82,3.0,8,4,4,3,11,0xb2d51492
321183.18,2.0,71,4,3,1,8,0xb2d4e8e9d
522140.33,3.0,34,4,4,2,10,0xb2d6e020
20000.84,2.0,70,2,3,1,6,0xb2d9a2c1
664.95,1.0,18,1,2,2,5,0xb2d625d0d
129285.55,4.0,20,3,4,2,9,0xb2d4e45bd
9.2,1.0,60,1,2,2,5,0xb2d9c1b2
50002.42,2.0,77,2,3,1,6,0xb2d1a46b
1550063.18,10.0,6,4,4,3,11,0xb2d3c067
563000.32,4.0,0,4,4,4,12,0xb2d94c4b
151285.44,1.0,189,3,2,1,6,0xb2d86ad3
466.6,2.0,14,1,3,3,7,0xb2d36ef8
225007.38,11.0,11,3,4,3,10,0xb2d60576
20008.19,2.0,186,2,3,1,6,0xb2d586d3d
76011.51,3.0,27,3,4,2,9,0xb2d0badd
729.2,1.0,13,1,2,3,6,0xb2d42f75
14.03,1.0,19,1,2,2,5,0xb2d9b977
20001.06,2.0,33,2,3,2,7,0xb2d92f60
198896.75,2.0,0,3,3,4,10,0xb2d336f1
14514.81,1.0,5,2,2,3,7,0xb2d8ebdf
700000.0,2.0,24,4,3,2,9,0xb2da1e49
112103.38,4.0,41,3,4,2,9,0xb2d55c0c
60031.25,2.0,32,3,3,2,8,0xb2d15c99
701520.57,3.0,28,4,4,2,10,0xb2d781e5d
1416.71,1.0,21,1,2,2,5,0xb2d6134d
179.6,1.0,112,1,2,1,4,0xb2d56fbb
463586.7,5.0,77,4,4,1,9,0xb2d323ad
6723.41,1.0,5,2,2,3,7,0xb2d69b5b
2292.23,1.0,1,1,2,4,7,0xb2d6a957
52181.81,2.0,2,3,3,4,10,0xb2d6d53e
30340.61,2.0,0,2,3,4,9,0xb2d31552
71.69,1.0,6,1,2,3,6,0xb2d6f5f4d
519692.71,2.0,0,4,3,4,11,0xb2d610bfd
20169.53,1.0,92,2,2,1,5,0xb2d2ed3bd
390004.11,3.0,10,4,4,3,11,0xb2d9222e
409.78,1.0,5,1,2,3,6,0xb2d1b59ad
0.11,1.0,15,1,2,3,6,0xb2d61973
0.73,1.0,8,1,2,3,6,0xb2d6f05b
431623.35,3.0,49,4,4,2,10,0xb2d6b672
77.12,1.0,39,1,2,2,5,0xb2d27925
5693.24,5.0,0,2,4,4,10,0x3b9af166
200000.0,2.0,77,3,3,1,7,0xb2d99afc
717.49,1.0,11,1,2,3,6,0xb2d6b2a6
430005.17,3.0,6,4,4,3,11,0xb2d95e46d
2085085.89,7.0,6,4,4,3,11,0xb2d1bc24
470027.85,7.0,0,4,4,4,12,0xb2d1b3d6
19190.64,1.0,0,2,2,4,8,0xb2d402b2
326760.68,4.0,19,4,4,2,10,0xb2d126bb
112140.13,1.0,92,3,2,1,6,0xb2d427aa
19.05,1.0,4,1,2,4,7,0xb2d1928f
7517.1,1.0,0,2,2,4,8,0xb2d2da05
44378.35,1.0,9,2,2,3,7,0xb2d0b5f3
40029.42,2.0,34,2,3,2,7,0xb2d50af2
16907.54,1.0,0,2,2,4,8,0xb2d3d3c6
70045.59,4.0,25,3,4,2,9,0xb2d61f92
40.88,1.0,23,1,2,2,5,0xb2d260cb
6320.34,1.0,14,2,2,3,7,0xb2d916f6
703002.7,4.0,0,4,4,4,12,0xb2d5611f
283304.94,1.0,1,3,2,4,9,0xb2da01be
633129.89,5.0,0,4,4,4,12,0xb2d6c12ed
3458.05,1.0,0,2,2,4,8,0xb2d61225d
16941.89,2.0,112,2,3,1,6,0xb2d52d9f
419.89,3.0,3,1,4,4,9,0x3b9b46f5
210582.65,5.0,116,3,4,1,8,0xb2d1530c
165153.22,2.0,28,3,3,2,8,0xb2d8f8f1
25584.25,1.0,3,2,2,4,8,0xb2d7878e
600319.51,3.0,0,4,4,4,12,0xb2da1eae
488.21,1.0,22,1,2,2,5,0xb2d1fa31
14174.03,1.0,1,2,2,4,8,0xb2d3e92a
2774763.72,53.0,0,4,4,4,12,0xb2d26445
0.59,5.0,4,1,4,4,9,0x3b9b3e95
103.79,2.0,90,1,3,1,5,0xb2d479f4
184540.81,4.0,2,3,4,4,11,0xb2d42383
401553.07,3.0,4,4,4,4,12,0xb2d7efc6
392366.37,4.0,104,4,4,1,9,0xb2d151c7d
51758.53,1.0,184,2,2,1,5,0xb2d0894fd
12.81,2.0,12,1,3,3,7,0xb2d62742
306650.32,3.0,24,4,4,2,10,0xb2d68367
1152.93,1.0,184,1,2,1,4,0xb2d3f308
67555.12,1.0,0,3,2,4,9,0xb2d77fa3
70.52,1.0,25,1,2,2,5,0xb2d772b8
250010.57,2.0,161,3,3,1,7,0xb2d8e666d
15.08,1.0,15,1,2,3,6,0x3b9b40a1
100000.0,1.0,0,3,2,4,9,0xb2d98071
454854.52,3.0,11,4,4,3,11,0xb2d6a0b0
1009.58,1.0,92,1,2,1,4,0xb2d2dd11
21471.48,1.0,0,2,2,4,8,0xb2d8f4f5
5007.04,1.0,0,2,2,4,8,0xb2d4f1ce
116000.0,1.0,11,3,2,3,8,0xb2d7828ed
100004.75,2.0,18,3,3,2,8,0xb2d7a781
700007.49,3.0,8,4,4,3,11,0xb2d9cf91
602131.43,4.0,45,4,4,2,10,0xb2d9cb09
108107.19,2.0,0,3,3,4,10,0xb2da2165
1505425.8,2.0,5,4,3,3,10,0xb2d6d4de
92382.77,1.0,13,3,2,3,8,0xb2d23489
50001.03,3.0,184,2,4,1,7,0xb2d098d4
100978.02,2.0,25,3,3,2,8,0xb2d6396d
1263.56,1.0,29,1,2,2,5,0xb2d8cfee
700000.0,2.0,4,4,3,4,11,0xb2d9791a
989997.43,11.0,3,4,4,4,12,0xb2d11839
228957.52,3.0,52,3,4,2,9,0xb2d36cb4
471.63,1.0,11,1,2,3,6,0xb2d2bfce
211116.17,3.0,52,3,4,2,9,0xb2d64af7
100005.28,2.0,34,3,3,2,8,0xb2d9f6db
1283.2,1.0,7,1,2,3,6,0xb2d6bcea
200090.0,2.0,11,3,3,3,9,0xb2da4c18
15.78,1.0,4,1,2,4,7,0xb2d2fb0b
1133003.73,5.0,31,4,4,2,10,0xb2d0c2cb
733245.53,2.0,29,4,3,2,9,0xb2d6dfaa
201337.76,2.0,32,3,3,2,8,0xb2d92460
0.12,1.0,27,1,2,2,5,0xb2d68ff0d
31123.04,4.0,28,2,4,2,8,0xb2d0a2a1d
100028.18,3.0,10,3,4,3,10,0xb2d3804ad
1287840.09,16.0,0,4,4,4,12,0x3b9b3b11d
9051.93,1.0,92,2,2,1,5,0xb2d0f2db
563887.86,12.0,0,4,4,4,12,0xb2d1038e
82082.08,3.0,48,3,4,2,9,0xb2d2022c
18000.57,2.0,39,2,3,2,7,0xb2d9ecb7
200000.0,2.0,1,3,3,4,10,0xb2d97fc6
0.58,1.0,11,1,2,3,6,0xb2d8926a
131062.89,2.0,0,3,3,4,10,0xb2d5c3aad
306163.03,3.0,4,4,4,4,12,0xb2d60971
50907.25,1.0,0,2,2,4,8,0xb2d2c627d
1016.76,1.0,184,1,2,1,4,0xb2d0e5f6
11011.72,1.0,184,2,2,1,5,0xb2d2f12c
95001.0,2.0,35,3,3,2,8,0xb2d9f90b
100084.88,2.0,19,3,3,2,8,0xb2d44f15
1061373.35,10.0,3,4,4,4,12,0xb2d24112
24.48,1.0,89,1,2,1,4,0xb2d626dd
2088.44,1.0,32,1,2,2,5,0xb2d28996d
160010.89,2.0,216,3,3,1,7,0xb2d5abf1
9991.69,1.0,11,2,2,3,7,0xb2d9a644
1401.42,2.0,111,1,3,1,5,0x3b9b265d
70063.81,1.0,0,3,2,4,9,0xb2d67d1c
10723.45,2.0,0,2,3,4,9,0xb2d6dab9
3237.17,1.0,0,2,2,4,8,0xb2d55cc0
2134.35,1.0,92,1,2,1,4,0xb2d3872e
11368.23,1.0,53,2,2,2,6,0xb2d0bd43
6.99,1.0,62,1,2,2,5,0xb2d15c27
670021.18,5.0,17,4,4,2,10,0xb2d6fa2ad
240014.61,5.0,21,3,4,2,9,0xb2d0e17dd
218410.1,3.0,3,3,4,4,11,0xb2d1ea3bd
142.9,1.0,86,1,2,1,4,0xb2d27e46
620.56,1.0,17,1,2,2,5,0xb2d916cc
264.45,1.0,0,1,2,4,7,0xb2d43704
10201.64,1.0,202,2,2,1,5,0xb2d5cddd
2950765.56,4.0,0,4,4,4,12,0xb2d62428d
900258.65,12.0,0,4,4,4,12,0xb2d0982a
498766.67,4.0,0,4,4,4,12,0xb2d90fdf
561220.59,2.0,0,4,3,4,11,0xb2d38a85
645067.54,3.0,4,4,4,4,12,0xb2d52102
3435.78,1.0,0,2,2,4,8,0xb2d7688e
13000.14,2.0,8,2,3,3,8,0xb2da4a0d
175000.0,3.0,4,3,4,4,11,0xb2d19b58
82.72,1.0,0,1,2,4,7,0xb2d57f98d
4369.4,1.0,92,2,2,1,5,0xb2d42e3a
830000.53,7.0,9,4,4,3,11,0xb2d62b09
544878.99,7.0,18,4,4,2,10,0x3b9b2c29
442106.68,1.0,0,4,2,4,10,0xb2d3afc9
151750.81,2.0,59,3,3,2,8,0xb2d604d9
14.33,1.0,53,1,2,2,5,0xb2d64d6e
1093.11,1.0,0,1,2,4,7,0xb2d210f7
1020134.4,3.0,2,4,4,4,12,0xb2d89f4a
240041.28,3.0,4,3,4,4,11,0xb2d96eb1d
111302.7,2.0,49,3,3,2,8,0xb2d579c6
50009.58,2.0,23,2,3,2,7,0xb2d8cfb1
5905.03,3.0,6,2,4,3,9,0xb2d55be2
270033.2,4.0,5,3,4,3,10,0xb2d11f7c
11828.81,1.0,128,2,2,1,5,0xb2d1748a
10000.16,2.0,14,2,3,3,8,0xb2da2e7e
298.89,1.0,1,1,2,4,7,0xb2d91c24
40968.64,1.0,5,2,2,3,7,0xb2d2df61
60007.3,7.0,0,3,4,4,11,0xb2d6139d
203554.75,2.0,19,3,3,2,8,0xb2d6c3a9
410044.53,3.0,14,4,4,3,11,0xb2d645e8
871.42,1.0,1,1,2,4,7,0xb2d833af
30748.51,1.0,267,2,2,1,5,0xb2d4fe1e
10861.63,2.0,10,2,3,3,8,0xb2d1a442
130129.82,4.0,6,3,4,3,10,0xb2d34812d
278023.12,3.0,1,3,4,4,11,0xb2d95fdd
53576.75,2.0,139,3,3,1,7,0xb2d3be44
500103.35,2.0,76,4,3,1,8,0xb2d8ddb3d
29.22,1.0,41,1,2,2,5,0xb2d33f6f
214480.08,2.0,27,3,3,2,8,0xb2d68aea
250000.0,2.0,11,3,3,3,9,0xb2da4aa5
41000.01,2.0,125,2,3,1,6,0xb2d44434
500000.0,2.0,12,4,3,3,10,0xb2d5e918
30205.73,3.0,34,2,4,2,8,0xb2d90911
2016.5,1.0,9,1,2,3,6,0xb2d5fbf8d
644255.59,4.0,0,4,4,4,12,0xb2d1dd68
10.45,1.0,4,1,2,4,7,0xb2d91a71
106412.13,2.0,4,3,3,4,10,0xb2d402e2
650296.34,13.0,0,4,4,4,12,0xb2d61864
832025.29,4.0,206,4,4,1,9,0xb2d683a1d
62365.25,2.0,184,3,3,1,7,0xb2d13575
3.2,3.0,71,1,4,1,6,0xb2d95aabd
2239.23,1.0,12,1,2,3,6,0xb2d435e6
1634122.61,6.0,24,4,4,2,10,0xb2d530a0
200006.71,2.0,14,3,3,3,9,0xb2d95b3c
11701.6,1.0,1,2,2,4,8,0xb2d780ec
200987.65,2.0,41,3,3,2,8,0xb2d38279
100078.44,2.0,76,3,3,1,7,0xb2d5cb90
40001.9,4.0,125,2,4,1,7,0xb2d6a4f7
106036.92,4.0,1,3,4,4,11,0xb2d370a9
414485.01,5.0,21,4,4,2,10,0x3b9b2336d
1080120.07,2.0,63,4,3,2,9,0xb2d685a2
110887.58,3.0,9,3,4,3,10,0xb2d61ea8
35034.05,1.0,5,2,2,3,7,0xb2d43712
102388.33,3.0,160,3,4,1,8,0xb2d48b81d
217.11,1.0,19,1,2,2,5,0xb2d60026d
19302.3,1.0,0,2,2,4,8,0xb2d6a9d6
40008.46,3.0,98,2,4,1,7,0xb2d621e8d
300009.21,3.0,175,3,4,1,8,0xb2d246aa
50003.27,4.0,18,2,4,2,8,0xb2d804fe
301053.43,2.0,0,4,3,4,11,0xb2d8f8ed
28.33,1.0,32,1,2,2,5,0xb2d82442d
118909.9,3.0,107,3,4,1,8,0xb2d11080
29635.49,1.0,122,2,2,1,5,0xb2d32840
250000.0,2.0,3,3,3,4,10,0xb2d5fe9c
900183.49,4.0,1,4,4,4,12,0xb2d69ea8
136051.52,5.0,53,3,4,2,9,0xb2d6062f
131019.26,2.0,107,3,3,1,7,0xb2d5df97
649030.36,3.0,103,4,4,1,9,0xb2d35069
1191007.18,6.0,27,4,4,2,10,0xb2d1cd73
2327.54,1.0,2,1,2,4,7,0xb2d178d8
2202223.62,14.0,18,4,4,2,10,0x3b9adae3
2959.51,1.0,6,2,2,3,7,0xb2d6a1e4
67564.63,6.0,0,3,4,4,11,0xb2d06534
503553.11,2.0,22,4,3,2,9,0xb2d8d326
50316.27,2.0,139,2,3,1,6,0xb2d6e76f
10170.41,1.0,184,2,2,1,5,0xb2d0ce47
222420.34,4.0,11,3,4,3,10,0xb2d3c0d5
146019.13,4.0,11,3,4,3,10,0xb2d5c57d
3430.83,1.0,149,2,2,1,5,0xb2d434f9
1000000.06,6.0,3,4,4,4,12,0xb2d23c53
109470.06,2.0,18,3,3,2,8,0xb2d26bd4
360580.22,4.0,95,4,4,1,9,0xb2d08cd3
110766.94,2.0,184,3,3,1,7,0xb2d09066
101139.52,1.0,24,3,2,2,7,0xb2d71786
23.01,1.0,59,1,2,2,5,0xb2d9b7b1
202202.75,2.0,36,3,3,2,8,0xb2d58f1c
4431.13,1.0,162,2,2,1,5,0xb2d28d89
675000.71,5.0,0,4,4,4,12,0xb2d433a9
71.94,1.0,4,1,2,4,7,0xb2d63a91
40091.39,2.0,2,2,3,4,9,0xb2d4f5f2
30003.07,2.0,56,2,3,2,7,0xb2d166d5
1069.13,1.0,186,1,2,1,4,0xb2d2f62dd
626593.18,4.0,3,4,4,4,12,0xb2d43eb6
4303.94,1.0,3,2,2,4,8,0xb2d24561
36692.25,2.0,27,2,3,2,7,0xb2d61fd3
4.26,1.0,35,1,2,2,5,0xb2d2957cd
50450.15,2.0,76,2,3,1,6,0xb2d5bcedd
1051.53,1.0,186,1,2,1,4,0xb2d6fadad
30010.73,2.0,24,2,3,2,7,0xb2d62b81
21.11,1.0,28,1,2,2,5,0xb2d9fa06
79480.64,6.0,0,3,4,4,11,0x3b9b265b
204161.77,2.0,0,3,3,4,10,0xb2d3aa29
515711.2,2.0,10,4,3,3,10,0xb2d2edbe
281327.69,7.0,0,3,4,4,11,0xb2d23eb7d
4834.71,1.0,92,2,2,1,5,0xb2d30785
450795.43,7.0,0,4,4,4,12,0x3b9b45cd
200005.79,2.0,67,3,3,1,7,0xb2d25f5d
4683.48,1.0,6,2,2,3,7,0xb2d5824d
100068.21,2.0,102,3,3,1,7,0xb2d5fc9f
77138.77,1.0,6,3,2,3,8,0xb2d41b53
80021.09,2.0,59,3,3,2,8,0xb2d3b945
30892.22,3.0,0,2,4,4,10,0xb2d28c6ad
13518.97,1.0,1,2,2,4,8,0xb2d2ecb8
9652.07,1.0,20,2,2,2,6,0xb2d967f0
20000.63,2.0,231,2,3,1,6,0xb2d6eeaa
0.41,1.0,75,1,2,1,4,0xb2d78b98
542088.09,3.0,6,4,4,3,11,0xb2d262a3d
786003.14,4.0,5,4,4,3,11,0xb2d258d1
200055.1,2.0,20,3,3,2,8,0xb2d78b5fd
4496.18,3.0,0,2,4,4,10,0xb2d4b63e
1250097.31,2.0,265,4,3,1,8,0xb2d470d9d
48.68,1.0,69,1,2,1,4,0xb2d267a9
554084.24,6.0,47,4,4,2,10,0xb2d5c1c9d
1.85,1.0,161,1,2,1,4,0xb2d2ace8
42197.98,3.0,18,2,4,2,8,0x3b9b4153d
4109.02,1.0,14,2,2,3,7,0xb2d38290
93291.43,3.0,10,3,4,3,10,0xb2d55b0e
301831.64,3.0,0,4,4,4,12,0xb2d5b005
3.21,1.0,8,1,2,3,6,0xb2d61c14
97.25,1.0,12,1,2,3,6,0xb2d605c5
30699.62,1.0,3,2,2,4,8,0xb2d2b7bb
200000.0,2.0,7,3,3,3,9,0xb2d959aa
370006.47,6.0,18,4,4,2,10,0xb2d55c73
718310.68,6.0,0,4,4,4,12,0xb2d4dbd7
109314.02,1.0,8,3,2,3,8,0xb2d5033dd
440000.34,3.0,7,4,4,3,11,0xb2d9af91
280.53,2.0,92,1,3,1,5,0x3b9ae63f
250115.86,3.0,1,3,4,4,11,0xb2d410cc
155183.75,3.0,104,3,4,1,8,0xb2d4101b
1000042.22,2.0,90,4,3,1,8,0xb2d89fd1
361.3,1.0,1,1,2,4,7,0xb2d8ebb0
100001.06,3.0,123,3,4,1,8,0xb2d5559ed
100036.07,2.0,172,3,3,1,7,0xb2d6b664d
0.62,4.0,32,1,4,2,7,0xb2d5e5e1
341245.84,4.0,1,4,4,4,12,0xb2d56e80
33096.59,1.0,92,2,2,1,5,0xb2d61ec1
416439.14,3.0,93,4,4,1,9,0xb2d8f5f2
30001370.8,7.0,4,4,4,4,12,0xb2d0f404d
1369.8,1.0,3,1,2,4,7,0xb2d6bb4d
51738.07,1.0,184,2,2,1,5,0xb2d13fd1
286810.35,5.0,0,3,4,4,11,0x3b9af198
1.9,1.0,74,1,2,1,4,0xb2d6b860
13187.25,1.0,6,2,2,3,7,0xb2d114a1
275000.0,26.0,4,3,4,4,11,0xb2d1944e
1066.75,1.0,146,1,2,1,4,0xb2d6c5e4
100009.86,2.0,66,3,3,2,8,0xb2d5b7c6
2138.97,1.0,2,1,2,4,7,0xb2d2ebd9d
881023.16,16.0,0,4,4,4,12,0xb2d93146
100001.69,4.0,45,3,4,2,9,0xb2d5d0c3
405011.05,4.0,52,4,4,2,10,0xb2d1e0c6
548825.1,6.0,14,4,4,3,11,0xb2d3a190d
1274.34,1.0,53,1,2,2,5,0xb2d57ae7d
28000.59,2.0,74,2,3,1,6,0xb2d99d05
4.98,1.0,10,1,2,3,6,0xb2d69df9
6.08,1.0,15,1,2,3,6,0xb2d2602a
1151.55,3.0,2,1,4,4,9,0x3b9af262
63003.7,2.0,228,3,3,1,7,0xb2d4372f
561283.52,6.0,123,4,4,1,9,0xb2d5c5fe
0.58,1.0,2,1,2,4,7,0xb2d6dbab
43359.45,1.0,7,2,2,3,7,0xb2d78c73
250888.02,2.0,32,3,3,2,8,0xb2da0621
7061.62,1.0,11,2,2,3,7,0xb2d5e385
160118.11,5.0,13,3,4,3,10,0xb2d563c9
200000.0,2.0,5,3,3,3,9,0xb2da1563
107358.49,3.0,0,3,4,4,11,0x3b9b43f3
360000.0,8.0,0,4,4,4,12,0xb2d16d91d
1672.77,1.0,3,1,2,4,7,0xb2d94b29
12526.5,1.0,175,2,2,1,5,0xb2d17cec
762617.0,9.0,95,4,4,1,9,0xb2d2474e
1000001.17,5.0,12,4,4,3,11,0xb2d6c0cb
5928.88,1.0,132,2,2,1,5,0xb2d233cf
884495.61,7.0,97,4,4,1,9,0xb2d0ffd9
7307.47,1.0,9,2,2,3,7,0xb2d3a62f
676000.25,7.0,0,4,4,4,12,0xb2d5ab74
9769.12,1.0,109,2,2,1,5,0xb2d30de0
10001.2,2.0,199,2,3,1,6,0xb2d5cdc8
6385.29,1.0,1,2,2,4,8,0xb2d6fe28d
159673.44,2.0,0,3,3,4,10,0xb2d45064
9022.8,1.0,10,2,2,3,7,0xb2d2aee1
601065.63,3.0,11,4,4,3,11,0xb2d93ebc
9916.51,1.0,1,2,2,4,8,0xb2d4ce70
980208.95,4.0,0,4,4,4,12,0xb2d3d3ced
3939.23,1.0,0,2,2,4,8,0xb2d42760
260062.24,2.0,18,3,3,2,8,0xb2d5b8ae
1.66,1.0,82,1,2,1,4,0xb2d85bb3
105424.71,2.0,18,3,3,2,8,0xb2d5847ad
1975.31,1.0,154,1,2,1,4,0xb2d36ddf
150006.68,3.0,21,3,4,2,9,0xb2d2866e
1317.77,1.0,2,1,2,4,7,0xb2d5d2ae
1391.48,1.0,258,1,2,1,4,0xb2d0ea1d
60677.83,1.0,3,3,2,4,9,0xb2d37a41
200783.7,2.0,29,3,3,2,8,0xb2d6db1e
111087.35,2.0,24,3,3,2,8,0xb2d7650a
50001.06,2.0,10,2,3,3,8,0xb2d9654f
1099.07,1.0,0,1,2,4,7,0xb2d9acc0
15209.81,1.0,10,2,2,3,7,0xb2d26658
153022.05,3.0,14,3,4,3,10,0xb2d683c1d
1569661.98,5.0,25,4,4,2,10,0xb2d775b6
60000.63,2.0,95,3,3,1,7,0xb2d97957d
600065.63,4.0,11,4,4,3,11,0xb2d921d5
72.31,1.0,0,1,2,4,7,0xb2d910c7
1531.57,1.0,89,1,2,1,4,0xb2d2130a
7772.93,1.0,19,2,2,2,6,0xb2d9da3f
1050.38,1.0,3,1,2,4,7,0xb2d3162dd
3.1,1.0,35,1,2,2,5,0xb2d2f6e0
15279.4,1.0,1,2,2,4,8,0xb2d64eb0d
37323.2,1.0,0,2,2,4,8,0xb2d2f29ed
43784.77,1.0,19,2,2,2,6,0xb2d90bf2
56.24,1.0,25,1,2,2,5,0xb2d2b80b
62292.8,1.0,12,3,2,3,8,0xb2d41e79
530499.94,2.0,1,4,3,4,11,0xb2da63b2
1001011.24,3.0,133,4,4,1,9,0xb2d066af
200048.17,2.0,12,3,3,3,9,0xb2d6bb2f
15.77,1.0,1,1,2,4,7,0xb2d5278f
120730.77,2.0,0,3,3,4,10,0xb2d5f9cb
3253.02,1.0,92,2,2,1,5,0x3b9b1821
91005.59,4.0,0,3,4,4,11,0xb2d5bcf0
11061.84,1.0,0,2,2,4,8,0xb2d8ef75
60003.04,4.0,6,3,4,3,10,0xb2d9cfd1
18031.32,1.0,0,2,2,4,8,0xb2d54f1c
151.0,1.0,68,1,2,1,4,0xb2d780e9
31309.99,5.0,0,2,4,4,10,0x3b9af186
50077.69,2.0,110,2,3,1,6,0xb2d41014
404574.38,5.0,0,4,4,4,12,0xb2d5a935
152081.31,4.0,83,3,4,1,8,0xb2d0b162
100015.79,2.0,53,3,3,2,8,0xb2d96b57d
160075.73,4.0,14,3,4,3,10,0xb2d526f1
604438.0,5.0,8,4,4,3,11,0x3b9b1c4c
41297.38,1.0,28,2,2,2,6,0xb2d6c630
1160000.22,25.0,0,4,4,4,12,0xb2d53c3f
141268.86,3.0,0,3,4,4,11,0xb2d5e928
280023.87,1.0,0,3,2,4,9,0xb2d61d01
821186.54,3.0,20,4,4,2,10,0xb2d42b2c
5229.54,1.0,0,2,2,4,8,0xb2d599c4d
5.17,1.0,50,1,2,2,5,0xb2d8d75c
20000.42,2.0,46,2,3,2,7,0xb2d9decc
13.72,1.0,18,1,2,2,5,0xb2d9c2e8
0.0,2.0,29,1,3,2,6,0xb2da06dd
645028.93,6.0,6,4,4,3,11,0xb2d58de0
457818.55,8.0,38,4,4,2,10,0xb2d4fc8f
10015.2,1.0,29,2,2,2,6,0xb2d2a06b
100003.2,2.0,193,3,3,1,7,0xb2d7d34a
911762.52,6.0,18,4,4,2,10,0x3b9b2715
6524.56,1.0,3,2,2,4,8,0xb2d68c3f
51521.84,1.0,5,2,2,3,7,0xb2d38034d
80396.71,1.0,20,3,2,2,7,0xb2d16647
111.17,1.0,9,1,2,3,6,0xb2d40d36
3833.99,1.0,1,2,2,4,8,0xb2d85baa
1835.97,1.0,92,1,2,1,4,0x3b9b2b2b
6.12,2.0,67,1,3,1,5,0xb2d06924
320051.3,2.0,52,4,3,2,9,0xb2d261d6
128010.57,3.0,4,3,4,4,11,0xb2d93bda
4283.0,1.0,29,2,2,2,6,0xb2d32d80
411639.7,4.0,23,4,4,2,10,0xb2d9894a
28092.32,1.0,18,2,2,2,6,0xb2d6c2dc
116788.38,2.0,102,3,3,1,7,0xb2d3e466d
100002.11,2.0,80,3,3,1,7,0xb2d8d4ab
8210.66,1.0,0,2,2,4,8,0xb2d3ef3f
554780.25,2.0,203,4,3,1,8,0xb2d0be6d
100001.06,2.0,80,3,3,1,7,0xb2d98fa8
444218.79,2.0,2,4,3,4,11,0xb2d274ba
73.19,1.0,6,1,2,3,6,0xb2d4094d
3876.33,1.0,4,2,2,4,8,0xb2d2ad1d
505461.85,5.0,9,4,4,3,11,0xb2d40a97
50019.03,2.0,133,2,3,1,6,0xb2d90e66
500023.98,5.0,1,4,4,4,12,0xb2d9ff35
3.21,1.0,59,1,2,2,5,0xb2d537d7
607.63,1.0,184,1,2,1,4,0xb2d2aebe
2389.65,1.0,184,1,2,1,4,0xb2d0f2a3d
265195.17,1.0,26,3,2,2,7,0xb2d93c11
301840.13,2.0,1,4,3,4,11,0xb2d33e71
600037.9,2.0,10,4,3,3,10,0xb2d95725d
231.26,1.0,18,1,2,2,5,0xb2d3ae80
1299.42,1.0,60,1,2,2,5,0xb2d3aeced
156524.99,1.0,92,3,2,1,6,0x3b9ae9ca
1561.9,1.0,92,1,2,1,4,0xb2d3326dd
10305.18,2.0,118,2,3,1,6,0xb2d564d5
189005.07,3.0,181,3,4,1,8,0xb2d65cd2
613406.49,2.0,11,4,3,3,10,0xb2d6a383
400006.19,3.0,25,4,4,2,10,0xb2d41e38
70063.01,2.0,18,3,3,2,8,0xb2d66abe
421570.55,3.0,41,4,4,2,10,0xb2d19ba3
0.01,1.0,92,1,2,1,4,0xb2d1edfed
1011695.57,2.0,122,4,3,1,8,0xb2d65c7f
65994.81,1.0,8,3,2,3,8,0xb2d553c5
20047.64,2.0,92,2,3,1,6,0xb2d600e3d
1110203.53,9.0,120,4,4,1,9,0xb2d13e34
1680824.06,7.0,19,4,4,2,10,0xb2d1b695
340015.82,6.0,15,4,4,3,11,0xb2d45212d
100022.02,3.0,19,3,4,2,9,0xb2d91868
110003.95,4.0,47,3,4,2,9,0xb2d61c17d
654659.81,4.0,11,4,4,3,11,0xb2d6a408
72.88,1.0,19,1,2,2,5,0xb2d9914e
60000.0,2.0,0,3,3,4,10,0xb2d97fda
100001.06,2.0,73,3,3,1,7,0xb2d8e406
6010.6,1.0,8,2,2,3,7,0xb2d4f504
1459.34,1.0,3,1,2,4,7,0xb2d38bbe
10050.54,2.0,19,2,3,2,7,0xb2d94d7a
365125.77,3.0,214,4,4,1,9,0xb2d140bf
363377.52,4.0,3,4,4,4,12,0xb2d58773
2145385.19,12.0,3,4,4,4,12,0xb2d4b623d
10000.63,2.0,213,2,3,1,6,0xb2d681a6
40761.29,1.0,1,2,2,4,8,0xb2d2f742
1017.65,1.0,104,1,2,1,4,0xb2d586aad
200000.0,2.0,22,3,3,2,8,0xb2da209a
119560.89,2.0,0,3,3,4,10,0xb2d4a8f3
519542.66,2.0,10,4,3,3,10,0xb2d2978fd
2689739.08,9.0,0,4,4,4,12,0xb2d23e12
177000.0,9.0,0,3,4,4,11,0xb2d5b283
90043.17,3.0,39,3,4,2,9,0xb2d463a8
101.45,2.0,0,1,3,4,8,0x3b9af273
70.32,1.0,6,1,2,3,6,0xb2d1b644
62098.16,3.0,136,3,4,1,8,0x3b9b2c06
120051.01,2.0,1,3,3,4,10,0xb2da5dcb
10002.27,1.0,5,2,2,3,7,0xb2d824d7
2978.51,1.0,26,2,2,2,6,0xb2d583c5
1.94,1.0,81,1,2,1,4,0xb2d95304d
280064.16,2.0,94,3,3,1,7,0xb2d4edf5
54465.52,3.0,21,3,4,2,9,0xb2d06b17
25534.51,1.0,1,2,2,4,8,0xb2d6bff8
273430.44,3.0,6,3,4,3,10,0xb2d44089
502942.17,3.0,9,4,4,3,11,0xb2d980da
257013.6,4.0,5,3,4,3,10,0xb2d5617e
230012.99,4.0,27,3,4,2,9,0xb2d466dd
353027.32,12.0,3,4,4,4,12,0xb2d415fa
52410.87,2.0,189,3,3,1,7,0xb2d5174a
100009.22,2.0,20,3,3,2,8,0xb2d5a5e4
20115.29,1.0,89,2,2,1,5,0xb2d4a9af
102640.15,2.0,45,3,3,2,8,0xb2d63b4e
80051.48,3.0,89,3,4,1,8,0xb2d14d1b
2024.12,1.0,92,1,2,1,4,0xb2d11039
70000.74,2.0,73,3,3,1,7,0xb2d8e432d
541219.57,10.0,6,4,4,3,11,0xb2d158d6d
4679.95,1.0,268,2,2,1,5,0xb2d1067c
3586.83,1.0,32,2,2,2,6,0xb2d9d3f2
119108.86,1.0,13,3,2,3,8,0xb2d272f9
4277.4,1.0,13,2,2,3,7,0xb2d37a37
1.3,1.0,24,1,2,2,5,0xb2d603ae
1041582.46,2.0,0,4,3,4,11,0xb2d1ec2f
1500.95,1.0,69,1,2,1,4,0xb2d8ee88
1223571.59,1.0,3,4,2,4,10,0xb2d9ecf4
1849187.6,14.0,1,4,4,4,12,0xb2d69290
100001.06,2.0,76,3,3,1,7,0xb2d8dccf
10002.45,2.0,8,2,3,3,8,0xb2d9f338
7685.57,1.0,21,2,2,2,6,0xb2d3eb1fd
20259.55,2.0,6,2,3,3,8,0xb2d91fdf
2054.19,1.0,184,1,2,1,4,0xb2d1836e
70084.11,7.0,15,3,4,3,10,0xb2d65dfa
10120.23,1.0,92,2,2,1,5,0xb2d24aaa
440008.13,5.0,94,4,4,1,9,0xb2d1d6ae
31239.04,4.0,18,2,4,2,8,0xb2d9b97a
4680.31,1.0,8,2,2,3,7,0xb2d69f4e
181443.98,3.0,52,3,4,2,9,0xb2d381c2
355.19,1.0,11,1,2,3,6,0xb2d65501
2.85,1.0,65,1,2,2,5,0xb2d59387
302199.39,2.0,21,4,3,2,9,0xb2d430cfd
10006.92,2.0,18,2,3,2,7,0xb2d5ef98
10043.22,1.0,257,2,2,1,5,0xb2d5867e
54011.54,3.0,35,3,4,2,9,0xb2d9224c
11036.99,1.0,92,2,2,1,5,0xb2d5d973d
7228.5,1.0,15,2,2,3,7,0xb2d718b6d
314001.36,6.0,18,4,4,2,10,0xb2d605cbd
900.42,1.0,11,1,2,3,6,0xb2d930cb
251129.69,1.0,1,3,2,4,9,0xb2d31e50
6431.61,1.0,182,2,2,1,5,0xb2d2d07c
253641.12,3.0,3,3,4,4,11,0xb2d6e29d
383114.72,5.0,22,4,4,2,10,0xb2d0e652
9756.52,1.0,2,2,2,4,8,0xb2d745a9
341537.01,6.0,3,4,4,4,12,0xb2d0fea0
253704.12,2.0,111,3,3,1,7,0xb2d621d1
2610.03,1.0,92,1,2,1,4,0xb2d53f03d
6.98,1.0,28,1,2,2,5,0xb2d6c62c
52050.42,2.0,211,2,3,1,6,0xb2d40fa1
3056.25,1.0,20,2,2,2,6,0xb2d30432
275639.33,2.0,0,3,3,4,10,0xb2d6059e
10076.71,1.0,9,2,2,3,7,0xb2d4242a
15496.55,1.0,184,2,2,1,5,0xb2d402c6
132502.56,2.0,1,3,3,4,10,0xb2d55c11
200002.11,2.0,4,3,3,4,10,0xb2d9e939
210745.94,2.0,36,3,3,2,8,0xb2d9fa8c
20037.63,1.0,0,2,2,4,8,0xb2d2ead8d
582.85,2.0,7,1,3,3,7,0xb2d900f3
20287.4,2.0,0,2,3,4,9,0xb2d0d93a
4857.3,1.0,104,2,2,1,5,0xb2d12289d
111610.21,2.0,139,3,3,1,7,0xb2d18a31
34.57,1.0,31,1,2,2,5,0xb2d3241b
3757.16,1.0,0,2,2,4,8,0xb2d210e2d
8044.87,1.0,14,2,2,3,7,0xb2d8c84cd
475.48,1.0,39,1,2,2,5,0xb2d62e11
5064.4,1.0,184,2,2,1,5,0xb2d17a1ad
8326.8,2.0,0,2,3,4,9,0xb2d51e9f
305720.1,2.0,24,4,3,2,9,0xb2d2650ad
100000.0,1.0,5,3,2,3,8,0xb2d3056b
3450.7,4.0,0,2,4,4,10,0xb2d0680cd
1840.73,1.0,5,1,2,3,6,0xb2d8cd3d
50000.53,2.0,52,2,3,2,7,0xb2d62b63
1173.39,1.0,92,1,2,1,4,0xb2d288e5
579.21,1.0,26,1,2,2,5,0xb2d78e3b
30118.28,1.0,184,2,2,1,5,0xb2d4246cd
84791.93,1.0,6,3,2,3,8,0xb2d55a23
17509.39,1.0,92,2,2,1,5,0xb2d172c3
264809.52,3.0,15,3,4,3,10,0xb2d3d5bf
1920453.03,3.0,35,4,4,2,10,0xb2d5806d
1451456.77,5.0,11,4,4,3,11,0xb2d9be28
683.98,1.0,0,1,2,4,7,0xb2d919ab
311410.75,1.0,139,4,2,1,7,0xb2d52012
345182.17,4.0,12,4,4,3,11,0xb2d5c1ce
10032.24,2.0,69,2,3,1,6,0xb2d59abd
3651.1,1.0,4,2,2,4,8,0xb2d1fd4a
133.18,1.0,15,1,2,3,6,0xb2d7d2e7
91583.48,3.0,179,3,4,1,8,0xb2d52905
519.7,1.0,15,1,2,3,6,0xb2d587a4
135518.37,2.0,5,3,3,3,9,0xb2d0f598d
220655.85,6.0,18,3,4,2,9,0xb2d1d4ad
93.41,1.0,5,1,2,3,6,0xb2d42abe
200710.54,2.0,56,3,3,2,8,0xb2d9cb2f
200000.0,3.0,28,3,4,2,9,0xb2da0d87
200000.0,2.0,12,3,3,3,9,0xb2d9ecce
200710.42,2.0,8,3,3,3,9,0xb2d92f98
5081.52,1.0,0,2,2,4,8,0xb2d95a02
80002.48,3.0,53,3,4,2,9,0xb2d6b2e3
200752.26,2.0,28,3,3,2,8,0xb2d6db1ed
84000.0,2.0,0,3,3,4,10,0xb2d980fa
604371.42,9.0,47,4,4,2,10,0xb2d62a3b
291676.08,7.0,3,3,4,4,11,0xb2d443a1
1.75,1.0,10,1,2,3,6,0xb2d5cfcd
900858.37,5.0,0,4,4,4,12,0xb2d22f3e
3.65,1.0,11,1,2,3,6,0xb2d68e94
420000.0,6.0,3,4,4,4,12,0xb2d0b54a
51083.6,2.0,184,2,3,1,6,0xb2d298b7d
16.11,1.0,0,1,2,4,7,0xb2d8d642
490016.62,6.0,67,4,4,1,9,0xb2d207cfd
927665.88,1.0,0,4,2,4,10,0xb2d24147
1103.98,1.0,201,1,2,1,4,0xb2d081cf
1060068.85,3.0,25,4,4,2,10,0xb2d3d2ea
0.0,2.0,3,1,3,4,8,0xb2d6a0f7
1038.37,5.0,14,1,4,3,8,0xb2d16bb7
144.14,1.0,0,1,2,4,7,0xb2d2c384
151287.36,3.0,101,3,4,1,8,0xb2d5efa5
10000.43,3.0,10,2,4,3,9,0xb2d3bcd7
172153.19,4.0,6,3,4,3,10,0xb2d52c9d
477835.49,9.0,11,4,4,3,11,0xb2d6442c
12111.85,2.0,2,2,3,4,9,0x3b9b468bd
46258.67,1.0,2,2,2,4,8,0xb2d235d1d
10000.32,2.0,60,2,3,2,7,0xb2d9b988
20800.85,2.0,39,2,3,2,7,0xb2d5f059
77051.19,1.0,0,3,2,4,9,0xb2d60333
650001.59,2.0,7,4,3,3,10,0xb2d95f19
940385.36,11.0,7,4,4,3,11,0xb2d55e69
82.14,1.0,26,1,2,2,5,0xb2d54e89
500104.6,3.0,16,4,4,2,10,0xb2d94d8c
425.74,1.0,18,1,2,2,5,0xb2d352a2
105015.92,2.0,132,3,3,1,7,0xb2d4ac39
52568.33,2.0,10,3,3,3,9,0xb2d1a848
400054.25,3.0,19,4,4,2,10,0xb2d5577fd
25483.52,2.0,0,2,3,4,9,0xb2d37ad5
100009.5,2.0,83,3,3,1,7,0xb2d98483
830030.11,9.0,6,4,4,3,11,0xb2d202d0d
16769.61,6.0,92,2,4,1,7,0xb2d0795b
450001.56,5.0,1,4,4,4,12,0xb2d1948b
0.0,1.0,92,1,2,1,4,0xb2d2c6c4
172072.86,5.0,10,3,4,3,10,0xb2d2b393
8521.31,2.0,92,2,3,1,6,0x3b9b19e0
162493.81,2.0,52,3,3,2,8,0xb2d1de2fd
664.78,1.0,55,1,2,2,5,0xb2d54899
449.37,1.0,1,1,2,4,7,0xb2d28fae
9435.47,1.0,184,2,2,1,5,0xb2d4663ad
887.89,1.0,3,1,2,4,7,0xb2d166da
4778.24,1.0,0,2,2,4,8,0xb2d91fe3
4245.66,1.0,15,2,2,3,7,0xb2d321ce
29092.09,1.0,0,2,2,4,8,0xb2d59fe3
54049.55,3.0,77,3,4,1,8,0xb2d6539cd
100073.18,2.0,171,3,3,1,7,0xb2d459bed
903.5,3.0,124,1,4,1,6,0xb2d76b09
4062062.08,2.0,11,4,3,3,10,0xb2d5f2d2
80000.84,2.0,34,3,3,2,8,0xb2d9340b
56019.97,2.0,21,3,3,2,8,0xb2d19c44d
1369.29,1.0,17,1,2,2,5,0xb2d3f042
821011.28,9.0,6,4,4,3,11,0xb2d08b55
106.71,1.0,11,1,2,3,6,0xb2d31eb8
233886.67,2.0,0,3,3,4,10,0xb2d09fe2
1663.58,1.0,8,1,2,3,6,0xb2d2661e
2023.9,1.0,0,1,2,4,7,0xb2d6c97e
111688.85,2.0,213,3,3,1,7,0xb2d10cc4
60110.83,2.0,5,3,3,3,9,0xb2d91848
23127.76,1.0,184,2,2,1,5,0xb2d3f5b8
4.72,4.0,10,1,4,3,8,0xb2d3e41ed
200000.0,2.0,29,3,3,2,8,0xb2da0c72
1403399.59,6.0,13,4,4,3,11,0xb2d6a2e1
1075669.04,5.0,116,4,4,1,9,0xb2d1032c
2789.23,1.0,184,1,2,1,4,0xb2d2fb78
55001.74,3.0,151,3,4,1,8,0xb2d8df57
68.0,1.0,11,1,2,3,6,0xb2d5d5d7
400003.38,2.0,19,4,3,2,9,0xb2d90068
22104.88,1.0,11,2,2,3,7,0xb2d2b799
271502.09,2.0,7,3,3,3,9,0xb2d478a0
144923.11,4.0,108,3,4,1,8,0xb2d26191
40586.16,3.0,60,2,4,2,8,0xb2d63354d
51738.06,3.0,0,2,4,4,10,0x3b9b4171
1170.76,1.0,0,1,2,4,7,0xb2d59a1f
30000.32,2.0,210,2,3,1,6,0xb2d62b4b
111525.29,2.0,11,3,3,3,9,0xb2d0dfba
381044.23,3.0,14,4,4,3,11,0xb2d62613
2900.63,1.0,92,2,2,1,5,0xb2d3028bd
1027328.18,6.0,0,4,4,4,12,0xb2d5f1ac
764.29,1.0,19,1,2,2,5,0xb2d15e42
303558.3,4.0,153,4,4,1,9,0xb2d7862f
61015.33,3.0,18,3,4,2,9,0xb2d78e83
60002.53,2.0,20,3,3,2,8,0xb2d94f47
7596.26,1.0,0,2,2,4,8,0xb2d6f4f2
1439.52,1.0,92,1,2,1,4,0xb2d1b751
500034.82,3.0,184,4,4,1,9,0xb2d0ac2f
2142000.0,18.0,0,4,4,4,12,0xb2d0d02bd
1010671.2,2.0,18,4,3,2,9,0xb2d787f6d
30862.48,2.0,112,2,3,1,6,0xb2d2a298
200018.49,2.0,221,3,3,1,7,0xb2d41428d
70156.84,1.0,6,3,2,3,8,0xb2d586c3
6672.83,1.0,92,2,2,1,5,0xb2d1e9f5
50582.71,3.0,45,2,4,2,8,0xb2d68328
0.0,1.0,3,1,2,4,7,0xb2d32ec5
8.64,1.0,0,1,2,4,7,0xb2d2b53a
738679.94,9.0,13,4,4,3,11,0xb2d42fee
10174.51,1.0,92,2,2,1,5,0xb2d2535b
667.96,2.0,0,1,3,4,8,0xb2d1b570
0.01,1.0,184,1,2,1,4,0xb2d29ef3
35726.24,1.0,10,2,2,3,7,0xb2d5d14b
1968.51,1.0,0,1,2,4,7,0xb2d3c5d3
113.66,1.0,4,1,2,4,7,0xb2d3b744
601066.76,3.0,19,4,4,2,10,0xb2d5ad87
30206.19,2.0,26,2,3,2,7,0xb2d3539fd
209967.2,2.0,107,3,3,1,7,0xb2d5b44b
835346.64,7.0,9,4,4,3,11,0xb2d0ef06
262654.93,3.0,65,3,4,2,9,0xb2d39388
3003.38,1.0,176,2,2,1,5,0xb2d1d46c
7396.21,1.0,6,2,2,3,7,0xb2d5d5a4
40113.22,2.0,199,2,3,1,6,0xb2d60c9f
4.37,1.0,24,1,2,2,5,0xb2d6d335d
5130.04,1.0,8,2,2,3,7,0xb2d441dd
419.3,1.0,5,1,2,3,6,0xb2d1aef0
80622.35,5.0,0,3,4,4,11,0xb2d65249
9.26,1.0,60,1,2,2,5,0xb2d58bdbd
153.42,1.0,7,1,2,3,6,0xb2d46839
2433.94,1.0,10,1,2,3,6,0xb2d8a7b8
1199.34,1.0,10,1,2,3,6,0xb2d5e827
3329.32,1.0,58,2,2,2,6,0xb2d8fcb0
1096.93,1.0,184,1,2,1,4,0xb2d20aba
20027.8,2.0,27,2,3,2,7,0xb2d60d0f
99882.56,1.0,92,3,2,1,6,0xb2d07e3f
13545.48,1.0,3,2,2,4,8,0xb2d96775
4950153.58,3.0,20,4,4,2,10,0xb2d8edec
329110.43,6.0,0,4,4,4,12,0x3b9af285
1518092.44,6.0,4,4,4,4,12,0xb2d1ae51
400000.0,3.0,1,4,4,4,12,0xb2da2b16
3369342.65,14.0,1,4,4,4,12,0xb2d10ba8
362027.8,5.0,7,4,4,3,11,0xb2d0f2cad
330001.9,4.0,6,4,4,3,11,0xb2d9654fd
30139.32,1.0,20,2,2,2,6,0xb2d60a9dd
170002.12,4.0,0,3,4,4,11,0xb2d913e5
9.53,1.0,3,1,2,4,7,0xb2d8d554
5007.27,1.0,12,2,2,3,7,0xb2d348ad
132009.95,3.0,101,3,4,1,8,0xb2d24eb8
21.86,1.0,63,1,2,2,5,0xb2d36231
30000.85,4.0,38,2,4,2,8,0xb2d69b39
100028.33,2.0,206,3,3,1,7,0xb2d59800
600008.64,3.0,34,4,4,2,10,0xb2d96870
140029.49,3.0,165,3,4,1,8,0xb2d2b332
6019.65,1.0,0,2,2,4,8,0xb2d6b553
30000.32,2.0,83,2,3,1,6,0xb2d8d00c
60012.22,4.0,104,3,4,1,8,0xb2d5d0fad
200001.38,2.0,15,3,3,3,9,0xb2d228c0d
235040.64,2.0,87,3,3,1,7,0xb2d3a84a
37.53,1.0,36,1,2,2,5,0xb2d622bf
100002.11,3.0,66,3,4,2,9,0xb2d8eff9
2.69,1.0,9,1,2,3,6,0xb2d4336a
122079.37,3.0,94,3,4,1,8,0xb2d11d6a
10001.06,2.0,33,2,3,2,7,0xb2d9b063
120097.95,2.0,31,3,3,2,8,0xb2d10ec5
58986.63,1.0,1,3,2,4,9,0xb2d6cc6e
3403.89,1.0,92,2,2,1,5,0x3b9b24d7
51447.15,2.0,41,2,3,2,7,0xb2d17a09
119761.6,3.0,151,3,4,1,8,0xb2d27ab1d
333.54,1.0,89,1,2,1,4,0xb2d1a756
2377.1,3.0,92,1,4,1,6,0x3b9ade72
7.8,1.0,60,1,2,2,5,0xb2d2ba4e
9488.58,1.0,18,2,2,2,6,0xb2d6c4b3
480000.0,2.0,5,4,3,3,10,0xb2d970ff
458502.69,3.0,27,4,4,2,10,0xb2d2d8f2
41101.25,3.0,0,2,4,4,10,0xb2d503b1
80056.46,2.0,188,3,3,1,7,0xb2d5d2a6
401505.44,3.0,9,4,4,3,11,0xb2d64999
68018.81,2.0,67,3,3,1,7,0xb2d185ff
100000.0,2.0,0,3,3,4,10,0xb2d97cdd
70001.38,3.0,62,3,4,2,9,0xb2d815ec
7221.17,2.0,184,2,3,1,6,0xb2d145fc
202131.96,2.0,102,3,3,1,7,0xb2d96cb7d
235114.34,4.0,24,3,4,2,9,0xb2d60162d
9019.59,1.0,77,2,2,1,5,0xb2d5697b
150032.88,4.0,4,3,4,4,11,0xb2d1cb35
130004.33,4.0,4,3,4,4,11,0xb2da3582
350118.49,1.0,14,4,2,3,9,0xb2d948dd
250010.48,3.0,18,3,4,2,9,0xb2d9df24
1174.48,1.0,66,1,2,2,5,0xb2d1d68c
4470.32,1.0,6,2,2,3,7,0xb2d65362
15.78,1.0,53,1,2,2,5,0xb2d9be83
3062639.05,8.0,4,4,4,4,12,0xb2d32fbc
300106.36,3.0,25,4,4,2,10,0xb2d98dc8
517000.0,4.0,1,4,4,4,12,0xb2d2ee06
0.42,1.0,74,1,2,1,4,0xb2d10f2e
200000.0,2.0,4,3,3,4,10,0xb2d97a7f
3555617.6,1.0,0,4,2,4,10,0xb2d58ac8
5.14,1.0,54,1,2,2,5,0xb2d3565fd
14.99,1.0,64,1,2,2,5,0xb2d1e047
12713.8,1.0,8,2,2,3,7,0xb2d314c4
51.68,1.0,10,1,2,3,6,0xb2d3da3d
50001.58,2.0,53,2,3,2,7,0xb2d9c962
5598.64,1.0,1,2,2,4,8,0xb2d6f780
0.38,1.0,0,1,2,4,7,0xb2d787d6
300659.71,1.0,0,4,2,4,10,0xb2d25436
3091.31,1.0,0,2,2,4,8,0xb2d2c424
1438602.57,3.0,5,4,4,3,11,0xb2d5fddf
6203.32,1.0,74,2,2,1,5,0xb2d32abf
120110.47,4.0,59,3,4,2,9,0xb2d0c1d0
1310021.13,6.0,0,4,4,4,12,0xb2d4f965
400020.83,2.0,4,4,3,4,11,0xb2d9c7d6
210005.59,2.0,2,3,3,4,10,0xb2da1cf2
85224.35,4.0,32,3,4,2,9,0x3b9af1cc
328718.44,5.0,22,4,4,2,10,0xb2d629f7
3114.2,1.0,218,2,2,1,5,0xb2d3ec4ad
531743.12,3.0,23,4,4,2,10,0xb2d6bbff
169312.13,7.0,6,3,4,3,10,0xb2d59ce5
1584.85,1.0,113,1,2,1,4,0xb2d68106
220010.28,7.0,0,3,4,4,11,0xb2d43021
30008.73,2.0,1,2,3,4,9,0xb2d5d66f
90005.35,3.0,52,3,4,2,9,0xb2d49141
0.21,1.0,47,1,2,2,5,0xb2d9d6a7
8866.88,1.0,45,2,2,2,6,0xb2d5b73c
20305.96,1.0,82,2,2,1,5,0xb2d68d02
219.85,1.0,26,1,2,2,5,0xb2d8d1ae
785012.39,5.0,56,4,4,2,10,0xb2d51bb9d
256662.52,8.0,0,3,4,4,11,0x3b9b3f48
259906.17,3.0,1,3,4,4,11,0xb2d212b1
600713.62,4.0,25,4,4,2,10,0xb2d9799f
270061.48,4.0,11,3,4,3,10,0xb2d62f1d
3112.61,1.0,92,2,2,1,5,0xb2d3f720
61760.0,2.0,172,3,3,1,7,0xb2d55597
88067.4,2.0,189,3,3,1,7,0xb2d233d3
180070.98,2.0,132,3,3,1,7,0xb2d11ef8
1102420.25,3.0,30,4,4,2,10,0xb2d8b135
203260.01,2.0,10,3,3,3,9,0xb2d8e3fd
6485.13,1.0,4,2,2,4,8,0xb2d958e7
200002.11,2.0,92,3,3,1,7,0xb2d65984
253870.03,7.0,20,3,4,2,9,0xb2d5890e
26160.2,1.0,0,2,2,4,8,0xb2d6b3e8d
80000.0,1.0,1,3,2,4,9,0xb2d0dd45
385020.58,9.0,6,4,4,3,11,0xb2d68251
13717.07,1.0,8,2,2,3,7,0xb2d3093c
9557.62,1.0,2,2,2,4,8,0xb2d5d318
5052470.73,8.0,0,4,4,4,12,0x3b9ae49c
500003.6,2.0,6,4,3,3,10,0xb2da4a80
3.42,1.0,18,1,2,2,5,0xb2d42425
100001.06,2.0,18,3,3,2,8,0xb2da2f0b
861004.94,5.0,1,4,4,4,12,0xb2d34727
1153000.1,5.0,0,4,4,4,12,0xb2d8d2ec
1027.95,1.0,0,1,2,4,7,0xb2d6da43
430666.18,3.0,160,4,4,1,9,0xb2d1b0ab
110445.75,2.0,0,3,3,4,10,0xb2d2d09a
70000.08,4.0,40,3,4,2,9,0xb2d53d4c
11413.57,2.0,174,2,3,1,6,0x3b9b2f98d
16559.91,2.0,0,2,3,4,9,0xb2d0790f
21568.64,2.0,0,2,3,4,9,0xb2d94198d
15674504.48,3.0,12,4,4,3,11,0xb2d4b93b
252664.94,2.0,0,3,3,4,10,0xb2d968df
150051.52,2.0,0,3,3,4,10,0xb2d2089e
70001.48,2.0,49,3,3,2,8,0xb2d9d59d
1528.43,1.0,1,1,2,4,7,0xb2d28d52
379241.49,6.0,0,4,4,4,12,0xb2d41a4e
1283027.09,2.0,6,4,3,3,10,0xb2d9671f
17393.35,1.0,1,2,2,4,8,0xb2d6f43c
217.55,1.0,22,1,2,2,5,0xb2d45825
217784.33,4.0,77,3,4,1,8,0xb2d2e86ad
20010.01,2.0,53,2,3,2,7,0xb2d9d048
200419.19,2.0,24,3,3,2,8,0xb2d17121
1115.58,1.0,184,1,2,1,4,0xb2d1dd64
1603851.07,7.0,1,4,4,4,12,0xb2d5f856d
10023.69,1.0,18,2,2,2,6,0xb2d6d028
50247.56,2.0,3,2,3,4,9,0xb2d40d7e
302.19,1.0,11,1,2,3,6,0xb2d5875f
145003.06,3.0,76,3,4,1,8,0xb2d8dc5c
1261789.69,10.0,49,4,4,2,10,0xb2d580e1
1102786.18,8.0,7,4,4,3,11,0xb2d13dced
50671.15,1.0,0,2,2,4,8,0xb2d4d48f
1600033.27,3.0,26,4,4,2,10,0xb2d7843c
4704.01,1.0,15,2,2,3,7,0xb2d8cd38
102744.8,3.0,231,3,4,1,8,0xb2d3a86bd
666068.92,14.0,0,4,4,4,12,0xb2d48265d
2321.5,1.0,0,1,2,4,7,0xb2d17119
350074.57,4.0,62,4,4,2,10,0xb2d33d01
50198.7,1.0,0,2,2,4,8,0xb2d150af
260001.27,3.0,6,3,4,3,10,0xb2d8e28fd
1428.88,2.0,12,1,3,3,7,0xb2d5ca62
50688.74,2.0,256,2,3,1,6,0xb2d604db
141072.91,2.0,15,3,3,3,9,0xb2d231b8d
400000.0,2.0,20,4,3,2,9,0xb2da2c1b
672037.09,9.0,11,4,4,3,11,0xb2d11f75
495066.35,4.0,20,4,4,2,10,0xb2d23c3bd
2314990.79,10.0,1,4,4,4,12,0xb2d4b6df
400000.84,2.0,22,4,3,2,9,0xb2d9d245
3.0,1.0,14,1,2,3,6,0xb2d9cf57
485656.28,6.0,3,4,4,4,12,0xb2d2c92fd
500307.59,1.0,0,4,2,4,10,0xb2d51cea
179.77,1.0,204,1,2,1,4,0xb2d56fbbd
416789.05,4.0,1,4,4,4,12,0xb2d25d76d
210321.85,3.0,97,3,4,1,8,0xb2d1b1c4
2.49,1.0,14,1,2,3,6,0xb2d94545
2094.46,2.0,184,1,3,1,5,0xb2d06e05d
570030.08,3.0,0,4,4,4,12,0xb2d68bdc
1186371.37,5.0,53,4,4,2,10,0xb2d12bf3d
4057610.84,2.0,0,4,3,4,11,0xb2d5f2d2d
14310.15,1.0,92,2,2,1,5,0xb2d1e84f
4065.94,1.0,17,2,2,2,6,0xb2d34397
1814.4,1.0,207,1,2,1,4,0xb2d32d5cd
85.51,1.0,37,1,2,2,5,0xb2d62a37
14424.7,1.0,1,2,2,4,8,0xb2d3b45ed
2495.32,1.0,97,1,2,1,4,0xb2d6d910
313070.62,2.0,15,4,3,3,10,0xb2d13c38d
374660.64,8.0,11,4,4,3,11,0xb2d417a4
8354.0,2.0,4,2,3,4,9,0xb2d97878
1342.68,1.0,0,1,2,4,7,0xb2d14e80d
8052.77,1.0,29,2,2,2,6,0xb2d91ba3
360056.08,7.0,28,4,4,2,10,0xb2d19d18d
492736.03,6.0,33,4,4,2,10,0xb2d0cc2cd
35.79,1.0,32,1,2,2,5,0xb2d5b70f
36900.33,1.0,14,2,2,3,7,0xb2d6120b
106.49,1.0,0,1,2,4,7,0xb2d29bcd
812827.57,4.0,1,4,4,4,12,0xb2d3cac0
7182.27,1.0,92,2,2,1,5,0xb2d0dbb2
393133.31,3.0,80,4,4,1,9,0xb2d41162
31300.54,3.0,27,2,4,2,8,0xb2d0739a
8237.15,1.0,92,2,2,1,5,0xb2d21d6a
6441.82,1.0,1,2,2,4,8,0xb2d91f7c
150094.75,4.0,10,3,4,3,10,0x3b9b401a
11.77,1.0,31,1,2,2,5,0xb2d6d089
1234433.86,5.0,19,4,4,2,10,0xb2d6950d
261228.99,2.0,3,3,3,4,10,0xb2d42e70
393251.1,7.0,5,4,4,3,11,0xb2d06eab
184688.58,3.0,92,3,4,1,8,0xb2d0a5ba
50012.75,2.0,108,2,3,1,6,0xb2d56e9e
227349.08,3.0,56,3,4,2,9,0xb2d3e607d
51.45,1.0,67,1,2,1,4,0xb2d33582
5622.02,1.0,0,2,2,4,8,0xb2d9581f
18.37,1.0,15,1,2,3,6,0xb2d99ca0
20154.91,1.0,9,2,2,3,7,0xb2d5ccc1
202362.39,2.0,83,3,3,1,7,0xb2d3638bd
1981.5,1.0,76,1,2,1,4,0xb2d0e9f5
3196.2,1.0,2,2,2,4,8,0xb2d1aec2
20.21,1.0,19,1,2,2,5,0xb2d35a27
190003.8,2.0,1,3,3,4,10,0xb2da1b97
420742.04,4.0,16,4,4,2,10,0xb2d594d4
260835.12,2.0,3,3,3,4,10,0xb2d591b4
800121.5,2.0,116,4,3,1,8,0xb2d12c3e
44.74,1.0,10,1,2,3,6,0xb2d9a48e
11167.97,2.0,0,2,3,4,9,0xb2d5ec0f
947.96,1.0,0,1,2,4,7,0xb2d14613
145086.68,4.0,3,3,4,4,11,0xb2d5903e
10383.67,2.0,125,2,3,1,6,0xb2d53d59
0.56,1.0,80,1,2,1,4,0xb2d21e61
20000.21,2.0,18,2,3,2,7,0xb2da3055
23.78,1.0,0,1,2,4,7,0xb2d8f246
1125.44,1.0,59,1,2,2,5,0xb2d4f928
170591.56,2.0,35,3,3,2,8,0xb2d6b2a5
350050.54,3.0,1,4,4,4,12,0xb2d40147
1970.16,1.0,112,1,2,1,4,0xb2d12856
35243.25,1.0,197,2,2,1,5,0xb2d2f058
400055.32,2.0,0,4,3,4,11,0xb2d96407d
694063.82,5.0,60,4,4,2,10,0xb2d1ab23d
10044.64,1.0,184,2,2,1,5,0xb2d5c490
0.0,1.0,4,1,2,4,7,0xb2d9ecd6
254635.07,3.0,8,3,4,3,10,0xb2d3f5e3
490236.53,3.0,0,4,4,4,12,0xb2d57a5e
6871.43,1.0,169,2,2,1,5,0xb2d271b6
405019.44,3.0,22,4,4,2,10,0xb2d29e07
576824.46,4.0,3,4,4,4,12,0xb2d23250
4386.38,1.0,2,2,2,4,8,0xb2d3b980
4428.22,1.0,45,2,2,2,6,0xb2d6e4a5d
7696.35,1.0,9,2,2,3,7,0xb2d2846d
96941.24,1.0,87,3,2,1,6,0xb2d2aff7
21931.45,2.0,0,2,3,4,9,0xb2d944b5
690094.6,5.0,6,4,4,3,11,0xb2d57301
400733.91,3.0,14,4,4,3,11,0xb2d97288
581608.5,4.0,3,4,4,4,12,0xb2d5b9f4
15559.24,1.0,1,2,2,4,8,0xb2d6cc59
7219.55,1.0,0,2,2,4,8,0xb2d6bb8a
50039.66,2.0,11,2,3,3,8,0xb2d59defd
51456.56,1.0,10,2,2,3,7,0xb2d64c27d
131002.37,3.0,76,3,4,1,8,0xb2d5c2ef
439692.11,3.0,50,4,4,2,10,0xb2d25f48
100017.95,2.0,97,3,3,1,7,0xb2d95b6d
852.96,1.0,0,1,2,4,7,0xb2d8cee3
190682.07,3.0,11,3,4,3,10,0xb2d0c457
1.84,2.0,66,1,3,2,6,0xb2d500d3
10017.22,1.0,27,2,2,2,6,0xb2d6cacd
16558.93,1.0,5,2,2,3,7,0xb2d1f751
120304.5,3.0,0,3,4,4,11,0xb2d5e821d
80894.3,1.0,9,3,2,3,8,0xb2d33cb0
5847.4,1.0,0,2,2,4,8,0xb2d6c858
1270000.0,5.0,4,4,4,4,12,0xb2d42510d
93.77,1.0,7,1,2,3,6,0xb2d45c02
50023.22,1.0,11,2,2,3,7,0xb2d93bec
3353.33,1.0,1,2,2,4,8,0xb2d3d299
10000.21,2.0,92,2,3,1,6,0xb2d64131
313.64,1.0,5,1,2,3,6,0xb2d201aa
49271.44,1.0,21,2,2,2,6,0xb2d5897d
700004.64,4.0,4,4,4,4,12,0xb2d6c5b7d
203029.09,2.0,129,3,3,1,7,0xb2d10b53
200000.49,2.0,16,3,3,2,8,0xb2d904d2
9750.4,1.0,29,2,2,2,6,0xb2d91b7b
651553.31,3.0,5,4,4,3,11,0xb2d4a928d
95376.85,2.0,66,3,3,2,8,0xb2d1dda0
580.45,1.0,2,1,2,4,7,0xb2d340ac
150194.67,2.0,97,3,3,1,7,0xb2d1b866d
5814.51,1.0,7,2,2,3,7,0xb2d948bbd
1000251.18,2.0,6,4,3,3,10,0xb2d8f8af
7.52,1.0,21,1,2,2,5,0xb2d4a5aed
1001061.28,6.0,1,4,4,4,12,0xb2d25fbf
7549.01,1.0,0,2,2,4,8,0xb2d97c96
58063.81,1.0,0,3,2,4,9,0xb2d5dfaa
3004.89,1.0,9,2,2,3,7,0xb2d5d341
16001.76,2.0,21,2,3,2,7,0xb2d2c293
1360316.29,13.0,0,4,4,4,12,0xb2d4ef1f
218308.3,3.0,46,3,4,2,9,0xb2d0c126
3794143.59,14.0,17,4,4,2,10,0xb2d6bc98
1021070.55,1.0,2,4,2,4,10,0xb2d8a804
51229.9,2.0,33,2,3,2,7,0xb2d3d2fe
654.37,1.0,3,1,2,4,7,0xb2d6af8f
501776.04,2.0,36,4,3,2,9,0xb2d9f6ac
37589.04,1.0,10,2,2,3,7,0xb2d2b5f9d
300000.63,2.0,8,3,3,3,9,0xb2d9e82b
175019.78,2.0,76,3,3,1,7,0xb2d31cb1d
1569.27,1.0,10,1,2,3,6,0xb2d68412
880023.45,2.0,25,4,3,2,9,0xb2d61c4e
1307.92,1.0,24,1,2,2,5,0xb2d6588f
54896.85,2.0,56,3,3,2,8,0xb2d23608
700037.69,2.0,35,4,3,2,9,0xb2d14c88
6523.64,1.0,1,2,2,4,8,0xb2d6060ad
100170.87,2.0,8,3,3,3,9,0xb2d36c81
202243.32,2.0,25,3,3,2,8,0xb2d9301cd
2127.03,1.0,0,1,2,4,7,0xb2d78b39
1568.9,1.0,2,1,2,4,7,0xb2d8db08
28537.97,1.0,49,2,2,2,6,0xb2d39035
11724.96,1.0,0,2,2,4,8,0xb2d3568a
101996.23,2.0,3,3,3,4,10,0xb2d59a54
349.86,1.0,0,1,2,4,7,0xb2d24ac6
50287.99,2.0,38,2,3,2,7,0xb2d415b6
201421.04,2.0,68,3,3,1,7,0xb2d9afda
119693.98,2.0,38,3,3,2,8,0xb2d0d891
285524.75,1.0,4,3,2,4,9,0xb2d9308c
10432.94,1.0,0,2,2,4,8,0xb2d34826d
33067.38,1.0,92,2,2,1,5,0xb2d49d6e
200005.81,4.0,35,3,4,2,9,0xb2d78b72
84627.64,2.0,0,3,3,4,10,0xb2d1cb07
125001.32,3.0,59,3,4,2,9,0xb2d7636fd
23797.5,1.0,140,2,2,1,5,0xb2d48f97
0.0,1.0,8,1,2,3,6,0xb2d8daba
10172.18,3.0,15,2,4,3,9,0xb2d99525
544226.01,6.0,4,4,4,4,12,0xb2d5d3f7
3745.96,1.0,184,2,2,1,5,0xb2d1a6b6
520002.7,6.0,0,4,4,4,12,0xb2d408ad
95007.26,2.0,69,3,3,1,7,0xb2d6467e
7048.29,1.0,15,2,2,3,7,0xb2d41f54
1577377.07,9.0,0,4,4,4,12,0xb2d0ca84d
11.28,1.0,44,1,2,2,5,0xb2d5ebd8
183694.86,1.0,12,3,2,3,8,0xb2d25aaf
306376.35,2.0,90,4,3,1,8,0xb2d3f8c8
4318.2,1.0,1,2,2,4,8,0xb2d91cc7
53720.14,1.0,8,3,2,3,8,0xb2d47953d
16971.85,1.0,16,2,2,2,6,0xb2d90d43
320011.84,3.0,92,4,4,1,9,0xb2d77fb5
683070.98,4.0,28,4,4,2,10,0xb2d11ffe
23696.2,1.0,239,2,2,1,5,0xb2d1b1bc
50032.63,2.0,33,2,3,2,7,0xb2d9f94c
42341.1,2.0,0,2,3,4,9,0xb2d2fef3
637.54,1.0,0,1,2,4,7,0xb2d2ee1b
4241.33,2.0,184,2,3,1,6,0xb2d3b61f
283002.99,2.0,19,3,3,2,8,0xb2da2865
8602.12,1.0,4,2,2,4,8,0xb2d6bfd6
50001.47,2.0,32,2,3,2,7,0xb2d80ff0
67.59,1.0,31,1,2,2,5,0xb2d6c2d5
920060.0,4.0,16,4,4,2,10,0xb2d48fcdd
497.71,1.0,42,1,2,2,5,0xb2d19c12
366.33,1.0,5,1,2,3,6,0xb2d75b57
835137.22,4.0,3,4,4,4,12,0xb2d217e9
800061.88,3.0,37,4,4,2,10,0xb2d6de10
620006.54,4.0,6,4,4,3,11,0xb2d9a619
102069.02,2.0,28,3,3,2,8,0xb2d65d83
594767.99,5.0,6,4,4,3,11,0xb2d6cd72d
60026.18,2.0,70,3,3,1,7,0xb2d5039c
336.98,1.0,12,1,2,3,6,0xb2d7fd87
80290.17,3.0,153,3,4,1,8,0xb2d438b4
2999.04,1.0,184,2,2,1,5,0xb2d2abb3
983058.21,6.0,1,4,4,4,12,0xb2d1b044
80002.53,2.0,25,3,3,2,8,0xb2da0fc5
1800008.76,6.0,35,4,4,2,10,0xb2d59709
5267.21,1.0,1,2,2,4,8,0xb2d92329
111183.19,3.0,2,3,4,4,11,0xb2d23bb8
210045.42,4.0,137,3,4,1,8,0xb2d50922
145.01,1.0,18,1,2,2,5,0xb2d3732f
192297.98,6.0,3,3,4,4,11,0xb2d16d9a
22331.79,1.0,7,2,2,3,7,0xb2d0a42c
4098.91,1.0,20,2,2,2,6,0xb2d8ea14
61342.4,2.0,1,3,3,4,10,0xb2d60953d
392570.54,3.0,11,4,4,3,11,0xb2d1dd26
280055.44,3.0,31,3,4,2,9,0xb2d1553ed
50039.67,2.0,32,2,3,2,7,0xb2d60c4c
500000.28,2.0,26,4,3,2,9,0xb2d65ca8
186393.41,4.0,4,3,4,4,11,0xb2d1c6ec
25005.32,3.0,13,2,4,3,9,0xb2d5bcfd
3629.56,1.0,166,2,2,1,5,0xb2d2b4d2
1224076.92,8.0,69,4,4,1,9,0xb2d0630c
790659.7,4.0,92,4,4,1,9,0x3b9b3396
9033.72,1.0,15,2,2,3,7,0xb2d9cf37
1205528.23,5.0,14,4,4,3,11,0xb2d14c7a
11.92,1.0,63,1,2,2,5,0xb2d64627
10000.11,2.0,14,2,3,3,8,0xb2da3951
200012.9,2.0,92,3,3,1,7,0xb2d3a157
205.57,1.0,20,1,2,2,5,0xb2d64345
457710.54,3.0,19,4,4,2,10,0xb2d9ca3e
2381043.56,6.0,39,4,4,2,10,0xb2d1a70e
1056782.57,11.0,0,4,4,4,12,0xb2d152b9
288642.89,2.0,27,3,3,2,8,0xb2d2f861d
901850.13,10.0,0,4,4,4,12,0xb2d209a2
207360.17,1.0,182,3,2,1,6,0xb2d1a546
2029453.43,7.0,3,4,4,4,12,0xb2d06d21
482210.25,3.0,14,4,4,3,11,0xb2d23946
0.66,1.0,61,1,2,2,5,0xb2d23ee7
165639.62,4.0,0,3,4,4,11,0xb2d085ce
2200002.53,2.0,3,4,3,4,11,0xb2da3456
914.6,1.0,277,1,2,1,4,0xb2d28dd1
53742.38,2.0,39,3,3,2,8,0xb2d430c6
23231.04,1.0,133,2,2,1,5,0xb2d627f1
630037.83,2.0,19,4,3,2,9,0xb2d9bd74
3007.81,1.0,184,2,2,1,5,0xb2d4f03a
146626.53,2.0,18,3,3,2,8,0xb2d3db41
35836.67,1.0,0,2,2,4,8,0xb2d3f838
3980.61,2.0,184,2,3,1,6,0x3b9b3902d
200710.42,2.0,36,3,3,2,8,0xb2d8f342
546858.32,2.0,151,4,3,1,8,0xb2d2bc55
141.54,1.0,5,1,2,3,6,0xb2d2ec36
733.27,1.0,75,1,2,1,4,0xb2d7ce68
1452.99,1.0,92,1,2,1,4,0xb2d5ef24
208008.79,2.0,126,3,3,1,7,0xb2d2ee3a
10104.0,2.0,0,2,3,4,9,0xb2d6b54d
982303.98,7.0,5,4,4,3,11,0xb2d5af10
200042.78,2.0,9,3,3,3,9,0xb2d2baf2d
1.46,1.0,5,1,2,3,6,0xb2d6d7ef
120001.3,3.0,178,3,4,1,8,0xb2d08ddc
3821.95,1.0,0,2,2,4,8,0xb2d963ff
1162942.65,10.0,0,4,4,4,12,0xb2d2e585
121554.42,2.0,1,3,3,4,10,0xb2d2d779d
83263.86,2.0,196,3,3,1,7,0xb2d21925
24774.92,1.0,18,2,2,2,6,0xb2d5064a
640000.0,8.0,0,4,4,4,12,0xb2d20980
548631.14,2.0,76,4,3,1,8,0xb2d17626
0.11,1.0,55,1,2,2,5,0xb2d6d74b
3706.52,1.0,0,2,2,4,8,0xb2d56220
2540.03,1.0,25,1,2,2,5,0xb2d317f3
380082.91,4.0,7,4,4,3,11,0xb2d2ad43
550284.11,4.0,7,4,4,3,11,0xb2d243bcd
2662.83,1.0,10,1,2,3,6,0xb2d4557b
7259.03,1.0,46,2,2,2,6,0xb2d778a2d
1129.15,1.0,3,1,2,4,7,0xb2d53b47
8.53,1.0,25,1,2,2,5,0xb2d51e96
3714.31,1.0,0,2,2,4,8,0xb2d0d2d5
10196.65,1.0,10,2,2,3,7,0xb2d41b38d
51500.41,1.0,0,2,2,4,8,0xb2d57bbd
56865.39,1.0,14,3,2,3,8,0xb2d8db71
21563.16,2.0,74,2,3,1,6,0xb2d6b707
2478.74,1.0,15,1,2,3,6,0xb2d944e6
21110.97,3.0,0,2,4,4,10,0xb2d61542d
30000.95,2.0,10,2,3,3,8,0xb2d961d2
10.13,1.0,62,1,2,2,5,0xb2d931fb
390011.63,4.0,95,4,4,1,9,0xb2d5cf5fd
2845.59,2.0,184,1,3,1,5,0xb2d095f8d
100030.17,4.0,39,3,4,2,9,0xb2d61e34
7867.89,1.0,14,2,2,3,7,0xb2d57896
5046.66,1.0,19,2,2,2,6,0xb2d9298b
505856.14,4.0,3,4,4,4,12,0xb2d3c0b9
50001.06,2.0,92,2,3,1,6,0xb2d65af2
535673.41,5.0,7,4,4,3,11,0x3b9b1940d
4097.86,1.0,184,2,2,1,5,0xb2d2a2f8
455000.0,5.0,4,4,4,4,12,0xb2d6ad6cd
225538.51,4.0,144,3,4,1,8,0xb2d182a8
67011.79,2.0,35,3,3,2,8,0xb2d5b1ce
278014.12,3.0,161,3,4,1,8,0xb2d436b0
4963.61,1.0,133,2,2,1,5,0xb2d44a67
40007.15,2.0,89,2,3,1,6,0xb2d5f6e4d
1038.78,1.0,92,1,2,1,4,0xb2d273c0
500000.0,2.0,7,4,3,3,10,0xb2da2a07
464006.93,3.0,25,4,4,2,10,0xb2d5ff65
170005.28,4.0,13,3,4,3,10,0xb2d8df86
60044.03,3.0,0,3,4,4,11,0xb2d31ee6d
78216.64,1.0,0,3,2,4,9,0xb2d1fc3f
818.46,1.0,10,1,2,3,6,0xb2d2f11e
80000.0,1.0,4,3,2,4,9,0xb2da1a2c
22607.09,1.0,11,2,2,3,7,0xb2d68370d
199.81,1.0,4,1,2,4,7,0xb2d5b38b
5660.42,1.0,7,2,2,3,7,0xb2d21291
355104.49,2.0,108,4,3,1,8,0xb2d184a7
18001612.19,7.0,42,4,4,2,10,0xb2d07ab4
4211.98,1.0,25,2,2,2,6,0xb2d9bdb8
50080.53,2.0,6,2,3,3,8,0xb2d56374d
10.75,1.0,40,1,2,2,5,0xb2d39000
59.25,1.0,13,1,2,3,6,0xb2d2733d
5816.78,1.0,16,2,2,2,6,0xb2d1d87bd
2014.83,1.0,7,1,2,3,6,0xb2d2fd76
104344.65,4.0,59,3,4,2,9,0x3b9b24c2
815.48,6.0,27,1,4,2,7,0x3b9ae549
55509.93,2.0,116,3,3,1,7,0xb2d287a4d
15546.61,2.0,38,2,3,2,7,0xb2d5d5bfd
2115.43,1.0,92,1,2,1,4,0xb2d3466a
2033346.91,2.0,0,4,3,4,11,0xb2d6522fd
27001178.65,2.0,20,4,3,2,9,0xb2d6b682
330130.72,4.0,6,4,4,3,11,0xb2d33259
910001.0,4.0,22,4,4,2,10,0xb2d32403d
26614.91,2.0,1,2,3,4,9,0xb2d0f8bf
177021.69,5.0,41,3,4,2,9,0xb2d1db31
20001.06,2.0,41,2,3,2,7,0xb2d9e627
75.47,1.0,6,1,2,3,6,0xb2d5d5f3
6587.45,1.0,24,2,2,2,6,0xb2d40b35
198.29,1.0,20,1,2,2,5,0xb2d609f6d
5569.17,1.0,10,2,2,3,7,0xb2d94ce5
254363.37,9.0,0,3,4,4,11,0x3b9b3c39
409958.68,3.0,62,4,4,2,10,0xb2d62ca4
369.98,1.0,89,1,2,1,4,0xb2d1db77
1.4,1.0,19,1,2,2,5,0xb2d77f1b
1040.27,1.0,10,1,2,3,6,0xb2d430f0
322108.76,3.0,8,4,4,3,11,0xb2d0827cd
38097.18,18.0,0,2,4,4,10,0x3b9af113
180035.48,4.0,34,3,4,2,9,0xb2d57ab4
5654.77,1.0,14,2,2,3,7,0xb2d6980f
7000101.87,1.0,0,4,2,4,10,0xb2d41042
337088.26,3.0,27,4,4,2,10,0xb2d23ae1
317275.92,3.0,1,4,4,4,12,0xb2d3a2a3d
367090.89,5.0,8,4,4,3,11,0xb2d614e0d
2783.62,1.0,22,1,2,2,5,0xb2d30b6f
461452.89,56.0,1,4,4,4,12,0xb2d3fe34
211095.66,2.0,6,3,3,3,9,0xb2d2910c
500001.05,10.0,0,4,4,4,12,0xb2d61162d
735000.81,4.0,0,4,4,4,12,0xb2d5e38b
1094.54,1.0,184,1,2,1,4,0xb2d2df6ad
4059.25,1.0,31,2,2,2,6,0xb2d17508d
60225.61,2.0,187,3,3,1,7,0xb2d69386
4655.6,1.0,92,2,2,1,5,0xb2d18acfd
10000.0,2.0,1,2,3,4,9,0xb2d6931f
56000.0,6.0,4,3,4,4,11,0xb2d1c58e
150001.58,2.0,35,3,3,2,8,0xb2d9f97b
2106.69,1.0,0,1,2,4,7,0xb2d599b8
370010.33,6.0,0,4,4,4,12,0x3b9af0fe
66342.9,1.0,280,3,2,1,6,0xb2d3a5c3
284.84,1.0,9,1,2,3,6,0xb2d53762
1058.64,1.0,184,1,2,1,4,0xb2d62c0f
482591.76,5.0,1,4,4,4,12,0xb2d06b8c
850006.27,6.0,15,4,4,3,11,0xb2d68700
5148.3,1.0,184,2,2,1,5,0xb2d12078
60038.81,3.0,5,3,4,3,10,0xb2d56165
402227.83,2.0,0,4,3,4,11,0xb2d19192
1200152.78,3.0,23,4,4,2,10,0xb2d69084
4799.21,1.0,11,2,2,3,7,0xb2d935d2
95821.68,1.0,22,3,2,2,7,0xb2d4711cd
969783.16,1.0,184,4,2,1,7,0xb2d15582
49977.91,4.0,0,2,4,4,10,0xb2d5b893d
2044.38,1.0,15,1,2,3,6,0xb2d5ef21
300000.06,2.0,9,3,3,3,9,0xb2d64a6d
2807.9,2.0,92,1,3,1,5,0xb2d115c7d
10403.37,1.0,4,2,2,4,8,0xb2d19665d
41541.57,1.0,0,2,2,4,8,0xb2d0e8dcd
100003.17,2.0,10,3,3,3,9,0xb2d96114
56.78,1.0,6,1,2,3,6,0xb2d94499
3042.02,1.0,184,2,2,1,5,0xb2d2a9d9
1175019.33,22.0,13,4,4,3,11,0xb2d2022ed
1123712.48,4.0,1,4,4,4,12,0xb2d3c731
10694.23,1.0,35,2,2,2,6,0xb2d0f948
12074.92,1.0,9,2,2,3,7,0xb2d3706f
93.37,2.0,29,1,3,2,6,0xb2d9786bd
50076.67,1.0,1,2,2,4,8,0x3b9b3b14
241095.64,3.0,19,3,4,2,9,0xb2d1309dd
200.38,1.0,14,1,2,3,6,0xb2d9c091
846076.41,6.0,1,4,4,4,12,0xb2d12f55
0.0,1.0,0,1,2,4,7,0xb2d26675d
10079.01,1.0,184,2,2,1,5,0xb2d385fa
10000.21,2.0,11,2,3,3,8,0xb2da434f
31.67,1.0,60,1,2,2,5,0xb2d75759
300000.0,2.0,22,3,3,2,8,0xb2da214b
80049.25,2.0,136,3,3,1,7,0xb2d3f546
73926.1,2.0,83,3,3,1,7,0xb2d24696
359.49,1.0,10,1,2,3,6,0xb2d9419e
4450.19,1.0,12,2,2,3,7,0xb2d2c1c4
930064.57,5.0,4,4,4,4,12,0xb2d8fec8d
96.84,1.0,1,1,2,4,7,0xb2d98498
43572.14,4.0,0,2,4,4,10,0xb2d2112d
290022.79,3.0,9,3,4,3,10,0xb2d63535
200000.72,2.0,15,3,3,3,9,0xb2d6f592
1176.18,2.0,0,1,3,4,8,0xb2d08d8a
364408.55,2.0,25,4,3,2,9,0xb2d57c47
164000.48,7.0,4,3,4,4,11,0xb2d3a945
6801.43,1.0,25,2,2,2,6,0xb2d9447dd
151367.73,1.0,9,3,2,3,8,0xb2d41d52d
290753.7,3.0,2,3,4,4,11,0xb2d6a2b2
10402.66,1.0,0,2,2,4,8,0xb2d5570ed
2161.75,1.0,8,1,2,3,6,0xb2d5c950
1496599.94,11.0,1,4,4,4,12,0xb2d578f3d
240275.17,2.0,0,3,3,4,10,0xb2d14c95
50002.64,2.0,111,2,3,1,6,0xb2d94d83
17420.04,1.0,2,2,2,4,8,0xb2d36af5
500010.16,2.0,14,4,3,3,10,0xb2d9203e
2070.31,1.0,1,1,2,4,7,0xb2d78332
43387.73,2.0,0,2,3,4,9,0x3b9af205
500012.4,3.0,1,4,4,4,12,0xb2d7094c
420000.0,79.0,8,4,4,3,11,0xb2d23940
28277.54,1.0,171,2,2,1,5,0xb2d26e72
450007.37,3.0,15,4,4,3,11,0xb2d95d25
0.0,1.0,8,1,2,3,6,0xb2d0d62cd
150217.05,2.0,0,3,3,4,10,0xb2d636dcd
734.88,1.0,0,1,2,4,7,0xb2d2e64c
261847.46,2.0,75,3,3,1,7,0xb2d5c82d
741170.59,1.0,5,4,2,3,9,0xb2d1df25
80000.0,7.0,3,3,4,4,11,0xb2d1941fd
631540.91,6.0,25,4,4,2,10,0xb2d0893f
36729.31,2.0,0,2,3,4,9,0xb2d6e45ed
19.0,1.0,38,1,2,2,5,0xb2d90278
192.99,1.0,20,1,2,2,5,0xb2d23e11
4820.7,1.0,103,2,2,1,5,0xb2d4682a
820030.35,6.0,0,4,4,4,12,0xb2d64f7fd
126127.59,2.0,83,3,3,1,7,0xb2d41649d
9385.07,1.0,13,2,2,3,7,0xb2d5974ed
3346.95,1.0,10,2,2,3,7,0xb2d6f1a4
4147.84,1.0,1,2,2,4,8,0xb2d5a6a9
100005.45,3.0,11,3,4,3,10,0xb2d5122c
200002.62,2.0,20,3,3,2,8,0xb2d69271
7384000.35,5.0,9,4,4,3,11,0xb2d19200
606112.14,4.0,18,4,4,2,10,0xb2d56071
2667.1,1.0,92,1,2,1,4,0xb2d4878c
75927.51,2.0,4,3,3,4,10,0xb2d0bd58
700000.0,2.0,1,4,3,4,11,0xb2d0f8b8
94629.44,8.0,0,3,4,4,11,0x3b9b1802
820010.14,3.0,0,4,4,4,12,0xb2d8ea6d
500000.45,2.0,26,4,3,2,9,0xb2d9ef0a
53963.32,2.0,6,3,3,3,9,0xb2d3313ed
202003.21,3.0,92,3,4,1,8,0xb2d637a5
50355.24,1.0,92,2,2,1,5,0xb2d39f89
10000.53,2.0,48,2,3,2,7,0xb2d9d3e3
2747.91,1.0,0,1,2,4,7,0xb2d551e8d
17.55,1.0,8,1,2,3,6,0xb2d34ccd
2000226.72,4.0,14,4,4,3,11,0xb2d0b79ed
248.41,1.0,70,1,2,1,4,0xb2d11298
215649.75,2.0,3,3,3,4,10,0x3b9b0e33
213279.07,2.0,122,3,3,1,7,0xb2d32830d
102434.85,3.0,52,3,4,2,9,0xb2d5201b
121061.46,2.0,27,3,3,2,8,0xb2d0d891d
200026.29,2.0,1,3,3,4,10,0xb2d9aa8c
5422.02,1.0,9,2,2,3,7,0xb2d8efcbd
300003.17,2.0,83,3,3,1,7,0xb2d8d099
500005.53,3.0,2,4,4,4,12,0xb2d90707
2071443.44,6.0,35,4,4,2,10,0xb2d1a891
440068.6,3.0,21,4,4,2,10,0xb2d8e66a
410361.58,2.0,235,4,3,1,8,0xb2d440e7
100002.11,2.0,189,3,3,1,7,0xb2d84eeed
200108.36,6.0,0,3,4,4,11,0xb2d0e908
921443.04,3.0,53,4,4,2,10,0xb2d68324
123318.3,3.0,60,3,4,2,9,0xb2d3cea3
311092.73,4.0,27,4,4,2,10,0xb2d5346b
500002.1,2.0,24,4,3,2,9,0xb2d94aa8
670.62,3.0,0,1,4,4,9,0x3b9b18dfd
412066.97,3.0,1,4,4,4,12,0xb2d8f5f2d
1016.33,1.0,92,1,2,1,4,0xb2d0c1ce
504099.94,4.0,15,4,4,3,11,0xb2d5793fd
420.5,2.0,3,1,3,4,8,0xb2d0d129
1901.93,1.0,52,1,2,2,5,0xb2d28d7dd
154431.22,10.0,6,3,4,3,10,0x3b9af518d
10000.53,2.0,188,2,3,1,6,0xb2d6a482
101151.94,3.0,108,3,4,1,8,0xb2d2b08b
20005.1,1.0,9,2,2,3,7,0xb2d6eef3
180001.9,3.0,6,3,4,3,10,0xb2d8dcca
0.09,1.0,37,1,2,2,5,0xb2d1b8f5d
623295.1,4.0,0,4,4,4,12,0xb2d2e784
74343.48,1.0,5,3,2,3,8,0xb2d30fd5
3092.11,1.0,10,2,2,3,7,0xb2d7c404
9.54,1.0,83,1,2,1,4,0xb2d59071
702378.33,3.0,6,4,4,3,11,0xb2d45ab5
101.7,1.0,11,1,2,3,6,0xb2da486b
506102.93,2.0,83,4,3,1,8,0xb2d0d2c3
100032.76,3.0,14,3,4,3,10,0xb2d11490
2945.0,1.0,149,2,2,1,5,0xb2d213f3
88789.86,2.0,92,3,3,1,7,0xb2d5a698
284281.22,3.0,27,3,4,2,9,0xb2d27353
5366.9,1.0,11,2,2,3,7,0xb2d267e4
4777.14,1.0,92,2,2,1,5,0xb2d29cffd
500006.33,3.0,3,4,4,4,12,0xb2d8fd8b
0.0,1.0,14,1,2,3,6,0xb2d0f3b2
51493.74,2.0,104,2,3,1,6,0xb2d5aaba
5731.45,1.0,12,2,2,3,7,0xb2d0d07a
130160.33,6.0,1,3,4,4,11,0xb2d5d5a6
7.33,1.0,10,1,2,3,6,0xb2d6b761
420000.0,3.0,4,4,4,4,12,0xb2da5d08
135063.45,4.0,47,3,4,2,9,0xb2d3e744
7045.43,1.0,284,2,2,1,5,0xb2d65593
185001.33,2.0,0,3,3,4,10,0xb2d62f41d
1297131.08,6.0,1,4,4,4,12,0xb2d2e35b
1266575.94,40.0,1,4,4,4,12,0xb2d3f1a3
200063.57,2.0,164,3,3,1,7,0xb2d65beb
56060.24,2.0,27,3,3,2,8,0xb2d11fcd
620016.36,9.0,0,4,4,4,12,0xb2d0db64
6959.49,1.0,225,2,2,1,5,0xb2d6ec47d
321973.72,4.0,0,4,4,4,12,0xb2d38ddcd
226.11,1.0,25,1,2,2,5,0xb2d24e5e
2546.06,1.0,184,1,2,1,4,0xb2d156e9d
260016.39,2.0,14,3,3,3,9,0xb2d25a5c
2375.17,1.0,7,1,2,3,6,0xb2d4582d
5024.31,1.0,13,2,2,3,7,0xb2d69fd6
391029.89,6.0,3,4,4,4,12,0xb2d6b6f6
310083.0,2.0,27,4,3,2,9,0xb2d22d9c
4012.48,1.0,29,2,2,2,6,0xb2d6e0e3
2222.68,1.0,104,1,2,1,4,0xb2d38c85
417953.03,5.0,0,4,4,4,12,0xb2d3a289
300178.5,2.0,31,4,3,2,9,0xb2d91ec5
202004.64,3.0,136,3,4,1,8,0xb2d22c3d
1250040.94,7.0,62,4,4,2,10,0xb2d0d400
252664.84,2.0,97,3,3,1,7,0xb2d624fdd
310003.27,2.0,18,4,3,2,9,0xb2d957ab
45.28,1.0,76,1,2,1,4,0xb2d75abc
18643.98,1.0,14,2,2,3,7,0xb2d6cf06
329079.83,4.0,76,4,4,1,9,0xb2d5b35d
1963.88,1.0,1,1,2,4,7,0xb2d261b0
15000.48,2.0,80,2,3,1,6,0xb2d8d430
12362.93,1.0,5,2,2,3,7,0xb2d8f89e
5235.36,1.0,13,2,2,3,7,0xb2d78ceb
1403151.55,2.0,92,4,3,1,8,0xb2d0de7d
5511.3,1.0,2,2,2,4,8,0xb2d95276
4082.26,1.0,0,2,2,4,8,0xb2d64fff
177547.79,3.0,1,3,4,4,11,0xb2d25a1d
6282.96,1.0,184,2,2,1,5,0xb2d14e4e
5739.89,1.0,9,2,2,3,7,0xb2d7898e
111884.82,2.0,139,3,3,1,7,0xb2d629d5
2123.2,1.0,184,1,2,1,4,0xb2d11065
255267.43,5.0,139,3,4,1,8,0xb2d17f52d
100001.06,2.0,193,3,3,1,7,0xb2d81d7a
1683.73,1.0,113,1,2,1,4,0xb2d5f934
492743.21,8.0,8,4,4,3,11,0xb2d78f3d
105243.89,1.0,3,3,2,4,9,0xb2d55ea8
18242.07,4.0,0,2,4,4,10,0xb2d064cd
311949.17,3.0,25,4,4,2,10,0xb2d08468
564.65,1.0,42,1,2,2,5,0xb2d8fc82
363883.11,4.0,3,4,4,4,12,0xb2d6ac48
3655.76,1.0,18,2,2,2,6,0xb2d6b69f
123597.57,1.0,91,3,2,1,6,0xb2d415bd
220995.38,6.0,1,3,4,4,11,0xb2d07b76d
12.36,1.0,0,1,2,4,7,0xb2d636e5
309125.63,1.0,202,4,2,1,7,0xb2d50252
200000.0,2.0,15,3,3,3,9,0xb2da3915
60095.18,1.0,69,3,2,1,6,0xb2d41b9bd
4670.4,1.0,0,2,2,4,8,0xb2d1eff2
220774.99,7.0,0,3,4,4,11,0x3b9b3891d
100017.6,2.0,4,3,3,4,10,0xb2d93211
63383.75,3.0,1,3,4,4,11,0x3b9b17e6
520695.36,4.0,46,4,4,2,10,0xb2d19ba3d
315149.4,25.0,0,4,4,4,12,0x3b9ae50f
35.97,1.0,0,1,2,4,7,0xb2d3ebe0
15437.14,1.0,0,2,2,4,8,0xb2d8ebb7
5150.35,1.0,1,2,2,4,8,0xb2d67d75
31926.45,1.0,9,2,2,3,7,0xb2d6ec4f
6893.94,1.0,0,2,2,4,8,0xb2d6aca9
2.67,1.0,67,1,2,1,4,0xb2d6cbd1
2637119.54,13.0,6,4,4,3,11,0xb2d4fc98
20221.56,2.0,63,2,3,2,7,0xb2d8d782
420013.26,6.0,34,4,4,2,10,0xb2d90e69
190104.33,3.0,77,3,4,1,8,0xb2d4381d
191983.84,4.0,10,3,4,3,10,0xb2d0f8a7
12.35,1.0,67,1,2,1,4,0xb2d9b027
1555395.79,3.0,34,4,4,2,10,0xb2d54946d
21.73,1.0,18,1,2,2,5,0xb2d87e0d
19561.03,1.0,92,2,2,1,5,0xb2d1204b
744.89,1.0,4,1,2,4,7,0xb2d24681
17902.4,1.0,3,2,2,4,8,0xb2d2ede4
51046.75,2.0,25,2,3,2,7,0xb2d65e58
1000002.08,2.0,25,4,3,2,9,0xb2d9cde2
300004.38,3.0,1,3,4,4,11,0xb2d2b146d
1012.78,1.0,92,1,2,1,4,0xb2d34575d
55095.65,2.0,116,3,3,1,7,0xb2d2fc7a
33.83,1.0,81,1,2,1,4,0xb2d2b398
320214.96,3.0,32,4,4,2,10,0xb2d94336
30419.03,2.0,18,2,3,2,7,0xb2d550c2
990.72,2.0,81,1,3,1,5,0xb2d2f78b
1006438.03,3.0,0,4,4,4,12,0xb2d958d6
3770.03,1.0,184,2,2,1,5,0xb2d3fb28
452051.24,3.0,0,4,4,4,12,0xb2d644d7
494061.0,4.0,97,4,4,1,9,0x3b9b2a61
1868.73,3.0,90,1,4,1,6,0x3b9b498b
200000.0,2.0,22,3,3,2,8,0xb2da2373
341029.28,3.0,7,4,4,3,11,0xb2d65954
1927067.23,5.0,3,4,4,4,12,0xb2d2fb43d
1007113.98,3.0,41,4,4,2,10,0xb2d6fe2f
10.21,1.0,24,1,2,2,5,0xb2d17caa
55667.0,1.0,18,3,2,2,7,0xb2d69f29
762856.02,2.0,38,4,3,2,9,0xb2d1626fd
473.28,1.0,69,1,2,1,4,0xb2d308dc
120009.1,3.0,80,3,4,1,8,0xb2d076c5
2638.55,1.0,9,1,2,3,6,0xb2d4557bd
300000.84,2.0,12,3,3,3,9,0xb2d3a836
682.08,2.0,2,1,3,4,8,0xb2d2eb75
241690.27,6.0,11,3,4,3,10,0xb2d0b857
1434.51,1.0,15,1,2,3,6,0xb2d263f5
200493.04,2.0,16,3,3,2,8,0xb2d25e31
511002.34,4.0,1,4,4,4,12,0xb2d57df7d
246000.0,14.0,0,3,4,4,11,0xb2d55d7f
10983.36,1.0,8,2,2,3,7,0xb2d535e7
41943.14,1.0,2,2,2,4,8,0xb2d303f9
10357.14,1.0,7,2,2,3,7,0xb2d2f209
100047.41,2.0,189,3,3,1,7,0xb2d26c14
6098.97,2.0,184,2,3,1,6,0xb2d194f7
61.31,1.0,1,1,2,4,7,0xb2d6dd97
46601.71,4.0,59,2,4,2,8,0xb2d564c7d
5113.85,1.0,92,2,2,1,5,0xb2d291d9d
420709.88,4.0,3,4,4,4,12,0xb2d91464
3.17,1.0,81,1,2,1,4,0xb2d681fe
30.81,1.0,9,1,2,3,6,0xb2d138be
503552.47,2.0,61,4,3,2,9,0xb2d9bf6b
164089.51,3.0,1,3,4,4,11,0xb2d37a60
200010.55,3.0,10,3,4,3,10,0xb2d294a6
148886.43,1.0,0,3,2,4,9,0xb2d22426d
201251.9,2.0,18,3,3,2,8,0xb2d5d0d8
34.31,1.0,41,1,2,2,5,0xb2d9932c
53866.38,2.0,62,3,3,2,8,0xb2d3802a
53.91,1.0,65,1,2,2,5,0xb2d3050d
90099.99,2.0,1,3,3,4,10,0xb2d534b3d
7.26,1.0,43,1,2,2,5,0xb2d8d100
1000038.02,1.0,0,4,2,4,10,0xb2d682fc
601552.2,5.0,25,4,4,2,10,0xb2d76474
683958.51,27.0,1,4,4,4,12,0x3b9b3114
1038.59,1.0,10,1,2,3,6,0xb2d2cd72d
306103.93,3.0,76,4,4,1,9,0xb2d6085a
2049.62,1.0,10,1,2,3,6,0xb2d3e97a
220395.97,3.0,62,3,4,2,9,0xb2d58b87
70000.74,2.0,13,3,3,3,9,0xb2d95e38
83183.15,1.0,0,3,2,4,9,0xb2d3903fd
100004.97,3.0,10,3,4,3,10,0xb2d61c1f
166942.91,2.0,229,3,3,1,7,0xb2d40e54
710243.0,2.0,0,4,3,4,11,0xb2d6bc75
587000.0,2.0,0,4,3,4,11,0xb2d7f1d3
28250.4,1.0,79,2,2,1,5,0xb2d26e72d
32.47,1.0,48,1,2,2,5,0xb2d615ead
50000.53,2.0,21,2,3,2,7,0xb2da2109
600038.11,5.0,15,4,4,3,11,0xb2d5b016
171265.8,3.0,70,3,4,1,8,0xb2d62b64
65.01,1.0,20,1,2,2,5,0xb2d177a5
58451.87,2.0,59,3,3,2,8,0xb2d12bf6
200000.0,2.0,7,3,3,3,9,0xb2d970fa
200710.55,2.0,58,3,3,2,8,0xb2d902a9d
149103.24,1.0,1,3,2,4,9,0xb2d9b86a
600623.7,7.0,0,4,4,4,12,0xb2d0ea7fd
700000.01,6.0,4,4,4,4,12,0x3b9b182f
120199.0,1.0,0,3,2,4,9,0xb2da6b48
647422.84,6.0,1,4,4,4,12,0xb2d11d8a
5061.42,1.0,92,2,2,1,5,0xb2d2872e
100222.22,2.0,26,3,3,2,8,0xb2d57695
234.11,1.0,77,1,2,1,4,0xb2d42442d
5.09,1.0,9,1,2,3,6,0xb2d90cb0
1270013.41,2.0,21,4,3,2,9,0xb2da238d
8259.77,1.0,39,2,2,2,6,0xb2d560a5
3871.43,1.0,92,2,2,1,5,0xb2d41538
88.18,1.0,6,1,2,3,6,0xb2d621f2
428070.16,5.0,0,4,4,4,12,0xb2d100a6
93000.98,3.0,77,3,4,1,8,0xb2d8f200d
264077.53,3.0,0,3,4,4,11,0xb2d64b6b
2945.9,1.0,163,2,2,1,5,0xb2d8d670
42.23,2.0,60,1,3,2,6,0xb2d12551
500864.91,4.0,30,4,4,2,10,0xb2d550d4d
38.63,1.0,67,1,2,1,4,0xb2d9a9ad
12313.37,1.0,92,2,2,1,5,0xb2d070ab
500045.88,4.0,5,4,4,3,11,0xb2d56cf7
10000.11,2.0,38,2,3,2,7,0xb2d92ca1d
801776.04,3.0,9,4,4,3,11,0xb2d92d71
820.89,2.0,92,1,3,1,5,0xb2d18ad4
250118.32,2.0,92,3,3,1,7,0xb2d6269c
52487.08,2.0,20,3,3,2,8,0xb2d49fc2d
179.35,1.0,10,1,2,3,6,0xb2d9e278
2992.28,1.0,5,2,2,3,7,0xb2d25c24
1272403.22,5.0,31,4,4,2,10,0xb2d4de9c
140092.01,5.0,3,3,4,4,11,0xb2d3beda
261496.57,2.0,0,3,3,4,10,0xb2d302f3
111.3,1.0,1,1,2,4,7,0xb2d9af03
1634.0,1.0,184,1,2,1,4,0xb2d0786d
182411.56,11.0,0,3,4,4,11,0xb2d5a7abd
4358.83,1.0,7,2,2,3,7,0xb2d91f98
31569.33,9.0,0,2,4,4,10,0x3b9af2ca
1.76,1.0,32,1,2,2,5,0xb2d407da
6103.23,1.0,7,2,2,3,7,0xb2d6b5a8
510226.85,9.0,0,4,4,4,12,0xb2d515e8
1282.23,1.0,58,1,2,2,5,0xb2d30809
308620.22,3.0,25,4,4,2,10,0xb2d24c10
1623.89,1.0,9,1,2,3,6,0xb2d4fdc2
27.23,1.0,78,1,2,1,4,0xb2d945af
10105.64,2.0,6,2,3,3,8,0xb2d937d9d
54165.74,2.0,39,3,3,2,8,0xb2d16a71d
100.17,1.0,45,1,2,2,5,0xb2d36e49
27479.94,1.0,4,2,2,4,8,0xb2d8dd12
19.6,1.0,41,1,2,2,5,0xb2d19d55
280000.0,2.0,25,3,3,2,8,0xb2da1c19
997806.97,7.0,60,4,4,2,10,0xb2d1b5a9
47334.87,1.0,0,2,2,4,8,0xb2d4f57f
85598.39,1.0,4,3,2,4,9,0xb2d435a3
260013.38,3.0,70,3,4,1,8,0xb2d58e47
50543.39,1.0,0,2,2,4,8,0xb2d517e3
1292.8,1.0,0,1,2,4,7,0xb2d54f49
529051.12,1.0,7,4,2,3,9,0xb2d57bdd
371849.16,3.0,0,4,4,4,12,0xb2d3a629
1201.21,1.0,28,1,2,2,5,0xb2d21bf9
1030105.97,2.0,87,4,3,1,8,0xb2d44d78d
132923.97,2.0,164,3,3,1,7,0xb2d08912
254376.6,3.0,11,3,4,3,10,0xb2d416a7
1029508.51,1.0,0,4,2,4,10,0xb2d42f4b
6057.69,1.0,92,2,2,1,5,0xb2d24fb2
1200037.6,4.0,10,4,4,3,11,0xb2d68f0ed
7290.46,1.0,4,2,2,4,8,0xb2d331f8
1098516.68,3.0,0,4,4,4,12,0xb2d101a6
253000.0,4.0,58,3,4,2,9,0xb2d289a6
5058.55,1.0,0,2,2,4,8,0xb2d74537
0.09,2.0,5,1,3,3,7,0xb2d3c2a6
55277.79,2.0,20,3,3,2,8,0xb2d39a14
1986.51,1.0,92,1,2,1,4,0xb2d36927d
480.35,1.0,19,1,2,2,5,0xb2d69a7b
612347.17,6.0,24,4,4,2,10,0xb2d62a18
180037.73,3.0,24,3,4,2,9,0xb2d451b5
40512.95,1.0,14,2,2,3,7,0xb2d334a9
14074.98,2.0,2,2,3,4,9,0xb2d311a8
783406.41,2.0,0,4,3,4,11,0xb2d17bd8
586.44,1.0,0,1,2,4,7,0xb2d478eb
10051.62,1.0,184,2,2,1,5,0xb2d5558a
1212.2,1.0,140,1,2,1,4,0xb2d4cdf6d
700173.02,2.0,7,4,3,3,10,0xb2d8ec9f
5058.43,1.0,184,2,2,1,5,0xb2d2432a
25.81,1.0,9,1,2,3,6,0xb2d6ab38
7270.03,1.0,184,2,2,1,5,0xb2d1197dd
347251.47,2.0,30,4,3,2,9,0xb2d3bf36d
580188.15,4.0,0,4,4,4,12,0xb2d2d243d
101560.71,2.0,13,3,3,3,9,0xb2d6574bd
61273.23,2.0,20,3,3,2,8,0xb2d427a0
97.13,2.0,77,1,3,1,5,0xb2d52ad9
50001.06,2.0,33,2,3,2,7,0xb2d962ed
704.61,1.0,6,1,2,3,6,0xb2d6be48
63358.85,1.0,15,3,2,3,8,0xb2d2fd20
110005.22,2.0,63,3,3,2,8,0xb2d0ffa0d
134082.35,3.0,3,3,4,4,11,0xb2d116cf
3041.35,1.0,0,2,2,4,8,0xb2d53f45d
4556.94,1.0,93,2,2,1,5,0xb2d55ac9
524560.51,12.0,5,4,4,3,11,0xb2d29f06
498369.92,4.0,21,4,4,2,10,0xb2d3c653
1460.01,1.0,0,1,2,4,7,0xb2d6fbe5
162277.63,5.0,14,3,4,3,10,0xb2d0e74d
31298.47,1.0,2,2,2,4,8,0xb2d8cea8
94037.74,5.0,0,3,4,4,11,0xb2d1a04e
501878.1,3.0,33,4,4,2,10,0xb2d9feb2
400010.42,3.0,8,4,4,3,11,0xb2d9f5fc
5.78,1.0,16,1,2,2,5,0xb2d9267a
4222.66,1.0,12,2,2,3,7,0xb2d91240d
470005.7,3.0,18,4,4,2,10,0xb2d9521cd
641009.61,19.0,1,4,4,4,12,0xb2d60570d
126000.0,8.0,4,3,4,4,11,0xb2d92b33
13932.79,1.0,16,2,2,2,6,0xb2d787a5
10251.73,2.0,34,2,3,2,7,0xb2d63f79
10028.61,2.0,0,2,3,4,9,0xb2d91247
401343.7,3.0,29,4,4,2,10,0xb2d3c595d
45273.68,2.0,235,2,3,1,6,0xb2d6202c
100000.0,2.0,6,3,3,3,9,0xb2da51d6
232292.88,2.0,6,3,3,3,9,0xb2d4a9dbd
786886.72,28.0,1,4,4,4,12,0x3b9b17f4
5066.28,1.0,184,2,2,1,5,0xb2d2872ed
86793.69,2.0,3,3,3,4,10,0xb2d5de97
1405.96,1.0,2,1,2,4,7,0xb2d0d7db
1599631.8,2.0,15,4,3,3,10,0xb2d1bf0e
83753.3,2.0,0,3,3,4,10,0xb2d8d98ad
2689.66,1.0,92,1,2,1,4,0xb2d0adbb
837.84,1.0,23,1,2,2,5,0xb2d11ba7d
3281.0,1.0,60,2,2,2,6,0xb2d16116d
10.58,1.0,6,1,2,3,6,0xb2d15c27d
20063.97,2.0,3,2,3,4,9,0xb2d178a2
42213.73,1.0,10,2,2,3,7,0xb2d3ea1b
360000.01,6.0,96,4,4,1,9,0xb2d5a506
621.44,1.0,0,1,2,4,7,0xb2d2b07c
550032.61,7.0,11,4,4,3,11,0xb2d54d23
72.97,1.0,85,1,2,1,4,0xb2d2de4a
480.04,1.0,65,1,2,2,5,0xb2d0cbcb
233674.93,3.0,94,3,4,1,8,0xb2d5d954
400000.55,7.0,8,4,4,3,11,0x3b9af18a
452366.5,4.0,3,4,4,4,12,0xb2d7aae4
2609.59,1.0,8,1,2,3,6,0xb2d221ba
240.27,2.0,54,1,3,2,6,0xb2d4f7f1
260002.74,2.0,70,3,3,1,7,0xb2d9a63e
1.54,1.0,3,1,2,4,7,0xb2d6d0a5
200004.47,2.0,11,3,3,3,9,0xb2d79119
50099.18,2.0,118,2,3,1,6,0xb2d6cf91
1800.84,1.0,127,1,2,1,4,0xb2d3262c
2261.36,1.0,92,1,2,1,4,0xb2d2cd33
5849.78,1.0,7,2,2,3,7,0xb2d56d8f
152.0,1.0,28,1,2,2,5,0xb2d8d030
29365.83,1.0,2,2,2,4,8,0xb2d769e3
45005.78,2.0,32,2,3,2,7,0xb2d8f4b4
500005.28,2.0,66,4,3,2,9,0xb2d8f1ddd
86.18,1.0,12,1,2,3,6,0xb2d2860a
1572.65,1.0,16,1,2,2,5,0xb2d30524
48701.97,1.0,7,2,2,3,7,0xb2d2b5f7
200098.03,2.0,4,3,3,4,10,0xb2d6e118
4126.81,1.0,0,2,2,4,8,0xb2d5aec8
3490.29,1.0,0,2,2,4,8,0xb2d5d2a9
1308011.61,4.0,0,4,4,4,12,0xb2d8cabd
172059.9,4.0,5,3,4,3,10,0xb2d4babed
90604.88,1.0,20,3,2,2,7,0xb2d56834
2022.33,1.0,92,1,2,1,4,0xb2d24b87
45964.31,1.0,11,2,2,3,7,0xb2d6f627d
1.65,1.0,10,1,2,3,6,0xb2d6b095
202841.29,2.0,21,3,3,2,8,0xb2d30a9f
2014.21,1.0,184,1,2,1,4,0xb2d6115c
483043.03,3.0,52,4,4,2,10,0xb2d0de61
2873.91,1.0,0,1,2,4,7,0xb2d3828b
160400.77,5.0,0,3,4,4,11,0xb2d1bae6d
470006.64,5.0,1,4,4,4,12,0xb2d43385
66002.2,2.0,32,3,3,2,8,0xb2d5d5aad
5.64,1.0,50,1,2,2,5,0xb2d8dc64d
10443.37,1.0,0,2,2,4,8,0xb2d5ec63d
89.22,1.0,2,1,2,4,7,0xb2d5787b
1335.18,1.0,184,1,2,1,4,0x3b9af5a2
170008.35,4.0,13,3,4,3,10,0xb2d6ef45
60009.29,2.0,4,3,3,4,10,0xb2d6f4d6d
1000574.8,3.0,15,4,4,3,11,0xb2d1fcd4
44161.08,4.0,3,2,4,4,10,0xb2d5e2f4d
661.43,1.0,55,1,2,2,5,0xb2d1723c
10023.64,1.0,9,2,2,3,7,0xb2d78bbdd
20025.08,3.0,59,2,4,2,8,0xb2d6f8b5d
25.3,1.0,1,1,2,4,7,0xb2d68e7d
25199.45,2.0,132,2,3,1,6,0xb2d6920d
730000.0,7.0,3,4,4,4,12,0xb2d22293
81680.85,2.0,4,3,3,4,10,0xb2d6d53cd
13.59,1.0,14,1,2,3,6,0xb2d925ca
102829.69,3.0,74,3,4,1,8,0xb2d52283
390860.84,2.0,144,4,3,1,8,0xb2d576e0
50001.06,2.0,92,2,3,1,6,0xb2d97f4ed
29688.17,1.0,10,2,2,3,7,0xb2d5d481d
200375.28,2.0,45,3,3,2,8,0xb2d310f6
1364.15,1.0,211,1,2,1,4,0xb2d632b8
3.72,1.0,48,1,2,2,5,0xb2d574afd
109933.87,2.0,167,3,3,1,7,0xb2d2a7c9
51494.21,2.0,196,2,3,1,6,0xb2d5ae4b
5750710.84,34.0,1,4,4,4,12,0xb2d7fce3
550000.01,3.0,11,4,4,3,11,0xb2d6fc0b
1.5,1.0,17,1,2,2,5,0xb2d2aef4
121714.76,3.0,3,3,4,4,11,0xb2d5e618
1003.93,1.0,92,1,2,1,4,0xb2d147d2
1353.18,1.0,184,1,2,1,4,0xb2d294c7
65347.24,3.0,0,3,4,4,11,0xb2d20175
4748.33,1.0,15,2,2,3,7,0xb2d08536
62.51,1.0,0,1,2,4,7,0xb2d689fe
1.5,1.0,27,1,2,2,5,0xb2d5b84b
500032.44,2.0,5,4,3,3,10,0xb2d681f4
20000.0,3.0,3,2,4,4,10,0xb2d96d06
8977.99,1.0,92,2,2,1,5,0xb2d2af25
20602.92,3.0,1,2,4,4,10,0xb2d9782b
500069.67,3.0,4,4,4,4,12,0xb2d8c73f
3447.72,1.0,0,2,2,4,8,0xb2d69b3a
301066.63,2.0,18,4,3,2,9,0xb2d1d942
8081.37,1.0,184,2,2,1,5,0xb2d2a893
4315.64,1.0,92,2,2,1,5,0xb2d31fb4
176269.89,1.0,184,3,2,1,6,0xb2d40a45
100003.17,2.0,143,3,3,1,7,0xb2d6e68a
326.09,1.0,116,1,2,1,4,0xb2d5d69fd
103092.73,3.0,2,3,4,4,11,0xb2d1637d
12033.99,1.0,10,2,2,3,7,0xb2d53c36
14561.52,1.0,11,2,2,3,7,0xb2d959dc
210.65,1.0,2,1,2,4,7,0xb2d56220d
33966.59,1.0,0,2,2,4,8,0xb2d642b2
200000.0,2.0,6,3,3,3,9,0xb2da5955
132140.66,2.0,1,3,3,4,10,0xb2d221d4
105.43,1.0,51,1,2,2,5,0xb2d573cf
751855.38,3.0,23,4,4,2,10,0xb2d9897a
2306.02,1.0,146,1,2,1,4,0xb2d64a9f
2068.59,1.0,0,1,2,4,7,0xb2d3d3c6d
300015.85,2.0,188,3,3,1,7,0xb2d6a5c4
412.11,1.0,1,1,2,4,7,0xb2d361d9
7.92,1.0,0,1,2,4,7,0xb2da34e2
190000.0,6.0,4,3,4,4,11,0xb2d8eb56
1272775.53,3.0,25,4,4,2,10,0xb2d4968b
3.95,1.0,24,1,2,2,5,0xb2d92349
2682.18,1.0,0,1,2,4,7,0xb2d6a21d
1000739.74,4.0,35,4,4,2,10,0xb2d979f7
559041.18,8.0,19,4,4,2,10,0xb2d5191e
1425.46,1.0,10,1,2,3,6,0xb2d3f342
173877.32,2.0,97,3,3,1,7,0xb2d580cfd
52000.93,5.0,18,2,4,2,8,0xb2d3ea1c
96.73,2.0,56,1,3,2,6,0x3b9b2dc8
210248.64,3.0,94,3,4,1,8,0xb2d1b9bad
20471.03,2.0,154,2,3,1,6,0xb2d5b4c5
161538.25,4.0,6,3,4,3,10,0xb2d598f7
100093.69,2.0,153,3,3,1,7,0xb2d287aed
530139.98,2.0,95,4,3,1,8,0xb2d0d26e
1131.11,1.0,10,1,2,3,6,0xb2d8c904
5644.96,1.0,1,2,2,4,8,0xb2d2f413d
639735.84,6.0,46,4,4,2,10,0xb2d4f221
5965.39,4.0,166,2,4,1,7,0xb2d2c27cd
60000.0,2.0,6,3,3,3,9,0xb2d96da7
320887.31,6.0,14,4,4,3,11,0xb2d19ced
500061.8,2.0,1,4,3,4,11,0xb2d0ee32d
30356.82,1.0,0,2,2,4,8,0xb2d6a3f6
441911.93,4.0,0,4,4,4,12,0xb2d2af6a
1020.5,1.0,10,1,2,3,6,0xb2d8e3cd
3092.76,1.0,9,2,2,3,7,0xb2d952f2
50000.0,1.0,1,2,2,4,8,0xb2da6640
2568.01,1.0,17,1,2,2,5,0xb2d46dcf
606.24,2.0,4,1,3,4,8,0xb2d08d62d
268296.08,5.0,2,3,4,4,11,0xb2d17738
8678.66,1.0,184,2,2,1,5,0xb2d3099e
50603.33,2.0,0,2,3,4,9,0xb2d41c4c
80.27,1.0,7,1,2,3,6,0xb2d6ad3c
10378.43,2.0,0,2,3,4,9,0xb2d5df17d
240007.93,4.0,77,3,4,1,8,0xb2d91e3c
246003.18,4.0,1,3,4,4,11,0xb2d176ff
400139.7,3.0,0,4,4,4,12,0xb2d68ea3
4953.02,1.0,1,2,2,4,8,0xb2d6f4f7d
840397.12,5.0,0,4,4,4,12,0xb2d63a4fd
280718.13,4.0,5,3,4,3,10,0xb2d928f4
14021.47,1.0,14,2,2,3,7,0xb2d5bf2ed
340010.5,3.0,25,4,4,2,10,0xb2d43993
462098.87,3.0,20,4,4,2,10,0xb2d68dd3
494.02,1.0,67,1,2,1,4,0xb2d5e178
1209.93,1.0,184,1,2,1,4,0xb2d2f207
152.88,1.0,28,1,2,2,5,0xb2d53da9d
48135.48,1.0,41,2,2,2,6,0xb2d2d471
36.93,1.0,5,1,2,3,6,0xb2d6bded
85.41,1.0,1,1,2,4,7,0xb2d1f7bc
18.28,2.0,14,1,3,3,7,0xb2d94a9b
500423.4,2.0,20,4,3,2,9,0xb2d64878d
200049.36,2.0,45,3,3,2,8,0xb2d6d9ea
227597.68,5.0,25,3,4,2,9,0xb2d0d0f5
759235.51,3.0,21,4,4,2,10,0xb2d367fdd
1840.71,1.0,0,1,2,4,7,0xb2d6cf34
19793.32,1.0,10,2,2,3,7,0xb2d2bd5a
20013.02,1.0,13,2,2,3,7,0xb2d63fca
2571.18,1.0,18,1,2,2,5,0xb2d92001
10582.56,1.0,92,2,2,1,5,0xb2d26dea
3088.87,1.0,1,2,2,4,8,0xb2d909ec
319.04,1.0,36,1,2,2,5,0xb2d955c8
317805.13,10.0,4,4,4,4,12,0xb2d3cf57
241641.04,4.0,14,3,4,3,10,0xb2d2ba1c
46190.87,1.0,24,2,2,2,6,0xb2d62664
15.83,1.0,19,1,2,2,5,0xb2d93bea
40579.92,1.0,9,2,2,3,7,0xb2d39e1f
8.87,1.0,18,1,2,2,5,0xb2d6a5a5
371314.75,2.0,28,4,3,2,9,0xb2d31366
7446.02,1.0,6,2,2,3,7,0xb2d4c1e0
458000.0,20.0,4,4,4,4,12,0xb2d48cdb
2.66,1.0,70,1,2,1,4,0xb2d355a6
14489.9,1.0,21,2,2,2,6,0xb2d9648c
545.39,1.0,14,1,2,3,6,0xb2d5b3f8
6.18,1.0,0,1,2,4,7,0xb2d51e7fd
1679.39,1.0,195,1,2,1,4,0xb2d5b674
2202.65,1.0,29,1,2,2,5,0xb2d70083
150025.63,3.0,76,3,4,1,8,0xb2d25f73
220957.81,1.0,0,3,2,4,9,0xb2d6357a
50026.65,2.0,73,2,3,1,6,0xb2d11660d
124.26,1.0,4,1,2,4,7,0xb2d6d359d
322337.76,5.0,6,4,4,3,11,0xb2d61616
100023.74,6.0,0,3,4,4,11,0xb2d5419f
83020.79,2.0,6,3,3,3,9,0xb2d4c400d
156005.34,3.0,67,3,4,1,8,0xb2d23f5d
112.54,2.0,49,1,3,2,6,0xb2d086c1
9.95,1.0,70,1,2,1,4,0xb2d6ba85
280028.05,2.0,1,3,3,4,10,0xb2d9cce4
395626.46,1.0,0,4,2,4,10,0xb2d6aab3d
1410.0,1.0,3,1,2,4,7,0xb2d2c025d
20.38,2.0,75,1,3,1,5,0xb2d1baa8
300339.95,3.0,0,4,4,4,12,0xb2d9b29b
1688.0,2.0,6,1,3,3,7,0xb2d378b8
451.12,1.0,87,1,2,1,4,0xb2d32677
449524.45,4.0,3,4,4,4,12,0xb2d22676
84.83,1.0,7,1,2,3,6,0xb2d58938
564861.23,5.0,108,4,4,1,9,0xb2d24460
7005.75,1.0,184,2,2,1,5,0xb2d3126c
6.53,1.0,22,1,2,2,5,0xb2d3c2a9
19.43,1.0,9,1,2,3,6,0xb2d35d17
33002.68,3.0,48,2,4,2,8,0xb2d644f6d
154662.04,14.0,10,3,4,3,10,0xb2d339ee
921.3,1.0,13,1,2,3,6,0xb2d54cd4d
91014.58,2.0,56,3,3,2,8,0xb2d148ff
190156.71,6.0,1,3,4,4,11,0xb2d5a41d
300066.41,3.0,117,3,4,1,8,0xb2d9192f
16.36,1.0,12,1,2,3,6,0xb2da113e
150583.77,4.0,83,3,4,1,8,0xb2d568ce
967056.76,16.0,0,4,4,4,12,0xb2d4f595
150083.6,4.0,34,3,4,2,9,0xb2d5ece1
200003.69,2.0,66,3,3,2,8,0xb2d636a8d
450048.01,6.0,15,4,4,3,11,0xb2d53dc4d
600200.0,2.0,0,4,3,4,11,0xb2d58c49
118573.39,2.0,67,3,3,1,7,0xb2d0bf8dd
7269.43,1.0,184,2,2,1,5,0xb2d5bf23d
70000.74,3.0,53,3,4,2,9,0xb2d96f1b
1508.04,2.0,184,1,3,1,5,0xb2d32f3b
1359.51,1.0,92,1,2,1,4,0xb2d1f80b
344085.17,4.0,5,4,4,3,11,0xb2d2ae85
156846.79,3.0,132,3,4,1,8,0xb2d400d6
70.49,1.0,57,1,2,2,5,0xb2d5d6e1
273048.95,3.0,61,3,4,2,9,0xb2d25b26
152420.92,2.0,3,3,3,4,10,0xb2d17afd
300018.1,2.0,256,3,3,1,7,0xb2d528cc
130276.53,4.0,62,3,4,2,9,0xb2d69d29d
700000.18,4.0,25,4,4,2,10,0xb2d945b4
51538.24,1.0,76,2,2,1,5,0xb2d64e5f
153127.82,4.0,0,3,4,4,11,0xb2d0de18
71000.0,1.0,4,3,2,4,9,0xb2da61ad
2.3,1.0,57,1,2,2,5,0xb2d5ac1e
22473.51,1.0,0,2,2,4,8,0xb2d214afd
150003.17,2.0,213,3,3,1,7,0xb2d58bb2
60305.97,3.0,129,3,4,1,8,0xb2d14eaf
3977.61,1.0,10,2,2,3,7,0xb2d8d309
3216.67,1.0,185,2,2,1,5,0xb2d29c5e
120081.54,7.0,130,3,4,1,8,0xb2d53c7dd
89192.67,2.0,31,3,3,2,8,0xb2d200a2
674061.93,7.0,37,4,4,2,10,0xb2d4954e
4093.35,1.0,1,2,2,4,8,0xb2d3b8c6
3000056.89,1.0,0,4,2,4,10,0xb2d4a97a
12117.16,2.0,0,2,3,4,9,0xb2d080e3
4777.64,1.0,20,2,2,2,6,0xb2d5aeb4
20101.61,3.0,24,2,4,2,8,0xb2d59f7b
6736.66,1.0,193,2,2,1,5,0xb2d12697
1761333.46,3.0,117,4,4,1,9,0xb2d12cab
501876.8,2.0,17,4,3,2,9,0xb2d5d4c6
522176.5,2.0,5,4,3,3,10,0xb2d23114d
1497.86,1.0,184,1,2,1,4,0xb2d2e520
11875.46,2.0,0,2,3,4,9,0x3b9b29f5
43272.85,1.0,33,2,2,2,6,0xb2d537fe
34.06,1.0,60,1,2,2,5,0xb2d627ff
1160819.08,8.0,6,4,4,3,11,0xb2d5a6b1d
121009.92,2.0,0,3,3,4,10,0xb2d63276
1756.83,1.0,184,1,2,1,4,0xb2d35ae9
1325.49,1.0,92,1,2,1,4,0xb2d33dd2
821878.94,7.0,0,4,4,4,12,0x3b9b44bfd
2312435.71,17.0,1,4,4,4,12,0xb2d65a13d
2.29,1.0,3,1,2,4,7,0xb2d8ccc0
530417.89,5.0,154,4,4,1,9,0xb2d41284
90001.68,3.0,55,3,4,2,9,0xb2d1b19d
40057.5,2.0,165,2,3,1,6,0xb2d6d017d
90004.4,3.0,14,3,4,3,10,0xb2d16a81d
9200.25,2.0,184,2,3,1,6,0xb2d65877
100.0,1.0,0,1,2,4,7,0xb2d93987
634251.26,9.0,24,4,4,2,10,0xb2d230f6
1.34,1.0,7,1,2,3,6,0xb2d656f0
109416.08,2.0,92,3,3,1,7,0xb2d18420
1.59,1.0,36,1,2,2,5,0xb2d2c451
401463.61,3.0,42,4,4,2,10,0xb2d78996d
1030.72,1.0,10,1,2,3,6,0xb2d4bd30
350027.63,7.0,34,4,4,2,10,0xb2d6b7b9
27.96,1.0,44,1,2,2,5,0xb2d6aff8
8.34,1.0,139,1,2,1,4,0xb2d0bf20
1470124.49,4.0,28,4,4,2,10,0xb2d4d993d
404.54,13.0,1,1,4,4,9,0x3b9adcd0
90109.24,2.0,108,3,3,1,7,0xb2d42934d
141217.27,1.0,1,3,2,4,9,0xb2d584b7d
500002.59,3.0,22,4,4,2,10,0xb2d43d75
200000.0,2.0,1,3,3,4,10,0xb2d32d7a
500196.99,3.0,22,4,4,2,10,0xb2d95239d
85689.25,1.0,16,3,2,2,7,0xb2d39f24
380070.8,4.0,224,4,4,1,9,0xb2d113db
600063.23,4.0,0,4,4,4,12,0xb2da2aa8
30112.41,4.0,6,2,4,3,9,0xb2d62ec6
119457.31,2.0,33,3,3,2,8,0xb2d1097c
3016.52,1.0,7,2,2,3,7,0xb2d2f2e5
3200000.0,2.0,2,4,3,4,11,0xb2d938e9
1326001.72,8.0,19,4,4,2,10,0xb2d27e11
340899.76,7.0,3,4,4,4,12,0xb2d31371
185149.98,10.0,0,3,4,4,11,0xb2d5ce21
4467291.63,2.0,122,4,3,1,8,0xb2d06884d
7105.9,1.0,6,2,2,3,7,0xb2d6f2ba
200000.0,2.0,12,3,3,3,9,0xb2d9613d
1630009.58,10.0,1,4,4,4,12,0xb2d511bf
19696.9,1.0,184,2,2,1,5,0xb2d4fce7
93.77,1.0,60,1,2,2,5,0xb2d5d0e7
858945.46,2.0,214,4,3,1,8,0xb2d2825ed
26690.21,1.0,0,2,2,4,8,0xb2d62536
330976.32,7.0,59,4,4,2,10,0xb2d5e930
21189.91,1.0,3,2,2,4,8,0xb2d6a1f3
33512.23,1.0,184,2,2,1,5,0xb2d10a79
502224.04,3.0,77,4,4,1,9,0xb2d24635
178143.54,5.0,0,3,4,4,11,0xb2d60e0d
2620.49,1.0,9,1,2,3,6,0xb2d83b57
9415.16,1.0,4,2,2,4,8,0xb2d91f5d
200017.93,2.0,231,3,3,1,7,0xb2d61159
4505.68,1.0,6,2,2,3,7,0xb2d6bd49
106489.41,2.0,75,3,3,1,7,0xb2d2c1c0d
22.98,2.0,18,1,3,2,6,0xb2d25616
100151.17,2.0,172,3,3,1,7,0xb2d6b66f
100693.58,2.0,245,3,3,1,7,0xb2d682df
1000000.86,5.0,0,4,4,4,12,0xb2d12682d
1.43,1.0,10,1,2,3,6,0xb2d96f22
11540.03,1.0,196,2,2,1,5,0xb2d3d925
1765.09,1.0,7,1,2,3,6,0xb2d86afb
1447.18,2.0,184,1,3,1,5,0xb2d102c9
1204.92,1.0,184,1,2,1,4,0xb2d58e11d
44.88,1.0,52,1,2,2,5,0xb2d23f5b
783.19,1.0,7,1,2,3,6,0xb2d99549
563252.07,8.0,5,4,4,3,11,0xb2d62a3bd
7353.3,1.0,18,2,2,2,6,0xb2d15112
1138.76,1.0,25,1,2,2,5,0xb2d26df6
417148.76,7.0,0,4,4,4,12,0xb2d354e3d
2.64,1.0,48,1,2,2,5,0xb2d2ab64
72001.84,3.0,179,3,4,1,8,0xb2d2d819
3775.82,1.0,20,2,2,2,6,0xb2d48c0a
130546.73,3.0,18,3,4,2,9,0xb2d90889
38.39,1.0,0,1,2,4,7,0xb2d6155e
498582.19,6.0,0,4,4,4,12,0xb2d12e7e
100001.78,3.0,31,3,4,2,9,0xb2d6256f
43.05,1.0,0,1,2,4,7,0xb2d27f2ad
1010.98,1.0,184,1,2,1,4,0xb2d290b0d
20012.46,6.0,217,2,4,1,7,0xb2d0b01f
3503.46,1.0,11,2,2,3,7,0xb2d3b7ef
1690021.6,14.0,11,4,4,3,11,0xb2d23307
135939.84,1.0,184,3,2,1,6,0x3b9b40c9
1518.11,1.0,92,1,2,1,4,0xb2d11706
193836.11,3.0,60,3,4,2,9,0xb2d569ac
100000.0,2.0,0,3,3,4,10,0xb2d32ffd
12182.7,1.0,3,2,2,4,8,0xb2d772c3
500009.91,4.0,1,4,4,4,12,0xb2d91461
1180330.98,9.0,10,4,4,3,11,0xb2d2155f
10057.95,2.0,15,2,3,3,8,0xb2d9bc26
1202014.71,3.0,19,4,4,2,10,0xb2d6dc07d
10000.43,2.0,77,2,3,1,6,0xb2d242c2
50019.92,2.0,214,2,3,1,6,0xb2d2d954d
11804.55,1.0,92,2,2,1,5,0xb2d22b2ed
14.8,1.0,139,1,2,1,4,0xb2d1a3c0
458954.0,5.0,13,4,4,3,11,0xb2d323add
328.17,1.0,5,1,2,3,6,0xb2d906f4
450011.3,4.0,21,4,4,2,10,0xb2d6a10a
172801.21,7.0,6,3,4,3,10,0xb2d41a8a
1116448.44,7.0,23,4,4,2,10,0xb2d6fce9
36828.71,3.0,0,2,4,4,10,0xb2d0bed7
14.95,1.0,39,1,2,2,5,0xb2d6fed1
10000.11,2.0,56,2,3,2,7,0xb2d9c7fb
88946.49,6.0,0,3,4,4,11,0xb2d41683d
261119.33,4.0,27,3,4,2,9,0xb2d1c40a
220009.31,2.0,92,3,3,1,7,0xb2d64041
327844.64,2.0,83,4,3,1,8,0xb2d36688
257051.65,5.0,47,3,4,2,9,0xb2d59889
104376.9,1.0,9,3,2,3,8,0xb2d8ea3c
290046.13,3.0,7,3,4,3,10,0xb2d07da4d
0.0,1.0,69,1,2,1,4,0xb2d4ff63
400058.29,11.0,17,4,4,2,10,0xb2d6a40a
8849.91,1.0,1,2,2,4,8,0xb2d551a5
50000.53,2.0,46,2,3,2,7,0xb2d9e2af
200008.44,2.0,62,3,3,2,8,0xb2d8f4b3
158731.96,2.0,21,3,3,2,8,0xb2d59198
360332.93,9.0,18,4,4,2,10,0xb2d4f800d
587312.18,4.0,12,4,4,3,11,0xb2d3a0f3d
27843.99,1.0,1,2,2,4,8,0xb2d4045cd
2249.15,1.0,0,1,2,4,7,0xb2d17bf7
1998.74,2.0,184,1,3,1,5,0x3b9b3e25d
83020.31,1.0,102,3,2,1,6,0xb2d248ff
101945.48,1.0,12,3,2,3,8,0xb2d6ad14d
1800.0,1.0,0,1,2,4,7,0xb2d5bd7d
10000.21,2.0,18,2,3,2,7,0xb2da2a29
1729.98,1.0,210,1,2,1,4,0xb2d3c3a4
65006823.21,3.0,46,4,4,2,10,0xb2d5f57f
461955.36,12.0,3,4,4,4,12,0xb2d5c26d
21893.33,1.0,0,2,2,4,8,0xb2d57a1cd
10041.97,1.0,92,2,2,1,5,0xb2d6234a
210056.85,2.0,11,3,3,3,9,0xb2d2390b
103009.82,2.0,92,3,3,1,7,0xb2d4307ed
121595.43,1.0,12,3,2,3,8,0xb2d3bbef
10004.22,2.0,25,2,3,2,7,0xb2da1153
878725.06,5.0,77,4,4,1,9,0xb2d15288
1014.04,1.0,92,1,2,1,4,0xb2d35b71d
5956.15,1.0,12,2,2,3,7,0xb2d63f4f
473085.91,2.0,166,4,3,1,8,0xb2d25248
103119.44,2.0,221,3,3,1,7,0xb2d3b40b
362079.42,3.0,0,4,4,4,12,0xb2d3d62d
435003.82,3.0,1,4,4,4,12,0xb2d541ae
60000.63,2.0,48,3,3,2,8,0xb2d912d5
50001.06,2.0,21,2,3,2,7,0xb2da1f26
4287.55,1.0,92,2,2,1,5,0xb2d3732a
607884.52,10.0,0,4,4,4,12,0x3b9adbdd
8098.64,1.0,213,2,2,1,5,0xb2d528dcd
3846.29,1.0,10,2,2,3,7,0xb2d6e775d
4040.64,1.0,184,2,2,1,5,0xb2d17f4c
666288.4,4.0,5,4,4,3,11,0xb2d25157
500052.92,3.0,154,4,4,1,9,0xb2d32022
3.35,1.0,88,1,2,1,4,0xb2d2c313
2001910.33,1.0,0,4,2,4,10,0xb2d8daeb
161346.73,1.0,0,3,2,4,9,0xb2d212e6
1433000.0,10.0,6,4,4,3,11,0xb2d40d48d
829366.69,7.0,153,4,4,1,9,0xb2d19239
100068.94,3.0,3,3,4,4,11,0xb2d25ff0
17748.37,1.0,11,2,2,3,7,0xb2d93638
25002.85,2.0,42,2,3,2,7,0xb2d9db2c
2536788.41,2.0,30,4,3,2,9,0xb2d7789e
440005.48,5.0,0,4,4,4,12,0xb2d07ad3
262.38,2.0,60,1,3,2,6,0x3b9b3c7b
60380.16,3.0,5,3,4,3,10,0xb2d58f94
14942.92,1.0,20,2,2,2,6,0xb2d9c787
692015.72,4.0,1,4,4,4,12,0xb2d8dff3
556.87,1.0,10,1,2,3,6,0xb2d658b3
3.37,1.0,98,1,2,1,4,0xb2d96a88
50008.54,2.0,73,2,3,1,6,0xb2d8debe
10000.32,2.0,11,2,3,3,8,0xb2d50b7c
1000732.86,4.0,18,4,4,2,10,0xb2d08761d
300000.0,2.0,26,3,3,2,8,0xb2da15f1
231027.82,3.0,47,3,4,2,9,0xb2d0e8de
34853.15,5.0,0,2,4,4,10,0x3b9af40a
34.73,1.0,12,1,2,3,6,0xb2d97979
2000.83,1.0,43,1,2,2,5,0xb2d91543
3123.7,1.0,184,2,2,1,5,0xb2d39cec
200000.13,2.0,9,3,3,3,9,0xb2d8e6ead
377036.31,6.0,102,4,4,1,9,0xb2d11071d
1599.3,1.0,31,1,2,2,5,0xb2d69537
112425.58,5.0,0,3,4,4,11,0x3b9b3db0
506862.09,5.0,104,4,4,1,9,0xb2d0e7ffd
783.2,1.0,0,1,2,4,7,0xb2d34ef7
30001.27,2.0,70,2,3,1,6,0xb2d9a38e
1639.44,1.0,184,1,2,1,4,0xb2d2a974
13071.76,2.0,19,2,3,2,7,0xb2d8f53ed
115388.59,1.0,67,3,2,1,6,0xb2d20b60
67456.69,3.0,129,3,4,1,8,0x3b9b3d19
201246.97,12.0,1,3,4,4,11,0xb2d0b4e3
2432.59,1.0,176,1,2,1,4,0xb2d64980d
20822.5,1.0,92,2,2,1,5,0xb2d1ed43
4757.02,1.0,2,2,2,4,8,0xb2d67d9e
3426.57,1.0,10,2,2,3,7,0xb2d2a3dd
280604.6,1.0,92,3,2,1,6,0xb2d364cd
11491.5,2.0,0,2,3,4,9,0xb2d54f42d
35085.57,2.0,196,2,3,1,6,0xb2d08763
1551.99,1.0,184,1,2,1,4,0xb2d4e2cd
0.0,1.0,1,1,2,4,7,0xb2d97783
9.8,1.0,21,1,2,2,5,0xb2d37cee
304839.43,2.0,4,4,3,4,11,0xb2d63830
2513.63,4.0,6,1,4,3,8,0x3b9b2b6f
156847.6,3.0,224,3,4,1,8,0xb2d400d6d
150502.56,3.0,76,3,4,1,8,0xb2d3f6f5
8.28,3.0,60,1,4,2,7,0xb2d68963
1222565.86,8.0,17,4,4,2,10,0xb2d640a8d
120012.35,1.0,1,3,2,4,9,0xb2d2e209
170042.22,3.0,139,3,4,1,8,0xb2d12cbed
11381.54,1.0,184,2,2,1,5,0xb2d30530
28.24,1.0,18,1,2,2,5,0xb2d22ce6
286100.0,5.0,7,3,4,3,10,0xb2d3abf4
1200036.0,7.0,3,4,4,4,12,0xb2d6dc22
620176.63,3.0,6,4,4,3,11,0xb2d52c61d
529275.11,2.0,1,4,3,4,11,0xb2d3494d
300002.96,2.0,20,3,3,2,8,0xb2d94f05
85658.62,6.0,10,3,4,3,10,0xb2d54c72d
3752.76,1.0,184,2,2,1,5,0xb2d08851
385030.62,7.0,20,4,4,2,10,0xb2d45509
2935.77,1.0,0,2,2,4,8,0xb2d6be04
435039.52,2.0,0,4,3,4,11,0xb2d39ff6d
1299.32,1.0,1,1,2,4,7,0xb2d32c79
1750.13,2.0,92,1,3,1,5,0xb2d264e7
381.61,1.0,14,1,2,3,6,0xb2d6a9c7
22003.34,2.0,158,2,3,1,6,0xb2d6aae6
4300031.25,10.0,3,4,4,4,12,0xb2d92b4d
13665.66,1.0,164,2,2,1,5,0xb2d57308
329.65,1.0,5,1,2,3,6,0xb2d1fd17
220000.42,3.0,46,3,4,2,9,0xb2d9df53
1044.34,1.0,92,1,2,1,4,0xb2d1ab6dd
190287.74,2.0,13,3,3,3,9,0xb2d59820d
10012.32,2.0,6,2,3,3,8,0xb2d92b6c
3.02,1.0,75,1,2,1,4,0xb2d65cc5d
2119292.22,5.0,13,4,4,3,11,0xb2d28101
203687.51,2.0,41,3,3,2,8,0xb2d64a51
726076.44,3.0,24,4,4,2,10,0xb2d15e70
800582.44,4.0,40,4,4,2,10,0xb2d37d3ad
10.11,1.0,27,1,2,2,5,0xb2d8b290
14706.93,1.0,8,2,2,3,7,0xb2d68581
3.02,1.0,74,1,2,1,4,0xb2d1550ed
900711.97,5.0,1,4,4,4,12,0xb2d6cc94
1000835.82,4.0,0,4,4,4,12,0xb2d69c54
1106.09,2.0,4,1,3,4,8,0xb2d089f3
12.65,2.0,0,1,3,4,8,0xb2d4f398
60294.98,2.0,170,3,3,1,7,0xb2d59ef6
200002.14,2.0,22,3,3,2,8,0xb2d5c8be
803242.4,3.0,16,4,4,2,10,0xb2d64432d
27265.96,1.0,0,2,2,4,8,0xb2d4876d
130648.91,3.0,42,3,4,2,9,0xb2d622e4d
1105.68,1.0,11,1,2,3,6,0xb2d9273e
15081.22,1.0,1,2,2,4,8,0xb2d5c769d
795858.41,7.0,4,4,4,4,12,0xb2d2ae76
276044.68,5.0,0,3,4,4,11,0x3b9b33cd
110035.73,2.0,215,3,3,1,7,0xb2d39009
380970.47,3.0,21,4,4,2,10,0xb2d9527d
138.53,1.0,18,1,2,2,5,0xb2d6bd37
996491.83,5.0,18,4,4,2,10,0xb2d581a2
1513076.78,9.0,12,4,4,3,11,0xb2d19f14
1075.59,1.0,184,1,2,1,4,0x3b9b177f
71833.74,2.0,60,3,3,2,8,0xb2d2539d
20012.77,3.0,6,2,4,3,9,0xb2d59028
594314.57,4.0,7,4,4,3,11,0xb2d3b46e
9.43,1.0,3,1,2,4,7,0xb2d4b3b6
200054.33,2.0,92,3,3,1,7,0xb2d43bf8
1080980.76,10.0,0,4,4,4,12,0xb2d5ae18
1296538.92,5.0,33,4,4,2,10,0xb2d4dbb1
681.71,1.0,13,1,2,3,6,0xb2d6acd0
885298.96,8.0,1,4,4,4,12,0xb2d682ae
2891764.56,5.0,157,4,4,1,9,0xb2d0aaa1
200101.45,2.0,8,3,3,3,9,0xb2d6edf1
1424274.18,3.0,129,4,4,1,9,0xb2d61393
36609.63,1.0,10,2,2,3,7,0xb2d2fea3
1483.11,1.0,184,1,2,1,4,0xb2d2e5f0d
3821.9,1.0,0,2,2,4,8,0xb2d1a898d
700024.28,3.0,182,4,4,1,9,0xb2d1ab12d
12.67,1.0,93,1,2,1,4,0xb2d973fb
500028.17,2.0,10,4,3,3,10,0xb2d96d9a
1.85,1.0,184,1,2,1,4,0xb2d39518
5109.31,1.0,33,2,2,2,6,0xb2d14215
97804.32,1.0,0,3,2,4,9,0xb2d3fca8
0.86,1.0,3,1,2,4,7,0xb2d9798d
1143019.1,3.0,172,4,4,1,9,0xb2d16b35
10000.97,2.0,6,2,3,3,8,0xb2d716ca
2355821.26,7.0,6,4,4,3,11,0xb2d160aa
8835.26,1.0,0,2,2,4,8,0xb2d57caf
30172.59,1.0,1,2,2,4,8,0xb2d1b82f
6898.79,1.0,18,2,2,2,6,0xb2d5cee2
461216.28,2.0,3,4,3,4,11,0xb2d561b9
3810034.59,4.0,0,4,4,4,12,0xb2d60791
300065.64,2.0,15,3,3,3,9,0xb2d9184f
280318.08,3.0,1,3,4,4,11,0xb2d1501a
7540.68,1.0,6,2,2,3,7,0xb2d51dcd
224079.67,2.0,6,3,3,3,9,0xb2d5e158
1313663.78,2.0,33,4,3,2,9,0xb2d52dd8
12210.67,1.0,56,2,2,2,6,0xb2d29709
1232.54,1.0,0,1,2,4,7,0xb2d6ac90
500000.0,2.0,15,4,3,3,10,0xb2d8dcee
1814.08,1.0,39,1,2,2,5,0xb2d685aa
20184.58,2.0,143,2,3,1,6,0xb2d5c4b2
932.01,1.0,1,1,2,4,7,0xb2d4361f
450091.06,2.0,1,4,3,4,11,0xb2d6abb8d
356415.89,9.0,0,4,4,4,12,0xb2d10bdad
5379.44,1.0,15,2,2,3,7,0xb2d31e42
360115.55,4.0,60,4,4,2,10,0xb2d3f31bd
2513.7,1.0,40,1,2,2,5,0xb2d626bcd
156015.84,4.0,102,3,4,1,8,0xb2d6e9bd
201141.55,5.0,27,3,4,2,9,0xb2d51fd2
130004.23,1.0,11,3,2,3,8,0xb2da3420
1503925.65,7.0,9,4,4,3,11,0xb2d6a222
19124.17,1.0,2,2,2,4,8,0xb2d21aa1
11518.26,1.0,0,2,2,4,8,0xb2d6c5e7
1842.38,1.0,18,1,2,2,5,0xb2d29b5dd
1001.45,1.0,92,1,2,1,4,0xb2d41684
67.11,1.0,53,1,2,2,5,0xb2d2f1ac
870.21,2.0,92,1,3,1,5,0xb2d0a2f2
1.81,1.0,10,1,2,3,6,0xb2d597ecd
6258.57,1.0,0,2,2,4,8,0xb2d5644d
442910.88,4.0,32,4,4,2,10,0xb2d22c2a
247001.6,5.0,39,3,4,2,9,0xb2d58173
302005.35,5.0,62,4,4,2,10,0xb2d125c3d
3295.7,1.0,18,2,2,2,6,0xb2d272edd
50001.58,2.0,158,2,3,1,6,0xb2d8ece9
25000.37,2.0,10,2,3,3,8,0xb2d964c0
203291.18,3.0,24,3,4,2,9,0xb2d34f93
53236.69,2.0,92,3,3,1,7,0xb2d35161
65264.21,2.0,122,3,3,1,7,0xb2d36551d
2074238.96,5.0,0,4,4,4,12,0xb2d6ec4ed
100002.11,2.0,87,3,3,1,7,0xb2d8c90d
60044.19,5.0,0,3,4,4,11,0xb2d5e92b
200779.34,2.0,43,3,3,2,8,0xb2d5c710
500000.0,2.0,5,4,3,3,10,0xb2d97727
27518.98,1.0,0,2,2,4,8,0xb2d34160
97655.78,1.0,92,3,2,1,6,0xb2d10c56
53070.62,2.0,11,3,3,3,9,0xb2d4be07
202249.61,1.0,0,3,2,4,9,0xb2d8cabc
19607.11,1.0,1,2,2,4,8,0xb2d2342b
150152.1,3.0,5,3,4,3,10,0xb2d5997c
330069.31,13.0,0,4,4,4,12,0xb2d4fdf3
20108.27,2.0,188,2,3,1,6,0xb2d62c31
956898.69,5.0,6,4,4,3,11,0xb2d618c0d
213009.31,3.0,74,3,4,1,8,0xb2d413c3
3835.58,1.0,9,2,2,3,7,0xb2d2b5fa
450048.71,3.0,5,4,4,3,11,0xb2d279ee
16199.81,2.0,20,2,3,2,7,0xb2d0a76e
1137092.76,6.0,3,4,4,4,12,0xb2d0b0ea
623.11,1.0,0,1,2,4,7,0xb2d8eb3e
102259.89,2.0,31,3,3,2,8,0xb2d19f05
521836.77,1.0,67,4,2,1,7,0xb2d5891e
408010.59,5.0,108,4,4,1,9,0xb2d0b007
200041.99,2.0,6,3,3,3,9,0xb2d3964d
91043.64,3.0,0,3,4,4,11,0xb2d63c73
104.67,2.0,14,1,3,3,7,0xb2d1961dd
10000.0,2.0,0,2,3,4,9,0xb2d1c28d
72.58,1.0,13,1,2,3,6,0xb2d0a749
250016.74,3.0,143,3,4,1,8,0xb2d58e47d
93.79,1.0,60,1,2,2,5,0xb2d5b2e5
530000.16,2.0,16,4,3,2,9,0xb2d5583d
802135.37,6.0,28,4,4,2,10,0xb2d5b6db
1057.28,1.0,184,1,2,1,4,0xb2d13fbc
2195.43,1.0,184,1,2,1,4,0xb2d59f25
130256.34,5.0,15,3,4,3,10,0xb2d6002dd
2173.47,1.0,10,1,2,3,6,0xb2d42472d
500128.79,4.0,10,4,4,3,11,0xb2d78ba2d
231143.3,2.0,288,3,3,1,7,0xb2d5d388
230093.55,2.0,1,3,3,4,10,0xb2da4690
1335.23,1.0,1,1,2,4,7,0xb2d9739d
715335.29,3.0,35,4,4,2,10,0xb2d78e67
102000.0,4.0,2,3,4,4,11,0xb2d07ca5
47895.74,5.0,184,2,4,1,7,0xb2d086c8d
102010.46,2.0,125,3,3,1,7,0xb2d55df0
561557.82,6.0,0,4,4,4,12,0xb2d596d5
780000.38,12.0,0,4,4,4,12,0xb2d1b33c
2712.92,1.0,10,1,2,3,6,0xb2d423cb
4477.35,1.0,16,2,2,2,6,0xb2d697ac
3000467.15,2.0,0,4,3,4,11,0xb2d8a604
79.23,1.0,105,1,2,1,4,0xb2d64936
1506.89,1.0,230,1,2,1,4,0xb2d5692f
131849.84,2.0,0,3,3,4,10,0xb2d2670cd
60005.56,2.0,0,3,3,4,10,0xb2d5ba76d
152531.05,3.0,67,3,4,1,8,0xb2d55a42
50195.73,1.0,1,2,2,4,8,0xb2d6d0c8
3960.47,1.0,0,2,2,4,8,0xb2d176fe
207485.57,4.0,11,3,4,3,10,0xb2d5edfb
15075.47,1.0,137,2,2,1,5,0xb2d7b040
660846.35,3.0,6,4,4,3,11,0xb2d29fc2
90142.38,2.0,7,3,3,3,9,0xb2d5a0b3
12258.7,1.0,10,2,2,3,7,0xb2d5f83e
55026.63,3.0,39,3,4,2,9,0xb2d60be5
440092.01,3.0,12,4,4,3,11,0xb2d0bf39
8000000.0,2.0,15,4,3,3,10,0xb2da2949
670110.88,3.0,10,4,4,3,11,0xb2d40a70
301345.18,2.0,5,4,3,3,10,0xb2d5f5a4d
70065.92,1.0,0,3,2,4,9,0xb2d432c0
918000.0,18.0,0,4,4,4,12,0xb2d16ed9
39016.46,2.0,1,2,3,4,9,0xb2d2128d
8.64,1.0,12,1,2,3,6,0xb2d2e842
500015.83,2.0,60,4,3,2,9,0xb2d9bb26
100027.07,2.0,10,3,3,3,9,0xb2d5f271
2870.1,1.0,15,1,2,3,6,0xb2d1f84e
5000.63,1.0,21,2,2,2,6,0xb2d90074
112247.85,1.0,184,3,2,1,6,0xb2d427aad
59.93,1.0,22,1,2,2,5,0xb2d355f1d
5340.27,1.0,0,2,2,4,8,0xb2d8ea7c
2895195.53,7.0,47,4,4,2,10,0xb2d0b995d
384779.0,3.0,24,4,4,2,10,0xb2d15c06
19.22,1.0,7,1,2,3,6,0xb2d67e01
557146.87,4.0,94,4,4,1,9,0xb2d0bcef
51682.55,1.0,1,2,2,4,8,0xb2d5e387d
890000.06,20.0,6,4,4,3,11,0xb2d5857f
5968.15,1.0,10,2,2,3,7,0xb2d479a6
423906.16,5.0,32,4,4,2,10,0xb2d50b5b
7.06,1.0,64,1,2,2,5,0xb2d54f96
3951.5,1.0,0,2,2,4,8,0xb2d24802
10646.98,1.0,162,2,2,1,5,0xb2d31d38
462573.04,8.0,18,4,4,2,10,0xb2d16c51
5017.6,1.0,184,2,2,1,5,0xb2d645e6
406258.3,4.0,6,4,4,3,11,0xb2d60da2
9577.4,1.0,32,2,2,2,6,0xb2d43bfd
3742.37,1.0,92,2,2,1,5,0xb2d1a6b6d
1355614.02,4.0,28,4,4,2,10,0xb2d5e0f2
48094.73,6.0,24,2,4,2,8,0xb2d64f62
22002.67,1.0,18,2,2,2,6,0xb2d1ca13
1500031.67,4.0,4,4,4,4,12,0xb2da07c5
1696.35,1.0,5,1,2,3,6,0xb2d6e83b
70000.95,3.0,31,3,4,2,9,0xb2d921ab
26508.88,1.0,0,2,2,4,8,0xb2d54f05
2308.26,1.0,189,1,2,1,4,0xb2d2c005
4778.15,1.0,10,2,2,3,7,0xb2d3f759
119000.0,7.0,3,3,4,4,11,0xb2d208f0
34.53,1.0,2,1,2,4,7,0xb2d8e448
402827.2,6.0,7,4,4,3,11,0xb2d0db2e
61021.85,2.0,20,3,3,2,8,0xb2d1b8dc
4696.53,1.0,2,2,2,4,8,0xb2d4f796
170799.32,4.0,0,3,4,4,11,0xb2d91081
5139.89,1.0,12,2,2,3,7,0xb2d5ea45
200004.22,2.0,11,3,3,3,9,0xb2da3ff0
110093.51,2.0,83,3,3,1,7,0xb2d6d14d
1977.02,1.0,7,1,2,3,6,0xb2d6b9c1
2.61,1.0,18,1,2,2,5,0xb2d9a952
31455.35,1.0,3,2,2,4,8,0xb2d64d60
5202.79,1.0,5,2,2,3,7,0xb2d48fd9
52.32,1.0,46,1,2,2,5,0xb2d38ca3
90073.68,6.0,26,3,4,2,9,0xb2d07af4
2232.36,1.0,92,1,2,1,4,0xb2d1c2aad
3.17,1.0,0,1,2,4,7,0xb2d2a552d
33934.92,1.0,19,2,2,2,6,0xb2d6af74
2.48,1.0,24,1,2,2,5,0xb2d24d60
0.0,2.0,2,1,3,4,8,0xb2d93ab1
2560031.13,20.0,5,4,4,3,11,0xb2d52e0a
310475.08,1.0,10,4,2,3,9,0xb2d280c6d
102072.41,2.0,9,3,3,3,9,0xb2d2bdead
240.11,1.0,1,1,2,4,7,0xb2d6c404
9934.37,1.0,184,2,2,1,5,0x3b9aebee
319.46,1.0,0,1,2,4,7,0xb2d1dc72
22.37,1.0,20,1,2,2,5,0xb2d2eecd
50884.62,1.0,133,2,2,1,5,0xb2d63b76
51385.25,1.0,3,2,2,4,8,0xb2d4c99d
119.21,1.0,1,1,2,4,7,0xb2d94aa4
474317.67,13.0,0,4,4,4,12,0xb2d20fab
30.96,1.0,3,1,2,4,7,0xb2d4f813
772.67,1.0,0,1,2,4,7,0xb2d1b5ecd
1790.92,1.0,14,1,2,3,6,0xb2d2df51
300000.0,4.0,4,3,4,4,11,0xb2d59b43
20058.74,1.0,92,2,2,1,5,0xb2d3c514
6265.01,1.0,92,2,2,1,5,0x3b9b0f2a
100000.0,1.0,3,3,2,4,9,0xb2da64d2
646.55,1.0,1,1,2,4,7,0xb2d97b9e
8093.19,1.0,10,2,2,3,7,0xb2d5c19f
284644.31,5.0,47,3,4,2,9,0xb2d42c4a
3419.89,1.0,2,2,2,4,8,0xb2d702e2
1004.89,1.0,184,1,2,1,4,0xb2d147d2d
32204.72,1.0,0,2,2,4,8,0xb2d6c167
91241.6,2.0,249,3,3,1,7,0xb2d52e20d
601032.5,6.0,3,4,4,4,12,0x3b9b425b
1402587.81,7.0,4,4,4,4,12,0xb2d606fa
1131826.21,4.0,17,4,4,2,10,0xb2d5f8e0d
170011.5,2.0,32,3,3,2,8,0xb2d99c22
3109.16,1.0,187,2,2,1,5,0xb2d5d6de
1537.12,1.0,184,1,2,1,4,0xb2d22456
4.42,1.0,4,1,2,4,7,0xb2d437f7
200947.14,2.0,53,3,3,2,8,0xb2d3a0cd
40361.29,4.0,6,2,4,3,9,0xb2d52bcd
19089.96,1.0,11,2,2,3,7,0xb2d6892e
34690.86,12.0,0,2,4,4,10,0xb2d190fdd
472588.12,4.0,35,4,4,2,10,0xb2d8cf99
132028.98,2.0,0,3,3,4,10,0xb2d6f70ed
170853.36,4.0,0,3,4,4,11,0xb2d91db7d
272496.67,2.0,0,3,3,4,10,0xb2d15998
250326.1,4.0,2,3,4,4,11,0xb2d11f7cd
20832.91,1.0,92,2,2,1,5,0xb2d1a039
2986.51,1.0,21,2,2,2,6,0xb2d24246
3070094.34,11.0,25,4,4,2,10,0xb2d9300a
846201.87,5.0,8,4,4,3,11,0xb2d1cdd2
230765.03,4.0,27,3,4,2,9,0xb2d06417
254046.18,2.0,3,3,3,4,10,0xb2d6def3
2435.43,1.0,92,1,2,1,4,0xb2d2dd32
56.61,1.0,79,1,2,1,4,0xb2d65af2d
1003552.46,2.0,26,4,3,2,9,0xb2d93550
500010.0,3.0,19,4,4,2,10,0xb2da0fa4
157008.68,2.0,74,3,3,1,7,0xb2d5ed97
4924.15,1.0,14,2,2,3,7,0xb2d36867
1052.95,1.0,20,1,2,2,5,0xb2d27b45
907.08,1.0,89,1,2,1,4,0xb2d3b07fd
62.89,1.0,5,1,2,3,6,0xb2d97283
50001.06,2.0,228,2,3,1,6,0xb2d6f459
45000.79,3.0,14,2,4,3,9,0xb2d9ef0f
36.19,1.0,3,1,2,4,7,0xb2d444b0
1301959.47,4.0,0,4,4,4,12,0xb2d53c86
954.91,1.0,10,1,2,3,6,0xb2d9c137
366553.09,2.0,1,4,3,4,11,0xb2d58418
35849.93,1.0,18,2,2,2,6,0xb2d988dd
333518.35,2.0,27,4,3,2,9,0xb2d783dcd
50017.74,2.0,53,2,3,2,7,0xb2d5873b
75080.56,1.0,11,3,2,3,8,0xb2d9a5a8
30000.0,2.0,6,2,3,3,8,0xb2d6e96bd
30000.63,2.0,11,2,3,3,8,0xb2da443a
7116.12,1.0,5,2,2,3,7,0xb2d99418
521776.32,4.0,27,4,4,2,10,0xb2d1941ad
151824.02,3.0,14,3,4,3,10,0xb2d17c2f
249329.63,14.0,46,3,4,2,9,0xb2d2db3f
1269.3,1.0,2,1,2,4,7,0xb2d38ca9
1976.34,2.0,98,1,3,1,5,0x3b9ada18
120001.27,2.0,21,3,3,2,8,0xb2da2053
1.99,1.0,11,1,2,3,6,0xb2d13e9c
151210.21,2.0,35,3,3,2,8,0xb2d9f0ae
4658.61,1.0,16,2,2,2,6,0xb2d32a07
1237.96,1.0,0,1,2,4,7,0xb2d28036
33169.41,2.0,202,2,3,1,6,0xb2d5c61b
100013.18,2.0,52,3,3,2,8,0xb2d42993
15124.48,1.0,6,2,2,3,7,0xb2d5e0ccd
4000.0,1.0,0,2,2,4,8,0xb2d3ed92
0.0,2.0,1,1,3,4,8,0xb2d8c668
5667.67,1.0,210,2,2,1,5,0xb2d3d181
2340636.2,3.0,28,4,4,2,10,0xb2d441a8
2.32,1.0,5,1,2,3,6,0xb2d3c38f
37.46,2.0,16,1,3,2,6,0xb2d06bc5
895468.8,12.0,69,4,4,1,9,0xb2d20b64
686490.36,3.0,5,4,4,3,11,0xb2d2b84bd
15311.61,1.0,0,2,2,4,8,0xb2d485bd
2415.86,1.0,92,1,2,1,4,0xb2d3231d
50856.78,1.0,0,2,2,4,8,0xb2d6bf6b
5200.55,1.0,14,2,2,3,7,0xb2d9fbc9
4705757.23,4.0,11,4,4,3,11,0xb2d1a4eb
320307.23,4.0,35,4,4,2,10,0xb2d5dd2fd
39706.42,1.0,9,2,2,3,7,0xb2d5f83ed
2056.6,1.0,92,1,2,1,4,0xb2d1d1f1
6921.72,1.0,0,2,2,4,8,0xb2d50b23
1261.06,1.0,48,1,2,2,5,0xb2d6c02a
26504.56,1.0,0,2,2,4,8,0xb2d5916d
2797491.68,6.0,175,4,4,1,9,0xb2d34db9d
698022.1,2.0,24,4,3,2,9,0xb2d94498d
21.45,1.0,2,1,2,4,7,0xb2d58585
15009.85,1.0,2,2,2,4,8,0xb2d5ad84
10042.39,1.0,1,2,2,4,8,0xb2d547fed
65020.4,3.0,76,3,4,1,8,0xb2d77fad
348875.63,2.0,0,4,3,4,11,0xb2d108f1
13.15,1.0,6,1,2,3,6,0xb2d6e963d
182552.14,5.0,41,3,4,2,9,0x3b9b3f45
55001.81,2.0,21,3,3,2,8,0xb2d60afe
443.29,1.0,24,1,2,2,5,0xb2d34d3a
6473.77,1.0,10,2,2,3,7,0xb2d3bd85
65031.65,2.0,5,3,3,3,9,0xb2d81ed8
42.01,1.0,15,1,2,3,6,0xb2d0c4f1
6241.11,1.0,184,2,2,1,5,0xb2d5fd10
310001.62,2.0,11,4,3,3,10,0xb2d940cdd
136465.74,3.0,1,3,4,4,11,0xb2d4f03e
47901.97,1.0,0,2,2,4,8,0xb2d36783
259013.8,3.0,4,3,4,4,11,0xb2d548a0
180181.33,1.0,9,3,2,3,8,0xb2d3f93cd
66.63,2.0,78,1,3,1,5,0xb2d69a80
204405.64,3.0,27,3,4,2,9,0x3b9b2b2f
3430.36,1.0,37,2,2,2,6,0xb2d13f6f
500722.97,4.0,87,4,4,1,9,0xb2d1a897
41113.58,4.0,0,2,4,4,10,0xb2d1ed48
10.31,1.0,83,1,2,1,4,0xb2d56acd
1215.3,1.0,0,1,2,4,7,0xb2d62c3d
602.36,2.0,0,1,3,4,8,0xb2d0a11e
4697.43,2.0,92,2,3,1,6,0x3b9b396f
20111.15,1.0,103,2,2,1,5,0xb2d562dbd
20499.5,2.0,53,2,3,2,7,0xb2d6b198
124767.79,1.0,1,3,2,4,9,0xb2d21126
1621.9,2.0,184,1,3,1,5,0xb2d5d72dd
331531.94,5.0,40,4,4,2,10,0xb2d1e081
49.74,1.0,0,1,2,4,7,0xb2d968cb
991.58,1.0,9,1,2,3,6,0xb2d452f1
502.61,1.0,5,1,2,3,6,0xb2d1b543
11724.24,1.0,3,2,2,4,8,0xb2d6c00d
321336.7,4.0,4,4,4,4,12,0xb2d126fa
450001.0,3.0,3,4,4,4,12,0xb2da6124
22.52,1.0,9,1,2,3,6,0xb2d33e98
70187.47,6.0,0,3,4,4,11,0xb2d1c01c
577009.28,4.0,6,4,4,3,11,0xb2d5c5c3
29.93,1.0,35,1,2,2,5,0xb2d5cc52
309603.05,2.0,41,4,3,2,9,0xb2d61b7e
130565.29,1.0,0,3,2,4,9,0xb2d6b46d
10180.54,2.0,77,2,3,1,6,0xb2d98aef
3722000.0,2.0,1,4,3,4,11,0xb2da5c14
426015.4,3.0,13,4,4,3,11,0xb2d9eb07
729.46,1.0,12,1,2,3,6,0xb2d1187d
5998.81,1.0,10,2,2,3,7,0xb2d341fa
657628.84,6.0,10,4,4,3,11,0xb2d580db
105586.4,2.0,61,3,3,2,8,0xb2d4c475
50002.55,2.0,157,2,3,1,6,0xb2d5f6f1
170088.18,2.0,25,3,3,2,8,0xb2d518bc
31.67,1.0,34,1,2,2,5,0xb2d91bc1
201940.06,4.0,1,3,4,4,11,0xb2d40d51d
4.63,1.0,19,1,2,2,5,0xb2d9cd3b
5465.58,1.0,225,2,2,1,5,0xb2d26c0fd
13995.09,1.0,22,2,2,2,6,0xb2d2b877
108491.18,1.0,1,3,2,4,9,0xb2d227a3
500594.66,2.0,98,4,3,1,8,0xb2d26bd5
1791.13,4.0,107,1,4,1,6,0x3b9af204
200.55,2.0,18,1,3,2,6,0x3b9b3ef8
352948.18,4.0,7,4,4,3,11,0xb2d09841d
5745.75,2.0,85,2,3,1,6,0xb2d25be1d
1456.98,1.0,184,1,2,1,4,0x3b9b2da5
41273.82,1.0,8,2,2,3,7,0xb2d685c5d
766724.19,5.0,1,4,4,4,12,0xb2d0cbbd
35437.45,7.0,142,2,4,1,7,0xb2d0b1a3
251142.48,2.0,26,3,3,2,8,0xb2d68276
1100.37,1.0,9,1,2,3,6,0xb2d1c9f6
400022.33,3.0,3,4,4,4,12,0xb2d52e79
1520000.0,7.0,9,4,4,3,11,0xb2d1d4e4
1038958.79,2.0,36,4,3,2,9,0xb2d5b020
623909.43,4.0,2,4,4,4,12,0xb2d1714ad
6157.24,1.0,206,2,2,1,5,0xb2d61f49
7812.97,1.0,0,2,2,4,8,0xb2d280ce
360040.6,2.0,125,4,3,1,8,0xb2d49382
260070.95,2.0,25,3,3,2,8,0xb2d2abd4
512016.43,2.0,206,4,3,1,8,0xb2d5c323
3.34,1.0,14,1,2,3,6,0xb2d16c63
20.12,1.0,80,1,2,1,4,0xb2d867d8d
12.31,1.0,9,1,2,3,6,0xb2d69ca3
295033.07,5.0,13,3,4,3,10,0xb2da094d
233.46,1.0,80,1,2,1,4,0xb2d68210
706.57,1.0,0,1,2,4,7,0xb2d77f8a
699.27,1.0,102,1,2,1,4,0xb2d24081
1362.22,1.0,0,1,2,4,7,0xb2d0c444
28002.8,3.0,27,2,4,2,8,0xb2da010d
3416509.68,15.0,0,4,4,4,12,0x3b9b0e18
350003.21,4.0,14,4,4,3,11,0xb2d55c01
1158729.4,18.0,14,4,4,3,11,0xb2d520cc
5553.57,4.0,92,2,4,1,7,0xb2d0796f
330000.0,21.0,0,4,4,4,12,0x3b9b185ad
7324.31,1.0,1,2,2,4,8,0xb2d8f4f5d
56085.79,1.0,116,3,2,1,6,0xb2d3a686
128000.32,2.0,1,3,3,4,10,0xb2d60f91
1789.5,1.0,4,1,2,4,7,0xb2d61e95
500000.0,2.0,10,4,3,3,10,0xb2da4ea6
80000.84,2.0,69,3,3,1,7,0xb2d8ebc9
1603693.23,4.0,20,4,4,2,10,0x3b9af1bd
174689.21,2.0,1,3,3,4,10,0xb2d5e754
3027.14,1.0,9,2,2,3,7,0xb2d42e55
680014.4,2.0,186,4,3,1,8,0xb2d0ba23
30811.72,2.0,26,2,3,2,7,0xb2d41795
103.97,1.0,25,1,2,2,5,0xb2d97060
31950.26,2.0,101,2,3,1,6,0xb2d09207
37.08,1.0,133,1,2,1,4,0xb2d6562d
500000.36,2.0,16,4,3,2,9,0xb2d6c733
450118.59,5.0,80,4,4,1,9,0xb2d1fbee
30007.98,1.0,13,2,2,3,7,0xb2d2daced
50000.53,2.0,46,2,3,2,7,0xb2d9e0f6
821426.42,12.0,13,4,4,3,11,0xb2d65a35
2.09,1.0,0,1,2,4,7,0xb2d0c382
70.09,1.0,9,1,2,3,6,0xb2da0117
10312.11,1.0,112,2,2,1,5,0xb2d57064
30385.0,1.0,0,2,2,4,8,0xb2d54891
41.89,1.0,22,1,2,2,5,0xb2d8fef7
5426.0,1.0,77,2,2,1,5,0xb2d2fea0
1739.63,1.0,92,1,2,1,4,0xb2d3eabf
100575.39,1.0,2,3,2,4,9,0xb2d3878e
7089.0,1.0,0,2,2,4,8,0xb2d9bf9d
1107.12,1.0,145,1,2,1,4,0xb2d23a41
13674.91,2.0,87,2,3,1,6,0xb2d0ef57
50000.0,2.0,6,2,3,3,8,0xb2d969c1
4907.55,1.0,2,2,2,4,8,0xb2d2ef4bd
9965.22,1.0,92,2,2,1,5,0xb2d260e2
7998.48,1.0,0,2,2,4,8,0xb2d5f0c8
500059.22,1.0,4,4,2,4,10,0xb2d551ac
400020.83,2.0,25,4,3,2,9,0xb2d8fd8e
6314.67,1.0,110,2,2,1,5,0xb2d31212
2108.43,1.0,132,1,2,1,4,0xb2d78cce
50000.0,2.0,6,2,3,3,8,0xb2d96e8b
7150536.62,4.0,1,4,4,4,12,0xb2d91a50d
466.96,1.0,68,1,2,1,4,0xb2d212d6
213972.0,2.0,101,3,3,1,7,0xb2d3d3da
79.84,1.0,9,1,2,3,6,0xb2d30736
2117.59,2.0,0,1,3,4,8,0xb2d07928
100530.56,3.0,180,3,4,1,8,0xb2d1d510
976.81,1.0,51,1,2,2,5,0xb2d5b578
67998.42,1.0,8,3,2,3,8,0xb2d6853e
464413.59,2.0,42,4,3,2,9,0xb2d5f573
11730.7,1.0,20,2,2,2,6,0xb2d6b37ad
1362786.24,5.0,49,4,4,2,10,0xb2d10b07d
555556.13,2.0,8,4,3,3,10,0xb2d34975
839060.0,8.0,9,4,4,3,11,0xb2d2143a
5025.71,1.0,92,2,2,1,5,0xb2d42d3d
45002.85,2.0,69,2,3,1,6,0xb2d642a4d
833682.14,4.0,0,4,4,4,12,0xb2d6e21e
1068.48,1.0,184,1,2,1,4,0xb2d0a720d
3122862.29,5.0,24,4,4,2,10,0xb2d37493
50915.61,2.0,18,2,3,2,7,0xb2d63edb
5934.3,1.0,0,2,2,4,8,0xb2d6bafe
63.39,1.0,133,1,2,1,4,0xb2d91b4d
3019.26,1.0,92,2,2,1,5,0xb2d33466
50167.39,2.0,101,2,3,1,6,0xb2d613aed
230000.0,5.0,2,3,4,4,11,0xb2d14895
70001.8,4.0,27,3,4,2,9,0xb2d6d496d
41201.38,2.0,24,2,3,2,7,0xb2d55260
350306.56,2.0,74,4,3,1,8,0xb2d4c970
288391.65,5.0,59,3,4,2,9,0xb2d0b56f
13359.69,1.0,14,2,2,3,7,0xb2d275a8
1013347.52,2.0,31,4,3,2,9,0xb2d43ed5d
3784.1,1.0,184,2,2,1,5,0xb2d22102
30355.09,2.0,73,2,3,1,6,0xb2d5d20fd
0.0,1.0,8,1,2,3,6,0xb2d57634
3052.57,2.0,92,2,3,1,6,0x3b9b12c9d
3523532.29,1.0,0,4,2,4,10,0xb2d0e3eed
2013.8,1.0,184,1,2,1,4,0xb2d12be6
114.79,2.0,48,1,3,2,6,0xb2d1fec5
44414.25,1.0,3,2,2,4,8,0xb2d205ded
681091.58,5.0,4,4,4,4,12,0xb2d3c543
595.1,1.0,3,1,2,4,7,0xb2d729bb
1252346.96,4.0,35,4,4,2,10,0xb2d90a16d
0.38,1.0,2,1,2,4,7,0xb2d2c8c9
1205.91,1.0,184,1,2,1,4,0xb2d0e4c5
9606.48,1.0,2,2,2,4,8,0xb2d17ea9
120000.0,2.0,3,3,3,4,10,0xb2d977f0d
80011.63,2.0,92,3,3,1,7,0xb2d223a5d
200000.44,2.0,18,3,3,2,8,0xb2d90f56
202867.66,5.0,18,3,4,2,9,0xb2d06ebb
113010.36,4.0,25,3,4,2,9,0xb2d6de5fd
0.13,1.0,0,1,2,4,7,0xb2d6ac8e
6702.2,1.0,10,2,2,3,7,0xb2d926f9
50600.63,5.0,0,2,4,4,10,0xb2d36718
30000.32,2.0,92,2,3,1,6,0xb2d6376b
4701.25,1.0,12,2,2,3,7,0xb2d979ba
15251.37,2.0,11,2,3,3,8,0xb2d5c86b
52393.64,2.0,60,3,3,2,8,0xb2d9b51e
102531.46,2.0,104,3,3,1,7,0xb2d51033
62.13,1.0,7,1,2,3,6,0xb2d9268bd
0.84,1.0,2,1,2,4,7,0xb2d9eeb8
222313.72,1.0,4,3,2,4,9,0xb2d5b89a
846319.56,5.0,0,4,4,4,12,0xb2d20246
0.23,1.0,20,1,2,2,5,0xb2d119b4
43.5,1.0,8,1,2,3,6,0xb2da0eb2
713.85,1.0,56,1,2,2,5,0xb2d6b926
208111.8,4.0,132,3,4,1,8,0xb2d11d31d
50000.53,2.0,172,2,3,1,6,0xb2d23c26
51740.94,1.0,92,2,2,1,5,0xb2d4363c
104168.53,3.0,0,3,4,4,11,0xb2d6216a
0.84,1.0,60,1,2,2,5,0xb2d9b5d1
2938.41,1.0,2,2,2,4,8,0xb2d5b342
61778.12,2.0,95,3,3,1,7,0xb2d1ea2d
82218.49,2.0,13,3,3,3,9,0xb2d5746cd
0.0,1.0,7,1,2,3,6,0xb2d8e849
500728.07,2.0,20,4,3,2,9,0xb2d254ed
31146.63,1.0,0,2,2,4,8,0xb2d212ef
99718.04,1.0,49,3,2,2,7,0xb2d37c2f
792045.29,7.0,21,4,4,2,10,0xb2d6e3a7
530011.56,2.0,25,4,3,2,9,0xb2d953a3
80000.95,3.0,1,3,4,4,11,0xb2d9f98d
34102.02,1.0,0,2,2,4,8,0xb2d4518c
525920.65,4.0,0,4,4,4,12,0x3b9af237
200007.01,2.0,6,3,3,3,9,0xb2d61570
200270.38,2.0,5,3,3,3,9,0xb2d6b622
25100.16,1.0,184,2,2,1,5,0xb2d60b9d
137003.41,5.0,1,3,4,4,11,0xb2d163d8
240056.77,5.0,18,3,4,2,9,0xb2d1dc46d
1431.44,1.0,0,1,2,4,7,0xb2d20f6e
2000106.24,2.0,0,4,3,4,11,0xb2d34154
257.62,1.0,8,1,2,3,6,0xb2d14215d
10000.21,2.0,38,2,3,2,7,0xb2d92a15
2201.6,1.0,48,1,2,2,5,0xb2d92e58
288652.92,4.0,14,3,4,3,10,0xb2d0da0b
1312.9,1.0,9,1,2,3,6,0xb2d68c28d
1635.18,1.0,9,1,2,3,6,0xb2d7a8e0
1466479.47,4.0,0,4,4,4,12,0xb2d0cb01
7443.14,2.0,0,2,3,4,9,0xb2d0b7f2
197.41,1.0,14,1,2,3,6,0xb2d351ed
4531.21,1.0,97,2,2,1,5,0xb2d6d8c5
89.95,1.0,53,1,2,2,5,0xb2d44ac8
375006.73,9.0,7,4,4,3,11,0xb2d5bd3c
35002.68,3.0,6,2,4,3,9,0xb2d92b6cd
853.38,1.0,9,1,2,3,6,0xb2d8dcbf
50000.53,2.0,116,2,3,1,6,0xb2d7ee68
5290.0,1.0,184,2,2,1,5,0xb2d25a05
20466.68,3.0,0,2,4,4,10,0xb2d90ab7d
3.34,1.0,3,1,2,4,7,0xb2d611c6
42716.64,4.0,111,2,4,1,7,0xb2d93bedd
200000.0,2.0,11,3,3,3,9,0xb2d96871d
869853.4,4.0,76,4,4,1,9,0xb2d110a3
50046.93,3.0,53,2,4,2,8,0xb2d9c76a
30401.69,1.0,6,2,2,3,7,0xb2d94904
2288.16,1.0,245,1,2,1,4,0xb2d1f147
9100.71,1.0,184,2,2,1,5,0xb2d2754c
1019.55,1.0,0,1,2,4,7,0xb2d5bdbf
402911.25,2.0,57,4,3,2,9,0xb2d68764
359649.8,6.0,8,4,4,3,11,0xb2d3532f
1939.18,1.0,98,1,2,1,4,0xb2d2fa62
1716408.99,16.0,3,4,4,4,12,0xb2d207c8
24273.57,1.0,22,2,2,2,6,0xb2d247f3
2950080.34,3.0,186,4,4,1,9,0xb2d7836e
13237.75,1.0,3,2,2,4,8,0xb2d75388
50000.53,2.0,70,2,3,1,6,0xb2d9a638
10044.34,1.0,20,2,2,2,6,0xb2da0fd2
200710.68,2.0,37,3,3,2,8,0xb2d423c1
130001.37,2.0,87,3,3,1,7,0xb2d8cacf
700000.85,3.0,16,4,4,2,10,0xb2d3156a
72339.04,1.0,28,3,2,2,7,0xb2d5c000
0.0,1.0,6,1,2,3,6,0xb2d5d3f2
26295.28,1.0,14,2,2,3,7,0xb2d42ae8
247.7,1.0,0,1,2,4,7,0xb2d623e8
250027.17,5.0,42,3,4,2,9,0xb2d127e1
120001.27,2.0,92,3,3,1,7,0xb2d98009d
0.0,2.0,70,1,3,1,5,0xb2d5ae67
142092.64,4.0,1,3,4,4,11,0xb2d1e8c3
1712.24,1.0,184,1,2,1,4,0xb2d34b16d
1674.88,1.0,89,1,2,1,4,0xb2d6525fd
21314.67,1.0,26,2,2,2,6,0xb2d2eadb
500491.94,3.0,11,4,4,3,11,0xb2d2dd5d
1776.44,1.0,2,1,2,4,7,0xb2d2ef40
52401.8,2.0,161,3,3,1,7,0xb2d12220d
56075.84,2.0,202,3,3,1,7,0xb2d2952a
850019.04,5.0,1,4,4,4,12,0xb2d5efefd
91001.0,6.0,2,3,4,4,11,0xb2d52c3ed
550000.86,7.0,6,4,4,3,11,0xb2d25de5
57.42,1.0,0,1,2,4,7,0xb2d78527d
15000.9,2.0,66,2,3,2,7,0xb2d351d0d
8001.65,1.0,29,2,2,2,6,0xb2d781ed
501776.04,2.0,33,4,3,2,9,0xb2d93902
63869.6,3.0,82,3,4,1,8,0xb2d5b51a
150175.62,2.0,83,3,3,1,7,0xb2d2697b
10705.07,2.0,184,2,3,1,6,0x3b9b3284
0.49,1.0,4,1,2,4,7,0xb2d69712
1385.88,1.0,184,1,2,1,4,0xb2d2d521d
3000684.78,4.0,18,4,4,2,10,0xb2d90f90d
10243.95,1.0,35,2,2,2,6,0xb2d42afb
3454.63,1.0,118,2,2,1,5,0xb2d68c49
192008.09,7.0,8,3,4,3,10,0xb2d11f28
133019.77,4.0,39,3,4,2,9,0xb2d5fb8a
36935.76,3.0,0,2,4,4,10,0xb2d4d93e
60004.96,3.0,60,3,4,2,9,0xb2d685df
2925.59,1.0,20,2,2,2,6,0xb2d3f796
130086.58,2.0,221,3,3,1,7,0xb2d575e8
23000.97,2.0,196,2,3,1,6,0xb2d7ad0c
159510.62,3.0,34,3,4,2,9,0xb2d2f153
2681.84,1.0,15,1,2,3,6,0xb2d2f1a6d
1021.39,1.0,184,1,2,1,4,0xb2d10054
30159.67,2.0,15,2,3,3,8,0xb2d1e587
654054.47,7.0,1,4,4,4,12,0xb2d455cc
526053.85,7.0,1,4,4,4,12,0xb2d47e51
20002.13,2.0,10,2,3,3,8,0xb2d960afd
3174.5,1.0,0,2,2,4,8,0xb2d9c449
1015.93,1.0,92,1,2,1,4,0xb2d0d92b
272.24,1.0,18,1,2,2,5,0xb2d18354
1672222.65,80.0,181,4,4,1,9,0xb2d159b8
26080.5,3.0,2,2,4,4,10,0xb2d16615
281078.43,2.0,33,3,3,2,8,0xb2d93577
152.2,1.0,2,1,2,4,7,0xb2d1a567
1200000.8,2.0,16,4,3,2,9,0xb2d6f4c0
5806.44,1.0,0,2,2,4,8,0xb2d315bd
5.53,1.0,69,1,2,1,4,0xb2d8db4d
0.65,1.0,15,1,2,3,6,0xb2d63f4ed
326.52,1.0,0,1,2,4,7,0xb2d6f0b8
2318.18,1.0,20,1,2,2,5,0xb2d1f7c1
20005.74,1.0,0,2,2,4,8,0xb2d5eb33d
1700.96,1.0,2,1,2,4,7,0xb2d0f6c7
5437.94,2.0,15,2,3,3,8,0xb2da3205
8420.11,2.0,184,2,3,1,6,0xb2d0ded6
146.41,1.0,1,1,2,4,7,0xb2d8399c
80522.03,1.0,0,3,2,4,9,0xb2d60768
1970069.58,10.0,6,4,4,3,11,0xb2d1487f
4913.41,1.0,152,2,2,1,5,0xb2d8dd36
54154.7,2.0,10,3,3,3,9,0xb2d378d0
16062.38,2.0,212,2,3,1,6,0xb2d07bc6d
364491.21,2.0,31,4,3,2,9,0xb2d40ed1d
1743.89,1.0,2,1,2,4,7,0xb2d4b8ca
1409.2,1.0,5,1,2,3,6,0xb2d6ec9e
3.15,1.0,30,1,2,2,5,0xb2d4a603d
140019.38,3.0,76,3,4,1,8,0xb2d58bd8
410013.54,3.0,193,4,4,1,9,0xb2d1c162
20077.85,2.0,11,2,3,3,8,0xb2d84773
8147.67,1.0,8,2,2,3,7,0xb2d48c75d
50002.64,2.0,63,2,3,2,7,0xb2d9afd9
34573.41,1.0,22,2,2,2,6,0xb2d30423
206992.81,1.0,1,3,2,4,9,0xb2d790c5
665487.61,8.0,83,4,4,1,9,0xb2d22db7d
2448.95,1.0,92,1,2,1,4,0xb2d0bf79
8965.97,2.0,184,2,3,1,6,0x3b9aceaa
213608.82,6.0,0,3,4,4,11,0xb2d9a31e
303820.84,2.0,83,4,3,1,8,0xb2d249a0
140007.3,3.0,70,3,4,1,8,0xb2d1db2f
1000181.56,2.0,53,4,3,2,9,0xb2d94acd
600000.11,6.0,3,4,4,4,12,0xb2d0ff0f
133931.82,2.0,45,3,3,2,8,0xb2d4260f
982892.82,6.0,3,4,4,4,12,0xb2d3c5f5d
268.09,2.0,0,1,3,4,8,0x3b9af62b
1738.42,1.0,151,1,2,1,4,0xb2d60d14
47005.67,4.0,184,2,4,1,7,0xb2d16dce
2150000.0,2.0,0,4,3,4,11,0xb2d38333
40225.5,1.0,15,2,2,3,7,0xb2d3110e
1050087.62,6.0,4,4,4,4,12,0xb2d9acc1
529.91,1.0,10,1,2,3,6,0xb2d98929
1122.68,1.0,11,1,2,3,6,0xb2d2c276
15227.74,2.0,52,2,3,2,7,0xb2d4bdfc
341131.24,3.0,69,4,4,1,9,0xb2d0a976d
154355.8,1.0,12,3,2,3,8,0xb2d4b628
44565.94,2.0,142,2,3,1,6,0xb2d5d0b0
3002.1,1.0,11,2,2,3,7,0xb2d6bce7
200000.0,1.0,5,3,2,3,8,0xb2da095f
10507.5,1.0,306,2,2,1,5,0xb2d37016
90291.28,8.0,0,3,4,4,11,0xb2d58529
0.0,1.0,6,1,2,3,6,0xb2d6bf9f
100082.36,2.0,39,3,3,2,8,0xb2d94ae1
284273.93,4.0,10,3,4,3,10,0xb2d29116d
500292.61,2.0,4,4,3,4,11,0xb2d9d519
1405155.08,11.0,6,4,4,3,11,0xb2d156a7
10165.93,1.0,92,2,2,1,5,0xb2d2f361
713114.12,8.0,1,4,4,4,12,0xb2d839b5d
1827696.61,5.0,1,4,4,4,12,0xb2d1a310
687506.44,7.0,0,4,4,4,12,0x3b9af2c8
5513.73,1.0,9,2,2,3,7,0xb2d3fa11
40078.56,2.0,133,2,3,1,6,0xb2d6a7e7
234074.48,7.0,6,3,4,3,10,0xb2d5e743d
238059.01,5.0,45,3,4,2,9,0xb2d8048d
251177.52,2.0,17,3,3,2,8,0xb2d5ab9d
200003.17,2.0,18,3,3,2,8,0xb2d643cb
1239.31,1.0,92,1,2,1,4,0xb2d26fae
334692.43,2.0,88,4,3,1,8,0xb2d90217
500000.0,2.0,19,4,3,2,9,0xb2da3030
1186.06,1.0,10,1,2,3,6,0xb2d4763ed
710032.83,8.0,12,4,4,3,11,0xb2d8c6a1
70075.0,2.0,0,3,3,4,10,0xb2d17791d
50025.46,4.0,13,2,4,3,9,0xb2d09963
9681.39,1.0,16,2,2,2,6,0xb2d728f2
19.8,1.0,12,1,2,3,6,0xb2d80f2b
173613.69,7.0,2,3,4,4,11,0xb2d57b15
230010.61,5.0,1,3,4,4,11,0xb2d9dbc8
500000.65,2.0,9,4,3,3,10,0xb2d9634b
300001.06,3.0,12,3,4,3,10,0xb2da144e
80047.69,2.0,87,3,3,1,7,0xb2d528f5
706007.45,3.0,83,4,4,1,9,0xb2d97c9a
50001.59,2.0,27,2,3,2,7,0xb2d27abf
700000.38,3.0,19,4,4,2,10,0xb2d6c026
170293.17,3.0,32,3,4,2,9,0xb2d38b9a
12096.65,1.0,2,2,2,4,8,0xb2d34c15
338715.14,4.0,60,4,4,2,10,0xb2d3fa8f
430634.28,4.0,31,4,4,2,10,0xb2d53c38d
63001.33,2.0,25,3,3,2,8,0xb2d91ed9
26.49,6.0,65,1,4,2,7,0xb2d23dce
8104.79,1.0,112,2,2,1,5,0xb2d18a41
10.7,1.0,18,1,2,2,5,0xb2d6824dd
1177031.74,5.0,6,4,4,3,11,0xb2d248f0
1816.52,1.0,92,1,2,1,4,0xb2d281fe
3137.44,1.0,193,2,2,1,5,0xb2d10b51d
11366.87,2.0,18,2,3,2,7,0xb2d532af
1807.59,1.0,10,1,2,3,6,0xb2d57966d
5794509.88,4.0,18,4,4,2,10,0x3b9b455d
50001.06,2.0,39,2,3,2,7,0xb2d9f01c
300008.05,2.0,0,3,3,4,10,0xb2d5f5a2
145058.66,5.0,6,3,4,3,10,0xb2d602fa
200.0,1.0,1,1,2,4,7,0xb2d95131
48669.32,1.0,152,2,2,1,5,0xb2d4015e
352222.41,3.0,0,4,4,4,12,0xb2d9a902
6633.39,1.0,114,2,2,1,5,0xb2d64f69
200007.29,3.0,27,3,4,2,9,0xb2d0b668
356867.65,5.0,0,4,4,4,12,0xb2d56dce
350022.24,2.0,1,4,3,4,11,0xb2d60e5f
31492.76,1.0,0,2,2,4,8,0xb2d1c281
1805.53,1.0,20,1,2,2,5,0xb2d2e5bc
3938.83,1.0,0,2,2,4,8,0xb2d9d9ac
534.06,1.0,0,1,2,4,7,0xb2d8d363
1042.34,1.0,184,1,2,1,4,0xb2d5a975
377.39,1.0,10,1,2,3,6,0xb2d61404
200000.75,3.0,82,3,4,1,8,0x3b9b19d4
321000.0,6.0,6,4,4,3,11,0xb2d2ecbf
3823.45,1.0,104,2,2,1,5,0xb2d1a4fdd
170389.65,4.0,18,3,4,2,9,0x3b9b4244d
100922.47,1.0,126,3,2,1,6,0xb2d34eb2
6067.71,1.0,9,2,2,3,7,0xb2d56ed1d
201470.49,2.0,76,3,3,1,7,0xb2d25aafd
630101.38,2.0,42,4,3,2,9,0xb2d61b41d
2287032.88,11.0,0,4,4,4,12,0xb2d1e297
744.88,1.0,60,1,2,2,5,0xb2d15c9cd
56040.34,2.0,67,3,3,1,7,0xb2d5ef8bd
1144931.32,21.0,0,4,4,4,12,0x3b9b17f5
1221523.37,49.0,3,4,4,4,12,0x3b9b0fa1
1804.95,1.0,77,1,2,1,4,0xb2d3ab3a
1166.26,1.0,126,1,2,1,4,0xb2d650fd
74894.25,1.0,0,3,2,4,9,0xb2d1f578
594879.56,7.0,11,4,4,3,11,0xb2d42202
269904.92,3.0,109,3,4,1,8,0xb2d1bca3
34.43,1.0,3,1,2,4,7,0xb2d437f0
1030056.58,2.0,0,4,3,4,11,0xb2d49c7d
6000.61,1.0,10,2,2,3,7,0xb2d9ea85
51005.05,2.0,82,2,3,1,6,0xb2d5b1aa
75620.17,2.0,51,3,3,2,8,0xb2d0b166
0.0,1.0,3,1,2,4,7,0xb2d57ab8
2133.22,1.0,30,1,2,2,5,0xb2d689d9
115.05,1.0,48,1,2,2,5,0xb2d9a343
580075.32,5.0,14,4,4,3,11,0xb2d94bd0d
4696.64,1.0,9,2,2,3,7,0xb2d5853a
4226.1,1.0,25,2,2,2,6,0xb2d6ba50
7824.35,1.0,14,2,2,3,7,0xb2d907ec
114496.44,1.0,1,3,2,4,9,0xb2d107cd
501088.12,6.0,0,4,4,4,12,0x3b9af16a
700580.92,3.0,118,4,4,1,9,0xb2d0d64a
1492.03,1.0,17,1,2,2,5,0xb2d2eec2
985067.82,6.0,19,4,4,2,10,0xb2d5ab60
27559.68,1.0,4,2,2,4,8,0xb2d40bc8
201421.11,2.0,13,3,3,3,9,0xb2d8e44c
5362.36,1.0,5,2,2,3,7,0xb2d6a251
194.4,1.0,0,1,2,4,7,0xb2d2b284
800130.33,2.0,217,4,3,1,8,0xb2d126ac
114265.82,1.0,0,3,2,4,9,0xb2d4070ad
800000.0,6.0,1,4,4,4,12,0xb2d572d4
30104.69,2.0,92,2,3,1,6,0xb2d93299d
501776.04,2.0,33,4,3,2,9,0xb2d90376
254036.34,3.0,15,3,4,3,10,0xb2d3e6b9
150003.69,3.0,60,3,4,2,9,0xb2d99acc
5075.27,1.0,92,2,2,1,5,0xb2d11c06
68100.74,2.0,32,3,3,2,8,0xb2d12ffe
200000.0,2.0,4,3,3,4,10,0xb2d9736d
0.0,1.0,6,1,2,3,6,0xb2d6ab86
133945.14,3.0,6,3,4,3,10,0xb2d252b9
16443.65,1.0,8,2,2,3,7,0xb2d8fec7
300011.1,3.0,41,3,4,2,9,0xb2d1342ad
1001.58,1.0,160,1,2,1,4,0xb2d8ea98
101.63,1.0,2,1,2,4,7,0xb2d92bec
1.0,1.0,0,1,2,4,7,0xb2da50af
660004.82,4.0,14,4,4,3,11,0xb2d633a1
41231.72,2.0,108,2,3,1,6,0x3b9b3029
7969765.66,24.0,0,4,4,4,12,0x3b9b0e1b
20566.22,1.0,0,2,2,4,8,0xb2d6f5a9
754.76,1.0,35,1,2,2,5,0xb2d1c5b4
250376.0,1.0,0,3,2,4,9,0xb2d4f02a
2000204.53,7.0,1,4,4,4,12,0xb2d1687e
7907.52,1.0,28,2,2,2,6,0xb2d2a68b
703.88,1.0,28,1,2,2,5,0xb2d27a47
122028.05,1.0,7,3,2,3,8,0xb2d21fb6
662149.97,4.0,15,4,4,3,11,0xb2d2be0d
5468.38,1.0,92,2,2,1,5,0xb2d33168
558862.41,4.0,52,4,4,2,10,0xb2d5dd95
620048.8,4.0,0,4,4,4,12,0xb2d624e3
50532.93,1.0,184,2,2,1,5,0xb2d2916e
467.36,1.0,7,1,2,3,6,0xb2d375d4
460491.0,3.0,0,4,4,4,12,0xb2d5920ad
29852.08,1.0,0,2,2,4,8,0xb2d355e3
10029.58,1.0,58,2,2,2,6,0xb2d4a9c8
3001.67,1.0,12,2,2,3,7,0xb2d9a059
15237.12,1.0,56,2,2,2,6,0xb2d247c0
1340.58,1.0,12,1,2,3,6,0xb2d24bdd
2168647.31,9.0,5,4,4,3,11,0xb2d0df37
1160649.03,2.0,92,4,3,1,8,0xb2d1720c
3695.67,2.0,68,2,3,1,6,0xb2d549c7
43002.11,1.0,10,2,2,3,7,0xb2d96ef5
721652.66,1.0,1,4,2,4,10,0xb2d360b3
2513.65,1.0,290,1,2,1,4,0xb2d2e486
2343.85,1.0,71,1,2,1,4,0xb2d7172f
719915.22,2.0,92,4,3,1,8,0xb2d644f2d
1297.67,1.0,92,1,2,1,4,0xb2d402d7d
300052.88,4.0,54,3,4,2,9,0xb2d5d252d
46160.38,3.0,94,2,4,1,7,0xb2d4273fd
468005.41,3.0,20,4,4,2,10,0xb2d9580b
80266.85,1.0,9,3,2,3,8,0xb2d4fd0e
41.17,1.0,25,1,2,2,5,0xb2da11d1
207118.97,3.0,172,3,4,1,8,0xb2d4e969
114733.58,3.0,42,3,4,2,9,0xb2d601a7d
3574.74,1.0,92,2,2,1,5,0xb2d2019ad
11223.05,2.0,66,2,3,2,7,0xb2d14a1c
30000.95,2.0,10,2,3,3,8,0xb2d95f37
600000.02,4.0,13,4,4,3,11,0xb2d44917
4857000.32,11.0,3,4,4,4,12,0xb2d54c24
895075.35,4.0,1,4,4,4,12,0xb2d6429c
106077.28,2.0,4,3,3,4,10,0xb2d23c39d
5355083.85,8.0,13,4,4,3,11,0xb2d17acd
0.0,1.0,2,1,2,4,7,0xb2da5909
162489.98,2.0,76,3,3,1,7,0xb2d1c340d
2720000.0,5.0,9,4,4,3,11,0xb2d58ca9
60997.3,2.0,77,3,3,1,7,0xb2d6d90fd
108.43,2.0,10,1,3,3,7,0xb2d20688
1009000.51,7.0,6,4,4,3,11,0xb2d329b7d
202.21,1.0,7,1,2,3,6,0xb2d8da14
0.0,1.0,0,1,2,4,7,0xb2d4666e
3.1,1.0,41,1,2,2,5,0xb2d921d9
62288.07,3.0,0,3,4,4,11,0xb2d4f0c5
270458.17,3.0,0,3,4,4,11,0xb2d30f63
540723.09,6.0,1,4,4,4,12,0xb2d5f57a
100164.13,3.0,104,3,4,1,8,0xb2d0da34d
396006.87,11.0,10,4,4,3,11,0xb2d1925a
213659.8,3.0,0,3,4,4,11,0xb2d28f7c
209.15,1.0,146,1,2,1,4,0xb2d5facdd
166049.99,5.0,12,3,4,3,10,0xb2d4f11ed
1350062.01,4.0,8,4,4,3,11,0xb2d60969
100025.26,3.0,21,3,4,2,9,0xb2d4e779
1837.73,1.0,184,1,2,1,4,0x3b9b2b2bd
64871.84,1.0,0,3,2,4,9,0xb2d6db38
201850.11,2.0,25,3,3,2,8,0xb2d1bca3d
50001.06,2.0,92,2,3,1,6,0xb2d67dc2
640085.41,6.0,9,4,4,3,11,0xb2d2e58b
5255334.95,7.0,6,4,4,3,11,0xb2d905c0
102387.18,3.0,70,3,4,1,8,0xb2d653d0
784.76,1.0,1,1,2,4,7,0xb2d923e1
3713.79,1.0,27,2,2,2,6,0xb2d972b0
6808.42,3.0,184,2,4,1,7,0x3b9b3d7f
204266.33,2.0,201,3,3,1,7,0xb2d30485
50006.72,2.0,228,2,3,1,6,0xb2d62644
360063.14,9.0,4,4,4,4,12,0xb2d8e1a8d
558605.03,9.0,0,4,4,4,12,0xb2d19ea9
60004.18,2.0,27,3,3,2,8,0xb2d4e8e5
5802.1,1.0,158,2,2,1,5,0xb2d69c6f
1219.11,1.0,42,1,2,2,5,0xb2d46995
50060.59,1.0,34,2,2,2,6,0xb2d37c14d
51861.71,2.0,0,2,3,4,9,0xb2d0e7b0
110000.17,2.0,9,3,3,3,9,0xb2d91f6fd
36340.6,1.0,16,2,2,2,6,0xb2d8cf36
3621.13,1.0,0,2,2,4,8,0xb2d6b7d5
879983.64,5.0,21,4,4,2,10,0xb2d5cb62
201.1,1.0,0,1,2,4,7,0xb2d92206
105577.74,2.0,89,3,3,1,7,0xb2d234a8
2312.08,1.0,14,1,2,3,6,0xb2d8e23b
8351.28,1.0,21,2,2,2,6,0xb2d9683b
602195.34,4.0,41,4,4,2,10,0xb2d15921d
925000.0,12.0,4,4,4,4,12,0xb2d24edb
3175457.93,2.0,0,4,3,4,11,0xb2d5f84c
265564.0,2.0,27,3,3,2,8,0xb2d4f636
3494.66,1.0,14,2,2,3,7,0xb2d2ac44
1862.75,1.0,5,1,2,3,6,0xb2d42d41
3701.74,1.0,20,2,2,2,6,0xb2d91d67
2400.83,1.0,14,1,2,3,6,0xb2d8e48b
6991.51,1.0,20,2,2,2,6,0xb2d92d0fd
203505.23,3.0,82,3,4,1,8,0xb2d61b4a
540616.82,3.0,143,4,4,1,9,0xb2d12167
52042.26,1.0,3,2,2,4,8,0xb2d59fc4
490037.11,3.0,3,4,4,4,12,0xb2d9479e
132440.41,7.0,0,3,4,4,11,0xb2d0d47fd
50002.64,2.0,92,2,3,1,6,0xb2d63459
1975.29,1.0,11,1,2,3,6,0xb2d1fc99
320000.0,2.0,7,4,3,3,10,0xb2da53cd
150193.19,2.0,2,3,3,4,10,0xb2d0e301
50002.64,2.0,19,2,3,2,7,0xb2d94d83d
162410.22,4.0,18,3,4,2,9,0xb2d06e67
605235.14,14.0,3,4,4,4,12,0xb2d35680
230016.98,2.0,1,3,3,4,10,0xb2d9c68b
8000001.53,3.0,1,4,4,4,12,0xb2da65ae
1048.15,1.0,10,1,2,3,6,0xb2d3717f
5959.07,1.0,0,2,2,4,8,0xb2d165aa
544982.7,2.0,0,4,3,4,11,0xb2d14620
100040.54,2.0,104,3,3,1,7,0xb2d574d1
125.15,1.0,21,1,2,2,5,0xb2d6d1a1d
50691.19,1.0,54,2,2,2,6,0xb2d2bd82
2271133.07,9.0,60,4,4,2,10,0xb2d11ce2d
200044.68,3.0,31,3,4,2,9,0xb2d9e927
144066.94,2.0,13,3,3,3,9,0xb2d14d4a
3366.67,1.0,15,2,2,3,7,0xb2d3a62b
17299.14,1.0,9,2,2,3,7,0xb2d6970c
50001.58,2.0,11,2,3,3,8,0xb2da3b62
500000.08,2.0,19,4,3,2,9,0xb2d992d5
500001.02,2.0,3,4,3,4,11,0xb2d0dd05
50000.96,3.0,163,2,4,1,7,0xb2d6061e
75313.99,32.0,0,3,4,4,11,0x3b9b1816
36717.97,1.0,28,2,2,2,6,0xb2d62b19d
31.3,1.0,10,1,2,3,6,0xb2d9cd8c
53247.93,2.0,116,3,3,1,7,0xb2d512d0
5398.41,1.0,3,2,2,4,8,0xb2d65607
100001.06,2.0,18,3,3,2,8,0xb2da2ea7
20043.09,1.0,214,2,2,1,5,0xb2d6e1c0
570674.27,15.0,3,4,4,4,12,0xb2d357f5
1919.38,1.0,184,1,2,1,4,0xb2d1dd25d
221576.04,3.0,111,3,4,1,8,0xb2d33c5dd
621.55,1.0,0,1,2,4,7,0xb2d6c004
85.91,1.0,20,1,2,2,5,0xb2d264d0
720002.21,2.0,0,4,3,4,11,0xb2d27c1f
283.0,1.0,9,1,2,3,6,0xb2d96067
50001.06,2.0,11,2,3,3,8,0xb2da3f8d
277.52,1.0,0,1,2,4,7,0xb2d6bbb4
4915.01,1.0,10,2,2,3,7,0xb2d96715d
32.12,1.0,33,1,2,2,5,0xb2d98349
5874.24,1.0,92,2,2,1,5,0xb2d22cc6
635.83,2.0,60,1,3,2,6,0xb2d0a06d
28521.88,1.0,110,2,2,1,5,0xb2d1b628
76499.06,1.0,0,3,2,4,9,0xb2d35a30d
8412.06,1.0,10,2,2,3,7,0xb2d6ef98
2952.99,1.0,15,2,2,3,7,0xb2d9bd32
202196.63,2.0,74,3,3,1,7,0xb2d8d37e
97067.17,3.0,87,3,4,1,8,0xb2d44dd1
0.03,1.0,6,1,2,3,6,0xb2da0acf
500000.0,2.0,21,4,3,2,9,0xb2d950a9d
500015.83,2.0,80,4,3,1,8,0xb2d8d28e
532156.77,1.0,33,4,2,2,8,0xb2d26a10
6019.4,1.0,92,2,2,1,5,0xb2d5edcb
343046.82,12.0,20,4,4,2,10,0xb2d50fe7d
738.89,1.0,40,1,2,2,5,0xb2d7a78f
800025.35,2.0,102,4,3,1,8,0xb2d95eaf
52.98,1.0,9,1,2,3,6,0xb2d8fdb7
4000000.0,1.0,0,4,2,4,10,0xb2d8f3bb
500000.0,2.0,22,4,3,2,9,0xb2d9504a
767194.28,5.0,97,4,4,1,9,0xb2d0bf3cd
1385.44,1.0,168,1,2,1,4,0x3b9ae069
192.43,1.0,12,1,2,3,6,0xb2d1f138
10027.46,1.0,112,2,2,1,5,0xb2d30c55
9151.26,1.0,2,2,2,4,8,0xb2d912eb
325000.89,5.0,0,4,4,4,12,0xb2d09705
53603.42,1.0,14,3,2,3,8,0xb2d31926
50007.53,2.0,108,2,3,1,6,0xb2d23c71
730000.13,7.0,0,4,4,4,12,0xb2d6696d
801873.26,4.0,27,4,4,2,10,0xb2d941f4
991411.65,3.0,5,4,4,3,11,0xb2d5d263
349001.49,5.0,32,4,4,2,10,0xb2d1870e
31117.59,1.0,0,2,2,4,8,0xb2d329b2d
7860755.95,3.0,0,4,4,4,12,0xb2d4db7f
52021.25,1.0,210,2,2,1,5,0xb2d6197f
302131.65,2.0,43,4,3,2,9,0xb2d8e6f3d
500077.5,3.0,22,4,4,2,10,0xb2d69294
1169.44,1.0,170,1,2,1,4,0xb2d63b8a
1146146.59,18.0,1,4,4,4,12,0x3b9adcdf
2651631.94,8.0,21,4,4,2,10,0xb2d1bd74d
15365.56,1.0,138,2,2,1,5,0xb2d6f3c2
400000.0,3.0,48,4,4,2,10,0xb2d98ac7
220146.63,4.0,1,3,4,4,11,0xb2d390bc
26535.75,1.0,0,2,2,4,8,0xb2d2f1b8
5433.09,1.0,13,2,2,3,7,0xb2d336de
862930.78,2.0,160,4,3,1,8,0xb2d4eec4d
1954.45,1.0,16,1,2,2,5,0xb2d34bc2
742045.86,5.0,15,4,4,3,11,0xb2d63534
21000.22,2.0,83,2,3,1,6,0xb2d8d1c6d
676011.79,18.0,0,4,4,4,12,0xb2d0b525
31312.61,2.0,11,2,3,3,8,0xb2d66b23
1260101.18,8.0,12,4,4,3,11,0xb2d2f24b
1018.88,1.0,4,1,2,4,7,0xb2d31ad2d
11.6,1.0,12,1,2,3,6,0xb2d26587d
7727.69,1.0,29,2,2,2,6,0xb2d928fc
50594.15,1.0,48,2,2,2,6,0xb2d90c9dd
300046.41,2.0,4,3,3,4,10,0xb2d178d7
1096.03,1.0,92,1,2,1,4,0xb2d1fc03
1.28,1.0,10,1,2,3,6,0xb2d9ab39
120000.0,3.0,10,3,4,3,10,0xb2d55c54
64810.97,2.0,0,3,3,4,10,0xb2d3b995d
335501.82,5.0,31,4,4,2,10,0xb2d460dd
20323.35,5.0,1,2,4,4,10,0xb2d09c8d
9.05,1.0,86,1,2,1,4,0xb2d6a380
500137.46,2.0,15,4,3,3,10,0xb2d78cda
100008.63,2.0,231,3,3,1,7,0xb2d4b33a
124294.96,1.0,7,3,2,3,8,0xb2d627b5
825509.36,2.0,60,4,3,2,9,0xb2d42fcc
40036.22,3.0,5,2,4,3,9,0xb2d567dad
252183.1,3.0,4,3,4,4,11,0xb2d19f05d
2577.29,1.0,5,1,2,3,6,0xb2d57886
1098.69,1.0,11,1,2,3,6,0xb2d6d40d
1210000.0,12.0,6,4,4,3,11,0xb2d225e5d
12643.86,1.0,0,2,2,4,8,0xb2d2687a
151955.22,2.0,4,3,3,4,10,0xb2d211b0
80019.23,2.0,115,3,3,1,7,0xb2d6bbbf
31304.38,2.0,36,2,3,2,7,0xb2d2ae4e
8110.1,1.0,31,2,2,2,6,0xb2d6aad1
137.59,1.0,5,1,2,3,6,0xb2d6cec6
290081.99,3.0,9,3,4,3,10,0xb2d0fc1f
448602.16,4.0,60,4,4,2,10,0xb2d5b021
1.84,1.0,5,1,2,3,6,0xb2d22bad
2142.08,2.0,12,1,3,3,7,0xb2d08cad
2526.26,1.0,92,1,2,1,4,0xb2d3be6b
4027.3,1.0,2,2,2,4,8,0xb2d1e763
20831.25,2.0,157,2,3,1,6,0xb2d61e94
503.13,1.0,42,1,2,2,5,0xb2d69f5a
8492.87,1.0,4,2,2,4,8,0xb2d2a20f
340032.9,4.0,46,4,4,2,10,0xb2d3f6da
710006.7,5.0,21,4,4,2,10,0xb2d95252d
2105.23,1.0,0,1,2,4,7,0xb2d6c1bb
115258.47,2.0,3,3,3,4,10,0xb2d1a618
24717.13,1.0,20,2,2,2,6,0xb2d6a05c
306415.71,3.0,1,4,4,4,12,0xb2d5c914
81934.32,6.0,4,3,4,4,11,0xb2d5a9ac
9888.1,1.0,9,2,2,3,7,0xb2d40e52d
697.09,1.0,24,1,2,2,5,0xb2d586ad
4226.26,1.0,19,2,2,2,6,0xb2d68d0c
80133.25,2.0,158,3,3,1,7,0xb2d559ca
34613.02,1.0,21,2,2,2,6,0xb2d6e10c
1241.46,1.0,118,1,2,1,4,0xb2d0ecded
510000.0,2.0,0,4,3,4,11,0xb2d75ba1d
20001.06,2.0,118,2,3,1,6,0xb2d93ef7
11046.83,1.0,7,2,2,3,7,0xb2d2c3eed
1168.22,1.0,0,1,2,4,7,0xb2d13330
620000.98,4.0,0,4,4,4,12,0xb2d47d6c
110792.22,1.0,133,3,2,1,6,0xb2d35513
620059.03,5.0,39,4,4,2,10,0xb2d5127c
826104.13,3.0,25,4,4,2,10,0xb2d43735
200.72,11.0,2,1,4,4,9,0xb2d0b50f
3000776.68,6.0,17,4,4,2,10,0xb2d5adf7
2.46,1.0,84,1,2,1,4,0xb2d7ef65
3.06,1.0,46,1,2,2,5,0xb2d8ee81
1616313.88,12.0,0,4,4,4,12,0x3b9b1016
846579.52,4.0,33,4,4,2,10,0xb2d1db91
180288.24,4.0,57,3,4,2,9,0xb2d41320
8017.48,1.0,82,2,2,1,5,0xb2d6c6e2
3750.98,1.0,5,2,2,3,7,0xb2d4e9dc
53.66,1.0,0,1,2,4,7,0xb2d48298
5030.89,1.0,184,2,2,1,5,0xb2d5fbdc
1147.14,1.0,21,1,2,2,5,0xb2d2c576
601153.55,3.0,16,4,4,2,10,0xb2d68fd6d
4293.36,1.0,4,2,2,4,8,0xb2da0438
37.99,2.0,21,1,3,2,6,0xb2d6cec2
508726.4,3.0,10,4,4,3,11,0xb2d6e430
90000.95,3.0,11,3,4,3,10,0xb2da22e8
301000.25,3.0,22,4,4,2,10,0xb2d17f63d
200000.21,2.0,14,3,3,3,9,0xb2d95c9c
4097.49,1.0,0,2,2,4,8,0xb2d63939
14362.92,1.0,20,2,2,2,6,0xb2d43242d
4268.88,2.0,250,2,3,1,6,0xb2d5add8
4500.22,1.0,9,2,2,3,7,0xb2d366f8
7341.77,1.0,0,2,2,4,8,0xb2d9bf21
11.63,1.0,50,1,2,2,5,0xb2d6beb2
252198.6,4.0,11,3,4,3,10,0xb2d3a9acd
480007.35,4.0,2,4,4,4,12,0xb2d3adb7d
530385.03,11.0,25,4,4,2,10,0x3b9b3bfa
190007.45,3.0,4,3,4,4,11,0xb2d8ff19
436421.55,6.0,0,4,4,4,12,0xb2d0689dd
1300.34,1.0,184,1,2,1,4,0xb2d27a39
1896.58,1.0,184,1,2,1,4,0xb2d1484a
207126.48,2.0,122,3,3,1,7,0xb2d68877d
50012.11,2.0,55,2,3,2,7,0xb2d8ebced
103638.27,2.0,12,3,3,3,9,0xb2d60a1a
15811.76,1.0,0,2,2,4,8,0xb2d48848d
1051472.47,4.0,56,4,4,2,10,0xb2d4559b
20148.68,1.0,92,2,2,1,5,0xb2d373ca
200745.72,2.0,27,3,3,2,8,0xb2d6a867
47562.28,1.0,0,2,2,4,8,0xb2d39101
50000.53,2.0,94,2,3,1,6,0xb2d8905c
520061.81,7.0,76,4,4,1,9,0x3b9b2c29d
16.17,1.0,23,1,2,2,5,0xb2d1c60c
310001.48,4.0,4,4,4,4,12,0xb2d9fdb1
166066.29,10.0,0,3,4,4,11,0xb2d69884
1138000.0,10.0,3,4,4,4,12,0xb2d486cc
120007.27,3.0,3,3,4,4,11,0xb2d07fd1d
500000.44,3.0,0,4,4,4,12,0xb2d9b569
100026.09,3.0,67,3,4,1,8,0xb2d2372f
53304.11,3.0,206,3,4,1,8,0x3b9b29a2
324319.02,3.0,5,4,4,3,11,0xb2d5f90b
505123.17,1.0,225,4,2,1,7,0xb2d687d4
936519.25,26.0,0,4,4,4,12,0x3b9b46a0
271096.85,3.0,55,3,4,2,9,0xb2d0bf69
200031.91,2.0,8,3,3,3,9,0xb2d9640a
519093.25,2.0,4,4,3,4,11,0xb2d6452c
1762.32,1.0,1,1,2,4,7,0xb2d8cad2
9822.58,1.0,80,2,2,1,5,0xb2d20fcd
530647.3,3.0,210,4,4,1,9,0xb2d570a9d
1091.75,2.0,309,1,3,1,5,0xb2d08ef5
416317.67,2.0,123,4,3,1,8,0xb2d106dd
215044.56,3.0,167,3,4,1,8,0xb2d0fdef
10087.25,2.0,121,2,3,1,6,0xb2d1d83a
10044.21,1.0,92,2,2,1,5,0xb2d0bd92
60025.57,2.0,31,3,3,2,8,0xb2d2681b
20649.59,2.0,0,2,3,4,9,0xb2d64846d
35001.48,3.0,48,2,4,2,8,0xb2d90f3a
1600000.66,2.0,17,4,3,2,9,0xb2d99825
4934.59,1.0,92,2,2,1,5,0xb2d36d46
15069.19,1.0,33,2,2,2,6,0xb2d9fd47
440000.0,2.0,1,4,3,4,11,0xb2d980ca
5223.56,2.0,92,2,3,1,6,0xb2d0a918
679000.0,6.0,0,4,4,4,12,0xb2d3e857
10534706.31,20.0,18,4,4,2,10,0xb2d2e72a
4235.88,1.0,8,2,2,3,7,0xb2d2c5f4
2400.83,1.0,14,1,2,3,6,0xb2d8c5d2d
352157.76,2.0,80,4,3,1,8,0xb2d8d402
59.03,1.0,45,1,2,2,5,0xb2d44c8f
110028.68,3.0,66,3,4,2,9,0xb2d60f4f
500000.0,3.0,4,4,4,4,12,0xb2d8a866d
1084.9,1.0,92,1,2,1,4,0xb2d353c7
190153.3,4.0,87,3,4,1,8,0xb2d4169ed
201496.26,3.0,69,3,4,1,8,0xb2d3a543d
153900.86,3.0,117,3,4,1,8,0xb2d5601f
10344.83,1.0,3,2,2,4,8,0xb2d68704d
503563.04,2.0,81,4,3,1,8,0xb2d8d1bbd
200906.06,4.0,80,3,4,1,8,0xb2d4f5a4
80202.67,5.0,21,3,4,2,9,0xb2d5c2a3
35069.51,1.0,40,2,2,2,6,0xb2d6e5bfd
1497524.76,5.0,31,4,4,2,10,0xb2d42947
190041.37,4.0,45,3,4,2,9,0xb2d206d2
10.35,1.0,75,1,2,1,4,0xb2d88ea2d
156279.54,2.0,95,3,3,1,7,0xb2d3b8cf
8.0,1.0,29,1,2,2,5,0xb2d6efad
22.44,1.0,82,1,2,1,4,0xb2d88a36
339113.58,4.0,158,4,4,1,9,0xb2d593db
80000.96,5.0,25,3,4,2,9,0xb2d96437
120654.31,1.0,13,3,2,3,8,0xb2d55ac2
53253.18,2.0,0,3,3,4,10,0xb2d0ce75
200000.0,2.0,7,3,3,3,9,0xb2da56fa
8171.69,1.0,5,2,2,3,7,0xb2d2de12d
1229867.15,2.0,43,4,3,2,9,0xb2d67cb7
9061.22,1.0,0,2,2,4,8,0xb2d1c32ed
569989.26,1.0,11,4,2,3,9,0xb2d12a57d
500000.92,2.0,9,4,3,3,10,0xb2d6ffbd
375912.36,1.0,4,4,2,4,10,0xb2d2d6cbd
522039.65,4.0,8,4,4,3,11,0xb2d08385
216284.68,2.0,0,3,3,4,10,0xb2d616c9
60026.23,2.0,235,3,3,1,7,0xb2d5d5fdd
1149903.23,4.0,3,4,4,4,12,0xb2d24e69d
230062.19,4.0,7,3,4,3,10,0xb2d27dc6
1820291.87,10.0,2,4,4,4,12,0xb2d20f1b
10669.35,1.0,15,2,2,3,7,0xb2d8fafc
1792.7,1.0,23,1,2,2,5,0xb2d2d8c2
1181.19,1.0,57,1,2,2,5,0xb2d0d0e0
50.32,1.0,14,1,2,3,6,0xb2d28c94
202000.0,2.0,0,3,3,4,10,0x3b9b2f02
500241.26,4.0,87,4,4,1,9,0xb2d6e258d
70000.97,3.0,0,3,4,4,11,0xb2d61b74
396568.85,5.0,19,4,4,2,10,0xb2d62db8
2854047.01,10.0,4,4,4,4,12,0xb2d4a5b9
77.36,2.0,46,1,3,2,6,0xb2d787ac
143711.07,1.0,2,3,2,4,9,0xb2d2d0bb
4.16,1.0,56,1,2,2,5,0xb2d50ccf
682.09,1.0,1,1,2,4,7,0xb2d3d2ac
12511.45,1.0,10,2,2,3,7,0xb2d5a793
225000.68,3.0,7,3,4,3,10,0xb2d8e84c
116.03,2.0,82,1,3,1,5,0xb2d4bb4d
33793.85,1.0,1,2,2,4,8,0xb2d68785
3.16,4.0,60,1,4,2,7,0xb2d2452d
1489938.17,7.0,1,4,4,4,12,0xb2d2e81d
24753.41,2.0,5,2,3,3,8,0xb2d2c77d
220000.53,2.0,7,3,3,3,9,0xb2d96b83
60001.27,2.0,10,3,3,3,9,0xb2d9418e
291.34,1.0,36,1,2,2,5,0xb2d9c66d
25905.7,2.0,0,2,3,4,9,0xb2d080ccd
304.67,1.0,55,1,2,2,5,0xb2d64f7d
500000.0,2.0,20,4,3,2,9,0xb2d95298d
2.71,1.0,7,1,2,3,6,0xb2d175b2
4051.56,1.0,184,2,2,1,5,0xb2d370d5
480015.69,2.0,1,4,3,4,11,0xb2d970ffd
301162.76,2.0,25,4,3,2,9,0xb2d75ad4
90002.84,2.0,25,3,3,2,8,0xb2d5c594
1304620.5,8.0,47,4,4,2,10,0xb2d65921
544.37,1.0,10,1,2,3,6,0xb2d36d19
140006.55,3.0,33,3,4,2,9,0xb2d688c2d
1280023.12,3.0,11,4,4,3,11,0xb2d9dab6
8.31,1.0,29,1,2,2,5,0xb2d92be6
80109.07,2.0,206,3,3,1,7,0xb2d32fce
2085.0,1.0,1,1,2,4,7,0xb2d29d54
90.49,1.0,36,1,2,2,5,0xb2d595a2
346614.88,5.0,8,4,4,3,11,0xb2d12bfb
5737.14,1.0,19,2,2,2,6,0xb2d9cf31
0.25,1.0,9,1,2,3,6,0xb2d6125a
350070.07,4.0,129,4,4,1,9,0xb2d0c5e9
56258.24,2.0,14,3,3,3,9,0xb2d077e9
62.12,1.0,53,1,2,2,5,0xb2d63b90d
151205.94,3.0,35,3,4,2,9,0xb2d911f1
1768.37,1.0,0,1,2,4,7,0xb2d5512cd
1259375.13,4.0,59,4,4,2,10,0xb2d39cc8
4.33,1.0,61,1,2,2,5,0xb2d8d12f
148000.0,1.0,0,3,2,4,9,0xb2d41372
1894.76,1.0,92,1,2,1,4,0xb2d1484ad
11131.81,1.0,76,2,2,1,5,0xb2d64c64
120004.68,2.0,95,3,3,1,7,0xb2d628e6
40002.22,4.0,0,2,4,4,10,0xb2d95893
401087.68,3.0,0,4,4,4,12,0xb2d5c1fc
26885.9,1.0,3,2,2,4,8,0xb2d61628
1106.74,1.0,46,1,2,2,5,0xb2d6b116
88.15,1.0,6,1,2,3,6,0xb2d21d48
5551.36,1.0,184,2,2,1,5,0xb2d34c3a
192000.54,5.0,3,3,4,4,11,0xb2d38a66
56.38,1.0,1,1,2,4,7,0xb2d2f5bd
6276.41,1.0,184,2,2,1,5,0xb2d29470
8497.56,1.0,96,2,2,1,5,0xb2d1bf86
605085.84,4.0,6,4,4,3,11,0xb2d3bb3c
130000.63,3.0,80,3,4,1,8,0xb2d62b93
4421.17,1.0,19,2,2,2,6,0xb2d3cbde
79002.5,2.0,59,3,3,2,8,0xb2d8fb3b
203093.01,2.0,88,3,3,1,7,0xb2d46f45
71.32,1.0,77,1,2,1,4,0xb2d21851
24830.07,1.0,184,2,2,1,5,0xb2d3423c
314000.0,2.0,4,4,3,4,11,0xb2da5935
5576.24,1.0,14,2,2,3,7,0xb2d31975
11315.25,2.0,0,2,3,4,9,0x3b9b257d
210045.61,4.0,0,3,4,4,11,0xb2d5b9b3d
552000.1,7.0,9,4,4,3,11,0xb2d59a77d
48825.52,1.0,0,2,2,4,8,0xb2d6b944
300000.0,3.0,3,3,4,4,11,0xb2d968cd
20000.21,2.0,14,2,3,3,8,0xb2da3990
692.86,1.0,0,1,2,4,7,0xb2d34bae
5812.83,1.0,184,2,2,1,5,0xb2d27d24
50416.98,2.0,90,2,3,1,6,0xb2d691ed
2050228.5,3.0,142,4,4,1,9,0xb2d2213a
185.05,1.0,5,1,2,3,6,0xb2d24aaed
514.42,1.0,73,1,2,1,4,0xb2d112ec
165.3,1.0,10,1,2,3,6,0xb2d5cb35
134480.55,2.0,0,3,3,4,10,0xb2d3b707
1565.32,1.0,165,1,2,1,4,0xb2d8de38d
1005.85,1.0,0,1,2,4,7,0xb2d4353b
220057.38,4.0,21,3,4,2,9,0xb2d53d9a
501266.41,20.0,6,4,4,3,11,0xb2d22a79
448320.35,2.0,8,4,3,3,10,0xb2d6d366d
0.11,4.0,74,1,4,1,6,0xb2d1c716
762.11,1.0,10,1,2,3,6,0xb2d49c63
12.44,1.0,16,1,2,2,5,0xb2d3087f
20000.21,2.0,32,2,3,2,7,0xb2da0315
21493.45,5.0,7,2,4,3,9,0xb2d3ffa6
120047.26,3.0,70,3,4,1,8,0xb2d4f33a
14673.71,1.0,92,2,2,1,5,0xb2d3158d
50005.08,2.0,25,2,3,2,7,0xb2da0d3d
484.15,1.0,0,1,2,4,7,0xb2d69f78
724.6,1.0,0,1,2,4,7,0xb2d63778
4088.69,1.0,1,2,2,4,8,0xb2d9131c
1.6,2.0,87,1,3,1,5,0xb2d6579e
729603.58,5.0,39,4,4,2,10,0xb2d27883
729.85,1.0,10,1,2,3,6,0xb2d5dd80
1050093.44,6.0,6,4,4,3,11,0xb2d13f9c
26427.38,1.0,5,2,2,3,7,0xb2d6a162
14835.07,1.0,92,2,2,1,5,0xb2d12219
8728.09,1.0,212,2,2,1,5,0xb2d2fd61
2156.02,1.0,44,1,2,2,5,0xb2d918dcd
0.0,1.0,3,1,2,4,7,0xb2d5664d
506976.05,2.0,213,4,3,1,8,0xb2d5891ed
58.26,1.0,116,1,2,1,4,0xb2d25ce5d
663303.09,6.0,228,4,4,1,9,0xb2d3ee8f
660282.48,5.0,6,4,4,3,11,0xb2d37379
3134.74,1.0,0,2,2,4,8,0xb2d6e7f2
252.11,1.0,68,1,2,1,4,0xb2d2c924
40000.42,2.0,74,2,3,1,6,0xb2d9a068
21200.79,1.0,184,2,2,1,5,0xb2d2a69c
31605.97,1.0,22,2,2,2,6,0xb2d6af70
51486.23,2.0,45,2,3,2,7,0xb2d5aca3
933036.26,8.0,18,4,4,2,10,0xb2d3bb4a
500052.58,8.0,13,4,4,3,11,0xb2d56fbdd
481705.13,3.0,31,4,4,2,10,0xb2d8f6a0
1070.12,1.0,184,1,2,1,4,0xb2d34a9e
449.43,1.0,0,1,2,4,7,0xb2d2a830
360000.75,2.0,1,4,3,4,11,0xb2d938f5
426031.0,12.0,4,4,4,4,12,0xb2d5fb9cd
164.86,1.0,47,1,2,2,5,0xb2d8ef36
126.98,2.0,6,1,3,3,7,0xb2d10151
279216.35,3.0,3,3,4,4,11,0xb2d6385fd
560000.0,7.0,8,4,4,3,11,0xb2d1408b
304178.03,3.0,74,4,4,1,9,0xb2d114f9
91926.85,5.0,14,3,4,3,10,0xb2d5cc2f
173904.46,3.0,0,3,4,4,11,0xb2d171a3d
68000.72,2.0,35,3,3,2,8,0xb2d9f8fb
118.47,1.0,8,1,2,3,6,0xb2d34572
0.0,1.0,7,1,2,3,6,0xb2d92ac4
1450.02,1.0,92,1,2,1,4,0xb2d2c3c9
73310414.69,7.0,5,4,4,3,11,0xb2d5169c
500002.09,2.0,18,4,3,2,9,0xb2d78fbed
6672.68,1.0,46,2,2,2,6,0xb2d5f088
20283.27,1.0,25,2,2,2,6,0xb2d64735d
5644.82,1.0,17,2,2,2,6,0xb2d9e5cc
3679.02,1.0,17,2,2,2,6,0xb2d5c8bb
302854.7,4.0,41,4,4,2,10,0xb2d154ab
10113.1,1.0,29,2,2,2,6,0xb2d6c84b
13000.85,2.0,70,2,3,1,6,0xb2d6aab9d
2400096.59,15.0,0,4,4,4,12,0xb2d197bd
17669.69,1.0,5,2,2,3,7,0xb2d21003
30876.81,1.0,0,2,2,4,8,0xb2d58cc5
15008.65,2.0,4,2,3,4,9,0xb2d56794
105197.31,2.0,73,3,3,1,7,0xb2d4e9f4
10002.21,2.0,25,2,3,2,7,0xb2d5abd2
600059.42,5.0,27,4,4,2,10,0xb2d6394c
50908.38,2.0,206,2,3,1,6,0xb2d5be2a
0.21,2.0,63,1,3,2,6,0xb2d5dde7
110753.85,3.0,1,3,4,4,11,0xb2d6c253
205287.57,2.0,199,3,3,1,7,0xb2d69d27
9182.28,1.0,18,2,2,2,6,0xb2d8e407
100088.35,2.0,20,3,3,2,8,0xb2d259bf
1200755.71,8.0,0,4,4,4,12,0xb2d5bd18
83666.54,2.0,184,3,3,1,7,0xb2d0b24cd
44.22,1.0,70,1,2,1,4,0xb2d5ea8a
5862.18,1.0,63,2,2,2,6,0xb2d57896d
5098.37,1.0,92,2,2,1,5,0xb2d07453
100051.67,2.0,39,3,3,2,8,0xb2d65974d
10203.25,1.0,92,2,2,1,5,0xb2d2c0aa
118400.29,6.0,142,3,4,1,8,0xb2d077c7
300010.03,2.0,10,3,3,3,9,0xb2da4174
100115.59,2.0,167,3,3,1,7,0xb2d24eef
4872.74,1.0,19,2,2,2,6,0xb2d5511a
16698.33,1.0,6,2,2,3,7,0xb2d6c2b5
724679.33,4.0,92,4,4,1,9,0xb2d3f751d
300008.33,5.0,73,3,4,1,8,0xb2d27319
2241.89,1.0,8,1,2,3,6,0xb2d6b489
7.16,1.0,3,1,2,4,7,0xb2d85cff
15761.79,1.0,0,2,2,4,8,0xb2d599bc
445592.49,3.0,14,4,4,3,11,0xb2d8e08a
1400.8,1.0,77,1,2,1,4,0xb2d243e3
1307.82,1.0,0,1,2,4,7,0xb2d1b7c5
5732.11,1.0,4,2,2,4,8,0xb2d1a47c
200.11,2.0,60,1,3,2,6,0xb2d8fc71
50297.67,1.0,1,2,2,4,8,0xb2d60d69
11957.5,2.0,0,2,3,4,9,0x3b9af233d
23.75,1.0,9,1,2,3,6,0xb2d3915f
104788.47,2.0,55,3,3,2,8,0xb2d0bdbe
621.78,1.0,74,1,2,1,4,0xb2d29346
201421.1,2.0,74,3,3,1,7,0xb2d6071d
240455.61,11.0,0,3,4,4,11,0xb2d16b80
6.25,1.0,80,1,2,1,4,0xb2d12720
0.0,1.0,3,1,2,4,7,0xb2d93047
92127.07,1.0,1,3,2,4,9,0xb2d6227ad
156215.32,3.0,27,3,4,2,9,0xb2d1cacf
604090.19,5.0,4,4,4,4,12,0xb2d5f359
72.83,1.0,19,1,2,2,5,0xb2d9adf3
20118.09,1.0,92,2,2,1,5,0xb2d3f298
264767.74,2.0,3,3,3,4,10,0xb2d1c74c
100005.29,2.0,4,3,3,4,10,0xb2d127cf
2208.5,1.0,10,1,2,3,6,0xb2d4ce7b
331.12,1.0,208,1,2,1,4,0xb2d28122d
500000.0,2.0,7,4,3,3,10,0xb2d96fb0
207456.46,3.0,62,3,4,2,9,0xb2d57fe0d
3.41,1.0,53,1,2,2,5,0xb2d0c4ba
101926.78,4.0,63,3,4,2,9,0xb2d5959b
173628.44,4.0,1,3,4,4,11,0xb2d6ef17
70120.18,2.0,11,3,3,3,9,0xb2d5f5f5
953394.94,7.0,0,4,4,4,12,0xb2d2609d
9640.41,1.0,184,2,2,1,5,0xb2d29162
1400000.42,3.0,0,4,4,4,12,0xb2d491a1
500184.62,3.0,24,4,4,2,10,0xb2d27fc0d
501776.21,2.0,19,4,3,2,9,0xb2d910f2
5011.2,1.0,92,2,2,1,5,0xb2d67fbf
5309.19,1.0,1,2,2,4,8,0xb2d6c008
100029.33,2.0,256,3,3,1,7,0xb2d5210b
13011.17,1.0,30,2,2,2,6,0xb2d1453d
461600.15,7.0,0,4,4,4,12,0xb2d5e0e2
8163.1,1.0,10,2,2,3,7,0xb2d519a0
200078.21,2.0,9,3,3,3,9,0xb2d475edd
296009.0,9.0,0,3,4,4,11,0xb2d55a85d
200000.0,2.0,193,3,3,1,7,0xb2d1297ad
6.22,1.0,43,1,2,2,5,0xb2d60f48
50001.06,2.0,11,2,3,3,8,0xb2da2e64
280000.0,3.0,1,3,4,4,11,0xb2d2ecbfd
503552.88,2.0,77,4,3,1,8,0xb2d8dcb0
100001.06,2.0,10,3,3,3,9,0xb2d968d5
21054.76,2.0,4,2,3,4,9,0xb2d55c95
90791.66,5.0,38,3,4,2,9,0xb2d6520ad
10019.76,3.0,6,2,4,3,9,0xb2d6d6d1
520096.54,3.0,0,4,4,4,12,0xb2d0bb9f
339311.2,10.0,0,4,4,4,12,0xb2d34740
230054.31,5.0,14,3,4,3,10,0xb2d5be7e
715.03,1.0,9,1,2,3,6,0xb2d900a2
735381.7,2.0,62,4,3,2,9,0xb2d1bef2
798.95,1.0,8,1,2,3,6,0xb2d321d2
260106.67,3.0,3,3,4,4,11,0xb2d32485
25656.39,1.0,92,2,2,1,5,0xb2d2f665
432842.45,3.0,3,4,4,4,12,0xb2d8d4bdd
201955.26,5.0,31,3,4,2,9,0xb2d3b1a9
165067.33,1.0,7,3,2,3,8,0xb2d1bb93
101009.52,3.0,193,3,4,1,8,0xb2d57fbc
60.31,1.0,75,1,2,1,4,0xb2d61552
60008.82,2.0,55,3,3,2,8,0xb2d53f24
151265.33,4.0,2,3,4,4,11,0xb2d6e007
317.63,1.0,12,1,2,3,6,0xb2d782e3
106695.95,1.0,1,3,2,4,9,0xb2d4f6d2d
530106.34,2.0,3,4,3,4,11,0xb2d0d26ed
2004.01,1.0,199,1,2,1,4,0xb2d69c2fd
107307.53,2.0,0,3,3,4,10,0xb2d6aca0
50.67,1.0,10,1,2,3,6,0xb2d5c512
178.53,1.0,23,1,2,2,5,0xb2d31593
122491.82,5.0,13,3,4,3,10,0xb2d61b90
6449.36,1.0,109,2,2,1,5,0xb2d35e7f
1401.37,1.0,23,1,2,2,5,0xb2d2f283
2860.14,1.0,1,1,2,4,7,0xb2d1fc90
250191.45,3.0,8,3,4,3,10,0xb2d6ff76d
130.95,2.0,5,1,3,3,7,0xb2d6d003
500276.04,2.0,1,4,3,4,11,0xb2d9ef59
1008.05,1.0,49,1,2,2,5,0xb2d99a9b
19704.2,1.0,0,2,2,4,8,0xb2d4275c
350013.69,3.0,63,4,4,2,10,0xb2d30a5a
62470.61,2.0,2,3,3,4,10,0xb2d154f3d
30450.24,2.0,104,2,3,1,6,0xb2d60b20d
4399.95,1.0,1,2,2,4,8,0xb2d3c81c
2401.65,1.0,46,1,2,2,5,0xb2d909d5
3402064.41,8.0,3,4,4,4,12,0xb2d7fbdb
20734.19,3.0,125,2,4,1,7,0xb2d4f388
210053.72,3.0,3,3,4,4,11,0xb2d5907c
117010.29,2.0,6,3,3,3,9,0xb2d1b1b7
56614.58,2.0,4,3,3,4,10,0xb2d190d1d
1.78,1.0,2,1,2,4,7,0xb2d9495a
402723.87,2.0,27,4,3,2,9,0xb2d16b89
3854.29,1.0,0,2,2,4,8,0xb2d91e75
1551027.59,4.0,13,4,4,3,11,0xb2d19555
225748.34,3.0,30,3,4,2,9,0xb2d977a1
1003000.0,6.0,1,4,4,4,12,0x3b9b3245d
100001.06,3.0,116,3,4,1,8,0xb2d6badb
500025.78,2.0,118,4,3,1,8,0xb2d50670
132003.82,3.0,80,3,4,1,8,0xb2d61ca8
303.71,1.0,80,1,2,1,4,0xb2d9017a
5626.89,1.0,92,2,2,1,5,0xb2d2b17f
70117.38,4.0,53,3,4,2,9,0xb2d8e10a
1828.39,3.0,173,1,4,1,6,0xb2d6521e
2960.52,1.0,184,2,2,1,5,0x3b9af62e
1378537.26,1.0,2,4,2,4,10,0xb2d60022
50509.38,2.0,3,2,3,4,9,0xb2d4c1df
33303.27,2.0,7,2,3,3,8,0xb2d59aa8
760.13,1.0,18,1,2,2,5,0xb2d20f69
200884.96,2.0,20,3,3,2,8,0xb2d6d806
10037.79,1.0,0,2,2,4,8,0xb2d85d63
320048.49,6.0,10,4,4,3,11,0xb2d265e8
101850.53,2.0,48,3,3,2,8,0xb2d4cdf9
541207.71,3.0,13,4,4,3,11,0xb2d9fdb0
204197.11,55.0,0,3,4,4,11,0xb2d0bc8a
300967.38,8.0,10,4,4,3,11,0x3b9b3099d
50004.18,19.0,18,2,4,2,8,0xb2d12b11
12199.42,1.0,92,2,2,1,5,0xb2d09bf0
1271633.64,5.0,8,4,4,3,11,0xb2d5f6b3d
272369.18,3.0,4,3,4,4,11,0xb2d5c7ccd
11086.12,2.0,125,2,3,1,6,0xb2d55f58
53003.61,2.0,41,3,3,2,8,0xb2d41059
149.88,1.0,0,1,2,4,7,0xb2d60bae
61392.49,3.0,184,3,4,1,8,0xb2d090e1
90299.68,2.0,80,3,3,1,7,0xb2d20767
5998.34,1.0,39,2,2,2,6,0xb2d9c68d
2657.93,1.0,184,1,2,1,4,0xb2d290c0
546501.67,7.0,4,4,4,4,12,0x3b9b0fd2
244068.72,2.0,4,3,3,4,10,0xb2da2026
172414.44,11.0,1,3,4,4,11,0xb2d5f607
430321.96,3.0,0,4,4,4,12,0xb2d500cc
5141.94,1.0,162,2,2,1,5,0xb2d35555
8.1,2.0,2,1,3,4,8,0xb2d08836
9122.19,1.0,21,2,2,2,6,0xb2d291c9
13185.05,1.0,0,2,2,4,8,0xb2d294a8
124.99,1.0,16,1,2,2,5,0xb2d9a950
53.8,1.0,0,1,2,4,7,0xb2d2d6dd
150076.26,19.0,9,3,4,3,10,0x3b9af121
25373.18,1.0,0,2,2,4,8,0xb2d67a3cd
8645541.33,10.0,1,4,4,4,12,0xb2d0ace3
50045.58,2.0,119,2,3,1,6,0xb2d35717
443.59,1.0,60,1,2,2,5,0xb2d610b6
153248.25,2.0,87,3,3,1,7,0xb2d3bd24
120193.91,4.0,80,3,4,1,8,0x3b9b328f
1384354.82,9.0,2,4,4,4,12,0xb2d3baa4
13.69,1.0,0,1,2,4,7,0xb2d3eb08d
45.6,1.0,10,1,2,3,6,0xb2d95b69
375160.43,3.0,6,4,4,3,11,0xb2d31627d
206876.3,4.0,28,3,4,2,9,0xb2d3ca56d
401650.64,5.0,1,4,4,4,12,0xb2d11b86
20643.59,3.0,18,2,4,2,8,0xb2d5ea91
1123.99,1.0,7,1,2,3,6,0xb2d2fc28d
600000.0,2.0,0,4,3,4,11,0xb2d979dc
496000.0,6.0,1,4,4,4,12,0xb2d16d3ad
1403.83,1.0,20,1,2,2,5,0xb2d6aee8d
800795.91,3.0,47,4,4,2,10,0x3b9b443e
608810.64,1.0,4,4,2,4,10,0xb2d6106e
73.89,1.0,21,1,2,2,5,0xb2d93496
40001.69,2.0,147,2,3,1,6,0xb2d900f5
202052.63,3.0,11,3,4,3,10,0xb2d5a5c9
167124.55,20.0,0,3,4,4,11,0x3b9b3274
51010.31,2.0,48,2,3,2,7,0xb2d5ad32
3998.46,1.0,1,2,2,4,8,0x3b9b46fd
2405.25,1.0,0,1,2,4,7,0xb2d13d3d
50001.06,2.0,87,2,3,1,6,0xb2d8c8d6
0.0,1.0,4,1,2,4,7,0xb2d8e28e
12219.45,1.0,23,2,2,2,6,0xb2d56849
11942.13,1.0,21,2,2,2,6,0xb2d8cb3d
3503.05,1.0,71,2,2,1,5,0xb2d3f271
57.09,1.0,2,1,2,4,7,0xb2d91566
97.2,1.0,36,1,2,2,5,0xb2d6bc26
1447038.56,11.0,0,4,4,4,12,0xb2d1fe6b
400050.81,3.0,208,4,4,1,9,0xb2d56e45d
201210.54,2.0,33,3,3,2,8,0xb2d9ef92
500120.46,4.0,35,4,4,2,10,0xb2d64795
45003.22,3.0,12,2,4,3,9,0xb2d85dac
72275.41,4.0,21,3,4,2,9,0xb2d59cf3
25711.89,1.0,20,2,2,2,6,0xb2d2fda4d
200102.43,2.0,235,3,3,1,7,0xb2d615aad
14200.21,1.0,15,2,2,3,7,0xb2d99f9d
2038.68,1.0,92,1,2,1,4,0xb2d28a99d
0.0,1.0,7,1,2,3,6,0xb2d5954b
100000.0,1.0,0,3,2,4,9,0xb2d9840cd
560668.86,2.0,231,4,3,1,8,0xb2d436bf
2077.02,1.0,1,1,2,4,7,0xb2d8fb61
300000.05,2.0,15,3,3,3,9,0xb2d8e01fd
1039.66,2.0,92,1,3,1,5,0x3b9ad549
17.59,1.0,1,1,2,4,7,0xb2d33fab
113241.17,4.0,35,3,4,2,9,0xb2d589aa
2295551.53,13.0,2,4,4,4,12,0xb2d066da
500000.0,2.0,27,4,3,2,9,0xb2d6e6f8
4892.29,2.0,92,2,3,1,6,0xb2d0db82
682000.05,12.0,0,4,4,4,12,0xb2d4fb93
551.31,1.0,7,1,2,3,6,0xb2d1c739
1926573.63,7.0,1,4,4,4,12,0xb2d0b8b2
1750335.97,9.0,19,4,4,2,10,0xb2d5c95f
401771.65,2.0,0,4,3,4,11,0xb2d3ee42d
486.45,1.0,9,1,2,3,6,0xb2d6f084
22.48,1.0,24,1,2,2,5,0xb2d90444d
350026.43,4.0,14,4,4,3,11,0xb2d1bccfd
117760.35,7.0,0,3,4,4,11,0xb2d4bd04
40991.95,1.0,20,2,2,2,6,0xb2d6a3a9
234531.83,4.0,43,3,4,2,9,0xb2d699ff
1454.78,1.0,10,1,2,3,6,0xb2d2b6f1
463.02,1.0,12,1,2,3,6,0xb2d22eeed
3852.38,1.0,9,2,2,3,7,0xb2d8c3da
857.24,1.0,2,1,2,4,7,0xb2d35568
1492.67,1.0,184,1,2,1,4,0xb2d289bb
380122.33,7.0,24,4,4,2,10,0xb2d5dc12
1232.35,1.0,1,1,2,4,7,0xb2d59a1d
300165.39,3.0,18,4,4,2,10,0xb2d5e5bf
64750.94,2.0,24,3,3,2,8,0xb2d58da1
1523.42,1.0,92,1,2,1,4,0xb2d2e495
14240.3,1.0,92,2,2,1,5,0xb2d14cbe
63934.52,2.0,18,3,3,2,8,0xb2d3a105
3153.42,1.0,21,2,2,2,6,0xb2d6dd86
2464.9,1.0,0,1,2,4,7,0xb2d2a28f
200000.15,2.0,14,3,3,3,9,0xb2d98c7c
1009.83,1.0,92,1,2,1,4,0xb2d1ee18d
50001.58,2.0,203,2,3,1,6,0xb2d753fa
111168.1,2.0,42,3,3,2,8,0xb2d908f5
550017.42,2.0,24,4,3,2,9,0xb2d9461c
51.3,1.0,9,1,2,3,6,0xb2d46471
140006.01,3.0,97,3,4,1,8,0xb2d85729
391.94,2.0,85,1,3,1,5,0xb2d304f9
6.43,1.0,13,1,2,3,6,0xb2d1a15e
50837.76,2.0,217,2,3,1,6,0xb2d58f29d
652.49,1.0,10,1,2,3,6,0xb2d517c4
8934.32,1.0,92,2,2,1,5,0xb2d26520d
18081.1,1.0,0,2,2,4,8,0xb2d948ddd
2.12,1.0,0,1,2,4,7,0xb2d60d12d
310000.0,2.0,2,4,3,4,11,0xb2d262bc
55942.92,1.0,60,3,2,2,7,0xb2d12e8d
300000.0,2.0,10,3,3,3,9,0xb2d9c34a
3556.24,1.0,18,2,2,2,6,0xb2d370a6
100000.59,2.0,3,3,3,4,10,0xb2d0afe6
1900000.0,6.0,6,4,4,3,11,0xb2d2c305
143.26,1.0,18,1,2,2,5,0xb2d2238a
10000.21,2.0,66,2,3,2,7,0xb2d8ef1a
492373.28,6.0,21,4,4,2,10,0xb2d5f5c0d
240002.51,2.0,20,3,3,2,8,0xb2d956f6
2578.89,1.0,99,1,2,1,4,0xb2d6c5ce
817.46,1.0,0,1,2,4,7,0xb2d6929ed
248.55,3.0,0,1,4,4,9,0xb2d09fea
960085.74,5.0,6,4,4,3,11,0xb2d232ea
12.2,1.0,11,1,2,3,6,0xb2d5f6d6
500021.11,2.0,21,4,3,2,9,0xb2d9a73f
2030082.24,3.0,139,4,4,1,9,0xb2d4ee81d
42.5,1.0,74,1,2,1,4,0xb2d70064
3958.68,1.0,9,2,2,3,7,0xb2d3dbaf
83940.83,3.0,235,3,4,1,8,0x3b9b25b4
500000.0,2.0,23,4,3,2,9,0xb2d9d460
149007.8,5.0,74,3,4,1,8,0xb2d32bfdd
18231.74,1.0,8,2,2,3,7,0xb2d322fc
79608.34,1.0,0,3,2,4,9,0xb2d2bf68
180008.9,3.0,137,3,4,1,8,0xb2d84dbb
150002.64,3.0,18,3,4,2,9,0xb2d99fd8
2663.51,1.0,9,1,2,3,6,0xb2d48898
22746.09,2.0,221,2,3,1,6,0xb2d45b18
2.11,1.0,55,1,2,2,5,0xb2d97204
42.86,1.0,48,1,2,2,5,0xb2d96548
750.58,1.0,0,1,2,4,7,0xb2d58a25
4.22,1.0,34,1,2,2,5,0xb2d92ebc
74.85,1.0,3,1,2,4,7,0xb2d5d5c5
4729.69,1.0,92,2,2,1,5,0xb2d33c50
1558758.28,9.0,6,4,4,3,11,0xb2d2d7bed
2.2,2.0,8,1,3,3,7,0x3b9b2857
8925.26,1.0,0,2,2,4,8,0xb2d9782d
410.37,1.0,56,1,2,2,5,0xb2d1040d
180063.33,4.0,94,3,4,1,8,0xb2d4ac19
452067.75,6.0,0,4,4,4,12,0xb2d1059b
106019.09,2.0,0,3,3,4,10,0xb2d1d8bb
154493.57,5.0,0,3,4,4,11,0x3b9b4616
10000.11,2.0,18,2,3,2,7,0xb2da30f3
350001.5,6.0,0,4,4,4,12,0xb2d70168
46996.72,1.0,5,2,2,3,7,0xb2d642dc
3208.07,1.0,9,2,2,3,7,0xb2d767d8
202843.52,2.0,88,3,3,1,7,0xb2d904d4
800053.51,3.0,136,4,4,1,9,0xb2d428b5
2162.42,1.0,92,1,2,1,4,0xb2d34674
2.02,1.0,51,1,2,2,5,0xb2d2db64
0.0,1.0,3,1,2,4,7,0xb2d933e9
162.98,1.0,0,1,2,4,7,0xb2d388b0
1880.54,1.0,92,1,2,1,4,0xb2d176a8
302132.01,2.0,28,4,3,2,9,0xb2d8c8a8d
589173.39,4.0,17,4,4,2,10,0xb2d48c31
147034.59,1.0,77,3,2,1,6,0xb2d6eef4d
503.96,1.0,10,1,2,3,6,0xb2d6d57c
553379.37,5.0,59,4,4,2,10,0xb2d1f6ead
110583.15,2.0,3,3,3,4,10,0xb2d5eb66d
2936.08,1.0,184,2,2,1,5,0xb2d41788d
66.72,1.0,45,1,2,2,5,0xb2d44c96
300000.0,2.0,26,3,3,2,8,0xb2da1501
20107.7,1.0,184,2,2,1,5,0xb2d5038cd
130086.5,2.0,129,3,3,1,7,0xb2d575e8d
106178.64,4.0,94,3,4,1,8,0xb2d57c98
89.19,1.0,9,1,2,3,6,0xb2d5d548d
1097436.55,3.0,28,4,4,2,10,0xb2d2399e
160000.0,7.0,4,3,4,4,11,0xb2d386e7d
5689.93,1.0,10,2,2,3,7,0xb2d9e9a7
390000.0,4.0,6,4,4,3,11,0xb2d782f9
306091.7,3.0,38,4,4,2,10,0xb2d24c28
113.04,1.0,62,1,2,2,5,0xb2d8f37d
293.23,1.0,11,1,2,3,6,0xb2d983a6d
197999.08,4.0,46,3,4,2,9,0xb2d225f4d
880000.0,8.0,1,4,4,4,12,0xb2d28b8f
0.04,1.0,49,1,2,2,5,0xb2d372be
640005.74,5.0,6,4,4,3,11,0xb2d60a13
766.23,1.0,25,1,2,2,5,0xb2d6d314
137.56,1.0,4,1,2,4,7,0xb2d2b176
11000.12,2.0,17,2,3,2,7,0xb2da027b
7787.08,1.0,0,2,2,4,8,0xb2d2f2b9
10006.76,1.0,73,2,2,1,5,0xb2d8e768
502012.42,6.0,0,4,4,4,12,0xb2d56325
15372.88,6.0,0,2,4,4,10,0xb2d06a04
217.14,1.0,10,1,2,3,6,0xb2d8ffef
666831.87,14.0,0,4,4,4,12,0x3b9af21bd
94.23,1.0,1,1,2,4,7,0xb2d69038
22002.13,1.0,5,2,2,3,7,0xb2d68c9b
40.14,1.0,68,1,2,1,4,0xb2d458b2
204428.27,3.0,34,3,4,2,9,0xb2d3cde1
430000.0,3.0,29,4,4,2,10,0xb2da0b1d
2084.05,1.0,184,1,2,1,4,0xb2d2986e
172918.26,22.0,1,3,4,4,11,0x3b9ae50fd
5018.92,2.0,92,2,3,1,6,0xb2d3c7b5
4313.02,1.0,21,2,2,2,6,0xb2d37c6fd
1099.61,1.0,10,1,2,3,6,0xb2d93a76
570122.59,4.0,3,4,4,4,12,0xb2d3b390
115.82,1.0,11,1,2,3,6,0xb2d43dda
17960.61,1.0,0,2,2,4,8,0xb2d9e400
1047.8,1.0,93,1,2,1,4,0xb2d3b1c1
1600067.56,2.0,63,4,3,2,9,0xb2d9b4cd
510001.58,4.0,4,4,4,4,12,0xb2d9f972
5.44,1.0,12,1,2,3,6,0xb2d0f212
4235.47,9.0,184,2,4,1,7,0xb2d14912
1011.44,2.0,92,1,3,1,5,0xb2d06aaa
29.56,1.0,53,1,2,2,5,0xb2d9a9b9
12920.84,1.0,0,2,2,4,8,0xb2d51ec6
1164742.39,11.0,70,4,4,1,9,0xb2d103add
5821.21,1.0,92,2,2,1,5,0xb2d1c05ad
407757.3,3.0,16,4,4,2,10,0xb2d4f4fc
20.14,1.0,42,1,2,2,5,0xb2d27932d
90685.59,3.0,92,3,4,1,8,0xb2d62f00d
4733.95,1.0,4,2,2,4,8,0xb2d591ae
2100.09,1.0,8,1,2,3,6,0xb2d2a2b5
209061.53,4.0,17,3,4,2,9,0xb2d61690
501777.28,2.0,24,4,3,2,9,0xb2d9d333
10000.0,1.0,60,2,2,2,6,0xb2d8ff15
1240.5,1.0,184,1,2,1,4,0xb2d26faed
80000.85,4.0,18,3,4,2,9,0xb2d91b56d
900057.72,4.0,200,4,4,1,9,0xb2d126f5d
60003.17,2.0,92,3,3,1,7,0xb2d633cc
56085.79,1.0,10,3,2,3,8,0xb2d42a0c
1438.3,1.0,184,1,2,1,4,0xb2d29eaf
31.6,2.0,3,1,3,4,8,0xb2d212e4
30046.29,1.0,3,2,2,4,8,0xb2d21d8e
200002.11,3.0,5,3,4,3,10,0xb2d96359d
59.33,5.0,78,1,4,1,6,0xb2d3ffa6d
107475.8,2.0,132,3,3,1,7,0xb2d390c1d
50000.0,2.0,7,2,3,3,8,0xb2d88f97d
4343.67,1.0,3,2,2,4,8,0xb2d8d14d
7927.53,1.0,2,2,2,4,8,0xb2d6d905d
6857.06,1.0,0,2,2,4,8,0xb2d615f4
41328.57,3.0,0,2,4,4,10,0xb2d51e8a
160447.75,7.0,5,3,4,3,10,0xb2d51899
28.03,1.0,2,1,2,4,7,0xb2d6ac92
802435.1,4.0,18,4,4,2,10,0xb2d8e9fed
1026.77,1.0,184,1,2,1,4,0xb2d0c3c1d
10575.18,2.0,75,2,3,1,6,0xb2d491cbd
255000.0,5.0,2,3,4,4,11,0xb2d8ef98
2300563.85,4.0,20,4,4,2,10,0xb2d58faf
250076.18,2.0,14,3,3,3,9,0xb2d9977a
40061.07,2.0,103,2,3,1,6,0xb2d12804
113031.56,2.0,3,3,3,4,10,0xb2d4c963
80000.1,2.0,0,3,3,4,10,0xb2d3d4e4d
325016.53,3.0,30,4,4,2,10,0xb2d24daf
63062.01,3.0,18,3,4,2,9,0xb2d693e3
1193.85,1.0,10,1,2,3,6,0xb2d56496
759339.6,2.0,94,4,3,1,8,0xb2d11897
1418.63,1.0,3,1,2,4,7,0xb2d82373
3734.38,1.0,29,2,2,2,6,0xb2da037e
100302.81,2.0,10,3,3,3,9,0xb2d479d3
159015.04,2.0,228,3,3,1,7,0xb2d1867b
108000.0,3.0,59,3,4,2,9,0xb2d28be4
301024.63,3.0,228,4,4,1,9,0xb2d537cad
100056.62,2.0,105,3,3,1,7,0xb2d469e7
37.28,1.0,73,1,2,1,4,0xb2d6de93
2184.38,1.0,184,1,2,1,4,0xb2d3a14ad
13.39,1.0,77,1,2,1,4,0xb2d9849a
24734.0,1.0,1,2,2,4,8,0xb2d40efa
1104418.84,8.0,0,4,4,4,12,0x3b9af2d4
105.84,1.0,54,1,2,2,5,0xb2d23588
524471.86,4.0,70,4,4,1,9,0xb2d106c4
1552598.2,9.0,2,4,4,4,12,0xb2d5978d
52894.97,2.0,266,3,3,1,7,0xb2d45c7e
522132.83,3.0,60,4,4,2,10,0xb2d6e020d
7.57,1.0,47,1,2,2,5,0xb2d9c26a
492227.52,11.0,0,4,4,4,12,0xb2d2c6ecd
64006.6,2.0,200,3,3,1,7,0xb2d4fea9
75083.27,2.0,0,3,3,4,10,0xb2d1d8e8
3400216.65,5.0,13,4,4,3,11,0xb2d616da
50127.64,1.0,70,2,2,1,5,0xb2d6a715
1263922.29,7.0,21,4,4,2,10,0xb2d637fc
80977.98,2.0,136,3,3,1,7,0xb2d607d3
20001.45,2.0,97,2,3,1,6,0xb2d638dc
9.03,1.0,20,1,2,2,5,0xb2d60d26
1504.93,1.0,0,1,2,4,7,0xb2d0f182
1034080.57,4.0,13,4,4,3,11,0xb2d97351
650000.0,4.0,5,4,4,3,11,0xb2d87a19
9520.36,1.0,0,2,2,4,8,0xb2d40328
126754.21,5.0,71,3,4,1,8,0xb2d58f60
1041.56,1.0,92,1,2,1,4,0xb2d33f6ad
10046.91,1.0,22,2,2,2,6,0xb2d5356cd
290583.09,5.0,10,3,4,3,10,0xb2d60623d
70003.09,3.0,27,3,4,2,9,0xb2d658c3
12008.51,2.0,2,2,3,4,9,0xb2d92481
4272.39,1.0,20,2,2,2,6,0xb2d5cc0cd
884532.68,3.0,48,4,4,2,10,0xb2d89f17
1759.52,1.0,4,1,2,4,7,0xb2d2cede
63839.42,3.0,249,3,4,1,8,0x3b9b3e60d
52075.99,1.0,0,2,2,4,8,0xb2d24c30
172213.35,3.0,62,3,4,2,9,0xb2d5a83c
7986.66,1.0,3,2,2,4,8,0xb2d581d8
720226.29,2.0,18,4,3,2,9,0xb2d5ee28d
157006.5,6.0,3,3,4,4,11,0xb2d08457
1500057.76,6.0,140,4,4,1,9,0xb2d18f07d
10949.02,1.0,184,2,2,1,5,0xb2d324e0d
300152.82,2.0,31,4,3,2,9,0xb2d5baac
169419.89,1.0,92,3,2,1,6,0x3b9b488bd
525709.98,4.0,2,4,4,4,12,0xb2d91e63
50005.52,2.0,80,2,3,1,6,0xb2d88b0e
260107.77,4.0,18,3,4,2,9,0xb2d10448
345725.9,4.0,0,4,4,4,12,0xb2d3151cd
9835.76,3.0,10,2,4,3,9,0x3b9b2d07
200008.81,2.0,62,3,3,2,8,0xb2d7821a
1531.87,2.0,8,1,3,3,7,0xb2d07067
1392.46,1.0,10,1,2,3,6,0xb2d83978d
61.0,1.0,15,1,2,3,6,0xb2d2a48b
0.0,2.0,8,1,3,3,7,0xb2d4f5e5
3006.97,1.0,92,2,2,1,5,0xb2d2e0ef
1400028.53,3.0,6,4,4,3,11,0xb2d78f28d
2455.64,1.0,184,1,2,1,4,0xb2d3e1ab
1000498.53,2.0,84,4,3,1,8,0xb2d598bc
85725.55,1.0,0,3,2,4,9,0xb2d951d4
46854.96,3.0,0,2,4,4,10,0xb2d0790a
201421.22,2.0,82,3,3,1,7,0xb2d98dd0
7372.95,1.0,130,2,2,1,5,0xb2d4a93fd
760247.75,5.0,27,4,4,2,10,0xb2d2f87b
310890.32,4.0,27,4,4,2,10,0xb2d4493ed
1006.84,1.0,92,1,2,1,4,0xb2d3c0d2d
368284.76,1.0,19,4,2,2,8,0xb2d360b3d
1144381.98,4.0,31,4,4,2,10,0xb2d5a4db
3328.82,1.0,0,2,2,4,8,0xb2d3d598
50000.0,2.0,0,2,3,4,9,0xb2d9792a
431192.18,8.0,18,4,4,2,10,0xb2d216a4
3175.92,1.0,10,2,2,3,7,0xb2d3d860
30042.03,2.0,107,2,3,1,6,0xb2d62ec7
651234.31,3.0,24,4,4,2,10,0xb2d5d512
3.9,1.0,43,1,2,2,5,0xb2d95088d
2286000.0,4.0,0,4,4,4,12,0xb2d550fe
400021.02,2.0,10,4,3,3,10,0xb2d90b0bd
2165.84,1.0,16,1,2,2,5,0xb2d9d3cf
50090.83,2.0,92,2,3,1,6,0xb2d0c3ad
1000002.52,2.0,0,4,3,4,11,0xb2d918cd
150797.05,4.0,42,3,4,2,9,0xb2d57815
450502.54,3.0,0,4,4,4,12,0xb2d57a35
200000.0,2.0,3,3,3,4,10,0xb2d97aaed
20.53,1.0,5,1,2,3,6,0xb2d787c6d
100415.36,1.0,11,3,2,3,8,0xb2d11ba9
255084.87,2.0,206,3,3,1,7,0xb2d1a58bd
15488.04,1.0,100,2,2,1,5,0xb2d398a0
22502.3,1.0,0,2,2,4,8,0xb2d5f3ed
15.47,1.0,10,1,2,3,6,0xb2d4f941
6461.62,1.0,184,2,2,1,5,0xb2d20df2
74864.93,3.0,60,3,4,2,9,0xb2d1c2d1
1040.97,1.0,92,1,2,1,4,0xb2d34d70
740000.0,5.0,9,4,4,3,11,0xb2d10e25
794027.85,4.0,144,4,4,1,9,0xb2d1275a
0.24,1.0,6,1,2,3,6,0xb2d2185a
17105.19,1.0,92,2,2,1,5,0xb2d35464
12814.89,1.0,4,2,2,4,8,0xb2d8d535
213821.38,2.0,35,3,3,2,8,0xb2d625a0
149.02,12.0,29,1,4,2,7,0xb2d1dd43d
136016.19,3.0,70,3,4,1,8,0xb2d24eb8d
10002.1,2.0,4,2,3,4,9,0xb2d25251
1951.85,1.0,0,1,2,4,7,0xb2d2e310
40002.11,2.0,92,2,3,1,6,0xb2d638d3d
200739.34,2.0,34,3,3,2,8,0xb2d992b6
2.74,1.0,34,1,2,2,5,0xb2d5bd87
1189.25,1.0,214,1,2,1,4,0xb2d54a9ad
3805.2,1.0,13,2,2,3,7,0xb2d5a79cd
300088.05,4.0,5,3,4,3,10,0xb2d4e714d
15264.49,1.0,18,2,2,2,6,0x3b9b2878
1997.5,11.0,233,1,4,1,6,0xb2d18d1f
61077.77,2.0,0,3,3,4,10,0xb2d93f9f
13.13,1.0,48,1,2,2,5,0xb2d4eca5
3255.01,1.0,92,2,2,1,5,0xb2d15b70
568023.26,3.0,24,4,4,2,10,0xb2d8f446
100000.27,6.0,6,3,4,3,10,0xb2d1ade3d
665454.89,5.0,102,4,4,1,9,0xb2d86e31
100000.0,1.0,0,3,2,4,9,0xb2d95d43
5.31,1.0,82,1,2,1,4,0xb2d296dc
1169017.02,11.0,0,4,4,4,12,0xb2d9155c
2340.02,1.0,4,1,2,4,7,0xb2d336b0d
588512.84,10.0,1,4,4,4,12,0xb2d9281d
2838.24,1.0,10,1,2,3,6,0xb2d95369
7163.23,1.0,9,2,2,3,7,0xb2d7bd65
459958.6,7.0,0,4,4,4,12,0x3b9b0e36
1349.35,1.0,0,1,2,4,7,0xb2d6f4a6
2313.64,1.0,7,1,2,3,6,0xb2d4ab33
200108.55,3.0,53,3,4,2,9,0xb2d17436
520075.41,4.0,4,4,4,4,12,0xb2d9a416
630040.71,4.0,11,4,4,3,11,0xb2d5b1f6d
100003.74,2.0,263,3,3,1,7,0xb2d603e1
4613.47,1.0,16,2,2,2,6,0xb2d69f54d
95.73,1.0,9,1,2,3,6,0xb2d8c64e
102.98,1.0,74,1,2,1,4,0xb2d9572c
20063.84,1.0,92,2,2,1,5,0xb2d44223d
0.0,1.0,4,1,2,4,7,0xb2d6bbf7
84244.72,1.0,15,3,2,3,8,0xb2d31935
521052.38,6.0,4,4,4,4,12,0xb2d560cd
5524.87,1.0,14,2,2,3,7,0xb2d8c8b7d
1117.12,1.0,92,1,2,1,4,0xb2d355ca
350016.21,5.0,69,4,4,1,9,0xb2d59874d
87.16,1.0,50,1,2,2,5,0xb2d2c715
1073.65,1.0,10,1,2,3,6,0xb2d8d9a2
530278.62,2.0,203,4,3,1,8,0xb2d2198d
704803.29,2.0,181,4,3,1,8,0xb2d650cd
71162.85,1.0,19,3,2,2,7,0xb2d0e3bcd
625065.94,6.0,1,4,4,4,12,0xb2d23927
1964.15,1.0,5,1,2,3,6,0xb2d92374
1500390.56,2.0,0,4,3,4,11,0xb2d8e730
317535.36,10.0,48,4,4,2,10,0xb2d8dc23d
8467.9,1.0,9,2,2,3,7,0xb2d6b2e2
5151.89,1.0,92,2,2,1,5,0xb2d28779
2675466.05,4.0,0,4,4,4,12,0xb2d5f6b0
15000.42,2.0,74,2,3,1,6,0xb2d53c75
101221.89,2.0,139,3,3,1,7,0xb2d5925e
60002.53,2.0,104,3,3,1,7,0xb2d7ad14d
243166.81,1.0,56,3,2,2,7,0xb2d395e4d
500047.51,4.0,6,4,4,3,11,0xb2d63ec9
30079.21,4.0,7,2,4,3,9,0xb2d6983ad
2003.16,1.0,159,1,2,1,4,0xb2d601ed
507341.03,2.0,58,4,3,2,9,0xb2d3ab8b
52147.5,2.0,6,2,3,3,8,0xb2d41732
30766.67,1.0,25,2,2,2,6,0xb2d54d26
10735.49,1.0,25,2,2,2,6,0xb2d97384
1140088.54,5.0,66,4,4,2,10,0xb2d30373
49.73,1.0,0,1,2,4,7,0xb2d0f47a
13106.35,1.0,9,2,2,3,7,0xb2d2536fd
202131.91,2.0,98,3,3,1,7,0xb2d834bad
650017.72,2.0,10,4,3,3,10,0xb2da4159
10844.37,1.0,0,2,2,4,8,0xb2d9a357
6065.88,1.0,184,2,2,1,5,0xb2d29068
1383000.0,16.0,0,4,4,4,12,0xb2d1710f
42820.82,2.0,92,2,3,1,6,0x3b9b16aad
7037.97,2.0,145,2,3,1,6,0xb2d90d77
223909.89,2.0,135,3,3,1,7,0xb2d7096ad
5076.02,1.0,184,2,2,1,5,0xb2d15e3ad
296.25,1.0,9,1,2,3,6,0xb2d2c747
9.27,1.0,10,1,2,3,6,0xb2d37cb3
1381.52,1.0,184,1,2,1,4,0xb2d3e6d2d
1819.63,1.0,4,1,2,4,7,0xb2d2b136
20000.42,2.0,74,2,3,1,6,0xb2d99dd0
90994.79,3.0,0,3,4,4,11,0xb2d473a3
867.62,1.0,12,1,2,3,6,0xb2d6bbb7
331109.64,2.0,8,4,3,3,10,0xb2d5e258
364017.44,4.0,0,4,4,4,12,0xb2d1b2db
392847.64,11.0,0,4,4,4,12,0xb2d30730
46.79,1.0,0,1,2,4,7,0xb2d86c9d
112172.98,3.0,1,3,4,4,11,0xb2d332fc
4541.12,1.0,12,2,2,3,7,0xb2d7f4d7
116007.0,3.0,59,3,4,2,9,0xb2d1ba25d
132003.87,8.0,76,3,4,1,8,0xb2d5e60a
2034354.66,2.0,24,4,3,2,9,0xb2d985c6
840.55,1.0,0,1,2,4,7,0xb2d69120
20000.21,1.0,10,2,2,3,7,0xb2d64dd9
106007.52,2.0,231,3,3,1,7,0xb2d28f59
40.56,1.0,3,1,2,4,7,0xb2d232e2
5116.32,1.0,10,2,2,3,7,0xb2d2f2f3
288.77,5.0,0,1,4,4,9,0x3b9b3677
18180.53,1.0,11,2,2,3,7,0xb2d40950d
5057.62,3.0,184,2,4,1,7,0xb2d27250
250046.54,2.0,29,3,3,2,8,0xb2d2b62b
81000396.32,9.0,0,4,4,4,12,0xb2d5b6d8
1136563.01,9.0,0,4,4,4,12,0xb2d16e2e
768002.24,6.0,0,4,4,4,12,0xb2d5d97c
162473.2,4.0,0,3,4,4,11,0xb2d0dd80
20069.17,2.0,14,2,3,3,8,0xb2d58c90
9273.55,1.0,24,2,2,2,6,0xb2d62787
8390.03,1.0,4,2,2,4,8,0xb2d5ab29
22385.3,1.0,184,2,2,1,5,0xb2d39d39
27220.06,1.0,0,2,2,4,8,0xb2d1c2cbd
948008.35,16.0,3,4,4,4,12,0xb2d17950d
1605.47,1.0,4,1,2,4,7,0xb2d95db9
1141.07,1.0,92,1,2,1,4,0x3b9b19a7
1.96,1.0,25,1,2,2,5,0xb2d6c148
500000.0,3.0,18,4,4,2,10,0xb2da10b6
2295.16,1.0,0,1,2,4,7,0xb2d6c206
250289.14,2.0,13,3,3,3,9,0xb2da0bdc
6.1,6.0,59,1,4,2,7,0xb2d246f5
5000.27,1.0,52,2,2,2,6,0xb2d90f60
432044.99,5.0,4,4,4,4,12,0xb2d585c0
231404.35,2.0,249,3,3,1,7,0xb2d1511a
2000000.0,2.0,26,4,3,2,9,0xb2da1677
1796.05,1.0,98,1,2,1,4,0xb2d3ea20d
6017.43,1.0,17,2,2,2,6,0xb2d708e4
7687.53,2.0,2,2,3,4,9,0xb2d1869b
841780.36,7.0,30,4,4,2,10,0xb2d113d5d
3049022.28,3.0,11,4,4,3,11,0xb2d44464d
50007.84,6.0,4,2,4,4,10,0xb2d9c319
1.83,1.0,18,1,2,2,5,0xb2d4f76e
10022.89,1.0,26,2,2,2,6,0xb2d2fdd6
1601994.05,3.0,5,4,4,3,11,0xb2d948f5
1899.23,2.0,309,1,3,1,5,0xb2d37265
2565288.98,4.0,8,4,4,3,11,0xb2d950e6
15038.85,1.0,21,2,2,2,6,0xb2d96494
168547.07,1.0,0,3,2,4,9,0xb2d9756a
67029.74,1.0,0,3,2,4,9,0xb2d3e65dd
11666.79,1.0,11,2,2,3,7,0xb2d926db
4687.61,1.0,184,2,2,1,5,0xb2d61998
100005.28,2.0,69,3,3,1,7,0xb2d9a27b
59368.58,1.0,110,3,2,1,6,0xb2d24ec1
6065.12,1.0,184,2,2,1,5,0xb2d29e88
1822.71,1.0,92,1,2,1,4,0xb2d42b2f
266.11,1.0,7,1,2,3,6,0xb2d37367d
100002.01,2.0,39,3,3,2,8,0xb2d8d026
286000.0,10.0,1,3,4,4,11,0xb2d62dc4
27.42,1.0,13,1,2,3,6,0xb2d60b8a
830058.47,4.0,0,4,4,4,12,0xb2d590d4
274.36,1.0,0,1,2,4,7,0xb2d9224e
519680.53,7.0,20,4,4,2,10,0xb2d1082a
630.05,1.0,15,1,2,3,6,0xb2d0f3f0
82.69,1.0,30,1,2,2,5,0xb2d56209
2811.92,1.0,1,1,2,4,7,0xb2d5ab76
210312.09,3.0,55,3,4,2,9,0xb2d3a2ae
631855.18,3.0,12,4,4,3,11,0xb2d42bc7d
1.83,1.0,0,1,2,4,7,0xb2d8cfff
90126.54,3.0,10,3,4,3,10,0xb2d5e0da
508724.85,4.0,35,4,4,2,10,0xb2d2d6a8d
12.06,1.0,21,1,2,2,5,0xb2d6de37
4902.36,1.0,92,2,2,1,5,0xb2d4cc8a
9441.25,1.0,253,2,2,1,5,0xb2d259a4d
965.4,1.0,20,1,2,2,5,0xb2d26093
513578.07,7.0,3,4,4,4,12,0xb2d31793
1774.67,1.0,0,1,2,4,7,0xb2d6f951d
23021.33,1.0,6,2,2,3,7,0xb2d2562e
101244.01,2.0,228,3,3,1,7,0xb2d64f7b
1615.1,1.0,3,1,2,4,7,0xb2d69adf
13853.69,1.0,3,2,2,4,8,0xb2d62fc1
358968.27,3.0,136,4,4,1,9,0xb2d3e6e4d
4009.7,1.0,0,2,2,4,8,0xb2d61493
17817.82,1.0,60,2,2,2,6,0xb2d65987
998.27,1.0,8,1,2,3,6,0xb2d30c7ad
200000.13,2.0,10,3,3,3,9,0xb2d9030f
261122.28,3.0,132,3,4,1,8,0xb2d1e038d
5058.84,1.0,2,2,2,4,8,0xb2d77476
5601.31,1.0,11,2,2,3,7,0xb2d8b3a2
153556.73,2.0,9,3,3,3,9,0xb2d25164d
152586.18,3.0,221,3,4,1,8,0xb2d33a0e
1136.92,1.0,25,1,2,2,5,0xb2d6ef13d
9.88,1.0,13,1,2,3,6,0xb2d344f4
430.94,2.0,16,1,3,2,6,0xb2d243c9
25308.54,1.0,5,2,2,3,7,0xb2d681af
6676.3,2.0,184,2,3,1,6,0x3b9b2676
455083.68,5.0,7,4,4,3,11,0xb2d5eb36
1202.79,1.0,1,1,2,4,7,0xb2d8c803
508004.69,4.0,13,4,4,3,11,0xb2d20697
590157.65,4.0,154,4,4,1,9,0xb2d3ba71d
220176.56,1.0,158,3,2,1,6,0xb2d176e1
442.15,2.0,24,1,3,2,6,0xb2d4ac2a
123448.03,2.0,97,3,3,1,7,0xb2d5d879
465063.71,4.0,0,4,4,4,12,0xb2d5dde6
450028.03,9.0,101,4,4,1,9,0xb2d12138
257847.1,2.0,48,3,3,2,8,0xb2d1ff6b
200000.0,2.0,12,3,3,3,9,0xb2d96360
1.39,1.0,51,1,2,2,5,0xb2d68bca
784.89,2.0,10,1,3,3,7,0xb2d39e5c
696.8,1.0,4,1,2,4,7,0xb2d93c74
6221.29,1.0,0,2,2,4,8,0xb2d68ce8
298795.4,3.0,53,3,4,2,9,0xb2d9359a
202843.21,2.0,17,3,3,2,8,0xb2d91da9
114.4,1.0,3,1,2,4,7,0xb2d772d3
1899.3,1.0,9,1,2,3,6,0xb2d414dc
56.98,1.0,110,1,2,1,4,0xb2d63926
1540020.49,3.0,97,4,4,1,9,0xb2d909c8d
50021.61,2.0,94,2,3,1,6,0xb2d58956
30001.32,4.0,31,2,4,2,8,0xb2d572d0
257000.0,1.0,0,3,2,4,9,0xb2da6a79
9403.97,1.0,4,2,2,4,8,0xb2d97d4b
2083214.88,25.0,0,4,4,4,12,0xb2d0a6c9
4103.75,1.0,0,2,2,4,8,0xb2d4a246
16104.62,1.0,0,2,2,4,8,0xb2d7932f
50.17,1.0,1,1,2,4,7,0xb2d6aa25
1261.46,1.0,92,1,2,1,4,0xb2d2960a
14477.68,7.0,0,2,4,4,10,0xb2d8ea96
30927.33,1.0,6,2,2,3,7,0xb2d60146
51454.97,1.0,3,2,2,4,8,0xb2d6564e
3208.38,1.0,0,2,2,4,8,0xb2d92e44
123.7,6.0,4,1,4,4,9,0x3b9b4698
0.09,2.0,13,1,3,3,7,0xb2d95481
100091.92,2.0,152,3,3,1,7,0xb2d1d2d3
24210.74,1.0,4,2,2,4,8,0xb2d21a77d
10000.11,2.0,45,2,3,2,7,0xb2d91b4ed
2341.68,1.0,3,1,2,4,7,0xb2d5b35c
2928.51,1.0,1,2,2,4,8,0xb2d4faa0
202848.4,2.0,140,3,3,1,7,0xb2d637ad
1007297.22,13.0,0,4,4,4,12,0x3b9b0fc9
51801.1,3.0,3,2,4,4,10,0xb2d57f34
285343.52,3.0,70,3,4,1,8,0xb2d3a963
1007601.16,4.0,0,4,4,4,12,0x3b9b2fdf
117.79,1.0,5,1,2,3,6,0xb2d590b5
253601.64,3.0,20,3,4,2,9,0x3b9af254
453034.16,5.0,7,4,4,3,11,0xb2d49154
9207.54,1.0,3,2,2,4,8,0xb2d2f633
50397.34,2.0,129,2,3,1,6,0xb2d699ca
9540.15,1.0,2,2,2,4,8,0xb2d307c4
6.06,1.0,92,1,2,1,4,0xb2d2a6e4d
202131.86,2.0,4,3,3,4,10,0xb2d8935bd
27390642.92,2.0,14,4,3,3,10,0xb2d0bca7
1971.19,1.0,92,1,2,1,4,0xb2d1ba2a
38031.27,1.0,20,2,2,2,6,0xb2d6aa4e
1873978.07,7.0,0,4,4,4,12,0xb2d0face
571000.02,3.0,8,4,4,3,11,0xb2d9a60b
100018.77,2.0,20,3,3,2,8,0xb2d51c35
94.76,1.0,19,1,2,2,5,0xb2d7b15e
730.86,3.0,0,1,4,4,9,0xb2d3e43e
15369.66,1.0,0,2,2,4,8,0xb2d1b8a5
741047.41,10.0,0,4,4,4,12,0xb2d625f1
2325.42,1.0,184,1,2,1,4,0xb2d2dd19
56.04,1.0,16,1,2,2,5,0xb2d2c356
115.39,1.0,27,1,2,2,5,0xb2da052c
884007.22,8.0,14,4,4,3,11,0xb2d107d6d
179695.83,5.0,4,3,4,4,11,0xb2d072cf
3400.66,1.0,11,2,2,3,7,0xb2d9e130
5177.74,1.0,92,2,2,1,5,0xb2d1c2f1d
80136.44,1.0,0,3,2,4,9,0xb2d62787d
69239.86,2.0,14,3,3,3,9,0xb2d45edb
0.0,2.0,55,1,3,2,6,0xb2d5bb9ed
90113.62,1.0,11,3,2,3,8,0xb2da00cb
100018.91,2.0,5,3,3,3,9,0xb2d9d02b
208950.38,4.0,3,3,4,4,11,0xb2d2aace
427008.56,13.0,18,4,4,2,10,0xb2d0b5f5
1173.06,1.0,10,1,2,3,6,0xb2d6e903
1171864.2,5.0,3,4,4,4,12,0xb2d574a2
50855.12,1.0,1,2,2,4,8,0xb2d2bf68d
500085.16,2.0,3,4,3,4,11,0xb2d6aaec
539099.52,3.0,108,4,4,1,9,0xb2d30e88
20000.21,2.0,21,2,3,2,7,0xb2da238c
327668.74,2.0,160,4,3,1,8,0xb2d39ffa
1293.38,1.0,92,1,2,1,4,0xb2d0e3bad
15063.46,2.0,48,2,3,2,7,0xb2d9d5a4
3557898.04,13.0,3,4,4,4,12,0xb2d0ce93
234016.1,3.0,54,3,4,2,9,0xb2d22415
42.76,1.0,18,1,2,2,5,0xb2d33354d
280060.51,3.0,59,3,4,2,9,0xb2d0fc1fd
2217.24,1.0,4,1,2,4,7,0xb2d4262b
200000.0,2.0,25,3,3,2,8,0xb2da1a61
241954.42,4.0,18,3,4,2,9,0xb2d5d392
11633.46,5.0,216,2,4,1,7,0xb2d559fe
2125.39,1.0,14,1,2,3,6,0xb2d9b8f0
449335.35,2.0,30,4,3,2,9,0xb2d37846
115058.38,5.0,11,3,4,3,10,0xb2d68dd6
904515.81,4.0,1,4,4,4,12,0xb2d07166
280072.28,4.0,43,3,4,2,9,0xb2d4eb0ad
3030.17,1.0,184,2,2,1,5,0xb2d2b78fd
200720.87,2.0,27,3,3,2,8,0xb2d8fa38
7282.87,1.0,29,2,2,2,6,0xb2d925cd
6349.68,1.0,92,2,2,1,5,0x3b9b19ebd
2078.57,4.0,0,1,4,4,9,0xb2d09271d
4.12,1.0,54,1,2,2,5,0xb2d11b24
15648.79,1.0,89,2,2,1,5,0xb2d37260
67003.46,5.0,11,3,4,3,10,0xb2d15156
503800.03,6.0,11,4,4,3,11,0xb2d2a5a3
353847.28,3.0,74,4,4,1,9,0xb2d56f18
24.02,1.0,69,1,2,1,4,0xb2d23ac5
1141.47,1.0,118,1,2,1,4,0xb2d2da25
508886.02,3.0,97,4,4,1,9,0xb2d8e19c
100007.86,2.0,74,3,3,1,7,0xb2d53083d
7608.25,1.0,184,2,2,1,5,0xb2d238c4
817142.31,5.0,23,4,4,2,10,0xb2d8f7c1
3.64,1.0,28,1,2,2,5,0xb2d69238
3056.25,1.0,17,2,2,2,6,0xb2d6da00
1410.72,1.0,184,1,2,1,4,0xb2d221ce
52002.11,2.0,92,2,3,1,6,0xb2d4019b
557086.76,5.0,8,4,4,3,11,0xb2d12c11d
102947.58,2.0,179,3,3,1,7,0xb2d5dcd1d
0.0,1.0,2,1,2,4,7,0xb2d55ed2
5220.17,1.0,0,2,2,4,8,0xb2d6b994d
942200.2,6.0,4,4,4,4,12,0xb2d281b8
1538.54,1.0,18,1,2,2,5,0xb2d475ae
100042.26,2.0,179,3,3,1,7,0xb2d5f347
528683.78,5.0,4,4,4,4,12,0xb2d4dcc2
200862.23,2.0,23,3,3,2,8,0xb2d25724
1240003.69,4.0,0,4,4,4,12,0xb2d78f3f
2660803.75,4.0,20,4,4,2,10,0xb2d23808d
340069.23,4.0,25,4,4,2,10,0xb2d10805
1326978.91,2.0,33,4,3,2,9,0xb2d65309
492015.92,3.0,4,4,4,4,12,0xb2d4955d
180320.77,2.0,3,3,3,4,10,0xb2d61fa0
1134.94,1.0,54,1,2,2,5,0xb2d62367
630014.38,7.0,0,4,4,4,12,0xb2d625fe
120005.19,2.0,158,3,3,1,7,0xb2d5d77e
200004.22,2.0,67,3,3,1,7,0xb2d9ac51
30440.07,3.0,3,2,4,4,10,0xb2d78a2c
7.3,1.0,58,1,2,2,5,0xb2d5a4fd
139.79,1.0,7,1,2,3,6,0xb2d36a85
300051.36,3.0,206,3,4,1,8,0xb2d109a9
400011.47,7.0,5,4,4,3,11,0xb2d28285
5848.18,1.0,184,2,2,1,5,0xb2d300f2d
388.52,1.0,67,1,2,1,4,0xb2d656c6
90003.8,2.0,70,3,3,1,7,0xb2d9a323
4360.32,7.0,132,2,4,1,7,0x3b9ae857
186763.84,1.0,0,3,2,4,9,0xb2d791b6d
30115.12,1.0,184,2,2,1,5,0xb2d60e0c
2680.9,1.0,0,1,2,4,7,0xb2d6c85a
278230.17,2.0,10,3,3,3,9,0xb2d5796b
200004.22,2.0,66,3,3,2,8,0xb2d8ef35
78.49,1.0,69,1,2,1,4,0xb2d230c7
1.61,1.0,2,1,2,4,7,0xb2d5fbc9
2.12,2.0,0,1,3,4,8,0xb2d15db8
101875.26,3.0,31,3,4,2,9,0xb2d5fcb2d
406621.53,3.0,11,4,4,3,11,0xb2d4ebf5
67.32,1.0,44,1,2,2,5,0xb2d62da9
3822.37,1.0,9,2,2,3,7,0xb2d2ab24d
32173.03,1.0,7,2,2,3,7,0xb2d255ec
4217.68,1.0,92,2,2,1,5,0xb2d322ead
220781.46,2.0,39,3,3,2,8,0xb2d9e101
117.34,1.0,9,1,2,3,6,0xb2d913bf
202131.82,2.0,93,3,3,1,7,0xb2d98182
48702.51,3.0,14,2,4,3,9,0xb2d5cc7a
500078.17,3.0,6,4,4,3,11,0xb2d64dc6d
5023.74,2.0,184,2,3,1,6,0xb2d3c7b5d
100000.0,2.0,6,3,3,3,9,0xb2d96eae
209928.12,1.0,8,3,2,3,8,0xb2d5dfa1
20948.7,2.0,1,2,3,4,9,0xb2d5a442
1478.86,1.0,9,1,2,3,6,0xb2d3c7eed
200001.44,3.0,9,3,4,3,10,0xb2d602ad
5216.06,1.0,5,2,2,3,7,0xb2d62da9d
779.94,1.0,8,1,2,3,6,0xb2d4ba4b
412012.49,2.0,159,4,3,1,8,0xb2d2d257
10001.18,2.0,118,2,3,1,6,0xb2d56569d
15.1,1.0,63,1,2,2,5,0xb2d9a940
521421.0,3.0,1,4,4,4,12,0xb2d636d5
1572.21,1.0,214,1,2,1,4,0xb2d247c6
393986.06,6.0,0,4,4,4,12,0xb2d15ff5
1213000.55,5.0,5,4,4,3,11,0xb2d6b93e
378619.76,3.0,2,4,4,4,12,0xb2d12c93
155067.67,3.0,77,3,4,1,8,0xb2d20d57
1373.9,1.0,25,1,2,2,5,0xb2d78973
25200.0,2.0,3,2,3,4,9,0xb2d97a62d
50000.53,2.0,87,2,3,1,6,0xb2d8c6c1
1617.7,1.0,10,1,2,3,6,0xb2d471a4d
1.66,1.0,5,1,2,3,6,0xb2d69225d
15847.69,1.0,105,2,2,1,5,0xb2d1e1c2
432729.39,8.0,0,4,4,4,12,0xb2d06560d
694786.95,6.0,74,4,4,1,9,0xb2d23abf
50000.53,2.0,98,2,3,1,6,0xb2d6ba26
606000.63,17.0,0,4,4,4,12,0xb2d155c1
504330.11,2.0,74,4,3,1,8,0xb2d2acc4
855000.08,7.0,0,4,4,4,12,0xb2d31674d
2119.1,1.0,46,1,2,2,5,0xb2d5178a
921.63,1.0,0,1,2,4,7,0xb2d64537
2082.57,2.0,87,1,3,1,5,0xb2d6e184
1627012.57,6.0,46,4,4,2,10,0xb2d23ea0
2.68,1.0,14,1,2,3,6,0xb2d7aaf0
342007.22,2.0,46,4,3,2,9,0xb2d9dca7
432.08,1.0,8,1,2,3,6,0xb2d16485
25840423.83,2.0,0,4,3,4,11,0xb2d96cfad
200045.11,3.0,0,3,4,4,11,0xb2d28ee2
413730.87,2.0,77,4,3,1,8,0xb2d1b093d
773050.25,5.0,3,4,4,4,12,0xb2d24d1b
275434.03,11.0,0,3,4,4,11,0xb2d5ac35
20390.0,2.0,184,2,3,1,6,0xb2d419b5
1560003.14,5.0,21,4,4,2,10,0xb2d5a519
1012489.95,7.0,10,4,4,3,11,0xb2d3c055
1012.0,1.0,0,1,2,4,7,0xb2d315f4
4183.19,3.0,92,2,4,1,7,0xb2d55fa0
636580.92,4.0,4,4,4,4,12,0xb2d0677fd
605.41,1.0,184,1,2,1,4,0xb2d29f92
30110.0,1.0,2,2,2,4,8,0xb2d6e709
1036.64,1.0,136,1,2,1,4,0xb2d6c45a
813023.83,5.0,31,4,4,2,10,0xb2d25cd2d
10277.91,1.0,26,2,2,2,6,0xb2d643a7
272247.36,4.0,10,3,4,3,10,0xb2d43d9fd
1078.24,1.0,42,1,2,2,5,0xb2d6d414
173.86,1.0,0,1,2,4,7,0xb2d26266
500000.0,2.0,19,4,3,2,9,0xb2d9570b
87.62,1.0,92,1,2,1,4,0xb2d4d9e8
287394.87,4.0,108,3,4,1,8,0xb2d250cd
470393.66,2.0,208,4,3,1,8,0xb2d56641d
280000.37,4.0,0,3,4,4,11,0xb2d55be9
74.22,1.0,0,1,2,4,7,0xb2d34803
8.04,1.0,75,1,2,1,4,0xb2d6b760
200000.0,2.0,24,3,3,2,8,0xb2d94e33
2956.39,1.0,184,2,2,1,5,0xb2d1197c
91459.64,2.0,14,3,3,3,9,0xb2d593ba
208000.01,4.0,89,3,4,1,8,0xb2d28abed
120367.04,4.0,0,3,4,4,11,0xb2d6fb17
19994.84,1.0,15,2,2,3,7,0xb2d99163
1003.38,1.0,126,1,2,1,4,0xb2d5b0fc
81.86,1.0,83,1,2,1,4,0xb2d412c4
275473.86,4.0,0,3,4,4,11,0xb2d65564
1510070.81,2.0,0,4,3,4,11,0xb2d4e3c0
200196.42,2.0,0,3,3,4,10,0xb2d64ebe
10585.13,1.0,17,2,2,2,6,0xb2d62e45d
39.3,1.0,59,1,2,2,5,0xb2d53c36d
230054.08,5.0,83,3,4,1,8,0xb2d5fd91
16298.25,1.0,92,2,2,1,5,0xb2d0f8c4
3993.05,1.0,0,2,2,4,8,0xb2d6c175
165010.69,3.0,3,3,4,4,11,0xb2d541cd
2218.0,1.0,10,1,2,3,6,0xb2d2ce8c
349477.34,4.0,77,4,4,1,9,0xb2d1aea2
5003.27,1.0,20,2,2,2,6,0xb2d96440
213018.93,2.0,9,3,3,3,9,0xb2d56492d
101228.72,2.0,26,3,3,2,8,0xb2d6b209
280005.95,3.0,104,3,4,1,8,0xb2d61b10
563.01,1.0,89,1,2,1,4,0xb2d696fb
106637.07,2.0,12,3,3,3,9,0xb2d94db6
74006.85,4.0,3,3,4,4,11,0xb2d62879
310006.74,7.0,46,4,4,2,10,0xb2d13794d
21606.51,1.0,2,2,2,4,8,0xb2d801e3d
604.46,2.0,0,1,3,4,8,0x3b9af1ead
169983.05,3.0,6,3,4,3,10,0x3b9b38fd
253978.03,5.0,0,3,4,4,11,0xb2d09db8
2496.76,3.0,92,1,4,1,6,0xb2d223e0
381122.52,3.0,1,4,4,4,12,0xb2d1ba7f
719425.83,7.0,0,4,4,4,12,0xb2d4116a
3265.92,1.0,92,2,2,1,5,0xb2d17366
500000.0,2.0,1,4,3,4,11,0xb2d98017
859167.91,2.0,0,4,3,4,11,0xb2d35174
856.14,1.0,14,1,2,3,6,0xb2d340e1
219.45,1.0,7,1,2,3,6,0xb2d3ec1b
1061756.76,16.0,0,4,4,4,12,0xb2d34f06
771.83,1.0,9,1,2,3,6,0xb2d5b6c3
361863.01,3.0,20,4,4,2,10,0xb2d20088
52531.26,2.0,0,3,3,4,10,0xb2d44d35d
25111.24,2.0,73,2,3,1,6,0xb2d3bbb6d
41069.47,2.0,20,2,3,2,7,0xb2d0feba
3.89,1.0,88,1,2,1,4,0xb2d236c8
480.57,1.0,12,1,2,3,6,0xb2d31985
865.22,1.0,3,1,2,4,7,0xb2d0b31d
457230.86,4.0,0,4,4,4,12,0xb2d2d13bd
50000.53,2.0,39,2,3,2,7,0xb2d9f45d
1008.66,1.0,138,1,2,1,4,0xb2d642ecd
53707.01,1.0,10,3,2,3,8,0xb2d430c6d
4042.15,1.0,0,2,2,4,8,0xb2d926de
444.34,1.0,14,1,2,3,6,0xb2d65b8c
78.87,1.0,14,1,2,3,6,0xb2d5dde1
205855.16,10.0,0,3,4,4,11,0xb2d43124d
1322971.75,10.0,1,4,4,4,12,0xb2d3ba3f
648079.21,8.0,0,4,4,4,12,0xb2d64a1a
46.54,1.0,2,1,2,4,7,0xb2d0906e
17518.91,1.0,21,2,2,2,6,0xb2d6dda5
30010.09,2.0,33,2,3,2,7,0xb2d557c4
50853.99,2.0,179,2,3,1,6,0xb2d5f4c7
670032.13,4.0,0,4,4,4,12,0xb2d12833
1350007.39,4.0,11,4,4,3,11,0xb2da3ffe
0.64,1.0,5,1,2,3,6,0xb2d1eb41
4183.6,1.0,184,2,2,1,5,0xb2d1150e
128767.45,4.0,13,3,4,3,10,0xb2d3d203
51729.54,8.0,11,2,4,3,9,0x3b9af0ca
40003.8,2.0,83,2,3,1,6,0xb2d9833a
4387.58,1.0,11,2,2,3,7,0xb2d55f9c
80120.18,2.0,48,3,3,2,8,0xb2d56a6ad
150191.88,3.0,18,3,4,2,9,0xb2d21e0b
70000.0,2.0,3,3,3,4,10,0xb2d9789f
10166.24,1.0,0,2,2,4,8,0xb2d6de25
4750050.28,3.0,153,4,4,1,9,0xb2d80167
135455.38,2.0,82,3,3,1,7,0xb2d21a39d
13092.05,1.0,0,2,2,4,8,0xb2d78fdf
9443.57,1.0,3,2,2,4,8,0xb2d55df4d
306183.3,2.0,4,4,3,4,11,0xb2d0dc9b
80971.12,2.0,28,3,3,2,8,0xb2d9e9d1
130002.07,4.0,87,3,4,1,8,0xb2d2ce7a
50002.64,2.0,63,2,3,2,7,0xb2d9af9f
63403.56,1.0,0,3,2,4,9,0xb2d6505fd
50.66,1.0,5,1,2,3,6,0xb2d1ccc0
240156.24,3.0,16,3,4,2,9,0xb2d19a1a
487018.92,4.0,80,4,4,1,9,0xb2d1d97ed
1286.39,1.0,92,1,2,1,4,0xb2d34d82d
36.93,1.0,11,1,2,3,6,0xb2d781c4d
1200032.21,8.0,0,4,4,4,12,0xb2d40d42
1823.74,1.0,0,1,2,4,7,0xb2d24e1d
260495.34,3.0,0,3,4,4,11,0xb2d921ad
1812.97,1.0,0,1,2,4,7,0xb2d1d72b
102521.26,1.0,6,3,2,3,8,0xb2d637c1
8025.46,5.0,84,2,4,1,7,0xb2d92d5e
4148.75,1.0,10,2,2,3,7,0xb2d1c23e
190017.08,4.0,1,3,4,4,11,0xb2d3a646
244076.08,2.0,39,3,3,2,8,0xb2d90ba6
410050.53,6.0,18,4,4,2,10,0xb2d60f78
920058.63,5.0,0,4,4,4,12,0xb2d92d05
4109.34,4.0,168,2,4,1,7,0xb2d0d4d9
476026.56,5.0,172,4,4,1,9,0xb2d1103bd
1032.32,1.0,0,1,2,4,7,0xb2d53151
210838.39,2.0,29,3,3,2,8,0xb2d5a84e
1933.55,1.0,9,1,2,3,6,0xb2d565d0d
40833.66,2.0,11,2,3,3,8,0xb2d5cb4f
36036.49,4.0,0,2,4,4,10,0xb2d3834e
426057.43,3.0,104,4,4,1,9,0xb2d17df1
115.92,1.0,0,1,2,4,7,0xb2d227f8
500000.0,3.0,0,4,4,4,12,0xb2d980ed
120451.64,4.0,35,3,4,2,9,0xb2d12867
1108000.0,4.0,1,4,4,4,12,0xb2d4a678
1832.63,2.0,22,1,3,2,6,0xb2d2e5af
31046.23,1.0,24,2,2,2,6,0xb2d62838
20009.31,5.0,12,2,4,3,9,0xb2d0b649d
10000.0,2.0,7,2,3,3,8,0xb2d1882a
3930.87,1.0,3,2,2,4,8,0xb2d319d9
1134.97,1.0,16,1,2,2,5,0xb2d4f34c
84641.31,6.0,0,3,4,4,11,0xb2d07bedd
21011.98,2.0,19,2,3,2,7,0x3b9b47b1
6173.79,1.0,0,2,2,4,8,0xb2d8c8b8
4194.98,1.0,21,2,2,2,6,0xb2d26569
1011.04,1.0,92,1,2,1,4,0xb2d25241d
213040.7,4.0,58,3,4,2,9,0xb2d5d3ebd
100014.23,2.0,4,3,3,4,10,0xb2d68e31
135471.7,5.0,25,3,4,2,9,0xb2d5c30b
13459.16,1.0,15,2,2,3,7,0xb2d8d2fe
277.13,1.0,11,1,2,3,6,0xb2d32073
230003.16,2.0,27,3,3,2,8,0xb2d5bfaa
68881.04,2.0,20,3,3,2,8,0x3b9b28c2
100005.41,2.0,231,3,3,1,7,0xb2d55bcf
1672.74,1.0,67,1,2,1,4,0xb2d5a7c9d
1250369.1,2.0,0,4,3,4,11,0xb2d5e855
4002.56,1.0,0,2,2,4,8,0xb2d1d893
402842.11,2.0,71,4,3,1,8,0xb2d9a5e1
1000137.82,2.0,62,4,3,2,9,0xb2d6936b
364514.01,8.0,0,4,4,4,12,0xb2d3118b
1400119.26,7.0,19,4,4,2,10,0xb2d9569dd
175012.93,5.0,10,3,4,3,10,0xb2d952d2d
109.61,1.0,32,1,2,2,5,0xb2d37d07
700118.04,4.0,39,4,4,2,10,0xb2d52783
398289.98,5.0,104,4,4,1,9,0xb2d2b078
1045.43,1.0,92,1,2,1,4,0xb2d213d4
171341.43,4.0,11,3,4,3,10,0xb2d59069d
483127.69,3.0,14,4,4,3,11,0xb2d58077
1000120.88,2.0,18,4,3,2,9,0xb2d518d0
503687.64,3.0,0,4,4,4,12,0xb2d62b36
4050.65,1.0,0,2,2,4,8,0xb2d9106c
421655.73,3.0,221,4,4,1,9,0xb2d2b57a
200710.53,2.0,55,3,3,2,8,0xb2d9cd63
17.79,1.0,2,1,2,4,7,0xb2d3f0aa
3.1,1.0,13,1,2,3,6,0xb2d94459
5.9,3.0,5,1,4,3,8,0xb2d1c8af
445120.32,9.0,26,4,4,2,10,0xb2d1c795d
3625461.35,1.0,92,4,2,1,7,0xb2d100c6d
5.17,1.0,58,1,2,2,5,0xb2d8f0b9
1402.85,1.0,0,1,2,4,7,0xb2d926c0
43.95,1.0,6,1,2,3,6,0xb2d3afb6
90289.59,2.0,76,3,3,1,7,0xb2d502b0d
7092.1,1.0,11,2,2,3,7,0xb2d27c40
17347.46,2.0,0,2,3,4,9,0xb2d9ed26
5.37,1.0,50,1,2,2,5,0xb2d1544e
63493.87,3.0,66,3,4,2,9,0x3b9b33a5
1722.13,1.0,21,1,2,2,5,0xb2d20f44
120578.94,2.0,181,3,3,1,7,0xb2d11d0d
11306.41,2.0,19,2,3,2,7,0xb2d1b02b
251737.51,3.0,29,3,4,2,9,0xb2d6e168
720050.81,4.0,87,4,4,1,9,0xb2d51e26
120067.72,3.0,76,3,4,1,8,0xb2d1cf11
542.48,1.0,6,1,2,3,6,0xb2d95a2c
195.81,1.0,4,1,2,4,7,0xb2d65e80d
1.49,1.0,83,1,2,1,4,0xb2d5f9e4
11198.78,1.0,0,2,2,4,8,0xb2d6a3de
22.66,1.0,9,1,2,3,6,0xb2d2613a
2005.75,1.0,184,1,2,1,4,0xb2d1c6de
1634074.0,13.0,0,4,4,4,12,0xb2d2541c
180004.75,4.0,28,3,4,2,9,0xb2d949be
197027.92,2.0,136,3,3,1,7,0xb2d43da2
75145.41,1.0,18,3,2,2,7,0xb2d54c10
50679.38,4.0,0,2,4,4,10,0xb2d8f6d1
662495.87,8.0,0,4,4,4,12,0xb2d1a562
46.56,2.0,51,1,3,2,6,0xb2d697b7
35.66,1.0,10,1,2,3,6,0xb2d3ebed
1424.98,3.0,92,1,4,1,6,0x3b9ad77b
92409.81,5.0,0,3,4,4,11,0xb2d2113cd
0.0,1.0,0,1,2,4,7,0xb2d2972b
22529.2,1.0,18,2,2,2,6,0xb2d51e75
1878.57,1.0,92,1,2,1,4,0xb2d34a37
6508.21,1.0,8,2,2,3,7,0xb2d3933ed
40112.73,3.0,63,2,4,2,8,0xb2d8e9b2d
100004.22,2.0,76,3,3,1,7,0xb2d641d5
257084.74,8.0,0,3,4,4,11,0xb2d21348d
244331.12,5.0,4,3,4,4,11,0xb2d1d017
9205.65,1.0,9,2,2,3,7,0xb2d92920
1000031.52,4.0,97,4,4,1,9,0xb2d1a51cd
400007.51,4.0,5,4,4,3,11,0xb2d1a61d
5995.48,1.0,11,2,2,3,7,0xb2d99654
699169.75,3.0,179,4,4,1,9,0xb2d5f75e
904.35,1.0,11,1,2,3,6,0xb2d8e2f9
530930.16,3.0,36,4,4,2,10,0xb2d10d4a
407133.8,2.0,19,4,3,2,9,0xb2d66274
1795760.75,12.0,49,4,4,2,10,0xb2d0641d
0.63,1.0,2,1,2,4,7,0xb2d3789a
400004.22,2.0,28,4,3,2,9,0xb2da0b90
134024.04,5.0,6,3,4,3,10,0xb2d588b1
4630.14,1.0,275,2,2,1,5,0xb2d60b98d
201866.31,3.0,103,3,4,1,8,0xb2d2368ad
1100078.51,17.0,110,4,4,1,9,0xb2d0a932
152226.2,3.0,10,3,4,3,10,0xb2d8fed0
1703.12,1.0,1,1,2,4,7,0xb2d348e3
1648743.6,6.0,0,4,4,4,12,0xb2d0afffd
502235.18,2.0,13,4,3,3,10,0xb2d6f9d8d
205264.47,2.0,84,3,3,1,7,0xb2d699b8
858.23,1.0,1,1,2,4,7,0xb2d393d9
222.5,2.0,0,1,3,4,8,0x3b9b4709
329016.59,8.0,14,4,4,3,11,0xb2d1341a
110685.9,1.0,41,3,2,2,7,0xb2d35513d
478559.65,3.0,19,4,4,2,10,0xb2d6c35b
3695.49,1.0,25,2,2,2,6,0xb2d90c80
4058.74,1.0,92,2,2,1,5,0xb2d2854d
750000.44,4.0,22,4,4,2,10,0xb2d0d659d
6235.12,1.0,92,2,2,1,5,0xb2d5fd10d
16009.06,1.0,17,2,2,2,6,0xb2d6c468
1600008.29,9.0,0,4,4,4,12,0xb2d511bfd
2135.91,1.0,92,1,2,1,4,0xb2d26b2f
130000.0,1.0,0,3,2,4,9,0xb2d33495
200016.6,2.0,20,3,3,2,8,0xb2d64a50d
30000.32,2.0,48,2,3,2,7,0xb2d9dbcc
220124.53,4.0,10,3,4,3,10,0xb2d6e9f1
240000.0,3.0,1,3,4,4,11,0xb2da5049
200000.0,2.0,5,3,3,3,9,0xb2d2adc9d
1070.8,1.0,8,1,2,3,6,0xb2d91773
40000.42,2.0,98,2,3,1,6,0xb2d9709e
260055.25,4.0,92,3,4,1,8,0xb2d2b39dd
550000.0,3.0,17,4,4,2,10,0xb2da0a2a
1079.34,1.0,1,1,2,4,7,0xb2d6fa8d
568314.68,2.0,67,4,3,1,8,0xb2d0f33bd
251028.38,4.0,28,3,4,2,9,0xb2d1f452
685000.76,3.0,8,4,4,3,11,0xb2d56340
100016.27,3.0,3,3,4,4,11,0xb2d2bd67
20162.33,1.0,92,2,2,1,5,0xb2d23addd
361050.38,7.0,4,4,4,4,12,0xb2d17cc3
855022.85,6.0,11,4,4,3,11,0xb2d14386d
648.98,1.0,9,1,2,3,6,0xb2d3794b
28340.44,1.0,18,2,2,2,6,0xb2d995c0
0.99,1.0,5,1,2,3,6,0xb2d455a1
3928.07,1.0,184,2,2,1,5,0xb2d42ba3
1097.45,6.0,92,1,4,1,6,0xb2d0a6a2
1253356.07,1.0,24,4,2,2,8,0xb2d368d1
70991.7,1.0,13,3,2,3,8,0xb2d30f82d
400162.13,2.0,43,4,3,2,9,0xb2d2b427
3036816.15,5.0,11,4,4,3,11,0xb2d5b3b8
400041.88,3.0,5,4,4,3,11,0xb2d97a7fd
19010.52,2.0,19,2,3,2,7,0xb2d5c500
400010.42,3.0,11,4,4,3,11,0xb2d921d6
3197.15,1.0,92,2,2,1,5,0xb2d29094
200000.0,2.0,12,3,3,3,9,0xb2da464a
8404.2,1.0,1,2,2,4,8,0xb2d5e08a
1001.57,1.0,29,1,2,2,5,0xb2d992bb
226150.66,11.0,11,3,4,3,10,0xb2d26232
66.49,1.0,9,1,2,3,6,0xb2d6a4bc
1196534.87,9.0,1,4,4,4,12,0xb2d4956b
117030.85,2.0,52,3,3,2,8,0xb2d13e7b
251016.13,4.0,105,3,4,1,8,0xb2d6251c
197.27,1.0,1,1,2,4,7,0xb2d6c4bad
263220.69,5.0,25,3,4,2,9,0xb2d0c98ed
4403.15,1.0,131,2,2,1,5,0xb2d299be
0.74,4.0,8,1,4,3,8,0xb2d089f1
560009.14,3.0,1,4,4,4,12,0xb2d6b44b
50040.87,2.0,259,2,3,1,6,0xb2d43833
50005.34,2.0,168,2,3,1,6,0xb2d4f9a1
513005.28,4.0,68,4,4,1,9,0xb2d5ca07
3174.85,1.0,4,2,2,4,8,0xb2d98602
150011.31,2.0,18,3,3,2,8,0xb2d9c036
30052.28,1.0,174,2,2,1,5,0xb2d36328d
520000.0,12.0,2,4,4,4,12,0x3b9af192
240157.94,2.0,9,3,3,3,9,0xb2d957d6
5.58,1.0,1,1,2,4,7,0xb2d0c45f
159048.67,2.0,66,3,3,2,8,0xb2d5d427
896.95,1.0,6,1,2,3,6,0xb2d91831
700000.13,3.0,14,4,4,3,11,0xb2d645ab
33.24,1.0,9,1,2,3,6,0xb2d27c45
8038.65,1.0,0,2,2,4,8,0xb2d61eda
1846200.04,10.0,0,4,4,4,12,0xb2d23fe5
32.57,1.0,12,1,2,3,6,0xb2d25880
400051.93,2.0,92,4,3,1,8,0xb2d61ea7
22898.71,1.0,1,2,2,4,8,0xb2d87f39d
502435.57,3.0,7,4,4,3,11,0xb2d6f0d3
30739.64,1.0,15,2,2,3,7,0xb2d3a5b0
30093.9,2.0,63,2,3,2,7,0xb2d09847
250000.0,3.0,1,3,4,4,11,0xb2da62e9
51821.07,2.0,5,2,3,3,8,0xb2d6163d
190031.09,3.0,102,3,4,1,8,0xb2d2d151
1222658.53,8.0,0,4,4,4,12,0xb2d9793bd
841.16,1.0,10,1,2,3,6,0xb2d58c6f
410017.51,2.0,56,4,3,2,9,0xb2d5c711
6235.17,1.0,1,2,2,4,8,0xb2d10c64
260024.91,6.0,18,3,4,2,9,0xb2d5705ad
43188.89,1.0,0,2,2,4,8,0xb2d0f988
22200.18,1.0,46,2,2,2,6,0xb2d6262e
11753.76,2.0,18,2,3,2,7,0xb2d0e25f
45830.24,5.0,0,2,4,4,10,0xb2d95870d
200011.91,3.0,48,3,4,2,9,0xb2d55864
90098.62,3.0,18,3,4,2,9,0xb2d21c5dd
500820.89,2.0,108,4,3,1,8,0xb2d3af33
485013.35,5.0,38,4,4,2,10,0xb2d78e23
1656.27,1.0,0,1,2,4,7,0xb2d17572
25397.68,1.0,6,2,2,3,7,0xb2d22bb7
384.73,1.0,89,1,2,1,4,0xb2d16b2d
556001.67,3.0,2,4,4,4,12,0xb2d62e07
530925.87,6.0,9,4,4,3,11,0xb2d5a69a
70005.07,2.0,172,3,3,1,7,0xb2d122a9d
4006.56,1.0,184,2,2,1,5,0xb2d2a747
8000.02,2.0,92,2,3,1,6,0xb2d57634d
649.08,1.0,0,1,2,4,7,0xb2da03a2
190004.65,4.0,26,3,4,2,9,0xb2d83852d
364241.48,3.0,41,4,4,2,10,0xb2d41958
10219.98,1.0,28,2,2,2,6,0xb2d214d4
101895.94,3.0,196,3,4,1,8,0xb2d1ca62
100019.19,2.0,56,3,3,2,8,0xb2d24551
0.0,1.0,0,1,2,4,7,0xb2d86ac9
239086.1,3.0,13,3,4,3,10,0xb2d3a61c
26322.5,1.0,1,2,2,4,8,0xb2d292bad
15517.17,1.0,18,2,2,2,6,0xb2d14126
3552.42,1.0,11,2,2,3,7,0xb2d0f314d
498.92,1.0,1,1,2,4,7,0xb2d8f062
1250.86,1.0,208,1,2,1,4,0xb2d44b5c
3210.72,1.0,6,2,2,3,7,0xb2d3f5ce
467068.28,4.0,25,4,4,2,10,0xb2d17929
1580466.62,3.0,6,4,4,3,11,0xb2d5a61a
4053.44,1.0,42,2,2,2,6,0xb2d57708
710963.59,6.0,41,4,4,2,10,0xb2d102ce
5469.83,1.0,8,2,2,3,7,0xb2d3a188
4011.79,1.0,47,2,2,2,6,0xb2d6a4dcd
4120.13,1.0,1,2,2,4,8,0x3b9ad723
241808.69,3.0,98,3,4,1,8,0xb2d1a13d
51582.41,2.0,249,2,3,1,6,0xb2d52135
40005.92,5.0,11,2,4,3,9,0xb2d1ee88
110720.75,3.0,76,3,4,1,8,0xb2d684cad
2383046.2,8.0,1,4,4,4,12,0xb2d5ac54
13180.55,4.0,31,2,4,2,8,0xb2d1c8f3
63.18,1.0,2,1,2,4,7,0xb2d558f7
199039.88,6.0,1,3,4,4,11,0xb2d116bf
329.04,1.0,1,1,2,4,7,0xb2d6ecebd
2401.34,1.0,14,1,2,3,6,0xb2d8c5ac
210063.08,2.0,217,3,3,1,7,0xb2d2a749
24.01,1.0,19,1,2,2,5,0xb2d37c72
592.73,3.0,91,1,4,1,6,0xb2d167b5
1052.24,1.0,92,1,2,1,4,0xb2d3f85f
4041.82,1.0,92,2,2,1,5,0x3b9b366e
378.47,1.0,5,1,2,3,6,0xb2d3265c
80000.84,2.0,18,3,3,2,8,0xb2da2f0d
43454.74,1.0,171,2,2,1,5,0xb2d18ea4
8.58,1.0,17,1,2,2,5,0xb2d2161a
2113.7,1.0,104,1,2,1,4,0xb2d61559
97552.95,3.0,3,3,4,4,11,0xb2d65e45d
869.05,1.0,0,1,2,4,7,0xb2d228fe
2140064.76,8.0,74,4,4,1,9,0xb2d12591
520199.11,4.0,21,4,4,2,10,0xb2d631f2
13819.29,1.0,10,2,2,3,7,0xb2d9e69a
521408.89,3.0,5,4,4,3,11,0xb2d974b5
500000.9,5.0,1,4,4,4,12,0xb2d2b35e
205354.47,5.0,18,3,4,2,9,0xb2d50281
100007.29,2.0,26,3,3,2,8,0xb2d4cafa
1379.64,1.0,184,1,2,1,4,0xb2d1294f
17855.87,1.0,2,2,2,4,8,0xb2d2a95a
4359.6,1.0,184,2,2,1,5,0xb2d30175
14401.0,1.0,0,2,2,4,8,0xb2d6a473
13.54,3.0,7,1,4,3,8,0xb2d25510
80002.43,4.0,92,3,4,1,8,0xb2d6661dd
364.51,1.0,10,1,2,3,6,0xb2d61cfe
200720.86,2.0,27,3,3,2,8,0xb2d8fd63
3987.67,1.0,92,2,2,1,5,0xb2d37744
20709.57,2.0,0,2,3,4,9,0xb2d8a24d
4460.1,1.0,0,2,2,4,8,0xb2d34d5a
681133.06,8.0,1,4,4,4,12,0xb2d24f2a
367184.9,10.0,0,4,4,4,12,0xb2d18fa6
100011.39,2.0,0,3,3,4,10,0xb2d0d9a5
598.02,1.0,18,1,2,2,5,0xb2d1cb23
6703.77,1.0,15,2,2,3,7,0xb2d925a6
500000.0,3.0,9,4,4,3,11,0xb2d5f019
29537.86,1.0,5,2,2,3,7,0xb2d3a463
3290.45,1.0,74,2,2,1,5,0xb2d5d2b9
3397.84,1.0,17,2,2,2,6,0xb2d69531
93000.92,4.0,19,3,4,2,9,0xb2d3c766
2152.18,2.0,135,1,3,1,5,0xb2d087eb
7870.87,1.0,2,2,2,4,8,0xb2d312f9d
5003.31,1.0,71,2,2,1,5,0xb2d8de2f
50874.46,2.0,143,2,3,1,6,0xb2d62779
2625.29,1.0,10,1,2,3,6,0xb2d3b4f0
2410.51,1.0,0,1,2,4,7,0xb2d0d22d
100676.83,2.0,10,3,3,3,9,0xb2d6425e
52894.91,2.0,35,3,3,2,8,0xb2d69fc9
1666147.32,10.0,6,4,4,3,11,0xb2d5139ed
17148.64,1.0,21,2,2,2,6,0xb2d965e7
270194.21,7.0,18,3,4,2,9,0xb2d504cf
139.51,1.0,184,1,2,1,4,0xb2d2a3cfd
63.33,1.0,60,1,2,2,5,0xb2d8fd05
1791.66,1.0,140,1,2,1,4,0xb2d45eab
250065.53,4.0,133,3,4,1,8,0xb2d6a04e
4254.2,1.0,92,2,2,1,5,0xb2d232d2d
601171.41,4.0,0,4,4,4,12,0xb2d0d95b
1074.48,1.0,0,1,2,4,7,0xb2d2fbd7
5258.36,1.0,20,2,2,2,6,0xb2d43221
100008.02,6.0,4,3,4,4,11,0xb2d11f59
62.98,1.0,3,1,2,4,7,0xb2d62391d
200016.94,5.0,129,3,4,1,8,0xb2d411b1
400095.59,4.0,3,4,4,4,12,0xb2d57a23
260068.46,5.0,0,3,4,4,11,0xb2d78af1
1222985.04,12.0,1,4,4,4,12,0xb2d291dad
1827076.39,8.0,6,4,4,3,11,0xb2d1db7cd
10109.51,2.0,101,2,3,1,6,0xb2d6e47bd
3129.28,1.0,0,2,2,4,8,0xb2d242cd
135576.29,2.0,41,3,3,2,8,0xb2d53f73
13148.2,1.0,9,2,2,3,7,0xb2d586c3d
2558.05,1.0,184,1,2,1,4,0xb2d347c9
133.63,1.0,10,1,2,3,6,0xb2d56f01
3441.67,1.0,92,2,2,1,5,0xb2d3b7bfd
3.93,1.0,18,1,2,2,5,0xb2d60f15
504278.7,5.0,102,4,4,1,9,0xb2d36832
10.72,1.0,98,1,2,1,4,0xb2d5e42ed
1629000.0,12.0,0,4,4,4,12,0xb2d2e168
200005.34,1.0,6,3,2,3,8,0xb2da3391
111226.47,2.0,47,3,3,2,8,0xb2d6d895
82688.24,1.0,43,3,2,2,7,0xb2d2d904
30618.49,1.0,30,2,2,2,6,0xb2d6a209
230.54,1.0,147,1,2,1,4,0xb2d12a83
344559.22,2.0,4,4,3,4,11,0xb2d4eed9
313001.47,6.0,1,4,4,4,12,0xb2d1522c
10003.01,1.0,6,2,2,3,7,0xb2d9484a
1113665.09,8.0,0,4,4,4,12,0xb2d5e358d
479008.17,12.0,3,4,4,4,12,0xb2d226dd
1250487.53,4.0,70,4,4,1,9,0xb2d4f874
400003.88,6.0,14,4,4,3,11,0xb2d629f4
3399.92,1.0,0,2,2,4,8,0xb2d3ec0d
24.85,1.0,25,1,2,2,5,0xb2d596c8d
363.28,1.0,71,1,2,1,4,0xb2d3668c
50000.0,3.0,0,2,4,4,10,0xb2d5a187d
646553.5,1.0,4,4,2,4,10,0xb2d35e6f
2676.33,1.0,14,1,2,3,6,0xb2d27def
200753.32,2.0,8,3,3,3,9,0xb2d92d9a
536597.08,2.0,181,4,3,1,8,0xb2d37feb
7271.34,1.0,5,2,2,3,7,0xb2d5ca2d
10125.83,1.0,184,2,2,1,5,0xb2d3452a
72775.77,2.0,192,3,3,1,7,0xb2d2377c
3330.28,6.0,0,2,4,4,10,0xb2d0839d
488.98,1.0,12,1,2,3,6,0xb2d60acad
203495.14,1.0,0,3,2,4,9,0xb2d2fc03
31.67,1.0,31,1,2,2,5,0xb2d9f71b
2406.11,1.0,60,1,2,2,5,0xb2d60d2c
47.6,1.0,47,1,2,2,5,0xb2d9771cd
1492.59,1.0,92,1,2,1,4,0xb2d1c4c4d
105869.63,3.0,2,3,4,4,11,0xb2d19867
1022146.79,7.0,24,4,4,2,10,0xb2d13a61d
48.51,2.0,0,1,3,4,8,0xb2d15e3e
10771.67,1.0,1,2,2,4,8,0xb2d9cfeb
188.61,1.0,15,1,2,3,6,0xb2d967d9
151.44,1.0,74,1,2,1,4,0xb2d3fca7
640003.69,7.0,80,4,4,1,9,0xb2d4116ad
20.25,1.0,67,1,2,1,4,0xb2d63978
1222326.0,3.0,20,4,4,2,10,0xb2d29c0a
200.0,1.0,4,1,2,4,7,0xb2d19e0c
150922.92,2.0,76,3,3,1,7,0xb2d2c4b3
605010.13,3.0,80,4,4,1,9,0xb2d53473
220.66,1.0,42,1,2,2,5,0xb2d6b337
247904.69,3.0,60,3,4,2,9,0xb2d1774bd
200711.33,2.0,31,3,3,2,8,0xb2d5fd8d
380000.0,3.0,5,4,4,3,11,0xb2d28fe4d
2160.26,1.0,92,1,2,1,4,0xb2d36384d
202123.01,5.0,0,3,4,4,11,0xb2d84e62
619981.75,3.0,0,4,4,4,12,0xb2d5a180
628.31,1.0,13,1,2,3,6,0xb2d8c629
100099.48,2.0,4,3,3,4,10,0xb2d5e8ea
209006.63,2.0,249,3,3,1,7,0xb2d454c3
472341.66,2.0,42,4,3,2,9,0xb2d9b5f5
958.51,1.0,1,1,2,4,7,0xb2d5d5ef
6217607.6,2.0,80,4,3,1,8,0xb2d50296d
182.49,1.0,0,1,2,4,7,0xb2d65954d
23.7,1.0,8,1,2,3,6,0xb2d214a7
215574.34,2.0,1,3,3,4,10,0xb2da4ef8
257798.05,3.0,15,3,4,3,10,0xb2d206d0
10083.27,2.0,87,2,3,1,6,0xb2d6a30f
240332.84,4.0,95,3,4,1,8,0xb2d3a2bd
670.54,1.0,1,1,2,4,7,0xb2d91a6a
1150147.82,3.0,27,4,4,2,10,0xb2d1cbfb
730100.12,4.0,0,4,4,4,12,0xb2d10e25d
1471000.0,4.0,9,4,4,3,11,0xb2d1c11e
564488.28,3.0,0,4,4,4,12,0xb2d6a6e9
8110.86,1.0,0,2,2,4,8,0xb2d68cb1
100397.48,1.0,184,3,2,1,6,0xb2d30553
2332.59,1.0,0,1,2,4,7,0xb2d17fb6
2.79,3.0,17,1,4,2,7,0xb2d3bd62
360729.5,10.0,76,4,4,1,9,0xb2d62626d
28.47,1.0,43,1,2,2,5,0xb2d19e66d
2648.03,1.0,184,1,2,1,4,0xb2d15365
134.58,1.0,15,1,2,3,6,0xb2d4f779
40073.76,3.0,10,2,4,3,9,0xb2d57294d
38.52,1.0,13,1,2,3,6,0xb2d332e8
44.62,1.0,5,1,2,3,6,0xb2d408c6
246.84,1.0,5,1,2,3,6,0xb2d92670
4026.03,1.0,92,2,2,1,5,0xb2d3e9c0
300003.17,2.0,11,3,3,3,9,0xb2da36d0
50001.59,2.0,192,2,3,1,6,0xb2d6a0b8
50326.7,2.0,83,2,3,1,6,0xb2d151e0
202891.68,2.0,125,3,3,1,7,0xb2d56666
984881.82,4.0,83,4,4,1,9,0xb2d166c8
4156.3,1.0,0,2,2,4,8,0xb2d54fbc
156454.87,1.0,112,3,2,1,6,0xb2d442a8
39.59,1.0,49,1,2,2,5,0xb2d59936
397011.14,1.0,21,4,2,2,8,0xb2d16a85
502753.6,4.0,76,4,4,1,9,0xb2d11f37
127.03,1.0,3,1,2,4,7,0xb2d1e98c
760000.0,4.0,0,4,4,4,12,0xb2d56486d
44.33,1.0,7,1,2,3,6,0xb2d6ba29
1539.73,1.0,92,1,2,1,4,0xb2d1ba4a
1802.61,1.0,0,1,2,4,7,0xb2d6c6d9
568585.58,4.0,27,4,4,2,10,0xb2d38d60
390004.12,2.0,66,4,3,2,9,0xb2d8ef16
10047.12,2.0,0,2,3,4,9,0xb2d96d06d
4611492.61,10.0,0,4,4,4,12,0xb2d552cd
5971.06,1.0,8,2,2,3,7,0xb2d34813d
325044.15,5.0,61,4,4,2,10,0xb2d305cd
4000.0,1.0,2,2,2,4,8,0xb2d161b9d
1760102.28,3.0,25,4,4,2,10,0xb2d5818a
730.08,1.0,0,1,2,4,7,0xb2d18bf6
200008.7,3.0,27,3,4,2,9,0xb2d59cf5
2877.12,1.0,173,1,2,1,4,0xb2d24991
57181.15,2.0,27,3,3,2,8,0xb2d6839e
12115.51,1.0,253,2,2,1,5,0xb2d2dfc1
452628.46,4.0,52,4,4,2,10,0xb2d2d688
2021.53,1.0,92,1,2,1,4,0xb2d1c685d
20245.44,1.0,3,2,2,4,8,0xb2d5df9f
145534.25,3.0,56,3,4,2,9,0xb2d509db
328286.8,5.0,4,4,4,4,12,0xb2d4254e
51895.85,2.0,151,2,3,1,6,0xb2d2a7f0
1500105.76,3.0,63,4,4,2,10,0xb2d5ab67d
400000.0,1.0,3,4,2,4,10,0xb2d592e9
500065.63,2.0,5,4,3,3,10,0xb2d3679dd
625434.52,2.0,76,4,3,1,8,0xb2d46299
952.85,1.0,5,1,2,3,6,0xb2d2399d
37236.1,1.0,10,2,2,3,7,0xb2d6de5e
1934.49,1.0,217,1,2,1,4,0xb2d321c5
49463.43,1.0,30,2,2,2,6,0xb2d6facf
200000.0,2.0,12,3,3,3,9,0xb2da47bc
12091.11,1.0,92,2,2,1,5,0xb2d2f4c6
887401.94,20.0,0,4,4,4,12,0xb2d067d3
296131.27,2.0,184,3,3,1,7,0x3b9aed19d
60709.76,1.0,41,3,2,2,7,0xb2d915b6
588.04,1.0,22,1,2,2,5,0xb2d2da31
450006.71,4.0,14,4,4,3,11,0xb2d511c9d
500000.0,2.0,5,4,3,3,10,0xb2d86dcad
452092.47,8.0,25,4,4,2,10,0xb2d78e4b
1490.26,1.0,9,1,2,3,6,0xb2d5405f
61043.08,2.0,10,3,3,3,9,0xb2d6a8dc
2596.33,1.0,290,1,2,1,4,0xb2d2f06f
1878.62,1.0,1,1,2,4,7,0xb2d623dd
588137.68,4.0,102,4,4,1,9,0xb2d213a6d
100073.08,4.0,50,3,4,2,9,0xb2d4167e
12405.91,1.0,21,2,2,2,6,0xb2d7c05ed
10000.43,2.0,8,2,3,3,8,0xb2d518ab
67.43,1.0,21,1,2,2,5,0xb2d77f48
30000.32,2.0,83,2,3,1,6,0xb2d8d0fa
530018.61,2.0,110,4,3,1,8,0xb2d4e3c4
1893.86,1.0,92,1,2,1,4,0xb2d17401d
1501810.49,5.0,6,4,4,3,11,0xb2d9522cd
4378.0,1.0,253,2,2,1,5,0xb2d502b1
302228.52,2.0,36,4,3,2,9,0xb2d06b42
500.54,1.0,5,1,2,3,6,0xb2d59b51
4583.56,1.0,8,2,2,3,7,0xb2d786a1
2200.98,1.0,1,1,2,4,7,0xb2d952e8
1140.4,1.0,10,1,2,3,6,0xb2d5e5c4
21925.28,1.0,184,2,2,1,5,0xb2d61d1f
15187.06,1.0,2,2,2,4,8,0xb2d4ec47
1165035.41,3.0,154,4,4,1,9,0xb2d6ff97
1256.16,1.0,10,1,2,3,6,0xb2d42ffa
22.64,1.0,9,1,2,3,6,0xb2d329f3
25.4,1.0,88,1,2,1,4,0xb2d51b3ad
13.11,1.0,25,1,2,2,5,0xb2d60d93
601269.7,1.0,1,4,2,4,10,0xb2d2a5d0
7906.16,1.0,0,2,2,4,8,0xb2d6d35b
472.41,1.0,24,1,2,2,5,0xb2d6d9bfd
25155.49,1.0,0,2,2,4,8,0xb2d3ad47
6894.58,1.0,18,2,2,2,6,0xb2d7180dd
108958065.84,9.0,0,4,4,4,12,0xb2d65892
3186904.53,5.0,0,4,4,4,12,0xb2d2c1b3
0.44,2.0,11,1,3,3,7,0xb2d078ca
1651.92,1.0,92,1,2,1,4,0x3b9b302c
126610.42,3.0,18,3,4,2,9,0xb2d333d4
13167.97,2.0,4,2,3,4,9,0xb2d9496bd
1778497.02,9.0,3,4,4,4,12,0xb2d2b03b
9315.09,1.0,14,2,2,3,7,0xb2d34382
9928.25,1.0,156,2,2,1,5,0xb2d2cbd0
5003.43,1.0,74,2,2,1,5,0xb2d8e56f
110035.88,7.0,18,3,4,2,9,0xb2d5e47c
100064.15,2.0,15,3,3,3,9,0xb2d448d7
918.48,1.0,22,1,2,2,5,0xb2d3c58d
298075.81,4.0,4,3,4,4,11,0xb2d12169d
223979.89,2.0,88,3,3,1,7,0xb2d2e9ebd
1117.96,1.0,92,1,2,1,4,0xb2d3e93f
585099.15,4.0,18,4,4,2,10,0xb2d7784a
15098.37,2.0,5,2,3,3,8,0xb2d2a43b
13.27,1.0,38,1,2,2,5,0xb2d23c50
15409.69,1.0,21,2,2,2,6,0xb2d965f8
200080.83,2.0,0,3,3,4,10,0xb2d3f600
220865.92,2.0,4,3,3,4,10,0xb2d57fced
100878.16,1.0,0,3,2,4,9,0xb2d3187d
1270085.85,2.0,1,4,3,4,11,0xb2d5df8c
50820.93,3.0,4,2,4,4,10,0xb2d0b396
14397.77,1.0,0,2,2,4,8,0xb2d4f76ed
71024.95,3.0,49,3,4,2,9,0xb2d6284fd
34665.78,6.0,14,2,4,3,9,0xb2d1277a
443.94,1.0,4,1,2,4,7,0xb2d27254
110016.43,2.0,157,3,3,1,7,0xb2d301b7
143701.8,4.0,0,3,4,4,11,0xb2d8da1f
77533.82,3.0,87,3,4,1,8,0xb2d5be75
11699.84,1.0,0,2,2,4,8,0xb2d22f11d
17253.2,1.0,5,2,2,3,7,0xb2d2b5b7
6.24,1.0,66,1,2,2,5,0xb2d609bf
50.45,1.0,9,1,2,3,6,0xb2d8f2dc
100023.98,2.0,1,3,3,4,10,0xb2d9f6ab
0.0,3.0,9,1,4,3,8,0xb2d957d9
850905.27,15.0,18,4,4,2,10,0xb2d0bc9c
1382.02,1.0,153,1,2,1,4,0xb2d32a45
1010.99,1.0,184,1,2,1,4,0xb2d235ec
480095.21,4.0,87,4,4,1,9,0xb2d59efb
90020.57,2.0,60,3,3,2,8,0xb2d1bad8d
3359.78,1.0,8,2,2,3,7,0xb2d527bd
1619.13,1.0,10,1,2,3,6,0xb2d2786e
473544.96,1.0,12,4,2,3,9,0xb2d30a22
12497.65,1.0,3,2,2,4,8,0xb2d2b4d5
78.37,1.0,0,1,2,4,7,0xb2d2d684
520022.8,6.0,28,4,4,2,10,0xb2d670de
102.39,1.0,62,1,2,2,5,0xb2d4b72e
304268.99,2.0,17,4,3,2,9,0xb2d63998d
100099.08,2.0,12,3,3,3,9,0xb2d9e2f3
1130000.0,3.0,17,4,4,2,10,0xb2d950a0
105.66,1.0,166,1,2,1,4,0xb2d6826f
352001.23,3.0,94,4,4,1,9,0xb2d2914a
2036514.04,2.0,223,4,3,1,8,0xb2d5e843
140223.95,2.0,118,3,3,1,7,0xb2d08af8
4488.11,1.0,0,2,2,4,8,0xb2d1a199d
15.12,2.0,64,1,3,2,6,0xb2d07dac
11.82,1.0,11,1,2,3,6,0xb2d98729
83570.77,2.0,45,3,3,2,8,0xb2d58a38
151218.59,2.0,108,3,3,1,7,0xb2d439cb
10033.07,1.0,92,2,2,1,5,0xb2d5e4d4
1000070.75,7.0,0,4,4,4,12,0xb2d6a368
76687.32,105.0,0,3,4,4,11,0x3b9b17f9
202136.88,2.0,105,3,3,1,7,0xb2d3fa02
3123.16,1.0,3,2,2,4,8,0xb2d916f7
80001.79,4.0,52,3,4,2,9,0xb2d8ec9e
60105.62,2.0,189,3,3,1,7,0xb2d3e979
74.84,1.0,0,1,2,4,7,0xb2d5303e
641012.26,7.0,0,4,4,4,12,0xb2d39c43
19263.08,1.0,4,2,2,4,8,0xb2d20ccd
320016.99,6.0,17,4,4,2,10,0xb2d58447d
714757.58,14.0,15,4,4,3,11,0xb2d294f3d
1202.47,1.0,188,1,2,1,4,0xb2d22324
1423.36,1.0,3,1,2,4,7,0xb2d2a2c0
10526.36,1.0,0,2,2,4,8,0xb2d6931b
300000.0,4.0,0,3,4,4,11,0xb2d3aa2e
677.96,1.0,0,1,2,4,7,0xb2d2bc61
118601.12,5.0,0,3,4,4,11,0xb2d167b0
50421.16,1.0,92,2,2,1,5,0xb2d1d00dd
1153.34,2.0,92,1,3,1,5,0x3b9b157c
10009.73,2.0,200,2,3,1,6,0xb2d68d11d
15153.68,1.0,143,2,2,1,5,0xb2d3d626
751977.23,1.0,0,4,2,4,10,0xb2d2f297
100006.39,2.0,122,3,3,1,7,0xb2d1dc90
2355.01,1.0,92,1,2,1,4,0xb2d1fa56
614165.19,10.0,23,4,4,2,10,0xb2d5c52d
276631.22,4.0,28,3,4,2,9,0xb2d58475
1051002.94,15.0,24,4,4,2,10,0x3b9b3fa9
558843.98,6.0,1,4,4,4,12,0xb2d11e4bd
1116.83,1.0,92,1,2,1,4,0xb2d25152
1300.15,1.0,10,1,2,3,6,0xb2d68788
3000000.99,2.0,9,4,3,3,10,0xb2d6ba0b
2613.39,1.0,4,1,2,4,7,0xb2d5fd3a
56.86,1.0,6,1,2,3,6,0xb2d638f8
1262.71,1.0,12,1,2,3,6,0xb2d24920
613.54,1.0,0,1,2,4,7,0xb2d3159f
932039.54,6.0,3,4,4,4,12,0xb2d3bf3f
200620.63,2.0,0,3,3,4,10,0xb2d38279d
1954.98,2.0,184,1,3,1,5,0xb2d3937ed
50821.74,2.0,122,2,3,1,6,0xb2d6474a
200010.0,2.0,6,3,3,3,9,0xb2d96e7cd
140034.67,4.0,14,3,4,3,10,0xb2d60406
316520.84,2.0,27,4,3,2,9,0xb2d08261
162006.57,3.0,41,3,4,2,9,0xb2d60b78
634.96,1.0,1,1,2,4,7,0xb2d96180
8409.44,1.0,3,2,2,4,8,0xb2d27d3e
5762.07,2.0,184,2,3,1,6,0xb2d18f3ad
1086.91,1.0,0,1,2,4,7,0xb2d9fa02
700032.53,2.0,7,4,3,3,10,0xb2d8ec9fd
214.51,1.0,9,1,2,3,6,0xb2d3a495
789.51,1.0,15,1,2,3,6,0xb2d9069e
300059.32,3.0,20,3,4,2,9,0xb2d5d1f5
29895.6,1.0,0,2,2,4,8,0xb2d36e59
8404.36,1.0,1,2,2,4,8,0xb2d303ddd
110100.0,2.0,0,3,3,4,10,0xb2d611a5
2391.31,1.0,29,1,2,2,5,0xb2d92399
600022.17,3.0,53,4,4,2,10,0xb2d9373c
2450.74,1.0,184,1,2,1,4,0xb2d42701
252.81,1.0,34,1,2,2,5,0xb2d8d213
200028.52,3.0,20,3,4,2,9,0xb2d6dc1d
5159.72,1.0,0,2,2,4,8,0xb2d8790a
426722.54,2.0,25,4,3,2,9,0xb2d65915d
308.88,1.0,4,1,2,4,7,0xb2d6b6a5
326953.51,7.0,34,4,4,2,10,0xb2d1086cd
11523.11,1.0,21,2,2,2,6,0xb2d609f7
1411.08,1.0,184,1,2,1,4,0xb2d0fc44
100393.21,8.0,1,3,4,4,11,0xb2d58529d
5719.4,1.0,0,2,2,4,8,0xb2d210ad
70038.17,3.0,165,3,4,1,8,0xb2d26f8a
2500027.39,2.0,59,4,3,2,9,0xb2d8fe52
8879.69,1.0,0,2,2,4,8,0xb2d3c7edd
94016.79,4.0,4,3,4,4,11,0xb2d5d1a1
109218.34,4.0,224,3,4,1,8,0x3b9b259e
24556.39,1.0,20,2,2,2,6,0xb2d2a2c6
83000.0,2.0,3,3,3,4,10,0xb2d53823
102970.4,2.0,35,3,3,2,8,0xb2d685aad
20944.18,1.0,24,2,2,2,6,0xb2d1b573
82.82,1.0,3,1,2,4,7,0xb2d9658e
42009.19,2.0,6,2,3,3,8,0xb2d19f7a
9701.46,1.0,5,2,2,3,7,0xb2d19312
11001.9,1.0,0,2,2,4,8,0xb2d84546
65.87,1.0,8,1,2,3,6,0xb2d6a9d2
47297.34,1.0,0,2,2,4,8,0xb2d3319dd
314784.31,2.0,3,4,3,4,11,0xb2d53d48
4541.01,1.0,92,2,2,1,5,0xb2d37d37
250748.2,3.0,18,3,4,2,9,0xb2d5dfa2
2551072.33,10.0,4,4,4,4,12,0xb2d5f4f5
228416.32,4.0,21,3,4,2,9,0xb2d4e979
50000.0,1.0,0,2,2,4,8,0xb2d93bca
1534.91,1.0,92,1,2,1,4,0xb2d3b9e5
8480.03,1.0,50,2,2,2,6,0xb2d5d152
320427.34,2.0,4,4,3,4,11,0xb2d6a9c8
19828.32,1.0,1,2,2,4,8,0xb2d3b6f4
200000.0,2.0,0,3,3,4,10,0xb2d2b345d
545483.56,2.0,6,4,3,3,10,0xb2d57711
146.33,1.0,39,1,2,2,5,0xb2d432a9d
4246.06,1.0,0,2,2,4,8,0xb2d6d3b2
5656.8,1.0,0,2,2,4,8,0xb2d27711
306399.91,6.0,3,4,4,4,12,0xb2d7fd08
17501.52,2.0,158,2,3,1,6,0xb2d194e5
651809.61,4.0,70,4,4,1,9,0xb2d636c5d
100054.4,3.0,66,3,4,2,9,0xb2d45e30
100001.06,2.0,8,3,3,3,9,0xb2da4c4f
229697.31,4.0,52,3,4,2,9,0xb2d173db
190.85,1.0,9,1,2,3,6,0xb2d78b70d
626.91,1.0,74,1,2,1,4,0xb2d2ebe9
140224.17,2.0,210,3,3,1,7,0xb2d08af8d
10009.61,2.0,4,2,3,4,9,0xb2d8f82c
2836.84,1.0,184,1,2,1,4,0xb2d3161ed
2316445.93,14.0,1,4,4,4,12,0xb2d1286c
1363.86,1.0,21,1,2,2,5,0xb2d77774d
1017.31,1.0,184,1,2,1,4,0xb2d0c1ced
169892.51,2.0,11,3,3,3,9,0xb2d6c578
50790.63,3.0,168,2,4,1,7,0xb2d5ac15
340000.0,2.0,16,4,3,2,9,0xb2d8dc5a
3914.89,2.0,0,2,3,4,9,0xb2d070d1
50029.72,3.0,55,2,4,2,8,0xb2d2d56ad
150011.84,3.0,47,3,4,2,9,0xb2d45344
401566.43,3.0,33,4,4,2,10,0xb2d63dea
20.08,1.0,0,1,2,4,7,0xb2d94e95
200006.45,3.0,9,3,4,3,10,0xb2d67eec
100013.45,2.0,123,3,3,1,7,0xb2d46ac8
665214.58,4.0,101,4,4,1,9,0x3b9b467ad
49086.41,1.0,1,2,2,4,8,0xb2d54c49
396038.94,1.0,2,4,2,4,10,0xb2d4d24c
60016.65,2.0,13,3,3,3,9,0xb2d0cde2
150004.22,4.0,0,3,4,4,11,0xb2d90f4f
6199.56,1.0,0,2,2,4,8,0xb2d5881c
1400033.51,7.0,0,4,4,4,12,0xb2d1d4f4
0.0,1.0,0,1,2,4,7,0xb2da6568
1475.84,1.0,83,1,2,1,4,0xb2d339d1
1276388.27,7.0,1,4,4,4,12,0xb2d08584
150005.61,3.0,5,3,4,3,10,0xb2d58c53
428131.08,5.0,0,4,4,4,12,0xb2d06a11
1001195.84,2.0,13,4,3,3,10,0xb2d6a65f
55025.88,1.0,1,3,2,4,9,0xb2d5f1cf
88.28,1.0,7,1,2,3,6,0xb2d78927
138.83,1.0,15,1,2,3,6,0xb2d27bed
100006.34,2.0,105,3,3,1,7,0xb2d958e6d
16866.84,1.0,103,2,2,1,5,0xb2d13651
200167.18,2.0,10,3,3,3,9,0xb2d5d3e1
101307.51,3.0,31,3,4,2,9,0xb2d1bcbbd
76.93,1.0,71,1,2,1,4,0xb2d11c06d
507107.94,2.0,137,4,3,1,8,0xb2d91f32
10538790.94,11.0,0,4,4,4,12,0xb2d67f78
448.8,1.0,1,1,2,4,7,0xb2d6187e
860113.81,3.0,15,4,4,3,11,0xb2d6c3aa
4151.19,2.0,92,2,3,1,6,0xb2d08244d
1363.72,1.0,18,1,2,2,5,0xb2d27a84d
60025.42,2.0,56,3,3,2,8,0xb2d25fe5
5765.58,1.0,92,2,2,1,5,0xb2d20848
2039.4,1.0,14,1,2,3,6,0xb2d62802
20007.43,2.0,212,2,3,1,6,0xb2d6f22b
84.55,1.0,58,1,2,2,5,0xb2d28066
140.11,1.0,0,1,2,4,7,0xb2d7820d
0.0,1.0,3,1,2,4,7,0xb2d3a66e
17816.88,1.0,6,2,2,3,7,0xb2d91a05
341235.67,4.0,28,4,4,2,10,0xb2d60383
61215.02,1.0,0,3,2,4,9,0xb2d36934
100098.14,2.0,154,3,3,1,7,0xb2d10787
7480.55,1.0,10,2,2,3,7,0xb2d3e2c1
208000.0,6.0,5,3,4,3,10,0xb2d55a78
110.6,1.0,11,1,2,3,6,0xb2d35946
1538785.23,6.0,0,4,4,4,12,0xb2d11fc8
225.46,1.0,9,1,2,3,6,0xb2d4665b
3341.17,1.0,40,2,2,2,6,0xb2d38de3
1764954.66,3.0,0,4,4,4,12,0xb2d17896
153025.64,3.0,0,3,4,4,11,0xb2d20d57d
37005.37,4.0,110,2,4,1,7,0xb2d68963d
112246.09,5.0,7,3,4,3,10,0xb2d59924
360123.71,3.0,151,4,4,1,9,0xb2d28990
500014.06,2.0,19,4,3,2,9,0xb2d9d371
60098.13,3.0,83,3,4,1,8,0xb2d6211bd
450000.0,6.0,4,4,4,4,12,0xb2d7ada6
150001.58,2.0,73,3,3,1,7,0xb2d8e512d
30.72,1.0,5,1,2,3,6,0xb2d94370
35547.72,1.0,1,2,2,4,8,0xb2d380b8
22.44,1.0,24,1,2,2,5,0xb2d2503c
151747.7,2.0,28,3,3,2,8,0xb2d92332
1540.97,1.0,7,1,2,3,6,0xb2d226ea
70086.57,1.0,17,3,2,2,7,0xb2d2c96a
316050.44,4.0,168,4,4,1,9,0xb2d22aab
27661.5,2.0,0,2,3,4,9,0xb2d48e9f
2498.02,1.0,9,1,2,3,6,0xb2d8b19b
182195.31,4.0,47,3,4,2,9,0xb2d651f9
21654.73,1.0,1,2,2,4,8,0xb2d63c88
6183.56,1.0,24,2,2,2,6,0xb2d30486
76.05,4.0,6,1,4,3,8,0xb2d69a6c
3674.62,1.0,21,2,2,2,6,0xb2d4d0a0d
80002.53,2.0,74,3,3,1,7,0xb2d998f5
161732.32,2.0,76,3,3,1,7,0xb2d50dad
18016.23,1.0,0,2,2,4,8,0xb2d60914
150050.5,2.0,78,3,3,1,7,0xb2d368b9
81523.29,4.0,10,3,4,3,10,0xb2d2b55e
10068.15,1.0,3,2,2,4,8,0xb2d43bb2
4425.11,1.0,0,2,2,4,8,0xb2d5a2b6
695182.99,3.0,14,4,4,3,11,0xb2d0dc46
211.78,1.0,11,1,2,3,6,0xb2d2c5f9
1194.93,1.0,92,1,2,1,4,0xb2d1b976
30.21,1.0,54,1,2,2,5,0xb2d70970
0.22,1.0,18,1,2,2,5,0xb2d698d1
28.92,1.0,10,1,2,3,6,0xb2d95af6
17879.48,1.0,4,2,2,4,8,0xb2d08524
20328.27,2.0,122,2,3,1,6,0xb2d6495ad
1.28,1.0,74,1,2,1,4,0xb2d5c4bb
65001.03,4.0,48,3,4,2,9,0xb2d56d09
150043.09,2.0,111,3,3,1,7,0xb2d30366
1123553.22,3.0,174,4,4,1,9,0xb2d0788cd
321406.56,7.0,221,4,4,1,9,0xb2d623ed
850000.53,5.0,5,4,4,3,11,0xb2da4240
220000.0,2.0,15,3,3,3,9,0xb2da3853
255075.82,7.0,4,3,4,4,11,0xb2d43692
10100.08,1.0,2,2,2,4,8,0xb2d8d410
3900.77,1.0,0,2,2,4,8,0xb2d5834dd
351022.8,1.0,250,4,2,1,7,0xb2d604c9
300000.0,2.0,7,3,3,3,9,0xb2da4ea7
500000.0,2.0,18,4,3,2,9,0xb2d8d9af
1177221.76,5.0,11,4,4,3,11,0xb2d0b623d
2674.06,1.0,131,1,2,1,4,0xb2d1239a
2610798.67,15.0,5,4,4,3,11,0xb2d2d317
322028.03,8.0,18,4,4,2,10,0xb2d0fc39
235685.66,2.0,5,3,3,3,9,0xb2d06ccbd
0.0,16.0,1,1,4,4,9,0xb2d6e166d
160.12,1.0,0,1,2,4,7,0xb2d16520
17.74,1.0,77,1,2,1,4,0xb2d2fa15
153060.21,3.0,97,3,4,1,8,0xb2d61b48
177451.14,3.0,6,3,4,3,10,0xb2d2173b
100001.11,2.0,49,3,3,2,8,0xb2d9d885
19975.07,1.0,29,2,2,2,6,0xb2d6cb04
8.04,1.0,6,1,2,3,6,0xb2d6fc35
8.66,1.0,12,1,2,3,6,0xb2d91c68
12519.27,1.0,92,2,2,1,5,0xb2d2592c
1907707.27,12.0,6,4,4,3,11,0xb2d16d03
5500068.33,4.0,21,4,4,2,10,0xb2d1aca4d
1124000.0,5.0,6,4,4,3,11,0xb2d235f5
90002.64,2.0,74,3,3,1,7,0xb2d99953
242.01,1.0,0,1,2,4,7,0xb2d4634cd
1011.37,1.0,92,1,2,1,4,0xb2d1c417
882475.17,7.0,6,4,4,3,11,0xb2d5876f
69.75,1.0,12,1,2,3,6,0xb2d19ff5
35.36,1.0,65,1,2,2,5,0xb2d95bfc
670023.01,6.0,4,4,4,4,12,0xb2d26c19
3058.32,1.0,15,2,2,3,7,0xb2d37be6
50001.06,2.0,6,2,3,3,8,0xb2d967a8d
1000000.0,2.0,5,4,3,3,10,0xb2da5ad8
56043.36,1.0,1,3,2,4,9,0xb2d0dcc7
707137.4,4.0,0,4,4,4,12,0xb2d90ea9d
1060.09,1.0,1,1,2,4,7,0xb2d23fcc
117.1,1.0,10,1,2,3,6,0xb2d2f45ad
1.02,1.0,67,1,2,1,4,0xb2d82383
313800.88,4.0,18,4,4,2,10,0xb2d4ebcb
0.0,1.0,4,1,2,4,7,0xb2d84546d
9407.34,1.0,0,2,2,4,8,0xb2d55409
20000.76,2.0,80,2,3,1,6,0xb2d6b2bad
1750042.34,16.0,39,4,4,2,10,0xb2d54fc3
170007.22,4.0,42,3,4,2,9,0xb2d61383
868964.22,1.0,232,4,2,1,7,0xb2d6eeeb
401430.31,5.0,0,4,4,4,12,0xb2d20c6fd
29260.2,2.0,36,2,3,2,7,0xb2d1bf74
200000.0,2.0,29,3,3,2,8,0xb2da0bd0
34275.4,3.0,0,2,4,4,10,0xb2d52c6a
416115.48,4.0,12,4,4,3,11,0xb2d67390d
150006.79,2.0,83,3,3,1,7,0xb2d944f1
521050.52,4.0,13,4,4,3,11,0xb2d1b03a
4850.76,1.0,42,2,2,2,6,0xb2d3b329d
26297.18,1.0,1,2,2,4,8,0xb2d32113
279904.52,1.0,3,3,2,4,9,0xb2d17003
1924.3,1.0,92,1,2,1,4,0xb2d47083
3.24,1.0,61,1,2,2,5,0xb2d2982e
400029.56,2.0,11,4,3,3,10,0xb2d95ade
268164.96,1.0,12,3,2,3,8,0xb2d3a82d
100183.77,3.0,4,3,4,4,11,0xb2d2678ad
481479.24,4.0,11,4,4,3,11,0xb2d77f0e
433010.75,3.0,21,4,4,2,10,0xb2d433f5
4579.57,4.0,184,2,4,1,7,0x3b9b37ea
500000.0,2.0,0,4,3,4,11,0xb2d8fa6a
51826.11,1.0,0,2,2,4,8,0xb2d3aa3b
0.53,1.0,104,1,2,1,4,0xb2d957e2
8504.44,1.0,0,2,2,4,8,0xb2d65c0f
9607.1,1.0,79,2,2,1,5,0xb2d6bd4bd
29.04,2.0,48,1,3,2,6,0xb2d2f029
539480.55,7.0,0,4,4,4,12,0x3b9b33e1
529356.62,5.0,3,4,4,4,12,0xb2d142ddd
280000.89,3.0,4,3,4,4,11,0xb2d68297
2649.61,1.0,184,1,2,1,4,0xb2d1a5b9
2099.0,1.0,218,1,2,1,4,0xb2d70411
500014.32,4.0,66,4,4,2,10,0xb2d49297d
3014.26,1.0,182,2,2,1,5,0xb2d28297
300000.0,2.0,0,3,3,4,10,0xb2d9841c
266547.89,4.0,1,3,4,4,11,0xb2d5aca8d
170507.81,2.0,1,3,3,4,10,0xb2d955fa
24014.68,2.0,154,2,3,1,6,0xb2d47ca4
22387.43,1.0,14,2,2,3,7,0xb2d25a73
20000.21,2.0,70,2,3,1,6,0xb2d9a602
1184647.64,7.0,11,4,4,3,11,0xb2d62a18d
9.7,1.0,9,1,2,3,6,0xb2d3c74cd
6342.96,1.0,7,2,2,3,7,0xb2d3aabb
958.31,1.0,4,1,2,4,7,0xb2d24175
216.04,1.0,2,1,2,4,7,0xb2d43e09
330131.24,4.0,63,4,4,2,10,0xb2d251bb
322394.97,6.0,8,4,4,3,11,0xb2d06477
51945.58,1.0,0,2,2,4,8,0xb2d8c9a7
297320.71,3.0,53,3,4,2,9,0xb2d456fa
210727.1,2.0,0,3,3,4,10,0xb2d2787d
61.92,1.0,4,1,2,4,7,0xb2d3be9f
40000.0,2.0,0,2,3,4,9,0xb2d934a5
53966.65,1.0,217,3,2,1,6,0xb2d3414d
101898.02,2.0,92,3,3,1,7,0xb2d4d1f1
400000.51,6.0,6,4,4,3,11,0xb2d18237d
200218.32,1.0,0,3,2,4,9,0xb2d5a24cd
506863.32,4.0,13,4,4,3,11,0xb2d27ef1
24.62,1.0,61,1,2,2,5,0xb2d548c3
239596.71,2.0,41,3,3,2,8,0xb2d0a0ba
60614.41,1.0,94,3,2,1,6,0xb2d1a7bf
1127343.62,6.0,0,4,4,4,12,0xb2d51ed6
261000.82,2.0,5,3,3,3,9,0xb2d0c931d
2684.36,5.0,116,1,4,1,6,0x3b9ada0a
1.44,1.0,13,1,2,3,6,0xb2d11605
27378.81,2.0,0,2,3,4,9,0xb2d21248
5570.12,1.0,18,2,2,2,6,0xb2d97a1f
1357.79,1.0,12,1,2,3,6,0xb2d32dc2
160702.4,1.0,102,3,2,1,6,0xb2d415eb
22398.57,1.0,10,2,2,3,7,0xb2d31421
4518.06,1.0,7,2,2,3,7,0xb2d6b5bb
10000.32,2.0,80,2,3,1,6,0xb2d98a4c
150034.1,3.0,3,3,4,4,11,0xb2d2d22e
208368.45,2.0,82,3,3,1,7,0xb2d2286d
500000.0,2.0,7,4,3,3,10,0xb2da518f
100001.13,2.0,157,3,3,1,7,0xb2d1767b
143394.23,1.0,0,3,2,4,9,0xb2d20eec
102462.05,3.0,3,3,4,4,11,0xb2d4254ed
334.06,1.0,87,1,2,1,4,0xb2d63ca2
85783.66,1.0,6,3,2,3,8,0xb2d93c4f
100055.36,2.0,0,3,3,4,10,0xb2d26ff6d
10113.04,2.0,41,2,3,2,7,0xb2d90038
180001.9,2.0,228,3,3,1,7,0xb2d18a7e
5521.68,1.0,6,2,2,3,7,0xb2d472bc
354.93,1.0,8,1,2,3,6,0xb2d24b21
23701.44,1.0,18,2,2,2,6,0xb2d2fc8c
1050.98,1.0,15,1,2,3,6,0xb2d5d14f
10217.12,2.0,18,2,3,2,7,0xb2d55e72d
5.34,1.0,47,1,2,2,5,0xb2d273c4
100005.29,2.0,111,3,3,1,7,0xb2d94debd
4646.14,1.0,35,2,2,2,6,0xb2d401fb
300053.53,3.0,20,3,4,2,9,0xb2d23b0b
596764.37,4.0,10,4,4,3,11,0xb2d10e03
317712.82,3.0,83,4,4,1,9,0xb2d1965c
100032.31,1.0,0,3,2,4,9,0xb2d63437
2222.96,1.0,0,1,2,4,7,0xb2d912e0
220000.0,1.0,3,3,2,4,9,0xb2d47bced
130510.17,1.0,184,3,2,1,6,0xb2d61526d
200010.59,3.0,21,3,4,2,9,0xb2d67cee
140067.21,4.0,4,3,4,4,11,0xb2d5e0dad
2797.75,1.0,92,1,2,1,4,0x3b9b1b9c
67138.77,1.0,0,3,2,4,9,0xb2d2f908
340012.78,6.0,26,4,4,2,10,0xb2d758b2
400000.0,2.0,1,4,3,4,11,0xb2d9fa28
21175.65,1.0,184,2,2,1,5,0xb2d358a7
183.59,1.0,10,1,2,3,6,0xb2d26f96
8309.7,2.0,4,2,3,4,9,0xb2d10e24
105.82,1.0,78,1,2,1,4,0xb2d645ea
790076.29,5.0,4,4,4,4,12,0xb2d1a604
200000.0,2.0,0,3,3,4,10,0xb2d97d34d
735278.87,7.0,0,4,4,4,12,0x3b9af237d
7083.0,1.0,74,2,2,1,5,0xb2d3c28a
515022.45,5.0,3,4,4,4,12,0xb2d8f8f9
559710.11,5.0,11,4,4,3,11,0xb2d0d7f0
370138.32,44.0,0,4,4,4,12,0xb2d4a6b1
1296.18,1.0,0,1,2,4,7,0xb2d22b01
6.02,1.0,38,1,2,2,5,0xb2d95ebb
650006.28,11.0,0,4,4,4,12,0xb2d5e081d
180512.89,2.0,66,3,3,2,8,0xb2d4959cd
5424.99,1.0,92,2,2,1,5,0xb2d2c4bd
720000.44,3.0,4,4,4,4,12,0xb2d4c042
60016.17,2.0,48,3,3,2,8,0xb2d48ba2d
6512031.08,7.0,3,4,4,4,12,0x3b9adeea
1645.93,2.0,184,1,3,1,5,0xb2d3fb07
298.29,1.0,57,1,2,2,5,0xb2d6ad9c
71512.8,3.0,62,3,4,2,9,0xb2d656c2d
1535090.37,10.0,0,4,4,4,12,0xb2d4bd44
101531.26,3.0,0,3,4,4,11,0x3b9b3d16
1445042.16,6.0,83,4,4,1,9,0xb2d189e3
451133.14,3.0,104,4,4,1,9,0xb2d5cbe0d
204580.5,3.0,74,3,4,1,8,0xb2d2134ed
200034.68,2.0,18,3,3,2,8,0xb2d695d1
13387.15,1.0,141,2,2,1,5,0xb2d37c50d
140253.96,2.0,59,3,3,2,8,0xb2d5b01ed
51971.33,1.0,118,2,2,1,5,0xb2d6197fd
1213.01,1.0,128,1,2,1,4,0xb2d6a710d
1014.28,1.0,0,1,2,4,7,0xb2d8814d
2322735.72,8.0,25,4,4,2,10,0xb2d5bccb
8974.77,1.0,0,2,2,4,8,0xb2d2fe89d
25306.66,1.0,14,2,2,3,7,0xb2d5c23a
2.23,1.0,9,1,2,3,6,0xb2d6813bd
800016.89,4.0,25,4,4,2,10,0xb2d9be0f
3497.44,1.0,33,2,2,2,6,0xb2d2be69
4.95,1.0,4,1,2,4,7,0xb2d16f74d
200052.07,4.0,6,3,4,3,10,0xb2d52ed9d
60049.41,2.0,92,3,3,1,7,0xb2d61ca3
300599.48,2.0,4,4,3,4,11,0xb2da20d2
6.9,1.0,10,1,2,3,6,0xb2d66a34
51.64,1.0,2,1,2,4,7,0xb2d83c8b
356346.87,4.0,8,4,4,3,11,0xb2d6246fd
650000.98,8.0,0,4,4,4,12,0xb2d60e29
30567.95,2.0,4,2,3,4,9,0xb2d94591
200001.06,2.0,21,3,3,2,8,0xb2d907c6d
36914.74,2.0,0,2,3,4,9,0xb2d97fea
50478.52,2.0,49,2,3,2,7,0xb2d673b7
140003.81,3.0,49,3,4,2,9,0xb2d99c31
138.68,1.0,6,1,2,3,6,0xb2d32010
1018.57,1.0,92,1,2,1,4,0xb2d0d899
110005.81,2.0,90,3,3,1,7,0xb2d88ad3d
241.95,1.0,1,1,2,4,7,0xb2d9671d
511.53,1.0,1,1,2,4,7,0xb2d3c142
500000.54,2.0,14,4,3,3,10,0xb2d36cdd
335012.35,8.0,34,4,4,2,10,0xb2d5daaad
150001.58,2.0,139,3,3,1,7,0xb2d916c8
17142.12,1.0,184,2,2,1,5,0xb2d184abd
2602.78,1.0,10,1,2,3,6,0xb2d68924
500209.02,2.0,10,4,3,3,10,0xb2d9d629
21890.79,1.0,0,2,2,4,8,0xb2d2addf
1337.03,1.0,154,1,2,1,4,0xb2d6582f
5688.01,1.0,18,2,2,2,6,0xb2d512e2d
5.25,1.0,157,1,2,1,4,0xb2d304c4
1238.0,1.0,140,1,2,1,4,0xb2d5a783
30231.56,1.0,4,2,2,4,8,0xb2d2a8ca
393.16,1.0,10,1,2,3,6,0xb2d294b5
266687.25,5.0,0,3,4,4,11,0xb2d515cd
13149.82,1.0,184,2,2,1,5,0xb2d0f4f1d
7933.61,1.0,24,2,2,2,6,0xb2d17d5ed
192171.41,2.0,27,3,3,2,8,0xb2d1b8d2
240782.09,3.0,18,3,4,2,9,0xb2da05fc
2818037.44,35.0,0,4,4,4,12,0xb2d06f76
160048.79,6.0,11,3,4,3,10,0xb2d57620
76610.42,2.0,2,3,3,4,10,0xb2d58475d
32.44,1.0,1,1,2,4,7,0xb2d60a86
301264.17,2.0,1,4,3,4,11,0xb2d69ecc
113.05,1.0,36,1,2,2,5,0xb2d2ae8c
690122.05,4.0,7,4,4,3,11,0xb2d2303ed
528113.55,4.0,25,4,4,2,10,0xb2d1b03ad
1931.2,1.0,1,1,2,4,7,0xb2d422d0
42730.81,2.0,18,2,3,2,7,0xb2d28d58
80000.0,2.0,0,3,3,4,10,0xb2d97fc2
5079.09,1.0,0,2,2,4,8,0xb2d6b3a9
1034.44,1.0,26,1,2,2,5,0xb2d41b7e
78.79,1.0,9,1,2,3,6,0xb2d4e70a
5538.35,1.0,0,2,2,4,8,0xb2d2d28d
150039.96,7.0,3,3,4,4,11,0xb2d1ced7
121217.46,6.0,74,3,4,1,8,0xb2d42d57d
2953.91,1.0,1,2,2,4,8,0xb2d61e12
16070.68,2.0,1,2,3,4,9,0xb2d24de2
7742.69,1.0,16,2,2,2,6,0xb2d62a88
234565.71,4.0,92,3,4,1,8,0xb2d50f16d
184210.99,4.0,0,3,4,4,11,0x3b9b3ae2
420175.91,3.0,62,4,4,2,10,0xb2d42769d
11023.87,1.0,0,2,2,4,8,0xb2d6efadd
56152.8,2.0,217,3,3,1,7,0xb2d51bbb
3407.16,1.0,184,2,2,1,5,0x3b9b24d7d
915622.99,11.0,7,4,4,3,11,0xb2d50d34
11308.04,1.0,92,2,2,1,5,0xb2d35061
50003.41,2.0,192,2,3,1,6,0xb2d69d91
340002.4,4.0,12,4,4,3,11,0xb2d6f16cd
289000.25,3.0,18,3,4,2,9,0xb2d3961c
20842.5,1.0,184,2,2,1,5,0xb2d1ed43d
501776.15,3.0,41,4,4,2,10,0xb2d9d5d1
1050014.61,13.0,15,4,4,3,11,0xb2d13b61
3001.84,1.0,68,2,2,1,5,0xb2d349cb
14221.71,1.0,1,2,2,4,8,0xb2d6d5c6
56058.45,2.0,17,3,3,2,8,0xb2d68322
695013.4,6.0,92,4,4,1,9,0xb2d25830
711.41,1.0,3,1,2,4,7,0xb2d30c52
500101.47,3.0,12,4,4,3,11,0xb2d4fce9
500825.6,3.0,4,4,4,4,12,0xb2d6de1b
194163.38,3.0,0,3,4,4,11,0xb2d331fa
200020.84,2.0,18,3,3,2,8,0xb2d8d9bad
200000.42,2.0,19,3,3,2,8,0xb2d3f4cd
89.34,2.0,26,1,3,2,6,0x3b9b24df
5263.48,4.0,4,2,4,4,10,0xb2d14e9a
160120.24,4.0,1,3,4,4,11,0xb2d4ec04
4260.6,1.0,1,2,2,4,8,0xb2d386b9
46101.09,2.0,123,2,3,1,6,0xb2d93881
100012.1,6.0,12,3,4,3,10,0xb2d54cc7
450012.15,4.0,139,4,4,1,9,0xb2d6a1fc
43000.0,2.0,4,2,3,4,9,0xb2d2411ad
280052.3,3.0,27,3,4,2,9,0xb2d4cdd7d
230000.0,2.0,1,3,3,4,10,0xb2da69a6
1303.0,1.0,0,1,2,4,7,0xb2d6f1b9
130011.23,2.0,194,3,3,1,7,0xb2d5bdf8
33606.93,1.0,13,2,2,3,7,0xb2d6c514
3946000.0,6.0,9,4,4,3,11,0xb2d1c41e
260.54,1.0,26,1,2,2,5,0xb2d7f1f5
85855.03,3.0,0,3,4,4,11,0xb2d244b7
34526.67,1.0,21,2,2,2,6,0xb2d535e3
714078.01,4.0,4,4,4,4,12,0xb2d34ef3
40008.97,2.0,21,2,3,2,7,0xb2d218d4
154943.74,3.0,70,3,4,1,8,0xb2d646ce
210289.86,4.0,95,3,4,1,8,0xb2d61f15
315348.71,2.0,7,4,3,3,10,0xb2d5ea47
11529.07,1.0,98,2,2,1,5,0xb2d2ab52
69391.75,1.0,10,3,2,3,8,0xb2d59c44d
9152.12,2.0,184,2,3,1,6,0x3b9b0f59d
200000.44,2.0,7,3,3,3,9,0xb2d8dcc4
370004.8,3.0,6,4,4,3,11,0xb2d5127cd
151961.52,6.0,76,3,4,1,8,0xb2d620ddd
271154.09,4.0,48,3,4,2,9,0xb2d8d73f
1101811.73,5.0,1,4,4,4,12,0xb2d0a3b9
25.17,1.0,35,1,2,2,5,0xb2d3f24cd
254443.13,2.0,76,3,3,1,7,0xb2d8e0b7d
12627.93,1.0,3,2,2,4,8,0xb2d68713d
122.69,1.0,84,1,2,1,4,0xb2d3ad28
485.78,2.0,74,1,3,1,5,0xb2d116cfd
538450.48,8.0,4,4,4,4,12,0xb2d1d839
83.56,1.0,67,1,2,1,4,0xb2d3008dd
55776.47,3.0,0,3,4,4,11,0xb2d0d766d
14248.69,1.0,17,2,2,2,6,0xb2d6c4ce
503519.49,6.0,1,4,4,4,12,0xb2d5b4f7
12963.77,1.0,6,2,2,3,7,0xb2d93dded
10004.17,2.0,12,2,3,3,8,0xb2d06764
9786.67,1.0,18,2,2,2,6,0xb2d68f5f
621795.88,6.0,5,4,4,3,11,0xb2d6565e
6149.75,1.0,1,2,2,4,8,0xb2d697dd
4605.15,1.0,10,2,2,3,7,0xb2da00c0
4127.32,2.0,92,2,3,1,6,0x3b9b4587
8893.12,1.0,29,2,2,2,6,0xb2d928ba
206339.52,5.0,6,3,4,3,10,0xb2d50281d
222073.08,6.0,24,3,4,2,9,0xb2d23f26
2754.98,1.0,92,1,2,1,4,0xb2d3a7b1
210404.08,4.0,28,3,4,2,9,0xb2d29b7c
200257.35,2.0,116,3,3,1,7,0xb2d686b3
425533.61,4.0,80,4,4,1,9,0xb2d2f818
4493.0,1.0,0,2,2,4,8,0xb2d22207d
941.77,1.0,0,1,2,4,7,0xb2d6f55c
536752.88,4.0,6,4,4,3,11,0xb2d49be5d
70061.97,1.0,18,3,2,2,7,0xb2d9cb2d
565.16,1.0,0,1,2,4,7,0xb2d326cb
7568.77,1.0,19,2,2,2,6,0xb2d1ff9b
170760.78,2.0,0,3,3,4,10,0xb2d8931e
1816.13,1.0,18,1,2,2,5,0xb2d63459d
1007.82,1.0,92,1,2,1,4,0xb2d3471a
40.96,1.0,60,1,2,2,5,0xb2d94648d
55076.68,2.0,196,3,3,1,7,0xb2d1223f
5890.29,1.0,16,2,2,2,6,0xb2d6b8e9
14171.66,1.0,0,2,2,4,8,0xb2d3701b
174053.9,4.0,17,3,4,2,9,0xb2d39392
50011.98,2.0,0,2,3,4,9,0xb2d57ebf
18785.32,1.0,6,2,2,3,7,0xb2d791e4
127341.67,2.0,14,3,3,3,9,0xb2d1c4fa
0.0,1.0,1,1,2,4,7,0xb2d36ced
400013.43,3.0,1,4,4,4,12,0xb2d8faab
1618513.87,1.0,0,4,2,4,10,0xb2d16c31d
200001.26,2.0,9,3,3,3,9,0xb2d5d596
219.37,2.0,24,1,3,2,6,0xb2d2d4c0
1530978.34,2.0,4,4,3,4,11,0xb2d3ec92
21.04,1.0,41,1,2,2,5,0xb2d33cb6
530022.38,2.0,42,4,3,2,9,0xb2d9e62a
480066.61,5.0,6,4,4,3,11,0xb2d109aed
50998.12,2.0,211,2,3,1,6,0xb2d53fc1d
36785.61,1.0,7,2,2,3,7,0xb2d3339d
3922.65,1.0,138,2,2,1,5,0xb2d5d47cd
8.03,1.0,35,1,2,2,5,0xb2d68f37d
360014.16,3.0,18,4,4,2,10,0xb2d5a05f
61.07,1.0,1,1,2,4,7,0xb2d3a5d9
52022.53,2.0,59,2,3,2,7,0xb2d580c1d
302131.52,2.0,63,4,3,2,9,0xb2d8f73a
286202.75,2.0,10,3,3,3,9,0xb2d1238c
423487.86,3.0,1,4,4,4,12,0xb2d5f7ad
88.19,1.0,5,1,2,3,6,0xb2d27c59
82593.01,10.0,0,3,4,4,11,0x3b9af62c
90461.8,3.0,1,3,4,4,11,0xb2d2b472
64887.79,5.0,0,3,4,4,11,0x3b9b3272
6.95,1.0,81,1,2,1,4,0xb2d5c53f
495170.89,4.0,3,4,4,4,12,0xb2d3ab9ed
500000.0,2.0,26,4,3,2,9,0xb2d94c1c
200031.35,2.0,25,3,3,2,8,0xb2d946c1
150138.56,2.0,122,3,3,1,7,0xb2d56057d
186264.62,3.0,14,3,4,3,10,0xb2d0fb0f
8103.86,1.0,1,2,2,4,8,0xb2d47277
800082.79,4.0,0,4,4,4,12,0xb2d6d8dad
2259.79,1.0,184,1,2,1,4,0xb2d1b524
1041.96,1.0,92,1,2,1,4,0xb2d2018c
316244.72,10.0,6,4,4,3,11,0xb2d16b4b
340051.23,5.0,108,4,4,1,9,0xb2d1ae88
663.24,1.0,18,1,2,2,5,0xb2d2dc98
6706.16,1.0,0,2,2,4,8,0xb2d4ce13d
501797.45,2.0,54,4,3,2,9,0xb2d905b6d
500076.08,2.0,16,4,3,2,9,0xb2d99a18
52.15,1.0,46,1,2,2,5,0xb2d1c555
350110.96,4.0,42,4,4,2,10,0xb2d33582d
6.97,1.0,14,1,2,3,6,0xb2d45b99
0.48,1.0,1,1,2,4,7,0xb2d5c8c5
200843.09,2.0,2,3,3,4,10,0xb2d9243fd
21083.76,3.0,92,2,4,1,7,0xb2d0e441d
36219.38,8.0,0,2,4,4,10,0x3b9ae3f4d
6971.57,1.0,15,2,2,3,7,0xb2d9c444
51.46,1.0,9,1,2,3,6,0xb2d5c7e0
710045.25,5.0,18,4,4,2,10,0xb2d24675
5874.64,1.0,11,2,2,3,7,0xb2d32aed
201010.32,6.0,26,3,4,2,9,0xb2d6a109
1000076.04,3.0,1,4,4,4,12,0xb2d9ed44
560029.49,4.0,20,4,4,2,10,0xb2d2b339
111.12,2.0,20,1,3,2,6,0xb2da1d77
4953.19,1.0,0,2,2,4,8,0xb2d90a8d
100206.31,2.0,164,3,3,1,7,0xb2d5efd3
120079.4,4.0,25,3,4,2,9,0xb2d8f9d8
1021.15,1.0,184,1,2,1,4,0xb2d422aed
40618.64,2.0,0,2,3,4,9,0xb2d631eed
50079.53,2.0,165,2,3,1,6,0xb2d575c1
32684.49,1.0,82,2,2,1,5,0xb2d1e9a6
823.49,1.0,4,1,2,4,7,0xb2d33935
6262.32,1.0,0,2,2,4,8,0xb2d6c654d
202546.73,4.0,32,3,4,2,9,0xb2d5fce8
90086.28,3.0,30,3,4,2,9,0xb2d6804a
307506.62,1.0,1,4,2,4,10,0xb2d6adbe
4.43,1.0,75,1,2,1,4,0xb2d5c47f
11570.74,1.0,2,2,2,4,8,0xb2d688da
574.03,1.0,12,1,2,3,6,0xb2d9274f
5388.45,1.0,0,2,2,4,8,0xb2d55fd0
35.76,1.0,3,1,2,4,7,0xb2d5358f
152259.86,2.0,75,3,3,1,7,0xb2d2f8fa
9322.26,1.0,15,2,2,3,7,0xb2d705cc
3903.87,1.0,8,2,2,3,7,0xb2d3aae3
8587.96,1.0,0,2,2,4,8,0xb2d5d787
443149.55,26.0,1,4,4,4,12,0xb2d0b459d
11906.78,1.0,1,2,2,4,8,0xb2d5dfc9
1103.04,1.0,1,1,2,4,7,0xb2d2e663d
1457.8,1.0,92,1,2,1,4,0xb2d0fede
1259984.0,13.0,11,4,4,3,11,0xb2d1c370
160061.9,3.0,100,3,4,1,8,0xb2d52cb7
5589.98,1.0,6,2,2,3,7,0xb2d3e93e
1077319.51,11.0,9,4,4,3,11,0xb2d959e8
20873.38,1.0,3,2,2,4,8,0xb2d41e25
55.42,1.0,49,1,2,2,5,0xb2d960f6
1000000.0,2.0,13,4,3,3,10,0xb2d7fd8a
2829.43,1.0,5,1,2,3,6,0xb2d939ee
210781.67,2.0,4,3,3,4,10,0xb2d6fae5
101352.82,2.0,10,3,3,3,9,0xb2d279e8
400000.66,2.0,22,4,3,2,9,0xb2d8d084
355442.79,5.0,69,4,4,1,9,0xb2d5771b
134034.67,3.0,49,3,4,2,9,0xb2d12571d
200044.64,2.0,0,3,3,4,10,0xb2d43a2c
5910.32,1.0,0,2,2,4,8,0xb2d38b17
21615.97,1.0,11,2,2,3,7,0xb2d80fd3
5517.18,1.0,0,2,2,4,8,0xb2d85ae4
421087.94,15.0,14,4,4,3,11,0x3b9b0fb4
42243.64,1.0,52,2,2,2,6,0xb2d229f3
105092.42,2.0,224,3,3,1,7,0xb2d49d65
172991.15,1.0,174,3,2,1,6,0xb2d1f211d
5392.64,1.0,0,2,2,4,8,0xb2d3959f
300033.11,3.0,193,3,4,1,8,0xb2d08a51
9.38,1.0,5,1,2,3,6,0xb2d48cb1
44494.86,1.0,6,2,2,3,7,0xb2d6a519
503783.42,3.0,25,4,4,2,10,0xb2d707a9
505000.05,3.0,1,4,4,4,12,0xb2d594fed
700123.64,5.0,2,4,4,4,12,0xb2d0d398
75000.0,2.0,0,3,3,4,10,0xb2d5db56d
3188.14,1.0,184,2,2,1,5,0xb2d40e4a
81665.39,2.0,24,3,3,2,8,0xb2d5b449d
813255.82,4.0,41,4,4,2,10,0xb2d6e21ed
311844.7,4.0,5,4,4,3,11,0xb2d515d2
147.08,1.0,15,1,2,3,6,0xb2d6a783
10290.93,2.0,1,2,3,4,9,0xb2d5c0f6
108.25,13.0,184,1,4,1,6,0xb2d117ebd
2992.74,1.0,8,2,2,3,7,0xb2d6ec48
31300.24,1.0,92,2,2,1,5,0xb2d22c3e
206583.18,4.0,62,3,4,2,9,0xb2d1d017d
1965.78,1.0,92,1,2,1,4,0xb2d2968e
320001.42,6.0,26,4,4,2,10,0xb2d77790
55094.84,2.0,24,3,3,2,8,0xb2d50990
100023.75,2.0,179,3,3,1,7,0xb2d595aa
130669.4,7.0,0,3,4,4,11,0xb2d291a7
1885.41,1.0,184,1,2,1,4,0xb2d0b0a5
5047.88,3.0,184,2,4,1,7,0x3b9b35dbd
1023780.36,7.0,0,4,4,4,12,0xb2d4aaa1
14589.63,1.0,0,2,2,4,8,0xb2d5decf
80076.52,3.0,7,3,4,3,10,0xb2d60be5d
250034.14,3.0,80,3,4,1,8,0xb2d28892
1389.85,13.0,1,1,4,4,9,0xb2d0a297
4253.17,1.0,0,2,2,4,8,0xb2d866a5
463.46,1.0,12,1,2,3,6,0xb2d2cfaf
232495.72,3.0,200,3,4,1,8,0xb2d3e610
300006.33,2.0,10,3,3,3,9,0xb2d961e4
37729.96,1.0,14,2,2,3,7,0xb2d2e6d5d
1020.41,1.0,92,1,2,1,4,0xb2d10054d
455508.4,3.0,27,4,4,2,10,0xb2d6f2fc
794027.82,4.0,52,4,4,2,10,0xb2d1275ad
50202.68,1.0,0,2,2,4,8,0xb2d54b8a
23071.72,1.0,1,2,2,4,8,0xb2d26658d
516079.23,2.0,126,4,3,1,8,0xb2d0ea83
368.96,1.0,2,1,2,4,7,0xb2d941c7
981043.36,7.0,7,4,4,3,11,0xb2d1b752
637.37,1.0,75,1,2,1,4,0xb2d4ea91
263997.55,5.0,5,3,4,3,10,0xb2d5eb4e
177054.1,2.0,136,3,3,1,7,0xb2d39a51
601152.9,3.0,0,4,4,4,12,0xb2d28cb1
6728.22,1.0,24,2,2,2,6,0xb2d6bea4
10046.72,1.0,27,2,2,2,6,0xb2d5f3b3
18800.21,2.0,13,2,3,3,8,0xb2d950c3
212009.05,2.0,4,3,3,4,10,0xb2d13b28
480020.29,2.0,189,4,3,1,8,0xb2d827a9d
761309.37,7.0,7,4,4,3,11,0xb2d1708f
231701.84,4.0,27,3,4,2,9,0xb2d6ac08
34645.51,1.0,46,2,2,2,6,0xb2d424b6d
4670.23,1.0,10,2,2,3,7,0xb2d26be8
206564.3,3.0,126,3,4,1,8,0xb2d3cde1d
618.85,3.0,0,1,4,4,9,0xb2d09f7f
676061.1,7.0,18,4,4,2,10,0xb2d1c44e
8610.98,1.0,0,2,2,4,8,0xb2d31553
200012.48,3.0,0,3,4,4,11,0xb2d5d4c2
123496.49,2.0,87,3,3,1,7,0xb2d5e649d
1152520.28,11.0,1,4,4,4,12,0xb2d1716a
593.29,1.0,0,1,2,4,7,0xb2d80593
1.45,1.0,6,1,2,3,6,0xb2d3b0dcd
20632.37,1.0,184,2,2,1,5,0xb2d5c5fcd
99434.17,3.0,11,3,4,3,10,0xb2d4b2e2
350017.0,5.0,87,4,4,1,9,0xb2d1fc77
303559.48,2.0,73,4,3,1,8,0xb2d6baab
2839.61,1.0,184,1,2,1,4,0xb2d3515ad
103080.13,5.0,4,3,4,4,11,0xb2d6349ad
50866.74,2.0,129,2,3,1,6,0xb2d623bc
1803.84,1.0,184,1,2,1,4,0xb2d21bacd
320000.0,6.0,5,4,4,3,11,0xb2d54d23d
13.06,1.0,23,1,2,2,5,0xb2d9aa92
3514.62,1.0,2,2,2,4,8,0xb2d3e86c
5000.79,1.0,24,2,2,2,6,0xb2d94d5b
60037.29,3.0,32,3,4,2,9,0xb2d8d305
1004629.34,4.0,87,4,4,1,9,0xb2d1ee4c
9475.16,1.0,10,2,2,3,7,0xb2d6d3d1
200000.0,2.0,21,3,3,2,8,0xb2da2510
802842.17,2.0,36,4,3,2,9,0xb2d6d74a
710019.1,5.0,3,4,4,4,12,0xb2d217e6d
7001921.39,2.0,1,4,3,4,11,0xb2d9849e
380042.38,4.0,41,4,4,2,10,0xb2d3d21a
34.21,1.0,23,1,2,2,5,0xb2d93b79
3924.67,1.0,8,2,2,3,7,0xb2d3421a
208087.36,2.0,1,3,3,4,10,0xb2d6d8ef
5256.07,1.0,16,2,2,2,6,0xb2d2e4b8
276555.8,2.0,12,3,3,3,9,0xb2d384ac
157090.17,6.0,0,3,4,4,11,0xb2d28188d
91062.65,1.0,4,3,2,4,9,0xb2d23a96
14039.83,1.0,2,2,2,4,8,0xb2d2c6ea
201008.67,2.0,32,3,3,2,8,0xb2d668b0
2465677.62,8.0,0,4,4,4,12,0x3b9af23d
400182.9,3.0,60,4,4,2,10,0xb2d91ec5d
200004.22,2.0,20,3,3,2,8,0xb2d0695c
24783.77,1.0,92,2,2,1,5,0xb2d28cecd
60756.95,2.0,4,3,3,4,10,0xb2d3ba81
95.71,1.0,10,1,2,3,6,0xb2d30979
71847.72,5.0,16,3,4,2,9,0xb2d577a6
20009.52,2.0,92,2,3,1,6,0xb2d6d88a
131059.29,5.0,53,3,4,2,9,0xb2d0ed60d
100003.17,2.0,206,3,3,1,7,0xb2d29aa2d
19385.08,1.0,0,2,2,4,8,0xb2d3bc60
1041.09,1.0,6,1,2,3,6,0xb2d19314d
13345.78,1.0,20,2,2,2,6,0xb2d801ab
51117.75,1.0,0,2,2,4,8,0xb2d98b76
18002.24,2.0,68,2,3,1,6,0xb2d5eec2
29.87,1.0,34,1,2,2,5,0xb2d5b1b0
713741.69,3.0,18,4,4,2,10,0xb2d5c0c0d
550002.24,3.0,80,4,4,1,9,0xb2d5837b
44000.46,1.0,10,2,2,3,7,0xb2d90bf2d
500000.0,2.0,7,4,3,3,10,0xb2d5c055
928859.86,12.0,2,4,4,4,12,0xb2d691fa
40002.11,2.0,13,2,3,3,8,0xb2d959eb
0.0,1.0,7,1,2,3,6,0xb2d59cbf
23.66,1.0,70,1,2,1,4,0xb2d67f01
203438.85,2.0,244,3,3,1,7,0xb2d6092ad
275.65,1.0,5,1,2,3,6,0xb2d323cb
282.72,1.0,8,1,2,3,6,0xb2d53890
730034.96,3.0,40,4,4,2,10,0xb2d1b514
631087.04,6.0,42,4,4,2,10,0x3b9b29de
36789.65,2.0,158,2,3,1,6,0x3b9b3b23d
320004.57,10.0,0,4,4,4,12,0xb2d6521d
1215.85,1.0,184,1,2,1,4,0xb2d1f2c7
1000725.04,1.0,0,4,2,4,10,0xb2d397ef
269785.76,6.0,0,3,4,4,11,0xb2d212ab
23.7,1.0,11,1,2,3,6,0xb2d8dc35d
8233.98,1.0,4,2,2,4,8,0xb2d83a6b
275.35,1.0,9,1,2,3,6,0xb2d6c585
30828.78,2.0,119,2,3,1,6,0xb2d5ffbf
26659.59,1.0,1,2,2,4,8,0xb2d6cc72
80009.21,2.0,41,3,3,2,8,0xb2d610ac
3.32,1.0,27,1,2,2,5,0xb2d0d8c9
171440.35,2.0,95,3,3,1,7,0xb2d07ed2
570040.19,3.0,14,4,4,3,11,0xb2d69134d
18163.89,1.0,2,2,2,4,8,0xb2d97bc9
4000.8,1.0,29,2,2,2,6,0xb2d4cb59
60002.67,2.0,73,3,3,1,7,0xb2d0cde2d
2016.97,1.0,240,1,2,1,4,0xb2d2fd6dd
55908.8,2.0,136,3,3,1,7,0xb2d21e98
530000.56,3.0,0,4,4,4,12,0xb2d5cc96
100009.9,3.0,82,3,4,1,8,0xb2d38d87
611798.69,8.0,14,4,4,3,11,0xb2d42427
63757.25,2.0,10,3,3,3,9,0xb2d48c3f
40000.84,2.0,90,2,3,1,6,0xb2d8b17b
523641.82,3.0,6,4,4,3,11,0xb2d22fc1
113.6,1.0,30,1,2,2,5,0xb2d6f58d
5713.04,1.0,92,2,2,1,5,0xb2d1abf0
16387.52,1.0,176,2,2,1,5,0xb2d488e5
559249.53,5.0,87,4,4,1,9,0xb2d16dc4
10003.84,2.0,83,2,3,1,6,0xb2d58c8ed
2231.59,1.0,15,1,2,3,6,0xb2d563ea
501786.21,2.0,32,4,3,2,9,0xb2d3e24f
1792.53,1.0,6,1,2,3,6,0xb2d39aad
4017962.21,1.0,92,4,2,1,7,0xb2d2ebfe
500000.0,2.0,2,4,3,4,11,0xb2da06db
308326.89,7.0,59,4,4,2,10,0xb2d3bcb4
10683.82,2.0,5,2,3,3,8,0xb2d53aaa
896083.7,6.0,1,4,4,4,12,0xb2d64ee2
731077.4,3.0,1,4,4,4,12,0xb2d34613
389573.67,18.0,1,4,4,4,12,0xb2d20aab
1611.82,1.0,232,1,2,1,4,0xb2d1da83
892.0,1.0,10,1,2,3,6,0xb2d318e7
80.94,1.0,6,1,2,3,6,0xb2d1dc77
401420.84,3.0,4,4,4,4,12,0xb2d936b7
58111.37,2.0,112,3,3,1,7,0xb2d0f675
209597.27,1.0,3,3,2,4,9,0xb2d57345d
2691.78,1.0,184,1,2,1,4,0xb2d1afd6
1.0,1.0,5,1,2,3,6,0xb2d41083
301138.66,2.0,13,4,3,3,10,0xb2d787d7
24750.84,2.0,92,2,3,1,6,0xb2d08eaa
201004.32,2.0,30,3,3,2,8,0xb2d65313
70001.48,2.0,11,3,3,3,9,0xb2da40a6
197234.65,9.0,0,3,4,4,11,0x3b9b1bf7
500008.66,2.0,4,4,3,4,11,0xb2d5b2fb
310060.1,7.0,4,4,4,4,12,0x3b9b32b4
103512.82,2.0,18,3,3,2,8,0xb2d2a315
665541.74,2.0,90,4,3,1,8,0xb2d284e4d
2080.83,1.0,35,1,2,2,5,0xb2d2747b
420001.0,2.0,1,4,3,4,11,0xb2da4ec5
230104.55,3.0,19,3,4,2,9,0xb2d952b0
17495.57,1.0,119,2,2,1,5,0xb2d3bd66
1533.94,1.0,0,1,2,4,7,0xb2d3af0e
35024.11,1.0,1,2,2,4,8,0xb2d203bd
19.62,1.0,15,1,2,3,6,0xb2d5581b
2456.13,1.0,11,1,2,3,6,0xb2d07cc0
101243.78,2.0,136,3,3,1,7,0xb2d64f7bd
20000.21,2.0,80,2,3,1,6,0xb2d991cb
1108.39,1.0,168,1,2,1,4,0xb2d21810d
73427.54,2.0,47,3,3,2,8,0xb2d50277
186762.18,3.0,0,3,4,4,11,0xb2d55cbe
552003.19,7.0,59,4,4,2,10,0xb2d6447e
31325.99,2.0,3,2,3,4,9,0xb2d6fc42
3.38,1.0,4,1,2,4,7,0xb2d526cd
180324.87,2.0,95,3,3,1,7,0xb2d61fa0d
340002.11,3.0,1,4,4,4,12,0xb2da0a6f
8646.22,1.0,5,2,2,3,7,0xb2d2aab9d
1074.99,1.0,184,1,2,1,4,0xb2d304e9
582.15,1.0,0,1,2,4,7,0xb2d101cb
2700053.7,5.0,1,4,4,4,12,0xb2d4587c
534023.7,9.0,25,4,4,2,10,0xb2d58d33
10041.97,1.0,92,2,2,1,5,0xb2d5558ad
29.03,1.0,56,1,2,2,5,0xb2d9bfe3
25231.85,1.0,22,2,2,2,6,0xb2d24676
60037.1,2.0,144,3,3,1,7,0xb2d6d1b8
348100.42,4.0,62,4,4,2,10,0xb2d22dd1
50011.83,2.0,147,2,3,1,6,0xb2d53009d
542.73,1.0,0,1,2,4,7,0xb2d0c16c
20218.53,1.0,184,2,2,1,5,0xb2d29576
701633.77,4.0,8,4,4,3,11,0xb2d671f4d
0.0,7.0,0,1,4,4,9,0xb2d1c8ab
76639.95,2.0,8,3,3,3,9,0xb2d45aac
98035.5,9.0,21,3,4,2,9,0xb2d54a8cd
4.58,1.0,13,1,2,3,6,0xb2d2a541
71874.67,2.0,0,3,3,4,10,0xb2d0de69
475713.29,19.0,0,4,4,4,12,0x3b9b1914
350000.6,3.0,19,4,4,2,10,0xb2d2b36b
212933.82,2.0,26,3,3,2,8,0xb2d16e37d
3123.52,1.0,10,2,2,3,7,0xb2d1d50bd
11.85,1.0,33,1,2,2,5,0xb2d95f44
404361.7,2.0,89,4,3,1,8,0xb2d98135d
9.21,1.0,84,1,2,1,4,0xb2d5661e
650118.81,5.0,136,4,4,1,9,0xb2d63773
25.81,1.0,67,1,2,1,4,0xb2d42d0b
35507.58,1.0,14,2,2,3,7,0xb2d6a1d7d
100013.42,3.0,143,3,4,1,8,0xb2d54def
0.0,1.0,6,1,2,3,6,0xb2d91cae
202442.47,4.0,27,3,4,2,9,0xb2d5201bd
1752.24,1.0,4,1,2,4,7,0xb2d1c873
640.53,1.0,0,1,2,4,7,0xb2d4cb50
651100.28,8.0,1,4,4,4,12,0xb2d197f2d
25590.29,2.0,32,2,3,2,7,0xb2d6e19c
300423.21,2.0,43,4,3,2,9,0xb2d43993d
30813.64,1.0,15,2,2,3,7,0xb2d5ba51
459.82,2.0,5,1,3,3,7,0xb2d0ae80
200010.42,2.0,2,3,3,4,10,0xb2da069d
190546.83,2.0,3,3,3,4,10,0xb2d3404a
4328.69,1.0,0,2,2,4,8,0xb2d6d028d
261581.8,2.0,28,3,3,2,8,0xb2d5ef74d
200096.15,2.0,0,3,3,4,10,0xb2d5d04b
380004.01,2.0,77,4,3,1,8,0xb2d99678
501542.64,3.0,16,4,4,2,10,0xb2d29940
58111.26,2.0,20,3,3,2,8,0xb2d0f675d
500000.93,2.0,8,4,3,3,10,0xb2d9ab23
201000.18,2.0,4,3,3,4,10,0xb2d2e2a3
4.75,1.0,39,1,2,2,5,0xb2d92332d
1915693.55,10.0,9,4,4,3,11,0xb2d2cdc6
910099.14,25.0,0,4,4,4,12,0xb2d139eed
602.81,1.0,0,1,2,4,7,0xb2d28f0e
29498.11,1.0,0,2,2,4,8,0xb2d20219
367030.96,4.0,6,4,4,3,11,0xb2d81f3bd
1429222.39,5.0,0,4,4,4,12,0xb2d87aa3
268418.32,5.0,27,3,4,2,9,0xb2d28feb
186474.98,2.0,87,3,3,1,7,0xb2d17d11
8533.61,1.0,2,2,2,4,8,0xb2d1dd7ed
1033.62,1.0,92,1,2,1,4,0xb2d1d729
3696.84,1.0,125,2,2,1,5,0xb2d6b8ea
889.06,1.0,0,1,2,4,7,0xb2d38665
279692.63,4.0,172,3,4,1,8,0xb2d31e02
329645.92,1.0,0,4,2,4,10,0xb2d78286
173108.29,2.0,104,3,3,1,7,0xb2d5f338d
12000474.34,14.0,5,4,4,3,11,0xb2d67f78d
270023.32,3.0,32,3,4,2,9,0xb2d5ab24
503553.01,2.0,81,4,3,1,8,0xb2d98109
31.47,1.0,7,1,2,3,6,0xb2d6ab07
50000.53,2.0,228,2,3,1,6,0xb2d6f6c2
180000.01,2.0,98,3,3,1,7,0xb2d25e76
74.34,1.0,20,1,2,2,5,0xb2d177a3
30272.3,1.0,4,2,2,4,8,0xb2d18d45
1278.12,1.0,184,1,2,1,4,0xb2d2cddb
10000.05,2.0,184,2,3,1,6,0xb2d65916
300160.09,2.0,235,4,3,1,8,0xb2d11f34
1080.04,1.0,32,1,2,2,5,0xb2d26618
20010.0,1.0,1,2,2,4,8,0xb2d6a2d1
345880.82,3.0,5,4,4,3,11,0xb2d59552
80004.22,2.0,48,3,3,2,8,0xb2d9d430
56873.48,2.0,0,3,3,4,10,0xb2d25470
3043.01,1.0,42,2,2,2,6,0xb2d6501bd
6060.06,1.0,92,2,2,1,5,0xb2d29068d
280985.22,9.0,0,3,4,4,11,0xb2d091e3d
613084.77,4.0,14,4,4,3,11,0xb2d0eb39d
90.78,1.0,17,1,2,2,5,0xb2d34552
1758.63,1.0,105,1,2,1,4,0xb2d68bcd
1027111.42,7.0,11,4,4,3,11,0xb2d16bfb
2580.51,1.0,9,1,2,3,6,0xb2d6b77d
3519.02,1.0,92,2,2,1,5,0xb2d192b4d
6.44,1.0,12,1,2,3,6,0xb2d3a8e1
40705.39,1.0,184,2,2,1,5,0xb2d2067f
1697019.27,29.0,6,4,4,3,11,0xb2d4277a
200000.0,2.0,12,3,3,3,9,0xb2d9659c
4358511.44,3.0,87,4,4,1,9,0x3b9af114
2858.49,1.0,0,1,2,4,7,0xb2d6b59c
650078.42,4.0,31,4,4,2,10,0xb2d3a0b9
130162.21,4.0,3,3,4,4,11,0xb2d0e39e
251000.87,3.0,22,3,4,2,9,0xb2d5ff3f
55346.26,1.0,125,3,2,1,6,0xb2d11acad
47345.05,2.0,132,2,3,1,6,0xb2d54e2c
358.8,1.0,3,1,2,4,7,0xb2d6473a
50002.32,2.0,48,2,3,2,7,0xb2d910e9
0.99,1.0,8,1,2,3,6,0xb2d0c404
100085.38,2.0,189,3,3,1,7,0xb2d58b28
10001.61,2.0,73,2,3,1,6,0xb2d68e94d
6088.85,1.0,22,2,2,2,6,0xb2d826ee
244.87,1.0,22,1,2,2,5,0xb2d2cdf5
261.85,1.0,31,1,2,2,5,0xb2d3049f
629.28,1.0,13,1,2,3,6,0xb2d24639d
0.0,2.0,84,1,3,1,5,0xb2d97e4d
340055.98,3.0,0,4,4,4,12,0xb2d3c692
10000.21,2.0,8,2,3,3,8,0xb2da3bc6
440017.15,7.0,5,4,4,3,11,0xb2d5b2c6
1015.36,1.0,92,1,2,1,4,0xb2d27a83
390088.98,4.0,67,4,4,1,9,0xb2d28494
1002.23,1.0,219,1,2,1,4,0xb2d70859
2304.02,1.0,10,1,2,3,6,0xb2d42620
8455.94,1.0,1,2,2,4,8,0xb2d581a4
600000.4,43.0,4,4,4,4,12,0x3b9b345d
853419.3,6.0,0,4,4,4,12,0xb2d0f8abd
80001.06,3.0,4,3,4,4,11,0xb2d975a2
3.85,1.0,8,1,2,3,6,0xb2d9f2aa
100332.64,2.0,138,3,3,1,7,0xb2d65926
4020.25,1.0,92,2,2,1,5,0xb2d1a0c2
6795.59,1.0,0,2,2,4,8,0xb2d0e77f
13208.86,1.0,20,2,2,2,6,0xb2d83c70
1077888.02,11.0,0,4,4,4,12,0xb2d09466
1359.06,1.0,184,1,2,1,4,0xb2d42fc4d
1620882.61,2.0,1,4,3,4,11,0xb2d0fda9
10003.53,2.0,42,2,3,2,7,0xb2d9d793
62892.16,2.0,94,3,3,1,7,0xb2d522ac
92748.54,2.0,5,3,3,3,9,0xb2d62fca
0.11,1.0,92,1,2,1,4,0xb2d60fbb
305331.85,2.0,107,4,3,1,8,0xb2d8e084d
80016.0,1.0,1,3,2,4,9,0xb2d6c5e3
20073.25,2.0,147,2,3,1,6,0xb2d8f045
3748.62,1.0,1,2,2,4,8,0xb2d8c633
740.08,1.0,14,1,2,3,6,0xb2d6bd5d
1772.91,1.0,184,1,2,1,4,0xb2d197cc
14743430.91,29.0,0,4,4,4,12,0x3b9ae3af
160001.6,2.0,4,3,3,4,10,0xb2d2758a
0.77,1.0,0,1,2,4,7,0xb2d475c8
800298.99,11.0,0,4,4,4,12,0xb2d178f2
1902.76,1.0,7,1,2,3,6,0xb2d2ed1e
1037019.81,6.0,87,4,4,1,9,0xb2d248ecd
4928332.37,32.0,0,4,4,4,12,0x3b9b21a3
4524.73,1.0,45,2,2,2,6,0xb2d49065
50002.11,2.0,92,2,3,1,6,0xb2d64888d
16948.26,2.0,92,2,3,1,6,0xb2d108f6
114060.68,1.0,94,3,2,1,6,0xb2d4dea8
1751.66,1.0,4,1,2,4,7,0xb2d6f963
10000.21,2.0,8,2,3,3,8,0xb2da4838
484640.68,2.0,19,4,3,2,9,0xb2d30f65
500010.04,2.0,13,4,3,3,10,0xb2d9203ed
931.72,1.0,1,1,2,4,7,0xb2d6b598
2048.07,1.0,0,1,2,4,7,0xb2d3751f
212799.15,5.0,0,3,4,4,11,0xb2d50917d
3222632.12,4.0,4,4,4,4,12,0xb2d6b859
27.66,1.0,15,1,2,3,6,0xb2d15d0d
1202257.27,13.0,53,4,4,2,10,0x3b9b26abd
1040.83,1.0,184,1,2,1,4,0xb2d1da79d
500000.0,3.0,8,4,4,3,11,0xb2d5f019d
207007.68,2.0,31,3,3,2,8,0xb2d5ce95
323297.76,2.0,11,4,3,3,10,0xb2d681a1d
1750030.56,11.0,0,4,4,4,12,0xb2d3c067d
21197.04,1.0,92,2,2,1,5,0xb2d59ba3
600631.43,4.0,0,4,4,4,12,0xb2d6fce9d
5853557.45,7.0,4,4,4,4,12,0xb2d06c6e
50456.95,1.0,126,2,2,1,5,0xb2d6a4c9
571430.03,12.0,4,4,4,4,12,0xb2d138ca
24.48,1.0,14,1,2,3,6,0xb2d6e8d1
143154.13,3.0,136,3,4,1,8,0xb2d56eefd
6062.13,1.0,67,2,2,1,5,0xb2d6a337
564967.59,2.0,136,4,3,1,8,0xb2d24332
2589.06,1.0,11,1,2,3,6,0xb2d6a9dcd
892974.32,6.0,3,4,4,4,12,0xb2d78155
126487.55,1.0,120,3,2,1,6,0xb2d312da
600041.53,3.0,70,4,4,1,9,0xb2d65d57
278307.38,2.0,92,3,3,1,7,0xb2d33c68
100003.69,3.0,193,3,4,1,8,0xb2d78dfe
567194.08,6.0,0,4,4,4,12,0x3b9b37e7
250000.0,2.0,12,3,3,3,9,0xb2d96537
224844.91,5.0,0,3,4,4,11,0xb2d0d0f5d
350183.59,3.0,21,4,4,2,10,0xb2d0d342
23182.41,1.0,0,2,2,4,8,0xb2d69f89
140079.29,3.0,2,3,4,4,11,0xb2d93971
70199.69,1.0,92,3,2,1,6,0xb2d54a83
102975.55,3.0,73,3,4,1,8,0xb2d35d52
16412.51,1.0,5,2,2,3,7,0xb2d8de16d
404021.47,2.0,47,4,3,2,9,0xb2d6d967d
3109.16,1.0,92,2,2,1,5,0xb2d39909
47.19,1.0,14,1,2,3,6,0xb2d64af4
1951770.25,12.0,19,4,4,2,10,0xb2d6591cd
301247.37,2.0,0,4,3,4,11,0xb2d9f607
499434.72,2.0,116,4,3,1,8,0xb2d2f3e4
131.49,1.0,5,1,2,3,6,0xb2d5d53f
7109.0,1.0,21,2,2,2,6,0xb2d2b6eb
519015.79,8.0,11,4,4,3,11,0xb2d568a5
4727.69,1.0,0,2,2,4,8,0xb2d68d08
50002.12,1.0,12,2,2,3,7,0xb2da3e87
447000.0,3.0,10,4,4,3,11,0xb2d9a662
91.54,1.0,11,1,2,3,6,0xb2d9b7ee
35006.14,2.0,27,2,3,2,7,0xb2d5c70c
90064.43,9.0,0,3,4,4,11,0xb2d62b0c
5.51,1.0,208,1,2,1,4,0xb2d41001
46068.4,1.0,1,2,2,4,8,0xb2d0cef1d
94.5,1.0,71,1,2,1,4,0xb2d55deed
86.04,1.0,139,1,2,1,4,0xb2d6177c
21.63,1.0,18,1,2,2,5,0xb2d6f613
66.52,1.0,7,1,2,3,6,0xb2d656b1
3188.51,1.0,14,2,2,3,7,0xb2d33529
36.89,1.0,53,1,2,2,5,0xb2d209e8
1000081.98,2.0,24,4,3,2,9,0xb2d2582ed
768032.42,9.0,4,4,4,4,12,0xb2d17124
62121.79,3.0,42,3,4,2,9,0xb2d8f2f8d
10991.86,1.0,9,2,2,3,7,0xb2d36bd4
20039.39,2.0,27,2,3,2,7,0xb2d9a769
226.13,1.0,72,1,2,1,4,0xb2d3fb1e
180.61,1.0,4,1,2,4,7,0xb2d24abb
1022.16,1.0,92,1,2,1,4,0xb2d1b647d
24806.24,1.0,92,2,2,1,5,0xb2d3423cd
391993.3,2.0,1,4,3,4,11,0xb2d61236
8097.38,1.0,0,2,2,4,8,0xb2d8c385
50439.84,2.0,18,2,3,2,7,0xb2d4ebda
200012.75,3.0,59,3,4,2,9,0xb2d5afc4
180905.52,4.0,29,3,4,2,9,0xb2d39aa6d
2690.18,1.0,168,1,2,1,4,0xb2d24fa1
350000.24,2.0,18,4,3,2,9,0xb2d9da25
2068.21,1.0,1,1,2,4,7,0xb2d6b454
320143.57,5.0,0,4,4,4,12,0xb2d57bb9
255.83,1.0,8,1,2,3,6,0xb2d69bbfd
9900343.11,3.0,5,4,4,3,11,0xb2d345f4
2203.04,1.0,9,1,2,3,6,0xb2d52e47
6973.93,1.0,11,2,2,3,7,0xb2d6e6ac
20102.76,1.0,0,2,2,4,8,0xb2d56cd6d
550004.27,3.0,22,4,4,2,10,0xb2d6b468
321876.91,3.0,55,4,4,2,10,0xb2d0ea8a
870282.95,8.0,0,4,4,4,12,0xb2d0687d
2000084.44,2.0,11,4,3,3,10,0xb2da1a3e
490015.51,3.0,25,4,4,2,10,0xb2da03d1
57005.54,2.0,92,3,3,1,7,0xb2d78f29
150007.39,3.0,34,3,4,2,9,0xb2d9289f
1021233.21,4.0,1,4,4,4,12,0xb2d89f3fd
3250000.0,9.0,1,4,4,4,12,0xb2d62b45
8191.62,1.0,9,2,2,3,7,0xb2d36d19d
180453.31,3.0,60,3,4,2,9,0xb2d12653
144028.94,3.0,47,3,4,2,9,0xb2d9c6ac
191609.97,11.0,0,3,4,4,11,0x3b9b180e
110284.73,2.0,94,3,3,1,7,0xb2d2af4e
600078.54,6.0,13,4,4,3,11,0xb2d08076
1673863.19,2.0,0,4,3,4,11,0x3b9b2985
7652.51,1.0,205,2,2,1,5,0xb2d6380e
757443.59,3.0,1,4,4,4,12,0xb2d07074
51065.26,1.0,184,2,2,1,5,0xb2d5902fd
133005.76,8.0,6,3,4,3,10,0xb2d51737d
2.15,1.0,82,1,2,1,4,0xb2d6931bd
211.02,1.0,4,1,2,4,7,0xb2d319d9d
92.58,1.0,1,1,2,4,7,0xb2d63e21
114327.55,3.0,24,3,4,2,9,0xb2d4f510
0.0,2.0,89,1,3,1,5,0xb2d4c270
9915.72,1.0,0,2,2,4,8,0xb2d8da9f
340001.76,7.0,10,4,4,3,11,0xb2d402add
500000.12,2.0,7,4,3,3,10,0xb2d9b09b
40000.0,2.0,3,2,3,4,9,0xb2d97203
33285.58,2.0,3,2,3,4,9,0xb2d204d9
202215.57,2.0,105,3,3,1,7,0xb2d6470f
520113.4,2.0,108,4,3,1,8,0xb2d16c3d
367.13,1.0,9,1,2,3,6,0xb2d503a0
10291.87,1.0,233,2,2,1,5,0xb2d1ecf7
91500.71,2.0,235,3,3,1,7,0xb2d288fed
1400251.22,1.0,27,4,2,2,8,0xb2d57cb2
24162.31,1.0,8,2,2,3,7,0xb2d29620
89038.19,3.0,10,3,4,3,10,0x3b9b32db
275013.84,4.0,0,3,4,4,11,0xb2d8fada
2628.2,1.0,92,1,2,1,4,0xb2d1ee8a
411011.75,4.0,32,4,4,2,10,0xb2d1c229
4819.32,1.0,14,2,2,3,7,0xb2d6bd35
1100128.92,3.0,4,4,4,4,12,0xb2d97900
206402.68,2.0,295,3,3,1,7,0xb2d693bc
540039.82,3.0,11,4,4,3,11,0xb2d921f6
100346.52,2.0,14,3,3,3,9,0xb2d27462
10026.72,2.0,7,2,3,3,8,0xb2d0a22d
671966.89,4.0,4,4,4,4,12,0xb2d0880a
10192.34,1.0,92,2,2,1,5,0xb2d52ba3
107883.0,2.0,3,3,3,4,10,0xb2d53f41
17.23,1.0,83,1,2,1,4,0xb2d2cffa
10963.24,1.0,159,2,2,1,5,0xb2d58a39
0.0,1.0,8,1,2,3,6,0xb2d51e51
28.75,1.0,56,1,2,2,5,0xb2d79120
716.53,1.0,6,1,2,3,6,0xb2d5303d
404955.13,4.0,1,4,4,4,12,0xb2d61112
20000.84,2.0,56,2,3,2,7,0xb2d9c23f
242388.08,2.0,2,3,3,4,10,0x3b9af2c1
24706.53,4.0,0,2,4,4,10,0xb2d07fe1
230014.71,4.0,3,3,4,4,11,0xb2d24501d
3925.29,1.0,20,2,2,2,6,0xb2d60a4e
7568.85,1.0,20,2,2,2,6,0xb2d57f1dd
151618.11,2.0,0,3,3,4,10,0xb2d65ccb
2600000.0,2.0,4,4,3,4,11,0xb2d59a96
546.0,1.0,0,1,2,4,7,0xb2d1fc3d
45.39,1.0,126,1,2,1,4,0xb2d6fe5cd
599812.53,3.0,11,4,4,3,11,0xb2d429c0d
70187.11,1.0,13,3,2,3,8,0xb2d20a00
16.5,1.0,50,1,2,2,5,0xb2d42417
48443.81,3.0,33,2,4,2,8,0xb2d85dacd
898.25,1.0,0,1,2,4,7,0xb2d51f25
217576.91,2.0,27,3,3,2,8,0xb2d41010
500161.68,4.0,4,4,4,4,12,0xb2d2c515
37.45,1.0,13,1,2,3,6,0xb2d5d7f2
1.27,1.0,138,1,2,1,4,0xb2d91541d
70.86,1.0,0,1,2,4,7,0xb2d27bb7
4607.86,1.0,8,2,2,3,7,0xb2d6da65d
22785.7,1.0,9,2,2,3,7,0xb2d6df79
70002.43,3.0,27,3,4,2,9,0xb2d97028d
100100.2,2.0,31,3,3,2,8,0xb2d92510
21155.33,1.0,92,2,2,1,5,0xb2d358a7d
3090.46,1.0,293,2,2,1,5,0xb2d52b01
12.67,1.0,43,1,2,2,5,0xb2d993b5
320839.65,4.0,4,4,4,4,12,0xb2d1cb25d
172645.21,3.0,69,3,4,1,8,0xb2d1a62e
21304.05,1.0,10,2,2,3,7,0xb2d57acdd
2124.31,1.0,0,1,2,4,7,0xb2d26aaf
822004.58,5.0,1,4,4,4,12,0xb2d641c3d
240000.35,2.0,5,3,3,3,9,0xb2d6d327
10592.88,2.0,13,2,3,3,8,0xb2d54ce6
1233566.21,8.0,3,4,4,4,12,0xb2d36b1d
22090.57,1.0,11,2,2,3,7,0xb2d34992
100003.17,2.0,11,3,3,3,9,0xb2da3b80
1226.62,1.0,92,1,2,1,4,0xb2d062bad
23.05,1.0,59,1,2,2,5,0xb2d54f3e
32.59,1.0,4,1,2,4,7,0xb2d74b93
601421.22,4.0,45,4,4,2,10,0xb2d98cd6
1150002.57,5.0,0,4,4,4,12,0xb2d61cb6
2178.74,3.0,162,1,4,1,6,0xb2d48fb1
1478.37,1.0,138,1,2,1,4,0xb2d44c72d
4203.71,1.0,26,2,2,2,6,0xb2d639bf
535.29,1.0,0,1,2,4,7,0xb2d6d715
8076.73,1.0,20,2,2,2,6,0xb2d2d187d
2550312.2,5.0,122,4,4,1,9,0xb2d35acbd
230070.77,2.0,98,3,3,1,7,0xb2d583b3
200000.45,2.0,2,3,3,4,10,0xb2d6de46
19.22,1.0,76,1,2,1,4,0xb2d773ba
146.49,1.0,1,1,2,4,7,0xb2d1d48f
6406.93,1.0,0,2,2,4,8,0xb2d2bfd5
0.75,1.0,72,1,2,1,4,0xb2d349e7d
1001.41,1.0,301,1,2,1,4,0xb2d2666b
38087.66,1.0,0,2,2,4,8,0xb2d5916dd
7.82,1.0,11,1,2,3,6,0xb2d64235
0.28,2.0,1,1,3,4,8,0xb2d47039
2.53,1.0,11,1,2,3,6,0xb2d3a85a
75005.69,3.0,6,3,4,3,10,0xb2d5c4c6
107523.73,2.0,5,3,3,3,9,0xb2d40a51
229.41,1.0,42,1,2,2,5,0xb2d217bc
1356034.77,6.0,116,4,4,1,9,0xb2d1bedad
129.57,1.0,18,1,2,2,5,0xb2d8ce2a
52970.3,1.0,0,3,2,4,9,0xb2d92ee1
2599.89,1.0,10,1,2,3,6,0xb2d3750ed
544192.35,6.0,25,4,4,2,10,0xb2d3e9b1
187482.88,7.0,80,3,4,1,8,0xb2d16ddc
1320.14,1.0,184,1,2,1,4,0xb2d26d10
1764128.25,6.0,39,4,4,2,10,0xb2d24cb7
400000.83,2.0,5,4,3,3,10,0xb2d9db89
20982.04,1.0,9,2,2,3,7,0xb2d4a973
0.0,1.0,0,1,2,4,7,0xb2d505cf
0.21,1.0,83,1,2,1,4,0xb2d57a53d
405084.75,6.0,0,4,4,4,12,0xb2d1dfc9
122745.98,1.0,92,3,2,1,6,0xb2d4477b
41740.2,1.0,29,2,2,2,6,0xb2d31603
1000072.96,3.0,20,4,4,2,10,0xb2d5ce95d
400317.2,6.0,10,4,4,3,11,0xb2d1bfe2
2003.54,1.0,19,1,2,2,5,0xb2d0d115
413878.69,24.0,0,4,4,4,12,0x3b9b181fd
1110002.22,2.0,0,4,3,4,11,0xb2d8c575
400270.32,3.0,40,4,4,2,10,0xb2d5d838
273784.14,5.0,24,3,4,2,9,0x3b9b3655
7241.19,1.0,20,2,2,2,6,0xb2d74bec
200024.15,2.0,151,3,3,1,7,0xb2d2361e
130018.46,2.0,0,3,3,4,10,0xb2d3c8b6
2866.72,1.0,9,1,2,3,6,0xb2d31936
3040.83,1.0,0,2,2,4,8,0xb2d3097c
350591.7,2.0,0,4,3,4,11,0xb2d906c4
17458.97,10.0,0,2,4,4,10,0x3b9b172a
545607.05,8.0,24,4,4,2,10,0xb2d1aecb
10338.31,2.0,11,2,3,3,8,0xb2d5d0b1
717.04,2.0,133,1,3,1,5,0xb2d6ead1
45.28,1.0,38,1,2,2,5,0xb2d5c669
3005406.86,2.0,53,4,3,2,9,0xb2d23ed6
15736.92,1.0,18,2,2,2,6,0xb2d404a6
2356.86,1.0,10,1,2,3,6,0xb2d8dc06d
1476.64,1.0,14,1,2,3,6,0x3b9b3386
7764.5,1.0,0,2,2,4,8,0xb2d51eda
30344.86,2.0,80,2,3,1,6,0xb2d8a397d
80339.17,3.0,18,3,4,2,9,0xb2d9224dd
287050.85,5.0,31,3,4,2,9,0xb2d4179b
2985.56,1.0,23,2,2,2,6,0xb2d21664
2761.01,1.0,184,1,2,1,4,0xb2d134bf
377.98,14.0,3,1,4,4,9,0xb2d073e6d
25634.86,2.0,2,2,3,4,9,0xb2d64985
5266.08,1.0,265,2,2,1,5,0xb2d47068
423.95,1.0,92,1,2,1,4,0xb2d29366
45641.57,2.0,0,2,3,4,9,0x3b9b4598
56091.77,24.0,41,3,4,2,9,0xb2d217d8
250983.61,4.0,60,3,4,2,9,0xb2d5d814
4.52,1.0,69,1,2,1,4,0xb2d57763
5442.45,1.0,92,2,2,1,5,0xb2d37e5a
7821.81,2.0,0,2,3,4,9,0xb2d1566d
362325.82,4.0,32,4,4,2,10,0xb2d1a45e
80002.99,4.0,10,3,4,3,10,0xb2d166d5d
1480.18,1.0,52,1,2,2,5,0xb2d690d3d
607.24,1.0,0,1,2,4,7,0xb2d62013
500072.79,4.0,18,4,4,2,10,0xb2d1d05d
135836.85,4.0,27,3,4,2,9,0xb2d430f4d
658080.26,5.0,3,4,4,4,12,0x3b9b450c
20.39,1.0,7,1,2,3,6,0xb2d0f120
12150699.44,4.0,32,4,4,2,10,0xb2d65b4e
1.53,1.0,1,1,2,4,7,0xb2d2e977
60001.2,3.0,6,3,4,3,10,0xb2d52e35d
150006.33,2.0,35,3,3,2,8,0xb2d9f76c
900002.64,2.0,19,4,3,2,9,0xb2d95a52d
1043029.47,9.0,14,4,4,3,11,0xb2d42310
1615.92,1.0,28,1,2,2,5,0xb2d50c16
1960966.16,5.0,24,4,4,2,10,0xb2d56c23
150244.73,5.0,11,3,4,3,10,0xb2d3bedad
100003.17,2.0,10,3,3,3,9,0xb2d96063
4609.38,1.0,4,2,2,4,8,0xb2d7009dd
1206.56,1.0,0,1,2,4,7,0xb2d4ecc5
203475.29,3.0,193,3,4,1,8,0xb2d5316e
40000.42,2.0,74,2,3,1,6,0xb2d99faa
108858.68,4.0,8,3,4,3,10,0xb2d690d2d
1020.03,1.0,28,1,2,2,5,0xb2d2e64a
500001.35,2.0,25,4,3,2,9,0xb2d8c9d9
100149.23,3.0,245,3,4,1,8,0xb2d0ab22
500032.92,3.0,27,4,4,2,10,0x3b9b2e23d
1677.01,1.0,197,1,2,1,4,0xb2d243b5d
400081.19,4.0,9,4,4,3,11,0xb2d5ee6f
95035.54,2.0,175,3,3,1,7,0xb2d42060
11038.61,1.0,16,2,2,2,6,0xb2d5aca2
24529.75,7.0,6,2,4,3,9,0xb2d0b887d
120696.76,3.0,24,3,4,2,9,0xb2d5b042
55095.74,2.0,208,3,3,1,7,0xb2d2fc7ad
409835.12,3.0,19,4,4,2,10,0xb2d5eecd
767323.55,3.0,4,4,4,4,12,0xb2d4d329
5125.39,1.0,184,2,2,1,5,0xb2d4c811d
21.73,1.0,56,1,2,2,5,0xb2d5ae07
1002128.19,1.0,6,4,2,3,9,0xb2d43770
109708.71,2.0,4,3,3,4,10,0xb2d3c53c
1000099.45,3.0,10,4,4,3,11,0xb2d6a7c9
20000.0,1.0,83,2,2,1,5,0xb2d8d03d
7341.41,1.0,35,2,2,2,6,0xb2d90d14
18635.54,1.0,1,2,2,4,8,0xb2d2aadbd
37240.19,3.0,0,2,4,4,10,0xb2d5bc45
2500106.61,4.0,59,4,4,2,10,0xb2d0c118
63757.88,1.0,12,3,2,3,8,0xb2d48c52
2328.77,1.0,0,1,2,4,7,0xb2d83794
4801.52,1.0,25,2,2,2,6,0xb2d997f7
712456.25,4.0,0,4,4,4,12,0xb2d632b4
633.94,1.0,3,1,2,4,7,0xb2d2bdfe
32210.75,1.0,284,2,2,1,5,0xb2d3477e
301007.12,5.0,0,4,4,4,12,0xb2d1a9ef
6241.85,1.0,0,2,2,4,8,0xb2d3ec7d
1395.94,1.0,184,1,2,1,4,0xb2d1977ad
100005.28,2.0,20,3,3,2,8,0xb2da1a64
420135.87,2.0,6,4,3,3,10,0xb2d4aab1d
140688.02,3.0,70,3,4,1,8,0xb2d0cd5dd
1009.24,1.0,28,1,2,2,5,0xb2d6803a
108733.25,5.0,0,3,4,4,11,0xb2d0677d
203651.55,2.0,5,3,3,3,9,0xb2d4dbde
0.0,1.0,0,1,2,4,7,0xb2d6efae
1359027.76,4.0,1,4,4,4,12,0xb2d173d8
35.46,1.0,70,1,2,1,4,0xb2d6b87d
50061.72,2.0,27,2,3,2,7,0xb2d361f6
120.05,1.0,10,1,2,3,6,0xb2d8f695
8.7,1.0,26,1,2,2,5,0xb2d22afc
693342.78,8.0,0,4,4,4,12,0x3b9b4415
170005.71,4.0,19,3,4,2,9,0xb2d91fe2
266016.7,3.0,49,3,4,2,9,0xb2d58147
2015.29,2.0,184,1,3,1,5,0xb2d3dfc1
1706916.47,3.0,30,4,4,2,10,0xb2d1c394d
64307.09,2.0,14,3,3,3,9,0xb2d1053b
0.0,1.0,5,1,2,3,6,0xb2d241f0
151976.89,3.0,0,3,4,4,11,0xb2d54dee
6436.51,1.0,13,2,2,3,7,0xb2d6a400
16850.65,1.0,11,2,2,3,7,0xb2d13651d
560435.97,9.0,20,4,4,2,10,0xb2d32e43
18014.31,1.0,21,2,2,2,6,0xb2d60c53d
150458.4,2.0,0,3,3,4,10,0xb2d3dbd9d
100641.39,7.0,1,3,4,4,11,0x3b9af1e0d
955651.64,4.0,21,4,4,2,10,0xb2d1ba43
4046.78,1.0,26,2,2,2,6,0xb2d984d1
208243.1,2.0,98,3,3,1,7,0xb2d5af4c
10437.83,1.0,100,2,2,1,5,0xb2d3bf17
148003.12,2.0,67,3,3,1,7,0xb2d9add1
15003.11,2.0,203,2,3,1,6,0xb2d6acc9
104015.45,2.0,27,3,3,2,8,0xb2d61f01
7607.5,1.0,0,2,2,4,8,0xb2d995ab
755260.78,8.0,0,4,4,4,12,0xb2d51b2cd
12432.49,2.0,62,2,3,2,7,0xb2d647ad
140590.7,2.0,27,3,3,2,8,0xb2d1879e
110057.42,2.0,98,3,3,1,7,0xb2d131c3
1270021.4,4.0,62,4,4,2,10,0xb2d63639
1031.48,1.0,60,1,2,2,5,0xb2d763b1
373834.62,2.0,1,4,3,4,11,0xb2d0d988
700207.0,4.0,18,4,4,2,10,0xb2d5abb8
206732.25,2.0,28,3,3,2,8,0xb2d97c99
25021.72,2.0,94,2,3,1,6,0xb2d5e086
50027.56,2.0,164,2,3,1,6,0xb2d48b7f
25357.83,3.0,59,2,4,2,8,0xb2d2fb09
42.42,3.0,4,1,4,4,9,0xb2d08e59
10038.83,3.0,4,2,4,4,10,0x3b9b443f
461.35,1.0,101,1,2,1,4,0xb2d35c49
484459.48,4.0,92,4,4,1,9,0xb2d363f2
2084.96,1.0,81,1,2,1,4,0xb2d93da3
341005.74,4.0,25,4,4,2,10,0xb2d20b7e
3923.75,1.0,0,2,2,4,8,0xb2d36c36d
100001.06,2.0,6,3,3,3,9,0xb2da4def
500021.11,2.0,49,4,3,2,9,0xb2d9d49f
106556.97,3.0,14,3,4,3,10,0xb2d88000
50002.75,3.0,27,2,4,2,8,0xb2d9d54a
50.67,1.0,10,1,2,3,6,0xb2d27df5d
846.72,1.0,24,1,2,2,5,0xb2d46e2ed
2000020.88,6.0,3,4,4,4,12,0xb2d41177
15056.63,1.0,0,2,2,4,8,0xb2d94485
225024.61,4.0,0,3,4,4,11,0xb2d2d56b
6316.15,1.0,2,2,2,4,8,0xb2d6ecc2
213.97,1.0,0,1,2,4,7,0xb2d48e78
562325.42,6.0,95,4,4,1,9,0xb2d17937
0.11,1.0,69,1,2,1,4,0xb2d6a20a
16466.1,1.0,3,2,2,4,8,0xb2d65216
77005.47,3.0,49,3,4,2,9,0xb2d8fbd6
140003.25,3.0,19,3,4,2,9,0xb2d6e689
20774.09,2.0,231,2,3,1,6,0xb2d50ad3d
230207.52,5.0,33,3,4,2,9,0xb2d5dd54
2646.77,3.0,92,1,4,1,6,0xb2d0ef3c
68870.89,1.0,6,3,2,3,8,0xb2d189b1
562.14,1.0,0,1,2,4,7,0xb2d44103
0.0,1.0,29,1,2,2,5,0xb2d3627ed
299800.0,2.0,0,3,3,4,10,0xb2d9684d
3403.19,1.0,9,2,2,3,7,0xb2d2f53b
3760.64,1.0,81,2,2,1,5,0xb2d5873bd
350010.41,3.0,67,4,4,1,9,0xb2d500f7d
653985.61,1.0,7,4,2,3,9,0xb2d2f05f
24642.23,1.0,8,2,2,3,7,0xb2d91b4a
507289.51,8.0,25,4,4,2,10,0x3b9af18b
0.0,1.0,184,1,2,1,4,0xb2d2a5ee
100017.04,2.0,143,3,3,1,7,0xb2d3b5b7
1982975.09,8.0,19,4,4,2,10,0xb2d3a334
270272.4,2.0,31,3,3,2,8,0xb2d5cca8d
465000.0,12.0,3,4,4,4,12,0xb2d174d4
946803.64,10.0,87,4,4,1,9,0xb2d1a874
1144.01,1.0,10,1,2,3,6,0xb2d6eec6d
188.28,1.0,34,1,2,2,5,0xb2d62d99d
49912.36,1.0,10,2,2,3,7,0xb2d9d49d
173016.37,2.0,34,3,3,2,8,0xb2d5c054
128.49,1.0,9,1,2,3,6,0xb2d303fcd
350142.66,3.0,92,4,4,1,9,0xb2d11165
130120.29,2.0,1,3,3,4,10,0xb2da03b4
51753.22,2.0,154,2,3,1,6,0xb2d5af54d
50061.03,2.0,14,2,3,3,8,0xb2d21bb3
708044.43,4.0,0,4,4,4,12,0xb2d244dd
80002.24,3.0,0,3,4,4,11,0xb2d5a853
12177.4,1.0,2,2,2,4,8,0xb2d936b4
2840.4,1.0,93,1,2,1,4,0xb2d2f7fed
1.49,1.0,11,1,2,3,6,0xb2d913c0
50012.41,3.0,2,2,4,4,10,0xb2d11ac2
3919.67,1.0,35,2,2,2,6,0xb2d64d2a
3004048.27,15.0,3,4,4,4,12,0xb2d32f02
50096.09,2.0,214,2,3,1,6,0xb2d7590bd
1409.01,1.0,92,1,2,1,4,0xb2d2e96e
3925.31,1.0,28,2,2,2,6,0xb2d5a648
210036.77,3.0,4,3,4,4,11,0xb2d26e7ed
50041.92,2.0,179,2,3,1,6,0xb2d65753
50347.64,4.0,0,2,4,4,10,0x3b9b46ab
601741.39,3.0,15,4,4,3,11,0xb2d62225
2098.51,1.0,1,1,2,4,7,0xb2d25848
71723.32,7.0,13,3,4,3,10,0xb2d50a06
6739.04,1.0,38,2,2,2,6,0xb2d40570d
694.6,1.0,36,1,2,2,5,0xb2d9070b
43645.44,1.0,0,2,2,4,8,0xb2d5b451
5735.98,1.0,9,2,2,3,7,0xb2d53150
150596.16,4.0,60,3,4,2,9,0xb2d573dd
170000.0,2.0,0,3,3,4,10,0xb2d516a0d
3170023.52,1.0,0,4,2,4,10,0xb2d97740
841972.05,3.0,4,4,4,4,12,0xb2d17492d
1059429.19,2.0,61,4,3,2,9,0xb2d5866c
651.31,3.0,10,1,4,3,8,0xb2d0cf1c
70002.75,2.0,41,3,3,2,8,0xb2d913a5d
1293.52,1.0,10,1,2,3,6,0xb2d9332c
1479.91,1.0,20,1,2,2,5,0xb2d4a915
220878.84,2.0,210,3,3,1,7,0xb2d434b1
500076.28,2.0,2,4,3,4,11,0xb2d9d241
210000.0,2.0,0,3,3,4,10,0xb2da6c5b
83.51,1.0,26,1,2,2,5,0xb2d29812
80301.41,2.0,107,3,3,1,7,0xb2d50060
1008.61,1.0,19,1,2,2,5,0xb2d5b115
202409.09,2.0,97,3,3,1,7,0xb2d441af
91066.82,7.0,1,3,4,4,11,0xb2d0ecc9
70876.46,3.0,101,3,4,1,8,0xb2d625fa
250068.69,4.0,83,3,4,1,8,0xb2d527d7
242058.68,5.0,11,3,4,3,10,0xb2d0f9d1
178.89,1.0,38,1,2,2,5,0xb2d21a87
314027.57,2.0,0,4,3,4,11,0xb2d4a9b0
7035623.6,1.0,26,4,2,2,8,0xb2d93d8e
0.9,1.0,16,1,2,2,5,0xb2d64a86
552510.82,6.0,10,4,4,3,11,0xb2d175fe
258865.24,7.0,0,3,4,4,11,0xb2d175ff
10052.78,1.0,92,2,2,1,5,0xb2d476e6
222.65,1.0,8,1,2,3,6,0xb2d5d5fe
250000.04,2.0,5,3,3,3,9,0xb2d1a843d
458.86,1.0,0,1,2,4,7,0xb2d9e091
250012.25,3.0,1,3,4,4,11,0xb2d656dc
17061.65,1.0,11,2,2,3,7,0xb2d34550
170097.72,7.0,0,3,4,4,11,0xb2d57541
40054.63,1.0,0,2,2,4,8,0xb2d284d5
42050.25,1.0,0,2,2,4,8,0xb2d393e2
12.67,1.0,50,1,2,2,5,0xb2d9a786
95.98,1.0,51,1,2,2,5,0xb2d37c1f
353.95,1.0,0,1,2,4,7,0xb2d912db
11889.68,2.0,2,2,3,4,9,0x3b9b0fbd
200005.81,2.0,137,3,3,1,7,0xb2d911f9
6743.13,1.0,285,2,2,1,5,0xb2d12697d
2633.96,1.0,0,1,2,4,7,0xb2d8edca
100036.41,2.0,83,3,3,1,7,0xb2d8a27d
0.0,1.0,3,1,2,4,7,0xb2d9369e
55102.3,4.0,92,3,4,1,8,0xb2d109d3
10442.87,1.0,34,2,2,2,6,0xb2d1fc29d
9.77,1.0,18,1,2,2,5,0xb2d6396fd
57.59,1.0,10,1,2,3,6,0xb2d535d4
4314.09,1.0,0,2,2,4,8,0xb2d7edaf
13.84,1.0,0,1,2,4,7,0xb2d394a5
200264.26,2.0,160,3,3,1,7,0xb2d5ff3ad
22936.36,1.0,22,2,2,2,6,0xb2d45c2dd
370003.91,2.0,34,4,3,2,9,0xb2d93200
2110024.66,8.0,3,4,4,4,12,0xb2d65e0d
6059.49,1.0,92,2,2,1,5,0xb2d289e5d
880071.97,2.0,38,4,3,2,9,0xb2d25462
556640.69,2.0,10,4,3,3,10,0xb2d5aac8d
5013.48,1.0,13,2,2,3,7,0xb2d794de
603461.16,3.0,66,4,4,2,10,0xb2d2d79b
100061.28,2.0,203,3,3,1,7,0xb2d3b3f6
121.15,3.0,20,1,4,2,7,0xb2d37b4d
38.42,4.0,2,1,4,4,9,0xb2d3159c
2097.37,1.0,92,1,2,1,4,0xb2d0fc60
12.67,1.0,93,1,2,1,4,0xb2d97783d
8736.98,1.0,23,2,2,2,6,0xb2d215f9d
7621.48,1.0,131,2,2,1,5,0xb2d27a71
210012.79,2.0,98,3,3,1,7,0xb2d8db49d
451.95,1.0,2,1,2,4,7,0xb2d38d90
1.0,2.0,56,1,3,2,6,0xb2d5192a
291676.17,4.0,0,3,4,4,11,0xb2d41a4ed
583496.06,3.0,94,4,4,1,9,0xb2d0bc07d
0.0,1.0,10,1,2,3,6,0xb2d8fca4
6761.12,1.0,0,2,2,4,8,0xb2d69c73d
4.11,2.0,0,1,3,4,8,0xb2d202e6
102942.99,1.0,0,3,2,4,9,0xb2d6db1ad
229.59,1.0,45,1,2,2,5,0xb2d9021e
51344.04,1.0,184,2,2,1,5,0xb2d36224d
47188.09,1.0,0,2,2,4,8,0xb2d69c88
6.94,1.0,30,1,2,2,5,0xb2d6c19b
128393.1,1.0,89,3,2,1,6,0xb2d45275
1000002.15,10.0,17,4,4,2,10,0x3b9b4024d
1068580.38,2.0,0,4,3,4,11,0xb2d16c36
44766.3,1.0,4,2,2,4,8,0xb2d68f3a
994597.22,1.0,5,4,2,3,9,0xb2d97765
230002.43,2.0,13,3,3,3,9,0xb2d95cfe
15301.35,4.0,10,2,4,3,9,0x3b9b3493d
850008.89,4.0,23,4,4,2,10,0xb2d8d014d
0.0,2.0,18,1,3,2,6,0xb2d6fffd
1481.38,1.0,7,1,2,3,6,0xb2d221bad
50003.52,2.0,27,2,3,2,7,0xb2d59a3d
23123.73,2.0,8,2,3,3,8,0x3b9b29ad
50001.58,2.0,73,2,3,1,6,0xb2d8e030
60001.9,2.0,24,3,3,2,8,0xb2d9418c
103005.46,2.0,92,3,3,1,7,0xb2d65c64
70001.6,2.0,161,3,3,1,7,0xb2d6bdcd
109302.97,4.0,34,3,4,2,9,0xb2d5d0b4
5.0,1.0,83,1,2,1,4,0xb2d4e232
1200106.61,6.0,95,4,4,1,9,0xb2d51ed9d
9558.06,1.0,9,2,2,3,7,0xb2d4bdbd
10227.7,1.0,92,2,2,1,5,0xb2d17503
90314.19,3.0,15,3,4,3,10,0xb2d53f44d
40073.49,2.0,31,2,3,2,7,0xb2d3beb0d
2983.57,1.0,172,2,2,1,5,0xb2d24a98
100964.24,2.0,6,3,3,3,9,0xb2d64d60d
186.6,1.0,1,1,2,4,7,0xb2d250fe
20629.94,2.0,143,2,3,1,6,0xb2d55ea5
481.43,1.0,20,1,2,2,5,0xb2d2f4a7
733111.86,5.0,1,4,4,4,12,0xb2d1290d
140760.87,2.0,0,3,3,4,10,0xb2d4b684
3336.7,1.0,10,2,2,3,7,0xb2d42d41d
300065.63,2.0,8,3,3,3,9,0xb2d92b49
426003.46,6.0,24,4,4,2,10,0xb2d3a250
1754.11,1.0,7,1,2,3,6,0xb2d223e2
24000.0,1.0,0,2,2,4,8,0xb2d8c539
152115.78,3.0,1,3,4,4,11,0xb2d17c1d
18100.11,1.0,21,2,2,2,6,0xb2d159c0
25117.93,1.0,0,2,2,4,8,0xb2d43a3dd
1178.42,1.0,302,1,2,1,4,0xb2d20b89
111411.99,3.0,1,3,4,4,11,0xb2d687ba
44354.25,1.0,2,2,2,4,8,0xb2d18da7
303198.07,2.0,105,4,3,1,8,0xb2d7a73a
1051.49,1.0,9,1,2,3,6,0xb2d70157d
50392.45,2.0,112,2,3,1,6,0xb2d5798a
826007.62,8.0,11,4,4,3,11,0xb2d520fb
320045.49,2.0,5,4,3,3,10,0xb2d0bb9fd
1692.09,1.0,10,1,2,3,6,0xb2d2b961d
451.69,1.0,0,1,2,4,7,0xb2d2fea0d
7557.99,1.0,10,2,2,3,7,0xb2d6e929
3822.42,1.0,9,2,2,3,7,0xb2d26a2dd
11156.88,1.0,38,2,2,2,6,0xb2d355d3
32005.81,2.0,5,2,3,3,8,0xb2d9990e
103331.66,2.0,18,3,3,2,8,0xb2d44974
20289.82,2.0,29,2,3,2,7,0xb2d6dbc5
4072.88,1.0,0,2,2,4,8,0xb2d43fb5
50019.18,2.0,128,2,3,1,6,0xb2d229f4
10128.65,2.0,5,2,3,3,8,0xb2d1f129
34.96,1.0,0,1,2,4,7,0xb2d3c38fd
105083.37,4.0,0,3,4,4,11,0xb2d427f4d
271664.04,2.0,94,3,3,1,7,0x3b9b3167
2.64,1.0,55,1,2,2,5,0xb2d96c97
4359.11,1.0,184,2,2,1,5,0xb2d4e6ea
7506859.86,1.0,0,4,2,4,10,0xb2d91978d
1386349.8,5.0,66,4,4,2,10,0xb2d4fee8d
2453.75,1.0,9,1,2,3,6,0xb2d28f8b
90851.62,2.0,0,3,3,4,10,0xb2d0d94f
10234.95,2.0,20,2,3,2,7,0xb2d688a0
10000.61,2.0,27,2,3,2,7,0xb2d93400
1055.08,2.0,92,1,3,1,5,0xb2d08a58
200711.44,2.0,32,3,3,2,8,0xb2d8f57d
50000.53,2.0,21,2,3,2,7,0xb2da209b
200070.44,5.0,3,3,4,4,11,0xb2d746b2d
463.35,1.0,7,1,2,3,6,0xb2d2bf36
342.13,1.0,9,1,2,3,6,0xb2d7c55b
11649.65,2.0,27,2,3,2,7,0xb2d0e25fd
3121.0,1.0,18,2,2,2,6,0xb2d98b5b
911.55,1.0,73,1,2,1,4,0xb2d67ccb
233290.09,2.0,221,3,3,1,7,0xb2d0c6d4
10000.0,3.0,3,2,4,4,10,0xb2d91236
100001.06,2.0,45,3,3,2,8,0xb2d635b0d
223471.03,4.0,53,3,4,2,9,0xb2d607a4d
412289.31,3.0,3,4,4,4,12,0xb2d15251d
66.62,1.0,0,1,2,4,7,0xb2d42b4b
884334.46,9.0,26,4,4,2,10,0xb2d0cf6fd
292.26,1.0,48,1,2,2,5,0xb2d6d092
2375.05,1.0,184,1,2,1,4,0xb2d1c1da
1.72,1.0,69,1,2,1,4,0xb2d5dd8c
3185.04,1.0,0,2,2,4,8,0xb2d50a8cd
2004014.88,6.0,3,4,4,4,12,0xb2d22151
100488.0,4.0,34,3,4,2,9,0xb2d62c22
5109.35,1.0,9,2,2,3,7,0xb2d6aa30
2803.95,1.0,146,1,2,1,4,0xb2d5a9fc
206462.58,1.0,98,3,2,1,6,0xb2d4f424d
51540.32,1.0,13,2,2,3,7,0xb2d41df7
3635.6,1.0,0,2,2,4,8,0xb2d59169
8011.77,1.0,39,2,2,2,6,0xb2d5ac4bd
118295.13,1.0,7,3,2,3,8,0xb2d30bf9d
307301.22,5.0,0,4,4,4,12,0xb2d2d69a
19768.26,1.0,0,2,2,4,8,0xb2d69b58
6103.65,1.0,65,2,2,2,6,0xb2d28f3f
915457.81,5.0,52,4,4,2,10,0xb2d0c6f8
72336.03,1.0,6,3,2,3,8,0xb2d56aba
60000.0,2.0,4,3,3,4,10,0xb2da5920
5917.27,9.0,1,2,4,4,10,0xb2d69017
0.0,1.0,1,1,2,4,7,0xb2d4f734
1131008.78,14.0,11,4,4,3,11,0xb2d138e1d
16958624.52,35.0,0,4,4,4,12,0x3b9b1257
15140.27,1.0,1,2,2,4,8,0xb2d1c72bd
71019.05,2.0,14,3,3,3,9,0xb2d6298b
140002.65,3.0,158,3,4,1,8,0xb2d21c05
360036.77,2.0,6,4,3,3,10,0xb2d61bdc
60000.63,2.0,60,3,3,2,8,0xb2d9bf7f
31.14,1.0,55,1,2,2,5,0xb2d9713d
3986.14,1.0,17,2,2,2,6,0xb2d9243a
9895.51,1.0,10,2,2,3,7,0xb2d8d676
23564.99,1.0,23,2,2,2,6,0xb2d4187b
422131.8,2.0,0,4,3,4,11,0xb2d992ce
610000.02,4.0,13,4,4,3,11,0xb2d6cbfa
160000.81,4.0,0,3,4,4,11,0xb2d5ac21
239056.21,2.0,6,3,3,3,9,0xb2d5a45b
318227.76,4.0,1,4,4,4,12,0xb2d1dc65
576611.91,2.0,53,4,3,2,9,0xb2d32b87d
30008.55,2.0,90,2,3,1,6,0xb2d59c97
444015.46,5.0,0,4,4,4,12,0xb2d61494
4423.82,1.0,3,2,2,4,8,0xb2d31be7
2001.37,1.0,74,1,2,1,4,0xb2d8e5a2
3192.54,1.0,84,2,2,1,5,0xb2d8e629
550946.66,11.0,0,4,4,4,12,0xb2d24ffd
3113.8,1.0,0,2,2,4,8,0xb2d9c417
48.38,1.0,40,1,2,2,5,0xb2d337c8
300009.51,4.0,49,3,4,2,9,0xb2d97c7bd
9993.74,1.0,1,2,2,4,8,0xb2d374c3
200035.35,2.0,0,3,3,4,10,0xb2d43bf8d
31469.16,2.0,139,2,3,1,6,0xb2d37b88d
1040126.7,6.0,76,4,4,1,9,0xb2d61b2a
150000.0,2.0,101,3,3,1,7,0xb2d5680ad
200019.05,2.0,7,3,3,3,9,0xb2d70185
121190.86,5.0,1,3,4,4,11,0xb2d63384
919072.01,9.0,3,4,4,4,12,0xb2d622a0
32.35,1.0,49,1,2,2,5,0xb2d6bbe4
58979.02,1.0,0,3,2,4,9,0xb2d5dba3
10289.63,1.0,7,2,2,3,7,0xb2d6b723
8314.77,1.0,5,2,2,3,7,0xb2d2c472
225.08,1.0,77,1,2,1,4,0xb2d33380
463543.52,3.0,104,4,4,1,9,0xb2d14194
301465.61,3.0,60,4,4,2,10,0xb2d7f3df
630106.38,4.0,6,4,4,3,11,0xb2d3a833
41232.86,4.0,0,2,4,4,10,0xb2d94567
90071.35,2.0,136,3,3,1,7,0xb2d65477d
0.11,1.0,0,1,2,4,7,0xb2d6aa25d
58345.6,4.0,31,3,4,2,9,0xb2d1d696
100147.45,2.0,116,3,3,1,7,0xb2d3fdff
272399.69,6.0,0,3,4,4,11,0xb2d1739e
11222.27,1.0,0,2,2,4,8,0xb2d8d9ef
90004.14,5.0,31,3,4,2,9,0xb2d4fe1fd
25025.05,2.0,193,2,3,1,6,0xb2d6466e
150000.48,6.0,147,3,4,1,8,0xb2d07663
26207.16,9.0,0,2,4,4,10,0x3b9b1254
50071.51,2.0,6,2,3,3,8,0xb2da03c6
220017.56,4.0,171,3,4,1,8,0xb2d59f59d
170026.49,3.0,41,3,4,2,9,0xb2d13f4e
35662.13,1.0,92,2,2,1,5,0xb2d08fcd
131.32,1.0,15,1,2,3,6,0xb2d3ff47d
10032.12,1.0,184,2,2,1,5,0xb2d67d51
350713.59,3.0,4,4,4,4,12,0xb2d9358cd
100007.71,4.0,27,3,4,2,9,0xb2d24da8d
149.84,1.0,8,1,2,3,6,0xb2d2390e
504571.95,2.0,51,4,3,2,9,0xb2d62f8e
289618.14,3.0,111,3,4,1,8,0xb2d4ee29d
1003552.08,2.0,34,4,3,2,9,0xb2d9fc60
3664.61,3.0,92,2,4,1,7,0x3b9b35bcd
5000000.67,3.0,1,4,4,4,12,0xb2d76a57
1429.14,1.0,92,1,2,1,4,0xb2d11a66
110002.24,3.0,38,3,4,2,9,0xb2d15f13
9195.64,1.0,92,2,2,1,5,0xb2d0d3e3
774999.35,8.0,27,4,4,2,10,0xb2d0776f
1702359.87,13.0,3,4,4,4,12,0xb2d181a4
3720.15,1.0,40,2,2,2,6,0xb2d47cb4
399.39,2.0,15,1,3,3,7,0xb2d2e22bd
55243.0,1.0,7,3,2,3,8,0xb2d38406
3101.68,1.0,16,2,2,2,6,0xb2d93321
700780.59,3.0,0,4,4,4,12,0xb2d689aad
1000153.02,2.0,74,4,3,1,8,0xb2d1b879
200000.0,2.0,1,3,3,4,10,0xb2da68f8
1101776.55,8.0,8,4,4,3,11,0xb2d14a02
3777.48,1.0,8,2,2,3,7,0xb2d8c3dad
50001.58,2.0,185,2,3,1,6,0xb2d6ab18
200000.0,3.0,1,3,4,4,11,0xb2d1157c
7202.08,1.0,14,2,2,3,7,0xb2d8d5dc
12033.07,1.0,92,2,2,1,5,0xb2d13110
0.0,1.0,3,1,2,4,7,0xb2d61b33
5405.84,1.0,0,2,2,4,8,0xb2d6af2f
750013.54,6.0,38,4,4,2,10,0xb2d5e611
185010.76,5.0,55,3,4,2,9,0xb2d59087d
540250.15,3.0,6,4,4,3,11,0xb2d3d6b8
673121.94,3.0,8,4,4,3,11,0xb2d5e3f0
47766.88,1.0,24,2,2,2,6,0xb2d37b70
200194.44,2.0,11,3,3,3,9,0xb2d69cfc
302227.47,2.0,62,4,3,2,9,0xb2d6b5d0
306300.71,13.0,39,4,4,2,10,0x3b9b1b01
6000010.0,1.0,1,4,2,4,10,0xb2d97bd6
655.02,1.0,0,1,2,4,7,0xb2d2b607
123122.61,3.0,34,3,4,2,9,0xb2d390d4d
393219.8,2.0,136,4,3,1,8,0xb2d280d6
201798.56,1.0,0,3,2,4,9,0xb2d478a3
492001.63,9.0,3,4,4,4,12,0xb2d4cf05d
608901.56,2.0,0,4,3,4,11,0xb2d31541
503.34,1.0,0,1,2,4,7,0xb2d3ab78d
4054.6,1.0,3,2,2,4,8,0xb2d8e417d
502614.45,5.0,0,4,4,4,12,0xb2d5b0a9d
18.2,1.0,32,1,2,2,5,0xb2d594f3
600019.51,1.0,0,4,2,4,10,0xb2d687c5
0.0,1.0,2,1,2,4,7,0xb2d2c58b
140006.28,3.0,256,3,4,1,8,0x3b9b3e3b
7101.58,1.0,0,2,2,4,8,0xb2d973b0
710313.06,4.0,6,4,4,3,11,0xb2d472d9d
20354.49,2.0,256,2,3,1,6,0xb2d5c72c
1091.97,1.0,92,1,2,1,4,0xb2d3332fd
63745.89,2.0,23,3,3,2,8,0xb2d0e00a
1434.11,1.0,184,1,2,1,4,0xb2d3155e
370000.0,17.0,0,4,4,4,12,0xb2d1c29e
350056.41,5.0,4,4,4,4,12,0xb2d54c4dd
615451.37,13.0,0,4,4,4,12,0xb2d240cc
1632.27,1.0,9,1,2,3,6,0xb2d32ba6
86613.65,1.0,1,3,2,4,9,0xb2d4188d
201953.57,3.0,0,3,4,4,11,0xb2d1a917d
520049.46,4.0,13,4,4,3,11,0xb2d635cbd
3425.52,1.0,1,2,2,4,8,0xb2d0cbc1
823137.6,8.0,27,4,4,2,10,0xb2d4195d
2979.56,1.0,11,2,2,3,7,0xb2d6d3f3
33322.58,1.0,6,2,2,3,7,0xb2d6b4ddd
320012.52,3.0,132,4,4,1,9,0xb2d518ef
18460.62,1.0,184,2,2,1,5,0x3b9ad3a7
30000.63,2.0,67,2,3,1,6,0xb2d3b478
640032.46,4.0,21,4,4,2,10,0xb2d3a10d
160024.92,3.0,108,3,4,1,8,0xb2d105de
4211800.76,83.0,0,4,4,4,12,0x3b9b1258d
100021.36,2.0,112,3,3,1,7,0xb2d48f89
100009.07,2.0,92,3,3,1,7,0xb2d141e9d
2535.12,1.0,92,1,2,1,4,0xb2d5ddfe
53895.51,11.0,33,3,4,2,9,0xb2d2a185
801089.85,3.0,0,4,4,4,12,0xb2d5da92
12.54,1.0,42,1,2,2,5,0xb2d933a0
48919.26,1.0,1,2,2,4,8,0xb2d3cbe2
16643.27,1.0,3,2,2,4,8,0xb2d7c0b2d
1834768.88,6.0,67,4,4,1,9,0xb2d206f8
1041.33,1.0,92,1,2,1,4,0xb2d2ce81
310014.02,3.0,22,4,4,2,10,0xb2d5f2c1
200031.26,2.0,2,3,3,4,10,0xb2d97ebdd
3240.47,1.0,0,2,2,4,8,0xb2d6867a
3.24,1.0,0,1,2,4,7,0xb2d93034
632294.05,4.0,5,4,4,3,11,0xb2d40cb0d
330147.0,6.0,0,4,4,4,12,0xb2d8ed55
1748.89,1.0,25,1,2,2,5,0xb2d08155
877537.18,7.0,49,4,4,2,10,0xb2d14639
295002.99,3.0,5,3,4,3,10,0xb2d6c7ecd
162306.83,2.0,71,3,3,1,7,0xb2d68574
462573.0,5.0,1,4,4,4,12,0xb2d11eac
911.43,1.0,0,1,2,4,7,0xb2d30b06d
2082683.9,15.0,8,4,4,3,11,0xb2d175fdd
179.93,1.0,49,1,2,2,5,0xb2d487b3
309906.19,3.0,18,4,4,2,10,0xb2d28dd7d
460005.51,2.0,118,4,3,1,8,0xb2d5794c
50011.53,3.0,27,2,4,2,8,0xb2d56408
127984.91,2.0,0,3,3,4,10,0xb2d24789
14526.22,1.0,209,2,2,1,5,0xb2d3f698
1002.79,1.0,48,1,2,2,5,0xb2d6bb9d
80045.59,1.0,15,3,2,3,8,0xb2d153bf
1664670.64,5.0,17,4,4,2,10,0xb2d22634
50535.48,2.0,179,2,3,1,6,0xb2d634afd
221331.58,1.0,26,3,2,2,7,0xb2d650ab
3042.72,1.0,184,2,2,1,5,0xb2d24bf7
632.75,1.0,67,1,2,1,4,0xb2d369b1
2007.76,1.0,92,1,2,1,4,0xb2d3f6ed
68831.45,5.0,184,3,4,1,8,0xb2d26eb2
2.8,1.0,20,1,2,2,5,0xb2d30859
3933.54,1.0,0,2,2,4,8,0xb2d557be
200003.86,3.0,4,3,4,4,11,0xb2d6c909
854.2,1.0,92,1,2,1,4,0xb2d22ebdd
401.36,1.0,0,1,2,4,7,0xb2d2110d
14035.65,1.0,17,2,2,2,6,0xb2d6cab6
70329.14,1.0,266,3,2,1,6,0xb2d68b3d
2987.41,1.0,0,2,2,4,8,0xb2d503c7
88500.67,1.0,18,3,2,2,7,0xb2d5d129
529872.31,3.0,25,4,4,2,10,0xb2d204e2d
77919.19,4.0,26,3,4,2,9,0xb2d0d864
1370000.0,5.0,2,4,4,4,12,0xb2d5a0a2d
100004.22,2.0,63,3,3,2,8,0xb2d9b4fa
602110.97,3.0,11,4,4,3,11,0xb2d4ea94
130072.63,1.0,22,3,2,2,7,0xb2d9a136
4630.23,1.0,0,2,2,4,8,0xb2d51f2e
449727.6,6.0,42,4,4,2,10,0xb2d63743
172661.94,2.0,6,3,3,3,9,0xb2d59511
47.98,1.0,10,1,2,3,6,0xb2d5bdd2
793848.26,6.0,3,4,4,4,12,0xb2d4ac92
600000.0,2.0,22,4,3,2,9,0xb2da228f
500021.11,5.0,1,4,4,4,12,0xb2d8c3af
31393.68,1.0,184,2,2,1,5,0xb2d3f71d
1546.93,1.0,0,1,2,4,7,0xb2d259c3
271472.31,2.0,30,3,3,2,8,0xb2d180c2
210713.87,3.0,14,3,4,3,10,0xb2d36cccd
1701.6,1.0,98,1,2,1,4,0xb2d78c7f
130002.33,3.0,31,3,4,2,9,0xb2d8ddac
5.46,1.0,0,1,2,4,7,0xb2d6d342
569433.94,6.0,110,4,4,1,9,0xb2d1b856
17296.68,1.0,2,2,2,4,8,0xb2d0d9f1d
105000.37,7.0,15,3,4,3,10,0xb2d0f5ec
1014.99,1.0,92,1,2,1,4,0xb2d11fbf
1256.13,1.0,8,1,2,3,6,0xb2d2e9b1
200410.54,2.0,7,3,3,3,9,0xb2d905ba
4042.29,1.0,10,2,2,3,7,0xb2d17acc
1504.33,1.0,4,1,2,4,7,0xb2d7878a
150003.17,3.0,46,3,4,2,9,0xb2d9cc03
185.93,1.0,9,1,2,3,6,0xb2d4543c
3018.2,2.0,42,2,3,2,7,0xb2d96363
41.45,1.0,5,1,2,3,6,0xb2d6970b
350343.46,6.0,69,4,4,1,9,0xb2d6d8c7d
11.11,2.0,14,1,3,3,7,0xb2da3a40
3339.98,1.0,0,2,2,4,8,0xb2d1f405
694783.66,6.0,73,4,4,1,9,0xb2d23abfd
329004.07,4.0,0,4,4,4,12,0xb2d9845d
30003.43,2.0,6,2,3,3,8,0xb2d5821ad
1598.72,1.0,2,1,2,4,7,0xb2d3481b
163018.72,4.0,27,3,4,2,9,0xb2d5c203
100516.74,3.0,98,3,4,1,8,0xb2d610da
203823.62,3.0,4,3,4,4,11,0xb2d66919d
55112.3,2.0,92,3,3,1,7,0xb2d09330
1092.03,1.0,92,1,2,1,4,0xb2d3490ad
10344.49,1.0,162,2,2,1,5,0xb2d59715d
400008.0,3.0,0,4,4,4,12,0xb2d9790ed
210468.68,3.0,42,3,4,2,9,0xb2d24bca
577477.05,4.0,179,4,4,1,9,0xb2d119ae
20782.06,1.0,90,2,2,1,5,0xb2d59bdf
4565.82,1.0,0,2,2,4,8,0xb2d3ac8b
907.75,1.0,4,1,2,4,7,0xb2d86e4c
938014.74,4.0,11,4,4,3,11,0x3b9b4075d
301012.72,12.0,0,4,4,4,12,0xb2d1ebee
1040.24,1.0,3,1,2,4,7,0xb2d629cd
700009.31,6.0,11,4,4,3,11,0xb2d788d1
1776.86,1.0,139,1,2,1,4,0xb2d26bbc
1014861.32,5.0,1,4,4,4,12,0xb2d1733c
200152.58,2.0,2,3,3,4,10,0xb2d9bc02
200000.56,2.0,23,3,3,2,8,0xb2d906e4
5110.34,1.0,259,2,2,1,5,0xb2d32d8dd
1100132.95,3.0,39,4,4,2,10,0xb2d5bba4
1001.16,1.0,120,1,2,1,4,0xb2d91986
1025.12,1.0,184,1,2,1,4,0xb2d2cd6a
11662.3,1.0,0,2,2,4,8,0xb2d2ba01
581131.64,5.0,0,4,4,4,12,0xb2d9699b
10000.53,2.0,13,2,3,3,8,0xb2d6300b
1058.24,1.0,156,1,2,1,4,0xb2d2fb5f
79.86,1.0,62,1,2,2,5,0xb2d62da6
119004.31,6.0,31,3,4,2,9,0xb2d0bcf3
194078.77,3.0,1,3,4,4,11,0xb2d5c541
180009.51,3.0,153,3,4,1,8,0xb2d1af9fd
30057.61,1.0,0,2,2,4,8,0xb2d4517b
225326.03,4.0,136,3,4,1,8,0xb2d2a4f4
3549.03,1.0,29,2,2,2,6,0xb2d3e4b6d
1138.73,1.0,0,1,2,4,7,0xb2d6e5d4
264849.08,2.0,18,3,3,2,8,0xb2d5c342
4000.93,1.0,0,2,2,4,8,0xb2d9937a
494772.23,4.0,0,4,4,4,12,0x3b9b29d7
200000.0,2.0,3,3,3,4,10,0xb2d1d601
81094.95,2.0,60,3,3,2,8,0xb2d34416
1021.53,1.0,92,1,2,1,4,0xb2d2b666
227614.18,4.0,0,3,4,4,11,0xb2d80ef3d
186420.76,1.0,13,3,2,3,8,0xb2d34f78
175.66,1.0,29,1,2,2,5,0xb2d9c682
227003.87,5.0,1,3,4,4,11,0xb2d4159fd
110199.94,2.0,259,3,3,1,7,0xb2d160ba
1486.47,1.0,96,1,2,1,4,0xb2d5b384
370868.66,5.0,8,4,4,3,11,0xb2d6231a
13167.23,1.0,0,2,2,4,8,0xb2d6972cd
9989.83,1.0,4,2,2,4,8,0xb2d0c5a0
77.86,1.0,29,1,2,2,5,0xb2d287c1
13032.5,1.0,10,2,2,3,7,0xb2d60516
473573.82,5.0,3,4,4,4,12,0xb2d24be6
1290.03,1.0,25,1,2,2,5,0xb2d590c5
6699.07,1.0,24,2,2,2,6,0xb2d37ba8
59000.05,2.0,0,3,3,4,10,0xb2da45c7
254086.62,1.0,92,3,2,1,6,0xb2d09b58d
11127.95,2.0,184,2,3,1,6,0x3b9b3a94
14.08,1.0,20,1,2,2,5,0xb2d4a546
478.63,1.0,10,1,2,3,6,0xb2d434ba
2403.55,1.0,0,1,2,4,7,0xb2d2fb57
5024.85,1.0,92,2,2,1,5,0xb2d4be15
500089.91,2.0,27,4,3,2,9,0xb2d93ed7
1002.81,1.0,92,1,2,1,4,0xb2d63120
40.22,1.0,139,1,2,1,4,0xb2d61562
6996.42,1.0,230,2,2,1,5,0xb2d44d23d
133.34,2.0,19,1,3,2,6,0xb2da257f
439837.81,2.0,13,4,3,3,10,0xb2d6afb1
51079.92,2.0,102,2,3,1,6,0xb2d617d5
70005.07,2.0,42,3,3,2,8,0xb2d40998
600022.07,9.0,11,4,4,3,11,0xb2d37789
1008.88,1.0,92,1,2,1,4,0xb2d2bcead
84256.52,5.0,0,3,4,4,11,0x3b9af196
3.71,1.0,67,1,2,1,4,0xb2d566b6
97.89,1.0,12,1,2,3,6,0xb2d8d39b
120150.78,2.0,74,3,3,1,7,0xb2d57857
80081.39,2.0,8,3,3,3,9,0xb2d69d13d
141.84,1.0,68,1,2,1,4,0xb2d1d6bd
98082.46,5.0,0,3,4,4,11,0xb2d2bb67
1100000.0,6.0,4,4,4,4,12,0xb2d99ac2
661.2,1.0,61,1,2,2,5,0xb2d8d0f7d
211.85,1.0,62,1,2,2,5,0xb2d58f5bd
1069.76,1.0,184,1,2,1,4,0xb2d20221d
5025.43,1.0,92,2,2,1,5,0xb2d40d5e
2000000.0,2.0,26,4,3,2,9,0xb2d947ea
2789.46,4.0,4,1,4,4,9,0xb2d3c22c
15393.37,1.0,7,2,2,3,7,0xb2d4c829d
73932.75,1.0,15,3,2,3,8,0xb2d58b5cd
3528.53,1.0,0,2,2,4,8,0xb2d4cc4a
1.0,1.0,184,1,2,1,4,0xb2d29f0cd
200724.0,2.0,39,3,3,2,8,0xb2d25725
170951.23,4.0,77,3,4,1,8,0x3b9b42ab
90093.66,5.0,70,3,4,1,8,0xb2d641bc
5183.99,1.0,77,2,2,1,5,0xb2d970b4
20653.71,1.0,0,2,2,4,8,0xb2d92b3e
5924.33,1.0,2,2,2,4,8,0xb2d1bc4f
20395.29,1.0,182,2,2,1,5,0xb2d5efd1
500132.7,2.0,104,4,3,1,8,0xb2d26b74d
550000.8,3.0,20,4,4,2,10,0xb2d6ed26
500000.0,2.0,20,4,3,2,9,0xb2da27eb
5652.81,1.0,0,2,2,4,8,0xb2d63618d
1746.09,1.0,3,1,2,4,7,0xb2d62fc9
0.0,1.0,0,1,2,4,7,0xb2d33dce
550000.65,4.0,33,4,4,2,10,0xb2d5b0e3
450177.49,7.0,11,4,4,3,11,0xb2d634b2d
201.93,1.0,8,1,2,3,6,0xb2d8f897
1624.54,1.0,0,1,2,4,7,0xb2d3d674
599015.06,4.0,4,4,4,4,12,0xb2d110af
440069.41,8.0,11,4,4,3,11,0xb2d3625bd
190069.17,4.0,1,3,4,4,11,0xb2d3fe9e
945313.15,10.0,41,4,4,2,10,0xb2d0a55e
2056.07,1.0,237,1,2,1,4,0xb2d58f6e
504037.9,3.0,29,4,4,2,10,0xb2d9b94e
1933.78,1.0,7,1,2,3,6,0xb2d1a39a
2171.97,1.0,6,1,2,3,6,0xb2d6c266
18555.47,1.0,6,2,2,3,7,0xb2d3a442
82.8,1.0,19,1,2,2,5,0xb2d6eabf
630865.92,4.0,7,4,4,3,11,0x3b9b29ded
96086.72,1.0,253,3,2,1,6,0xb2d562b9
600099.05,4.0,104,4,4,1,9,0xb2d0efe1
400090.32,3.0,6,4,4,3,11,0xb2d4c3f5
4.99,1.0,1,1,2,4,7,0xb2d0ed53
1792809.01,3.0,4,4,4,4,12,0xb2d6ac72
484712.05,4.0,0,4,4,4,12,0xb2d1cd57
269432.26,3.0,104,3,4,1,8,0xb2d12bbed
245006.3,5.0,129,3,4,1,8,0xb2d6434c
30004.96,2.0,27,2,3,2,7,0xb2d698b9
260058.71,2.0,172,3,3,1,7,0xb2d638c3
272937.92,8.0,0,3,4,4,11,0xb2d0b4bd
236.93,1.0,1,1,2,4,7,0xb2d6edb9
2422.14,1.0,5,1,2,3,6,0xb2d66539
1001.17,1.0,121,1,2,1,4,0xb2d91997
197400.0,4.0,0,3,4,4,11,0xb2d254f6
330489.95,3.0,92,4,4,1,9,0xb2d06b1e
10000951.0,2.0,0,4,3,4,11,0xb2d893ff
17.99,1.0,17,1,2,2,5,0xb2d944f3
410066.43,2.0,231,4,3,1,8,0xb2d24d98d
500194.33,2.0,109,4,3,1,8,0xb2d2a059
30037.09,2.0,130,2,3,1,6,0xb2d0b95c
3742.63,3.0,184,2,4,1,7,0xb2d3ffbc
2.12,1.0,34,1,2,2,5,0xb2d6bbf7d
43083.93,2.0,58,2,3,2,7,0xb2d1c7a4
1218.59,1.0,184,1,2,1,4,0xb2d2e002
26521.83,2.0,0,2,3,4,9,0xb2d31552d
220004.38,2.0,14,3,3,3,9,0xb2d96025
11545.21,2.0,0,2,3,4,9,0xb2d0d8f7
2373.99,1.0,184,1,2,1,4,0xb2d31dc6
112456.27,3.0,139,3,4,1,8,0xb2d17237
221694.07,3.0,30,3,4,2,9,0xb2d6d7bb
1167796.53,11.0,39,4,4,2,10,0x3b9b276b
366.44,1.0,6,1,2,3,6,0xb2d7bfe7
269634.52,16.0,5,3,4,3,10,0xb2d0690f
200000.0,2.0,21,3,3,2,8,0xb2d8d510d
601.5,1.0,11,1,2,3,6,0xb2d4be1e
2243.39,1.0,0,1,2,4,7,0xb2d25ed1
520897.44,6.0,13,4,4,3,11,0xb2d3171cd
1524.88,1.0,184,1,2,1,4,0xb2d2e495d
4199.32,1.0,7,2,2,3,7,0xb2d3422d
805753.33,6.0,60,4,4,2,10,0xb2d2774e
3417.2,1.0,9,2,2,3,7,0xb2d95864
105065.81,1.0,28,3,2,2,7,0xb2d55d5f
15201.59,1.0,92,2,2,1,5,0xb2d3b6d8d
52018.07,2.0,179,2,3,1,6,0xb2d55d0a
154009.31,3.0,69,3,4,1,8,0xb2d63ebf
527008.85,18.0,11,4,4,3,11,0xb2d40bf4
150309.26,1.0,5,3,2,3,8,0xb2d2bca6
280045.38,4.0,45,3,4,2,9,0xb2d43bd0
294363.9,3.0,1,3,4,4,11,0xb2d21bc8
144348.57,4.0,5,3,4,3,10,0xb2d6330a
691.89,1.0,13,1,2,3,6,0xb2d8ef1f
1388.39,1.0,184,1,2,1,4,0xb2d47bb6
670009.58,9.0,0,4,4,4,12,0xb2d62dfa
95.0,2.0,43,1,3,2,6,0xb2d9340c
1095098.78,4.0,1,4,4,4,12,0xb2d1baf1
590074.25,3.0,67,4,4,1,9,0xb2d5a561d
350040.0,2.0,12,4,3,3,10,0xb2d96307
9.1,1.0,1,1,2,4,7,0xb2d6355e
11.35,1.0,9,1,2,3,6,0xb2d48da8
581426.6,3.0,3,4,4,4,12,0xb2d6caefd
200007.13,5.0,47,3,4,2,9,0xb2d1cb32
5329.51,1.0,4,2,2,4,8,0xb2d91f50
93512.53,1.0,10,3,2,3,8,0xb2d63bbe
115350.0,2.0,5,3,3,3,9,0xb2d93e8d
316034.0,2.0,16,4,3,2,9,0xb2d5d71e
3542.76,1.0,0,2,2,4,8,0xb2d50ccfd
1180.88,1.0,124,1,2,1,4,0xb2d3bc6f
21489.86,2.0,0,2,3,4,9,0xb2d37ad5d
2804.22,1.0,36,1,2,2,5,0xb2d636ff
0.0,1.0,99,1,2,1,4,0x3b9af018
1510.18,1.0,10,1,2,3,6,0xb2d2bf73
3055.58,1.0,184,2,2,1,5,0xb2d28068
1260052.35,8.0,11,4,4,3,11,0xb2d54b13
865.21,1.0,1,1,2,4,7,0xb2d6c1b2
1570.61,14.0,0,1,4,4,9,0x3b9adcd0d
500000.0,2.0,0,4,3,4,11,0xb2da6c7c
57592.27,2.0,73,3,3,1,7,0xb2d4e639
40001.27,2.0,11,2,3,3,8,0xb2da3b63
400332.35,10.0,0,4,4,4,12,0xb2d090ca
1126317.34,7.0,112,4,4,1,9,0xb2d4dced
300080.88,4.0,205,3,4,1,8,0xb2d1b146
357.1,1.0,167,1,2,1,4,0xb2d4528cd
20165.89,1.0,184,2,2,1,5,0xb2d5f279
212147.93,2.0,164,3,3,1,7,0xb2d1c6f2d
24082.0,1.0,0,2,2,4,8,0xb2d0e6eb
50389.3,2.0,63,2,3,2,7,0xb2d9af82
0.53,1.0,105,1,2,1,4,0xb2d95d3b
2463.93,1.0,92,1,2,1,4,0xb2d22ee1
95.0,1.0,24,1,2,2,5,0xb2d8ef08
241986.99,3.0,95,3,4,1,8,0xb2d15d5b
77341532.8,3.0,8,4,4,3,11,0xb2d9099fd
300769.1,3.0,25,4,4,2,10,0xb2d4374c
110002.53,4.0,6,3,4,3,10,0xb2d6e6b0
3.31,1.0,60,1,2,2,5,0xb2d688b7
9478.34,2.0,92,2,3,1,6,0xb2d087add
1.32,1.0,6,1,2,3,6,0xb2d43a60
291117.15,3.0,11,3,4,3,10,0xb2d1a6cad
1000036.8,3.0,74,4,4,1,9,0xb2d15f7a
17541.23,3.0,0,2,4,4,10,0x3b9b34ee
111522.86,1.0,10,3,2,3,8,0xb2d2c731
101766.04,2.0,157,3,3,1,7,0xb2d5f3b0
31741.67,2.0,4,2,3,4,9,0xb2d315bbd
274798.85,2.0,108,3,3,1,7,0xb2d11292d
350096.15,4.0,80,4,4,1,9,0xb2d2b01c
7781.39,1.0,4,2,2,4,8,0xb2d38f92
120131.73,1.0,10,3,2,3,8,0xb2d9523b
5357.78,1.0,0,2,2,4,8,0xb2d65d7c
200000.0,2.0,7,3,3,3,9,0xb2da4000
207006.42,3.0,116,3,4,1,8,0xb2d93061
11121.2,1.0,0,2,2,4,8,0xb2d30255
244290.87,2.0,18,3,3,2,8,0xb2d1c6dd
300015.87,2.0,209,3,3,1,7,0xb2d68050
7.41,1.0,20,1,2,2,5,0xb2d1d9f4
6737.16,2.0,152,2,3,1,6,0xb2d17e3b
2082.22,1.0,92,1,2,1,4,0xb2d3e843
40055.9,3.0,174,2,4,1,7,0xb2d7869e
764509.79,7.0,13,4,4,3,11,0xb2d155c4
50000.0,2.0,0,2,3,4,9,0xb2d4b129
2458.42,1.0,92,1,2,1,4,0xb2d3a8a7
2481302.88,23.0,0,4,4,4,12,0xb2d5fca4d
35001.48,2.0,69,2,3,1,6,0xb2d8e695
282.56,1.0,1,1,2,4,7,0xb2d90c7c
97.34,1.0,74,1,2,1,4,0xb2d8dd26d
162814.22,2.0,24,3,3,2,8,0xb2d29656d
387348.43,4.0,0,4,4,4,12,0xb2d0680ed
535674.38,3.0,5,4,4,3,11,0xb2d24333d
17822.17,1.0,9,2,2,3,7,0xb2d2ff6c
3030968.98,4.0,3,4,4,4,12,0xb2d1b951
60000.0,3.0,0,3,4,4,11,0xb2d0b34d
1218.6,1.0,0,1,2,4,7,0xb2d6a261
213.0,1.0,0,1,2,4,7,0xb2d4f6bf
21280.15,1.0,29,2,2,2,6,0xb2d3395bd
500011.04,7.0,0,4,4,4,12,0xb2d2bd7e
11201.29,2.0,82,2,3,1,6,0xb2d78ef3d
1943631.41,4.0,10,4,4,3,11,0xb2d5aab4
1302.24,1.0,7,1,2,3,6,0xb2d6cc06
51003.4,1.0,92,2,2,1,5,0xb2d381ddd
759.46,1.0,16,1,2,2,5,0xb2d45cb8
1063319.67,8.0,80,4,4,1,9,0xb2d302e8d
150006.38,2.0,136,3,3,1,7,0xb2d55e97
4785.97,1.0,2,2,2,4,8,0xb2d240e5
0.0,1.0,8,1,2,3,6,0xb2d58c07
1500166.95,3.0,2,4,4,4,12,0xb2d4497d
480000.85,4.0,5,4,4,3,11,0xb2d68297d
200031.27,2.0,1,3,3,4,10,0xb2d8b0b2
20167.05,1.0,184,2,2,1,5,0xb2d37113
1720016.6,3.0,0,4,4,4,12,0xb2d904edd
411484.42,2.0,28,4,3,2,9,0xb2d6b668
42.15,1.0,35,1,2,2,5,0xb2d6fc2d
216065.41,4.0,11,3,4,3,10,0xb2d20ab6
30000.95,2.0,11,2,3,3,8,0xb2da2c30
5340.31,1.0,7,2,2,3,7,0xb2d3e86b
50042.27,2.0,78,2,3,1,6,0xb2d28085
55291.16,7.0,180,3,4,1,8,0xb2d26e59
42092.42,4.0,8,2,4,3,9,0xb2d30b9a
5066.99,1.0,184,2,2,1,5,0xb2d2192c
2848.92,1.0,92,1,2,1,4,0xb2d14d3b
274051.69,4.0,4,3,4,4,11,0xb2d25216
101140.04,1.0,3,3,2,4,9,0xb2d61263
25661.79,1.0,0,2,2,4,8,0xb2d5ad7b
32.09,1.0,50,1,2,2,5,0xb2d6e00e
130002.74,2.0,102,3,3,1,7,0xb2d96532d
46.29,1.0,39,1,2,2,5,0xb2d181b1
73.51,1.0,9,1,2,3,6,0xb2d48174d
500002.0,2.0,0,4,3,4,11,0xb2d69e5d
787.28,6.0,5,1,4,3,8,0xb2d10b6b
78922.39,1.0,18,3,2,2,7,0xb2d5e186d
60524.24,2.0,23,3,3,2,8,0xb2d6288fd
11677475.27,17.0,0,4,4,4,12,0xb2d244a6
2241050.68,4.0,0,4,4,4,12,0xb2d524f3d
131157.41,2.0,39,3,3,2,8,0xb2d3abba
155002.22,3.0,47,3,4,2,9,0xb2d9136d
1795112.38,9.0,31,4,4,2,10,0xb2d1f508d
500011.11,2.0,19,4,3,2,9,0xb2d8c3c7d
180002.95,3.0,167,3,4,1,8,0xb2d6ab82
240012.65,2.0,14,3,3,3,9,0xb2d10eab
1360.54,1.0,184,1,2,1,4,0x3b9b2428
501776.04,2.0,36,4,3,2,9,0xb2d9fab4
130727.05,3.0,0,3,4,4,11,0xb2d6b29f
600035.24,2.0,1,4,3,4,11,0xb2d80420
520406.99,5.0,76,4,4,1,9,0xb2d2d578
172001.61,4.0,5,3,4,3,10,0xb2d8c359
310009.93,3.0,20,4,4,2,10,0xb2d91894
35628.84,1.0,164,2,2,1,5,0xb2d5c8ca
329.44,1.0,10,1,2,3,6,0xb2d561a6d
507248.27,4.0,4,4,4,4,12,0xb2d1786e
3315.51,1.0,3,2,2,4,8,0xb2d700a1
110080.0,2.0,8,3,3,3,9,0xb2d225c7d
97.92,1.0,8,1,2,3,6,0xb2d5d28c
506208.68,4.0,1,4,4,4,12,0xb2d38dc4
140007.29,3.0,27,3,4,2,9,0xb2d9f1b5
2662.25,1.0,7,1,2,3,6,0xb2d2a29ed
240600.03,7.0,0,3,4,4,11,0xb2d142c6
674033.66,4.0,14,4,4,3,11,0xb2d6c0e4
120084.06,2.0,27,3,3,2,8,0xb2d642b7
90052.11,3.0,189,3,4,1,8,0xb2d0fccd
29.62,1.0,93,1,2,1,4,0xb2d25ff4
426279.95,6.0,10,4,4,3,11,0x3b9b2848
200086.09,2.0,143,3,3,1,7,0xb2d2e46bd
664002.46,5.0,82,4,4,1,9,0xb2d256b9
2.17,1.0,18,1,2,2,5,0xb2d5cf9ad
84477.9,3.0,0,3,4,4,11,0xb2d7045ad
2748529.4,7.0,1,4,4,4,12,0xb2d0bb52
49950.78,1.0,0,2,2,4,8,0xb2d34fdc
174666.26,1.0,0,3,2,4,9,0xb2d35b04
138902.03,6.0,0,3,4,4,11,0xb2d064a9
180157.11,1.0,0,3,2,4,9,0xb2d2bca6d
650000.24,9.0,4,4,4,4,12,0xb2d22bb1
170010.58,2.0,125,3,3,1,7,0xb2d18153
101512.34,2.0,108,3,3,1,7,0xb2d1e092
260071.75,5.0,14,3,4,3,10,0xb2d3c64c
1580989.07,3.0,0,4,4,4,12,0xb2d1250c
145.82,1.0,9,1,2,3,6,0xb2d936d9
83013.52,3.0,0,3,4,4,11,0xb2d091df
593753.49,5.0,24,4,4,2,10,0xb2d627fad
400892.5,8.0,28,4,4,2,10,0xb2d621aa
57874.61,1.0,15,3,2,3,8,0xb2d3183ed
200002.95,2.0,10,3,3,3,9,0xb2d9a670
21683.26,1.0,12,2,2,3,7,0xb2d6c2c4d
356461.78,6.0,1,4,4,4,12,0xb2d384e4d
3000169.64,19.0,0,4,4,4,12,0xb2d548f9
130.63,1.0,30,1,2,2,5,0xb2d8e302
50013.45,3.0,12,2,4,3,9,0xb2d6af67
2568.79,1.0,14,1,2,3,6,0xb2d4f1cb
120007.37,2.0,228,3,3,1,7,0xb2d60d2b
8421.69,1.0,0,2,2,4,8,0xb2d69fb5
100047.88,2.0,193,3,3,1,7,0xb2d38482
10004.04,2.0,18,2,3,2,7,0xb2d18f66
615343.65,5.0,18,4,4,2,10,0xb2d58de0d
901758.86,4.0,39,4,4,2,10,0xb2d540ba
80294.02,11.0,0,3,4,4,11,0x3b9b264a
6520.62,2.0,0,2,3,4,9,0xb2d18f99d
375409.63,3.0,0,4,4,4,12,0xb2d6c35f
101362.81,5.0,11,3,4,3,10,0xb2d64c60d
10295.67,1.0,125,2,2,1,5,0xb2d52ad5
459911.48,2.0,92,4,3,1,8,0x3b9ad3dd
24288.76,4.0,164,2,4,1,7,0xb2d0b169
157412.74,2.0,52,3,3,2,8,0xb2d518b1
500.26,1.0,3,1,2,4,7,0xb2d60199
500190.61,3.0,11,4,4,3,11,0xb2d46354
39897.19,1.0,18,2,2,2,6,0xb2d3f30c
404962.36,9.0,1,4,4,4,12,0xb2d25176
1.45,1.0,3,1,2,4,7,0xb2d590d9d
45306.92,5.0,18,2,4,2,8,0xb2d17106
62671.99,1.0,92,3,2,1,6,0xb2d22307d
180016.81,3.0,10,3,4,3,10,0xb2d100a3
1177.76,1.0,1,1,2,4,7,0xb2d6f22d
5298.12,1.0,8,2,2,3,7,0xb2d56a64
2854.19,1.0,4,1,2,4,7,0xb2d5c488
240.0,1.0,4,1,2,4,7,0xb2d8e70f
203865.08,2.0,122,3,3,1,7,0xb2d8c42e
35.69,1.0,74,1,2,1,4,0xb2d59936d
200000.0,5.0,2,3,4,4,11,0xb2d410fa
1785.62,1.0,2,1,2,4,7,0xb2d24bd1
41.76,1.0,2,1,2,4,7,0xb2d8e2a0
259629.49,3.0,0,3,4,4,11,0xb2d51038d
160006.77,2.0,188,3,3,1,7,0xb2d6a624
0.0,1.0,63,1,2,2,5,0xb2d9763b
516.77,1.0,44,1,2,2,5,0xb2d191a7
100102.38,2.0,103,3,3,1,7,0xb2d12708
506883.64,5.0,179,4,4,1,9,0xb2d5b341d
320004.33,3.0,10,4,4,3,11,0xb2d62d9e
20803.63,2.0,92,2,3,1,6,0x3b9ade66d
3373.53,1.0,0,2,2,4,8,0xb2d45bfb
10566.81,1.0,21,2,2,2,6,0xb2d9864b
16.4,1.0,57,1,2,2,5,0xb2d627ca
1177.38,1.0,2,1,2,4,7,0xb2d71788
111382.2,1.0,52,3,2,2,7,0xb2d6d460
538.81,1.0,10,1,2,3,6,0xb2da309f
879001.17,8.0,0,4,4,4,12,0xb2d09bf7
319.3,1.0,33,1,2,2,5,0xb2d1cb55
500080.89,2.0,0,4,3,4,11,0xb2d8e7a3
19001.8,2.0,34,2,3,2,7,0xb2d5c310
500857.16,7.0,94,4,4,1,9,0xb2d0ebba
47.22,1.0,48,1,2,2,5,0xb2d33b24
170034.12,4.0,77,3,4,1,8,0xb2d0ed54d
11109.14,1.0,2,2,2,4,8,0xb2d316be
17765.44,1.0,0,2,2,4,8,0xb2d6c48b
100141.06,2.0,20,3,3,2,8,0xb2d3cd36d
30514.59,2.0,231,2,3,1,6,0xb2d62956
14354.32,1.0,0,2,2,4,8,0xb2d6bfa1
6110.29,1.0,3,2,2,4,8,0xb2d6dc8c
178054.74,2.0,32,3,3,2,8,0xb2d580edd
262824.4,3.0,36,3,4,2,9,0xb2d9b2aa
14079.48,1.0,116,2,2,1,5,0xb2d5480a
1010935.23,5.0,56,4,4,2,10,0xb2d265fad
500042.22,2.0,18,4,3,2,9,0xb2d4a2c5
100281.48,2.0,189,3,3,1,7,0xb2d32dea
44466.42,1.0,6,2,2,3,7,0xb2d8f736
7980.99,1.0,183,2,2,1,5,0xb2d4384a
500000.08,2.0,10,4,3,3,10,0xb2d7fbcf
400000.0,3.0,1,4,4,4,12,0xb2d6e427
30000.95,2.0,10,2,3,3,8,0xb2d961f8
7398.73,1.0,35,2,2,2,6,0xb2d4126f
61822.99,2.0,139,3,3,1,7,0xb2d5ca28d
0.11,1.0,184,1,2,1,4,0xb2d1447f
509.04,1.0,0,1,2,4,7,0xb2d53047
200164.28,1.0,5,3,2,3,8,0xb2d3546d
362460.36,7.0,1,4,4,4,12,0xb2d29f06d
220021.51,3.0,1,3,4,4,11,0xb2d950c0
82002.15,5.0,116,3,4,1,8,0xb2d4f160d
42.03,1.0,14,1,2,3,6,0xb2d21a7ed
6067.87,1.0,0,2,2,4,8,0xb2d8ea55
500928.88,4.0,21,4,4,2,10,0xb2d21811
308344.9,4.0,87,4,4,1,9,0xb2d0940cd
689.75,1.0,92,1,2,1,4,0xb2d11ec3
1058006.68,3.0,21,4,4,2,10,0xb2d280a9
38441.73,1.0,18,2,2,2,6,0xb2d2392f
0.74,1.0,68,1,2,1,4,0xb2d5b5d3
270050.59,5.0,0,3,4,4,11,0xb2d24581
505329.86,2.0,41,4,3,2,9,0xb2d83860
22088.33,2.0,1,2,3,4,9,0xb2d49167
3741.17,1.0,1,2,2,4,8,0xb2d3d2b8d
0.0,1.0,7,1,2,3,6,0xb2d95768
700000.0,2.0,193,4,3,1,8,0xb2d4837b
67457.13,3.0,221,3,4,1,8,0x3b9b3d19d
0.0,1.0,0,1,2,4,7,0xb2d480ef
320020.94,3.0,14,4,4,3,11,0xb2d1a6e5
2731.18,2.0,204,1,3,1,5,0xb2d1aafc
610000.42,5.0,3,4,4,4,12,0xb2d68638d
320018.93,2.0,231,4,3,1,8,0xb2d6e2fbd
14432.25,1.0,4,2,2,4,8,0xb2d93cd8
157089.64,3.0,0,3,4,4,11,0xb2d3a0aa
5340.52,1.0,7,2,2,3,7,0xb2d3b568
1601120.93,4.0,11,4,4,3,11,0xb2d103bb
110048.5,4.0,3,3,4,4,11,0xb2d68748d
31012.98,2.0,140,2,3,1,6,0xb2d21e1c
3826.88,1.0,292,2,2,1,5,0xb2d26067d
40.28,1.0,18,1,2,2,5,0xb2d95ac0
306.39,1.0,0,1,2,4,7,0xb2d977f7
4053.7,1.0,200,2,2,1,5,0xb2d23987
520107.84,5.0,7,4,4,3,11,0xb2d681ff
7.71,1.0,50,1,2,2,5,0xb2d21a6a
230219.28,3.0,259,3,4,1,8,0xb2d1b20dd
3940.93,1.0,0,2,2,4,8,0xb2d6b69a
234138.42,2.0,23,3,3,2,8,0xb2d24d68d
45000.95,2.0,228,2,3,1,6,0xb2d6f58c
10416.54,1.0,92,2,2,1,5,0x3b9af650
591.47,1.0,0,1,2,4,7,0xb2d68c12
204266.59,2.0,24,3,3,2,8,0xb2d68f36d
1220.2,1.0,16,1,2,2,5,0xb2d2df0a
681699.24,7.0,3,4,4,4,12,0xb2d581d4
50192.92,1.0,184,2,2,1,5,0xb2d5ecd7d
459.21,1.0,1,1,2,4,7,0xb2d43352
50002.29,2.0,98,2,3,1,6,0xb2d649eb
5142.19,1.0,0,2,2,4,8,0xb2d70581
501776.11,2.0,14,4,3,3,10,0xb2d6afe2
1285.01,1.0,184,1,2,1,4,0xb2d243b9
102998.15,3.0,49,3,4,2,9,0xb2d5d52ad
50028.83,2.0,20,2,3,2,7,0xb2d0be34
318759.84,1.0,11,4,2,3,9,0xb2d19b95
215227.24,2.0,235,3,3,1,7,0xb2d6edc9
303282.42,3.0,28,4,4,2,10,0xb2d56277
263073.74,4.0,82,3,4,1,8,0xb2d1778d
30525.3,2.0,256,2,3,1,6,0xb2d60492
600072.56,4.0,1,4,4,4,12,0xb2d975f9
3197.76,1.0,0,2,2,4,8,0xb2d58cd2
34000.49,2.0,8,2,3,3,8,0xb2d396b4
425117.76,5.0,11,4,4,3,11,0xb2d06f60d
600024.24,9.0,63,4,4,2,10,0xb2d19419
91643.73,3.0,0,3,4,4,11,0xb2d38a62
40081.36,2.0,32,2,3,2,7,0xb2d8c4ab
103249.25,4.0,0,3,4,4,11,0xb2d426c9
1940.71,1.0,180,1,2,1,4,0xb2d1fc00
200052.84,2.0,18,3,3,2,8,0xb2d22060
241319.14,4.0,0,3,4,4,11,0xb2d1ca49d
111.16,1.0,2,1,2,4,7,0xb2d69f29d
302843.98,3.0,53,4,4,2,10,0xb2d933da
2312.45,1.0,92,1,2,1,4,0xb2d141c5
6955.73,1.0,0,2,2,4,8,0xb2d2db0d
1868.76,1.0,184,1,2,1,4,0xb2d0c312
10000000.0,3.0,3,4,4,4,12,0xb2d8e218
158524.17,2.0,224,3,3,1,7,0xb2d41a29
31568.04,3.0,0,2,4,4,10,0xb2d2ab17
100005.47,2.0,92,3,3,1,7,0xb2d8483ad
619031.23,8.0,1,4,4,4,12,0xb2d5b6d2
30000.0,1.0,5,2,2,3,7,0xb2da142b
170011.73,4.0,13,3,4,3,10,0xb2d072a9
6180.14,3.0,0,2,4,4,10,0x3b9b459c
7.23,1.0,76,1,2,1,4,0xb2d37535
0.0,1.0,5,1,2,3,6,0xb2d22b25
5355845.47,17.0,1,4,4,4,12,0xb2d193ef
200257.1,2.0,24,3,3,2,8,0xb2d686b3d
202004.26,2.0,92,3,3,1,7,0xb2d67d50
25369.52,1.0,20,2,2,2,6,0xb2d6bb83d
57.29,1.0,5,1,2,3,6,0xb2d5d5d1
480018.78,5.0,0,4,4,4,12,0xb2d4dc49
293.88,1.0,4,1,2,4,7,0xb2d36f1a
283.35,1.0,51,1,2,2,5,0xb2d38376d
7.6,1.0,92,1,2,1,4,0xb2d3a12d
450000.0,2.0,49,4,3,2,9,0xb2d91361
270011.4,2.0,90,3,3,1,7,0xb2d7b196
3576020.22,6.0,59,4,4,2,10,0xb2d11e9c
350000.0,2.0,4,4,3,4,11,0xb2d48f8ad
976892.1,4.0,64,4,4,2,10,0xb2d9906a
2204.34,1.0,98,1,2,1,4,0xb2d49276
10276.12,2.0,12,2,3,3,8,0xb2d5ca3b
300000.66,3.0,0,3,4,4,11,0xb2d2614cd
417331.18,2.0,216,4,3,1,8,0xb2d381e5
1295.93,1.0,0,1,2,4,7,0xb2d3e4bbd
940400.46,9.0,8,4,4,3,11,0xb2d18479d
31.03,1.0,28,1,2,2,5,0xb2d8f94f
200058.75,5.0,14,3,4,3,10,0xb2d0f9f0
350017.22,3.0,136,4,4,1,9,0xb2d246b0
440104.68,5.0,0,4,4,4,12,0xb2d5cdf3
1577.22,1.0,184,1,2,1,4,0xb2d0a59e
5629.53,1.0,5,2,2,3,7,0xb2d37cf9
2.76,1.0,21,1,2,2,5,0xb2d4b9b3
150006.45,2.0,102,3,3,1,7,0xb2d415e6d
2580.1,1.0,0,1,2,4,7,0xb2d6fab5
60000.7,2.0,176,3,3,1,7,0xb2d646a6
120701.33,1.0,184,3,2,1,6,0xb2d2df2a
33128.38,1.0,184,2,2,1,5,0xb2d61ec1d
1000021.11,2.0,67,4,3,1,8,0xb2d9ae35
8138.94,1.0,9,2,2,3,7,0xb2d92737
2.69,1.0,19,1,2,2,5,0xb2d43a2d
5060.45,12.0,0,2,4,4,10,0xb2d17f84d
548009.91,16.0,0,4,4,4,12,0xb2d226ddd
160271.06,2.0,193,3,3,1,7,0xb2d3f74d
798.38,1.0,25,1,2,2,5,0xb2d24b57
346017.58,5.0,40,4,4,2,10,0xb2d8d8cc
86055.56,2.0,104,3,3,1,7,0xb2d5fd0a
138176.98,2.0,1,3,3,4,10,0xb2d19867d
5.17,1.0,10,1,2,3,6,0xb2d8f119
30000.4,2.0,7,2,3,3,8,0xb2d21b48
352706.43,8.0,20,4,4,2,10,0xb2d137ae
534417.33,12.0,8,4,4,3,11,0xb2d26f07
2112.49,1.0,92,1,2,1,4,0xb2d2018a
60.2,1.0,10,1,2,3,6,0xb2d6bf79
273591.57,7.0,1,3,4,4,11,0xb2d09fc2
1502698.03,16.0,0,4,4,4,12,0x3b9af2be
70033.45,7.0,0,3,4,4,11,0xb2d0f937
330004.42,3.0,3,4,4,4,12,0xb2d9383ed
10200.61,2.0,41,2,3,2,7,0xb2d9e410
137.22,1.0,15,1,2,3,6,0xb2d6b4bb
325418.62,2.0,139,4,3,1,8,0xb2d609b9d
400008.44,2.0,74,4,3,1,8,0xb2d99c52
1247.59,1.0,1,1,2,4,7,0xb2d78355
207289.72,2.0,125,3,3,1,7,0xb2d34f6fd
30000.53,3.0,55,2,4,2,8,0xb2d7a8a3
4901.91,1.0,92,2,2,1,5,0xb2d2f788
809786.7,3.0,2,4,4,4,12,0xb2d640aa
40001.43,2.0,63,2,3,2,7,0xb2d59e03
3.17,1.0,60,1,2,2,5,0xb2d9c136
501634.09,2.0,1,4,3,4,11,0xb2d9ca46
1295007.73,9.0,0,4,4,4,12,0xb2d9747a
6517.25,3.0,184,2,4,1,7,0xb2d0ce96d
254402.91,2.0,167,3,3,1,7,0xb2d51ba1d
350029.08,2.0,2,4,3,4,11,0xb2d3132f
600036.36,6.0,6,4,4,3,11,0xb2d51783
10229.28,1.0,19,2,2,2,6,0xb2d6f250
118842.07,3.0,5,3,4,3,10,0xb2d080d4
500039.0,2.0,6,4,3,3,10,0xb2d4b303d
859.72,1.0,0,1,2,4,7,0xb2d944e3
0.21,1.0,53,1,2,2,5,0xb2d42a27
9833.23,1.0,1,2,2,4,8,0xb2d9552f
614.34,3.0,0,1,4,4,9,0x3b9af22c
0.0,1.0,0,1,2,4,7,0xb2d55a18
210838.34,2.0,6,3,3,3,9,0xb2d637a5d
4.52,1.0,22,1,2,2,5,0xb2d1b217
9432.85,1.0,35,2,2,2,6,0xb2d6acefd
4.25,1.0,33,1,2,2,5,0xb2d6e0eb
20162.72,1.0,92,2,2,1,5,0xb2d2ec58
106962.37,2.0,186,3,3,1,7,0xb2d40ff2
1795.17,1.0,141,1,2,1,4,0xb2d29ae1
800002.87,14.0,0,4,4,4,12,0xb2d41093
1.06,1.0,110,1,2,1,4,0xb2d2481a
160033.4,2.0,11,3,3,3,9,0xb2d93bf9
5712.22,1.0,184,2,2,1,5,0x3b9ade3cd
110020.58,3.0,40,3,4,2,9,0xb2d20ad0
3029.39,1.0,0,2,2,4,8,0xb2d29d54d
493.92,1.0,10,1,2,3,6,0xb2d1fe9a
2367.07,1.0,0,1,2,4,7,0xb2d923dcd
167089.27,2.0,60,3,3,2,8,0xb2d21540
1219322.49,3.0,96,4,4,1,9,0xb2d8ff9dd
43.33,1.0,62,1,2,2,5,0xb2d347aa
1415014.19,26.0,21,4,4,2,10,0xb2d1e0afd
98.62,1.0,25,1,2,2,5,0xb2d7c33bd
928017.05,6.0,2,4,4,4,12,0xb2d3a5f2d
1326.76,1.0,184,1,2,1,4,0xb2d33dd2d
10867.64,1.0,1,2,2,4,8,0xb2d33650
559.99,1.0,2,1,2,4,7,0xb2d30560
350092.13,4.0,18,4,4,2,10,0xb2d6375f
60003.28,3.0,52,3,4,2,9,0xb2d41c79
386.21,1.0,3,1,2,4,7,0xb2d5a807
60001.9,2.0,92,3,3,1,7,0xb2d638aa
15.59,1.0,74,1,2,1,4,0xb2d62193d
58965.38,1.0,0,3,2,4,9,0xb2d39a14d
9342.03,1.0,0,2,2,4,8,0xb2d68c86
345096.08,3.0,52,4,4,2,10,0xb2d4346d
13.7,1.0,1,1,2,4,7,0xb2d2834f
220000.0,2.0,7,3,3,3,9,0xb2da4f70
320055.12,4.0,14,4,4,3,11,0xb2d5ef8a
304261.96,3.0,38,4,4,2,10,0xb2d1b5afd
45173.11,3.0,92,2,4,1,7,0xb2d695d4
357832.16,2.0,69,4,3,1,8,0xb2d54df9
815544.92,4.0,80,4,4,1,9,0xb2d0c6f8d
39321.3,1.0,184,2,2,1,5,0xb2d28427
90008.74,4.0,129,3,4,1,8,0xb2d425d0
751008.36,3.0,0,4,4,4,12,0xb2d1de51d
880251.78,2.0,83,4,3,1,8,0xb2d25462d
10214.83,7.0,0,2,4,4,10,0xb2d17193d
130001.37,2.0,55,3,3,2,8,0xb2d9041b
200000.0,3.0,7,3,4,3,10,0xb2d970be
200020.67,3.0,102,3,4,1,8,0xb2d39552
1108.68,1.0,184,1,2,1,4,0xb2d540dfd
90791.25,4.0,3,3,4,4,11,0xb2d65350d
1015.01,1.0,184,1,2,1,4,0xb2d1571ed
50002.64,2.0,181,2,3,1,6,0xb2d6b06ed
3751.06,1.0,207,2,2,1,5,0xb2d4321f
71754.42,1.0,84,3,2,1,6,0xb2d572d9
521948.09,3.0,39,4,4,2,10,0xb2d21194
10000.11,2.0,221,2,3,1,6,0xb2d6a764
300586.01,2.0,10,4,3,3,10,0xb2d0f791
150009.23,4.0,1,3,4,4,11,0xb2d5a5e4d
125465.62,1.0,1,3,2,4,9,0xb2d6158c
90178.96,4.0,24,3,4,2,9,0xb2d5bd37
1670017.63,2.0,42,4,3,2,9,0xb2d9b703
180747.76,5.0,4,3,4,4,11,0xb2d22bded
1505.19,1.0,184,1,2,1,4,0xb2d25c9dd
20032.95,2.0,3,2,3,4,9,0xb2d9d61c
607.52,1.0,0,1,2,4,7,0xb2d210cdd
0.0,1.0,1,1,2,4,7,0xb2d6908f
4330078.34,14.0,8,4,4,3,11,0xb2d10a9fd
189389.35,1.0,10,3,2,3,8,0xb2d5ccc1d
40096.73,2.0,212,2,3,1,6,0xb2d6438a
10349.11,1.0,3,2,2,4,8,0xb2d630d8d
11015.46,4.0,0,2,4,4,10,0xb2d5ce70
50006.95,2.0,74,2,3,1,6,0xb2d969a4
352396.53,2.0,0,4,3,4,11,0xb2d1397e
60046.79,3.0,6,3,4,3,10,0xb2d826f4
7185.47,1.0,18,2,2,2,6,0xb2d53f4f
200001.68,2.0,15,3,3,3,9,0xb2d6f484
111040.04,5.0,59,3,4,2,9,0xb2d10673
120065.65,3.0,32,3,4,2,9,0xb2d0ee39
3670785.53,3.0,87,4,4,1,9,0xb2d1ab19
200022.14,3.0,6,3,4,3,10,0xb2d2db41
500005.91,2.0,74,4,3,1,8,0xb2d99ea0
1581714.44,3.0,12,4,4,3,11,0xb2d0a0c8
65.71,1.0,75,1,2,1,4,0xb2d30df3
9256.17,1.0,184,2,2,1,5,0xb2d1a0ea
170049.71,3.0,92,3,4,1,8,0xb2d5d815
83650.82,3.0,48,3,4,2,9,0xb2d1e9e7
200031.32,2.0,2,3,3,4,10,0xb2d97d1f
3.1,1.0,76,1,2,1,4,0xb2d775b8
196.93,1.0,67,1,2,1,4,0xb2d91d49
1015.26,1.0,92,1,2,1,4,0xb2d108cb
580348.93,8.0,6,4,4,3,11,0xb2d0e71e
215769.52,2.0,1,3,3,4,10,0xb2d5b71a
86.84,1.0,7,1,2,3,6,0xb2d6f1fb
1419.65,1.0,2,1,2,4,7,0xb2d95530
10794.15,1.0,14,2,2,3,7,0xb2d22aa6
306398.76,2.0,190,4,3,1,8,0xb2d857fe
14.81,1.0,41,1,2,2,5,0xb2d2caf9
61366.7,3.0,5,3,4,3,10,0xb2d2573dd
7445.69,1.0,1,2,2,4,8,0xb2d6bd3e
2.29,1.0,12,1,2,3,6,0xb2d5cfb5
740200.56,4.0,21,4,4,2,10,0xb2d9d9b5
0.0,1.0,4,1,2,4,7,0xb2d60478
250010.33,2.0,92,3,3,1,7,0xb2d1beb7
78720.01,4.0,33,3,4,2,9,0xb2d09d85d
6301.42,1.0,0,2,2,4,8,0xb2d37caa
387559.44,3.0,30,4,4,2,10,0xb2d1801c
1372.0,1.0,184,1,2,1,4,0xb2d0f487
1991050.91,5.0,179,4,4,1,9,0xb2d1a520d
2513.85,1.0,0,1,2,4,7,0xb2d92683
6217.97,1.0,1,2,2,4,8,0xb2d4370a
157.17,1.0,63,1,2,2,5,0xb2d6d999
212420.07,2.0,259,3,3,1,7,0xb2d17570
121001.33,3.0,31,3,4,2,9,0xb2d8e2cc
0.75,1.0,50,1,2,2,5,0xb2d6db9f
250027.85,1.0,4,3,2,4,9,0xb2d3c558
171.59,1.0,7,1,2,3,6,0xb2d85ae8
20680.46,1.0,22,2,2,2,6,0xb2d3464bd
526702.04,4.0,3,4,4,4,12,0xb2da0346
999000.0,4.0,4,4,4,4,12,0xb2d2a27b
1006.94,1.0,30,1,2,2,5,0xb2d1b009d
242303.7,3.0,77,3,4,1,8,0xb2d66558
9205.24,1.0,0,2,2,4,8,0xb2d41b9f
101205.3,1.0,4,3,2,4,9,0xb2d114e6
968010.53,13.0,6,4,4,3,11,0xb2d6440c
974.54,1.0,10,1,2,3,6,0xb2d613c3
2.28,1.0,17,1,2,2,5,0xb2d98916
50313.2,3.0,6,2,4,3,9,0xb2d0779c
204036.36,5.0,83,3,4,1,8,0xb2d627e1
440092.1,3.0,104,4,4,1,9,0xb2d0bf39d
650018.77,3.0,42,4,4,2,10,0x3b9b2c74
301596.27,3.0,77,4,4,1,9,0xb2d63400
1898.96,1.0,0,1,2,4,7,0xb2d6bb72
912.93,2.0,48,1,3,2,6,0xb2d4bdeb
200068.16,2.0,111,3,3,1,7,0xb2d93da0
1382.03,1.0,9,1,2,3,6,0xb2d4b965
3391.68,2.0,0,2,3,4,9,0xb2d099ff
205008.66,2.0,34,3,3,2,8,0xb2d9296b
1.07,1.0,69,1,2,1,4,0xb2d2a5fe
20000.0,1.0,0,2,2,4,8,0xb2d8b0d6
1077041.25,3.0,0,4,4,4,12,0xb2d2fc10
340668.06,6.0,90,4,4,1,9,0xb2d428fb
58687.62,2.0,98,3,3,1,7,0xb2d438b6
2.66,1.0,28,1,2,2,5,0xb2d6bb26
20001.33,2.0,48,2,3,2,7,0xb2d63f14
808036.35,7.0,76,4,4,1,9,0xb2d2b3a9
220000.0,2.0,20,3,3,2,8,0xb2d952d7
275.79,1.0,60,1,2,2,5,0xb2d94e86
303064.46,2.0,0,4,3,4,11,0xb2d2e7cc
1354849.51,3.0,22,4,4,2,10,0xb2d6bce2
50890.07,13.0,1,2,4,4,10,0x3b9b18c0
2.68,1.0,30,1,2,2,5,0xb2d26a14
151594.8,3.0,181,3,4,1,8,0xb2d16c96
50872.13,3.0,0,2,4,4,10,0xb2d61a25
30214.75,4.0,4,2,4,4,10,0xb2d5c805
1056.78,1.0,12,1,2,3,6,0xb2d6beaad
30000.63,2.0,18,2,3,2,7,0xb2d953d0
1156.22,1.0,9,1,2,3,6,0xb2d3c062
56365.65,1.0,11,3,2,3,8,0xb2d6595a
20166.97,1.0,92,2,2,1,5,0xb2d204d6
3241860.47,5.0,0,4,4,4,12,0xb2d530efd
8997.73,1.0,0,2,2,4,8,0xb2d2ac49
200000.0,2.0,1,3,3,4,10,0xb2d97724
1778.6,1.0,34,1,2,2,5,0xb2d61fa2
25137.13,6.0,224,2,4,1,7,0x3b9b294f
903547.43,4.0,9,4,4,3,11,0xb2d5637c
46549.56,1.0,0,2,2,4,8,0xb2d97b31
60.43,1.0,9,1,2,3,6,0xb2d2dab2
8313.61,1.0,1,2,2,4,8,0xb2d320f5
10618.76,1.0,14,2,2,3,7,0xb2d0f738d
200050.04,2.0,18,3,3,2,8,0xb2d9d63b
20113.2,3.0,10,2,4,3,9,0xb2d6492d
4287402.22,28.0,0,4,4,4,12,0xb2d1ebad
476.65,1.0,4,1,2,4,7,0xb2d50bc8
36611.01,1.0,0,2,2,4,8,0xb2d2c544
720000.42,4.0,19,4,4,2,10,0xb2d7855d
7755.41,1.0,12,2,2,3,7,0xb2d17755
40692.53,1.0,92,2,2,1,5,0xb2d2b7eb
308019.62,6.0,7,4,4,3,11,0xb2d1c9a1d
2.86,1.0,63,1,2,2,5,0xb2d7be76
100.87,1.0,206,1,2,1,4,0xb2d484e4
1596.42,1.0,3,1,2,4,7,0xb2d91f08
207006.41,3.0,24,3,4,2,9,0xb2d93061d
501000.0,2.0,29,4,3,2,9,0xb2da0b5b
54804.75,2.0,10,3,3,3,9,0xb2d39cdf
202011.87,1.0,6,3,2,3,8,0xb2d391c9
5583.89,1.0,184,2,2,1,5,0xb2d1e9efd
1002520.6,3.0,30,4,4,2,10,0xb2d19aed
22480.26,1.0,116,2,2,1,5,0xb2d2c440
18154.34,1.0,36,2,2,2,6,0xb2d801cfd
440849.06,4.0,22,4,4,2,10,0xb2d63d7cd
10212.93,2.0,0,2,3,4,9,0xb2d5c1cf
10000.21,2.0,94,2,3,1,6,0xb2d63e82
2265.27,2.0,0,1,3,4,8,0xb2d06946
50001.58,2.0,8,2,3,3,8,0xb2da3af1
1420027.28,6.0,0,4,4,4,12,0xb2d9300ad
175872.47,5.0,12,3,4,3,10,0x3b9b1825
12694.19,4.0,5,2,4,3,9,0xb2d21243
12471.06,1.0,12,2,2,3,7,0xb2d9c774
69295.34,1.0,6,3,2,3,8,0xb2d6271c
180008.26,3.0,33,3,4,2,9,0xb2d38c7ed
1270035.47,4.0,11,4,4,3,11,0xb2da060b
60519.81,2.0,94,3,3,1,7,0xb2d43363
176210.0,4.0,1,3,4,4,11,0xb2d3963f
11155.91,1.0,14,2,2,3,7,0xb2d6899a
3.06,1.0,40,1,2,2,5,0xb2d4158a
202131.91,2.0,99,3,3,1,7,0xb2d96ed8d
25909.22,1.0,4,2,2,4,8,0xb2d59f5d
256564.62,2.0,206,3,3,1,7,0xb2d5c342d
925710.42,16.0,4,4,4,4,12,0xb2d44109
1097016.11,1.0,1,4,2,4,10,0xb2d55708
30235.6,2.0,8,2,3,3,8,0xb2d41050
25000.78,2.0,58,2,3,2,7,0xb2d5f134
56000.0,2.0,6,3,3,3,9,0xb2d96ef9
774.26,1.0,46,1,2,2,5,0xb2d2c957
500000.95,3.0,10,4,4,3,11,0xb2d64a6dd
60002.96,2.0,123,3,3,1,7,0xb2d90fa4
5.32,1.0,6,1,2,3,6,0xb2d6aafb
3718.77,1.0,100,2,2,1,5,0xb2d6ec6d
718.76,1.0,2,1,2,4,7,0xb2d1bf69
201078.97,6.0,0,3,4,4,11,0xb2d12aa3
1110011.72,2.0,34,4,3,2,9,0xb2d92a09
50000.0,1.0,3,2,2,4,8,0xb2d96d2bd
0.0,1.0,1,1,2,4,7,0xb2d962f8
500020.54,3.0,13,4,4,3,11,0xb2d5a790
6344.75,1.0,20,2,2,2,6,0xb2d68f03
200019.98,4.0,10,3,4,3,10,0xb2d5b721
52414.11,6.0,69,3,4,1,8,0xb2d7fee3
331000.73,4.0,20,4,4,2,10,0xb2d97c51
10.43,1.0,4,1,2,4,7,0xb2d8c874
5879.88,1.0,184,2,2,1,5,0xb2d22cc6d
471126.94,5.0,6,4,4,3,11,0xb2d22a05
80007.54,3.0,11,3,4,3,10,0xb2d587dc
173384.21,2.0,31,3,3,2,8,0xb2d06efed
50101.18,2.0,18,2,3,2,7,0xb2da1091
3054.97,1.0,7,2,2,3,7,0xb2d147a5
550110.61,3.0,0,4,4,4,12,0xb2d6f322
35021.27,3.0,6,2,4,3,9,0xb2d5bcc7
459033.64,9.0,4,4,4,4,12,0xb2d6c8d0
49045891.67,5.0,0,4,4,4,12,0xb2d41387d
1266110.5,5.0,74,4,4,1,9,0xb2d1a682d
9670.35,2.0,178,2,3,1,6,0xb2d53481
100001.06,2.0,105,3,3,1,7,0xb2d95cd3
82.34,1.0,39,1,2,2,5,0xb2d69239
53853.75,1.0,8,3,2,3,8,0xb2d54185
1027.43,1.0,92,1,2,1,4,0x3b9b3680d
30.85,1.0,0,1,2,4,7,0xb2d83a05
300000.53,3.0,0,3,4,4,11,0xb2d97ce6
1648966.12,9.0,18,4,4,2,10,0xb2d44ce2
2479058.84,21.0,14,4,4,3,11,0xb2d45534
1007.49,1.0,92,1,2,1,4,0xb2d34cc3
50192.93,1.0,92,2,2,1,5,0xb2d59071d
519005.03,4.0,6,4,4,3,11,0xb2d64386
227000.03,2.0,0,3,3,4,10,0xb2d651ee
10428.01,1.0,184,2,2,1,5,0x3b9b0f22
29244.0,2.0,1,2,3,4,9,0xb2d9c4de
32920.85,2.0,0,2,3,4,9,0xb2d5899b
363649.7,3.0,111,4,4,1,9,0xb2d4fb26
71156.85,2.0,83,3,3,1,7,0xb2d657ff
101075.57,1.0,184,3,2,1,6,0xb2d2a618
80472.32,1.0,5,3,2,3,8,0xb2d2f747
379.51,2.0,4,1,3,4,8,0x3b9af291d
891.07,1.0,3,1,2,4,7,0xb2d58bfa
0.2,1.0,4,1,2,4,7,0xb2d6e952
1009.46,1.0,184,1,2,1,4,0xb2d25ac3
1796.52,1.0,24,1,2,2,5,0xb2d95d15
100055.33,2.0,1,3,3,4,10,0xb2d58c53d
14291.7,2.0,56,2,3,2,7,0xb2d0d275
412366.22,4.0,53,4,4,2,10,0xb2d5c4a5
100015.79,2.0,21,3,3,2,8,0xb2d530b8
286852.61,1.0,12,3,2,3,8,0xb2d7c24a
400088.73,3.0,164,4,4,1,9,0xb2d0a613
6042.13,1.0,92,2,2,1,5,0xb2d398eb
900017.89,8.0,83,4,4,1,9,0xb2d11d3e
1920.21,1.0,0,1,2,4,7,0xb2d25cd7
190015.5,1.0,1,3,2,4,9,0xb2d4e476
4650.19,1.0,307,2,2,1,5,0xb2d2a5d7
1353439.1,6.0,14,4,4,3,11,0xb2d5ebe1
13609.6,6.0,2,2,4,4,10,0x3b9af0d0
11546.29,1.0,1,2,2,4,8,0xb2d960ba
260098.01,2.0,17,3,3,2,8,0xb2d95559
3303.73,3.0,242,2,4,1,7,0xb2d50b6d
404264.36,2.0,33,4,3,2,9,0xb2d3230e
500096.22,5.0,59,4,4,2,10,0xb2d4953d
1.06,1.0,39,1,2,2,5,0xb2d921a7
17741.46,1.0,1,2,2,4,8,0xb2d901f6
1072.52,1.0,176,1,2,1,4,0xb2d59e30
80.54,1.0,15,1,2,3,6,0xb2da034d
6262.81,6.0,0,2,4,4,10,0x3b9b1829d
1916.08,1.0,0,1,2,4,7,0xb2d336f3
10.05,1.0,75,1,2,1,4,0xb2d5c309d
1060442.35,4.0,4,4,4,4,12,0xb2d08170
3141.08,1.0,0,2,2,4,8,0xb2d54096
4469.42,1.0,10,2,2,3,7,0xb2d92e9a
10201.43,1.0,202,2,2,1,5,0xb2d54e90
200031.67,1.0,22,3,2,2,7,0xb2d9d805
354003.74,2.0,46,4,3,2,9,0xb2d9e20a
49721.47,2.0,20,2,3,2,7,0xb2d23d83
41.14,1.0,25,1,2,2,5,0xb2d29343
10866.57,1.0,92,2,2,1,5,0xb2d4ec2b
70547.67,1.0,184,3,2,1,6,0xb2d57fe2
101150.95,2.0,32,3,3,2,8,0xb2d928a5
400004.22,2.0,34,4,3,2,9,0xb2d9331ed
5056.68,1.0,0,2,2,4,8,0xb2d5a1b3
77.43,1.0,2,1,2,4,7,0xb2d41a77
900019.02,2.0,137,4,3,1,8,0xb2d91993
690059.39,2.0,102,4,3,1,8,0xb2d9546c
343255.48,3.0,93,4,4,1,9,0xb2d63190
1.8,1.0,39,1,2,2,5,0xb2d11860
330178.99,2.0,153,4,3,1,8,0xb2d2568ed
730320.31,3.0,70,4,4,1,9,0xb2d13f70d
6.34,2.0,101,1,3,1,5,0x3b9b32f8
11619.52,1.0,0,2,2,4,8,0xb2d6803dd
5783.01,1.0,0,2,2,4,8,0xb2d57cafd
52413.93,1.0,39,3,2,2,7,0xb2d35b69
1032661.11,7.0,18,4,4,2,10,0xb2d96302d
1255513.01,1.0,0,4,2,4,10,0xb2d65766
2300006.33,3.0,10,4,4,3,11,0xb2d963a3
5016.27,1.0,92,2,2,1,5,0xb2d57df2
500000.0,2.0,3,4,3,4,11,0xb2d97021d
5570.24,1.0,10,2,2,3,7,0xb2d31837
151707.8,3.0,10,3,4,3,10,0xb2d5f354
31.14,1.0,6,1,2,3,6,0xb2d56ced
109545.03,3.0,108,3,4,1,8,0xb2d19c39
2199.2,1.0,259,1,2,1,4,0xb2d64f2c
1312.95,1.0,2,1,2,4,7,0xb2d6bfe4
0.06,1.0,4,1,2,4,7,0xb2d41f55
1986.97,1.0,6,1,2,3,6,0xb2d518d1
201263.18,7.0,5,3,4,3,10,0xb2d6561cd
252341.99,2.0,172,3,3,1,7,0xb2d321e7d
420770.21,6.0,32,4,4,2,10,0xb2d17911
1013.15,1.0,184,1,2,1,4,0xb2d28e13
1095.58,1.0,160,1,2,1,4,0xb2d5e40f
201421.01,2.0,33,3,3,2,8,0xb2d8f7c1d
350010.56,3.0,39,4,4,2,10,0xb2d98c1b
157339.18,5.0,4,3,4,4,11,0xb2d68d3e
1510693.38,12.0,0,4,4,4,12,0xb2d63eeb
611325.32,2.0,84,4,3,1,8,0xb2d0769a
625000.0,3.0,4,4,4,4,12,0xb2da54c3
47748.52,1.0,0,2,2,4,8,0xb2d228ded
200012.69,2.0,209,3,3,1,7,0xb2d68640
391651.15,4.0,14,4,4,3,11,0xb2d26af9
70009.56,4.0,77,3,4,1,8,0x3b9b4105d
1957689.22,11.0,0,4,4,4,12,0xb2d62f23
171362.06,4.0,38,3,4,2,9,0xb2d186ad
400000.0,4.0,5,4,4,3,11,0xb2d8e811
96.37,1.0,0,1,2,4,7,0xb2d9c9dd
167020.71,2.0,189,3,3,1,7,0x3b9b22fed
5.04,1.0,11,1,2,3,6,0xb2da3cd9
1016.23,1.0,184,1,2,1,4,0xb2d3cc33
6268.89,1.0,184,2,2,1,5,0x3b9b26f2
968852.52,1.0,92,4,2,1,7,0xb2d15582d
262110.04,3.0,83,3,4,1,8,0xb2d3fa0c
30001.74,3.0,133,2,4,1,7,0xb2d8018b
501776.08,2.0,42,4,3,2,9,0xb2d9ed06
13602.23,1.0,0,2,2,4,8,0xb2d2310b
5585.21,1.0,6,2,2,3,7,0xb2d3f7af
1640.84,1.0,8,1,2,3,6,0xb2d9a0ea
663706.18,4.0,18,4,4,2,10,0xb2d55788d
1.37,1.0,67,1,2,1,4,0xb2d57b10
1212042.72,12.0,6,4,4,3,11,0xb2d50007d
171.64,1.0,11,1,2,3,6,0xb2d9441e
900005.06,5.0,27,4,4,2,10,0xb2d11fce
67572.46,1.0,116,3,2,1,6,0xb2d5ee93d
1003.26,1.0,184,1,2,1,4,0xb2d2ce76
1000000.0,1.0,0,4,2,4,10,0xb2da388e
100276.7,2.0,4,3,3,4,10,0xb2d25ff0d
200073.41,2.0,147,3,3,1,7,0xb2d445a5d
60754.47,2.0,6,3,3,3,9,0xb2d15fb8
250898.44,2.0,0,3,3,4,10,0xb2d5ab9dd
3203.71,1.0,6,2,2,3,7,0xb2d636cf
110134.98,2.0,4,3,3,4,10,0xb2d71827
1035.81,1.0,92,1,2,1,4,0xb2d0f62ed
1026.4,1.0,14,1,2,3,6,0xb2d2b6ebd
1431.11,1.0,0,1,2,4,7,0xb2d8f528d
1460480.38,12.0,73,4,4,1,9,0xb2d09e64d
11926.58,1.0,7,2,2,3,7,0xb2d32b27
500048.88,4.0,12,4,4,3,11,0xb2d2a8a7
74.06,1.0,21,1,2,2,5,0xb2d1e8e2
288.3,1.0,7,1,2,3,6,0xb2d5268ad
4183.58,3.0,184,2,4,1,7,0xb2d55fa0d
333121.16,3.0,92,4,4,1,9,0xb2d5f1d0d
1000015.93,2.0,1,4,3,4,11,0xb2d0e349
13519.04,1.0,0,2,2,4,8,0xb2d8f898
346462.96,4.0,0,4,4,4,12,0xb2d8d8ccd
40003.11,2.0,104,2,3,1,6,0xb2d50af2d
2050040.0,6.0,34,4,4,2,10,0xb2d4190f
10593.36,1.0,156,2,2,1,5,0xb2d6c7dd
303251.67,2.0,16,4,3,2,9,0xb2d3b26a
460457.1,5.0,10,4,4,3,11,0xb2d2c532
110061.2,4.0,0,3,4,4,11,0xb2d5f398d
9963.46,1.0,92,2,2,1,5,0xb2d1ef6b
201457.16,1.0,4,3,2,4,9,0xb2d25b89
661669.67,5.0,17,4,4,2,10,0xb2d580af
103411.69,3.0,11,3,4,3,10,0xb2d12cb6
22.19,1.0,31,1,2,2,5,0xb2d5ba81d
68.2,3.0,7,1,4,3,8,0xb2d11751
219.77,1.0,1,1,2,4,7,0xb2d922be
52394.34,5.0,0,3,4,4,11,0xb2d54b39
509491.64,3.0,19,4,4,2,10,0xb2d6179c
4622.1,1.0,0,2,2,4,8,0xb2d317de
664855.43,3.0,28,4,4,2,10,0xb2d52de7
556336.43,2.0,25,4,3,2,9,0xb2d396c1
403318.84,4.0,63,4,4,2,10,0xb2d07af9d
0.18,1.0,92,1,2,1,4,0xb2d29a80d
183.24,1.0,36,1,2,2,5,0xb2d34a38
175.31,1.0,10,1,2,3,6,0xb2d64706
3606626.69,7.0,1,4,4,4,12,0xb2d33fd0
98.0,1.0,17,1,2,2,5,0xb2d26392
20531.96,1.0,0,2,2,4,8,0xb2d3d31e
6.5,1.0,23,1,2,2,5,0xb2d700b1
3044.93,1.0,92,2,2,1,5,0xb2d23662
2308051.37,8.0,19,4,4,2,10,0xb2d2504f
105670.27,2.0,9,3,3,3,9,0xb2d783d5
629009.75,6.0,6,4,4,3,11,0xb2d0bbed
225.84,1.0,0,1,2,4,7,0xb2d94099
11.26,1.0,22,1,2,2,5,0xb2d4030a
200037.33,2.0,21,3,3,2,8,0xb2d7861b
3017.31,1.0,10,2,2,3,7,0xb2d93867
2462.58,1.0,92,1,2,1,4,0x3b9b2edd
41531.49,1.0,92,2,2,1,5,0xb2d30f52d
50.77,1.0,12,1,2,3,6,0xb2d5c98ed
298698.32,4.0,18,3,4,2,9,0xb2d5acaf
76981.71,1.0,17,3,2,2,7,0xb2d696f7d
1004629.94,4.0,179,4,4,1,9,0xb2d1ee4cd
100682.86,2.0,164,3,3,1,7,0xb2d659a1
17105.26,1.0,1,2,2,4,8,0xb2d95d6c
230041.17,2.0,8,3,3,3,9,0xb2d5df2a
6008.01,1.0,9,2,2,3,7,0xb2d31070
250815.7,3.0,14,3,4,3,10,0xb2d16b5f
440434.47,6.0,7,4,4,3,11,0xb2d759fd
2032.47,1.0,184,1,2,1,4,0xb2d1f017d
50001.06,2.0,7,2,3,3,8,0xb2da491d
63007.34,2.0,3,3,3,4,10,0xb2d1a529
28641.13,1.0,9,2,2,3,7,0xb2d263b8d
879000.48,10.0,4,4,4,4,12,0xb2d5b182
261118.68,2.0,108,3,3,1,7,0xb2d5b593
0.29,1.0,2,1,2,4,7,0xb2d17ebd
1017.35,1.0,184,1,2,1,4,0xb2d31d9c
250109.82,3.0,60,3,4,2,9,0xb2d1bbcf
200018.65,3.0,12,3,4,3,10,0xb2d65a82
1215.61,1.0,15,1,2,3,6,0xb2d3685fd
58.43,1.0,62,1,2,2,5,0xb2d32122d
50.81,1.0,10,1,2,3,6,0xb2d5e6d2
2012.32,1.0,7,1,2,3,6,0xb2d4fdd0d
10005.72,2.0,32,2,3,2,7,0xb2d68379
10032.96,1.0,92,2,2,1,5,0xb2d56c95
439.1,1.0,24,1,2,2,5,0xb2d53664d
2716.04,2.0,0,1,3,4,8,0xb2d0a48d
926567.24,4.0,0,4,4,4,12,0x3b9b331b
75505.53,5.0,0,3,4,4,11,0xb2d078f6
21.8,1.0,19,1,2,2,5,0xb2d61127
2806.99,1.0,3,1,2,4,7,0xb2d6a05a
20071.72,1.0,0,2,2,4,8,0xb2d20a4e
619697.71,4.0,0,4,4,4,12,0xb2d26161
29595.58,1.0,15,2,2,3,7,0xb2d5a916
200013.86,4.0,63,3,4,2,9,0xb2d6d6fe
562486.24,2.0,172,4,3,1,8,0xb2d1a94f
436200.62,4.0,80,4,4,1,9,0xb2d312e8
20940.06,1.0,18,2,2,2,6,0xb2d2bf96
8502.86,1.0,8,2,2,3,7,0xb2d3f9c2d
2852742.55,5.0,19,4,4,2,10,0xb2d17acdd
1500023.57,4.0,0,4,4,4,12,0xb2d6b4efd
50085.35,19.0,12,2,4,3,9,0xb2d11b73
2802.64,1.0,6,1,2,3,6,0xb2d77660d
1155.91,1.0,113,1,2,1,4,0xb2d23e86
0.11,1.0,45,1,2,2,5,0xb2d690ac
26.02,2.0,7,1,3,3,7,0xb2d06ba2d
40.22,1.0,28,1,2,2,5,0xb2d8f86d
1453165.23,11.0,6,4,4,3,11,0xb2d20d29
1314820.24,3.0,0,4,4,4,12,0xb2d399a8
400006.61,4.0,28,4,4,2,10,0xb2d17523
9468.38,1.0,184,2,2,1,5,0x3b9b2c3e
23.99,2.0,0,1,3,4,8,0x3b9b2983
200715.9,2.0,36,3,3,2,8,0xb2d9f76a
221771.09,3.0,19,3,4,2,9,0xb2d5f8da
298.02,3.0,26,1,4,2,7,0xb2d2f222
54.36,1.0,13,1,2,3,6,0xb2d25de8
100000.0,2.0,0,3,3,4,10,0xb2d9801ad
2229.68,1.0,184,1,2,1,4,0xb2d22693
573065.68,5.0,3,4,4,4,12,0xb2d0d7c2d
13588.05,1.0,13,2,2,3,7,0xb2d56221
89.63,1.0,2,1,2,4,7,0xb2d37c5a
3301.54,1.0,53,2,2,2,6,0xb2d96896
8055.06,1.0,3,2,2,4,8,0xb2d78bcc
98.89,2.0,24,1,3,2,6,0xb2d422da
1007105.47,2.0,43,4,3,2,9,0xb2d8e6d2
1495.16,1.0,125,1,2,1,4,0xb2d3077c
2.15,1.0,1,1,2,4,7,0xb2d94604
10538.62,1.0,18,2,2,2,6,0xb2d60a5c
200036.18,2.0,8,3,3,3,9,0xb2d676dd
17475.22,2.0,0,2,3,4,9,0xb2d26674
375.67,1.0,13,1,2,3,6,0xb2d2f147
320031.16,5.0,4,4,4,4,12,0xb2d8fadad
13835.98,1.0,184,2,2,1,5,0xb2d26c03d
45036.26,1.0,20,2,2,2,6,0xb2d6b674
354.28,1.0,2,1,2,4,7,0xb2d212e4d
18091.01,1.0,20,2,2,2,6,0xb2d67f50
500050.0,2.0,14,4,3,3,10,0xb2da3774
131054.68,3.0,59,3,4,2,9,0xb2d22d26
358.07,1.0,19,1,2,2,5,0xb2d57587
133076.88,19.0,6,3,4,3,10,0xb2d09fe3
200009.51,4.0,48,3,4,2,9,0x3b9b3dbf
137969.69,1.0,10,3,2,3,8,0xb2d6df79d
51351.72,1.0,50,2,2,2,6,0xb2d6aca1
8.69,1.0,3,1,2,4,7,0xb2d7a77ed
5648.11,1.0,2,2,2,4,8,0xb2d78cd9
401427.64,2.0,33,4,3,2,9,0xb2d6922c
9900.71,1.0,10,2,2,3,7,0xb2d91068
350000.01,2.0,24,4,3,2,9,0xb2d908ac
895030.33,8.0,25,4,4,2,10,0xb2d108c0
1670014.35,9.0,4,4,4,4,12,0xb2d11cd2
690000.0,3.0,0,4,4,4,12,0xb2d9711a
5571.63,1.0,90,2,2,1,5,0xb2d6b6a6
2011.76,1.0,184,1,2,1,4,0xb2d4ceb5d
110083.13,3.0,77,3,4,1,8,0xb2d637c7
31.39,1.0,71,1,2,1,4,0xb2d62d21
1206.53,1.0,184,1,2,1,4,0xb2d241b9
5005.07,1.0,144,2,2,1,5,0xb2d90f60d
28920.98,1.0,0,2,2,4,8,0xb2d8d104d
2634.32,1.0,92,1,2,1,4,0xb2d212b8
10001.23,2.0,32,2,3,2,7,0xb2d62196d
4.35,1.0,4,1,2,4,7,0xb2d27c2e
3600.55,1.0,4,2,2,4,8,0xb2d128f8d
111032.43,3.0,108,3,4,1,8,0xb2d5604a
223005.49,3.0,3,3,4,4,11,0xb2d90144
4.49,1.0,12,1,2,3,6,0xb2d13289d
50090.64,2.0,46,2,3,2,7,0xb2d13259
6.68,1.0,11,1,2,3,6,0xb2d6a406
206733.59,2.0,39,3,3,2,8,0xb2d4b65e
505544.62,2.0,4,4,3,4,11,0xb2d6aa05
407.09,1.0,21,1,2,2,5,0xb2d8821b
721077.29,4.0,10,4,4,3,11,0xb2d3a561
40699.3,2.0,164,2,3,1,6,0xb2d60546
90007.61,3.0,90,3,4,1,8,0xb2d411f9
9.13,1.0,12,1,2,3,6,0xb2d1dcb9
3002.69,1.0,94,2,2,1,5,0xb2d8a1f6
2485.79,1.0,0,1,2,4,7,0xb2d2addfd
400000.0,3.0,19,4,4,2,10,0xb2da2f36
51912.64,2.0,87,2,3,1,6,0xb2d59f2fd
8016.18,1.0,6,2,2,3,7,0xb2d15662
1514.06,2.0,184,1,3,1,5,0xb2d0827bd
200015.12,2.0,10,3,3,3,9,0xb2d1ff05
80100.0,2.0,4,3,3,4,10,0xb2da5916
1162216.44,11.0,16,4,4,2,10,0x3b9b0fc1d
502571.78,3.0,22,4,4,2,10,0xb2d4dede
2586.19,1.0,29,1,2,2,5,0xb2d92cdb
1816077.97,6.0,5,4,4,3,11,0xb2d60474
4705.73,1.0,47,2,2,2,6,0xb2d5a905
284170.72,3.0,32,3,4,2,9,0xb2d10d2b
207.51,24.0,0,1,4,4,9,0x3b9af2bb
1214374.92,3.0,18,4,4,2,10,0xb2d3e1dd
0.53,1.0,60,1,2,2,5,0xb2d8fd67
3675.57,1.0,14,2,2,3,7,0xb2d68c9a
472601.68,7.0,12,4,4,3,11,0xb2d683d9
810022.64,3.0,77,4,4,1,9,0xb2d65ea6
356547.96,8.0,1,4,4,4,12,0xb2d65c48
290121.19,2.0,24,3,3,2,8,0xb2d0a141
4901.07,1.0,0,2,2,4,8,0xb2da0742
8714.29,1.0,9,2,2,3,7,0xb2d2413d
41093.71,1.0,58,2,2,2,6,0xb2d2d471d
402226.65,5.0,110,4,4,1,9,0xb2d339a2
1098192.84,3.0,0,4,4,4,12,0xb2d23f63
93.98,5.0,11,1,4,3,8,0xb2d9f8fd
14009.55,1.0,2,2,2,4,8,0xb2d54fb0
72.73,1.0,133,1,2,1,4,0xb2d5f679
3.04,1.0,81,1,2,1,4,0xb2d41ef6
5900.94,1.0,11,2,2,3,7,0xb2d912e5d
250015.31,3.0,25,3,4,2,9,0xb2d92e39d
21175.69,1.0,19,2,2,2,6,0xb2d1f23c
288.21,1.0,30,1,2,2,5,0xb2d5a503
14.31,1.0,26,1,2,2,5,0xb2d4f999
299476.58,2.0,5,3,3,3,9,0xb2d155f2
8628.06,1.0,10,2,2,3,7,0xb2d2b5c7
265708.4,8.0,0,3,4,4,11,0xb2d52e3fd
50101.94,2.0,1,2,3,4,9,0xb2d5a43f
500027.14,4.0,10,4,4,3,11,0xb2d7167f
70006.52,2.0,13,3,3,3,9,0xb2d3c414
8000280.88,4.0,18,4,4,2,10,0xb2d1bd22
65347.62,4.0,25,3,4,2,9,0xb2d5c2a3d
4750.55,1.0,8,2,2,3,7,0xb2d92468
552437.66,3.0,108,4,4,1,9,0xb2d0ffc4d
364.7,1.0,30,1,2,2,5,0xb2d6575d
3.66,1.0,42,1,2,2,5,0xb2d25e4c
4450.96,1.0,0,2,2,4,8,0xb2d98651
1247.38,1.0,184,1,2,1,4,0xb2d260e4
200047.77,2.0,149,3,3,1,7,0xb2d0cd8b
1018.74,1.0,92,1,2,1,4,0xb2d1421b
518790.11,3.0,0,4,4,4,12,0xb2d41789
35071.96,2.0,11,2,3,3,8,0xb2d959ffd
22254.49,4.0,184,2,4,1,7,0xb2d07bb7
595821.13,7.0,16,4,4,2,10,0xb2d27034
5399.36,4.0,92,2,4,1,7,0xb2d07f42d
1600072.31,4.0,108,4,4,1,9,0xb2d5e71d
1240108.38,4.0,0,4,4,4,12,0xb2d5645d
668.58,1.0,11,1,2,3,6,0xb2d1d025
338869.79,1.0,97,4,2,1,7,0xb2d1fcf3
14.58,3.0,39,1,4,2,7,0xb2d0ac16
915215.51,6.0,0,4,4,4,12,0xb2d3c3ff
4758.96,1.0,14,2,2,3,7,0xb2d3192e
0.0,1.0,6,1,2,3,6,0xb2d942bc
1492.69,1.0,25,1,2,2,5,0xb2d76a17d
150000.13,2.0,0,3,3,4,10,0xb2d1d72fd
6364.88,1.0,29,2,2,2,6,0xb2d9233e
142008.6,3.0,13,3,4,3,10,0xb2d606e6d
260150.3,5.0,123,3,4,1,8,0xb2d2a107
4991.06,1.0,151,2,2,1,5,0xb2d1295cd
62.7,1.0,30,1,2,2,5,0xb2d612e6
5.03,1.0,1,1,2,4,7,0xb2d69ebfd
2.69,1.0,4,1,2,4,7,0xb2d956d0
100016.89,1.0,26,3,2,2,7,0xb2d9d0b8
10223.81,3.0,1,2,4,4,10,0xb2d084a2d
1068.98,1.0,15,1,2,3,6,0xb2d2dbe8
89.98,1.0,10,1,2,3,6,0xb2d2d38d
300012.8,2.0,11,3,3,3,9,0xb2d121c5
50001.08,2.0,123,2,3,1,6,0xb2d13bbb
60.67,1.0,82,1,2,1,4,0xb2d65c30
71537.34,3.0,80,3,4,1,8,0xb2d56f95
40184.84,2.0,49,2,3,2,7,0xb2d9d5e0
0.0,1.0,4,1,2,4,7,0xb2d973af
29102.38,1.0,18,2,2,2,6,0xb2d78e2a
24309.95,1.0,0,2,2,4,8,0xb2d2b5b6
20.04,1.0,0,1,2,4,7,0xb2d246f1
5019.39,1.0,92,2,2,1,5,0xb2d58bd6
669745.77,4.0,9,4,4,3,11,0xb2d172ead
1295.58,1.0,24,1,2,2,5,0xb2d5edbb
1129762.03,12.0,1,4,4,4,12,0xb2d689a4
470092.33,3.0,2,4,4,4,12,0xb2d910df
383044.84,6.0,6,4,4,3,11,0xb2d32f16d
813.97,1.0,22,1,2,2,5,0xb2d4e9bb
19.59,1.0,10,1,2,3,6,0xb2d48300
15817.78,1.0,0,2,2,4,8,0xb2d6c147
12155.55,1.0,14,2,2,3,7,0xb2d5cfbad
95001.91,6.0,7,3,4,3,10,0x3b9b2c6f
1050045.91,3.0,53,4,4,2,10,0xb2d9be3a
90010.87,4.0,60,3,4,2,9,0xb2d5d6e5
40.11,1.0,87,1,2,1,4,0xb2d56ff4
250063.38,4.0,32,3,4,2,9,0xb2d5b584
5463.04,2.0,92,2,3,1,6,0xb2d074d0
962746.59,5.0,96,4,4,1,9,0xb2d1cab3
18.41,1.0,70,1,2,1,4,0xb2d1248dd
100207.67,2.0,19,3,3,2,8,0xb2d0dccc
1410007.29,6.0,0,4,4,4,12,0xb2d249e5
665003.57,4.0,13,4,4,3,11,0xb2d8fd0e
6.33,2.0,60,1,3,2,6,0xb2d97f57
410282.94,6.0,3,4,4,4,12,0x3b9b34b7d
938085.23,5.0,1,4,4,4,12,0xb2d14ed0
30004.91,2.0,11,2,3,3,8,0xb2d7f54e
101923.36,1.0,0,3,2,4,9,0xb2d11b75
110362.6,5.0,139,3,4,1,8,0xb2d62842d
500005.28,2.0,27,4,3,2,9,0xb2d94201d
194377.61,6.0,0,3,4,4,11,0xb2d06b9ed
270018.6,5.0,77,3,4,1,8,0xb2d11c94d
558189.24,5.0,9,4,4,3,11,0xb2d2fb22
15904.4,1.0,25,2,2,2,6,0xb2d6c2bbd
196561.2,4.0,53,3,4,2,9,0xb2d56831
32179.84,1.0,192,2,2,1,5,0xb2d3477ed
49.93,4.0,208,1,4,1,6,0xb2d24479d
84.38,1.0,9,1,2,3,6,0xb2d90f3d
300015.84,2.0,98,3,3,1,7,0xb2d966a1
500781.39,3.0,7,4,4,3,11,0xb2d606d6
70.14,1.0,27,1,2,2,5,0xb2d45ef0
44.65,1.0,28,1,2,2,5,0xb2d2c6da
221647.69,3.0,102,3,4,1,8,0xb2d243ed
3507.45,1.0,7,2,2,3,7,0xb2d62578d
160637.54,2.0,107,3,3,1,7,0xb2d5c5e6
2520157.2,7.0,1,4,4,4,12,0xb2d118d4
52478.64,2.0,221,3,3,1,7,0xb2d2aa82d
67485.06,1.0,0,3,2,4,9,0xb2da28cc
558000.13,7.0,3,4,4,4,12,0xb2d26447
24099.41,1.0,0,2,2,4,8,0xb2d2e5a3
100048.24,2.0,92,3,3,1,7,0xb2d240b7
100003.18,3.0,74,3,4,1,8,0xb2d062eb
6990.91,1.0,29,2,2,2,6,0xb2d92350
7032.8,1.0,0,2,2,4,8,0xb2d69660
3.91,1.0,48,1,2,2,5,0xb2d6e3fc
70002.46,2.0,92,3,3,1,7,0xb2d62f5bd
33779.36,3.0,42,2,4,2,8,0xb2d123a5
512869.58,8.0,6,4,4,3,11,0xb2d79148
1644.01,2.0,92,1,3,1,5,0xb2d392cf
383266.8,5.0,4,4,4,4,12,0xb2d17d62
2.63,1.0,46,1,2,2,5,0xb2d5df38
101267.83,2.0,87,3,3,1,7,0xb2d21bfe
20280.24,1.0,11,2,2,3,7,0xb2d38947
64.58,1.0,0,1,2,4,7,0xb2d5dbd7d
500751.17,2.0,8,4,3,3,10,0xb2d9759d
20001.99,2.0,165,2,3,1,6,0xb2d786b6
220972.71,2.0,32,3,3,2,8,0xb2d65c99
1.78,1.0,39,1,2,2,5,0xb2d8ddc3
25008.25,1.0,92,2,2,1,5,0xb2d2204a
89000.0,2.0,3,3,3,4,10,0xb2d972db
200000.0,2.0,13,3,3,3,9,0xb2d9602dd
2566.24,1.0,184,1,2,1,4,0xb2d0b232
540027.2,6.0,13,4,4,3,11,0xb2d93c88
93043.49,4.0,1,3,4,4,11,0xb2d18ba8
1555021.07,51.0,19,4,4,2,10,0xb2d118ce
230000.0,5.0,0,3,4,4,11,0xb2d24077
1762754.26,9.0,38,4,4,2,10,0xb2d1b25e
263169.05,3.0,95,3,4,1,8,0xb2d62c2b
109001.59,8.0,19,3,4,2,9,0xb2d59bd4
100064.64,2.0,3,3,3,4,10,0xb2d6abc1
12.32,1.0,35,1,2,2,5,0xb2d9f445
1394.24,1.0,10,1,2,3,6,0xb2d50993
771.92,1.0,0,1,2,4,7,0xb2d11ab1
170953.59,6.0,5,3,4,3,10,0xb2d45285
420003.32,8.0,14,4,4,3,11,0xb2d6844d
300041.51,2.0,166,3,3,1,7,0xb2d0b408
506.95,2.0,5,1,3,3,7,0x3b9af235d
16286.08,3.0,101,2,4,1,7,0x3b9ad5d8
16219.44,1.0,11,2,2,3,7,0xb2da3144
1008.46,1.0,184,1,2,1,4,0xb2d34cc3d
0.0,1.0,8,1,2,3,6,0xb2d1be8c
402406.11,4.0,92,4,4,1,9,0xb2d0b368
370010.92,2.0,6,4,3,3,10,0xb2d23daa
789417.63,10.0,17,4,4,2,10,0x3b9af131
701781.42,5.0,15,4,4,3,11,0xb2d91f91
200000.0,1.0,1,3,2,4,9,0xb2da6692
12047.16,1.0,60,2,2,2,6,0xb2d1f0a5
300000.0,2.0,29,3,3,2,8,0xb2da0a0a
100001.06,2.0,42,3,3,2,8,0xb2d9e9cc
346.17,1.0,9,1,2,3,6,0xb2d7d889d
5709.0,1.0,22,2,2,2,6,0xb2d966e9
0.0,1.0,0,1,2,4,7,0xb2d40f3c
5186.49,1.0,29,2,2,2,6,0xb2d92d3d
5391.65,1.0,0,2,2,4,8,0xb2d607d6
9800000.0,2.0,3,4,3,4,11,0xb2d91f1cd
574110.79,9.0,3,4,4,4,12,0xb2d22fc8d
50008.21,1.0,0,2,2,4,8,0xb2d4d0dc
57.25,1.0,3,1,2,4,7,0xb2d35429
2876.91,1.0,13,1,2,3,6,0xb2d1d8ca
2.13,1.0,1,1,2,4,7,0xb2d22c86
741962.53,8.0,70,4,4,1,9,0xb2d2ad03
0.0,3.0,8,1,4,3,8,0xb2d17e39
116.4,1.0,0,1,2,4,7,0xb2d2ffb9
800001.0,9.0,4,4,4,4,12,0xb2d9f353
1604.44,1.0,1,1,2,4,7,0xb2d289ad
234.74,1.0,24,1,2,2,5,0xb2d6cac1
480000.0,3.0,2,4,4,4,12,0xb2d8f6a0d
40229.39,3.0,0,2,4,4,10,0x3b9b2e86
1017931.35,2.0,189,4,3,1,8,0xb2d5f351
554011.69,1.0,1,4,2,4,10,0xb2d37febd
151178.53,3.0,103,3,4,1,8,0xb2d43d1e
150000.83,5.0,0,3,4,4,11,0xb2d62ec0d
392.28,1.0,2,1,2,4,7,0xb2d5b576
1.06,1.0,64,1,2,2,5,0xb2d1ebc8
40001.69,2.0,74,2,3,1,6,0xb2d99716
2.11,1.0,77,1,2,1,4,0xb2d99146
1684003.26,6.0,8,4,4,3,11,0xb2d4155c
102.4,1.0,34,1,2,2,5,0xb2d3ac1c
350037.25,4.0,74,4,4,1,9,0xb2d28089
50467.34,2.0,60,2,3,2,7,0xb2d78c8a
619.26,1.0,0,1,2,4,7,0xb2d1e28c
2000068.11,3.0,0,4,4,4,12,0xb2d0cc7c
10146.02,1.0,92,2,2,1,5,0xb2d14452
73350.98,4.0,0,3,4,4,11,0xb2d20fa0
294.59,1.0,7,1,2,3,6,0xb2d27ee8
591.27,1.0,9,1,2,3,6,0xb2d4f67d
34653.24,1.0,0,2,2,4,8,0xb2d38738
400001.0,3.0,81,4,4,1,9,0xb2d8d5d7
230008.73,3.0,208,3,4,1,8,0xb2d53aa6d
1898.13,1.0,9,1,2,3,6,0xb2d0babf
120561.49,1.0,9,3,2,3,8,0xb2d33476
5019.02,1.0,3,2,2,4,8,0xb2da10b1
1369.43,1.0,9,1,2,3,6,0xb2d2c962
600113.76,4.0,20,4,4,2,10,0xb2d140d6
6054.14,1.0,92,2,2,1,5,0xb2d27bac
3143.37,1.0,9,2,2,3,7,0xb2d432aa
19656.96,2.0,0,2,3,4,9,0xb2d0e615d
100001.14,1.0,0,3,2,4,9,0xb2d38226d
20000.21,2.0,14,2,3,3,8,0xb2da37e7
1643.13,1.0,92,1,2,1,4,0xb2d323f6
24372.53,2.0,28,2,3,2,7,0xb2d74507
819473.07,6.0,43,4,4,2,10,0xb2d3237a
200422.44,3.0,0,3,4,4,11,0xb2d6962cd
366067.59,1.0,92,4,2,1,7,0xb2d20ee7
79.43,1.0,110,1,2,1,4,0xb2d5c760d
725.55,1.0,9,1,2,3,6,0xb2d4313b
50652.08,2.0,21,2,3,2,7,0xb2d0b1e5
380130.68,2.0,80,4,3,1,8,0xb2d8c9de
100079.11,2.0,56,3,3,2,8,0xb2d2d530
2300218.93,4.0,25,4,4,2,10,0xb2d20fdb
252000.0,12.0,9,3,4,3,10,0x3b9b3512
6799.59,1.0,60,2,2,2,6,0xb2d4adda
3094339.85,1.0,1,4,2,4,10,0xb2d28154d
490027.7,6.0,1,4,4,4,12,0xb2d5e07b
301.14,1.0,2,1,2,4,7,0xb2d967ac
260155.46,10.0,1,3,4,4,11,0xb2d112b1d
503026.32,3.0,1,4,4,4,12,0xb2d0c6ab
155.62,1.0,18,1,2,2,5,0xb2d1dae9
222607.28,12.0,34,3,4,2,9,0xb2d5b0d2d
3215.81,1.0,78,2,2,1,5,0xb2d30b72d
171274.78,4.0,35,3,4,2,9,0xb2d76b31d
18654.41,1.0,0,2,2,4,8,0xb2d6bdd4d
13597.61,1.0,0,2,2,4,8,0xb2d5c056
295046.02,5.0,80,3,4,1,8,0xb2d25f53
100000.0,2.0,4,3,3,4,10,0xb2da53dc
100122.63,2.0,0,3,3,4,10,0xb2d4f999d
94.93,1.0,47,1,2,2,5,0xb2d3d19b
160008.1,4.0,5,3,4,3,10,0xb2d61383d
41249.63,1.0,179,2,2,1,5,0xb2d4dbd8d
6.58,1.0,16,1,2,2,5,0xb2d59fb1
70610.81,5.0,76,3,4,1,8,0xb2d61145
550053.66,3.0,23,4,4,2,10,0xb2d9d288
1.5,1.0,8,1,2,3,6,0xb2d9d041
97500.75,1.0,13,3,2,3,8,0xb2d60468d
13254.91,1.0,13,2,2,3,7,0xb2d6bcfd
20608.78,1.0,35,2,2,2,6,0xb2d68968d
505274.15,5.0,3,4,4,4,12,0xb2d39a2b
250000.0,2.0,0,3,3,4,10,0xb2da6bc6
200000.0,2.0,5,3,3,3,9,0xb2d93320
6690.65,1.0,0,2,2,4,8,0xb2d87aa3d
348.4,1.0,6,1,2,3,6,0xb2d254a5
1001321.85,2.0,10,4,3,3,10,0xb2d68bc3
530493.97,6.0,3,4,4,4,12,0xb2d2d7a7
1748.47,1.0,3,1,2,4,7,0xb2d7f300d
500143.93,2.0,60,4,3,2,9,0xb2d2b654
615000.25,7.0,0,4,4,4,12,0xb2d56274
100002.64,3.0,27,3,4,2,9,0xb2d6faf4d
254716.36,3.0,25,3,4,2,9,0xb2d0ddb7
543.67,1.0,10,1,2,3,6,0xb2d7842d
420789.61,3.0,60,4,4,2,10,0xb2d12cb0
745.64,1.0,39,1,2,2,5,0xb2d43822
600000.0,2.0,20,4,3,2,9,0xb2d953e9d
4001.9,1.0,54,2,2,2,6,0xb2d90a06d
608.62,1.0,12,1,2,3,6,0xb2d2a40e
50269.78,2.0,5,2,3,3,8,0xb2d790bdd
152.18,1.0,47,1,2,2,5,0xb2d612ec
1078.9,1.0,92,1,2,1,4,0xb2d20f9b
340566.04,14.0,0,4,4,4,12,0xb2d064d1d
1820113.87,4.0,13,4,4,3,11,0xb2d64696
10121.61,1.0,184,2,2,1,5,0xb2d10a03d
22102.08,1.0,112,2,2,1,5,0xb2d27754
3844.48,1.0,123,2,2,1,5,0xb2d59f43
250000.0,2.0,0,3,3,4,10,0xb2d8f255
1656854.41,8.0,4,4,4,4,12,0xb2d5e4a3d
50371.13,1.0,184,2,2,1,5,0xb2d447a9d
3956.96,2.0,92,2,3,1,6,0x3b9af0a4
944.32,1.0,10,1,2,3,6,0xb2d6da14
51251.52,2.0,25,2,3,2,7,0xb2d1773b
9046000.56,5.0,4,4,4,4,12,0xb2d65b4ed
357530.49,6.0,0,4,4,4,12,0xb2d1772c
16.81,1.0,10,1,2,3,6,0xb2d686e1
150003.17,2.0,172,3,3,1,7,0xb2d8d417
508.08,1.0,2,1,2,4,7,0xb2d223dad
65007.67,2.0,56,3,3,2,8,0xb2d39c38d
307105.65,3.0,0,4,4,4,12,0xb2d360a6
5260.62,1.0,12,2,2,3,7,0xb2d58500
500011.47,3.0,193,4,4,1,9,0xb2d8149dd
923553.57,3.0,1,4,4,4,12,0xb2d4dc37
672.1,2.0,9,1,3,3,7,0xb2d20ebf
86435.78,1.0,26,3,2,2,7,0xb2d68502
95206.52,2.0,9,3,3,3,9,0xb2d3b05f
410000.0,3.0,1,4,4,4,12,0xb2d62fbe
120016.59,2.0,164,3,3,1,7,0xb2d23599d
1061480.19,2.0,0,4,3,4,11,0xb2d8fe1b
5535.88,2.0,17,2,3,2,7,0xb2d113d4
50077.17,2.0,32,2,3,2,7,0xb2d5f655
374.48,1.0,9,1,2,3,6,0xb2d3c695
100049.88,2.0,53,3,3,2,8,0xb2d90009d
101793.44,2.0,0,3,3,4,10,0xb2d5fbd9
823087.61,2.0,5,4,3,3,10,0xb2d13235
302911.81,5.0,5,4,4,3,11,0xb2d16f47
24668.15,1.0,8,2,2,3,7,0xb2d527aa
1520.53,1.0,184,1,2,1,4,0xb2d3dc17
234348.2,4.0,56,3,4,2,9,0xb2d09a5f
6484.11,1.0,196,2,2,1,5,0xb2d40cab
150167.93,1.0,3,3,2,4,9,0xb2d286fbd
186014.04,2.0,0,3,3,4,10,0xb2d103c9
22.51,1.0,19,1,2,2,5,0xb2d3cb06
110887.94,4.0,73,3,4,1,8,0xb2d59b24
664791.66,2.0,24,4,3,2,9,0xb2d2409f
290.85,1.0,41,1,2,2,5,0xb2d4913e
30000.61,2.0,31,2,3,2,7,0xb2d93aff
211778.88,2.0,0,3,3,4,10,0xb2d55e76
1162223.51,6.0,27,4,4,2,10,0xb2d10add
190129.6,3.0,129,3,4,1,8,0xb2d31cd2
50579.46,2.0,32,2,3,2,7,0xb2d499b6
393632.62,4.0,34,4,4,2,10,0xb2d5fcddd
502409.61,2.0,15,4,3,3,10,0xb2d5b50bd
5418.61,1.0,184,2,2,1,5,0xb2d1a5de
5712.62,1.0,115,2,2,1,5,0xb2d70095
205.76,1.0,32,1,2,2,5,0xb2d2f06e
250092.64,1.0,11,3,2,3,8,0xb2d2bfdd
4128.34,1.0,67,2,2,1,5,0xb2d1fc8d
11327.06,1.0,0,2,2,4,8,0xb2d30968
53720.29,2.0,0,3,3,4,10,0xb2d0d58d
60000.0,2.0,3,3,3,4,10,0xb2d975d0
5707.93,1.0,4,2,2,4,8,0xb2d636e0
500052.86,2.0,22,4,3,2,9,0xb2d9896e
680044.27,4.0,52,4,4,2,10,0xb2d62eb2
1934.1,1.0,184,1,2,1,4,0xb2d64bcad
81958.63,2.0,6,3,3,3,9,0xb2d59132
0.02,1.0,14,1,2,3,6,0xb2d6c9b8
13108.52,1.0,9,2,2,3,7,0xb2d5bd61
3.48,1.0,92,1,2,1,4,0xb2d39fe5d
897.65,1.0,2,1,2,4,7,0xb2d5be2d
10000.11,2.0,34,2,3,2,7,0xb2d932a5
1154.2,1.0,178,1,2,1,4,0xb2d237a9
287011.82,4.0,63,3,4,2,9,0xb2d5cc17
1036613.91,9.0,101,4,4,1,9,0xb2d08f09
293291.52,4.0,94,3,4,1,8,0xb2d377a8d
585.24,1.0,10,1,2,3,6,0xb2d43283
2000000.0,5.0,15,4,4,3,11,0xb2d6c2d4
2881.55,1.0,92,1,2,1,4,0xb2d34060d
811670.31,7.0,11,4,4,3,11,0xb2d06fd8
430078.77,6.0,5,4,4,3,11,0xb2d3cbd5
1.81,1.0,104,1,2,1,4,0xb2d5be69
92676.77,1.0,2,3,2,4,9,0xb2d77372
4846.1,2.0,162,2,3,1,6,0xb2d46af5
26.65,2.0,35,1,3,2,6,0xb2d2e449
395160.9,4.0,0,4,4,4,12,0xb2d40b32d
122468.09,3.0,235,3,4,1,8,0xb2d5b5f1d
13914.94,1.0,166,2,2,1,5,0xb2d1bd1c
10000.11,2.0,52,2,3,2,7,0xb2d90c7d
40353.95,1.0,2,2,2,4,8,0xb2d632ff
3.42,1.0,88,1,2,1,4,0xb2d5b141d
461.0,1.0,54,1,2,2,5,0xb2d5d09a
501245.54,4.0,13,4,4,3,11,0xb2d5ada9
130058.05,2.0,116,3,3,1,7,0xb2d6a788d
86972.16,3.0,5,3,4,3,10,0xb2d5f647
39.39,1.0,4,1,2,4,7,0xb2d7c2c3
230373.16,4.0,90,3,4,1,8,0xb2d1113d
750000.24,2.0,14,4,3,3,10,0xb2d6e458d
1904090.65,1.0,6,4,2,3,9,0xb2d921ae
2635.57,1.0,92,1,2,1,4,0xb2d0c49c
1365.87,1.0,6,1,2,3,6,0xb2d23df9
543966.49,2.0,0,4,3,4,11,0xb2d62b8ed
80029.63,2.0,18,3,3,2,8,0xb2d41c79d
230014.73,2.0,55,3,3,2,8,0xb2d6335c
25451.74,1.0,6,2,2,3,7,0xb2d6210e
14.8,6.0,30,1,4,2,7,0xb2d520eed
271579.57,3.0,16,3,4,2,9,0xb2d5c8bd
350000.0,1.0,0,4,2,4,10,0xb2d96f79
124579.76,1.0,10,3,2,3,8,0xb2d9419a
345.27,1.0,3,1,2,4,7,0xb2d5fda5
30000.01,2.0,14,2,3,3,8,0xb2d8cc7d
7.95,1.0,26,1,2,2,5,0xb2d88115
14.28,1.0,34,1,2,2,5,0xb2d97074
1973.08,1.0,184,1,2,1,4,0xb2d1ba2ad
1071.63,1.0,2,1,2,4,7,0xb2d5cf9e
6842.46,1.0,7,2,2,3,7,0xb2d32995
1332087.17,5.0,31,4,4,2,10,0xb2d6b27c
98.73,1.0,11,1,2,3,6,0xb2d1f908
2712650.22,4.0,2,4,4,4,12,0xb2d0c1d1
1687.78,1.0,184,1,2,1,4,0xb2d11488
256250.77,3.0,39,3,4,2,9,0x3b9b2a50
91958.89,1.0,5,3,2,3,8,0xb2d39096
520145.21,7.0,0,4,4,4,12,0x3b9af2bd
250000.0,2.0,4,3,3,4,10,0xb2d53ac4
562.16,1.0,1,1,2,4,7,0xb2d28c7e
80102.57,2.0,41,3,3,2,8,0xb2d9e757
790027.07,5.0,6,4,4,3,11,0xb2d6a318
1305.85,1.0,88,1,2,1,4,0xb2d2fb27d
300003.17,2.0,14,3,3,3,9,0xb2da39fc
1101.44,1.0,21,1,2,2,5,0xb2da05f9
0.0,2.0,27,1,3,2,6,0xb2d944b2
20890.44,1.0,92,2,2,1,5,0xb2d0f85d
4170.35,1.0,9,2,2,3,7,0xb2d2f5d1
470039.24,2.0,13,4,3,3,10,0xb2d99ccb
73017.35,2.0,83,3,3,1,7,0xb2d1b968d
1390007.48,6.0,11,4,4,3,11,0xb2d7e03ed
23678.43,1.0,7,2,2,3,7,0xb2d90844
510500.01,2.0,26,4,3,2,9,0xb2d5cbbe
300097.16,2.0,11,3,3,3,9,0xb2d8015d
81959.83,3.0,76,3,4,1,8,0xb2d5cd33
29111.64,1.0,31,2,2,2,6,0xb2d40d54
2799.04,1.0,5,1,2,3,6,0xb2d37422
615693.43,5.0,6,4,4,3,11,0xb2d594b1d
300000.0,2.0,8,3,3,3,9,0xb2da5142
43358.22,1.0,5,2,2,3,7,0xb2d34aaf
86857.63,3.0,171,3,4,1,8,0xb2d5f887
2758.36,1.0,92,1,2,1,4,0xb2d134bfd
332387.97,3.0,3,4,4,4,12,0x3b9b4994d
141002.51,9.0,27,3,4,2,9,0xb2d5a4d7d
120001.27,2.0,92,3,3,1,7,0xb2d63729
1117.57,1.0,0,1,2,4,7,0xb2d34d65d
5170.81,3.0,0,2,4,4,10,0x3b9b1a39d
1078820.58,11.0,0,4,4,4,12,0xb2d906dc
3684536.01,7.0,42,4,4,2,10,0xb2d60430
73021.36,3.0,11,3,4,3,10,0xb2d5c789d
1022.45,1.0,10,1,2,3,6,0xb2d2c250d
375137.53,3.0,25,4,4,2,10,0xb2d539fa
900015.31,4.0,11,4,4,3,11,0xb2d49ebd
1428.53,1.0,92,1,2,1,4,0xb2d0f593
280023.48,3.0,192,3,4,1,8,0xb2d1080d
68001.14,4.0,10,3,4,3,10,0xb2d92854d
1103.8,1.0,184,1,2,1,4,0xb2d526b3
1196310.89,4.0,0,4,4,4,12,0xb2d5728f
1194.37,1.0,184,1,2,1,4,0xb2d349b0
22441.56,1.0,3,2,2,4,8,0xb2d27bb2
1363.82,1.0,0,1,2,4,7,0xb2d40acb
210792.21,2.0,31,3,3,2,8,0xb2d98530
25867.74,1.0,13,2,2,3,7,0xb2d24fda
658.55,1.0,0,1,2,4,7,0xb2d55cd4
15203.18,1.0,5,2,2,3,7,0xb2d3c9b0
170355.48,1.0,0,3,2,4,9,0xb2d6bf0f
11238.54,1.0,7,2,2,3,7,0xb2d5d500
104000.71,2.0,8,3,3,3,9,0xb2d90f5bd
78.54,1.0,9,1,2,3,6,0xb2d63c24
200002.11,2.0,94,3,3,1,7,0xb2d8908ed
50001.06,2.0,18,2,3,2,7,0xb2d9546b
16670.57,1.0,8,2,2,3,7,0xb2d423a1
1174.91,1.0,21,1,2,2,5,0xb2d2058a
10002175.3,2.0,34,4,3,2,9,0xb2d68bd7d
265.43,1.0,10,1,2,3,6,0xb2d512c7
1862.21,1.0,92,1,2,1,4,0xb2d1b081d
220080.01,2.0,24,3,3,2,8,0xb2da1e7d
45532.25,1.0,6,2,2,3,7,0xb2d2a91f
25.01,1.0,10,1,2,3,6,0xb2d8f81f
24570.61,1.0,15,2,2,3,7,0xb2d2ba37
15501.69,1.0,3,2,2,4,8,0xb2d61992d
1749.96,1.0,140,1,2,1,4,0xb2d6275a
5572.62,2.0,28,2,3,2,7,0xb2d22c36
1400873.59,3.0,11,4,4,3,11,0xb2d17a44
14813.2,1.0,1,2,2,4,8,0xb2d6bfe5
200000.0,2.0,1,3,3,4,10,0xb2da3220
6565.38,1.0,0,2,2,4,8,0xb2d95282
2688.25,1.0,5,1,2,3,6,0xb2d67d5c
52224.67,4.0,1,3,4,4,11,0xb2d15e11d
63.29,1.0,65,1,2,2,5,0xb2d3c4f0d
7462.12,1.0,2,2,2,4,8,0xb2d20e75
793287.74,10.0,3,4,4,4,12,0xb2d5dde6d
500006.0,2.0,3,4,3,4,11,0xb2d96f1a
2119.79,1.0,10,1,2,3,6,0xb2d3ccc8
7606.09,1.0,7,2,2,3,7,0xb2d4c21a
500099.45,3.0,46,4,4,2,10,0xb2d296bb
34656.5,2.0,25,2,3,2,7,0xb2d0f724
600063.38,2.0,0,4,3,4,11,0xb2d8e19b
1672148.04,7.0,30,4,4,2,10,0xb2d4b729d
714.9,1.0,24,1,2,2,5,0xb2d20c5a
340078.05,4.0,26,4,4,2,10,0xb2d0c5e9d
84.4,1.0,63,1,2,2,5,0xb2d213c1
68005.33,2.0,157,3,3,1,7,0xb2d44a6f
1231.7,1.0,9,1,2,3,6,0xb2d241e6
100097.07,3.0,41,3,4,2,9,0xb2d55ed1
348162.13,1.0,50,4,2,2,8,0xb2d9622d
493270.02,7.0,97,4,4,1,9,0x3b9b480e
261901.16,2.0,3,3,3,4,10,0xb2d1ad2e
110002.55,7.0,95,3,4,1,8,0xb2d54ae2
1057.3,1.0,92,1,2,1,4,0xb2d1f698
501794.3,2.0,0,4,3,4,11,0xb2d97351d
20000.0,1.0,7,2,2,3,7,0xb2d92927
10836.38,1.0,11,2,2,3,7,0xb2d586cc
2137.37,1.0,1,1,2,4,7,0xb2d54c37
498367.12,6.0,0,4,4,4,12,0xb2d2d0db
50193.46,1.0,92,2,2,1,5,0xb2d58e0ad
1852.34,3.0,0,1,4,4,9,0x3b9b3ae1
184.47,1.0,76,1,2,1,4,0xb2d2ae3f
9654.14,1.0,92,2,2,1,5,0xb2d24a65
104599.82,2.0,143,3,3,1,7,0xb2d48b54
100007.4,2.0,118,3,3,1,7,0xb2d74373
1347.96,1.0,92,1,2,1,4,0x3b9b381d
2511.24,1.0,198,1,2,1,4,0xb2d2e486d
20266.66,1.0,150,2,2,1,5,0xb2d630bd
3000031.71,7.0,21,4,4,2,10,0xb2d60805
14.86,1.0,46,1,2,2,5,0xb2d9024f
261867.62,3.0,18,3,4,2,9,0xb2d212b1d
0.0,2.0,9,1,3,3,7,0xb2d93ab0
47000.4,8.0,2,2,4,4,10,0xb2d27356d
1108.31,1.0,184,1,2,1,4,0xb2d1043bd
216483.96,3.0,203,3,4,1,8,0xb2d1069d
689633.66,5.0,116,4,4,1,9,0xb2d355ef
106997.58,4.0,0,3,4,4,11,0xb2d141fcd
270611.73,3.0,10,3,4,3,10,0xb2d90891
1824.46,1.0,184,1,2,1,4,0xb2d42b2fd
171955.68,7.0,18,3,4,2,9,0xb2d5adc0
270009.06,2.0,9,3,3,3,9,0xb2d9f67e
490002.73,5.0,4,4,4,4,12,0xb2d17257d
207114.16,2.0,97,3,3,1,7,0xb2d68232
6134.66,1.0,29,2,2,2,6,0xb2d6d2d6
2247.52,1.0,10,1,2,3,6,0xb2d3b141
192000.0,4.0,96,3,4,1,8,0xb2d59b94
237967.2,4.0,67,3,4,1,8,0xb2d5fcf1
7998.67,1.0,39,2,2,2,6,0xb2d92b4c
620000.0,3.0,9,4,4,3,11,0xb2d274f2
6750.07,1.0,20,2,2,2,6,0xb2d937d2
303819.49,5.0,11,4,4,3,11,0xb2d4df1d
451322.26,4.0,0,4,4,4,12,0xb2d5d393
800000.0,2.0,21,4,3,2,9,0xb2da27f3
91611.89,6.0,28,3,4,2,9,0xb2d59a67
358005.5,4.0,92,4,4,1,9,0xb2d3afb4
198.58,1.0,25,1,2,2,5,0xb2d6a172
41.86,1.0,72,1,2,1,4,0xb2d28ffd
153920.59,2.0,0,3,3,4,10,0xb2d064d5
4025.27,1.0,92,2,2,1,5,0xb2d2098e
10049.25,3.0,92,2,4,1,7,0xb2d26fca
61082.04,2.0,2,3,3,4,10,0xb2d3c503d
2.72,1.0,76,1,2,1,4,0xb2d1a547d
610287.73,9.0,0,4,4,4,12,0x3b9b1917
298952.54,3.0,167,3,4,1,8,0xb2d13269
8457.44,1.0,21,2,2,2,6,0xb2d9641d
600002.1,4.0,8,4,4,3,11,0xb2d791bfd
2950630.67,5.0,60,4,4,2,10,0xb2d288de
5232.17,1.0,4,2,2,4,8,0xb2d75b4d
55.4,1.0,9,1,2,3,6,0xb2d90d38
50002.22,2.0,14,2,3,3,8,0xb2d605b6
4598.83,1.0,1,2,2,4,8,0xb2d31e3b
3799.61,1.0,92,2,2,1,5,0xb2d3c233
210746.84,2.0,33,3,3,2,8,0xb2d9361b
321692.7,3.0,27,4,4,2,10,0xb2d2d5f2d
502307.07,3.0,147,4,4,1,9,0x3b9b2f90
6000.0,1.0,1,2,2,4,8,0xb2d925f8
257778.04,3.0,265,3,4,1,8,0xb2d0913f
81167.66,2.0,0,3,3,4,10,0xb2d5bca8d
250095.2,5.0,63,3,4,2,9,0xb2d26635
1.42,1.0,41,1,2,2,5,0xb2d691d3d
10000.42,2.0,112,2,3,1,6,0xb2d94d3a
516257.52,4.0,48,4,4,2,10,0xb2d2c960
343003.68,5.0,0,4,4,4,12,0x3b9b2453
4089.61,1.0,3,2,2,4,8,0xb2d6baec
305138.32,19.0,11,4,4,3,11,0xb2d10f56
721944.66,14.0,8,4,4,3,11,0xb2d35c05
140003.93,3.0,62,3,4,2,9,0xb2d7acf6
5121.46,1.0,92,2,2,1,5,0xb2d53dee
1124.87,1.0,0,1,2,4,7,0xb2d9d5d4
517288.48,2.0,83,4,3,1,8,0xb2d1b3a4
172330.21,9.0,0,3,4,4,11,0xb2d59b6f
55301.47,2.0,74,3,3,1,7,0xb2d5d2c7
5131.47,1.0,12,2,2,3,7,0xb2d57ab3d
7951.1,1.0,18,2,2,2,6,0xb2d347a5
8696.37,1.0,0,2,2,4,8,0xb2d25dec
450173.3,4.0,34,4,4,2,10,0xb2d8eded
18350.8,1.0,33,2,2,2,6,0xb2d68221
2003072.0,10.0,15,4,4,3,11,0xb2d2d4fa
500002.44,3.0,23,4,4,2,10,0xb2d44a0d
0.0,1.0,9,1,2,3,6,0xb2d2240b
359.94,1.0,0,1,2,4,7,0xb2d621f7
521485.29,6.0,10,4,4,3,11,0xb2d3048a
230012.14,2.0,14,3,3,3,9,0xb2da2b39
7032.69,1.0,9,2,2,3,7,0xb2d2b612
10138.5,1.0,92,2,2,1,5,0xb2d5e7aa
20012.78,3.0,43,2,4,2,8,0xb2d57aa7
4401982.21,12.0,4,4,4,4,12,0xb2d1af5a
285981.0,2.0,0,3,3,4,10,0xb2d4bfab
1067.79,1.0,184,1,2,1,4,0xb2d0e1b8
501061.74,2.0,1,4,3,4,11,0xb2d9c9fe
6765.49,1.0,0,2,2,4,8,0xb2d8ee31
152.57,1.0,9,1,2,3,6,0xb2d2ee85
130.74,1.0,53,1,2,2,5,0xb2d91992
1551.86,1.0,161,1,2,1,4,0xb2d2c463
200006.91,5.0,1,3,4,4,11,0xb2d67a70
6.45,1.0,69,1,2,1,4,0xb2d5b06c
62315.24,2.0,0,3,3,4,10,0xb2d65027
2758.88,1.0,10,1,2,3,6,0xb2d416ec
306695.91,2.0,7,4,3,3,10,0xb2d2c6e9
30001.25,3.0,62,2,4,2,8,0xb2d6c815
2987.63,2.0,3,2,3,4,9,0x3b9b27ddd
4646.47,1.0,19,2,2,2,6,0xb2da0a6e
1550016.36,2.0,25,4,3,2,9,0xb2da11ad
1635.55,1.0,92,1,2,1,4,0xb2d31145
17.73,1.0,19,1,2,2,5,0xb2d4a6c9
292.22,1.0,0,1,2,4,7,0xb2d8f6e7
410780.35,5.0,3,4,4,4,12,0xb2d15424
77807.03,1.0,20,3,2,2,7,0xb2d99499
167423.44,4.0,172,3,4,1,8,0xb2d1bfca
110.99,1.0,9,1,2,3,6,0xb2d5c43b
17.27,1.0,89,1,2,1,4,0xb2d6e899
330037.71,2.0,32,4,3,2,9,0xb2d1c85f
103090.29,2.0,185,3,3,1,7,0xb2d402e2d
963153.44,8.0,48,4,4,2,10,0xb2d35c52
11.11,1.0,4,1,2,4,7,0xb2d69320
6033.38,1.0,11,2,2,3,7,0xb2d37437
7569.88,2.0,92,2,3,1,6,0xb2d28705d
346045.45,1.0,283,4,2,1,7,0xb2d193e5
500000.0,2.0,3,4,3,4,11,0xb2d94526
250728.1,4.0,6,3,4,3,10,0xb2d43cf1d
400000.0,4.0,4,4,4,4,12,0xb2d8e0e7
830008.55,6.0,5,4,4,3,11,0xb2d5cdc1
2000381.55,1.0,0,4,2,4,10,0xb2d21208
602.12,1.0,0,1,2,4,7,0xb2d35030
410075.36,3.0,13,4,4,3,11,0xb2d645e8d
7754.07,1.0,9,2,2,3,7,0xb2d99d8b
900000.0,2.0,6,4,3,3,10,0xb2d698e7
7326.45,1.0,92,2,2,1,5,0xb2d11dbc
687540.18,5.0,20,4,4,2,10,0xb2d0cfad
929818.46,2.0,63,4,3,2,9,0xb2d5f61a
501787.78,3.0,32,4,4,2,10,0xb2d91280
2150.11,2.0,43,1,3,2,6,0xb2d087ebd
50000.0,1.0,3,2,2,4,8,0xb2d97449
87.51,1.0,24,1,2,2,5,0xb2d68180
110000.0,3.0,0,3,4,4,11,0xb2d98171
105124.02,4.0,21,3,4,2,9,0x3b9b2b8fd
1797000.0,6.0,0,4,4,4,12,0xb2d1c87f
296081.76,3.0,42,3,4,2,9,0xb2d56e98d
2058422.63,5.0,5,4,4,3,11,0xb2d59df8
29723.41,1.0,21,2,2,2,6,0xb2d3769d
161.9,1.0,104,1,2,1,4,0xb2d5387ad
400989.82,1.0,25,4,2,2,8,0xb2d0e6f3
460043.53,6.0,18,4,4,2,10,0xb2d19dc3d
700055.24,3.0,7,4,4,3,11,0xb2d986de
174004.92,5.0,0,3,4,4,11,0xb2d2e492d
93.73,1.0,51,1,2,2,5,0xb2d6bd27
27.2,1.0,5,1,2,3,6,0xb2d6359b
3208.21,2.0,20,2,3,2,7,0x3b9b1013
100002.49,2.0,87,3,3,1,7,0xb2d526f2
140006.79,4.0,55,3,4,2,9,0xb2d6d1fa
5321.9,1.0,19,2,2,2,6,0xb2d2d5e3
466609.07,3.0,2,4,4,4,12,0xb2d2628fd
1184.44,1.0,26,1,2,2,5,0xb2d46633
6810.95,1.0,1,2,2,4,8,0xb2d8ebcb
4.43,1.0,81,1,2,1,4,0xb2d8cf4e
3411.53,1.0,10,2,2,3,7,0xb2d96b1e
598403.55,4.0,5,4,4,3,11,0xb2d526bb
50001.06,2.0,25,2,3,2,7,0xb2da0daa
1785.28,1.0,13,1,2,3,6,0xb2d77fa2d
1818.66,1.0,157,1,2,1,4,0xb2d4b45f
173163.64,1.0,0,3,2,4,9,0xb2d6dead
3136.91,1.0,97,2,2,1,5,0xb2d6d8cc
6313.69,1.0,0,2,2,4,8,0xb2d426acd
545869.2,2.0,19,4,3,2,9,0xb2d78286d
101637.53,2.0,207,3,3,1,7,0xb2d692e7
636.01,1.0,6,1,2,3,6,0xb2d229ae
80650.24,4.0,6,3,4,3,10,0xb2d53044
0.92,1.0,8,1,2,3,6,0xb2d63595
850000.0,5.0,9,4,4,3,11,0xb2d3f6c6
2562.54,1.0,3,1,2,4,7,0xb2d39207
1001.03,1.0,91,1,2,1,4,0xb2d405c9
110.76,2.0,7,1,3,3,7,0xb2d29363
144165.48,2.0,7,3,3,3,9,0x3b9b2e44
3703.32,1.0,92,2,2,1,5,0xb2d21871d
4.79,1.0,46,1,2,2,5,0xb2d63e1d
3.45,1.0,78,1,2,1,4,0xb2d66575
47806.75,1.0,151,2,2,1,5,0xb2d6dedd
180041.8,1.0,31,3,2,2,7,0xb2d12517d
300022.35,3.0,27,3,4,2,9,0xb2d596d9
0.05,1.0,3,1,2,4,7,0xb2d6eb97
107631.99,2.0,92,3,3,1,7,0xb2d377b4d
1734.28,1.0,0,1,2,4,7,0xb2d2ecda
1173658.72,4.0,31,4,4,2,10,0xb2d360a0
360953.85,3.0,30,4,4,2,10,0xb2d966a8
1051793.63,10.0,4,4,4,4,12,0xb2d3bf29
1422.7,1.0,184,1,2,1,4,0xb2d1c1d3
1020020.64,6.0,144,4,4,1,9,0xb2d1868a
132.96,1.0,62,1,2,2,5,0xb2d5e719
13162.09,1.0,92,2,2,1,5,0xb2d20338
8.98,1.0,71,1,2,1,4,0xb2d06737
211.62,1.0,3,1,2,4,7,0xb2d967dc
1.0,1.0,92,1,2,1,4,0xb2d2958ed
12000.34,2.0,6,2,3,3,8,0xb2d94ac3
304005.68,5.0,39,4,4,2,10,0xb2d245a0d
10.46,1.0,2,1,2,4,7,0xb2d30ddb
4.31,1.0,84,1,2,1,4,0xb2d5910c
418.6,2.0,2,1,3,4,8,0xb2d1cbf2
217.11,1.0,14,1,2,3,6,0xb2d24a98d
1666.8,1.0,127,1,2,1,4,0xb2d2d977
171040.52,1.0,3,3,2,4,9,0xb2d651ab
1250077.25,3.0,174,4,4,1,9,0xb2d1c1dc
15.98,1.0,87,1,2,1,4,0xb2d29d01
15318.46,1.0,6,2,2,3,7,0xb2da4ecb
45076.86,1.0,23,2,2,2,6,0xb2d5cbf1d
400000.0,2.0,1,4,3,4,11,0xb2da6693
37078.02,4.0,95,2,4,1,7,0xb2d5808c
14574.56,9.0,0,2,4,4,10,0xb2d0f34cd
5995.88,1.0,0,2,2,4,8,0xb2d93e91
272299.25,5.0,39,3,4,2,9,0xb2d5769a
80087.47,2.0,110,3,3,1,7,0xb2d6e6c6d
1248.27,2.0,92,1,3,1,5,0xb2d0ef90
25000.26,2.0,105,2,3,1,6,0xb2d95d2d
2041.28,1.0,9,1,2,3,6,0xb2d70133
301263.98,2.0,0,4,3,4,11,0xb2d61499
203249.2,5.0,47,3,4,2,9,0xb2d55e32
802929.2,2.0,17,4,3,2,9,0xb2d620ea
260020.71,3.0,9,3,4,3,10,0xb2d1af08
200032.87,2.0,23,3,3,2,8,0xb2d6e824
361926.13,2.0,60,4,3,2,9,0xb2d54df9d
210292.33,4.0,41,3,4,2,9,0xb2d14d02
681030.21,3.0,18,4,4,2,10,0xb2d1bb89
410005.07,16.0,0,4,4,4,12,0xb2d5f1cd
311210.95,4.0,14,4,4,3,11,0xb2d3a82e
300009.5,2.0,22,3,3,2,8,0xb2da1a2f
109424.43,1.0,184,3,2,1,6,0xb2d18b5b
1510.99,1.0,184,1,2,1,4,0xb2d63624d
200710.48,2.0,48,3,3,2,8,0xb2d9df8f
48.08,1.0,77,1,2,1,4,0xb2d59fc8d
31258.31,2.0,92,2,3,1,6,0xb2d1e27e
200000.0,2.0,8,3,3,3,9,0xb2da507c
303616.37,3.0,4,4,4,4,12,0xb2d3d247
182500.0,6.0,4,3,4,4,11,0xb2d4a5b0d
11.21,1.0,46,1,2,2,5,0xb2d90e91
117091.59,2.0,7,3,3,3,9,0xb2d421ff
0.0,1.0,3,1,2,4,7,0xb2d690c2
46.96,1.0,60,1,2,2,5,0xb2d1c5b4d
7721.39,4.0,17,2,4,2,8,0xb2d78181
10002.01,2.0,165,2,3,1,6,0xb2d8e350d
38255.57,1.0,3,2,2,4,8,0xb2d5c73d
300035.67,3.0,18,3,4,2,9,0xb2d254f2
131841.67,2.0,164,3,3,1,7,0xb2d294d6
100000.0,2.0,0,3,3,4,10,0xb2d3dfe2
50889.76,2.0,45,2,3,2,7,0xb2d62d5c
83041.1,1.0,0,3,2,4,9,0xb2d0fc9e
3449.37,1.0,6,2,2,3,7,0xb2d3341fd
275733.06,3.0,0,3,4,4,11,0xb2d4115c
333522.0,3.0,34,4,4,2,10,0xb2d87beed
673.31,1.0,21,1,2,2,5,0xb2d92f00
310328.54,1.0,5,4,2,3,9,0xb2d23746
107.79,1.0,21,1,2,2,5,0xb2d95d8b
3934.82,1.0,0,2,2,4,8,0xb2d9b2fc
4904051.55,1.0,0,4,2,4,10,0xb2d2fbc5
601422.47,4.0,21,4,4,2,10,0xb2d2c90a
20372.88,2.0,55,2,3,2,7,0xb2d604ef
13864.45,1.0,0,2,2,4,8,0xb2d41f87
310047.36,6.0,28,4,4,2,10,0xb2d11753
209.81,1.0,0,1,2,4,7,0xb2d93d27
50708.2,2.0,0,2,3,4,9,0xb2d426a4
675188.29,3.0,36,4,4,2,10,0x3b9b27bc
368.25,1.0,0,1,2,4,7,0xb2d31b89
158950.78,2.0,104,3,3,1,7,0xb2d2164a
211.79,1.0,19,1,2,2,5,0xb2d54cc6
1400074.43,2.0,0,4,3,4,11,0xb2d925f9d
1251038.02,4.0,45,4,4,2,10,0xb2d551c6
500015.53,3.0,8,4,4,3,11,0xb2d6702f
1536099.0,6.0,19,4,4,2,10,0xb2d3cd34
38.51,1.0,0,1,2,4,7,0xb2d4092c
790013.42,3.0,111,4,4,1,9,0xb2d6344cd
150004.75,5.0,52,3,4,2,9,0xb2d908b6
7331.74,1.0,4,2,2,4,8,0xb2d6c4e3d
6.72,1.0,12,1,2,3,6,0xb2d601c6d
1.1,1.0,88,1,2,1,4,0xb2d59a05
45354.16,4.0,0,2,4,4,10,0x3b9b18c7
1010.15,1.0,92,1,2,1,4,0xb2d2834a
2122.66,1.0,0,1,2,4,7,0xb2d3d83e
1792.74,1.0,0,1,2,4,7,0xb2d40fa7d
456800.12,2.0,47,4,3,2,9,0xb2d67dcc
10014.47,1.0,147,2,2,1,5,0xb2d1ad7e
304057.83,4.0,0,4,4,4,12,0xb2d98aa8
854.65,1.0,1,1,2,4,7,0xb2d53e47d
2572.96,1.0,0,1,2,4,7,0xb2d4459a
11053.68,1.0,20,2,2,2,6,0xb2d6d968
3787.74,1.0,8,2,2,3,7,0xb2d91ed1
50738.24,1.0,92,2,2,1,5,0xb2d0b8a5
215691.6,2.0,21,3,3,2,8,0xb2d2e122d
0.0,1.0,1,1,2,4,7,0xb2d6553c
201421.21,2.0,81,3,3,1,7,0xb2d9902b
3049.42,1.0,92,2,2,1,5,0xb2d0f336
73960.64,5.0,94,3,4,1,8,0x3b9af3b2
530488.9,3.0,10,4,4,3,11,0xb2d3b590
98372.88,3.0,0,3,4,4,11,0xb2d69e8e
701850.35,13.0,0,4,4,4,12,0xb2d5b5cf
50682.49,1.0,184,2,2,1,5,0xb2d1d026
3000063.33,2.0,18,4,3,2,9,0xb2d95418
228625.11,1.0,4,3,2,4,9,0xb2d42958
117528.11,2.0,21,3,3,2,8,0xb2d323e7
500002.02,2.0,3,4,3,4,11,0xb2d93756
23.55,2.0,75,1,3,1,5,0xb2d1d155
51089.4,1.0,0,2,2,4,8,0xb2d605cd
1011.99,1.0,92,1,2,1,4,0xb2d1ddb4
3532.46,1.0,92,2,2,1,5,0xb2d2a40a
52778.28,2.0,95,3,3,1,7,0xb2d50671d
480000.51,3.0,15,4,4,3,11,0xb2d693d6
321136.69,2.0,42,4,3,2,9,0xb2d9205d
336.51,1.0,22,1,2,2,5,0xb2d26053
10719.76,1.0,184,2,2,1,5,0xb2d1f960
20.1,1.0,25,1,2,2,5,0xb2d25aa2d
20000.32,3.0,10,2,4,3,9,0xb2d633c6
57078.27,1.0,4,3,2,4,9,0xb2d47436
3144.92,1.0,12,2,2,3,7,0xb2d563ab
380081.42,4.0,0,4,4,4,12,0xb2d6172a
120071.84,5.0,4,3,4,4,11,0xb2d69b51d
100001.06,2.0,49,3,3,2,8,0xb2d9b96d
832266.04,6.0,49,4,4,2,10,0xb2d16dc4d
80853.46,1.0,4,3,2,4,9,0xb2d5963cd
400025.66,2.0,76,4,3,1,8,0xb2d6903d
15.52,1.0,12,1,2,3,6,0xb2d926f2
80000.58,5.0,80,3,4,1,8,0xb2d52ddb
32772.76,1.0,7,2,2,3,7,0xb2d5d13b
700000.81,3.0,16,4,4,2,10,0xb2d179ee
58.87,1.0,22,1,2,2,5,0xb2d99f5e
304264.97,2.0,111,4,3,1,8,0xb2d91249
50982.65,1.0,15,2,2,3,7,0xb2d7074f
20219.23,2.0,35,2,3,2,7,0xb2d2d8c1
288.35,1.0,5,1,2,3,6,0xb2d232bb
250064.43,2.0,13,3,3,3,9,0xb2d6c7cf
2965233.49,11.0,5,4,4,3,11,0x3b9b32a2
10000.21,2.0,18,2,3,2,7,0xb2da2ced
297988.07,1.0,0,3,2,4,9,0xb2d210a8
55201.32,7.0,16,3,4,2,9,0xb2d0f937d
502241.95,5.0,0,4,4,4,12,0xb2d63ec3
554.71,1.0,6,1,2,3,6,0xb2d680a9
1.6,1.0,77,1,2,1,4,0xb2d93ccb
715116.48,9.0,56,4,4,2,10,0xb2d57e23
2282.68,1.0,10,1,2,3,6,0xb2d3c7fe
972.29,1.0,25,1,2,2,5,0xb2d637d1
3122244.63,5.0,1,4,4,4,12,0xb2d21982
31727.1,1.0,214,2,2,1,5,0xb2d3ca1a
16606.01,2.0,3,2,3,4,9,0xb2d62441d
1095257.41,2.0,119,4,3,1,8,0xb2d1e302
200046.56,2.0,18,3,3,2,8,0xb2d58a14
0.0,1.0,0,1,2,4,7,0xb2da5b75
150065.47,3.0,11,3,4,3,10,0xb2d9478f
110227.17,2.0,18,3,3,2,8,0xb2d6e069
475818.06,4.0,139,4,4,1,9,0xb2d11c29d
100095.46,2.0,59,3,3,2,8,0xb2d10e0fd
425877.66,3.0,5,4,4,3,11,0xb2d26f4d
81600.98,4.0,40,3,4,2,9,0xb2d61119d
463.64,1.0,21,1,2,2,5,0xb2d2580d
700051.43,3.0,9,4,4,3,11,0xb2d6e4e9
2612000.0,22.0,3,4,4,4,12,0xb2d8e984
2636.85,1.0,184,1,2,1,4,0xb2d212b8d
247.77,1.0,12,1,2,3,6,0xb2d11229d
184062.37,1.0,0,3,2,4,9,0xb2d67471d
22.17,1.0,28,1,2,2,5,0xb2d633ec
200033.36,2.0,9,3,3,3,9,0xb2d58b83
199807.25,2.0,39,3,3,2,8,0xb2d28ce4d
605718.72,5.0,58,4,4,2,10,0xb2d4d1a4d
5727.06,1.0,20,2,2,2,6,0xb2d0b5f3d
255026.21,2.0,158,3,3,1,7,0xb2d6a259
10000.0,1.0,3,2,2,4,8,0xb2d6ab88
22.68,1.0,1,1,2,4,7,0xb2d91c8c
400091.07,2.0,8,4,3,3,10,0xb2d1c56ed
3.21,1.0,7,1,2,3,6,0xb2d1885f
150009.56,2.0,13,3,3,3,9,0xb2d236f1
94005.76,3.0,13,3,4,3,10,0xb2d5efbc
61312.47,3.0,76,3,4,1,8,0xb2d58947
7.09,1.0,0,1,2,4,7,0xb2d55bbe
16150.21,1.0,32,2,2,2,6,0xb2d6bc93
5808.51,1.0,47,2,2,2,6,0xb2d6ccf7d
360236.29,11.0,52,4,4,2,10,0xb2d6195b
500052.68,2.0,12,4,3,3,10,0xb2d9a112
282898.83,3.0,3,3,4,4,11,0xb2d54ad8
122822.64,2.0,54,3,3,2,8,0xb2d084c9
300000.74,5.0,4,3,4,4,11,0xb2d9f1be
3025.12,1.0,92,2,2,1,5,0xb2d202b5
64235.55,2.0,18,3,3,2,8,0xb2d422ea
14.08,1.0,9,1,2,3,6,0xb2d24d5fd
8.99,1.0,83,1,2,1,4,0xb2d5acc5
138.73,1.0,50,1,2,2,5,0xb2d3ab3b
207875.29,3.0,193,3,4,1,8,0xb2d13c8c
283.09,2.0,7,1,3,3,7,0xb2d318b2
304266.44,2.0,101,4,3,1,8,0xb2d92b76
8.23,1.0,11,1,2,3,6,0xb2d136c2
2928506.2,15.0,0,4,4,4,12,0xb2d5b28e
90021.62,2.0,92,3,3,1,7,0xb2d2e7c2
7725.19,1.0,19,2,2,2,6,0xb2d6889c
63204.47,4.0,0,3,4,4,11,0xb2d395c6
50047.05,1.0,97,2,2,1,5,0xb2d34c08
640.0,1.0,0,1,2,4,7,0xb2d8ebd5
6124.6,1.0,57,2,2,2,6,0xb2d2d295d
147419.9,8.0,0,3,4,4,11,0xb2d0b4a0
6559.93,1.0,1,2,2,4,8,0xb2d37c6d
8953.48,1.0,0,2,2,4,8,0xb2d57614
279.54,1.0,13,1,2,3,6,0xb2d4d0fd
430109.9,4.0,7,4,4,3,11,0xb2d61026d
272.42,1.0,59,1,2,2,5,0xb2d3a495d
161922.34,2.0,9,3,3,3,9,0x3b9af2ced
180256.78,2.0,101,3,3,1,7,0xb2d44078
250000.67,2.0,3,3,3,4,10,0xb2d6826b
9579561.2,2.0,18,4,3,2,9,0xb2d3a36d
166497.99,6.0,32,3,4,2,9,0xb2d2b810
300074.7,2.0,8,3,3,3,9,0xb2d9e407
0.04,1.0,1,1,2,4,7,0xb2d3875f
41.17,1.0,10,1,2,3,6,0xb2d5af1d
155005.21,5.0,0,3,4,4,11,0xb2d3ac47
2191589.1,2.0,33,4,3,2,9,0xb2d3847a
20283.53,2.0,97,2,3,1,6,0xb2d5d2c1
62920.98,2.0,14,3,3,3,9,0xb2d5c70e
10002.95,2.0,1,2,3,4,9,0xb2d465ff
25000.53,2.0,67,2,3,1,6,0xb2d9ad5e
5797.53,1.0,0,2,2,4,8,0xb2d7881c
710077.94,3.0,74,4,4,1,9,0xb2d1bed1
0.0,1.0,9,1,2,3,6,0xb2d3a374
41.34,1.0,5,1,2,3,6,0xb2d5db98
119086.75,3.0,17,3,4,2,9,0xb2d1fc14
650094.61,4.0,4,4,4,4,12,0xb2da0138
20269.33,3.0,38,2,4,2,8,0xb2d596a1
68.24,1.0,27,1,2,2,5,0xb2d177a5d
480015.27,2.0,4,4,3,4,11,0xb2d6b01b
81316.04,2.0,214,3,3,1,7,0xb2d645f3d
557687.29,6.0,104,4,4,1,9,0xb2d2513a
5284.55,1.0,9,2,2,3,7,0xb2d4461c
50308.77,1.0,38,2,2,2,6,0xb2d2abbf
275022.85,8.0,11,3,4,3,10,0xb2d2e32e
955.49,1.0,2,1,2,4,7,0xb2d6bde9
122115.92,3.0,80,3,4,1,8,0xb2d3ec17d
3804.63,1.0,9,2,2,3,7,0xb2d22f6d
316513.41,4.0,0,4,4,4,12,0xb2d0db75
0.0,2.0,77,1,3,1,5,0xb2d2c48e
5.44,1.0,88,1,2,1,4,0xb2d32043
540367.12,7.0,35,4,4,2,10,0xb2d5f7c5
1582012.52,5.0,31,4,4,2,10,0xb2d57a34d
6583.74,1.0,33,2,2,2,6,0xb2d17c04
461068.22,4.0,20,4,4,2,10,0xb2d9875d
4769.53,2.0,4,2,3,4,9,0xb2d6f0d4
879.52,1.0,10,1,2,3,6,0xb2d53150d
16562.63,1.0,29,2,2,2,6,0xb2d26dc6
6590000.07,23.0,0,4,4,4,12,0xb2d242f3d
34.59,2.0,58,1,3,2,6,0xb2d148de
73982.02,1.0,13,3,2,3,8,0xb2d3483ad
500000.0,2.0,8,4,3,3,10,0xb2d92d52
338331.52,3.0,122,4,4,1,9,0xb2d48792
630095.01,3.0,11,4,4,3,11,0xb2d644b3
6879.16,2.0,3,2,3,4,9,0xb2d9bacd
5372.82,1.0,277,2,2,1,5,0xb2d17a4e
2953.55,1.0,92,2,2,1,5,0xb2d1197cd
202039.74,3.0,41,3,4,2,9,0xb2d654b7
452888.84,3.0,4,4,4,4,12,0xb2d4f422
4444.13,1.0,18,2,2,2,6,0xb2d60b8dd
1035207.76,12.0,21,4,4,2,10,0xb2d2ab8e
1506.63,1.0,92,1,2,1,4,0xb2d3465c
1288.87,1.0,162,1,2,1,4,0xb2d5afa9
5914.04,1.0,10,2,2,3,7,0xb2d3c0aa
7542.73,1.0,61,2,2,2,6,0xb2d2a6ec
40000.42,2.0,87,2,3,1,6,0xb2d8caa9d
100009.46,1.0,2,3,2,4,9,0xb2d351e7d
172.94,1.0,75,1,2,1,4,0xb2d6f8a8
291.38,1.0,66,1,2,2,5,0xb2d415cb
330272.08,4.0,10,4,4,3,11,0xb2d33431
675006.49,6.0,75,4,4,1,9,0xb2d3d4d6
10035.05,2.0,92,2,3,1,6,0xb2d4b90f
728344.41,1.0,0,4,2,4,10,0xb2d56b0ed
1631.86,1.0,92,1,2,1,4,0xb2d0720f
325077.17,20.0,6,4,4,3,11,0xb2d69c80d
140839.65,2.0,1,3,3,4,10,0xb2d1cf54
50002.33,3.0,56,2,4,2,8,0xb2d23d2a
710.14,3.0,0,1,4,4,9,0x3b9b340a
14054.19,1.0,0,2,2,4,8,0xb2d395a4
280912.88,2.0,0,3,3,4,10,0xb2d0d6cfd
1834167.89,16.0,6,4,4,3,11,0xb2d0694dd
23398.18,1.0,6,2,2,3,7,0xb2d6862e
220000.88,2.0,6,3,3,3,9,0xb2d6a96cd
311213.51,4.0,26,4,4,2,10,0xb2d63ec3d
0.1,1.0,7,1,2,3,6,0xb2d28b93
302131.51,2.0,63,4,3,2,9,0xb2d9b975
1.47,1.0,71,1,2,1,4,0xb2d19ffa
22786.19,2.0,10,2,3,3,8,0xb2d5c01c
60060.6,2.0,46,3,3,2,8,0xb2d65a05
209000.0,12.0,6,3,4,3,10,0xb2d2b0c5
1507.12,1.0,6,1,2,3,6,0xb2d41f70d
210698.84,17.0,0,3,4,4,11,0x3b9b180a
200710.48,2.0,48,3,3,2,8,0xb2d9df49
789542.52,3.0,19,4,4,2,10,0xb2d13f2bd
159932.11,6.0,3,3,4,4,11,0xb2d38781
1660.51,1.0,10,1,2,3,6,0xb2d3e2ba
2505756.89,1.0,228,4,2,1,7,0xb2d6f93c
107.44,1.0,0,1,2,4,7,0xb2d83794d
10106.78,2.0,171,2,3,1,6,0xb2d19962
24774.44,3.0,0,2,4,4,10,0xb2d31d5d
500000.04,2.0,27,4,3,2,9,0xb2d9ae2c
2370.67,1.0,0,1,2,4,7,0xb2d177a6
401421.07,3.0,55,4,4,2,10,0xb2d9ca51
101242.68,2.0,123,3,3,1,7,0xb2d44a58
433577.18,5.0,6,4,4,3,11,0xb2d0e71cd
200559.77,5.0,0,3,4,4,11,0xb2d2ce66
30005.15,3.0,0,2,4,4,10,0xb2d5f3f9
1544.39,1.0,10,1,2,3,6,0xb2d6e2c4
50002.11,2.0,92,2,3,1,6,0xb2d65eded
61957.64,1.0,11,3,2,3,8,0xb2d9134d
5249.96,1.0,1,2,2,4,8,0xb2d6a357
2.88,1.0,21,1,2,2,5,0xb2d654ba
2343.39,1.0,184,1,2,1,4,0xb2d398a8
5746.41,1.0,92,2,2,1,5,0xb2d33f0c
80691.93,4.0,1,3,4,4,11,0xb2d44105
1110090.45,3.0,11,4,4,3,11,0xb2d5f931d
100019.93,2.0,32,3,3,2,8,0xb2d43593
268080.54,12.0,5,3,4,3,10,0x3b9b0fb4d
20000.21,2.0,14,2,3,3,8,0xb2da3a80
6081.57,1.0,21,2,2,2,6,0xb2d9809d
50029.11,2.0,60,2,3,2,7,0xb2d6a629
1397.21,1.0,184,1,2,1,4,0xb2d1234b
350007.39,2.0,73,4,3,1,8,0xb2d8e247
153834.24,2.0,0,3,3,4,10,0xb2d576c5
100042.43,3.0,53,3,4,2,9,0xb2d2113d
20000.84,2.0,34,2,3,2,7,0xb2d930be
50551.12,1.0,184,2,2,1,5,0xb2d287d0
259717.09,1.0,0,3,2,4,9,0xb2da1ccf
51902.3,1.0,92,2,2,1,5,0xb2d2b9c8d
10000.63,2.0,34,2,3,2,7,0xb2d9f54c
280035.17,2.0,82,3,3,1,7,0xb2d0a739
1392.64,1.0,9,1,2,3,6,0xb2d8cc7b
40947.26,2.0,27,2,3,2,7,0xb2d5dbb3
265019.82,3.0,167,3,4,1,8,0xb2d45618d
68.02,1.0,19,1,2,2,5,0xb2d950ec
950501.42,3.0,0,4,4,4,12,0xb2d22739
15182.66,2.0,228,2,3,1,6,0xb2d63433
120001.27,2.0,224,3,3,1,7,0xb2d6fbda
42145.04,2.0,111,2,3,1,6,0xb2d61b26
352329.43,3.0,40,4,4,2,10,0xb2d548c6
253467.33,7.0,0,3,4,4,11,0xb2d41c20d
338003.72,3.0,10,4,4,3,11,0xb2d78c7b
2124.57,1.0,2,1,2,4,7,0xb2d68401
300237.25,5.0,1,4,4,4,12,0xb2d2fc52
6220.04,1.0,92,2,2,1,5,0xb2d34593
11551.11,1.0,288,2,2,1,5,0xb2d3d925d
9031.65,8.0,20,2,4,2,8,0xb2d30597
751006.09,6.0,15,4,4,3,11,0xb2d6c435
775218.58,9.0,1,4,4,4,12,0xb2d5fc4a
412495.39,6.0,12,4,4,3,11,0xb2d1a562d
488692.31,4.0,10,4,4,3,11,0xb2d2c5a9
91497.53,6.0,27,3,4,2,9,0xb2d27513d
630073.28,7.0,6,4,4,3,11,0xb2d10b28
203088.71,2.0,52,3,3,2,8,0xb2d5e356
30207.92,1.0,0,2,2,4,8,0xb2d6b120
201393.93,2.0,26,3,3,2,8,0xb2d63d9f
5741.17,1.0,0,2,2,4,8,0xb2d6aa7c
180000.18,2.0,0,3,3,4,10,0xb2d0da22
18964.31,1.0,6,2,2,3,7,0xb2d2f7e7
1894.84,1.0,144,1,2,1,4,0xb2d6ad8f
65896.3,1.0,28,3,2,2,7,0xb2d37c33
13303.42,1.0,2,2,2,4,8,0xb2d23e48
17053.7,2.0,206,2,3,1,6,0xb2d5c31cd
1730034.96,17.0,6,4,4,3,11,0xb2d0a293
56819.9,3.0,70,3,4,1,8,0xb2d3fc4b
206510.04,1.0,15,3,2,3,8,0xb2d3346d
422199.17,4.0,6,4,4,3,11,0xb2d95eeed
313620.02,3.0,18,4,4,2,10,0xb2d6caec
503882.98,2.0,69,4,3,1,8,0xb2d6cf20d
18.4,1.0,33,1,2,2,5,0xb2d6a9c6
130006.96,2.0,139,3,3,1,7,0xb2d1740cd
50005.11,2.0,228,2,3,1,6,0xb2d5ac25
298301.14,1.0,3,3,2,4,9,0xb2d54bb5
17035.5,1.0,6,2,2,3,7,0xb2d18d80
3.73,1.0,14,1,2,3,6,0xb2d685a9
22033.08,1.0,168,2,2,1,5,0xb2d7f14e
11689.58,1.0,0,2,2,4,8,0xb2d985dd
70075.37,2.0,164,3,3,1,7,0xb2d6260c
1016.9,1.0,92,1,2,1,4,0xb2d62658d
80035.42,2.0,48,3,3,2,8,0xb2d5b08d
260019.39,2.0,90,3,3,1,7,0xb2d51dfe
6512.9,2.0,0,2,3,4,9,0xb2d08ae6
80133.12,2.0,66,3,3,2,8,0xb2d559cad
195736.45,3.0,0,3,4,4,11,0xb2d0d805
855823.63,4.0,21,4,4,2,10,0xb2d1db91d
566.77,2.0,0,1,3,4,8,0xb2d2a471d
180010.6,6.0,10,3,4,3,10,0xb2d3d86c
72490.45,2.0,95,3,3,1,7,0xb2d60968
812086.35,6.0,1,4,4,4,12,0xb2d3a576
5444.92,1.0,0,2,2,4,8,0xb2d2eb51
4500112.97,7.0,15,4,4,3,11,0xb2d226a6
500600.12,2.0,29,4,3,2,9,0xb2da0b61
10022.29,1.0,221,2,2,1,5,0xb2d716af
500012.3,2.0,5,4,3,3,10,0xb2d4ceea
52488.65,1.0,4,3,2,4,9,0xb2d13b92
1068027.53,7.0,47,4,4,2,10,0xb2d06918
351.73,1.0,53,1,2,2,5,0xb2d2db48
109010.52,2.0,38,3,3,2,8,0xb2d5d14a
385657.26,8.0,1,4,4,4,12,0xb2d0e744
800033.78,2.0,27,4,3,2,9,0xb2d0e279
380000.61,1.0,1,4,2,4,10,0xb2d54ce3
19000.69,1.0,0,2,2,4,8,0xb2d5ed7f
1954.83,1.0,301,1,2,1,4,0xb2d5b313
1123328.55,22.0,0,4,4,4,12,0xb2d0f1bdd
300000.0,4.0,9,3,4,3,10,0xb2d80ef7
8760.36,1.0,21,2,2,2,6,0xb2d34d29
500000.0,2.0,0,4,3,4,11,0xb2d98454d
4808.34,1.0,184,2,2,1,5,0xb2d20721
500000.0,1.0,24,4,2,2,8,0xb2d94ef9
75.34,1.0,10,1,2,3,6,0xb2d2c5df
360078.33,4.0,0,4,4,4,12,0xb2d21235
4860.58,1.0,11,2,2,3,7,0xb2d0adaa
4466.37,1.0,5,2,2,3,7,0xb2d94604d
870155.33,4.0,179,4,4,1,9,0xb2d59bad
1760.9,1.0,1,1,2,4,7,0xb2d3c879d
300000.34,2.0,17,3,3,2,8,0xb2d996bc
54334.18,1.0,4,3,2,4,9,0xb2d6f5af
5.94,1.0,75,1,2,1,4,0xb2d6c5d8
390790.45,5.0,18,4,4,2,10,0xb2d3441d
1370.56,1.0,92,1,2,1,4,0xb2d2b353
220522.02,1.0,0,3,2,4,9,0xb2d3ed3e
550014.24,7.0,40,4,4,2,10,0xb2d209a2d
4525.13,1.0,109,2,2,1,5,0xb2d1ace1
0.21,1.0,60,1,2,2,5,0xb2d8fc5d
30620.58,1.0,0,2,2,4,8,0xb2d6a07a
199002.1,2.0,92,3,3,1,7,0xb2d6383f
39104.54,1.0,20,2,2,2,6,0xb2d6a7b9
500000.0,2.0,20,4,3,2,9,0xb2d8d757
25678.21,1.0,10,2,2,3,7,0xb2d2c3f6d
3000092.91,2.0,139,4,3,1,8,0xb2d44c58d
6926.59,1.0,10,2,2,3,7,0xb2d9ef62
1965.37,1.0,184,1,2,1,4,0xb2d13354d
260.96,1.0,8,1,2,3,6,0xb2d8cf9d
717.8,1.0,1,1,2,4,7,0xb2d32aedd
967.17,1.0,17,1,2,2,5,0xb2d4fac5
541412.36,10.0,0,4,4,4,12,0xb2d6bd50
400000.67,9.0,2,4,4,4,12,0xb2d68198
550013.64,3.0,109,4,4,1,9,0xb2d1b037d
172675.8,3.0,25,3,4,2,9,0xb2d6b470
570031.98,3.0,20,4,4,2,10,0xb2d9420a
2319940.11,3.0,2,4,4,4,12,0xb2da5d7e
14.37,1.0,35,1,2,2,5,0xb2d5f4b9
200059.89,2.0,169,3,3,1,7,0xb2d0d6eb
100008.97,2.0,5,3,3,3,9,0xb2da2150
209592.26,2.0,99,3,3,1,7,0xb2d67de7
0.0,1.0,7,1,2,3,6,0xb2d6a964
100005.81,2.0,62,3,3,2,8,0xb2d9b0cd
200000.0,2.0,14,3,3,3,9,0xb2d95cae
25092.61,1.0,7,2,2,3,7,0xb2d1cf38
1984.12,1.0,139,1,2,1,4,0xb2d68bac
81220.57,2.0,11,3,3,3,9,0xb2d69905
12099.52,1.0,92,2,2,1,5,0xb2d1c1e6
3044.96,2.0,9,2,3,3,8,0xb2d683e5
500019.46,4.0,34,4,4,2,10,0xb2d5ef68
6.56,1.0,78,1,2,1,4,0xb2d21b65
2808.04,1.0,92,1,2,1,4,0xb2d24779
18.28,1.0,19,1,2,2,5,0xb2d3ac70
90315.87,3.0,56,3,4,2,9,0xb2d6a134d
30001.27,2.0,41,2,3,2,7,0xb2d92071
152.89,1.0,13,1,2,3,6,0xb2d55a3a
50095.79,2.0,83,2,3,1,6,0xb2d6254c
41569.1,2.0,1,2,3,4,9,0xb2d5e98a
5901.5,1.0,184,2,2,1,5,0xb2d33e92
183693.18,1.0,0,3,2,4,9,0xb2d64c98
7547.79,3.0,141,2,4,1,7,0xb2d08392
0.0,1.0,0,1,2,4,7,0xb2d8c852
578611.58,4.0,1,4,4,4,12,0xb2d6af7e
5450.56,1.0,8,2,2,3,7,0xb2d2bc5dd
2003.83,1.0,14,1,2,3,6,0xb2d0e48b
5200000.0,2.0,92,4,3,1,8,0xb2d5cd03
110000.0,2.0,6,3,3,3,9,0xb2da523c
390515.71,4.0,4,4,4,4,12,0xb2d9569c
2007.91,1.0,184,1,2,1,4,0xb2d6127f
712981.61,40.0,13,4,4,3,11,0x3b9b30fc
573872.32,4.0,53,4,4,2,10,0xb2d3c830d
11034.63,2.0,26,2,3,2,7,0xb2d59ba7
200006.34,2.0,129,3,3,1,7,0xb2d6faea
10002.81,2.0,80,2,3,1,6,0xb2d98de6
10410.34,1.0,0,2,2,4,8,0xb2d690ab
25.19,1.0,64,1,2,2,5,0xb2d51e75d
335114.1,4.0,136,4,4,1,9,0xb2d3fa8fd
300001.89,2.0,3,3,3,4,10,0xb2d97f50d
40001.23,5.0,14,2,4,3,9,0xb2d6417b
230.53,1.0,29,1,2,2,5,0xb2d5c61c
300000.0,2.0,1,3,3,4,10,0xb2da66b9
593.97,4.0,4,1,4,4,9,0xb2d0b056
520000.04,2.0,13,4,3,3,10,0xb2d6f464
7617.97,1.0,0,2,2,4,8,0xb2da0ffb
26120.82,5.0,174,2,4,1,7,0xb2d6350b
226763.64,3.0,20,3,4,2,9,0xb2d8b20a
838098.89,10.0,0,4,4,4,12,0xb2d55fba
11.71,1.0,10,1,2,3,6,0xb2d93412
112778.87,4.0,7,3,4,3,10,0xb2d4167d
107937.26,1.0,13,3,2,3,8,0xb2d90e3b
12315.17,1.0,27,2,2,2,6,0xb2d0fc9b
435974.16,1.0,1,4,2,4,10,0xb2d5dfcf
29.62,1.0,10,1,2,3,6,0xb2d69a49d
100368.94,3.0,216,3,4,1,8,0xb2d55bf7
6394.81,1.0,92,2,2,1,5,0xb2d0ee9bd
200865.52,2.0,46,3,3,2,8,0xb2d698ded
764.52,1.0,2,1,2,4,7,0xb2d0e5f8
160851.65,2.0,116,3,3,1,7,0xb2d6149a
300834.16,2.0,7,4,3,3,10,0xb2d58b61
26246.42,3.0,0,2,4,4,10,0xb2d5ef5e
1616214.45,7.0,5,4,4,3,11,0xb2d1c0da
200710.43,2.0,41,3,3,2,8,0xb2d926b2d
2.56,1.0,19,1,2,2,5,0xb2d5ccfa
300066.72,2.0,35,3,3,2,8,0xb2d95bae
28.5,1.0,29,1,2,2,5,0xb2d9e449
144.4,1.0,4,1,2,4,7,0xb2d9127a
1402905.06,14.0,1,4,4,4,12,0x3b9af16f
1094.88,1.0,93,1,2,1,4,0xb2d68ba6
101896.2,2.0,132,3,3,1,7,0xb2d25b19
174005.01,3.0,55,3,4,2,9,0xb2d9024fd
42991.68,2.0,0,2,3,4,9,0xb2d0a27f
1509.2,1.0,7,1,2,3,6,0xb2d6235f
338689.72,5.0,6,4,4,3,11,0xb2d5a935d
50000.0,2.0,3,2,3,4,9,0xb2d5eb29
1028969.47,2.0,255,4,3,1,8,0xb2d604e0
2178.26,1.0,0,1,2,4,7,0xb2d2cd11
226766.73,4.0,0,3,4,4,11,0xb2d92d32d
18060.66,1.0,22,2,2,2,6,0xb2d5772f
47.13,1.0,50,1,2,2,5,0xb2d59e18
2300136.12,3.0,15,4,4,3,11,0xb2d59929
152.0,1.0,52,1,2,2,5,0xb2d8c8cc
360028.75,2.0,17,4,3,2,9,0xb2d9e0c1
189.43,1.0,20,1,2,2,5,0xb2d5da67
1269911.14,10.0,9,4,4,3,11,0xb2d6aa63
341.41,1.0,157,1,2,1,4,0xb2d115a1
15505.2,1.0,0,2,2,4,8,0xb2d30f56
10034.17,1.0,13,2,2,3,7,0xb2d54c19d
119.44,1.0,0,1,2,4,7,0xb2d9dea2
289.93,1.0,5,1,2,3,6,0xb2d2b454
95.46,1.0,0,1,2,4,7,0xb2d96d3a
303000.75,4.0,0,4,4,4,12,0xb2d69243d
1484.04,1.0,11,1,2,3,6,0xb2d408f3
20000.0,2.0,1,2,3,4,9,0xb2da5fbd
1214.42,1.0,21,1,2,2,5,0xb2d46ecb
371010.75,6.0,98,4,4,1,9,0xb2d58677
28429.63,1.0,1,2,2,4,8,0xb2d3d876
40350.07,5.0,1,2,4,4,10,0xb2d4fd07d
6593.88,1.0,184,2,2,1,5,0x3b9b4392
186056.14,4.0,3,3,4,4,11,0xb2d5edcd
2.59,1.0,19,1,2,2,5,0xb2d15379
230089.6,4.0,112,3,4,1,8,0xb2d29ecb
115006.66,3.0,176,3,4,1,8,0xb2d57c52
340000.0,2.0,18,4,3,2,9,0xb2da3304
513846.63,4.0,14,4,4,3,11,0xb2d166f0
0.06,1.0,1,1,2,4,7,0xb2d94826
132005.59,2.0,185,3,3,1,7,0xb2d5ebc9d
220000.0,3.0,0,3,4,4,11,0xb2d22cc3
10397.35,2.0,4,2,3,4,9,0xb2d5e499
10009.33,2.0,7,2,3,3,8,0xb2d19360
1583.28,1.0,0,1,2,4,7,0xb2d4890e
3673.23,1.0,184,2,2,1,5,0xb2d3f62c
222586.67,2.0,6,3,3,3,9,0xb2d3f5e3d
501000.0,2.0,27,4,3,2,9,0xb2da12c6
1.21,1.0,13,1,2,3,6,0xb2d8d646d
180011.8,7.0,32,3,4,2,9,0xb2d48bbf
1870.52,1.0,184,1,2,1,4,0xb2d1c3e7
10006.06,1.0,20,2,2,2,6,0xb2d6ddcbd
124.97,1.0,32,1,2,2,5,0xb2d85db2
1887.99,1.0,184,1,2,1,4,0xb2d1c586d
44.17,1.0,60,1,2,2,5,0xb2d25327
201002.72,10.0,11,3,4,3,10,0xb2d5b283d
14122.28,1.0,0,2,2,4,8,0xb2d68ef0
1635.31,1.0,5,1,2,3,6,0xb2d5578c
2.04,1.0,9,1,2,3,6,0xb2d75348
6629.73,1.0,14,2,2,3,7,0xb2d32ba6d
751.81,1.0,1,1,2,4,7,0xb2d93c4d
10.53,1.0,1,1,2,4,7,0xb2d95892
110166.41,1.0,0,3,2,4,9,0xb2d0f5d5d
4230.7,1.0,82,2,2,1,5,0xb2d386e4d
130000.0,9.0,5,3,4,3,10,0xb2d5df7e
44463.2,2.0,1,2,3,4,9,0xb2d5edc1d
14166.37,1.0,201,2,2,1,5,0xb2d67d8a
375600.17,5.0,6,4,4,3,11,0xb2d0e5c4
100041.17,1.0,48,3,2,2,7,0xb2d916f6d
39795.63,1.0,2,2,2,4,8,0xb2d32f07d
75996.47,5.0,0,3,4,4,11,0xb2d2f232
3.49,1.0,7,1,2,3,6,0xb2d5374cd
10000.32,2.0,10,2,3,3,8,0xb2d960bf
200100.76,2.0,83,3,3,1,7,0xb2d629c5
1281.92,2.0,184,1,3,1,5,0xb2d26002
200058.37,2.0,83,3,3,1,7,0xb2d1095dd
10141.32,1.0,92,2,2,1,5,0xb2d56a7d
1003552.12,2.0,41,4,3,2,9,0xb2d926d4
11.07,1.0,32,1,2,2,5,0xb2d59b9d
48000.76,2.0,0,2,3,4,9,0xb2d48534
4700.2,1.0,4,2,2,4,8,0xb2d8f159
319385.81,5.0,66,4,4,2,10,0xb2d07834
3708.79,1.0,16,2,2,2,6,0xb2d1c3d2
11.71,1.0,70,1,2,1,4,0xb2d5eaa4
228924.98,4.0,0,3,4,4,11,0xb2d090d8
14480.28,1.0,3,2,2,4,8,0xb2d942d7
153886.25,3.0,0,3,4,4,11,0xb2d2ecb8d
245835.63,1.0,1,3,2,4,9,0xb2d33b6e
139255.61,1.0,0,3,2,4,9,0xb2d8d71a
550859.62,8.0,19,4,4,2,10,0xb2d17ea6d
100296.88,1.0,146,3,2,1,6,0xb2d3c074d
59.3,1.0,46,1,2,2,5,0xb2d2926c
150041.15,3.0,75,3,4,1,8,0xb2d4907e
100007.68,3.0,25,3,4,2,9,0x3b9b29c1d
17469.44,1.0,21,2,2,2,6,0xb2da0ab5
220002.32,2.0,24,3,3,2,8,0xb2d94c4bd
1392.14,1.0,10,1,2,3,6,0xb2d3826e
511436.62,4.0,3,4,4,4,12,0xb2d3ba65
80004.68,2.0,95,3,3,1,7,0xb2d32352
30.65,2.0,14,1,3,3,7,0xb2d69c5ad
113758.11,3.0,66,3,4,2,9,0xb2d0887a
0.0,1.0,7,1,2,3,6,0xb2d4f636d
502103.16,4.0,52,4,4,2,10,0xb2d0d2fb
180891.13,1.0,59,3,2,2,7,0xb2d57dd5
106.22,1.0,0,1,2,4,7,0xb2d51de2
200000.0,2.0,7,3,3,3,9,0xb2da5410
305567.82,6.0,10,4,4,3,11,0xb2d17cc3d
238779.66,2.0,133,3,3,1,7,0xb2d55868d
50013.2,1.0,15,2,2,3,7,0xb2da0ae0
200004.22,1.0,11,3,2,3,8,0xb2d95eb6
842027.86,6.0,6,4,4,3,11,0xb2d24349
818686.64,5.0,110,4,4,1,9,0xb2d17934
333706.64,2.0,1,4,3,4,11,0xb2d36688d
9952.56,1.0,30,2,2,2,6,0xb2d98e0c
253895.13,3.0,42,3,4,2,9,0xb2d9466bd
171296.91,13.0,3,3,4,4,11,0xb2d575e3
50000.53,2.0,71,2,3,1,6,0xb2d98d75
211558.41,3.0,1,3,4,4,11,0xb2d5ab39
4865.1,1.0,19,2,2,2,6,0xb2d5b1d2
4839.04,1.0,0,2,2,4,8,0xb2d324c6d
6264.37,1.0,5,2,2,3,7,0xb2d4306d
301717.37,3.0,74,4,4,1,9,0xb2d33c49
100357.54,2.0,11,3,3,3,9,0xb2d3eaeb
250050.09,2.0,28,3,3,2,8,0xb2d78afa
11127.36,1.0,0,2,2,4,8,0xb2d41a6a
307153.01,2.0,123,4,3,1,8,0xb2d5a173
70334.06,6.0,3,3,4,4,11,0xb2d1ef20
550097.59,2.0,7,4,3,3,10,0xb2d206d3
1000012.5,13.0,92,4,4,1,9,0xb2d53da5
9367.01,1.0,1,2,2,4,8,0xb2d2b5e2
44998.35,1.0,27,2,2,2,6,0xb2d6b6ad
11098.65,1.0,18,2,2,2,6,0xb2d99558
500000.0,2.0,27,4,3,2,9,0xb2d944a2d
700177.23,2.0,0,4,3,4,11,0xb2d22192
772737.2,2.0,30,4,3,2,9,0xb2d9c401
1662.09,1.0,18,1,2,2,5,0xb2d21ca2
5211.37,1.0,9,2,2,3,7,0xb2d5cba3d
123099.12,1.0,0,3,2,4,9,0xb2d304a6d
4289.39,1.0,5,2,2,3,7,0xb2d1f51f
190.83,1.0,0,1,2,4,7,0xb2d51edad
1466982.5,8.0,0,4,4,4,12,0xb2d17c8a
0.0,1.0,6,1,2,3,6,0xb2d2dc9c
11799.4,2.0,92,2,3,1,6,0x3b9adcb4
600000.6,6.0,7,4,4,3,11,0xb2d3a9d6
5800.2,1.0,0,2,2,4,8,0xb2d353ac
112110.95,3.0,111,3,4,1,8,0xb2d17126
20000.42,2.0,221,2,3,1,6,0xb2d6fb43
4904.32,1.0,1,2,2,4,8,0xb2d70019d
10194.55,1.0,8,2,2,3,7,0xb2d69842
51146.93,2.0,3,2,3,4,9,0xb2d68d0a
130028.01,1.0,1,3,2,4,9,0xb2d23e24
30001.27,2.0,70,2,3,1,6,0xb2d9a354
7461.18,1.0,19,2,2,2,6,0xb2d6f5e9
304047.32,3.0,0,4,4,4,12,0xb2d231ead
917125.66,7.0,1,4,4,4,12,0xb2d0b916
980296.31,8.0,24,4,4,2,10,0xb2d26cbc
180.56,1.0,0,1,2,4,7,0xb2d695de
1.58,1.0,39,1,2,2,5,0xb2d92434
10000.53,2.0,90,2,3,1,6,0xb2d89027
2586.67,1.0,1,1,2,4,7,0xb2d96738
201439.08,4.0,18,3,4,2,9,0xb2d105d3
6351.05,1.0,2,2,2,4,8,0xb2d959b7
87004.35,5.0,136,3,4,1,8,0xb2d69512
1001836.13,5.0,7,4,4,3,11,0xb2d118f3
1504094.57,8.0,1,4,4,4,12,0xb2d8ea6dd
4708.9,1.0,11,2,2,3,7,0xb2d8b22f
4264.78,2.0,158,2,3,1,6,0xb2d5add8d
1851075.47,4.0,213,4,4,1,9,0xb2d42d0bd
65445.38,1.0,27,3,2,2,7,0xb2d2eadbd
103314.34,2.0,206,3,3,1,7,0xb2d2fb76
5094009.03,2.0,17,4,3,2,9,0xb2d59d42
61813.61,5.0,0,3,4,4,11,0xb2d61b71
1382598.5,8.0,17,4,4,2,10,0xb2d775ff
21747.79,1.0,9,2,2,3,7,0xb2d5d22d
13355.74,1.0,18,2,2,2,6,0xb2d717f7
8700000.0,2.0,92,4,3,1,8,0xb2d4f97c
131.83,1.0,46,1,2,2,5,0xb2d24020
470027.31,3.0,5,4,4,3,11,0xb2d913ccd
155.52,1.0,8,1,2,3,6,0xb2d5d576
10.56,2.0,83,1,3,1,5,0xb2d96990
593320.08,8.0,28,4,4,2,10,0xb2d0e71ed
50068.58,1.0,25,2,2,2,6,0xb2d920d7
3924.3,1.0,92,2,2,1,5,0xb2d42ba3d
242115.84,2.0,133,3,3,1,7,0xb2d0a0bad
403.02,1.0,0,1,2,4,7,0xb2d1d4dcd
195036.25,3.0,195,3,4,1,8,0xb2d5d05a
51043.91,3.0,0,2,4,4,10,0xb2d32994
559626.4,4.0,0,4,4,4,12,0xb2d1e7bdd
373936.65,2.0,116,4,3,1,8,0xb2d22f59d
934695.83,10.0,0,4,4,4,12,0x3b9b185b
7296.02,1.0,14,2,2,3,7,0xb2d6863a
2119.95,1.0,184,1,2,1,4,0x3b9b2d1f
152089.89,3.0,228,3,4,1,8,0xb2d1e89c
595001.44,2.0,11,4,3,3,10,0xb2d52102d
91.33,1.0,0,1,2,4,7,0xb2d51eecd
154.09,1.0,2,1,2,4,7,0xb2d9265a
2000000.0,3.0,5,4,4,3,11,0xb2d3fb09
1088.6,1.0,92,1,2,1,4,0xb2d24e09d
50063.97,4.0,0,2,4,4,10,0xb2d41a73
3165.18,1.0,1,2,2,4,8,0xb2d3a3fd
410292.42,2.0,147,4,3,1,8,0xb2d6054d
4356.49,1.0,0,2,2,4,8,0xb2d6c015
65024.81,6.0,0,3,4,4,11,0xb2d0c19e
715.55,1.0,9,1,2,3,6,0xb2d370d9
592001.39,6.0,13,4,4,3,11,0xb2d2285a
160010.81,3.0,25,3,4,2,9,0xb2d409fad
400733.51,1.0,4,4,2,4,10,0xb2d4ec19
180004.71,3.0,18,3,4,2,9,0xb2d643cc
239626.42,3.0,98,3,4,1,8,0xb2d26284
2.14,1.0,40,1,2,2,5,0xb2d420f9
71071.73,2.0,24,3,3,2,8,0xb2d593bad
207433.96,2.0,132,3,3,1,7,0xb2d6a7c6d
320000.41,2.0,18,4,3,2,9,0xb2d98d37
21160.73,1.0,20,2,2,2,6,0xb2d967d8
1113.42,1.0,92,1,2,1,4,0xb2d34d62d
90.18,1.0,6,1,2,3,6,0xb2d283ab
10042.22,1.0,0,2,2,4,8,0xb2d553eb
350076.19,5.0,18,4,4,2,10,0xb2d18a37
345016.69,7.0,20,4,4,2,10,0xb2d3c15d
1251038.06,4.0,137,4,4,1,9,0xb2d551c6d
632.73,1.0,2,1,2,4,7,0xb2d214c4
4024.98,1.0,21,2,2,2,6,0xb2d48a5e
1231697.16,5.0,63,4,4,2,10,0xb2d2d011
401.13,1.0,12,1,2,3,6,0xb2d4a8fb
441079.07,7.0,53,4,4,2,10,0xb2d24cf8
250039.33,3.0,20,3,4,2,9,0xb2d1cf2ed
416.52,1.0,9,1,2,3,6,0xb2d29ece
16150.31,1.0,15,2,2,3,7,0xb2d277fb
117.48,1.0,80,1,2,1,4,0xb2d97de1
189151.75,2.0,206,3,3,1,7,0xb2d19ff5d
40000.7,5.0,11,2,4,3,9,0xb2d591c6d
340008.71,5.0,47,4,4,2,10,0xb2d33366d
180081.71,3.0,175,3,4,1,8,0xb2d1f7ac
516913.48,3.0,108,4,4,1,9,0xb2d68795d
2848.63,2.0,7,1,3,3,7,0xb2d080e3d
704.9,2.0,0,1,3,4,8,0xb2d0977c
705113.41,6.0,56,4,4,2,10,0x3b9b47b8d
70000.53,3.0,6,3,4,3,10,0xb2d90dd3
559.57,1.0,48,1,2,2,5,0xb2d8e364
791318.47,5.0,3,4,4,4,12,0xb2d49989
8.94,4.0,21,1,4,2,7,0x3b9b25e5
0.13,1.0,9,1,2,3,6,0xb2d12eae
37.52,1.0,9,1,2,3,6,0xb2d1cf5e
1020000.0,1.0,0,4,2,4,10,0xb2d6f9ae
109726.31,2.0,4,3,3,4,10,0xb2d97148
1793.18,1.0,10,1,2,3,6,0xb2d87aa0
82590.2,2.0,172,3,3,1,7,0xb2d5cb2c
1728.64,1.0,46,1,2,2,5,0xb2d6f318
692061.49,5.0,0,4,4,4,12,0xb2d4739ad
33400.39,1.0,7,2,2,3,7,0xb2d643e8
2300000.07,3.0,0,4,4,4,12,0xb2d18879
296615.09,2.0,74,3,3,1,7,0xb2d22c82
147161.3,5.0,11,3,4,3,10,0xb2d28fafd
105212.29,3.0,111,3,4,1,8,0xb2d32e68
130035.04,5.0,132,3,4,1,8,0xb2d451dd
61.57,1.0,1,1,2,4,7,0xb2d5b4bdd
35012.77,1.0,10,2,2,3,7,0xb2d43d8f
1206663.62,13.0,0,4,4,4,12,0xb2d57063d
807073.81,2.0,7,4,3,3,10,0xb2d0e279d
594766.06,5.0,184,4,4,1,9,0x3b9af3fb
30000.32,2.0,74,2,3,1,6,0xb2d99e7e
100001.06,2.0,21,3,3,2,8,0xb2da200c
7728.19,1.0,15,2,2,3,7,0xb2d99fb2
14.71,1.0,18,1,2,2,5,0xb2d4469e
29020.11,1.0,15,2,2,3,7,0xb2d8d50ed
1099.75,1.0,184,1,2,1,4,0xb2d22ef1
500076.14,2.0,18,4,3,2,9,0xb2d9d181
880068.11,4.0,11,4,4,3,11,0xb2d2ee09
5012.64,1.0,59,2,2,2,6,0xb2d78e43
525051.65,6.0,1,4,4,4,12,0xb2d3fa58
193.82,1.0,0,1,2,4,7,0xb2d27c4c
35.51,1.0,30,1,2,2,5,0xb2d9e22c
9007.2,1.0,10,2,2,3,7,0xb2d349ce
63989.01,6.0,0,3,4,4,11,0x3b9af253
100079.29,2.0,206,3,3,1,7,0xb2d0db60d
184889.76,4.0,2,3,4,4,11,0xb2d6e693
69.91,2.0,0,1,3,4,8,0xb2d29c62
150055.97,3.0,145,3,4,1,8,0xb2d575ab
9.82,1.0,49,1,2,2,5,0xb2d553d7
62639.28,1.0,10,3,2,3,8,0xb2d593c3d
354409.36,2.0,1,4,3,4,11,0xb2d68e37d
50101.61,2.0,32,2,3,2,7,0xb2d9fc5e
454507.88,3.0,9,4,4,3,11,0xb2d16869
666034.31,3.0,0,4,4,4,12,0xb2d376cb
50010.23,2.0,60,2,3,2,7,0xb2d65b38
250002.64,3.0,14,3,4,3,10,0xb2da0b5f
177183.07,7.0,0,3,4,4,11,0xb2d07017
8339.33,1.0,11,2,2,3,7,0xb2d26673
20000.75,3.0,34,2,4,2,8,0xb2d6a7f5
7266.68,1.0,1,2,2,4,8,0xb2d94bef
80019.14,2.0,19,3,3,2,8,0xb2d6038d
403000.17,2.0,13,4,3,3,10,0xb2d9dfa9
70013.66,3.0,60,3,4,2,9,0xb2d43de9
418.09,1.0,149,1,2,1,4,0xb2d5c079
500041.0,3.0,15,4,4,3,11,0xb2d6c642d
2091000.0,14.0,0,4,4,4,12,0xb2d1e1bf
2526.41,1.0,9,1,2,3,6,0xb2d8c7d9d
213699.93,5.0,19,3,4,2,9,0xb2d1bc8f
40436.48,1.0,3,2,2,4,8,0xb2d6d164
1936.35,1.0,309,1,2,1,4,0xb2d321c5d
250290.22,4.0,6,3,4,3,10,0xb2d1a291
60051.13,3.0,38,3,4,2,9,0xb2d5be7ed
5241.56,1.0,10,2,2,3,7,0xb2da0b11
1710018.77,4.0,53,4,4,2,10,0xb2d2695c
200000.0,2.0,15,3,3,3,9,0xb2d92028
710096.38,5.0,108,4,4,1,9,0xb2d103c0
368019.48,7.0,8,4,4,3,11,0xb2d08300
2831158.78,8.0,25,4,4,2,10,0x3b9b3e9a
9.3,1.0,10,1,2,3,6,0xb2d82724
689013.9,13.0,11,4,4,3,11,0xb2d1bc7f
2.56,1.0,19,1,2,2,5,0xb2d49358
2.27,1.0,18,1,2,2,5,0xb2d37563
1640887.57,6.0,0,4,4,4,12,0xb2d2b34f
1245.83,1.0,10,1,2,3,6,0xb2d58f1b
1180892.89,9.0,0,4,4,4,12,0xb2d0687ad
50001.26,3.0,24,2,4,2,8,0xb2d8ecb2
1083610.53,10.0,0,4,4,4,12,0xb2d121f3
532311.2,4.0,0,4,4,4,12,0xb2d4132e
503561.06,2.0,55,4,3,2,9,0xb2d6a905d
100009.71,2.0,0,3,3,4,10,0xb2d3c470
17.17,1.0,64,1,2,2,5,0xb2d2d581
3696.53,1.0,6,2,2,3,7,0xb2d356cc
4065.11,1.0,184,2,2,1,5,0xb2d0f934
831440.01,1.0,5,4,2,3,9,0xb2d2a7e8
52104.14,2.0,0,2,3,4,9,0xb2d65c66
3235.52,1.0,9,2,2,3,7,0xb2d91d12
380393.38,2.0,70,4,3,1,8,0xb2d5a573d
518072.85,5.0,73,4,4,1,9,0xb2d1693a
221761.87,5.0,11,3,4,3,10,0xb2d59f0b
532729.69,8.0,4,4,4,4,12,0xb2d3fa0a
650000.0,4.0,0,4,4,4,12,0xb2d0d398d
500008.28,2.0,22,4,3,2,9,0xb2d78f34d
210000.35,6.0,1,3,4,4,11,0xb2d3eda2
10391.14,1.0,3,2,2,4,8,0xb2d55cd2
168.79,1.0,3,1,2,4,7,0xb2d3478c
282038.91,4.0,0,3,4,4,11,0xb2d69f91
1215.41,1.0,184,1,2,1,4,0xb2d1fc62
623.42,1.0,10,1,2,3,6,0xb2d54d3d
25757.61,2.0,0,2,3,4,9,0xb2d09234
490281.16,2.0,1,4,3,4,11,0xb2d8e03b
1009.99,1.0,131,1,2,1,4,0xb2d315c1d
19021.55,1.0,3,2,2,4,8,0xb2d3803e
21.8,1.0,28,1,2,2,5,0xb2d9743c
3000565.98,2.0,0,4,3,4,11,0x3b9b2fb7
1363.23,1.0,3,1,2,4,7,0xb2d4aa24
503751.4,2.0,0,4,3,4,11,0xb2d5f419
1182.26,4.0,92,1,4,1,6,0xb2d366e7
466000.0,25.0,0,4,4,4,12,0x3b9b2607d
1028567.81,2.0,10,4,3,3,10,0xb2d638c4d
17446.76,1.0,10,2,2,3,7,0xb2d408d0d
1209.75,1.0,17,1,2,2,5,0xb2d2d430
49.87,1.0,39,1,2,2,5,0xb2d22becd
83.42,1.0,9,1,2,3,6,0xb2d30d17
677142.51,6.0,9,4,4,3,11,0xb2d433a9d
190002.79,5.0,10,3,4,3,10,0xb2d3d2d1d
200117.65,4.0,101,3,4,1,8,0xb2d26635d
70040.32,3.0,27,3,4,2,9,0xb2d13401
725.51,2.0,20,1,3,2,6,0xb2d0711ed
1015.06,1.0,184,1,2,1,4,0xb2d113b4d
102109.26,2.0,34,3,3,2,8,0xb2d14337
100015.78,2.0,235,3,3,1,7,0xb2d4c838
667.43,1.0,0,1,2,4,7,0xb2d8ec07
203580.08,3.0,0,3,4,4,11,0xb2d5c560
100096.41,2.0,35,3,3,2,8,0xb2d8d026d
205690.85,2.0,120,3,3,1,7,0xb2d6b6ac
1940.14,2.0,184,1,3,1,5,0xb2d19bb6
20470.58,2.0,62,2,3,2,7,0xb2d5b4c5d
955351.98,9.0,3,4,4,4,12,0xb2d0ff2e
22759.04,1.0,0,2,2,4,8,0xb2d156d0
4.01,6.0,14,1,4,3,8,0xb2d2ae35
2577.65,1.0,9,1,2,3,6,0xb2d74bab
1128.22,1.0,10,1,2,3,6,0xb2d97f58
97.39,1.0,14,1,2,3,6,0xb2d9eece
710692.62,6.0,7,4,4,3,11,0xb2d5f9ca
254164.59,3.0,90,3,4,1,8,0xb2d3eadc
2777.41,1.0,1,1,2,4,7,0xb2d91cc8
2782.05,1.0,214,1,2,1,4,0xb2d39a99
1063030.32,6.0,0,4,4,4,12,0x3b9af16ad
337380.18,2.0,63,4,3,2,9,0xb2d9bb59
2692310.37,5.0,0,4,4,4,12,0x3b9b45bad
8870.79,5.0,0,2,4,4,10,0xb2d0650fd
30020.56,3.0,137,2,4,1,7,0xb2d90ea2
200083.97,2.0,6,3,3,3,9,0xb2d64be2
220213.85,1.0,189,3,2,1,6,0xb2d551c0
99905.71,2.0,56,3,3,2,8,0xb2d9bf2b
61429.02,1.0,17,3,2,2,7,0xb2d4e1e5
600777.61,5.0,3,4,4,4,12,0xb2d262fe
54604.88,2.0,0,3,3,4,10,0xb2d3e93b
159.27,1.0,69,1,2,1,4,0xb2d258e8
231068.51,12.0,0,3,4,4,11,0xb2d578c7
2023.82,1.0,92,1,2,1,4,0xb2d208df
565009.91,8.0,6,4,4,3,11,0xb2d19b94d
1217.94,1.0,0,1,2,4,7,0xb2d70000
321202.11,6.0,0,4,4,4,12,0x3b9af0c3
604779.17,3.0,122,4,4,1,9,0xb2d695a4
63.17,1.0,21,1,2,2,5,0xb2d96398
350114.18,2.0,21,4,3,2,9,0xb2d0d13a
5372.46,1.0,184,2,2,1,5,0xb2d0d5c4
50000.53,2.0,46,2,3,2,7,0xb2d9d990
20000635.17,2.0,92,4,3,1,8,0xb2d49da0
220876.82,3.0,18,3,4,2,9,0xb2d2825fd
20000.21,2.0,35,2,3,2,7,0xb2d9accc
7281.13,1.0,21,2,2,2,6,0xb2d7ec6e
61059.18,3.0,175,3,4,1,8,0xb2d5f466
1163.78,1.0,184,1,2,1,4,0xb2d39923
157009.9,4.0,18,3,4,2,9,0xb2d9a04e
463.89,1.0,8,1,2,3,6,0xb2d3cc0c
50001.0,2.0,4,2,3,4,9,0xb2da404b
3.39,1.0,25,1,2,2,5,0xb2d8ffa1
7.36,1.0,9,1,2,3,6,0xb2d1e87c
106214.33,2.0,87,3,3,1,7,0xb2d3f482d
500000.0,4.0,7,4,4,3,11,0xb2da524a
115244.56,3.0,122,3,4,1,8,0xb2d65d8b
50018.66,1.0,10,2,2,3,7,0xb2d986fb
4348.54,1.0,184,2,2,1,5,0xb2d342bcd
465873.54,7.0,0,4,4,4,12,0xb2d616e6
655350.04,3.0,1,4,4,4,12,0xb2d32494
580.85,1.0,1,1,2,4,7,0xb2d40872
3935.32,1.0,9,2,2,3,7,0xb2d536de
80999.58,2.0,1,3,3,4,10,0xb2d1a40d
821.16,1.0,19,1,2,2,5,0xb2d06cf9
100177.34,2.0,46,3,3,2,8,0xb2d580dc
83006.08,2.0,202,3,3,1,7,0xb2d4118ad
122.37,1.0,10,1,2,3,6,0xb2d4032f
302194.48,3.0,34,4,4,2,10,0xb2d31797
1000202.63,4.0,21,4,4,2,10,0xb2d1ba7fd
130009.51,3.0,52,3,4,2,9,0xb2d22eed
501776.17,2.0,11,4,3,3,10,0xb2d8fa6ad
140673.47,4.0,82,3,4,1,8,0xb2d6322ed
481000.41,12.0,0,4,4,4,12,0xb2d5f6ddd
200000.0,2.0,1,3,3,4,10,0xb2da627d
20196.92,2.0,39,2,3,2,7,0xb2d90fe3d
862978.75,5.0,25,4,4,2,10,0xb2d15288d
7.94,3.0,4,1,4,4,9,0xb2d068ff
767.58,1.0,10,1,2,3,6,0xb2d98108
84267.77,1.0,1,3,2,4,9,0xb2d35825
491779.87,3.0,28,4,4,2,10,0xb2d58786
632300.44,3.0,31,4,4,2,10,0xb2d0cff8d
11985.84,1.0,3,2,2,4,8,0xb2d2d929
28.31,1.0,2,1,2,4,7,0xb2d6b0dc
200037.69,2.0,6,3,3,3,9,0xb2d189ac
933.97,1.0,55,1,2,2,5,0xb2d86c9dd
3037.95,1.0,2,2,2,4,8,0xb2d1729a
200782.4,2.0,9,3,3,3,9,0xb2d6f7dc
20242.85,1.0,92,2,2,1,5,0xb2d184ec
10.3,1.0,24,1,2,2,5,0xb2d22ca7
8354.77,1.0,10,2,2,3,7,0xb2d69582d
360004.16,3.0,13,4,4,3,11,0xb2d575f6
10195.0,2.0,184,2,3,1,6,0xb2d410f5
19.07,1.0,17,1,2,2,5,0xb2d1c60cd
395.28,1.0,2,1,2,4,7,0xb2d81160d
430009.92,2.0,153,4,3,1,8,0xb2d68bbc
200005.31,2.0,13,3,3,3,9,0xb2d6457f
6544.18,1.0,24,2,2,2,6,0xb2d50627d
315888.71,7.0,14,4,4,3,11,0xb2d3f914
600245.1,2.0,0,4,3,4,11,0xb2d959fa
103863.16,2.0,139,3,3,1,7,0xb2d5385bd
782703.94,8.0,40,4,4,2,10,0xb2d64d23
606323.4,5.0,10,4,4,3,11,0xb2d3e7d6
104512.96,2.0,76,3,3,1,7,0xb2d388e1
2522.51,1.0,19,1,2,2,5,0xb2d6bf45
9000000.0,2.0,33,4,3,2,9,0xb2d9ba1a
511444.88,3.0,3,4,4,4,12,0xb2d610e5
919407.16,4.0,0,4,4,4,12,0xb2d090c3
945086.91,20.0,0,4,4,4,12,0xb2d16b79
1698.31,1.0,10,1,2,3,6,0xb2d5def9
629374.07,5.0,1,4,4,4,12,0xb2d12f16
630038.26,4.0,5,4,4,3,11,0xb2d9a0e1
61181.33,2.0,116,3,3,1,7,0xb2d41cd0
208533.13,3.0,11,3,4,3,10,0xb2d1875c
200007.39,3.0,55,3,4,2,9,0xb2d78db9
25.58,1.0,48,1,2,2,5,0xb2d6c66e
180005.78,3.0,10,3,4,3,10,0xb2d8f9d0
0.66,1.0,81,1,2,1,4,0xb2d633ccd
37.14,1.0,11,1,2,3,6,0xb2d7bfc3
1460.53,1.0,5,1,2,3,6,0xb2d6ee45
530032.55,3.0,31,4,4,2,10,0xb2d5cb66
511425.56,3.0,55,4,4,2,10,0xb2d64addd
100004.06,2.0,16,3,3,2,8,0xb2d93bc8
480007.67,5.0,7,4,4,3,11,0xb2d4a571
3827.49,1.0,0,2,2,4,8,0xb2d1ef57
251433.63,4.0,24,3,4,2,9,0xb2d2de19
1436.92,1.0,92,1,2,1,4,0xb2d29eafd
105404.06,5.0,129,3,4,1,8,0x3b9b2ca8
234282.09,3.0,4,3,4,4,11,0xb2d91ecfd
253003.69,3.0,140,3,4,1,8,0xb2d0ddb7d
8657.22,2.0,234,2,3,1,6,0xb2d4ef05d
5303.85,1.0,92,2,2,1,5,0xb2d1fcf7
4435941.33,2.0,11,4,3,3,10,0xb2d24aef
10072.1,2.0,4,2,3,4,9,0xb2d1628c
200071.48,2.0,8,3,3,3,9,0xb2d96f37d
406163.36,2.0,0,4,3,4,11,0xb2d1d46a
2017442.32,2.0,0,4,3,4,11,0xb2d1bbccd
30001.27,2.0,70,2,3,1,6,0xb2d9a39f
1404.87,1.0,27,1,2,2,5,0xb2d139c4
82862.73,1.0,60,3,2,2,7,0xb2d410be
7012.55,1.0,119,2,2,1,5,0xb2d2763a
300712.53,3.0,35,4,4,2,10,0xb2d9bc8a
918929.51,4.0,1,4,4,4,12,0xb2d391bc
2070016.04,2.0,1,4,3,4,11,0xb2da3871
5405740.34,7.0,6,4,4,3,11,0xb2d219e4d
105001.11,4.0,18,3,4,2,9,0xb2d15077
38000.4,2.0,53,2,3,2,7,0xb2d9cd86
200008.0,2.0,0,3,3,4,10,0xb2d972b8
20000.63,2.0,74,2,3,1,6,0xb2d99a92
126581.72,3.0,21,3,4,2,9,0xb2d0d687
6677.12,1.0,7,2,2,3,7,0xb2d9f914
100034.98,2.0,165,3,3,1,7,0xb2d5267c
190018.68,4.0,196,3,4,1,8,0xb2d4dd0f
70088.8,3.0,0,3,4,4,11,0xb2d08fa5
1461.74,1.0,9,1,2,3,6,0xb2d70079
400545.25,2.0,3,4,3,4,11,0xb2d8e1e6
220245.46,3.0,4,3,4,4,11,0x3b9b3db6
1062.76,1.0,9,1,2,3,6,0xb2d344d5
100643.52,2.0,21,3,3,2,8,0xb2d60a1ad
24.91,1.0,26,1,2,2,5,0xb2d9eef5
10287.67,1.0,92,2,2,1,5,0x3b9b2d45d
700000.83,4.0,6,4,4,3,11,0xb2d90b77d
10131.91,1.0,92,2,2,1,5,0xb2d29957d
101344.46,1.0,274,3,2,1,6,0xb2d637dfd
10322.78,1.0,10,2,2,3,7,0xb2d29c75d
555.34,1.0,7,1,2,3,6,0xb2d4f3fa
13528.97,2.0,2,2,3,4,9,0x3b9b2850d
130000.0,2.0,1,3,3,4,10,0xb2da48e4
9072.13,2.0,7,2,3,3,8,0xb2da2d0a
2230057.0,2.0,231,4,3,1,8,0xb2d1fbbcd
10413.39,1.0,184,2,2,1,5,0xb2d28c6b
3112.99,1.0,40,2,2,2,6,0xb2d9b631
50007.33,2.0,1,2,3,4,9,0xb2da336c
583.47,1.0,26,1,2,2,5,0xb2d3acaed
206416.35,2.0,8,3,3,3,9,0xb2d5ffa9d
501776.04,2.0,39,4,3,2,9,0xb2d9f6f6
0.0,1.0,1,1,2,4,7,0xb2d97c67d
10000.29,2.0,11,2,3,3,8,0xb2d61973d
790217.75,2.0,2,4,3,4,11,0xb2d5e966
2.47,1.0,8,1,2,3,6,0xb2d628bb
500005.28,2.0,53,4,3,2,9,0xb2d9cf3f
2.34,2.0,69,1,3,1,5,0xb2d98066
31961.99,1.0,49,2,2,2,6,0xb2d394bd
2437.68,2.0,0,1,3,4,8,0xb2d687a3
1712.49,1.0,10,1,2,3,6,0xb2d0acadd
115013.69,4.0,151,3,4,1,8,0xb2d6e969
2634.36,1.0,10,1,2,3,6,0xb2d455b1
100689.53,2.0,137,3,3,1,7,0xb2d6b684
67010.14,2.0,10,3,3,3,9,0xb2d69cdbd
210005.8,6.0,1,3,4,4,11,0xb2d56bb7
200010.47,3.0,4,3,4,4,11,0xb2d353fbd
502645.89,1.0,0,4,2,4,10,0xb2d37b52
17049.63,1.0,1,2,2,4,8,0xb2d34551
200021.34,4.0,27,3,4,2,9,0x3b9b4615
111031.26,2.0,6,3,3,3,9,0xb2d17799d
13170.38,1.0,102,2,2,1,5,0xb2d327c0d
100.33,1.0,92,1,2,1,4,0xb2d28ffcd
50000.53,2.0,98,2,3,1,6,0xb2d96e8bd
272792.14,7.0,0,3,4,4,11,0x3b9b1277
150111.01,2.0,42,3,3,2,8,0xb2d390c4
1001.17,1.0,121,1,2,1,4,0xb2d919bd
383000.0,3.0,6,4,4,3,11,0xb2d57e02
170011.02,4.0,76,3,4,1,8,0xb2d6fbfa
5447.73,1.0,15,2,2,3,7,0xb2d80372
15425.42,2.0,172,2,3,1,6,0xb2d5f0f7
2359.77,1.0,8,1,2,3,6,0xb2d928b6
105.21,3.0,0,1,4,4,9,0xb2d255cc
850017.73,4.0,5,4,4,3,11,0xb2d95b97
200097.75,3.0,3,3,4,4,11,0xb2d2061b
36141.48,1.0,13,2,2,3,7,0xb2d68c62
170034.32,3.0,41,3,4,2,9,0xb2d56854
50095.32,2.0,106,2,3,1,6,0xb2d43469
78.37,1.0,46,1,2,2,5,0xb2d1d236
1212891.91,3.0,88,4,4,1,9,0xb2d93ed3
260046.83,2.0,143,3,3,1,7,0xb2d621a0
200025.51,2.0,5,3,3,3,9,0xb2d62aee
18316.58,1.0,23,2,2,2,6,0xb2d3305b
120000.82,3.0,1,3,4,4,11,0xb2d0f00f
10020.19,1.0,9,2,2,3,7,0xb2d2d50fd
20325.11,2.0,6,2,3,3,8,0xb2d5e965
224034.44,3.0,206,3,4,1,8,0xb2d0e616
81.61,1.0,19,1,2,2,5,0xb2d648c2d
200723.29,2.0,9,3,3,3,9,0xb2d1e293
106.35,1.0,1,1,2,4,7,0xb2d2fcb0
4986.03,2.0,184,2,3,1,6,0xb2d06589d
0.78,3.0,5,1,4,3,8,0x3b9af262d
40016.68,2.0,13,2,3,3,8,0xb2d8d83d
51002.07,2.0,162,2,3,1,6,0xb2d4a66f
1150366.88,4.0,90,4,4,1,9,0xb2d1b4d4
1771.21,1.0,92,1,2,1,4,0xb2d197ccd
4094.54,1.0,25,2,2,2,6,0xb2d8ee53
2.04,1.0,24,1,2,2,5,0xb2d18910
370063.86,2.0,25,4,3,2,9,0xb2d78534
15614.06,1.0,4,2,2,4,8,0xb2d38ca5
2353.7,1.0,92,1,2,1,4,0xb2d4712ad
4249.25,1.0,184,2,2,1,5,0xb2d298e8
289038.31,11.0,0,3,4,4,11,0xb2d0691e
60523.44,1.0,2,3,2,4,9,0xb2d2f1b3
310003.27,4.0,5,4,4,3,11,0xb2d9699bd
546540.8,2.0,9,4,3,3,10,0xb2d68a87
13.04,1.0,0,1,2,4,7,0xb2d55ec4
57.61,1.0,27,1,2,2,5,0xb2d57972
250711.59,2.0,0,3,3,4,10,0xb2d92b3cd
13700.15,1.0,12,2,2,3,7,0xb2d987e6
11182.97,1.0,0,2,2,4,8,0xb2d8eb8a
27123.14,1.0,20,2,2,2,6,0xb2d6a43b
4001.0,1.0,10,2,2,3,7,0xb2d2dc07d
3426958.71,1.0,184,4,2,1,7,0xb2d264b6
23.49,2.0,13,1,3,3,7,0xb2d304a1
3079.96,1.0,2,2,2,4,8,0xb2d31d52
355490.13,2.0,31,4,3,2,9,0xb2d5e7c2
780.95,1.0,0,1,2,4,7,0xb2d6f343d
130278.37,2.0,0,3,3,4,10,0xb2d5c051d
50006.91,2.0,158,2,3,1,6,0xb2d6be7e
60000.63,2.0,74,3,3,1,7,0xb2d99fa7
200000.0,2.0,29,3,3,2,8,0xb2da09ed
17474.67,1.0,10,2,2,3,7,0xb2d2d3c9
10000.42,2.0,90,2,3,1,6,0xb2d8a79f
226.73,1.0,60,1,2,2,5,0xb2d29138
100087.62,2.0,74,3,3,1,7,0xb2d31ac2
937443.5,7.0,24,4,4,2,10,0xb2d1b752d
3928.99,1.0,18,2,2,2,6,0xb2d62498
808.27,1.0,88,1,2,1,4,0xb2d59059d
700039.03,4.0,0,4,4,4,12,0xb2d8e974
271.24,1.0,2,1,2,4,7,0xb2d86ca8d
401732.13,4.0,41,4,4,2,10,0xb2d18832
124538.88,5.0,76,3,4,1,8,0xb2d56f3e
1799.3,1.0,237,1,2,1,4,0xb2d6e8a2
230034.02,2.0,19,3,3,2,8,0xb2d8d604
337000.18,3.0,42,4,4,2,10,0xb2d9a2d1
758.67,2.0,112,1,3,1,5,0xb2d606bfd
20501.57,2.0,0,2,3,4,9,0xb2d64cec
856819.34,4.0,31,4,4,2,10,0xb2d4a5f0
642.85,1.0,30,1,2,2,5,0xb2d16b6a
1243.66,2.0,92,1,3,1,5,0xb2d09d2b
280138.05,2.0,5,3,3,3,9,0xb2da281c
70002.22,2.0,24,3,3,2,8,0xb2d944eb
56.8,1.0,15,1,2,3,6,0xb2d6db06
2005.9,5.0,1,1,4,4,9,0x3b9af0e7
7120.86,1.0,81,2,2,1,5,0xb2d57975d
735057.97,5.0,10,4,4,3,11,0xb2d2b37a
10611.61,2.0,184,2,3,1,6,0xb2d0fd43d
100000.82,2.0,4,3,3,4,10,0xb2d627a3
359304.33,2.0,95,4,3,1,8,0xb2d58ab8
3806.08,2.0,155,2,3,1,6,0xb2d50837d
3505.73,1.0,164,2,2,1,5,0xb2d39f76
1251.17,1.0,92,1,2,1,4,0xb2d2653e
2180.17,1.0,27,1,2,2,5,0xb2d53dd2
40001.69,3.0,42,2,4,2,8,0xb2d9d308
110604.3,9.0,39,3,4,2,9,0xb2d2916f
26741.68,1.0,0,2,2,4,8,0xb2d69ec5
3375.11,1.0,0,2,2,4,8,0xb2d781c3d
200000.0,2.0,18,3,3,2,8,0xb2da33df
1359.41,1.0,0,1,2,4,7,0xb2d2ed21
920020.6,6.0,6,4,4,3,11,0xb2d1487fd
5361.48,2.0,15,2,3,3,8,0xb2d31061
360002.06,3.0,25,4,4,2,10,0xb2d080e5
80002.54,2.0,46,3,3,2,8,0xb2d6325fd
350011.08,2.0,25,4,3,2,9,0xb2da0e74
600.0,1.0,0,1,2,4,7,0xb2d0f0b0
15764.43,1.0,92,2,2,1,5,0xb2d11bf7
1103.24,1.0,92,1,2,1,4,0x3b9b3602
250029.69,2.0,11,3,3,3,9,0xb2d9d804
32915.04,1.0,0,2,2,4,8,0xb2d43ad8
1005.12,1.0,30,1,2,2,5,0xb2d25638
204334.94,4.0,0,3,4,4,11,0xb2d42b5f
57003.32,2.0,235,3,3,1,7,0xb2d534e7
1435.16,1.0,12,1,2,3,6,0xb2d354f7
14561.79,1.0,2,2,2,4,8,0xb2d1bd7c
407604.35,2.0,37,4,3,2,9,0xb2d6d794
621358.79,5.0,79,4,4,1,9,0xb2d3bb1d
1168.78,1.0,0,1,2,4,7,0xb2d386b3
400032.4,3.0,5,4,4,3,11,0xb2d23936
35420.3,1.0,184,2,2,1,5,0xb2d281d7
2740184.73,7.0,0,4,4,4,12,0xb2d1b42c
450006.54,3.0,20,4,4,2,10,0xb2d744d9d
200011.65,4.0,39,3,4,2,9,0xb2d0706c
64199.85,2.0,63,3,3,2,8,0xb2d48911
440000.5,3.0,1,4,4,4,12,0xb2da067d
1505537.58,3.0,9,4,4,3,11,0xb2d5c075
300001.61,2.0,13,3,3,3,9,0xb2d8e1d6
57015.41,2.0,11,3,3,3,9,0xb2d35519
705.52,1.0,10,1,2,3,6,0xb2d2defd
15024.05,1.0,11,2,2,3,7,0xb2d4072b
130004.12,2.0,129,3,3,1,7,0xb2d6fcd1d
150002.69,2.0,3,3,3,4,10,0xb2d291e5
51.22,1.0,0,1,2,4,7,0xb2d3efdf
9231.88,1.0,0,2,2,4,8,0xb2d27b46
500016.65,2.0,179,4,3,1,8,0xb2d5fcb5
9016.77,1.0,55,2,2,2,6,0xb2d2756a
304447.69,2.0,120,4,3,1,8,0xb2d4cad6
4.21,1.0,24,1,2,2,5,0xb2d61779d
2.19,1.0,78,1,2,1,4,0xb2d63559d
100008.88,2.0,133,3,3,1,7,0xb2d3d352
959.99,1.0,3,1,2,4,7,0xb2d3573a
102495.49,2.0,259,3,3,1,7,0xb2d59258
201421.22,2.0,82,3,3,1,7,0xb2d98c7a
650098.7,5.0,0,4,4,4,12,0xb2d5e0a8d
129576.49,1.0,0,3,2,4,9,0xb2d9e535
466015.3,7.0,11,4,4,3,11,0xb2d230f6d
730003.03,4.0,18,4,4,2,10,0xb2d50677
2735.86,1.0,0,1,2,4,7,0xb2d68ef8
1426.05,2.0,0,1,3,4,8,0xb2d22ce5
27124.36,1.0,43,2,2,2,6,0xb2d6af76
100068.5,2.0,94,3,3,1,7,0xb2d3c2a9d
5089.8,1.0,92,2,2,1,5,0xb2d2aad1
354770.08,4.0,0,4,4,4,12,0xb2d63f0b
410004.17,5.0,137,4,4,1,9,0xb2d11849
800.99,1.0,3,1,2,4,7,0xb2d6f0b8d
1481078.75,11.0,0,4,4,4,12,0xb2d156a7d
1208.42,2.0,0,1,3,4,8,0xb2d064a1d
3195000.0,14.0,1,4,4,4,12,0xb2d5c3ba
80054.79,2.0,160,3,3,1,7,0xb2d449a6
118793.68,2.0,123,3,3,1,7,0xb2d584cf
668533.66,5.0,3,4,4,4,12,0xb2d3c543d
453197.77,2.0,82,4,3,1,8,0xb2d8d4b2
25258.71,2.0,174,2,3,1,6,0xb2d51694
620918.51,5.0,5,4,4,3,11,0xb2d98e44
204283.15,2.0,40,3,3,2,8,0xb2d46569
3.22,1.0,11,1,2,3,6,0xb2d90150
1014.7,1.0,92,1,2,1,4,0xb2d5ec55d
462021.08,3.0,1,4,4,4,12,0xb2d927ec
1522.34,1.0,10,1,2,3,6,0xb2d8d12bd
272223.48,3.0,0,3,4,4,11,0xb2d44089d
26.55,1.0,7,1,2,3,6,0xb2d6a6e8
104776.17,2.0,70,3,3,1,7,0xb2d58b51
280044.54,2.0,83,3,3,1,7,0xb2d17003d
96817.13,1.0,9,3,2,3,8,0xb2d482d2
50176.47,2.0,158,2,3,1,6,0xb2d5b6dd
116.45,1.0,0,1,2,4,7,0xb2d326e8
60000.63,2.0,20,3,3,2,8,0xb2d95110d
558.11,1.0,35,1,2,2,5,0xb2d2e325
230006.17,4.0,110,3,4,1,8,0xb2d14b1e
6415.12,1.0,286,2,2,1,5,0xb2d3a258d
330153.83,2.0,1,4,3,4,11,0xb2d58693
10356.61,2.0,92,2,3,1,6,0xb2d625ae
1039516.32,2.0,38,4,3,2,9,0xb2d1f0da
227.12,1.0,10,1,2,3,6,0xb2d4cb78
167.16,1.0,5,1,2,3,6,0xb2d2d5bb
11349784.59,5.0,4,4,4,4,12,0xb2d14579
5812.96,1.0,0,2,2,4,8,0xb2d1452b
160005.07,2.0,34,3,3,2,8,0xb2d92d62
0.37,1.0,4,1,2,4,7,0xb2d5ea30
400000.0,3.0,0,4,4,4,12,0xb2d95dba
253146.41,8.0,80,3,4,1,8,0xb2d4c803
210002.22,2.0,73,3,3,1,7,0xb2d8e5c2d
801015.32,4.0,5,4,4,3,11,0xb2d54becd
33650.27,1.0,66,2,2,2,6,0xb2d3110ed
240000.0,2.0,14,3,3,3,9,0xb2da3dad
50008.47,2.0,50,2,3,2,7,0xb2d7ff5f
200105.96,3.0,27,3,4,2,9,0xb2d41436d
787.07,2.0,4,1,3,4,8,0xb2d3ff62
200001.26,2.0,20,3,3,2,8,0xb2d958ee
460432.3,3.0,0,4,4,4,12,0xb2d8d2e1
6082.28,1.0,92,2,2,1,5,0xb2d24711
8957.5,2.0,92,2,3,1,6,0x3b9aceaad
89142.78,5.0,5,3,4,3,10,0xb2d647d3
30001.27,2.0,92,2,3,1,6,0xb2d62e33
50096.85,2.0,101,2,3,1,6,0xb2d259a0d
65635.83,1.0,0,3,2,4,9,0xb2d4ff8ad
60003.38,4.0,25,3,4,2,9,0xb2d9e434
1405.47,1.0,92,1,2,1,4,0xb2d3331a
40000.39,2.0,6,2,3,3,8,0xb2d1857c
503418.57,1.0,10,4,2,3,9,0xb2d561be
250008.02,2.0,18,3,3,2,8,0xb2d9dea5
450009.87,3.0,59,4,4,2,10,0xb2d65910
25161.46,2.0,33,2,3,2,7,0xb2d656c9
5880.57,1.0,0,2,2,4,8,0xb2d31543
1677.96,1.0,57,1,2,2,5,0xb2d12db1
209887.25,12.0,0,3,4,4,11,0xb2d0f2d0
35427.9,1.0,131,2,2,1,5,0xb2d6935b
170029.19,3.0,4,3,4,4,11,0xb2d6a42e
1010.1,1.0,1,1,2,4,7,0xb2d7833a
241013.18,2.0,165,3,3,1,7,0xb2d60a61
208404.48,3.0,56,3,4,2,9,0xb2d459d1
1600016.89,2.0,27,4,3,2,9,0xb2d93679d
605.05,4.0,0,1,4,4,9,0x3b9b3d13
35.16,1.0,50,1,2,2,5,0xb2d60835
40923.44,3.0,12,2,4,3,9,0xb2d65046
28.76,1.0,77,1,2,1,4,0xb2d2f236
400000.0,4.0,1,4,4,4,12,0xb2d58712
1776.73,1.0,0,1,2,4,7,0xb2d1d832
500100.01,2.0,21,4,3,2,9,0xb2da2366
351705.01,3.0,0,4,4,4,12,0xb2d3857f
201016.54,11.0,0,3,4,4,11,0xb2d57b15d
650005.4,3.0,6,4,4,3,11,0x3b9b2c74d
24450517.57,9.0,0,4,4,4,12,0xb2d14d69
1150012.14,2.0,74,4,3,1,8,0xb2d99b47
52790.82,2.0,256,3,3,1,7,0xb2d40d3dd
292055.99,5.0,0,3,4,4,11,0xb2d42c85d
2402693.85,4.0,70,4,4,1,9,0xb2d1269fd
1144000.0,4.0,3,4,4,4,12,0xb2d16c36d
120005.29,3.0,132,3,4,1,8,0xb2d91fbb
10631115.71,2.0,24,4,3,2,9,0xb2d6a4b1
3801877.21,1.0,0,4,2,4,10,0xb2d36ddfd
7448.39,1.0,0,2,2,4,8,0xb2d5cf15
52.88,1.0,1,1,2,4,7,0xb2d6bfab
233289.81,2.0,129,3,3,1,7,0xb2d0c6d4d
729.64,1.0,43,1,2,2,5,0xb2d99d2a
100009.5,3.0,11,3,4,3,10,0xb2d94fde
59770.87,2.0,0,3,3,4,10,0x3b9af0c4
103498.88,2.0,11,3,3,3,9,0xb2d44b0f
229009.92,6.0,4,3,4,4,11,0xb2d1cbea
10000.11,2.0,63,2,3,2,7,0xb2d90774
1143.86,1.0,92,1,2,1,4,0xb2d3ee63
51617.24,2.0,92,2,3,1,6,0xb2d4cc67
17.86,1.0,53,1,2,2,5,0xb2d36ffb
518964.36,4.0,31,4,4,2,10,0xb2d245e3
411036.29,6.0,32,4,4,2,10,0xb2d58e19
60002.53,2.0,28,3,3,2,8,0xb2da0652
170188.22,5.0,32,3,4,2,9,0xb2d60595
29.61,1.0,10,1,2,3,6,0xb2d5513b
380637.71,3.0,77,4,4,1,9,0xb2d27b74d
150004.75,3.0,47,3,4,2,9,0xb2d619b1d
1050032.31,7.0,5,4,4,3,11,0xb2d2c549
2496.88,1.0,10,1,2,3,6,0xb2d50abe
653303.79,6.0,2,4,4,4,12,0x3b9af20f
200004.22,2.0,80,3,3,1,7,0xb2d98cc1
100479.1,2.0,157,3,3,1,7,0xb2d20e1ed
200000.0,2.0,1,3,3,4,10,0xb2d9d60d
2551443.4,5.0,0,4,4,4,12,0xb2d6dfad
689.83,1.0,13,1,2,3,6,0xb2d6d722
0.74,1.0,18,1,2,2,5,0xb2d956a9d
12178.36,1.0,4,2,2,4,8,0xb2d60e04
15193.19,1.0,9,2,2,3,7,0xb2d475ba
6715.59,1.0,4,2,2,4,8,0xb2d8fee0
158120.98,3.0,10,3,4,3,10,0xb2d9684c
20615.36,1.0,6,2,2,3,7,0xb2da3ebd
100216.78,3.0,0,3,4,4,11,0xb2d5302e
110008.62,4.0,24,3,4,2,9,0xb2d57ca0
152004.31,3.0,83,3,4,1,8,0xb2d2ee87d
15002.61,2.0,11,2,3,3,8,0xb2d690fa
90079.37,6.0,1,3,4,4,11,0xb2d6f1add
908018.39,3.0,0,4,4,4,12,0xb2d69b11
101053.95,8.0,0,3,4,4,11,0x3b9b3853
100056.5,2.0,103,3,3,1,7,0xb2d519e7
149322.96,9.0,0,3,4,4,11,0xb2d0b5a6
320083.26,2.0,1,4,3,4,11,0xb2d576dcd
680000.0,4.0,0,4,4,4,12,0xb2d6f925
270009.39,5.0,0,3,4,4,11,0xb2d16cbc
560965.99,6.0,57,4,4,2,10,0xb2d1fc53
5083.4,1.0,29,2,2,2,6,0xb2d92bdf
46590.33,1.0,4,2,2,4,8,0xb2d2a79e
4062.28,1.0,21,2,2,2,6,0xb2d39373
400067.76,2.0,16,4,3,2,9,0xb2d7c60dd
687688.27,8.0,3,4,4,4,12,0xb2d32704d
1309.01,1.0,46,1,2,2,5,0xb2d25c45
20405.71,1.0,4,2,2,4,8,0xb2d48c12d
2349944.89,11.0,0,4,4,4,12,0xb2d0b7f1
282617.41,2.0,1,3,3,4,10,0xb2d2e82b
188014.38,6.0,6,3,4,3,10,0xb2d59090
95994.51,1.0,161,3,2,1,6,0xb2d562b9d
402843.46,3.0,11,4,4,3,11,0xb2d6e7d1
36483.24,1.0,6,2,2,3,7,0xb2d682d2
4.68,1.0,0,1,2,4,7,0xb2d2806fd
53.67,1.0,110,1,2,1,4,0xb2d39ce5
50001.06,2.0,92,2,3,1,6,0xb2d65714
3006.47,1.0,214,2,2,1,5,0xb2d78025
30000.32,2.0,10,2,3,3,8,0xb2d6584f
4043.97,1.0,0,2,2,4,8,0xb2d8e488
826.93,2.0,55,1,3,2,6,0xb2d0728f
10144.2,1.0,3,2,2,4,8,0xb2d434f2d
41001.86,2.0,18,2,3,2,7,0xb2d5e0cf
536280.29,6.0,17,4,4,2,10,0xb2d58de6
134050.1,2.0,188,3,3,1,7,0xb2d22c76
50587.2,1.0,34,2,2,2,6,0xb2d92a22
308810.65,2.0,70,4,3,1,8,0xb2d126ab
526049.54,8.0,18,4,4,2,10,0xb2d1492c
67406.11,2.0,122,3,3,1,7,0xb2d5746a
185004.96,4.0,2,3,4,4,11,0xb2d6f231
600025.05,4.0,6,4,4,3,11,0xb2d11fcf
10.07,1.0,10,1,2,3,6,0xb2d4f451
483.55,1.0,2,1,2,4,7,0xb2d48decd
170455.18,4.0,60,3,4,2,9,0xb2d4cc51
46.52,1.0,2,1,2,4,7,0xb2d40c2b
60209.5,2.0,63,3,3,2,8,0xb2d2af63
682.14,1.0,0,1,2,4,7,0xb2d6c015d
52434.7,1.0,10,3,2,3,8,0xb2d1f4d9d
6.37,1.0,49,1,2,2,5,0xb2d60b15
3664.44,1.0,10,2,2,3,7,0xb2d23dc4
13667.32,1.0,184,2,2,1,5,0xb2d1217a
1390044.86,4.0,2,4,4,4,12,0xb2d30061
3427.06,1.0,0,2,2,4,8,0xb2d6f07d
302193.79,2.0,49,4,3,2,9,0xb2d6a2d5d
5727.96,1.0,122,2,2,1,5,0xb2d695b6
60694.01,2.0,18,3,3,2,8,0xb2d27a40d
0.0,2.0,81,1,3,1,5,0xb2d56e35
10366.58,1.0,196,2,2,1,5,0xb2d0fa7ad
1103907.29,3.0,36,4,4,2,10,0xb2d9fabb
160474.09,1.0,4,3,2,4,9,0xb2d5b2f3
500084.6,2.0,18,4,3,2,9,0xb2d69324d
752316.2,2.0,31,4,3,2,9,0xb2d369b1d
206.68,1.0,4,1,2,4,7,0xb2d9cbdf
6464.38,1.0,19,2,2,2,6,0xb2d4646bd
210006.64,4.0,34,3,4,2,9,0xb2d8d9b8
1910000.0,40.0,0,4,4,4,12,0xb2d23dd2
800010.55,3.0,28,4,4,2,10,0xb2da0288
4656.19,1.0,0,2,2,4,8,0xb2d53772
415000.0,6.0,3,4,4,4,12,0xb2d14cd4
676001.13,12.0,16,4,4,2,10,0xb2d1be23
200003.61,2.0,6,3,3,3,9,0xb2d95dd4
568337.43,4.0,64,4,4,2,10,0xb2d5a818d
500062.57,3.0,7,4,4,3,11,0xb2d91422
59484.47,6.0,8,3,4,3,10,0xb2d64f62d
79986.03,1.0,184,3,2,1,6,0xb2d2aa5ed
90768.93,5.0,4,3,4,4,11,0xb2d2b162
85.26,1.0,11,1,2,3,6,0xb2d6bd26
93054.83,5.0,9,3,4,3,10,0xb2d07d41
302.86,1.0,74,1,2,1,4,0xb2d63339
359.62,1.0,131,1,2,1,4,0xb2d5f059d
72478.06,2.0,221,3,3,1,7,0xb2d130be
569.99,1.0,19,1,2,2,5,0xb2d5b61f
707979.2,3.0,3,4,4,4,12,0xb2d68271
943649.84,6.0,1,4,4,4,12,0xb2d4c84f
67759.09,2.0,60,3,3,2,8,0xb2d346fcd
704.01,1.0,74,1,2,1,4,0xb2d21c9c
21557.45,1.0,0,2,2,4,8,0xb2d18070
6661.71,1.0,10,2,2,3,7,0xb2d1d4f1
199941.34,7.0,0,3,4,4,11,0xb2d06548
1967174.45,5.0,11,4,4,3,11,0xb2d23e5b
904242.46,2.0,52,4,3,2,9,0xb2d354c5
6589.71,1.0,1,2,2,4,8,0xb2d24df5
350059.91,5.0,13,4,4,3,11,0xb2d411e6
8.01,1.0,83,1,2,1,4,0xb2d1bb0d
34.18,1.0,208,1,2,1,4,0xb2d2a66b
3583.02,1.0,10,2,2,3,7,0xb2d5b9f0
2466.3,1.0,184,1,2,1,4,0xb2d22ee1d
15233.82,2.0,0,2,3,4,9,0xb2d92b6a
350001.59,3.0,0,4,4,4,12,0xb2d96786
1441.73,1.0,0,1,2,4,7,0xb2d5c598d
23536.58,1.0,0,2,2,4,8,0xb2d6b538
67342.93,5.0,6,3,4,3,10,0xb2d7eee4d
6769.38,1.0,7,2,2,3,7,0xb2d34fb8
63.63,1.0,42,1,2,2,5,0xb2d5e1bd
5058.8,1.0,184,2,2,1,5,0xb2d287a6
20022.84,1.0,217,2,2,1,5,0xb2d6140a
56985.33,2.0,0,3,3,4,10,0xb2d5510f
1.33,1.0,79,1,2,1,4,0xb2d651a7
165286.48,6.0,41,3,4,2,9,0xb2d1c960
36720.29,2.0,4,2,3,4,9,0xb2d13c49
1175219.93,3.0,10,4,4,3,11,0xb2d3a547d
56713.11,2.0,8,3,3,3,9,0xb2d46384
450733.59,4.0,25,4,4,2,10,0xb2d11ac1
1048.78,1.0,92,1,2,1,4,0x3b9b2ad8
302701.19,3.0,235,4,4,1,9,0xb2d55f41
1150002.45,5.0,0,4,4,4,12,0xb2d61cb6d
440671.09,3.0,10,4,4,3,11,0xb2d406b7
154000.28,3.0,1,3,4,4,11,0xb2d4c875
110126.34,2.0,22,3,3,2,8,0xb2d18a31d
7.06,1.0,20,1,2,2,5,0xb2d54e31
62789.66,1.0,0,3,2,4,9,0xb2d39ca7d
91689.0,1.0,24,3,2,2,7,0xb2d2aa46
51080.82,2.0,14,2,3,3,8,0xb2d630f4
72.41,4.0,64,1,4,2,7,0xb2d8a679
550004.52,5.0,15,4,4,3,11,0xb2d52271
1027190.47,23.0,25,4,4,2,10,0xb2d3b6edd
152005.97,1.0,0,3,2,4,9,0x3b9b0e65
190002.87,3.0,98,3,4,1,8,0xb2d2a305
500005.29,2.0,10,4,3,3,10,0xb2d96147
2463963.42,9.0,5,4,4,3,11,0xb2d1ddbd
10299.63,1.0,18,2,2,2,6,0xb2d5a08cd
4797.43,1.0,15,2,2,3,7,0xb2d7176e
100114.08,2.0,0,3,3,4,10,0xb2d0bd07
289.84,1.0,11,1,2,3,6,0xb2d48f5e
167.37,1.0,19,1,2,2,5,0xb2d1ed6c
1673.09,2.0,0,1,3,4,8,0xb2d33a85
16199.18,4.0,184,2,4,1,7,0xb2d1862e
507.06,3.0,3,1,4,4,9,0x3b9b340ad
55654.57,1.0,20,3,2,2,7,0xb2d6a6d3
99908.17,1.0,9,3,2,3,8,0xb2d2d498
61091.96,2.0,206,3,3,1,7,0xb2d5b42a
12916.81,1.0,15,2,2,3,7,0xb2d9b2e4
350000.0,2.0,19,4,3,2,9,0xb2da2e9f
2574.02,1.0,0,1,2,4,7,0xb2d44c1e
556.8,1.0,25,1,2,2,5,0xb2d1d796
260010.67,4.0,27,3,4,2,9,0xb2d337cad
52.76,1.0,3,1,2,4,7,0xb2d22e19
12545.88,1.0,99,2,2,1,5,0xb2d649fb
357.4,1.0,63,1,2,2,5,0xb2d3af13
290000.84,3.0,3,3,4,4,11,0xb2d1eeb6
0.0,1.0,4,1,2,4,7,0xb2d55b05
60002.31,2.0,206,3,3,1,7,0xb2d11c91
20.01,1.0,40,1,2,2,5,0xb2d921f4
11231.96,1.0,0,2,2,4,8,0xb2d61134
216010.69,4.0,6,3,4,3,10,0xb2d0fcdf
121155.47,3.0,1,3,4,4,11,0xb2d554c5
37.14,1.0,75,1,2,1,4,0xb2d53fbc
630035.85,6.0,10,4,4,3,11,0xb2d572d4d
201421.3,2.0,57,3,3,2,8,0xb2d98531
12.56,1.0,9,1,2,3,6,0xb2d2e186
102352.13,2.0,82,3,3,1,7,0xb2d59a54d
500000.08,3.0,11,4,4,3,11,0xb2d99e32
11420.86,1.0,0,2,2,4,8,0xb2d53037
1297.43,1.0,184,1,2,1,4,0xb2d4da9f
14171.78,1.0,1,2,2,4,8,0xb2d6a7d4
773355.3,2.0,25,4,3,2,9,0xb2d11897d
310036.06,6.0,70,4,4,1,9,0xb2d4a692
10000.74,2.0,80,2,3,1,6,0xb2d8cdf8
1015.8,1.0,92,1,2,1,4,0xb2d0c8acd
271976.12,5.0,0,3,4,4,11,0x3b9b3e07
6.08,1.0,7,1,2,3,6,0xb2d998d0
11.38,7.0,1,1,4,4,9,0xb2d0a661
400.17,1.0,0,1,2,4,7,0xb2d3740f
555.69,1.0,9,1,2,3,6,0xb2d438ebd
32115.3,3.0,0,2,4,4,10,0xb2d1345ed
6.57,1.0,39,1,2,2,5,0xb2d635d9
352729.09,3.0,24,4,4,2,10,0xb2d14cf1
50002.53,3.0,189,2,4,1,7,0xb2d7c541
875073.35,5.0,18,4,4,2,10,0xb2d5ff13
146.07,1.0,18,1,2,2,5,0xb2d90f68
23077.41,1.0,0,2,2,4,8,0xb2d6fe01
1280580.18,5.0,0,4,4,4,12,0xb2d2e787d
4029.9,1.0,184,2,2,1,5,0xb2d3e9c0d
170266.38,3.0,133,3,4,1,8,0xb2d64ebf
650066.03,4.0,1,4,4,4,12,0xb2d6083e
564.54,2.0,19,1,3,2,6,0xb2d07e3d
32555.88,1.0,0,2,2,4,8,0xb2d0c10a
1.95,1.0,27,1,2,2,5,0xb2d78538
5.28,1.0,81,1,2,1,4,0xb2d8d502d
3983.5,1.0,184,2,2,1,5,0xb2d2a8a8
9771.74,1.0,13,2,2,3,7,0xb2d2b4d5d
57591.25,1.0,0,3,2,4,9,0xb2d33d81
500000.0,3.0,8,4,4,3,11,0xb2d8eafcd
33326.26,1.0,15,2,2,3,7,0xb2d69bd9d
13654.2,1.0,92,2,2,1,5,0xb2d1217ad
104112.19,2.0,145,3,3,1,7,0xb2d1a5e4
1240362.08,7.0,44,4,4,2,10,0xb2d5874f
453672.99,3.0,46,4,4,2,10,0xb2d1960b
1817.25,1.0,4,1,2,4,7,0xb2d31b7b
10521.78,1.0,54,2,2,2,6,0xb2d5ae78
2021.54,1.0,14,1,2,3,6,0xb2d8e2ed
1200.85,2.0,10,1,3,3,7,0xb2d8d1ef
217016.46,4.0,0,3,4,4,11,0xb2d361a4
1500.43,1.0,167,1,2,1,4,0xb2d6b4ee
10003104.44,4.0,3,4,4,4,12,0xb2d92960
111466.72,2.0,53,3,3,2,8,0xb2d4d9ac
282.21,1.0,56,1,2,2,5,0xb2d29417
154832.86,2.0,29,3,3,2,8,0xb2d24965
877.32,1.0,2,1,2,4,7,0xb2d94528
5413.59,1.0,116,2,2,1,5,0xb2d23111
817001.91,7.0,0,4,4,4,12,0xb2d0c1ead
31114.78,1.0,20,2,2,2,6,0xb2d6a7df
250888.1,2.0,19,3,3,2,8,0xb2d91234
21224.52,1.0,5,2,2,3,7,0xb2d85b80
54145.7,4.0,90,3,4,1,8,0xb2d1b8a7
75.39,1.0,27,1,2,2,5,0xb2d48cf3
34.44,1.0,18,1,2,2,5,0xb2d60a45
80004.83,3.0,221,3,4,1,8,0xb2d1f732
100627.41,2.0,0,3,3,4,10,0xb2d20f95
5.28,1.0,67,1,2,1,4,0xb2d6584c
2736.77,1.0,129,1,2,1,4,0xb2d92c22d
18103.11,1.0,18,2,2,2,6,0xb2d2674dd
168.99,1.0,10,1,2,3,6,0xb2d929c0
600039.78,2.0,95,4,3,1,8,0xb2d3c183
836023.46,21.0,0,4,4,4,12,0xb2d0a6fe
4.34,1.0,42,1,2,2,5,0xb2d7ee63
868620.88,2.0,0,4,3,4,11,0xb2d11b9f
50002.19,2.0,66,2,3,2,7,0xb2d60604
300009.51,2.0,151,3,3,1,7,0xb2d8fba3
60000.04,3.0,13,3,4,3,10,0xb2d9d37a
484714.26,11.0,8,4,4,3,11,0xb2d5d764
4442.25,1.0,74,2,2,1,5,0xb2d30e0d
271923.39,2.0,68,3,3,1,7,0xb2d567bd
5515.41,1.0,0,2,2,4,8,0xb2d0b491
300000.0,2.0,6,3,3,3,9,0xb2d971f9
959727.36,7.0,1,4,4,4,12,0xb2d394a8
200010.43,2.0,3,3,3,4,10,0xb2d9ef0d
1060201.98,8.0,14,4,4,3,11,0xb2d071a3
65827.51,1.0,1,3,2,4,9,0xb2d8e9a1
832086.92,7.0,0,4,4,4,12,0xb2d11c95d
4176.18,1.0,11,2,2,3,7,0xb2d408e1
12.8,1.0,3,1,2,4,7,0xb2d2eccd
210000.0,2.0,11,3,3,3,9,0xb2da4c15
4563.24,1.0,0,2,2,4,8,0xb2d343ca
62457.91,2.0,196,3,3,1,7,0xb2d55e02
644604.0,6.0,4,4,4,4,12,0xb2d42feed
13672.27,1.0,9,2,2,3,7,0xb2d5692c
800025.83,6.0,1,4,4,4,12,0xb2d24500
22.65,1.0,60,1,2,2,5,0xb2d1aa1f
50000.0,2.0,3,2,3,4,9,0xb2d5576ad
11.75,1.0,18,1,2,2,5,0xb2d1542d
593549.45,6.0,52,4,4,2,10,0xb2d39a38
116527.97,2.0,18,3,3,2,8,0xb2d54836
437197.76,8.0,74,4,4,1,9,0xb2d642d4
350559.92,7.0,0,4,4,4,12,0xb2d2ae17
10000.21,1.0,12,2,2,3,7,0xb2d948cc
14.82,1.0,8,1,2,3,6,0xb2d6e5a7
351079.08,3.0,34,4,4,2,10,0xb2d9a90d
168054.91,3.0,1,3,4,4,11,0xb2d5f69f
0.07,1.0,35,1,2,2,5,0xb2d48f38d
1537.49,1.0,210,1,2,1,4,0xb2d5090e
899556.28,11.0,26,4,4,2,10,0x3b9b276bd
1664.21,1.0,184,1,2,1,4,0xb2d15691d
15.45,1.0,19,1,2,2,5,0xb2d37cb4
41199.78,2.0,184,2,3,1,6,0xb2d1dd0ed
4.82,1.0,0,1,2,4,7,0xb2d201bc
4610.52,1.0,0,2,2,4,8,0xb2d2c8f2
4191.22,1.0,3,2,2,4,8,0xb2d6e871
35.55,2.0,18,1,3,2,6,0x3b9b3be3
4009.93,1.0,32,2,2,2,6,0xb2d9d2aa
102147.84,2.0,89,3,3,1,7,0xb2d5df37
200002.1,2.0,18,3,3,2,8,0xb2d8dc49
1570064.14,7.0,0,4,4,4,12,0x3b9b2fa1
33041.67,2.0,249,2,3,1,6,0xb2d25a1fd
50.89,1.0,88,1,2,1,4,0xb2d9277f
330122.42,2.0,1,4,3,4,11,0xb2d1090d
80003.1,3.0,63,3,4,2,9,0xb2d9a40c
150009.51,2.0,34,3,3,2,8,0xb2d926e2
15862.91,1.0,197,2,2,1,5,0xb2d1e1c2d
114586.3,3.0,11,3,4,3,10,0xb2d3a8d7
55.1,1.0,15,1,2,3,6,0xb2d9aa53
638.37,1.0,126,1,2,1,4,0xb2d5b1ae
4572.06,1.0,4,2,2,4,8,0xb2d78e0f
312898.79,3.0,7,4,4,3,11,0xb2d6ef24
32.66,1.0,184,1,2,1,4,0xb2d2566cd
3332000.0,7.0,4,4,4,4,12,0xb2d683cdd
189483.94,1.0,7,3,2,3,8,0xb2d616b7d
473704.22,4.0,11,4,4,3,11,0xb2d0aced
100003.29,7.0,0,3,4,4,11,0xb2d65dfad
88.36,2.0,0,1,3,4,8,0xb2d18eb0
0.04,1.0,0,1,2,4,7,0xb2d06d4a
745741.9,9.0,1,4,4,4,12,0xb2d45c4d
11.81,1.0,14,1,2,3,6,0xb2d7f180
6059.55,1.0,92,2,2,1,5,0xb2d297b0
502169.11,6.0,9,4,4,3,11,0xb2d37314
502162.75,3.0,83,4,4,1,9,0xb2d606d6d
1012.33,1.0,184,1,2,1,4,0xb2d25103d
277426.2,4.0,11,3,4,3,10,0xb2d5ff93
5.51,1.0,1,1,2,4,7,0xb2d568be
500000.0,2.0,1,4,3,4,11,0xb2da668e
79926.12,1.0,18,3,2,2,7,0xb2d5cf79
639.21,1.0,46,1,2,2,5,0xb2d2610dd
210045.53,2.0,19,3,3,2,8,0xb2d36b2a
587272.57,6.0,2,4,4,4,12,0xb2d35b30
2085.82,41.0,3,1,4,4,9,0x3b9b2634
283602.64,4.0,13,3,4,3,10,0xb2d2d5ee
1218.45,1.0,184,1,2,1,4,0xb2d152e6
124.12,1.0,19,1,2,2,5,0xb2d9ec81
10.78,1.0,9,1,2,3,6,0xb2d51ce8
793.58,1.0,139,1,2,1,4,0xb2d53529
207312.71,2.0,83,3,3,1,7,0xb2d2b338
1204.71,1.0,26,1,2,2,5,0xb2d08155d
7300.96,1.0,0,2,2,4,8,0xb2d6b632
6816.2,1.0,239,2,2,1,5,0xb2d6dede
1029.94,1.0,7,1,2,3,6,0xb2d3fee2
302135.91,2.0,77,4,3,1,8,0xb2d989a6
1660.73,1.0,2,1,2,4,7,0xb2d3292cd
679.23,1.0,15,1,2,3,6,0xb2d20b0a
202003.47,2.0,6,3,3,3,9,0xb2d6ef7e
200000.0,2.0,26,3,3,2,8,0xb2da14ea
20351.89,1.0,18,2,2,2,6,0xb2d6eba7
457.62,1.0,25,1,2,2,5,0xb2d78db6
10323.18,1.0,67,2,2,1,5,0xb2d5da27
1437085.36,4.0,60,4,4,2,10,0xb2d24a47d
25168.91,1.0,55,2,2,2,6,0xb2d53cde
342.79,1.0,167,1,2,1,4,0xb2d31a98d
4.56,1.0,31,1,2,2,5,0xb2d36e20
918118.83,5.0,18,4,4,2,10,0xb2d60cc8d
300008.67,2.0,228,3,3,1,7,0xb2d623aa
220012.65,5.0,27,3,4,2,9,0xb2d7825ed
103701.45,2.0,92,3,3,1,7,0xb2d24bf3
301065.64,2.0,41,4,3,2,9,0xb2d9ef3a
1991.41,1.0,1,1,2,4,7,0xb2d573d0
602.66,1.0,77,1,2,1,4,0xb2d48e4e
100735.44,2.0,18,3,3,2,8,0xb2d61c9e
1643.55,1.0,14,1,2,3,6,0x3b9b2d91
215134.81,2.0,94,3,3,1,7,0xb2d3f5d9
35176.3,1.0,0,2,2,4,8,0xb2d5f9bcd
14870.8,1.0,13,2,2,3,7,0xb2d527aad
171.85,1.0,13,1,2,3,6,0xb2d8c47a
400022.13,3.0,76,4,4,1,9,0xb2d10df4d
11854.92,1.0,1,2,2,4,8,0xb2d2b99e
160066.87,4.0,19,3,4,2,9,0xb2d5e8f0
31002.19,2.0,92,2,3,1,6,0xb2d970b8
3463.54,1.0,0,2,2,4,8,0xb2d92443
240852.5,2.0,31,3,3,2,8,0xb2d93f56
2621.23,1.0,0,1,2,4,7,0xb2d154a3
10.85,1.0,4,1,2,4,7,0xb2d616ed
47.0,1.0,72,1,2,1,4,0xb2d43a94
60001.78,4.0,0,3,4,4,11,0xb2d393e1
5677.38,1.0,0,2,2,4,8,0xb2d0d9a5d
5.47,1.0,80,1,2,1,4,0xb2d1beb7d
70005.17,2.0,48,3,3,2,8,0xb2d9ccc4
3171.42,1.0,25,2,2,2,6,0xb2d2d0ccd
69.13,1.0,98,1,2,1,4,0xb2d58e27
109446.08,3.0,24,3,4,2,9,0xb2d19a54
126.67,1.0,74,1,2,1,4,0xb2d8da76
3079.59,1.0,29,2,2,2,6,0xb2d9267d
545000.66,18.0,3,4,4,4,12,0xb2d581a9
18390.05,1.0,1,2,2,4,8,0xb2d33d81d
1128484.91,4.0,66,4,4,2,10,0xb2d52de4
40192.26,5.0,19,2,4,2,8,0xb2d78685
155222.86,2.0,0,3,3,4,10,0xb2d09fc8
96005.34,14.0,3,3,4,4,11,0xb2d067aa
55010.48,2.0,2,3,3,4,10,0xb2d6a98ed
30000.78,3.0,0,2,4,4,10,0xb2d62326
550284.81,5.0,4,4,4,4,12,0xb2d6e7ab
1392040.19,3.0,2,4,4,4,12,0xb2d4180d
56493.11,3.0,10,3,4,3,10,0xb2d5998d
250006.22,2.0,0,3,3,4,10,0xb2d9a2ce
250007.93,2.0,164,3,3,1,7,0xb2d6c8e0d
200013.68,2.0,98,3,3,1,7,0xb2d41ac0
3962.66,1.0,11,2,2,3,7,0xb2d8d4a9
174790.69,15.0,8,3,4,3,10,0xb2d2c294
10414.09,1.0,184,2,2,1,5,0xb2d42792d
389025.44,6.0,3,4,4,4,12,0xb2d13f60
2000.56,1.0,0,1,2,4,7,0xb2d78c37
100003.83,3.0,39,3,4,2,9,0xb2d44c99
80.47,1.0,80,1,2,1,4,0xb2d91cfe
687308.86,6.0,5,4,4,3,11,0xb2d30d40
450002.65,2.0,12,4,3,3,10,0xb2d6addd
660014.9,7.0,62,4,4,2,10,0x3b9b241d
456885.72,6.0,53,4,4,2,10,0xb2d2d1ac
5092.91,3.0,26,2,4,2,8,0xb2d43179d
385522.28,3.0,13,4,4,3,11,0xb2d2f818d
100005.29,3.0,132,3,4,1,8,0xb2d26aa0d
165.46,1.0,11,1,2,3,6,0xb2d9a996
83036.07,3.0,104,3,4,1,8,0xb2d0f887
583.68,1.0,116,1,2,1,4,0xb2d67feb
50009.71,2.0,92,2,3,1,6,0xb2d1b2df
2469.67,1.0,92,1,2,1,4,0xb2d2fc1ad
152094.83,3.0,4,3,4,4,11,0xb2d5ce8b
50006.92,3.0,185,2,4,1,7,0xb2d6a3a5
60001.62,3.0,193,3,4,1,8,0xb2d5922f
305280.18,3.0,6,4,4,3,11,0xb2d67eaf
1337.78,1.0,10,1,2,3,6,0xb2d61b29
50012.41,2.0,179,2,3,1,6,0xb2d58f49
71.49,1.0,82,1,2,1,4,0xb2d42772d
2178.74,3.0,70,1,4,1,6,0xb2d48fb1d
19.67,1.0,49,1,2,2,5,0xb2d38e50
20299.79,2.0,20,2,3,2,7,0xb2d0e86ed
50532.22,1.0,11,2,2,3,7,0xb2d62b81d
331.38,2.0,7,1,3,3,7,0xb2d0ae97
220100.72,2.0,73,3,3,1,7,0xb2d11063
150011.32,3.0,20,3,4,2,9,0xb2d6431a
353106.95,2.0,4,4,3,4,11,0xb2d57c47d
12933.1,1.0,92,2,2,1,5,0x3b9b35b1
100004.22,2.0,69,3,3,1,7,0xb2d8e81d
150573.47,4.0,1,3,4,4,11,0xb2d59f8b
501001.86,4.0,12,4,4,3,11,0xb2d91e4f
1280068.07,3.0,20,4,4,2,10,0xb2d63299
35305.81,3.0,14,2,4,3,9,0xb2d69365
1270.06,1.0,5,1,2,3,6,0xb2d8239f
17962.98,1.0,8,2,2,3,7,0xb2d2845f
40000.53,3.0,39,2,4,2,8,0xb2d953efd
327.89,1.0,1,1,2,4,7,0xb2d62d49
500101.68,4.0,53,4,4,2,10,0xb2d070ca
23020.36,1.0,0,2,2,4,8,0xb2d696bd
201.2,1.0,32,1,2,2,5,0xb2d33cb0d
532.75,2.0,104,1,3,1,5,0x3b9b2b04
550005.81,2.0,49,4,3,2,9,0xb2d9d88b
1251427.05,10.0,0,4,4,4,12,0xb2d1a93d
357690.65,5.0,42,4,4,2,10,0xb2d560cc
362894.81,2.0,65,4,3,2,9,0xb2d8f5e1
41367.01,3.0,11,2,4,3,9,0xb2d38775
1137.63,1.0,0,1,2,4,7,0xb2d4cb3d
1.27,1.0,41,1,2,2,5,0xb2d60ae8d
532188.0,2.0,286,4,3,1,8,0xb2d16eca
1.32,1.0,3,1,2,4,7,0xb2d5572d
5604.33,1.0,15,2,2,3,7,0xb2d55bed
14484.84,1.0,92,2,2,1,5,0xb2d3e474
201614.8,3.0,3,3,4,4,11,0xb2d5fce8d
81910.8,2.0,143,3,3,1,7,0xb2d5d056d
28285.86,1.0,0,2,2,4,8,0xb2d95aefd
364.6,1.0,24,1,2,2,5,0xb2d6a996
540000.89,3.0,16,4,4,2,10,0xb2d91a5f
5814.82,1.0,92,2,2,1,5,0xb2d1d888
15204.49,1.0,184,2,2,1,5,0xb2d511ca
4518.5,1.0,9,2,2,3,7,0xb2d509ec
860877.93,7.0,3,4,4,4,12,0xb2d1aa02
43424.0,1.0,116,2,2,1,5,0xb2d5a063
60000.63,2.0,69,3,3,1,7,0xb2d8ead7d
21985.61,1.0,10,2,2,3,7,0xb2d92171
73409.99,1.0,13,3,2,3,8,0xb2d350e8d
995296.07,5.0,49,4,4,2,10,0xb2d42e08
51272.55,2.0,21,2,3,2,7,0xb2d64827
3781.13,1.0,178,2,2,1,5,0xb2d208e3
100000.0,1.0,3,3,2,4,9,0xb2d97148d
150076.5,2.0,189,3,3,1,7,0xb2d282a0
1014.09,1.0,92,1,2,1,4,0xb2d1327f
1502.76,1.0,13,1,2,3,6,0xb2d1464a
262291.24,2.0,9,3,3,3,9,0xb2d61885
225.59,1.0,3,1,2,4,7,0xb2d2bad1
40158.15,1.0,184,2,2,1,5,0xb2d613f5d
1.28,1.0,2,1,2,4,7,0xb2d68b2f
570075.58,2.0,96,4,3,1,8,0xb2d25be3
7557.57,1.0,0,2,2,4,8,0xb2d6bcdf
20000.21,2.0,83,2,3,1,6,0xb2d84433
500076.41,3.0,9,4,4,3,11,0xb2d4fefc
361194.3,2.0,0,4,3,4,11,0xb2d6ef1b
14054.0,1.0,1,2,2,4,8,0xb2d93832
2012.06,1.0,18,1,2,2,5,0xb2d2e3b0
5865.05,1.0,0,2,2,4,8,0xb2d6d72c
575087.02,4.0,0,4,4,4,12,0xb2d6054fd
1844000.0,22.0,0,4,4,4,12,0xb2d1f8dcd
1499000.0,17.0,0,4,4,4,12,0xb2d5e37e
850132.77,4.0,11,4,4,3,11,0xb2d26349
130575.23,1.0,0,3,2,4,9,0xb2d65c73
2597.25,1.0,184,1,2,1,4,0xb2d36750
1103.88,2.0,119,1,3,1,5,0xb2d06b4dd
480314.2,4.0,25,4,4,2,10,0xb2d8ea66
1694706.81,19.0,0,4,4,4,12,0x3b9b125c
3298.85,1.0,184,2,2,1,5,0xb2d3c471
337187.4,10.0,14,4,4,3,11,0x3b9b4370
520.49,1.0,14,1,2,3,6,0xb2d6083f
550073.13,6.0,7,4,4,3,11,0xb2d0c4cdd
1995.43,1.0,0,1,2,4,7,0xb2d58bf1
362001.55,4.0,18,4,4,2,10,0xb2d2914ad
230010.42,5.0,97,3,4,1,8,0xb2d43de9d
201830.59,3.0,48,3,4,2,9,0xb2d17892
1805501.63,8.0,7,4,4,3,11,0xb2d352d1
1083000.08,10.0,0,4,4,4,12,0xb2d310d0
936.75,1.0,0,1,2,4,7,0xb2d28559
30000.32,2.0,182,2,3,1,6,0xb2d8c3a2d
3736.26,1.0,29,2,2,2,6,0xb2d92253
103.71,2.0,0,1,3,4,8,0xb2d0e37e
1056.27,1.0,92,1,2,1,4,0xb2d13fbcd
441000.0,7.0,10,4,4,3,11,0xb2d6d043
11111.28,1.0,22,2,2,2,6,0xb2d4326f
50148.66,2.0,0,2,3,4,9,0xb2d2d365
8917.17,1.0,12,2,2,3,7,0xb2d578ee
250038.21,1.0,12,3,2,3,8,0xb2d9e3cb
63773.79,2.0,95,3,3,1,7,0xb2d4da08d
10176.43,2.0,92,2,3,1,6,0xb2d558e5d
4725414.57,2.0,27,4,3,2,9,0xb2d0cfa9d
231.64,1.0,32,1,2,2,5,0xb2d1c89e
130023.5,2.0,171,3,3,1,7,0xb2d8c465d
191990.78,4.0,0,3,4,4,11,0xb2d3ccd5
525.67,1.0,5,1,2,3,6,0xb2d2e188
850704.42,1.0,75,4,2,1,7,0xb2d1d021
276749.99,9.0,1,3,4,4,11,0xb2d1697c
200168.31,1.0,8,3,2,3,8,0xb2d29b73
226.26,1.0,17,1,2,2,5,0xb2d21c7e
180.24,1.0,4,1,2,4,7,0xb2d60956
163.42,2.0,117,1,3,1,5,0xb2d0955ad
478.98,1.0,0,1,2,4,7,0xb2d51b8a
820405.98,5.0,1,4,4,4,12,0xb2d43394
10000.64,2.0,92,2,3,1,6,0xb2d5a691
81338.73,5.0,0,3,4,4,11,0xb2d095c8
51001.62,2.0,59,2,3,2,7,0xb2d8ed02d
630022.23,4.0,18,4,4,2,10,0xb2d5ef6e
21024.95,1.0,49,2,2,2,6,0xb2d3ce72
500000.1,2.0,3,4,3,4,11,0xb2d9b663
45281.29,4.0,0,2,4,4,10,0xb2d5e76dd
100026.14,2.0,34,3,3,2,8,0xb2d58474
132545.38,1.0,0,3,2,4,9,0xb2d5f1f9
11.17,1.0,42,1,2,2,5,0xb2d20090
240571.06,3.0,200,3,4,1,8,0xb2d46e59
667.3,3.0,0,1,4,4,9,0xb2d09b9f
3936.15,3.0,0,2,4,4,10,0xb2d2d97a
50006.82,2.0,42,2,3,2,7,0xb2d25c7c
236701.89,3.0,18,3,4,2,9,0xb2d2db47
991.48,1.0,10,1,2,3,6,0xb2d7c145d
207359.82,2.0,97,3,3,1,7,0xb2d6417a
0.0,1.0,0,1,2,4,7,0xb2d68434
87151.96,4.0,27,3,4,2,9,0xb2d26d78
2232.06,1.0,184,1,2,1,4,0xb2d1488b
320047.37,4.0,11,4,4,3,11,0xb2d62704d
377.49,1.0,26,1,2,2,5,0xb2d2ae97
20016.18,2.0,42,2,3,2,7,0xb2d9b984
121151.48,2.0,8,3,3,3,9,0xb2d8e0ad
183008.54,4.0,4,3,4,4,11,0xb2d28971
1298.02,1.0,125,1,2,1,4,0xb2d257bad
213243.69,5.0,0,3,4,4,11,0x3b9af263
345190.03,3.0,52,4,4,2,10,0xb2d3786f
110010.72,5.0,0,3,4,4,11,0xb2d6d324
3411715.47,11.0,0,4,4,4,12,0x3b9b252d
665.55,1.0,10,1,2,3,6,0xb2d69f19
80002.85,3.0,42,3,4,2,9,0xb2d9ab4e
4328.3,1.0,92,2,2,1,5,0x3b9b2a37d
1478.7,1.0,184,1,2,1,4,0xb2d40853
437452.42,8.0,80,4,4,1,9,0xb2d105f0
39590.47,3.0,0,2,4,4,10,0xb2d9d847
100005.28,2.0,97,3,3,1,7,0xb2d8243c
590220.83,8.0,8,4,4,3,11,0xb2d1613ad
500029.3,2.0,256,4,3,1,8,0xb2d3adc2
100073.92,9.0,154,3,4,1,8,0xb2d1293c
60008.33,2.0,18,3,3,2,8,0xb2d63a5dd
330135.71,3.0,4,4,4,4,12,0xb2d1743e
7087.41,1.0,9,2,2,3,7,0xb2d3f219
69.49,1.0,0,1,2,4,7,0xb2d1be26
10.59,1.0,23,1,2,2,5,0x3b9b39d2
10000000.0,1.0,0,4,2,4,10,0xb2d9c50e
53.83,1.0,9,1,2,3,6,0xb2d6d8e5
400200.54,2.0,18,4,3,2,9,0xb2d645f2
602882.39,4.0,34,4,4,2,10,0xb2d25952
9.19,1.0,8,1,2,3,6,0xb2d2e0e6
495.02,1.0,84,1,2,1,4,0xb2d3d05e
180005.07,2.0,55,3,3,2,8,0xb2d8ffee
300003.17,2.0,53,3,3,2,8,0xb2d9cfce
511.06,2.0,184,1,3,1,5,0xb2d3cd18d
150003.55,3.0,21,3,4,2,9,0xb2d2ecab
130039.8,3.0,3,3,4,4,11,0xb2d5cc36
101025.18,4.0,13,3,4,3,10,0xb2d5fde3
1342863.16,6.0,4,4,4,4,12,0xb2d6e1f3d
10010.98,1.0,114,2,2,1,5,0xb2d918a1
16302.1,1.0,15,2,2,3,7,0xb2d2d30e
269609.72,4.0,6,3,4,3,10,0xb2d296ac
198.34,1.0,49,1,2,2,5,0xb2d48903
26969.45,2.0,116,2,3,1,6,0xb2d4b461
1.01,1.0,67,1,2,1,4,0xb2d642f4
121000.11,2.0,4,3,3,4,10,0xb2d948fb
3283008.11,23.0,0,4,4,4,12,0xb2d12047
50002.57,2.0,189,2,3,1,6,0xb2d47de4
103510.04,2.0,18,3,3,2,8,0xb2d32dead
810000.0,2.0,3,4,3,4,11,0xb2d96599d
441.28,1.0,10,1,2,3,6,0xb2d5fcec
1143.64,2.0,184,1,3,1,5,0xb2d08efa
2980075.29,4.0,91,4,4,1,9,0xb2d434c7d
33289.84,1.0,13,2,2,3,7,0xb2d13002
32051.51,5.0,2,2,4,4,10,0xb2d4f7c3d
22005.42,1.0,10,2,2,3,7,0xb2d6f597d
103826.4,1.0,5,3,2,3,8,0xb2d78d08
203556.09,2.0,28,3,3,2,8,0xb2d6b792
28790.52,1.0,141,2,2,1,5,0xb2d5cf49d
2969937.62,6.0,43,4,4,2,10,0xb2d112a9
1089.99,1.0,0,1,2,4,7,0xb2d1db5a
523.5,1.0,10,1,2,3,6,0xb2d6e3d0
741764.5,11.0,0,4,4,4,12,0xb2d06745d
11853.81,1.0,11,2,2,3,7,0xb2d6b7ed
50400.0,5.0,0,2,4,4,10,0xb2d07863
3070299.03,1.0,45,4,2,2,8,0xb2d25758d
23331.0,6.0,0,2,4,4,10,0xb2d19f14d
55028.25,2.0,161,3,3,1,7,0xb2d106bfd
6699.96,2.0,184,2,3,1,6,0xb2d1a47b
5873.63,1.0,14,2,2,3,7,0xb2d31975d
4501.0,1.0,14,2,2,3,7,0xb2d9d06b
92520.37,2.0,14,3,3,3,9,0xb2d2054b
507122.99,3.0,28,4,4,2,10,0xb2d30a0fd
4896.65,1.0,0,2,2,4,8,0xb2d6a6e1
2993.47,1.0,4,2,2,4,8,0xb2d97ef3
561989.44,3.0,50,4,4,2,10,0xb2d9d772
34.15,1.0,116,1,2,1,4,0xb2d2a66bd
200000.0,1.0,0,3,2,4,9,0xb2d98437
214946.13,2.0,13,3,3,3,9,0xb2d6a5c8d
4235.78,1.0,99,2,2,1,5,0xb2d5f1dbd
2432.62,1.0,0,1,2,4,7,0xb2d21b2d
3802.22,1.0,4,2,2,4,8,0xb2d5919d
8.24,1.0,103,1,2,1,4,0xb2d136c2d
4023.48,1.0,10,2,2,3,7,0xb2d4fdc2d
470000.0,4.0,5,4,4,3,11,0xb2d146b7
3.44,1.0,25,1,2,2,5,0xb2d557ded
1000000.49,4.0,1,4,4,4,12,0xb2d55ebad
750108.44,5.0,56,4,4,2,10,0xb2d2b37ad
376629.1,7.0,11,4,4,3,11,0xb2d62ec8d
133074.21,3.0,126,3,4,1,8,0xb2d48427
9130099.85,2.0,131,4,3,1,8,0xb2d8ffe3
1300338.72,2.0,7,4,3,3,10,0xb2d27665
852315.09,3.0,0,4,4,4,12,0xb2d959fad
12970.65,1.0,2,2,2,4,8,0xb2d91d6f
1343007.68,8.0,0,4,4,4,12,0xb2d06436d
29160.18,3.0,12,2,4,3,9,0xb2d600a1
355094.46,3.0,20,4,4,2,10,0xb2d51795
1458151.21,9.0,1,4,4,4,12,0x3b9b396d
1664.88,1.0,184,1,2,1,4,0xb2d2295c
4000043.47,2.0,18,4,3,2,9,0xb2d78c14
11678.23,1.0,20,2,2,2,6,0xb2d8c85f
250025.11,2.0,5,3,3,3,9,0xb2d9b7fe
200000.0,2.0,1,3,3,4,10,0xb2da5f56
1.28,1.0,67,1,2,1,4,0xb2d99ac8
1225.87,1.0,9,1,2,3,6,0xb2d2786ed
4377.97,1.0,184,2,2,1,5,0xb2d0dca2
300025.18,2.0,1,3,3,4,10,0xb2d65222d
2105.09,1.0,0,1,2,4,7,0xb2d16980
51235.54,3.0,124,2,4,1,7,0xb2d57518d
10643.29,1.0,2,2,2,4,8,0xb2d5522a
9859.5,1.0,12,2,2,3,7,0xb2d937e3
763006.25,8.0,8,4,4,3,11,0xb2d594aa
404747.96,20.0,32,4,4,2,10,0xb2d0a6c9d
31.05,1.0,42,1,2,2,5,0xb2d1d862
2550000.98,5.0,2,4,4,4,12,0xb2d43c09
1888.48,1.0,0,1,2,4,7,0xb2d3e974
1939.91,1.0,8,1,2,3,6,0xb2d6ce8dd
150003.17,2.0,53,3,3,2,8,0xb2d9cdfe
486.43,1.0,1,1,2,4,7,0xb2d14580
50.47,1.0,207,1,2,1,4,0xb2d2f6ca
634.69,1.0,1,1,2,4,7,0xb2d2a867
10054.56,2.0,49,2,3,2,7,0xb2d8dcb3
270049.91,2.0,164,3,3,1,7,0xb2d50381
29045.88,1.0,144,2,2,1,5,0xb2d570d0
5010.62,1.0,0,2,2,4,8,0xb2d6ef59
0.0,1.0,33,1,2,2,5,0xb2d8f329
6797.41,1.0,4,2,2,4,8,0xb2d606ec
481708.45,2.0,19,4,3,2,9,0xb2d8efe5
1297.04,1.0,74,1,2,1,4,0xb2d61e5a
30000.63,2.0,18,2,3,2,7,0xb2d18841
165.41,2.0,6,1,3,3,7,0xb2d23bfc
3635.88,1.0,92,2,2,1,5,0xb2d2ed24
4150.83,1.0,0,2,2,4,8,0xb2d3473c
70000.74,2.0,92,3,3,1,7,0xb2d640b1
200007.64,2.0,210,3,3,1,7,0xb2d51bf1
34.22,1.0,20,1,2,2,5,0xb2d992c9
11662.86,1.0,92,2,2,1,5,0xb2d1caa4
125.15,1.0,26,1,2,2,5,0xb2d1ef63d
130649.61,1.0,0,3,2,4,9,0xb2d488a9d
1800.09,1.0,51,1,2,2,5,0xb2d6026dd
1671.2,1.0,0,1,2,4,7,0xb2d3231e
7021.2,1.0,3,2,2,4,8,0xb2d27c51
301176.77,3.0,24,4,4,2,10,0xb2d3ac2e
505361.53,6.0,3,4,4,4,12,0x3b9af10d
42354.57,1.0,18,2,2,2,6,0xb2d6e5b0d
1633.4,1.0,0,1,2,4,7,0xb2d394c9
38.76,1.0,14,1,2,3,6,0xb2d94042d
120376.82,6.0,4,3,4,4,11,0xb2d1ced7d
182.56,1.0,4,1,2,4,7,0xb2d6455ad
7.39,1.0,74,1,2,1,4,0xb2d9968e
9.53,1.0,32,1,2,2,5,0xb2d510ae
15573.04,1.0,28,2,2,2,6,0xb2d31930d
98.9,2.0,35,1,3,2,6,0xb2d08db2
326378.92,3.0,0,4,4,4,12,0xb2d2405d
253029.33,2.0,144,3,3,1,7,0xb2d6d70fd
322273.8,2.0,75,4,3,1,8,0xb2d995ff
15003.86,2.0,10,2,3,3,8,0xb2d68b2fd
291.6,1.0,26,1,2,2,5,0xb2d5a008
500015.42,4.0,18,4,4,2,10,0xb2d8f8de
40441.45,1.0,18,2,2,2,6,0xb2d2860f
643.47,1.0,14,1,2,3,6,0xb2d2e6d8
113218.97,3.0,122,3,4,1,8,0xb2d11fcdd
1955.09,1.0,1,1,2,4,7,0xb2d6edd2d
130045.51,3.0,57,3,4,2,9,0xb2d63696d
2061.22,1.0,92,1,2,1,4,0xb2d2cded
35982.77,1.0,10,2,2,3,7,0xb2d62440
15058.41,1.0,3,2,2,4,8,0xb2d4231a
26827.86,1.0,0,2,2,4,8,0xb2d369ae
81352.88,2.0,125,3,3,1,7,0xb2d410bed
506086.2,2.0,39,4,3,2,9,0xb2d90cd9
152468.12,1.0,7,3,2,3,8,0xb2d28720
14.31,1.0,0,1,2,4,7,0xb2d2502dd
2.08,1.0,46,1,2,2,5,0xb2d4be7c
340027.65,3.0,48,4,4,2,10,0xb2d6c55e
10603.94,1.0,0,2,2,4,8,0xb2d178d6
569.72,1.0,10,1,2,3,6,0xb2d99120
900179.44,1.0,1,4,2,4,10,0xb2d75f9fd
6.86,1.0,35,1,2,2,5,0xb2d9df67
6118.64,1.0,0,2,2,4,8,0xb2d9dbee
136054.17,2.0,90,3,3,1,7,0xb2d6ca87
24493.75,1.0,8,2,2,3,7,0xb2d351fad
252502.57,2.0,2,3,3,4,10,0xb2d9702b
470624.6,3.0,41,4,4,2,10,0xb2d16ee5
585190.97,3.0,21,4,4,2,10,0xb2d6384b
50681.61,2.0,129,2,3,1,6,0xb2d6159a
580046.12,6.0,8,4,4,3,11,0xb2d5c73ed
581827.03,5.0,1,4,4,4,12,0xb2d21c28
407520.91,4.0,73,4,4,1,9,0xb2d0c914d
390550.48,5.0,19,4,4,2,10,0xb2d1992dd
104015.33,2.0,231,3,3,1,7,0xb2d3a83e
320047.83,3.0,2,4,4,4,12,0xb2d1be47
4872.11,1.0,184,2,2,1,5,0xb2d1f83dd
400002.7,3.0,8,4,4,3,11,0x3b9b46c0d
1260000.26,7.0,0,4,4,4,12,0xb2d5dbefd
6804.12,2.0,102,2,3,1,6,0xb2d27410
20859.24,1.0,0,2,2,4,8,0xb2d535d1d
3041.57,1.0,184,2,2,1,5,0xb2d19c05d
74867.57,3.0,4,3,4,4,11,0xb2d70047
15050.42,2.0,66,2,3,2,7,0xb2d46ec1
500000.0,2.0,0,4,3,4,11,0xb2d97d0e
4.92,1.0,10,1,2,3,6,0xb2d6bfad
114153.94,2.0,125,3,3,1,7,0xb2d38c06
300000.56,2.0,1,3,3,4,10,0xb2d69ca9
5567112.43,3.0,1,4,4,4,12,0xb2d8edecd
97.55,1.0,13,1,2,3,6,0xb2d4fd2d
301250.68,4.0,5,4,4,3,11,0xb2d26d7e
2.18,1.0,63,1,2,2,5,0xb2d78278
221047.02,6.0,19,3,4,2,9,0xb2d4b2c7d
37048.39,1.0,46,2,2,2,6,0xb2d6c4a3
2.43,1.0,77,1,2,1,4,0xb2d82262
261.87,1.0,3,1,2,4,7,0xb2d2c19dd
8.92,1.0,61,1,2,2,5,0xb2d5b6fb
112855.39,2.0,0,3,3,4,10,0xb2d3cbd3
0.0,1.0,1,1,2,4,7,0xb2d96f07
23585.58,1.0,10,2,2,3,7,0xb2d37af8
3081809.31,3.0,11,4,4,3,11,0xb2d6e1c2
180003.8,3.0,18,3,4,2,9,0xb2d69939
183791.57,4.0,0,3,4,4,11,0xb2d59195d
1244.06,1.0,1,1,2,4,7,0xb2d50ae6
100697.7,1.0,92,3,2,1,6,0xb2d368b2
302722.7,2.0,108,4,3,1,8,0xb2d416c5
432337.32,2.0,157,4,3,1,8,0xb2d337d2
160011.11,2.0,214,3,3,1,7,0xb2d578c8
330928.68,4.0,46,4,4,2,10,0xb2d90b17
800023.55,16.0,0,4,4,4,12,0x3b9af2a2
402844.66,3.0,18,4,4,2,10,0xb2d8c3fb
500010.06,1.0,0,4,2,4,10,0xb2da69d4
1599009.08,8.0,1,4,4,4,12,0x3b9b1bded
266287.9,4.0,4,3,4,4,11,0xb2d178f4
469016.18,6.0,0,4,4,4,12,0xb2d8ee52d
880040.67,6.0,82,4,4,1,9,0xb2d593ec
26645.11,1.0,2,2,2,4,8,0xb2d627d4
401839.12,3.0,49,4,4,2,10,0xb2d170f8d
976.44,1.0,0,1,2,4,7,0xb2d583c5d
7607.73,1.0,6,2,2,3,7,0xb2d98181
448234.96,4.0,105,4,4,1,9,0xb2d56797
50000.0,2.0,0,2,3,4,9,0xb2d20fc8
100002.11,2.0,10,3,3,3,9,0xb2d963a0
138403.66,2.0,4,3,3,4,10,0xb2d22c76d
50150.87,1.0,0,2,2,4,8,0xb2d14e1c
860100.8,4.0,14,4,4,3,11,0xb2d94e3a
810000.0,5.0,0,4,4,4,12,0xb2d4c9ce
30000.0,4.0,4,2,4,4,10,0xb2d1326b
46758.96,1.0,0,2,2,4,8,0xb2d54e9d
26330.01,1.0,22,2,2,2,6,0xb2d4707b
131006.09,3.0,3,3,4,4,11,0xb2d227fb
514.67,1.0,9,1,2,3,6,0xb2d28949
60.5,1.0,92,1,2,1,4,0xb2d28a22
12794.15,1.0,1,2,2,4,8,0xb2d691f3
18.87,1.0,6,1,2,3,6,0xb2d7ee32
181505.75,1.0,10,3,2,3,8,0xb2d9198c
420896.86,4.0,19,4,4,2,10,0xb2d415e4
6.61,1.0,67,1,2,1,4,0xb2d434c1
10057.82,1.0,3,2,2,4,8,0xb2d6ede4
111503.79,1.0,92,3,2,1,6,0xb2d08f7e
400094.35,5.0,18,4,4,2,10,0xb2d339a2d
350548.44,3.0,3,4,4,4,12,0xb2d67f08d
228256.67,6.0,8,3,4,3,10,0xb2d51ba2
170005.8,2.0,31,3,3,2,8,0xb2d93364
20223.12,2.0,110,2,3,1,6,0xb2d60849d
0.81,1.0,2,1,2,4,7,0xb2d6f204
210020.86,4.0,4,3,4,4,11,0xb2d59c4d
300003.17,2.0,74,3,3,1,7,0xb2d99f7e
27600.01,2.0,0,2,3,4,9,0xb2d0d9d7
5128.88,1.0,92,2,2,1,5,0xb2d25894d
101170.98,2.0,53,3,3,2,8,0xb2d0b794d
69096.39,3.0,0,3,4,4,11,0x3b9b46ae
7084.32,1.0,11,2,2,3,7,0xb2d39581
1889000.0,4.0,0,4,4,4,12,0xb2d5d829
114847.26,1.0,3,3,2,4,9,0xb2d5a909
120426.99,3.0,80,3,4,1,8,0xb2d0749b
1059.99,1.0,184,1,2,1,4,0xb2d34cd7
280776.97,5.0,103,3,4,1,8,0xb2d07a45
311865.11,3.0,3,4,4,4,12,0xb2d52ef5d
213.87,1.0,0,1,2,4,7,0xb2d21281
117002.45,3.0,25,3,4,2,9,0xb2d5b8cc
103321.2,2.0,193,3,3,1,7,0xb2d18de3d
112.51,1.0,19,1,2,2,5,0xb2d93612
5890.44,1.0,15,2,2,3,7,0xb2d9b447
30000.63,2.0,228,2,3,1,6,0xb2d6f467
220003.5,2.0,123,3,3,1,7,0xb2d62bf7
30041.97,2.0,116,2,3,1,6,0xb2d69cf1
1538.46,1.0,239,1,2,1,4,0xb2d548c5
120007.29,3.0,0,3,4,4,11,0xb2d93e5f
111.86,1.0,13,1,2,3,6,0xb2d2e9f9
436510.87,3.0,52,4,4,2,10,0xb2d5df02
90493.41,8.0,0,3,4,4,11,0x3b9b3853d
33346.96,1.0,92,2,2,1,5,0xb2d1cae5
279786.92,6.0,48,3,4,2,9,0xb2d093b4
2306.18,1.0,105,1,2,1,4,0xb2d6ba30
200057.6,2.0,120,3,3,1,7,0xb2d62e1dd
10459.68,1.0,10,2,2,3,7,0xb2d0cc15
7.39,1.0,66,1,2,2,5,0xb2d8ccd6
90097.41,1.0,4,3,2,4,9,0xb2d62da7
4208.24,5.0,7,2,4,3,9,0x3b9af467d
761613.16,2.0,24,4,3,2,9,0xb2d168fb
1955.99,1.0,184,1,2,1,4,0xb2d2d9ccd
200076.8,4.0,87,3,4,1,8,0xb2d5f163
485200.75,8.0,14,4,4,3,11,0xb2d425f1
100002.11,2.0,52,3,3,2,8,0xb2d90b57
44.33,1.0,90,1,2,1,4,0xb2d62c81
1187.35,1.0,143,1,2,1,4,0xb2d63851
24229.67,1.0,3,2,2,4,8,0xb2d3959e
6802.07,3.0,92,2,4,1,7,0x3b9b3d7fd
62098.25,3.0,228,3,4,1,8,0x3b9b2c06d
703.15,1.0,12,1,2,3,6,0xb2d69a0a
755.97,1.0,1,1,2,4,7,0xb2d29cda
10331.3,1.0,208,2,2,1,5,0xb2d238b3d
50002.54,2.0,92,2,3,1,6,0xb2d5d978
10115.03,2.0,63,2,3,2,7,0xb2d8e2e6d
368000.0,3.0,6,4,4,3,11,0xb2d8d385
261.87,1.0,4,1,2,4,7,0xb2d3756f
20047.84,1.0,184,2,2,1,5,0x3b9b2d05
227.08,1.0,52,1,2,2,5,0xb2d2a696
2893.57,1.0,15,2,2,3,7,0xb2d2ffab
2.19,1.0,55,1,2,2,5,0xb2d3a6df
17522.97,1.0,18,2,2,2,6,0xb2d2189f
644064.81,3.0,0,4,4,4,12,0xb2d4da82
50009.5,1.0,0,2,2,4,8,0xb2d8d5b8d
226802.22,19.0,0,3,4,4,11,0x3b9b44f1
169.74,1.0,88,1,2,1,4,0xb2d64abe
550000.0,9.0,18,4,4,2,10,0xb2d33295d
0.0,1.0,9,1,2,3,6,0xb2d614ce
501043.61,3.0,231,4,4,1,9,0xb2d28283
200226.2,1.0,68,3,2,1,6,0xb2d28e4c
206099.44,4.0,49,3,4,2,9,0xb2d4101bd
254475.17,7.0,80,3,4,1,8,0xb2d22d2c
50197.93,2.0,90,2,3,1,6,0xb2d64242d
31248.08,1.0,11,2,2,3,7,0xb2d6125e
200789.44,6.0,7,3,4,3,10,0xb2d4da6f
38619.22,1.0,14,2,2,3,7,0xb2d5d5bcd
41292.34,2.0,0,2,3,4,9,0xb2d2a5b1
1250007.17,7.0,70,4,4,1,9,0xb2d1e64c
1007.38,1.0,184,1,2,1,4,0xb2d2edcd
180101.64,3.0,6,3,4,3,10,0xb2d2ab76
120007.62,2.0,92,3,3,1,7,0xb2d63ba5
45036.01,1.0,0,2,2,4,8,0xb2d518eb
11230.77,1.0,92,2,2,1,5,0xb2d3cbb6
2704.53,1.0,0,1,2,4,7,0xb2d6b632d
10002.85,2.0,26,2,3,2,7,0xb2d8d061
364854.06,4.0,0,4,4,4,12,0xb2d12753
100166.37,2.0,14,3,3,3,9,0xb2d59c9f
60045.31,2.0,90,3,3,1,7,0xb2d2b6fd
101359530.67,4.0,0,4,4,4,12,0xb2d6b37cd
37780.97,1.0,0,2,2,4,8,0xb2d0b468
501776.04,2.0,31,4,3,2,9,0xb2d93f51
794348.3,2.0,106,4,3,1,8,0x3b9b335a
819.64,1.0,43,1,2,2,5,0xb2d2fa6cd
0.04,1.0,5,1,2,3,6,0xb2d5e360
1022763.69,4.0,2,4,4,4,12,0xb2d5d986
81953.09,4.0,0,3,4,4,11,0xb2d41aef
471.16,1.0,10,1,2,3,6,0xb2d3cc0cd
21032.44,1.0,0,2,2,4,8,0xb2d0ad94
500006.06,2.0,11,4,3,3,10,0xb2d9e2cb
852553.96,29.0,1,4,4,4,12,0xb2d122bf
350075.6,3.0,0,4,4,4,12,0xb2d6349d
1327727.76,2.0,37,4,3,2,9,0xb2d6a893
5502.05,1.0,40,2,2,2,6,0xb2d8cba5
10604.44,1.0,0,2,2,4,8,0xb2d68d19
10000.22,2.0,81,2,3,1,6,0xb2d5b4c3
91679.79,4.0,80,3,4,1,8,0xb2d567dc
1012.34,1.0,184,1,2,1,4,0xb2d1c417d
160856.76,1.0,194,3,2,1,6,0xb2d415ebd
117000.0,3.0,3,3,4,4,11,0xb2d06a9b
1115.1,1.0,184,1,2,1,4,0xb2d1db30d
640300.02,3.0,1,4,4,4,12,0xb2d41053
101989.35,3.0,63,3,4,2,9,0xb2d62c0b
70168.59,2.0,72,3,3,1,7,0xb2d695c7
52.11,1.0,33,1,2,2,5,0xb2d5f367
40224.0,2.0,161,2,3,1,6,0xb2d61114
13991.16,1.0,46,2,2,2,6,0xb2d319d8
1129.06,1.0,212,1,2,1,4,0xb2d340d2
603366.31,5.0,0,4,4,4,12,0xb2d2e14b
1350.39,1.0,250,1,2,1,4,0xb2d3ef8d
57699.66,1.0,12,3,2,3,8,0xb2d576dbd
15000.79,2.0,70,2,3,1,6,0xb2d9a0c0
200000.67,2.0,2,3,3,4,10,0xb2d65311
330003.48,2.0,55,4,3,2,9,0xb2d90523
1987255.77,1.0,13,4,2,3,9,0xb2d2fed8
479170.24,5.0,14,4,4,3,11,0xb2d30d73d
25479.11,1.0,12,2,2,3,7,0xb2d41fd5d
1991000.0,20.0,4,4,4,4,12,0xb2d41355d
30001.95,2.0,88,2,3,1,6,0xb2d97cd7d
1018.88,1.0,92,1,2,1,4,0xb2d37268
49.86,1.0,3,1,2,4,7,0xb2d1e122
360131.67,2.0,122,4,3,1,8,0xb2d3900d
886.92,1.0,3,1,2,4,7,0xb2d2bb16d
170001.92,4.0,42,3,4,2,9,0xb2d6ec62
376198.74,6.0,0,4,4,4,12,0xb2d0daa4
224693.3,2.0,25,3,3,2,8,0xb2d68cc5d
13396.79,1.0,0,2,2,4,8,0xb2d6b0f7d
674026.02,4.0,1,4,4,4,12,0xb2d5fe52
13724.59,1.0,9,2,2,3,7,0xb2d62440d
2863.62,3.0,0,1,4,4,9,0xb2d09a7c
0.0,1.0,1,1,2,4,7,0xb2da548f
1030.19,1.0,184,1,2,1,4,0xb2d33b01
509.78,1.0,55,1,2,2,5,0xb2d5b86a
4253.41,1.0,2,2,2,4,8,0xb2d156a3
1.14,1.0,8,1,2,3,6,0xb2d4db2e
100584.18,3.0,59,3,4,2,9,0xb2d6c510
651048.74,9.0,0,4,4,4,12,0xb2d5a73c
200017.74,3.0,74,3,4,1,8,0xb2d64696d
895171.09,4.0,0,4,4,4,12,0xb2d594fc
40685.66,1.0,1,2,2,4,8,0xb2d6cf4c
4308.19,1.0,0,2,2,4,8,0xb2d6e7ed
500075.57,3.0,45,4,4,2,10,0xb2d1426bd
260020.63,18.0,27,3,4,2,9,0xb2d5acac
71195.56,2.0,90,3,3,1,7,0xb2d62383
205031.89,4.0,97,3,4,1,8,0xb2d3eae8
50002.64,1.0,14,2,2,3,7,0xb2d94fe7
16.52,1.0,19,1,2,2,5,0xb2d42866
860.08,1.0,8,1,2,3,6,0xb2d1f9c7
1322.46,1.0,0,1,2,4,7,0xb2d995c9
93330.42,1.0,20,3,2,2,7,0xb2d34c15d
10046.41,2.0,11,2,3,3,8,0xb2d0b746
601065.76,3.0,5,4,4,3,11,0xb2d8f1fb
6173.46,1.0,45,2,2,2,6,0xb2d4d102d
50001.58,2.0,92,2,3,1,6,0xb2d97db2
4697.54,1.0,101,2,2,1,5,0xb2d6129b
153263.89,2.0,92,3,3,1,7,0xb2d62cc1
15291.91,1.0,0,2,2,4,8,0xb2d693df
46.07,1.0,10,1,2,3,6,0xb2d8ce08d
862141.49,3.0,60,4,4,2,10,0xb2d1b86a
422.15,1.0,13,1,2,3,6,0xb2d91388
550000.56,7.0,14,4,4,3,11,0xb2d52271d
0.0,2.0,3,1,3,4,8,0xb2d6052ed
522479.09,2.0,31,4,3,2,9,0xb2d55502
60001.27,2.0,59,3,3,2,8,0xb2d8fdf1
553204.93,4.0,1,4,4,4,12,0xb2d0cd74
16.35,1.0,43,1,2,2,5,0xb2d96e40
360.06,1.0,24,1,2,2,5,0xb2d23c84
103866.16,2.0,224,3,3,1,7,0xb2d54662
3854.45,3.0,0,2,4,4,10,0xb2d912fb
85011.55,5.0,3,3,4,4,11,0xb2d0a85a
114.38,1.0,6,1,2,3,6,0xb2d34657
80000.83,3.0,1,3,4,4,11,0xb2d56bb7d
1675093.6,5.0,0,4,4,4,12,0xb2d4155cd
270114.74,2.0,26,3,3,2,8,0xb2d6e185
11457.73,1.0,5,2,2,3,7,0xb2d6fe9f
400074.29,2.0,80,4,3,1,8,0xb2d0d183
50915.25,2.0,0,2,3,4,9,0xb2d5dfb1
13698.32,1.0,13,2,2,3,7,0xb2d5d9a3
201028.08,13.0,13,3,4,3,10,0xb2d4d3b2
100000.0,1.0,0,3,2,4,9,0xb2d1a828
765081.99,3.0,7,4,4,3,11,0xb2d5cf41
239.69,1.0,2,1,2,4,7,0xb2d4084d
833069.84,7.0,21,4,4,2,10,0xb2d1963fd
4355.42,1.0,92,2,2,1,5,0xb2d30175d
30064.58,3.0,49,2,4,2,8,0xb2d162fe
103998.0,2.0,14,3,3,3,9,0xb2d31a01d
20330.29,1.0,8,2,2,3,7,0xb2d6a7f5d
8032.33,1.0,9,2,2,3,7,0xb2d8e787
849.44,2.0,92,1,3,1,5,0xb2d118e4
1000912.35,5.0,8,4,4,3,11,0xb2d6d27b
60724.71,2.0,28,3,3,2,8,0xb2d68d6bd
27591.19,1.0,18,2,2,2,6,0xb2d5c478
6669.89,2.0,92,2,3,1,6,0x3b9b2676d
20659.48,2.0,27,2,3,2,7,0xb2d5b5bbd
57.29,1.0,19,1,2,2,5,0xb2d60f91d
2134.99,1.0,0,1,2,4,7,0xb2d144f8
300000.0,2.0,3,3,3,4,10,0xb2d97e1a
100005.28,3.0,27,3,4,2,9,0xb2d9fa29
500052.13,2.0,21,4,3,2,9,0xb2d8d06ad
22026.15,3.0,4,2,4,4,10,0xb2d8d77d
34088.91,2.0,9,2,3,3,8,0xb2d0cfa8
111507.49,2.0,102,3,3,1,7,0xb2d3c4c8
369029.12,3.0,4,4,4,4,12,0xb2d3e81d
30000.0,2.0,3,2,3,4,9,0xb2d59537d
3489.52,1.0,6,2,2,3,7,0xb2d67dea
7521.87,1.0,214,2,2,1,5,0xb2d586d2
1000043.81,3.0,18,4,4,2,10,0xb2d4030e
1.95,1.0,14,1,2,3,6,0xb2d288ba
135626.18,2.0,26,3,3,2,8,0xb2d33597d
70014.01,2.0,20,3,3,2,8,0xb2d116bc
12196.84,1.0,1,2,2,4,8,0xb2d449cb
104385.99,2.0,42,3,3,2,8,0xb2d4f69d
3563.55,1.0,97,2,2,1,5,0xb2d1ddac
600093.72,3.0,1,4,4,4,12,0xb2d57c89
500000.0,2.0,20,4,3,2,9,0xb2d95406d
10363.48,2.0,3,2,3,4,9,0xb2d6140d
17.42,1.0,50,1,2,2,5,0xb2d9992e
4005.63,1.0,26,2,2,2,6,0xb2d42a16
1271426.92,13.0,1,4,4,4,12,0xb2d3fd8e
2380.07,1.0,63,1,2,2,5,0xb2d5ad3c
202843.39,2.0,143,3,3,1,7,0xb2d6edfa
2709298.74,5.0,15,4,4,3,11,0xb2d319d5
67514.07,3.0,0,3,4,4,11,0xb2d6a514
18654.54,1.0,28,2,2,2,6,0xb2d90511
343.87,2.0,2,1,3,4,8,0x3b9b264cd
137334.5,3.0,18,3,4,2,9,0xb2d5f561
340014.12,3.0,44,4,4,2,10,0xb2d2e5a9
1015.11,1.0,92,1,2,1,4,0xb2d5adef
500002.62,2.0,28,4,3,2,9,0xb2d22c35
250050.21,2.0,185,3,3,1,7,0xb2d3d5d2
118436.3,11.0,5,3,4,3,10,0xb2d65bb5
245410.32,1.0,92,3,2,1,6,0x3b9b49a5
3673968.87,3.0,32,4,4,2,10,0xb2d6ab68
39.0,1.0,31,1,2,2,5,0xb2d5e6a1
1003.39,1.0,181,1,2,1,4,0xb2d0ce09
20000.84,2.0,42,2,3,2,7,0xb2d9e575
436.99,1.0,0,1,2,4,7,0xb2d1bbc3
10009.68,1.0,10,2,2,3,7,0xb2d59387d
2126.15,1.0,13,1,2,3,6,0xb2d43770d
1119.7,1.0,56,1,2,2,5,0xb2d8f83c
24522.03,1.0,21,2,2,2,6,0xb2d8c85fd
1505339.27,2.0,31,4,3,2,9,0xb2d9cd38
5822.38,2.0,9,2,3,3,8,0xb2d95ceb
21548.7,1.0,184,2,2,1,5,0xb2d425bfd
4400.07,1.0,11,2,2,3,7,0xb2d8c6b1
257398.12,2.0,28,3,3,2,8,0xb2d68ff1
600710.42,4.0,1,4,4,4,12,0xb2d9c32c
105451.03,1.0,10,3,2,3,8,0xb2d31fdb
359.42,1.0,0,1,2,4,7,0xb2d421b1
74742.72,7.0,0,3,4,4,11,0x3b9b3734d
500000.0,2.0,3,4,3,4,11,0xb2d9605b
1050.02,1.0,92,1,2,1,4,0xb2d21fb4
761723.83,5.0,19,4,4,2,10,0xb2d623c8
362.83,1.0,0,1,2,4,7,0xb2d9208e
244250.46,3.0,0,3,4,4,11,0xb2d631c3
19136.53,1.0,10,2,2,3,7,0xb2d5bfb7
100044.41,2.0,181,3,3,1,7,0xb2d0da22d
105033.54,1.0,184,3,2,1,6,0xb2d2298a
20500.42,3.0,48,2,4,2,8,0xb2d4e8e7
787436.59,2.0,179,4,3,1,8,0xb2d58cefd
4125.75,1.0,9,2,2,3,7,0xb2d57092
36607.15,1.0,0,2,2,4,8,0xb2d4a91d
150672.54,1.0,0,3,2,4,9,0xb2d744df
240188.28,14.0,0,3,4,4,11,0xb2d129ae
609.91,4.0,0,1,4,4,9,0x3b9b3445
200138.6,2.0,116,3,3,1,7,0xb2d56498
310001.15,2.0,4,4,3,4,11,0xb2da00de
134000.1,4.0,43,3,4,2,9,0x3b9b3376d
2081.63,1.0,44,1,2,2,5,0xb2d37cb6
707560.96,3.0,3,4,4,4,12,0xb2d6b48d
283416.42,23.0,6,3,4,3,10,0x3b9b3985
102011.74,3.0,110,3,4,1,8,0xb2d6e0ef
449.63,1.0,7,1,2,3,6,0xb2d55719d
769.19,1.0,68,1,2,1,4,0xb2d33c67
4635.09,1.0,1,2,2,4,8,0xb2d6c0d9
200062.82,2.0,11,3,3,3,9,0xb2d690b1d
80277.89,3.0,22,3,4,2,9,0xb2d68958
202131.89,2.0,98,3,3,1,7,0xb2d97454
160070.06,2.0,256,3,3,1,7,0xb2d6021cd
400000.01,3.0,1,4,4,4,12,0xb2d3e641
39.11,1.0,11,1,2,3,6,0xb2d94172
2525.78,3.0,92,1,4,1,6,0xb2d246a8
10062.61,2.0,11,2,3,3,8,0xb2d69560
430000.0,4.0,5,4,4,3,11,0xb2d6a1e3
351657.77,3.0,139,4,4,1,9,0xb2d39b10d
67584.65,1.0,0,3,2,4,9,0xb2d210c1
611362.06,3.0,73,4,4,1,9,0xb2d22dc3
200066.25,2.0,6,3,3,3,9,0xb2d6badf
67387.62,1.0,184,3,2,1,6,0xb2d288f7d
4349.25,3.0,3,2,4,4,10,0x3b9b3679d
1861.85,1.0,92,1,2,1,4,0xb2d0c673
1173.59,2.0,122,1,3,1,5,0xb2d08646
20002.65,2.0,46,2,3,2,7,0xb2d6286b
51493.74,2.0,83,2,3,1,6,0xb2d29851
10178.44,1.0,169,2,2,1,5,0xb2d1f07ed
2411.21,1.0,184,1,2,1,4,0xb2d26112
29421.85,1.0,27,2,2,2,6,0xb2d63c7b
369116.29,14.0,3,4,4,4,12,0xb2d22afa
3404.98,1.0,7,2,2,3,7,0xb2d8cacc
15064.42,1.0,0,2,2,4,8,0xb2d906b7
110043.34,3.0,11,3,4,3,10,0xb2d19ff7
30786.46,1.0,1,2,2,4,8,0xb2d4c8a4
2980.2,1.0,92,2,2,1,5,0xb2d2498a
18398.61,1.0,2,2,2,4,8,0xb2d8d076
3845.04,1.0,10,2,2,3,7,0xb2d3e694
23.97,11.0,184,1,4,1,6,0xb2d25699
221745.02,2.0,97,3,3,1,7,0xb2d49198
11.61,1.0,18,1,2,2,5,0xb2d9257d
2283.78,2.0,92,1,3,1,5,0x3b9b0ffa
404359.27,9.0,137,4,4,1,9,0xb2d40dab
1114.22,1.0,0,1,2,4,7,0xb2d61b36
20102.05,1.0,0,2,2,4,8,0xb2d6a9e0
91.03,2.0,10,1,3,3,7,0xb2d5b191
1052.19,1.0,91,1,2,1,4,0xb2d331b1d
10000.11,2.0,25,2,3,2,7,0xb2da08da
7819.06,1.0,4,2,2,4,8,0xb2d3bb7ed
48751.31,2.0,121,2,3,1,6,0xb2d639d7
443621.87,3.0,33,4,4,2,10,0xb2d3efed
100978.57,1.0,92,3,2,1,6,0xb2d2a618d
20004.07,2.0,176,2,3,1,6,0xb2d18581
205608.84,2.0,89,3,3,1,7,0xb2d16da2
170005.0,2.0,4,3,3,4,10,0xb2d6a624d
80771.03,3.0,19,3,4,2,9,0xb2d10a1d
1026521.99,5.0,11,4,4,3,11,0xb2d6f1c2
82045.84,2.0,108,3,3,1,7,0xb2d5f0a6
31.3,1.0,20,1,2,2,5,0xb2d308e1
163414.98,5.0,0,3,4,4,11,0xb2d39dd6
450015.99,7.0,25,4,4,2,10,0xb2d15401
51179.1,2.0,31,2,3,2,7,0xb2d68216
152192.2,3.0,33,3,4,2,9,0xb2d67cadd
728408.65,9.0,0,4,4,4,12,0x3b9b186dd
203554.6,2.0,78,3,3,1,7,0xb2d8dd99
86.93,1.0,41,1,2,2,5,0xb2d56ba9
305610.42,4.0,0,4,4,4,12,0xb2d336fa
500019.56,3.0,27,4,4,2,10,0xb2da0c58
10659.35,1.0,20,2,2,2,6,0xb2d68e14
3245.44,1.0,169,2,2,1,5,0xb2d683c5
3000.03,2.0,32,2,3,2,7,0xb2d90bb1
613661.36,17.0,4,4,4,4,12,0xb2d0bfc9
60485.55,3.0,59,3,4,2,9,0xb2d693e3d
14324.17,1.0,20,2,2,2,6,0xb2d6d2af
8474.5,1.0,18,2,2,2,6,0xb2d54fb0d
419796.35,4.0,69,4,4,1,9,0xb2d3a566
9381.97,1.0,0,2,2,4,8,0xb2d7876a
46.89,1.0,76,1,2,1,4,0xb2d0bd92d
24.84,1.0,3,1,2,4,7,0xb2da29b7
121599.33,3.0,27,3,4,2,9,0xb2d0975a
292477.55,2.0,202,3,3,1,7,0xb2d11c26d
6.05,1.0,19,1,2,2,5,0xb2d5ebd3
371016.65,5.0,18,4,4,2,10,0xb2d23483d
5944.62,1.0,9,2,2,3,7,0xb2d908d2
1335394.31,10.0,0,4,4,4,12,0xb2d622fb
5576.77,1.0,4,2,2,4,8,0xb2d6d5c3
1938.84,1.0,92,1,2,1,4,0xb2d1ab3c
6460342.09,2.0,0,4,3,4,11,0xb2d398e5
9001.52,1.0,25,2,2,2,6,0xb2d937c3d
3217.08,1.0,0,2,2,4,8,0xb2d0f380
122925.18,8.0,1,3,4,4,11,0xb2d57761
1007849.39,3.0,9,4,4,3,11,0xb2d92b0c
1514137.9,4.0,22,4,4,2,10,0xb2d5ee7f
695160.89,2.0,87,4,3,1,8,0xb2d248fa
5137.78,1.0,184,2,2,1,5,0xb2d2f08f
250507.4,2.0,0,3,3,4,10,0xb2d28bc3
4664.38,1.0,1,2,2,4,8,0xb2d6fe92d
460046.58,6.0,1,4,4,4,12,0xb2d9557b
3546.09,1.0,184,2,2,1,5,0xb2d1e025
402500.97,3.0,136,4,4,1,9,0xb2d1baf9
50131.45,1.0,51,2,2,2,6,0xb2d8cc42
116.75,1.0,84,1,2,1,4,0xb2d97056
23755.83,1.0,138,2,2,1,5,0xb2d688ced
430000.0,2.0,13,4,3,3,10,0xb2d961a2
20000.21,2.0,70,2,3,1,6,0xb2d9a72a
138003.72,4.0,98,3,4,1,8,0xb2d35165
82664.8,1.0,14,3,2,3,8,0xb2d5ad1d
403228.99,2.0,1,4,3,4,11,0xb2d4cf2c
9994.28,1.0,0,2,2,4,8,0xb2d85ae8d
11275.79,1.0,9,2,2,3,7,0xb2d37024
63582.91,2.0,7,3,3,3,9,0x3b9b3ba5d
1719.74,1.0,94,1,2,1,4,0xb2d0eca6
450017.11,4.0,90,4,4,1,9,0xb2d14a00d
2014.01,1.0,0,1,2,4,7,0xb2d41f76d
735819.52,14.0,0,4,4,4,12,0xb2d1d70dd
1421.33,1.0,92,1,2,1,4,0xb2d1c1d3d
9.86,2.0,157,1,3,1,5,0x3b9b396e
80000.0,2.0,0,3,3,4,10,0xb2d97a74
97682.92,1.0,19,3,2,2,7,0xb2d69695
40193.75,1.0,184,2,2,1,5,0xb2d564b7
2228.13,1.0,20,1,2,2,5,0xb2d6d73c
119.08,1.0,3,1,2,4,7,0xb2d26cbed
212419.67,2.0,167,3,3,1,7,0xb2d17570d
50082.11,2.0,77,2,3,1,6,0xb2d230b9
6.46,8.0,32,1,4,2,7,0xb2d14438
200001.26,2.0,18,3,3,2,8,0xb2d79044
32333.49,3.0,0,2,4,4,10,0xb2d40170
100301.14,1.0,92,3,2,1,6,0xb2d30553d
19.11,1.0,7,1,2,3,6,0xb2d434ced
3739.38,1.0,10,2,2,3,7,0xb2d3ea04
13547.44,1.0,0,2,2,4,8,0xb2d39c5d
200106.47,2.0,14,3,3,3,9,0xb2d95b54
215630.48,4.0,3,3,4,4,11,0xb2d35d31
457493.17,1.0,184,4,2,1,7,0xb2d0e9bc
8168.0,1.0,9,2,2,3,7,0xb2d394b4
297959.91,4.0,0,3,4,4,11,0xb2d06e0a
50000.53,2.0,25,2,3,2,7,0xb2da149c
42032.45,4.0,34,2,4,2,8,0xb2d6fa83
1791.19,1.0,0,1,2,4,7,0xb2d54bd5
0.49,1.0,5,1,2,3,6,0xb2d5bf14
50012.89,2.0,83,2,3,1,6,0xb2d12574d
2762.3,1.0,8,1,2,3,6,0xb2d922e8
800636.48,3.0,0,4,4,4,12,0xb2d1c01f
0.0,1.0,92,1,2,1,4,0xb2d31d94d
45.32,1.0,46,1,2,2,5,0xb2d95e8d
80002.53,3.0,39,3,4,2,9,0xb2d945a5
30001.58,2.0,209,2,3,1,6,0xb2d5b5b1
780037.76,2.0,0,4,3,4,11,0xb2d3d141
8.23,1.0,10,1,2,3,6,0xb2d92cc7
17011.63,1.0,10,2,2,3,7,0xb2d100afd
457024.2,10.0,0,4,4,4,12,0xb2d14440d
527.19,2.0,0,1,3,4,8,0xb2d6d2ffd
600065.67,3.0,12,4,4,3,11,0xb2d91861d
700000.0,6.0,4,4,4,4,12,0xb2d5b9f4d
403007.48,22.0,11,4,4,3,11,0xb2d323ec
1650146.51,22.0,18,4,4,2,10,0xb2d12a96d
76.26,1.0,65,1,2,2,5,0xb2d8f45c
107.91,1.0,18,1,2,2,5,0xb2d1feb8
70050.4,4.0,6,3,4,3,10,0xb2da2d4d
0.29,2.0,1,1,3,4,8,0xb2d22f5f
70000.0,2.0,6,3,3,3,9,0xb2da4f8d
510663.81,2.0,122,4,3,1,8,0xb2d8c3b9
2023213.65,7.0,0,4,4,4,12,0xb2d6c8fd
6.54,1.0,6,1,2,3,6,0xb2d11605d
70001.48,2.0,10,3,3,3,9,0xb2d963b8d
21.04,1.0,50,1,2,2,5,0xb2d3a1b4
717000.0,4.0,1,4,4,4,12,0xb2d95493
370.25,1.0,1,1,2,4,7,0xb2d3470ed
70039.13,4.0,75,3,4,1,8,0x3b9adbe8
2013.12,1.0,14,1,2,3,6,0xb2d8ebd1
774042.6,3.0,10,4,4,3,11,0xb2d54820
20.51,8.0,49,1,4,2,7,0xb2d32008
183.23,1.0,0,1,2,4,7,0xb2d2eb27
1270090.52,5.0,9,4,4,3,11,0xb2d3ada2d
2372.39,1.0,309,1,2,1,4,0xb2d1befe
1277.22,1.0,71,1,2,1,4,0xb2d4bef7d
487310.3,3.0,22,4,4,2,10,0xb2d0de61d
300000.0,6.0,3,3,4,4,11,0xb2d1b1e3
231.47,1.0,10,1,2,3,6,0xb2d1fa7a
832751.42,5.0,18,4,4,2,10,0xb2d4f7b0
320634.25,7.0,165,4,4,1,9,0xb2d655d5
200000.0,2.0,16,3,3,2,8,0xb2d99aa4
18597.17,1.0,1,2,2,4,8,0xb2d2230c
120001.27,2.0,38,3,3,2,8,0xb2d92d5d
781614.37,3.0,102,4,4,1,9,0xb2d54820d
18029.9,3.0,0,2,4,4,10,0xb2d06811
500079.52,2.0,14,4,3,3,10,0xb2da32dc
5744.05,1.0,3,2,2,4,8,0xb2d8cf8c
21.14,1.0,101,1,2,1,4,0xb2d0f710d
1481.1,1.0,92,1,2,1,4,0xb2d12d47
580049.72,7.0,21,4,4,2,10,0xb2d69265
37.17,1.0,75,1,2,1,4,0xb2d8c5c4
1478.1,1.0,11,1,2,3,6,0xb2d5750e
195.66,1.0,10,1,2,3,6,0xb2d2d3bb
7.44,1.0,9,1,2,3,6,0xb2d2ff82
1323449.37,3.0,13,4,4,3,11,0xb2d6a1f6
180.3,1.0,46,1,2,2,5,0xb2d99c7d
150005.88,4.0,38,3,4,2,9,0xb2d59193
1930370.2,10.0,4,4,4,4,12,0xb2d5a562d
106659.63,2.0,18,3,3,2,8,0xb2d46f31
2473.53,1.0,92,1,2,1,4,0xb2d0e1d2
691357.83,4.0,74,4,4,1,9,0xb2d57aa2
350000.0,2.0,6,4,3,3,10,0xb2d97245
3005.36,1.0,178,2,2,1,5,0xb2d31aac
2244.7,1.0,92,1,2,1,4,0xb2d35bc7
4.75,1.0,45,1,2,2,5,0xb2d93987d
2434.99,1.0,147,1,2,1,4,0xb2d54065d
117.01,1.0,0,1,2,4,7,0xb2d6b5db
505000.81,8.0,4,4,4,4,12,0xb2d29686
369560.4,1.0,8,4,2,3,9,0xb2d2d166
100000.0,1.0,9,3,2,3,8,0xb2d93012d
252979.56,5.0,11,3,4,3,10,0xb2d0a3d2
595051.89,7.0,29,4,4,2,10,0xb2d24fef
640094.4,6.0,1,4,4,4,12,0xb2d1b9c7
250006.87,3.0,110,3,4,1,8,0xb2d944b4
115136.99,1.0,19,3,2,2,7,0xb2d1be05
200008.24,9.0,11,3,4,3,10,0xb2d64891
241970.17,3.0,3,3,4,4,11,0xb2d15d5bd
206081.54,4.0,3,3,4,4,11,0x3b9b34b6
510022.05,6.0,4,4,4,4,12,0xb2d44232d
500456.79,2.0,19,4,3,2,9,0xb2d78d81
57005.5,3.0,27,3,4,2,9,0xb2d5799e
4119.7,1.0,17,2,2,2,6,0xb2d29c83
400010.82,2.0,22,4,3,2,9,0xb2d23e33
38808.44,1.0,0,2,2,4,8,0xb2d40eb3
405.09,1.0,6,1,2,3,6,0xb2d2b9aa
6141.94,1.0,92,2,2,1,5,0xb2d0d0da
69002.92,2.0,94,3,3,1,7,0xb2d204f9
300019.28,3.0,20,3,4,2,9,0xb2d2206b
27028.68,1.0,9,2,2,3,7,0xb2d5d459d
30200.65,2.0,18,2,3,2,7,0xb2da2cbc
673095.11,8.0,10,4,4,3,11,0xb2d11a02
50001.06,2.0,11,2,3,3,8,0xb2da3cec
907.99,1.0,13,1,2,3,6,0xb2d277ec
2276.11,1.0,6,1,2,3,6,0xb2d78dca
100000.0,2.0,1,3,3,4,10,0xb2da6282
5680.61,1.0,92,2,2,1,5,0xb2d22f2ed
2401.38,1.0,20,1,2,2,5,0xb2d5ae0a
815784.13,5.0,0,4,4,4,12,0xb2d244c9
319308.89,2.0,3,4,3,4,11,0xb2d18b95
6.55,1.0,15,1,2,3,6,0xb2d4a91f
13710.55,1.0,0,2,2,4,8,0xb2d6bf2a
50021.88,2.0,15,2,3,3,8,0xb2d63abc
47950.12,1.0,3,2,2,4,8,0xb2d18da7d
501510.5,3.0,28,4,4,2,10,0xb2d4ed04
1013.47,1.0,92,1,2,1,4,0xb2d1a30c
2485.35,1.0,7,1,2,3,6,0xb2d2c299d
3135.49,1.0,22,2,2,2,6,0xb2d2617a
414.93,1.0,0,1,2,4,7,0xb2d68eb9
7311.35,1.0,8,2,2,3,7,0xb2d92276
1280049.4,9.0,73,4,4,1,9,0xb2d10091d
210082.88,4.0,213,3,4,1,8,0xb2d41058
10011.08,1.0,4,2,2,4,8,0xb2d91b87
101333.89,3.0,13,3,4,3,10,0x3b9b3c84
6.05,1.0,76,1,2,1,4,0xb2d572fe
7982.4,1.0,0,2,2,4,8,0xb2d39de7
1000000.0,2.0,6,4,3,3,10,0xb2da5239
4955.07,1.0,0,2,2,4,8,0xb2d5af29
20063.23,2.0,55,2,3,2,7,0xb2d6d092d
509.75,1.0,5,1,2,3,6,0xb2d21334
140002.11,3.0,35,3,4,2,9,0xb2d975d0d
457.42,1.0,18,1,2,2,5,0xb2d2595f
374009.76,8.0,13,4,4,3,11,0xb2d408f6
10126.74,1.0,92,2,2,1,5,0xb2d2333cd
7163.05,1.0,2,2,2,4,8,0xb2d9312d
794.24,1.0,2,1,2,4,7,0xb2d71738
461258.32,3.0,0,4,4,4,12,0xb2d17f1d
1000078.64,2.0,256,4,3,1,8,0xb2d1d3c7
224718.54,1.0,2,3,2,4,9,0xb2d99e5d
202269.97,2.0,102,3,3,1,7,0xb2d65457
15696.4,1.0,0,2,2,4,8,0xb2d9fc0e
3.86,1.0,20,1,2,2,5,0xb2d5618c
100001.06,2.0,217,3,3,1,7,0xb2d71af8
139312.84,2.0,74,3,3,1,7,0xb2d3c3edd
50030.33,1.0,0,2,2,4,8,0xb2d56f26
20002.79,2.0,83,2,3,1,6,0xb2d616cc
954.54,1.0,0,1,2,4,7,0xb2d2160fd
326571.28,2.0,235,4,3,1,8,0xb2d17784d
2131.4,1.0,92,1,2,1,4,0xb2d32983
5776.36,1.0,8,2,2,3,7,0xb2d27777d
0.0,1.0,0,1,2,4,7,0xb2da3e85
386387.88,9.0,4,4,4,4,12,0xb2d2fc19d
0.0,1.0,0,1,2,4,7,0xb2d68a94
575446.4,1.0,0,4,2,4,10,0xb2d144e4
71287.17,2.0,216,3,3,1,7,0xb2d445a0
2400.83,1.0,14,1,2,3,6,0xb2d8c603
0.55,1.0,0,1,2,4,7,0xb2d45736
4448.21,1.0,19,2,2,2,6,0xb2d2edd2
1401730.62,21.0,19,4,4,2,10,0xb2d15e5f
100000.53,1.0,0,3,2,4,9,0xb2d9550cd
0.0,1.0,4,1,2,4,7,0xb2d49f46
980030.13,8.0,6,4,4,3,11,0xb2d9a0b5
1034.24,1.0,92,1,2,1,4,0xb2d30e1e
30005.6,2.0,19,2,3,2,7,0xb2d36515d
1059.88,1.0,184,1,2,1,4,0xb2d111bf
560.52,1.0,5,1,2,3,6,0xb2d2b3f2d
207750.05,2.0,0,3,3,4,10,0xb2d96a6fd
550004.99,4.0,0,4,4,4,12,0xb2d548c6d
5997.41,1.0,8,2,2,3,7,0xb2d61edd
370000.41,1.0,3,4,2,4,10,0xb2d14216
200012.08,2.0,87,3,3,1,7,0xb2d124b4
12560.95,1.0,11,2,2,3,7,0xb2d284b1
80258.55,7.0,3,3,4,4,11,0xb2d59d61
15.51,1.0,26,1,2,2,5,0xb2d42e8e
884839.99,4.0,1,4,4,4,12,0xb2d3af47
10000.11,2.0,18,2,3,2,7,0xb2da253a
50287.57,2.0,42,2,3,2,7,0xb2d64d11d
150000.32,3.0,0,3,4,4,11,0xb2d2ce7ad
13082.34,1.0,22,2,2,2,6,0xb2d6e646
83032.86,2.0,15,3,3,3,9,0xb2d31583
3801.28,1.0,20,2,2,2,6,0xb2d8e349
700016.89,3.0,4,4,4,4,12,0xb2d9d2ef
53450.25,1.0,49,3,2,2,7,0xb2d5a10d
500000.01,2.0,6,4,3,3,10,0xb2d30679
10013.65,1.0,7,2,2,3,7,0xb2d2b7b0
1049.25,1.0,60,1,2,2,5,0xb2d3a5fd
3109.1,1.0,92,2,2,1,5,0xb2d0d6f8
3131.84,1.0,184,2,2,1,5,0xb2d099d4d
65601.11,3.0,2,3,4,4,11,0xb2d59cdf
100001.59,3.0,10,3,4,3,10,0xb2d9498e
1597.97,1.0,92,1,2,1,4,0xb2d13b09d
6248.33,1.0,3,2,2,4,8,0xb2d39558d
1770.21,1.0,0,1,2,4,7,0xb2d2a79ed
638010.15,20.0,0,4,4,4,12,0xb2d598fa
534137.6,6.0,0,4,4,4,12,0xb2d574a1
2009.67,1.0,0,1,2,4,7,0xb2d6c6cfd
2644.21,1.0,92,1,2,1,4,0xb2d11830
100003.17,1.0,13,3,2,3,8,0xb2d9b9b1
216000.0,7.0,3,3,4,4,11,0xb2d50ab8
25605.68,1.0,20,2,2,2,6,0xb2d21c12
1000020.53,2.0,1,4,3,4,11,0xb2d599bd
195.25,1.0,116,1,2,1,4,0xb2d4d312
3311.54,5.0,0,2,4,4,10,0x3b9af0e7d
97.78,1.0,12,1,2,3,6,0xb2d445c8
805477.27,3.0,23,4,4,2,10,0xb2d2a7f4
433.47,1.0,4,1,2,4,7,0xb2d8c455d
1331.19,1.0,17,1,2,2,5,0xb2d5b1bdd
232475.35,2.0,84,3,3,1,7,0xb2d659af
151420.17,3.0,13,3,4,3,10,0xb2d21c5ed
61952.5,1.0,8,3,2,3,8,0xb2d6a5db
890.96,1.0,5,1,2,3,6,0xb2d25d51
10863.72,1.0,5,2,2,3,7,0xb2d2b3a3
121835.57,6.0,6,3,4,3,10,0xb2d2a9c0
4000.92,1.0,0,2,2,4,8,0xb2d20fadd
370067.33,5.0,87,4,4,1,9,0xb2d1b803
10493.21,1.0,0,2,2,4,8,0xb2d57b9a
344344.43,5.0,73,4,4,1,9,0xb2d51166
6022.55,1.0,92,2,2,1,5,0xb2d3a004
510029.76,5.0,3,4,4,4,12,0xb2d912cb
4471.67,1.0,9,2,2,3,7,0xb2d48266
648.42,1.0,9,1,2,3,6,0xb2d62751d
100891.84,1.0,3,3,2,4,9,0xb2d317a2
5.4,1.0,46,1,2,2,5,0xb2d6ea61
43767.8,2.0,0,2,3,4,9,0xb2d1192a
1612.4,1.0,2,1,2,4,7,0xb2d2b5f0
4503.32,1.0,2,2,2,4,8,0xb2d6bd94d
16212.63,1.0,14,2,2,3,7,0xb2d6be24d
5473018.56,3.0,235,4,4,1,9,0xb2d22d17d
2694.73,1.0,0,1,2,4,7,0xb2d5f6b5
500008.96,2.0,14,4,3,3,10,0xb2d6c7c7
40950.69,2.0,24,2,3,2,7,0xb2d8f8e4
50002.64,2.0,83,2,3,1,6,0xb2d98527
608.71,1.0,0,1,2,4,7,0xb2d26aafd
651481.03,7.0,15,4,4,3,11,0xb2d41c3a
1005376.8,3.0,8,4,4,3,11,0xb2d3076c
102953.29,2.0,104,3,3,1,7,0xb2d0f7c2
175.2,1.0,4,1,2,4,7,0xb2d3ea0f
3271.69,1.0,184,2,2,1,5,0xb2d30b18d
1014.65,1.0,71,1,2,1,4,0xb2d34d4d
1390128.96,3.0,216,4,4,1,9,0xb2d12c87
9029.26,1.0,0,2,2,4,8,0xb2d2a1fe
64292.24,2.0,0,3,3,4,10,0xb2d365a9
152688.9,1.0,162,3,2,1,6,0xb2d5a2a8
5718.53,1.0,184,2,2,1,5,0xb2d1abf0d
110010.44,3.0,143,3,4,1,8,0xb2d5d392d
51714.72,2.0,235,2,3,1,6,0xb2d551e5
321451.5,3.0,0,4,4,4,12,0xb2d429d9
128131.25,6.0,4,3,4,4,11,0xb2d651b2
33426.94,3.0,184,2,4,1,7,0xb2d21f77
3637856.21,27.0,4,4,4,4,12,0xb2d64317d
272567.71,3.0,1,3,4,4,11,0xb2d626ed
40000.42,2.0,46,2,3,2,7,0xb2d9e0e6
4.51,1.0,25,1,2,2,5,0xb2d603d2
200017.0,3.0,39,3,4,2,9,0xb2d196aa
81675.44,1.0,5,3,2,3,8,0xb2d8ce67d
6754.78,1.0,21,2,2,2,6,0xb2d965af
60001.26,3.0,63,3,4,2,9,0xb2d62b9e
252308.82,3.0,66,3,4,2,9,0xb2d44670
971140.79,9.0,1,4,4,4,12,0xb2d5ddb2d
72000.76,2.0,27,3,3,2,8,0xb2d940d2
1350000.0,12.0,6,4,4,3,11,0xb2d5c5be
193539.06,5.0,1,3,4,4,11,0xb2d416bed
10106.59,2.0,0,2,3,4,9,0xb2d23ad1
150048.53,3.0,76,3,4,1,8,0xb2d451b7d
240882.01,3.0,90,3,4,1,8,0xb2d27cc3
15071.73,2.0,103,2,3,1,6,0xb2d5bf86d
266080.68,6.0,108,3,4,1,8,0xb2d1390ad
7800.3,6.0,0,2,4,4,10,0x3b9af62a
91855.38,1.0,18,3,2,2,7,0xb2d5d4bd
14152.78,1.0,109,2,2,1,5,0xb2d67d8ad
401578.2,2.0,27,4,3,2,9,0xb2d6d0e8
440271.65,3.0,30,4,4,2,10,0xb2d406b7d
53.3,1.0,0,1,2,4,7,0xb2d2b15e
5.07,1.0,35,1,2,2,5,0xb2d5fc02
1069264.55,6.0,6,4,4,3,11,0xb2d3a49d
0.42,2.0,62,1,3,2,6,0xb2d4f88f
11437.12,1.0,0,2,2,4,8,0xb2d7875e
765014.57,4.0,19,4,4,2,10,0x3b9b4574
1000079.62,1.0,0,4,2,4,10,0xb2d44521
22.5,1.0,19,1,2,2,5,0xb2d2561f
2791.14,1.0,0,1,2,4,7,0xb2d9050c
4819.6,1.0,0,2,2,4,8,0xb2d486db
831792.74,6.0,25,4,4,2,10,0xb2d17e68d
2003576.71,4.0,0,4,4,4,12,0xb2d41177d
100434.53,1.0,0,3,2,4,9,0xb2d1d9a9
614860.68,4.0,1,4,4,4,12,0xb2d1397f
104793.07,2.0,147,3,3,1,7,0xb2d0bdbed
11012.25,1.0,184,2,2,1,5,0xb2d0759e
3527.56,1.0,184,2,2,1,5,0xb2d2be3a
20987.34,2.0,2,2,3,4,9,0xb2da3779
5674.98,1.0,238,2,2,1,5,0xb2d42ec0
1.24,1.0,4,1,2,4,7,0xb2d2871a
275429.74,2.0,11,3,3,3,9,0xb2d32073d
6887.81,1.0,9,2,2,3,7,0xb2d2917d
2.32,1.0,110,1,2,1,4,0xb2d5c8bed
22790.4,3.0,0,2,4,4,10,0xb2d4c1de
10000.42,2.0,92,2,3,1,6,0xb2d6493e
1250066.87,5.0,73,4,4,1,9,0xb2d41f43
620055.23,2.0,143,4,3,1,8,0xb2d1c4b5d
78.72,1.0,0,1,2,4,7,0xb2d24bb7
25739.42,2.0,0,2,3,4,9,0xb2d20aa9
1224.62,1.0,92,1,2,1,4,0xb2d35e13
90114.52,2.0,6,3,3,3,9,0xb2d41c2d
660110.1,4.0,0,4,4,4,12,0xb2d53669
2866.08,1.0,184,1,2,1,4,0xb2d1edfd
100004.17,2.0,45,3,3,2,8,0xb2d915c0
1200038.53,3.0,1,4,4,4,12,0xb2d9fce8
59278.36,2.0,2,3,3,4,10,0xb2d2a449
222818.62,3.0,2,3,4,4,11,0xb2d339d0
1776334.18,1.0,0,4,2,4,10,0xb2d34a2a
1184.92,1.0,124,1,2,1,4,0xb2d0df11
1011023.21,3.0,22,4,4,2,10,0xb2d88a0ad
92.0,1.0,63,1,2,2,5,0xb2d1cdc8
448613.59,2.0,143,4,3,1,8,0xb2d14df4
4218.08,1.0,4,2,2,4,8,0xb2d6a639
518089.37,1.0,0,4,2,4,10,0xb2d2094b
180008.37,2.0,0,3,3,4,10,0xb2d19d8d
105.39,1.0,19,1,2,2,5,0xb2d9eefb
901003.3,5.0,0,4,4,4,12,0xb2d3a2e9
20312.59,2.0,164,2,3,1,6,0xb2d6098dd
454600.0,37.0,0,4,4,4,12,0x3b9af1c0d
26049.87,1.0,145,2,2,1,5,0xb2d3b344d
543000.0,4.0,0,4,4,4,12,0xb2d1abdf
60001.9,2.0,224,3,3,1,7,0xb2d6fa70
16513.02,1.0,10,2,2,3,7,0xb2d9f014
84829.02,1.0,10,3,2,3,8,0xb2d9cb1b
35216.04,4.0,40,2,4,2,8,0x3b9adc98
11341.84,1.0,0,2,2,4,8,0xb2d54e74d
100013.95,2.0,6,3,3,3,9,0xb2da078f
150628.75,1.0,92,3,2,1,6,0xb2d5000a
111713.24,2.0,1,3,3,4,10,0xb2d260b3
650056.15,6.0,34,4,4,2,10,0xb2d24aea
226629.19,1.0,92,3,2,1,6,0xb2d61264
220742.6,4.0,32,3,4,2,9,0xb2d935d9d
126600.77,2.0,92,3,3,1,7,0xb2d3e027
41206.49,1.0,22,2,2,2,6,0xb2d5e609
505982.18,13.0,70,4,4,1,9,0xb2d4d1aa
669.48,1.0,22,1,2,2,5,0xb2d1c10f
4.12,1.0,41,1,2,2,5,0xb2d31ab3
3001373.09,4.0,16,4,4,2,10,0xb2d6fbd2
256.15,1.0,4,1,2,4,7,0xb2d3a667d
39310.5,1.0,26,2,2,2,6,0xb2d8ff4a
300057.48,2.0,122,3,3,1,7,0xb2d18c46d
7439.04,1.0,12,2,2,3,7,0xb2d9189cd
52158.53,2.0,19,3,3,2,8,0xb2d9a3d9
1641.85,1.0,0,1,2,4,7,0xb2d93286
200167.22,7.0,0,3,4,4,11,0xb2d587c6
50004.01,2.0,11,2,3,3,8,0xb2d6dd58
491.96,1.0,9,1,2,3,6,0xb2d55201
8375.29,1.0,0,2,2,4,8,0xb2d54c0fd
454.63,1.0,15,1,2,3,6,0xb2d945b2
56001.77,2.0,107,3,3,1,7,0xb2d68a13
80002.76,5.0,11,3,4,3,10,0xb2d658c3d
10009.54,2.0,14,2,3,3,8,0xb2d57e11
20.69,1.0,14,1,2,3,6,0xb2d9fb6b
360000.0,2.0,3,4,3,4,11,0xb2d97a9fd
109288.44,4.0,92,3,4,1,8,0xb2d0798b
232.57,1.0,39,1,2,2,5,0xb2d52df1
500000.0,2.0,5,4,3,3,10,0xb2d8e788
326.19,1.0,8,1,2,3,6,0xb2d9de75
360010.43,3.0,6,4,4,3,11,0xb2d8e186
29969.08,1.0,11,2,2,3,7,0xb2d5b8bdd
30681.33,1.0,141,2,2,1,5,0xb2d61372d
20925.26,1.0,0,2,2,4,8,0xb2d76aca
10001.06,1.0,20,2,2,2,6,0xb2da2af7
20001.21,2.0,18,2,3,2,7,0xb2d603d5
201661.03,2.0,58,3,3,2,8,0xb2d6dd26
73.33,1.0,20,1,2,2,5,0xb2d94d51
200012.17,3.0,6,3,4,3,10,0xb2d1b90ad
250964.34,2.0,16,3,3,2,8,0xb2d9811d
27.23,1.0,48,1,2,2,5,0xb2d8fbcf
680004.32,4.0,4,4,4,4,12,0xb2d9d5e1
70691.28,3.0,80,3,4,1,8,0xb2d6b72c
2544000.0,13.0,1,4,4,4,12,0xb2d24de8d
801855.82,8.0,5,4,4,3,11,0xb2d1ea12
3918.27,1.0,10,2,2,3,7,0xb2d6db4e
404053.03,4.0,10,4,4,3,11,0xb2d2453d
5560762.81,10.0,53,4,4,2,10,0xb2d2799e
40001.69,2.0,73,2,3,1,6,0xb2d6f908
4332.26,1.0,15,2,2,3,7,0xb2d8c3d9d
120007.28,3.0,8,3,4,3,10,0xb2d1bff0
30241.44,2.0,13,2,3,3,8,0xb2d541a3
556007.16,6.0,80,4,4,1,9,0xb2d27e00
686409.02,7.0,74,4,4,1,9,0xb2d62513
3715.57,1.0,10,2,2,3,7,0xb2d6f2d5
110010.56,2.0,118,3,3,1,7,0xb2d562c2
0.74,1.0,3,1,2,4,7,0xb2d8699e
3094.56,1.0,123,2,2,1,5,0xb2d65752
5267.53,1.0,0,2,2,4,8,0xb2d4ce05
382.6,3.0,34,1,4,2,7,0xb2d0cf1cd
1.15,5.0,73,1,4,1,6,0xb2d162a1
90005.36,3.0,144,3,4,1,8,0xb2d49141d
1051.51,1.0,6,1,2,3,6,0xb2d21d25
111342.18,3.0,22,3,4,2,9,0xb2d35519d
107032.63,2.0,48,3,3,2,8,0xb2d3bf70
60628.1,3.0,104,3,4,1,8,0xb2d5c1a8
301142.73,2.0,0,4,3,4,11,0xb2d61499d
504000.78,4.0,57,4,4,2,10,0xb2d694f3
6498.07,1.0,8,2,2,3,7,0xb2d30b27
1090000.0,4.0,0,4,4,4,12,0xb2d20901
506379.21,3.0,24,4,4,2,10,0xb2d5cac7
2773.28,1.0,2,1,2,4,7,0xb2d27f36
331669.05,2.0,92,4,3,1,8,0xb2d23b15d
1736.54,1.0,4,1,2,4,7,0xb2d62113
225.18,1.0,9,1,2,3,6,0xb2d78bf9
741126.46,2.0,0,4,3,4,11,0xb2d2702f
11555.71,1.0,25,2,2,2,6,0xb2d2f060
20.91,1.0,17,1,2,2,5,0xb2d75464
1179.31,1.0,184,1,2,1,4,0xb2d20af7
13269.01,1.0,8,2,2,3,7,0xb2d6855e
42897.49,1.0,7,2,2,3,7,0xb2d579fa
10737.99,1.0,0,2,2,4,8,0xb2d20f74
16624.86,1.0,9,2,2,3,7,0xb2d37af8d
33396.82,4.0,0,2,4,4,10,0x3b9af279
2904.86,1.0,92,2,2,1,5,0xb2d45c27
310938.0,5.0,0,4,4,4,12,0xb2d31664
60053.98,2.0,153,3,3,1,7,0xb2d64a01
757525.52,7.0,0,4,4,4,12,0xb2d624fbd
21.62,1.0,0,1,2,4,7,0xb2d13ca2
11596.17,1.0,1,2,2,4,8,0xb2d2ed82
500043.49,3.0,25,4,4,2,10,0xb2d68c80
110067.74,2.0,80,3,3,1,7,0xb2d6b6b3
500000.0,2.0,20,4,3,2,9,0xb2d9f277
407029.11,7.0,3,4,4,4,12,0xb2d0d058
500010.62,2.0,32,4,3,2,9,0xb2d91b72
13205.38,1.0,9,2,2,3,7,0xb2d8fc4f
1016.26,1.0,184,1,2,1,4,0xb2d106ef
1040.66,2.0,184,1,3,1,5,0x3b9ad549d
43685.41,1.0,3,2,2,4,8,0xb2d5070c
39812.75,1.0,0,2,2,4,8,0xb2d6a6d3d
346.41,1.0,4,1,2,4,7,0xb2d7836c
74.67,1.0,29,1,2,2,5,0xb2d95bca
500000.0,2.0,12,4,3,3,10,0xb2d9634bd
9762.13,1.0,0,2,2,4,8,0xb2d9b0bc
656.96,1.0,8,1,2,3,6,0xb2d469d8
1587.91,1.0,92,1,2,1,4,0xb2d5e5bad
23023.84,1.0,18,2,2,2,6,0xb2d3b7ff
1444.19,1.0,184,1,2,1,4,0xb2d1a40ed
1008.49,1.0,92,1,2,1,4,0xb2d25ac3d
200745.78,2.0,28,3,3,2,8,0xb2d5961f
110131.0,3.0,122,3,4,1,8,0xb2d63b9d
1668922.39,6.0,6,4,4,3,11,0xb2d3838dd
1009114.94,1.0,0,4,2,4,10,0xb2d4138f
19184.55,1.0,0,2,2,4,8,0xb2d3ae84
30.83,1.0,1,1,2,4,7,0xb2d49101
590101.9,3.0,0,4,4,4,12,0xb2d94b96
10459.99,1.0,188,2,2,1,5,0xb2d64d0e
10.56,1.0,62,1,2,2,5,0xb2d974a3
100401.27,2.0,21,3,3,2,8,0xb2d90ba3
10442.11,2.0,40,2,3,2,7,0xb2d69cc0d
605.68,1.0,3,1,2,4,7,0xb2d4ce8f
110197.36,3.0,35,3,4,2,9,0xb2d8c5cc
1364.09,1.0,0,1,2,4,7,0xb2d6d7bcd
50229.12,1.0,38,2,2,2,6,0xb2d25ff6
10601.48,1.0,0,2,2,4,8,0xb2d569ead
195060.64,5.0,10,3,4,3,10,0xb2d06766d
1091.45,1.0,0,1,2,4,7,0xb2d31631
400003.43,6.0,0,4,4,4,12,0xb2d256e7
150367.49,3.0,55,3,4,2,9,0xb2d61113
901.9,1.0,10,1,2,3,6,0xb2d5aec6
500156.11,7.0,52,4,4,2,10,0xb2d40674
355567.57,2.0,3,4,3,4,11,0xb2d58ab8d
153805.55,3.0,0,3,4,4,11,0xb2d0bf54d
1000000.0,3.0,12,4,4,3,11,0xb2da40da
16104.25,1.0,1,2,2,4,8,0xb2d6a826
51782.25,2.0,34,2,3,2,7,0xb2d5ec3d
301353.62,3.0,1,4,4,4,12,0xb2d0f3c4
34751.76,1.0,10,2,2,3,7,0xb2d27dc0
241349.33,18.0,5,3,4,3,10,0xb2d5c813
352785.32,9.0,4,4,4,4,12,0xb2d1be6f
20706.68,1.0,301,2,2,1,5,0xb2d5a665
29.56,1.0,46,1,2,2,5,0xb2d9ac3a
9897.12,1.0,0,2,2,4,8,0xb2d48c37d
36.61,1.0,78,1,2,1,4,0xb2d6be7c
574007.2,7.0,19,4,4,2,10,0xb2d1a4e5
300010.27,3.0,92,3,4,1,8,0xb2d59544
5.23,1.0,28,1,2,2,5,0xb2d9005d
16.74,2.0,73,1,3,1,5,0xb2d2f5b5
10047.43,2.0,41,2,3,2,7,0xb2d5d16ed
100001.06,3.0,77,3,4,1,8,0xb2d98fd7
1.27,1.0,89,1,2,1,4,0xb2d8c368
11314.22,1.0,59,2,2,2,6,0xb2d2cea1d
238.58,1.0,62,1,2,2,5,0xb2d6eb91
19.05,1.0,41,1,2,2,5,0xb2d6c234
1277.42,1.0,0,1,2,4,7,0xb2d78733
223398.45,3.0,28,3,4,2,9,0xb2d5065e
120920.58,2.0,239,3,3,1,7,0xb2d3d94e
7126.83,1.0,92,2,2,1,5,0xb2d306df
4.29,1.0,1,1,2,4,7,0xb2d9e28c
1019.28,1.0,146,1,2,1,4,0xb2d6b6ffd
120051.54,2.0,228,3,3,1,7,0xb2d16eb5
781.84,1.0,10,1,2,3,6,0xb2d4ba4bd
5437.78,1.0,8,2,2,3,7,0xb2d6bd86
19951.04,1.0,3,2,2,4,8,0xb2d6a9aad
35943.43,3.0,74,2,4,1,7,0xb2d4b420
7983.98,1.0,116,2,2,1,5,0xb2d1b215
0.0,1.0,0,1,2,4,7,0xb2d9585f
100014.21,2.0,111,3,3,1,7,0xb2d30f91
2048100.0,13.0,1,4,4,4,12,0xb2d5b290
5607.44,1.0,9,2,2,3,7,0xb2d3ebcc
9165.85,1.0,20,2,2,2,6,0xb2d5a715d
3917.03,1.0,9,2,2,3,7,0xb2d902ac
9150.22,1.0,0,2,2,4,8,0xb2d42f4f
126374.88,1.0,77,3,2,1,6,0x3b9b41dcd
1137791.32,3.0,0,4,4,4,12,0xb2d239fd
312.63,1.0,35,1,2,2,5,0xb2d2e0c0
10206.95,1.0,14,2,2,3,7,0xb2d25ed5d
139353.15,1.0,0,3,2,4,9,0xb2d56395d
1000.92,1.0,97,1,2,1,4,0xb2d95cd6
52895.06,11.0,0,3,4,4,11,0x3b9b1a3a
2411.23,1.0,45,1,2,2,5,0xb2d2908f
310038.23,2.0,45,4,3,2,9,0xb2d63ef1
10356.08,1.0,14,2,2,3,7,0xb2d618c9
2309.29,1.0,129,1,2,1,4,0xb2d16c45
2335.88,1.0,73,1,2,1,4,0xb2d3e26a
8155.39,1.0,44,2,2,2,6,0xb2d93e89
300000.66,3.0,1,3,4,4,11,0xb2d71765
1852.27,3.0,92,1,4,1,6,0x3b9b36f1
100.68,1.0,28,1,2,2,5,0xb2d22b17
6614.59,1.0,1,2,2,4,8,0xb2d36b8ad
8877.59,1.0,0,2,2,4,8,0xb2d6baf5
567150.72,3.0,1,4,4,4,12,0xb2d107b8
75001.8,9.0,20,3,4,2,9,0xb2d077d9d
50006.19,2.0,4,2,3,4,9,0xb2d5634b
27536.82,1.0,21,2,2,2,6,0xb2d6c168
20161.88,1.0,92,2,2,1,5,0xb2d30db4
51009.06,2.0,6,2,3,3,8,0xb2d1a359
300081.97,3.0,8,3,4,3,10,0xb2d60e47
52.71,1.0,9,1,2,3,6,0xb2d4ec16
1420821.92,4.0,171,4,4,1,9,0xb2d11301
280514.27,1.0,21,3,2,2,7,0xb2d34348
480005.1,3.0,13,4,4,3,11,0xb2d13700
525161.04,5.0,118,4,4,1,9,0xb2d36691
10000.11,2.0,8,2,3,3,8,0xb2da4db3
112000.0,3.0,0,3,4,4,11,0xb2d97424
200002.1,2.0,15,3,3,3,9,0xb2d8e10b
36696.14,1.0,21,2,2,2,6,0xb2d603ea
300001.11,2.0,22,3,3,2,8,0xb2d62cff
70059.63,3.0,0,3,4,4,11,0xb2d0c387
1030073.8,5.0,4,4,4,4,12,0xb2d62870
120290.04,1.0,54,3,2,2,7,0xb2d4ee98
3029.8,1.0,92,2,2,1,5,0xb2d27d77d
52930.2,3.0,25,3,4,2,9,0xb2d50dd3
550056.05,2.0,2,4,3,4,11,0xb2d9f5b8
163.29,1.0,8,1,2,3,6,0xb2d30603
40393.31,1.0,4,2,2,4,8,0xb2d20d3d
652642.8,4.0,11,4,4,3,11,0xb2d50b14
32371.64,2.0,2,2,3,4,9,0xb2d906d9
120010.18,2.0,216,3,3,1,7,0xb2d157d5
200177.31,4.0,14,3,4,3,10,0xb2d5a0b3d
203937.56,2.0,168,3,3,1,7,0xb2d6c028d
507109.3,3.0,18,4,4,2,10,0xb2d65bac
472074.59,1.0,184,4,2,1,7,0xb2d2094e
2649.84,1.0,8,1,2,3,6,0xb2d6f052
30000.0,2.0,6,2,3,3,8,0xb2da4f58
236040.88,5.0,0,3,4,4,11,0xb2d240d2
1000060.07,4.0,0,4,4,4,12,0xb2d28a85
1636.81,1.0,9,1,2,3,6,0xb2d9acab
41616.56,1.0,0,2,2,4,8,0xb2d6b34d
11461.39,2.0,4,2,3,4,9,0xb2da08c7
180.2,1.0,56,1,2,2,5,0xb2d93718d
10002.11,2.0,52,2,3,2,7,0xb2d902acd
900092.14,3.0,90,4,4,1,9,0xb2d55c18
14096.78,1.0,87,2,2,1,5,0xb2d28969
15000.0,2.0,92,2,3,1,6,0xb2d5f967
40351.72,3.0,158,2,4,1,7,0xb2d5f026d
1454.48,1.0,0,1,2,4,7,0xb2d58702
31.49,1.0,5,1,2,3,6,0xb2d511c7
361.1,1.0,4,1,2,4,7,0xb2d4f4e5
734.76,1.0,15,1,2,3,6,0xb2d62178
1600161.46,2.0,95,4,3,1,8,0x3b9b491dd
545014.32,4.0,27,4,4,2,10,0xb2d140d7
201404.1,5.0,0,3,4,4,11,0x3b9b18d8
311655.5,3.0,32,4,4,2,10,0xb2d5fa74d
2737.73,2.0,96,1,3,1,5,0xb2d07f62
85495.47,7.0,11,3,4,3,10,0xb2d5ddd6
3958.34,1.0,39,2,2,2,6,0xb2d305ed
407005.59,3.0,0,4,4,4,12,0xb2d21e7c
1826.61,1.0,10,1,2,3,6,0xb2d57ddd
30653.93,2.0,2,2,3,4,9,0xb2d62d4a
1200000.0,4.0,0,4,4,4,12,0xb2d605cc
7414.98,1.0,0,2,2,4,8,0xb2d4a6c2
223160.95,2.0,184,3,3,1,7,0xb2d3bbd0
500919.24,4.0,108,4,4,1,9,0xb2d433f5d
15336.18,1.0,92,2,2,1,5,0xb2d12e72d
412132.22,4.0,39,4,4,2,10,0xb2d95ff7
50008.15,2.0,8,2,3,3,8,0xb2d6ee7f
2254.99,1.0,3,1,2,4,7,0xb2d62b25
35209.43,1.0,105,2,2,1,5,0xb2d2f058d
600012.67,3.0,24,4,4,2,10,0xb2d1f1e2
1241.34,1.0,92,1,2,1,4,0xb2d57fd2d
223007.26,2.0,30,3,3,2,8,0xb2d160d4
800026.12,3.0,15,4,4,3,11,0xb2d78f2d
109007.97,2.0,60,3,3,2,8,0xb2d97c76d
611906.72,1.0,1,4,2,4,10,0xb2d6a41d
150494.67,2.0,92,3,3,1,7,0xb2d10612d
49533.5,1.0,20,2,2,2,6,0xb2d3088f
2013.74,1.0,92,1,2,1,4,0xb2d3b46bd
27261.63,1.0,1,2,2,4,8,0xb2d2d750
3490.68,1.0,20,2,2,2,6,0xb2d6b1f3
405018.92,4.0,92,4,4,1,9,0xb2d23d6c
2035.15,1.0,2,1,2,4,7,0xb2d2ce8e
769.48,1.0,73,1,2,1,4,0xb2d13f64d
6117.81,1.0,284,2,2,1,5,0xb2d68068
2371.71,1.0,92,1,2,1,4,0xb2d31dc6d
511439.3,3.0,26,4,4,2,10,0xb2d12213
42388.86,1.0,20,2,2,2,6,0xb2d5862c
1156719.4,1.0,11,4,2,3,9,0xb2d2d65a
186171.66,12.0,5,3,4,3,10,0x3b9b4896d
2.37,1.0,53,1,2,2,5,0xb2d91a21
80001.69,2.0,221,3,3,1,7,0xb2d6ffc1
1162.39,1.0,184,1,2,1,4,0xb2d0ab1a
10107.76,2.0,0,2,3,4,9,0xb2d2a01c
425.93,1.0,5,1,2,3,6,0xb2d91c9a
47136.61,4.0,6,2,4,3,9,0xb2d54e08
1014.88,1.0,92,1,2,1,4,0xb2d12b04
519471.47,8.0,1,4,4,4,12,0xb2d0d1a8d
1076.44,1.0,5,1,2,3,6,0xb2d43a68
74555.02,2.0,74,3,3,1,7,0xb2d38ac3
60000.0,2.0,0,3,3,4,10,0xb2d2f066d
640000.0,4.0,12,4,4,3,11,0xb2da40ca
50005.39,2.0,74,2,3,1,6,0xb2d282a4
10145.39,2.0,56,2,3,2,7,0xb2d9c573
36.51,1.0,42,1,2,2,5,0xb2d40983
352066.59,2.0,20,4,3,2,9,0xb2d26df0d
1209.5,1.0,49,1,2,2,5,0xb2d63391
4857000.11,11.0,0,4,4,4,12,0xb2d54c24d
69.53,1.0,56,1,2,2,5,0xb2d5b072
409995.63,10.0,20,4,4,2,10,0x3b9b12c4
1.39,1.0,65,1,2,2,5,0xb2d96c56
63890.12,2.0,118,3,3,1,7,0xb2d3a7fb
101124.05,3.0,0,3,4,4,11,0xb2d55c19
119.09,1.0,2,1,2,4,7,0xb2d20f3a
153.43,2.0,10,1,3,3,7,0xb2d6a66b
300077.82,2.0,26,3,3,2,8,0xb2d5578f
580.63,1.0,0,1,2,4,7,0xb2d39fff
76003.42,5.0,34,3,4,2,9,0xb2d40e5ed
160041.08,3.0,1,3,4,4,11,0xb2d5fbc0
2207017.94,7.0,0,4,4,4,12,0xb2d2a22e
4293.19,1.0,12,2,2,3,7,0xb2d2b789
18108.44,1.0,19,2,2,2,6,0xb2d6b453d
50053.9,2.0,133,2,3,1,6,0xb2d45c3c
40061.13,2.0,195,2,3,1,6,0xb2d12804d
2855000.9,6.0,7,4,4,3,11,0xb2d16966
51303.38,2.0,4,2,3,4,9,0xb2d41082
100.88,1.0,8,1,2,3,6,0xb2d4f142
300000.63,2.0,1,3,3,4,10,0xb2da0459
80157.78,2.0,21,3,3,2,8,0xb2d0fde7
310664.54,2.0,83,4,3,1,8,0xb2d45d0b
1590.32,1.0,1,1,2,4,7,0xb2d7ee43
500000.0,4.0,9,4,4,3,11,0xb2d410fd
8126.34,1.0,1,2,2,4,8,0xb2d5837e
207262.58,3.0,13,3,4,3,10,0xb2d645dc
5000285.57,36.0,13,4,4,3,11,0xb2d0f2d7
400538.87,4.0,48,4,4,2,10,0xb2d1a4b5
34820.67,3.0,0,2,4,4,10,0xb2d1f6ffd
20806.77,1.0,1,2,2,4,8,0xb2d1be43
50700.24,3.0,25,2,4,2,8,0xb2d5fa98
6309.8,1.0,0,2,2,4,8,0xb2d2cf3b
88067.34,2.0,97,3,3,1,7,0xb2d233d3d
901.96,1.0,49,1,2,2,5,0xb2d8f72f
90.0,1.0,50,1,2,2,5,0xb2d6be23
130878.93,6.0,0,3,4,4,11,0x3b9b45a5
300691.23,3.0,10,4,4,3,11,0xb2d7821ad
100000.0,2.0,6,3,3,3,9,0xb2da509f
305040.69,3.0,0,4,4,4,12,0xb2d52f28d
302547.35,2.0,64,4,3,2,9,0xb2d6b9f2
784.93,1.0,0,1,2,4,7,0xb2d6a4ecd
301065.63,2.0,34,4,3,2,9,0xb2d935b2d
60949.62,1.0,0,3,2,4,9,0xb2d1912b
5302.86,1.0,0,2,2,4,8,0xb2d978a1
2820194.76,3.0,3,4,4,4,12,0x3b9b1008
1843087.58,5.0,7,4,4,3,11,0xb2d25e82d
112689.39,1.0,49,3,2,2,7,0xb2d37c5b
482336.04,4.0,44,4,4,2,10,0xb2d60bac
515.59,1.0,0,1,2,4,7,0xb2d46577
150001.06,4.0,3,3,4,4,11,0xb2d9051a
2784.12,1.0,17,1,2,2,5,0xb2d3f745
996.83,1.0,24,1,2,2,5,0xb2d6e403
20269.22,1.0,8,2,2,3,7,0xb2d2dafd
221004.75,4.0,47,3,4,2,9,0xb2d65696
350025.22,3.0,1,4,4,4,12,0xb2d63ea4
291.07,1.0,0,1,2,4,7,0xb2d3654cd
48.77,1.0,3,1,2,4,7,0xb2d22b01d
440005.81,1.0,6,4,2,3,9,0xb2d93289
1603.41,1.0,245,1,2,1,4,0xb2d1a7dd
290711.14,6.0,48,3,4,2,9,0xb2d093b4d
12886.91,1.0,3,2,2,4,8,0xb2d0f869
471669.62,3.0,0,4,4,4,12,0xb2d0be2a
4997.68,1.0,2,2,2,4,8,0xb2d18d8e
901351.89,17.0,12,4,4,3,11,0xb2d17f58
31005478.75,9.0,59,4,4,2,10,0xb2d227de
500011.36,5.0,11,4,4,3,11,0xb2d155f1
1789.58,1.0,55,1,2,2,5,0xb2d12aa2
2068709.5,1.0,4,4,2,4,10,0xb2d682f2d
420731.4,1.0,1,4,2,4,10,0xb2d28db2
1977940.77,3.0,0,4,4,4,12,0xb2d27b5b
0.64,1.0,2,1,2,4,7,0xb2d31190
82476.34,4.0,18,3,4,2,9,0xb2d1c27f
571673.84,4.0,21,4,4,2,10,0xb2d0d2fbd
226.64,1.0,9,1,2,3,6,0xb2d37ca1
7712.38,1.0,38,2,2,2,6,0xb2d25becd
4842.28,1.0,0,2,2,4,8,0xb2d0ba8b
2678.47,1.0,29,1,2,2,5,0xb2d6248fd
18846.93,1.0,12,2,2,3,7,0xb2d22aa6d
220120.6,3.0,4,3,4,4,11,0xb2d17aaad
190045.79,3.0,4,3,4,4,11,0xb2d3a011d
180118.34,2.0,200,3,3,1,7,0xb2d5e95d
291342.53,3.0,0,3,4,4,11,0xb2d0aaef
231702.59,3.0,66,3,4,2,9,0x3b9b2719
32140.43,2.0,0,2,3,4,9,0x3b9b0e79
19.63,1.0,74,1,2,1,4,0xb2d8d10b
474132.5,4.0,9,4,4,3,11,0xb2d52746
1321.32,1.0,2,1,2,4,7,0xb2d6c445d
1066.26,1.0,59,1,2,2,5,0xb2d16fe2
50061.78,2.0,119,2,3,1,6,0xb2d361f6d
300003.17,2.0,41,3,3,2,8,0xb2d923ac
3297.76,1.0,44,2,2,2,6,0xb2d8db1e
100014.45,2.0,217,3,3,1,7,0xb2d146d0
843930.04,7.0,10,4,4,3,11,0xb2d24812
61697.41,1.0,184,3,2,1,6,0xb2d1f7a0
50913.16,2.0,195,2,3,1,6,0xb2d5c1c4
2201061.17,8.0,27,4,4,2,10,0xb2d1bc24d
575677.72,5.0,0,4,4,4,12,0xb2d59b1cd
235.3,1.0,1,1,2,4,7,0xb2d62a0fd
1540.01,2.0,0,1,3,4,8,0x3b9b2d70d
620058.61,2.0,126,4,3,1,8,0xb2d9322ad
54183.81,3.0,10,3,4,3,10,0xb2d928d9
203280.74,3.0,7,3,4,3,10,0xb2d5c26e
4.85,2.0,23,1,3,2,6,0x3b9b4574d
1000000.0,3.0,18,4,4,2,10,0xb2d95563
6586.75,1.0,9,2,2,3,7,0xb2d91257
435144.84,5.0,111,4,4,1,9,0xb2d63743d
4299.1,1.0,168,2,2,1,5,0xb2d27eaed
1060.27,1.0,184,1,2,1,4,0xb2d45cce
4865.85,1.0,4,2,2,4,8,0xb2d1a7c2
2485.6,1.0,0,1,2,4,7,0xb2d28543
10171.58,2.0,136,2,3,1,6,0xb2d62c9e
107.25,12.0,0,1,4,4,9,0xb2d2e8e8
81856.48,1.0,9,3,2,3,8,0xb2d2430d
2886.13,1.0,75,1,2,1,4,0xb2d1b7c7
39271.3,1.0,64,2,2,2,6,0xb2d2dc19d
120035.0,2.0,1,3,3,4,10,0xb2da5cdb
78.2,1.0,19,1,2,2,5,0xb2d38ad9
85195.34,3.0,112,3,4,1,8,0xb2d4f1be
659.78,1.0,0,1,2,4,7,0xb2d55822
50001.06,2.0,62,2,3,2,7,0xb2d6e4df
891650.88,6.0,6,4,4,3,11,0xb2d270c0
1667.91,1.0,42,1,2,2,5,0xb2d61c1c
60002.26,2.0,28,3,3,2,8,0xb2d4116c
202131.86,2.0,4,3,3,4,10,0xb2d79013
292.92,1.0,43,1,2,2,5,0xb2d25d7a
742.8,1.0,61,1,2,2,5,0xb2d31a8b
3001.11,1.0,44,2,2,2,6,0xb2d8c63e
4752.83,1.0,3,2,2,4,8,0xb2d4dd54
197069.34,2.0,179,3,3,1,7,0xb2d59a07
2009.97,1.0,184,1,2,1,4,0xb2d303fbd
252231.13,3.0,76,3,4,1,8,0xb2d0adb0
36878.8,1.0,18,2,2,2,6,0xb2d6c4c1d
104001.1,4.0,34,3,4,2,9,0xb2d6911d
224606.52,2.0,24,3,3,2,8,0xb2d28473d
509228.48,2.0,11,4,3,3,10,0xb2d56237
53.31,1.0,62,1,2,2,5,0xb2d20f08
44.33,1.0,18,1,2,2,5,0xb2da09fa
21870.08,1.0,0,2,2,4,8,0xb2d6b5ee
1973.68,1.0,92,1,2,1,4,0xb2d26db1d
300078.42,2.0,12,3,3,3,9,0xb2d6cd0b
650000.53,3.0,4,4,4,4,12,0xb2d6f298
100268.16,2.0,129,3,3,1,7,0xb2d13e20
7565.45,1.0,21,2,2,2,6,0xb2d13c2b
52570.6,3.0,2,3,4,4,11,0x3b9af105
69.64,1.0,6,1,2,3,6,0xb2d89039
5835.99,1.0,18,2,2,2,6,0xb2d24f3dd
10000.21,2.0,214,2,3,1,6,0xb2d7656c
2312.89,1.0,13,1,2,3,6,0xb2d22e50
2042.3,1.0,184,1,2,1,4,0xb2d155b8
200000.84,2.0,4,3,3,4,10,0xb2d6a9b5
8000.0,2.0,184,2,3,1,6,0xb2d65bbf
4057.6,1.0,0,2,2,4,8,0xb2d24046d
1517.0,1.0,184,1,2,1,4,0xb2d10c93
4.7,2.0,61,1,3,2,6,0x3b9b2cc1d
7414.86,1.0,47,2,2,2,6,0xb2d3d84a
1001157.82,2.0,15,4,3,3,10,0xb2d919f4
86.38,1.0,16,1,2,2,5,0xb2d24907
33517.9,1.0,2,2,2,4,8,0xb2d6bd04d
400008.44,2.0,32,4,3,2,9,0xb2da01bb
0.0,1.0,67,1,2,1,4,0xb2d92ef0
8.45,1.0,50,1,2,2,5,0xb2d5d18f
9485.67,1.0,19,2,2,2,6,0xb2d29f76
3868.51,1.0,0,2,2,4,8,0xb2d6acaa
6159.79,1.0,0,2,2,4,8,0xb2d211b8d
1933771.15,6.0,9,4,4,3,11,0xb2d3336d
37614.76,1.0,0,2,2,4,8,0xb2d69739d
232130.12,6.0,0,3,4,4,11,0xb2d5c30bd
2741.42,2.0,300,1,3,1,5,0xb2d0ca40
26802.61,1.0,9,2,2,3,7,0xb2d456e8
839448.39,6.0,25,4,4,2,10,0xb2d33eef
43.81,1.0,42,1,2,2,5,0xb2d8f9f2
606492.96,4.0,40,4,4,2,10,0xb2d20632
85893.7,7.0,0,3,4,4,11,0xb2d8ea96d
70688.07,4.0,53,3,4,2,9,0xb2d66773
309759.36,2.0,4,4,3,4,11,0xb2d6a76b
404086.4,2.0,9,4,3,3,10,0xb2d7fc86d
229132.77,3.0,1,3,4,4,11,0xb2d1959b
60001.9,2.0,80,3,3,1,7,0xb2d98995
74489.88,3.0,11,3,4,3,10,0xb2d95d31
1640094.61,4.0,1,4,4,4,12,0xb2d239fdd
0.53,1.0,8,1,2,3,6,0xb2d6cb35
515064.87,4.0,39,4,4,2,10,0xb2d41670
100141.18,2.0,89,3,3,1,7,0xb2d1143cd
3675.84,1.0,26,2,2,2,6,0xb2d2c399
4378.48,1.0,14,2,2,3,7,0xb2d5d765d
6344.68,1.0,4,2,2,4,8,0xb2d19ba2d
508885.67,2.0,37,4,3,2,9,0xb2d6d768d
90935.66,2.0,189,3,3,1,7,0xb2d2b4c1d
467398.93,4.0,28,4,4,2,10,0xb2d6be64
202132.19,2.0,83,3,3,1,7,0xb2d95439
227349.39,2.0,36,3,3,2,8,0xb2d0e7cd
6033.37,1.0,7,2,2,3,7,0xb2d90862d
10002.96,1.0,28,2,2,2,6,0xb2d93776
180257.03,2.0,193,3,3,1,7,0xb2d44078d
4000.75,1.0,0,2,2,4,8,0xb2d27368
270056.49,3.0,60,3,4,2,9,0xb2d0e9f1
500000.0,3.0,2,4,4,4,12,0xb2d9b418
12461.69,1.0,20,2,2,2,6,0xb2d8f739d
120201.55,2.0,0,3,3,4,10,0xb2d41e63d
40004.71,2.0,14,2,3,3,8,0xb2da1f39
17448.04,1.0,20,2,2,2,6,0xb2d6f5b0
20198.76,2.0,143,2,3,1,6,0xb2d57eca
3573.81,1.0,5,2,2,3,7,0xb2d5bce0
1015.45,1.0,184,1,2,1,4,0xb2d14da3d
1870.05,2.0,184,1,3,1,5,0xb2d391ce
1014.81,1.0,92,1,2,1,4,0xb2d10086d
578012.99,9.0,14,4,4,3,11,0xb2d5866e
0.0,1.0,5,1,2,3,6,0xb2da5d11
614029.02,3.0,6,4,4,3,11,0xb2d5ad87d
1300.81,1.0,0,1,2,4,7,0xb2d0acc2
208224.68,2.0,103,3,3,1,7,0xb2d5f2c3
31.93,1.0,47,1,2,2,5,0xb2d41c6f
13484.41,1.0,8,2,2,3,7,0xb2d31069
300000.0,2.0,21,3,3,2,8,0xb2d9524c
153651.93,3.0,3,3,4,4,11,0xb2d3c53a
525008.15,3.0,5,4,4,3,11,0xb2d66385
7308.51,1.0,0,2,2,4,8,0xb2d5be49
1324333.32,2.0,0,4,3,4,11,0xb2d6006a
124652.71,2.0,0,3,3,4,10,0xb2d210dd
29071.31,1.0,125,2,2,1,5,0xb2d28066d
336.09,1.0,20,1,2,2,5,0xb2d1b1d8
20.15,1.0,16,1,2,2,5,0xb2d8b2dd
346069.05,5.0,11,4,4,3,11,0xb2d60dbc
166.39,1.0,0,1,2,4,7,0xb2d6c01e
184074.71,1.0,25,3,2,2,7,0xb2d7546d
263008.85,2.0,39,3,3,2,8,0xb2d5bca5d
200964.02,2.0,23,3,3,2,8,0xb2d97ebe
152358.79,4.0,80,3,4,1,8,0xb2d5cbe4
42.32,1.0,8,1,2,3,6,0xb2d6e1ea
60437.73,1.0,4,3,2,4,9,0xb2d8d4e2d
2541.74,1.0,0,1,2,4,7,0xb2d6bb4f
43880.12,1.0,2,2,2,4,8,0xb2d68922
96330.03,1.0,0,3,2,4,9,0xb2d0f3a5
6486.5,1.0,0,2,2,4,8,0xb2d34357
650014.79,4.0,21,4,4,2,10,0xb2d3a0b9d
3134.71,1.0,0,2,2,4,8,0xb2d6b5a8d
410222.39,2.0,120,4,3,1,8,0xb2d5a943
638143.02,5.0,70,4,4,1,9,0xb2d57396
3546.81,1.0,3,2,2,4,8,0xb2d43be4
160023.58,3.0,168,3,4,1,8,0xb2d17b8c
89.33,1.0,0,1,2,4,7,0xb2d249bd
1719.21,2.0,1,1,3,4,8,0xb2d0852c
1270001.07,12.0,1,4,4,4,12,0xb2d11406
150004.75,2.0,53,3,3,2,8,0xb2d9c9a6
41410.2,1.0,21,2,2,2,6,0xb2d5dbb3d
100246.54,2.0,69,3,3,1,7,0xb2d3d4da
50.58,1.0,60,1,2,2,5,0xb2d505cfd
44521.51,1.0,10,2,2,3,7,0xb2d5e781
85057.54,3.0,0,3,4,4,11,0xb2d11833
200121.1,2.0,19,3,3,2,8,0xb2d98c0f
50522.72,1.0,3,2,2,4,8,0xb2d3a3bd
70019.48,2.0,130,3,3,1,7,0xb2d57f5d
400000.0,3.0,0,4,4,4,12,0xb2d927f5
169.33,1.0,9,1,2,3,6,0xb2d63b73d
171452.96,4.0,92,3,4,1,8,0xb2d6b202d
700106.1,3.0,6,4,4,3,11,0xb2d96ec3
133022.01,3.0,0,3,4,4,11,0x3b9b41d2
125.03,2.0,10,1,3,3,7,0xb2d1815b
416582.53,18.0,1,4,4,4,12,0xb2d45df2
281484.71,3.0,0,3,4,4,11,0xb2d5a0f0
44050.86,3.0,19,2,4,2,8,0xb2d61884
253065.36,2.0,103,3,3,1,7,0xb2d968d0
15000.27,2.0,64,2,3,2,7,0xb2d60de6
5348.22,1.0,6,2,2,3,7,0xb2d2f8f7
6512.34,1.0,8,2,2,3,7,0xb2d8b1f3
875385.63,4.0,110,4,4,1,9,0xb2d2c920
206444.4,1.0,15,3,2,3,8,0xb2d1dfce
6272.56,1.0,0,2,2,4,8,0xb2d5570d
600101.0,3.0,7,4,4,3,11,0xb2d96fb1
230015.53,4.0,39,3,4,2,9,0xb2d8cd8c
319.05,1.0,4,1,2,4,7,0xb2d996ae
2.28,1.0,7,1,2,3,6,0xb2d5bd67
35.9,1.0,61,1,2,2,5,0xb2d36f06
200752.31,2.0,33,3,3,2,8,0xb2d6d725d
177054.15,2.0,228,3,3,1,7,0xb2d39a51d
1350000.0,2.0,6,4,3,3,10,0xb2d96fbbd
105497.76,2.0,21,3,3,2,8,0xb2d4e1b2d
190654.04,1.0,1,3,2,4,9,0xb2d28971d
616407.95,3.0,80,4,4,1,9,0xb2d32bff
6797.51,1.0,24,2,2,2,6,0xb2d990fe
500000.0,2.0,110,4,3,1,8,0xb2d5cc93
15124.35,1.0,184,2,2,1,5,0xb2d12219d
450010.77,4.0,13,4,4,3,11,0xb2da0a4c
160812.94,3.0,69,3,4,1,8,0xb2d41f5f
14981.08,1.0,28,2,2,2,6,0xb2d1d6c1
55671.59,2.0,70,3,3,1,7,0xb2d08661
701247.92,3.0,19,4,4,2,10,0xb2d6b48dd
466660.21,2.0,154,4,3,1,8,0xb2d5b84f
88.81,1.0,54,1,2,2,5,0xb2d333c2
112.87,1.0,6,1,2,3,6,0xb2d788e1
567.68,1.0,10,1,2,3,6,0xb2d8fe6b
260002.74,2.0,210,3,3,1,7,0xb2d781e9
400021.98,3.0,13,4,4,3,11,0xb2d17a4f
1813.92,1.0,17,1,2,2,5,0xb2d757a8
14321.94,1.0,2,2,2,4,8,0xb2d230ca
820111.26,5.0,70,4,4,1,9,0xb2d3600d
257450.89,3.0,67,3,4,1,8,0xb2d6427d
640.32,1.0,8,1,2,3,6,0xb2d62cd3
23.6,1.0,28,1,2,2,5,0xb2d57995
194.31,1.0,13,1,2,3,6,0xb2d8e9fbd
9101.12,1.0,184,2,2,1,5,0xb2d30617
2519.11,1.0,184,1,2,1,4,0xb2d2eb9d
1140012.04,3.0,112,4,4,1,9,0xb2d17944
390470.88,9.0,41,4,4,2,10,0xb2d5bba5
60.96,2.0,1,1,3,4,8,0xb2d49c7dd
89.01,1.0,267,1,2,1,4,0xb2d272cb
12990.85,1.0,10,2,2,3,7,0xb2d3ea2e
60403.19,3.0,69,3,4,1,8,0xb2d2b316d
383.46,1.0,9,1,2,3,6,0xb2d53171
45001.43,2.0,185,2,3,1,6,0xb2d6aba5
400001.19,6.0,61,4,4,2,10,0xb2d3516cd
47366.27,1.0,4,2,2,4,8,0xb2d903ae
50113.34,2.0,20,2,3,2,7,0xb2d402af
390277.77,1.0,162,4,2,1,7,0xb2d6bc71
108070.0,2.0,1,3,3,4,10,0xb2d4f52f
10000.23,2.0,83,2,3,1,6,0xb2d62e96
3929.08,1.0,120,2,2,1,5,0xb2d5a648d
300082.62,2.0,221,3,3,1,7,0xb2d55451
3664.98,1.0,93,2,2,1,5,0xb2d3ecd4
6961.48,1.0,0,2,2,4,8,0xb2d53034
221563.09,2.0,61,3,3,2,8,0xb2d9bf0e
44.41,1.0,52,1,2,2,5,0xb2d08888
153403.05,1.0,0,3,2,4,9,0xb2d43675
10013.93,1.0,34,2,2,2,6,0xb2d331e0d
1036.26,2.0,6,1,3,3,7,0x3b9b3a65
1204.7,1.0,77,1,2,1,4,0xb2d26ddb
350075.9,3.0,18,4,4,2,10,0xb2d697a5
9062.52,1.0,6,2,2,3,7,0xb2d88bd7
10000.05,2.0,92,2,3,1,6,0xb2d65916d
477469.96,4.0,10,4,4,3,11,0xb2d52746d
1.16,1.0,123,1,2,1,4,0xb2d59a12
60663.78,4.0,5,3,4,3,10,0xb2d67cead
154296.34,3.0,10,3,4,3,10,0xb2d09052
530008.73,4.0,55,4,4,2,10,0xb2d40f29
150005.46,2.0,31,3,3,2,8,0xb2d31357
1.11,1.0,92,1,2,1,4,0xb2d2a02f
500000.0,1.0,1,4,2,4,10,0xb2d9cb4c
61760.23,1.0,0,3,2,4,9,0xb2d50946
5546.2,1.0,0,2,2,4,8,0xb2d1a3e8d
374260.26,5.0,22,4,4,2,10,0xb2d4a91b
290064.18,3.0,14,3,4,3,10,0xb2d1df54
301930.41,5.0,1,4,4,4,12,0xb2d11b86d
143855.92,3.0,32,3,4,2,9,0xb2d6945dd
360081.13,4.0,168,4,4,1,9,0xb2d35396
94016.12,5.0,46,3,4,2,9,0xb2d57deb
86.5,1.0,0,1,2,4,7,0xb2d2eb25
466736.86,6.0,0,4,4,4,12,0x3b9b3bb3
3292.37,1.0,10,2,2,3,7,0xb2d2b17c
598003.38,5.0,3,4,4,4,12,0xb2d4cbe4
401624.75,2.0,6,4,3,3,10,0xb2d62232
8694.06,12.0,102,2,4,1,7,0xb2d1b021
252868.67,1.0,0,3,2,4,9,0xb2d28b8b
1202.45,1.0,92,1,2,1,4,0xb2d13f3d
50148.36,1.0,7,2,2,3,7,0xb2d67f16
2795.9,1.0,4,1,2,4,7,0xb2d617e3
9014.3,1.0,9,2,2,3,7,0xb2d5a97bd
2108299.96,6.0,76,4,4,1,9,0xb2d4fe3e
896.86,1.0,10,1,2,3,6,0xb2d6d62e
1000000.0,6.0,6,4,4,3,11,0xb2d78dc7
490070.21,4.0,18,4,4,2,10,0xb2d6daad
10000.11,2.0,18,2,3,2,7,0xb2d9a005
1.38,1.0,1,1,2,4,7,0xb2d90b3f
197.07,1.0,9,1,2,3,6,0xb2d57bf6
1401.12,1.0,8,1,2,3,6,0xb2d4bc48d
530.05,1.0,10,1,2,3,6,0xb2d27666
215056.38,5.0,35,3,4,2,9,0xb2d92a4f
101533.95,3.0,7,3,4,3,10,0x3b9b45ce
2872.87,1.0,10,1,2,3,6,0xb2d277a7d
461.44,1.0,146,1,2,1,4,0xb2d5d09ad
7824.14,1.0,28,2,2,2,6,0xb2d58bf4
111952.16,2.0,13,3,3,3,9,0xb2d549a6d
374609.24,4.0,25,4,4,2,10,0xb2d5c1ced
1229.22,2.0,92,1,3,1,5,0x3b9acc6cd
41004.21,3.0,95,2,4,1,7,0xb2d1c806
101627.71,1.0,1,3,2,4,9,0xb2d205c1d
26648.78,1.0,0,2,2,4,8,0xb2d1aec2d
40000.47,5.0,91,2,4,1,7,0xb2d782de
18982.38,1.0,77,2,2,1,5,0xb2d552c3
80926.79,2.0,74,3,3,1,7,0xb2d78246
100017.36,2.0,249,3,3,1,7,0xb2d38743
56108.83,1.0,77,3,2,1,6,0xb2d1db77d
500097.05,2.0,94,4,3,1,8,0xb2d4f2b2
732785.71,5.0,3,4,4,4,12,0xb2d15422
1588.26,1.0,184,1,2,1,4,0xb2d0730a
664479.58,3.0,2,4,4,4,12,0xb2d117de
4542.14,1.0,5,2,2,3,7,0xb2d2f9d8d
3364.58,1.0,184,2,2,1,5,0xb2d4013f
2697.69,1.0,92,1,2,1,4,0xb2d52cda
10600.93,1.0,92,2,2,1,5,0xb2d20306
50098.93,2.0,41,2,3,2,7,0xb2d56412
2001.73,1.0,92,1,2,1,4,0xb2d6db3a
10041.12,2.0,25,2,3,2,7,0xb2d78581
687.26,1.0,10,1,2,3,6,0xb2d6b7f4
370.89,1.0,10,1,2,3,6,0xb2d6b1ca
217000.0,4.0,3,3,4,4,11,0xb2d968fa
10493.99,2.0,188,2,3,1,6,0xb2d2dce5
1160000.42,10.0,1,4,4,4,12,0xb2d4a33d
6.71,1.0,77,1,2,1,4,0xb2d6b5f6
204092.44,3.0,31,3,4,2,9,0xb2d5c49a
5044.89,1.0,92,2,2,1,5,0xb2d2df50
28.94,1.0,5,1,2,3,6,0xb2d698d4
1.21,3.0,1,1,4,4,9,0xb2d11876d
202880.63,2.0,22,3,3,2,8,0xb2d1b483
2680.05,1.0,184,1,2,1,4,0xb2d1e2a9d
1010095.79,8.0,87,4,4,1,9,0xb2d09466d
280557.57,6.0,73,3,4,1,8,0xb2d2be18
2.54,1.0,10,1,2,3,6,0xb2d94e91
1210.99,1.0,5,1,2,3,6,0xb2d9ae38
4537.0,1.0,88,2,2,1,5,0xb2d240c5d
200000.03,2.0,5,3,3,3,9,0xb2da47a1
2942.08,2.0,29,2,3,2,7,0xb2d97ee1
90767.42,3.0,0,3,4,4,11,0xb2d5e673
2171.91,1.0,0,1,2,4,7,0xb2d1f7b6
5.93,1.0,45,1,2,2,5,0xb2d59706
6.17,1.0,61,1,2,2,5,0xb2d2ea30
80574.93,3.0,11,3,4,3,10,0xb2d8d194
80140.73,4.0,104,3,4,1,8,0xb2d0aa7b
622.07,1.0,9,1,2,3,6,0xb2d6bf61
90006.02,3.0,67,3,4,1,8,0xb2d5fe7d
250002.12,3.0,10,3,4,3,10,0xb2d95126
180009.98,6.0,38,3,4,2,9,0xb2d29869
10121.55,2.0,55,2,3,2,7,0xb2d63305
10020753.74,1.0,33,4,2,2,8,0xb2d6009a
405387.82,6.0,0,4,4,4,12,0x3b9b1a44
100078.45,2.0,6,3,3,3,9,0xb2d56abad
12.44,1.0,1,1,2,4,7,0xb2d47003
5337.22,1.0,187,2,2,1,5,0xb2d5c523
811280.2,2.0,122,4,3,1,8,0xb2d45871d
57.48,1.0,184,1,2,1,4,0xb2d23042
15390.68,1.0,41,2,2,2,6,0xb2d6b5f4
313.38,1.0,1,1,2,4,7,0xb2d51b8ad
200774.54,2.0,25,3,3,2,8,0xb2d0cfe9
72034.82,2.0,22,3,3,2,8,0xb2d1b6bad
48.2,1.0,1,1,2,4,7,0xb2d453a1
4735.24,1.0,184,2,2,1,5,0xb2d1cb8d
3902.53,4.0,0,2,4,4,10,0xb2d06774
5900.56,1.0,184,2,2,1,5,0xb2d0b90a
4570.83,1.0,0,2,2,4,8,0xb2d51b5fd
36729.82,1.0,1,2,2,4,8,0xb2d1aa8f
11001.99,1.0,1,2,2,4,8,0xb2d3519f
136923.32,3.0,10,3,4,3,10,0xb2d12340
260070.92,2.0,0,3,3,4,10,0xb2d97214
31941.64,1.0,31,2,2,2,6,0xb2d9a504
11919.66,1.0,8,2,2,3,7,0xb2d97e68
350011.04,4.0,13,4,4,3,11,0xb2d56258
5668.28,6.0,0,2,4,4,10,0x3b9b4698d
242000.0,16.0,1,3,4,4,11,0xb2d297ab
42.21,1.0,3,1,2,4,7,0xb2d53b1a
207024.96,2.0,104,3,3,1,7,0xb2d25f25
1449.52,1.0,0,1,2,4,7,0xb2d5c36c
1375.41,3.0,0,1,4,4,9,0xb2d0a750d
560086.88,4.0,25,4,4,2,10,0xb2d07bb9
200359.5,3.0,70,3,4,1,8,0xb2d6410f
34.0,1.0,2,1,2,4,7,0xb2d8ce33
1368.8,1.0,9,1,2,3,6,0xb2d3b4f0d
58.76,1.0,47,1,2,2,5,0xb2d23179
0.0,1.0,4,1,2,4,7,0xb2da5b83
3375.07,1.0,0,2,2,4,8,0xb2d5b839
367650.58,9.0,4,4,4,4,12,0xb2d41456
25547.01,1.0,0,2,2,4,8,0xb2d9285f
56527.5,2.0,20,3,3,2,8,0xb2d15d1ed
472.78,1.0,2,1,2,4,7,0xb2d6c024
21211.82,1.0,3,2,2,4,8,0xb2d43215
20100.94,2.0,98,2,3,1,6,0xb2d18badd
351125.28,3.0,40,4,4,2,10,0xb2d3ade8
100328.41,2.0,94,3,3,1,7,0xb2d69c50
450015.31,2.0,11,4,3,3,10,0xb2d9ae7a
50001.58,2.0,193,2,3,1,6,0xb2d7fc84
276480.37,3.0,73,3,4,1,8,0xb2d2b32a
206007.98,5.0,2,3,4,4,11,0xb2d1b946
2350.29,1.0,12,1,2,3,6,0xb2d30f6e
150119.63,2.0,0,3,3,4,10,0x3b9b38b3
159287.85,1.0,67,3,2,1,6,0xb2d4f120d
50002.96,2.0,102,2,3,1,6,0xb2d90b8e
550854.43,5.0,41,4,4,2,10,0xb2d313e8d
100004.88,3.0,80,3,4,1,8,0x3b9b32add
60000.64,3.0,21,3,4,2,9,0xb2d9d0c6
636327.53,12.0,0,4,4,4,12,0xb2d0b357d
100.97,1.0,298,1,2,1,4,0xb2d484e4d
194825.84,7.0,8,3,4,3,10,0xb2d0da05
1787329.17,3.0,4,4,4,4,12,0xb2d6ac72d
503.03,1.0,1,1,2,4,7,0xb2d6588c
50627.86,1.0,4,2,2,4,8,0xb2da2cc6
8597.69,1.0,15,2,2,3,7,0xb2d37cf5
2.11,1.0,77,1,2,1,4,0xb2d2e0e8
558800.9,3.0,0,4,4,4,12,0xb2d6b289d
77.95,1.0,4,1,2,4,7,0xb2d251ee
280000.0,2.0,8,3,3,3,9,0xb2d6a79ed
458238.73,3.0,87,4,4,1,9,0xb2d12c33
234017.92,2.0,109,3,3,1,7,0xb2d2919f
140020.96,3.0,69,3,4,1,8,0xb2d2c8af
19398.9,1.0,4,2,2,4,8,0xb2d23ac5d
400045.97,2.0,15,4,3,3,10,0xb2d6f741
26033.68,3.0,17,2,4,2,8,0xb2d24de2d
986.84,1.0,6,1,2,3,6,0xb2d7774d
1000000.0,2.0,0,4,3,4,11,0xb2d982dd
30063.63,2.0,189,2,3,1,6,0xb2d56e6f
5.21,1.0,45,1,2,2,5,0xb2d3940f
60737.3,1.0,0,3,2,4,9,0xb2d63b2c
468.03,1.0,10,1,2,3,6,0xb2d7760f
220021.78,4.0,11,3,4,3,10,0xb2d64f32
450029.64,3.0,18,4,4,2,10,0xb2d0ac0ad
2031.66,1.0,221,1,2,1,4,0xb2d4ce43d
7913.28,1.0,92,2,2,1,5,0xb2d60e3dd
50830.22,2.0,6,2,3,3,8,0xb2d2a081
3938.02,1.0,6,2,2,3,7,0xb2d2e17d
10090.5,1.0,184,2,2,1,5,0xb2d21a4ad
2199.42,2.0,184,1,3,1,5,0xb2d094c6
2206.46,1.0,190,1,2,1,4,0xb2d49276d
600098.72,2.0,4,4,3,4,11,0xb2d36bd4d
16605.9,1.0,0,2,2,4,8,0xb2d6cf39d
648418.67,10.0,3,4,4,4,12,0xb2d5b6d2d
410028.8,5.0,1,4,4,4,12,0xb2d921bd
880032.82,7.0,0,4,4,4,12,0xb2d138c8
155.48,1.0,6,1,2,3,6,0xb2d52665
371008.52,6.0,6,4,4,3,11,0xb2d58677d
50243.48,2.0,95,2,3,1,6,0xb2d29bd9
500019.18,5.0,4,4,4,4,12,0xb2d1bc45
955121.71,6.0,4,4,4,4,12,0xb2d09a94
10309.62,1.0,112,2,2,1,5,0xb2d5a2bfd
41407.26,1.0,9,2,2,3,7,0xb2d4b2f9
550033.31,3.0,101,4,4,1,9,0xb2d62deb
371233.53,12.0,0,4,4,4,12,0xb2d25fe0d
210000.0,2.0,12,3,3,3,9,0xb2da48c1
480357.65,2.0,0,4,3,4,11,0xb2d5be57
1206.58,1.0,92,1,2,1,4,0xb2d35024
70379.52,3.0,97,3,4,1,8,0xb2d58b53
66085.49,1.0,0,3,2,4,9,0xb2d47e47
73440.56,1.0,3,3,2,4,9,0xb2d50c01d
3757.49,1.0,0,2,2,4,8,0xb2d915eb
81072.99,2.0,228,3,3,1,7,0xb2d56e5ad
5268.63,2.0,0,2,3,4,9,0xb2d5d3e7d
98.54,1.0,48,1,2,2,5,0xb2d23caf
520018.54,4.0,4,4,4,4,12,0xb2d66385d
1073.07,1.0,167,1,2,1,4,0xb2d55fca
1900048.86,3.0,1,4,4,4,12,0xb2d6b1f9
496573.67,15.0,3,4,4,4,12,0xb2d4d1aad
14409.06,2.0,12,2,3,3,8,0x3b9af594
175.36,1.0,9,1,2,3,6,0xb2d7826a
90159.68,2.0,6,3,3,3,9,0xb2d9d311
15300.71,1.0,168,2,2,1,5,0xb2d62b20
200710.49,2.0,49,3,3,2,8,0xb2d913cfd
10777.34,12.0,0,2,4,4,10,0x3b9b17f8
1088.09,1.0,10,1,2,3,6,0xb2d6f2a7
16902.29,1.0,0,2,2,4,8,0xb2d451b6d
934654.73,4.0,4,4,4,4,12,0xb2d5e759
2757.63,1.0,184,1,2,1,4,0xb2d3a7b1d
328.81,1.0,0,1,2,4,7,0xb2d33de8
900000.0,2.0,0,4,3,4,11,0xb2d9fd87
757052.63,6.0,0,4,4,4,12,0xb2d185d5
17.07,1.0,68,1,2,1,4,0xb2d28607d
204147.7,2.0,41,3,3,2,8,0xb2d2af4d
3918.57,1.0,0,2,2,4,8,0xb2d912c4
617054.39,12.0,1,4,4,4,12,0xb2d2d4e2
107032.66,2.0,140,3,3,1,7,0xb2d3bf70d
10353.61,1.0,21,2,2,2,6,0xb2d69560d
80911.73,1.0,0,3,2,4,9,0xb2d91db6
71204.95,1.0,0,3,2,4,9,0xb2d8d3ab
38010.99,4.0,1,2,4,4,10,0xb2d6ab1d
833343.74,17.0,6,4,4,3,11,0xb2d65a3bd
38899.29,2.0,0,2,3,4,9,0x3b9b1c01
134.54,3.0,6,1,4,3,8,0xb2d5a494d
71300.49,1.0,0,3,2,4,9,0xb2d622aed
74.98,1.0,57,1,2,2,5,0xb2d8249f
13332.2,5.0,53,2,4,2,8,0xb2d22f85d
350031.7,2.0,9,4,3,3,10,0xb2d58ba1
31.16,1.0,57,1,2,2,5,0xb2d6f727
1847343.12,6.0,3,4,4,4,12,0xb2d41011
933902.84,4.0,83,4,4,1,9,0xb2d31104
20267.86,3.0,73,2,4,1,7,0xb2d4e8e7d
995150.38,6.0,36,4,4,2,10,0xb2d1733cd
26769.1,1.0,19,2,2,2,6,0xb2d68c59d
977010.12,4.0,80,4,4,1,9,0xb2d2a27bd
40001.06,2.0,25,2,3,2,7,0xb2d93ba3
6769705.79,6.0,0,4,4,4,12,0xb2d0a63d
3000107.52,2.0,26,4,3,2,9,0xb2d8c622
0.0,1.0,5,1,2,3,6,0xb2d30c62
5555.18,1.0,7,2,2,3,7,0xb2d0ef86
1406067.57,2.0,6,4,3,3,10,0x3b9ae86f
403555.71,3.0,19,4,4,2,10,0xb2d595b4
1062.71,2.0,92,1,3,1,5,0xb2d2776f
7046.4,1.0,13,2,2,3,7,0xb2da0f3e
11641.11,1.0,23,2,2,2,6,0xb2d94702
210018.32,2.0,119,3,3,1,7,0xb2d55435
5736.04,1.0,0,2,2,4,8,0xb2d3725c
324592.22,3.0,3,4,4,4,12,0xb2d62638
1038166.41,2.0,92,4,3,1,8,0xb2d594c4
94540.72,2.0,0,3,3,4,10,0xb2d98641
60630.75,2.0,4,3,3,4,10,0xb2d4ead8
11853.3,1.0,1,2,2,4,8,0xb2d6a79b
515000.48,14.0,4,4,4,4,12,0xb2d4205e
113.34,2.0,56,1,3,2,6,0xb2d3eb5a
26.4,1.0,59,1,2,2,5,0xb2d785d8
1001.41,1.0,41,1,2,2,5,0xb2d91fb8d
60719.84,2.0,1,3,3,4,10,0xb2d28308
31.82,1.0,27,1,2,2,5,0xb2d38519
501.09,1.0,15,1,2,3,6,0xb2d27d53
118.87,1.0,9,1,2,3,6,0xb2d4facd
160067.06,3.0,179,3,4,1,8,0xb2d55e0d
146.08,1.0,0,1,2,4,7,0xb2d3491c
130000.0,2.0,9,3,3,3,9,0xb2d57d0d
350308.81,2.0,0,4,3,4,11,0xb2d223f3d
60761.03,2.0,98,3,3,1,7,0xb2d6cf1b
100000.0,1.0,4,3,2,4,9,0xb2da6149
16.25,1.0,0,1,2,4,7,0xb2d259d4
353782.64,2.0,196,4,3,1,8,0xb2d2a602
40537.84,5.0,1,2,4,4,10,0xb2d60034d
68.42,1.0,7,1,2,3,6,0xb2d8a668
0.23,1.0,25,1,2,2,5,0xb2d5f57b
120867.84,1.0,24,3,2,2,7,0xb2d37f69
790.9,2.0,69,1,3,1,5,0xb2d41186
869519.16,8.0,4,4,4,4,12,0xb2d6def8d
180006.75,5.0,11,3,4,3,10,0xb2d6fc05
160008.55,3.0,83,3,4,1,8,0xb2d96dba
49.4,1.0,25,1,2,2,5,0xb2d7939e
7086.15,1.0,92,2,2,1,5,0xb2d1ba80
51381.38,2.0,91,2,3,1,6,0xb2d34151
7026.97,1.0,5,2,2,3,7,0xb2d0d5b8
190006.02,2.0,31,3,3,2,8,0xb2d93623
970016.93,4.0,87,4,4,1,9,0xb2d5a5af
447010.3,4.0,14,4,4,3,11,0xb2d53c5c
753.9,1.0,25,1,2,2,5,0xb2d5f55f
400004.22,2.0,137,4,3,1,8,0xb2d91d5f
20263.85,2.0,5,2,3,3,8,0xb2d64552d
11095.73,2.0,5,2,3,3,8,0xb2d59927
103000.0,5.0,0,3,4,4,11,0xb2d1b40d
22000.23,2.0,98,2,3,1,6,0xb2d9701dd
400773.23,4.0,10,4,4,3,11,0xb2d6881d
3304.77,1.0,32,2,2,2,6,0xb2d9a419
941960.03,18.0,18,4,4,2,10,0xb2d1aebdd
21991.74,1.0,29,2,2,2,6,0xb2d23a8d
0.73,1.0,17,1,2,2,5,0xb2d18357d
1062619.16,6.0,0,4,4,4,12,0x3b9b0fcad
416192.47,3.0,8,4,4,3,11,0xb2d0bc69
709072.96,3.0,0,4,4,4,12,0xb2d0d560
19.78,1.0,39,1,2,2,5,0xb2d6ccde
3021316.64,4.0,13,4,4,3,11,0xb2d8e4b8d
285089.97,7.0,0,3,4,4,11,0xb2d383bb
344099.78,2.0,6,4,3,3,10,0xb2d2918f
53005.67,2.0,144,3,3,1,7,0xb2d3ba0ad
206080.13,6.0,0,3,4,4,11,0xb2d5a964d
753201.16,5.0,78,4,4,1,9,0xb2d1a422
528714.73,15.0,11,4,4,3,11,0xb2d58f42d
785612.33,2.0,1,4,3,4,11,0xb2d635b8
990.6,1.0,0,1,2,4,7,0xb2d6a402
14.97,2.0,69,1,3,1,5,0xb2d5ee37
1056.53,1.0,92,1,2,1,4,0xb2d17c56
213439.91,6.0,8,3,4,3,10,0xb2d1b630
80052.01,2.0,161,3,3,1,7,0xb2d6bb3a
211559.11,2.0,4,3,3,4,10,0xb2d4207cd
1408.26,1.0,1,1,2,4,7,0xb2d368b8
300344.43,2.0,49,4,3,2,9,0xb2d8e1a4
693.28,1.0,0,1,2,4,7,0xb2d6af2fd
24.38,1.0,82,1,2,1,4,0xb2d6f4f3
225001.65,2.0,10,3,3,3,9,0xb2d591c5
175073.36,3.0,31,3,4,2,9,0xb2d29626
200710.52,2.0,54,3,3,2,8,0xb2d9d059
550362.73,10.0,4,4,4,4,12,0xb2d68bdb
20201358.64,2.0,112,4,3,1,8,0xb2d68076d
2.14,1.0,27,1,2,2,5,0xb2d6ddd4
50000.53,3.0,13,2,4,3,9,0xb2da11e7
2052.22,1.0,92,1,2,1,4,0xb2d1836ed
923.57,1.0,1,1,2,4,7,0xb2d37b52d
10.56,1.0,60,1,2,2,5,0xb2d983ce
278022.71,3.0,19,3,4,2,9,0xb2d171e7
826.04,1.0,1,1,2,4,7,0xb2d6156b
199094.53,2.0,8,3,3,3,9,0xb2d2b3f5
28811.2,2.0,10,2,3,3,8,0xb2d6f487
96851.68,1.0,92,3,2,1,6,0xb2d55c8b
700092.56,11.0,3,4,4,4,12,0xb2d4a3e4
98.68,1.0,17,1,2,2,5,0xb2d2989a
2197324.91,24.0,0,4,4,4,12,0xb2d60dc1
337.32,1.0,9,1,2,3,6,0xb2d2bdbd
9130.4,3.0,13,2,4,3,9,0xb2d41a7bd
1122107.74,7.0,46,4,4,2,10,0xb2d2a616
963.87,1.0,5,1,2,3,6,0xb2d8c3c3
48746.39,3.0,0,2,4,4,10,0xb2d4167dd
440002.65,10.0,1,4,4,4,12,0xb2d3b5d6
171255.63,6.0,0,3,4,4,11,0xb2d0de34
30000.0,2.0,1,2,3,4,9,0xb2da6187
370000.0,2.0,9,4,3,3,10,0xb2d51f8c
7402.21,1.0,184,2,2,1,5,0xb2d21689
304670.31,3.0,17,4,4,2,10,0xb2d529b5
2000184.79,2.0,140,4,3,1,8,0xb2d121f2
530020.1,4.0,63,4,4,2,10,0xb2d1a897d
370058.68,2.0,1,4,3,4,11,0xb2d60ebb
435014.67,3.0,27,4,4,2,10,0xb2d78fdd
1483603.54,3.0,1,4,4,4,12,0xb2d27c8b
856284.69,2.0,92,4,3,1,8,0x3b9b19d5d
6237.1,1.0,0,2,2,4,8,0xb2d1c887
15236.07,1.0,0,2,2,4,8,0xb2d210c4d
66165.28,3.0,4,3,4,4,11,0xb2d5d9fa
3533.46,1.0,184,2,2,1,5,0xb2d298e4
14929.08,1.0,1,2,2,4,8,0xb2d3ae83
50640.02,1.0,184,2,2,1,5,0xb2d3e931
530052.17,4.0,15,4,4,3,11,0xb2d8d9ce
1063455.0,3.0,24,4,4,2,10,0xb2d6d145d
47314.3,2.0,212,2,3,1,6,0xb2d56c54
2655.42,1.0,92,1,2,1,4,0xb2d2a7f7
188.67,1.0,10,1,2,3,6,0xb2d6c2ac
12864.61,1.0,2,2,2,4,8,0xb2d2072f
104015.32,2.0,139,3,3,1,7,0xb2d3a83ed
250896.67,2.0,33,3,3,2,8,0xb2d4a5d3
256528.26,3.0,3,3,4,4,11,0xb2d3fb0f
4972.31,1.0,10,2,2,3,7,0xb2d5726cd
350004.02,4.0,28,4,4,2,10,0xb2d1fe14
640248.12,4.0,59,4,4,2,10,0xb2d1becb
2290.04,6.0,0,1,4,4,9,0x3b9b46b7
311442.67,7.0,19,4,4,2,10,0xb2d39e0b
106490.64,1.0,0,3,2,4,9,0xb2d60967
310311.24,2.0,101,4,3,1,8,0xb2d575f6d
263814.8,4.0,0,3,4,4,11,0xb2d906dcd
224000.1,1.0,4,3,2,4,9,0xb2d16c08
985196.92,5.0,41,4,4,2,10,0xb2d1dbf7
505690.4,3.0,5,4,4,3,11,0xb2d628e0d
80061.93,2.0,18,3,3,2,8,0xb2d63b9ad
446627.36,7.0,25,4,4,2,10,0xb2d5c1b7
906014.14,2.0,3,4,3,4,11,0xb2d52915
40324.46,1.0,45,2,2,2,6,0xb2d150dd
59.11,1.0,43,1,2,2,5,0xb2d9461a
50015.24,2.0,157,2,3,1,6,0xb2d0fa29
182.49,1.0,9,1,2,3,6,0xb2d91d4a
1104339.96,6.0,1,4,4,4,12,0xb2d57aac
322.16,1.0,0,1,2,4,7,0xb2d1a7f7d
17030.31,1.0,1,2,2,4,8,0xb2d6dd13
64572.26,1.0,184,3,2,1,6,0xb2d181ab
250005.28,6.0,69,3,4,1,8,0xb2d8e935d
100038.58,2.0,85,3,3,1,7,0xb2d398f8d
790767.34,5.0,33,4,4,2,10,0xb2d49989d
1539.48,1.0,5,1,2,3,6,0xb2d3312b
200710.52,2.0,54,3,3,2,8,0xb2d9d093
646.05,1.0,0,1,2,4,7,0xb2d81fef
358523.8,2.0,0,4,3,4,11,0xb2d4b684d
200810.44,2.0,19,3,3,2,8,0xb2d9eab2
19780.04,1.0,11,2,2,3,7,0xb2d40e87d
204202.19,2.0,0,3,3,4,10,0xb2d62b67
1300118.13,4.0,6,4,4,3,11,0xb2d23f71
60002.62,2.0,94,3,3,1,7,0xb2d16dacd
1357.5,1.0,92,1,2,1,4,0xb2d0c4c7
9483.21,1.0,1,2,2,4,8,0xb2d21d2e
21412.05,2.0,3,2,3,4,9,0xb2d1163b
301008.02,5.0,3,4,4,4,12,0xb2d56ecc
366171.66,1.0,4,4,2,4,10,0xb2d9e275
101843.84,2.0,83,3,3,1,7,0xb2d128dad
629.64,1.0,0,1,2,4,7,0xb2d936e2
68.72,1.0,75,1,2,1,4,0xb2d7f855
100099.5,2.0,215,3,3,1,7,0xb2d1f408
1013.65,1.0,92,1,2,1,4,0xb2d186cdd
825030.92,2.0,27,4,3,2,9,0xb2d9dd1d
200036.42,7.0,9,3,4,3,10,0xb2d5a0b5
10375.29,1.0,10,2,2,3,7,0xb2d8e511
28.55,1.0,20,1,2,2,5,0xb2d58229
241513.05,1.0,7,3,2,3,8,0xb2d8c3c0
15.22,1.0,98,1,2,1,4,0xb2d5c308
239213.01,2.0,42,3,3,2,8,0xb2d12a87
275810.96,4.0,39,3,4,2,9,0xb2d1c40ad
344000.47,7.0,0,4,4,4,12,0xb2d11b23d
381098.15,12.0,62,4,4,2,10,0xb2d07146d
19027.6,1.0,10,2,2,3,7,0xb2d4b997
179.39,1.0,139,1,2,1,4,0xb2d5ec24d
61382.9,3.0,18,3,4,2,9,0xb2d6451a
10000.11,2.0,39,2,3,2,7,0xb2d9f31b
50004.64,2.0,67,2,3,1,6,0xb2d8e0d6
710318.12,5.0,1,4,4,4,12,0xb2d614a9
620293.37,4.0,14,4,4,3,11,0xb2d2d5db
112502.19,4.0,27,3,4,2,9,0xb2d62c64
89067.93,9.0,15,3,4,3,10,0xb2d29f72
200710.52,2.0,54,3,3,2,8,0xb2d9d13f
4283.53,1.0,0,2,2,4,8,0xb2d36edd
7752.98,1.0,0,2,2,4,8,0xb2d78bccd
556030.44,4.0,83,4,4,1,9,0xb2d1182bd
29000.31,2.0,8,2,3,3,8,0xb2da4a1b
15409.24,1.0,3,2,2,4,8,0xb2d2e4de
60001.27,2.0,249,3,3,1,7,0xb2d239e8
46.34,1.0,18,1,2,2,5,0xb2d22cf0
113240.43,3.0,182,3,4,1,8,0xb2d08a09d
22027.82,1.0,6,2,2,3,7,0xb2d1a8d3
201734.11,2.0,41,3,3,2,8,0xb2d98a7b
402064.37,5.0,5,4,4,3,11,0xb2d417fc
1032494.29,1.0,1,4,2,4,10,0xb2d1c292
450000.0,3.0,18,4,4,2,10,0xb2da2a88
10.88,1.0,35,1,2,2,5,0xb2d266ae
170003.28,3.0,92,3,4,1,8,0xb2d96128
998679.9,4.0,3,4,4,4,12,0xb2d446edd
0.0,1.0,4,1,2,4,7,0xb2d97703
80003.69,2.0,6,3,3,3,9,0xb2d958fc
128.56,1.0,7,1,2,3,6,0xb2d83b01d
20033.01,2.0,4,2,3,4,9,0xb2d167f5
12520.28,2.0,18,2,3,2,7,0xb2d5c6ee
104288.31,3.0,73,3,4,1,8,0xb2d4ec12
7388.75,3.0,0,2,4,4,10,0xb2d06c67
4269.04,1.0,0,2,2,4,8,0xb2d3ed88
131813.07,1.0,0,3,2,4,9,0xb2d5bad8
1004.99,1.0,92,1,2,1,4,0xb2d4ba7ed
48015.34,1.0,133,2,2,1,5,0xb2d657ad
253065.15,3.0,46,3,4,2,9,0xb2d92f31
600136.64,4.0,4,4,4,4,12,0xb2d681f5
14000.0,1.0,4,2,2,4,8,0xb2d6c8cf
400045.0,5.0,7,4,4,3,11,0xb2d9a553
78001.69,2.0,0,3,3,4,10,0xb2da361c
80002.95,2.0,0,3,3,4,10,0xb2d6003f
4.27,1.0,3,1,2,4,7,0xb2d39185
1009.62,2.0,184,1,3,1,5,0xb2d28ec6
421217.43,3.0,18,4,4,2,10,0xb2d92f98d
756.83,1.0,0,1,2,4,7,0xb2d98da9
1420002.6,9.0,0,4,4,4,12,0xb2d07da9d
440041.8,1.0,18,4,2,2,8,0xb2d92466d
159.55,1.0,72,1,2,1,4,0xb2d42887d
153569.1,3.0,59,3,4,2,9,0xb2d55f44
2.99,1.0,19,1,2,2,5,0xb2d51ea8
96.41,1.0,1,1,2,4,7,0xb2d5067c
110054.02,2.0,70,3,3,1,7,0xb2d28471
1482.9,1.0,42,1,2,2,5,0xb2d4340d
18827.15,3.0,0,2,4,4,10,0xb2d6594f
1366000.0,23.0,0,4,4,4,12,0xb2d4242c
271589.99,6.0,0,3,4,4,11,0xb2d3169b
501887.88,2.0,36,4,3,2,9,0xb2d6d745
14826.03,1.0,3,2,2,4,8,0xb2d0c84e
14373.34,15.0,1,2,4,4,10,0xb2d1730e
103442.47,3.0,24,3,4,2,9,0xb2d5d40dd
190212.13,3.0,0,3,4,4,11,0xb2d63627
50324.56,2.0,206,2,3,1,6,0xb2d60d4f
26.39,1.0,69,1,2,1,4,0xb2d999ed
1239.19,1.0,232,1,2,1,4,0xb2d5a783d
250005.53,2.0,18,3,3,2,8,0xb2d53a18
270011.16,5.0,32,3,4,2,9,0xb2d566b6d
5482.98,1.0,53,2,2,2,6,0xb2d24db0
584.62,1.0,133,1,2,1,4,0xb2d38ebb
91043.15,2.0,92,3,3,1,7,0xb2d59eadd
202240.15,3.0,27,3,4,2,9,0xb2d93172
145.0,1.0,9,1,2,3,6,0xb2d8fa24
77.83,1.0,33,1,2,2,5,0xb2d2e3b0d
64243.7,1.0,0,3,2,4,9,0xb2d0b5bc
41453.5,1.0,11,2,2,3,7,0xb2d08c69
31626.43,1.0,5,2,2,3,7,0xb2d61208
18831.82,9.0,6,2,4,3,9,0x3b9b0f32
64.74,1.0,10,1,2,3,6,0xb2d58bc7
165.09,1.0,76,1,2,1,4,0xb2d48627
640000.0,4.0,5,4,4,3,11,0xb2d8f2cd
30340.6,1.0,1,2,2,4,8,0xb2d31b18
1799.22,1.0,9,1,2,3,6,0xb2d41971
16876.03,1.0,21,2,2,2,6,0xb2d0eabd
130032.75,3.0,6,3,4,3,10,0xb2d959f2
40030.19,2.0,67,2,3,1,6,0xb2d8e411
2893.02,1.0,1,2,2,4,8,0xb2d6c06f
398008.4,4.0,60,4,4,2,10,0xb2d97c65
1.3,1.0,22,1,2,2,5,0xb2d938ae
17.54,1.0,95,1,2,1,4,0xb2d3a8da
48761.18,1.0,199,2,2,1,5,0xb2d2cf26
200063.85,2.0,6,3,3,3,9,0xb2d1bb2ed
1087607.83,9.0,0,4,4,4,12,0xb2d5b173
549446.76,2.0,0,4,3,4,11,0xb2d2d126d
150052.32,5.0,6,3,4,3,10,0xb2d57090
25390.51,2.0,5,2,3,3,8,0xb2d08ef4
2166.15,1.0,21,1,2,2,5,0xb2d99792
102007.54,4.0,14,3,4,3,10,0xb2d0c5ca
35095.24,1.0,0,2,2,4,8,0xb2d78987
1083.99,1.0,19,1,2,2,5,0xb2d20439
1000089.41,2.0,3,4,3,4,11,0xb2d6eb2c
108268.24,1.0,159,3,2,1,6,0xb2d0dd2f
1526.63,1.0,184,1,2,1,4,0xb2d10304
11505.9,2.0,50,2,3,2,7,0xb2d1560a
1200008.93,3.0,7,4,4,3,11,0xb2d9147c
561.2,1.0,12,1,2,3,6,0xb2d6a193d
0.07,1.0,10,1,2,3,6,0xb2d57753
450095.95,3.0,5,4,4,3,11,0xb2d94e24
10000.42,2.0,20,2,3,2,7,0xb2d94d3ad
97.65,1.0,5,1,2,3,6,0xb2d4f163
2831.31,1.0,0,1,2,4,7,0xb2d40b84
802443.65,4.0,11,4,4,3,11,0xb2d0e042d
711058.04,13.0,0,4,4,4,12,0xb2d44903
2790207.27,9.0,1,4,4,4,12,0xb2d473f5
1044.85,1.0,13,1,2,3,6,0xb2d6bd47
22301.09,1.0,184,2,2,1,5,0xb2d3c418d
224458.63,10.0,3,3,4,4,11,0xb2d064eed
61.61,1.0,8,1,2,3,6,0xb2d4e7e2
110031.71,2.0,73,3,3,1,7,0xb2d5c79bd
100034.66,2.0,111,3,3,1,7,0xb2d107d4
501835.22,3.0,0,4,4,4,12,0xb2d16f9e
200000.0,2.0,18,3,3,2,8,0xb2d95b27
278962.23,2.0,231,3,3,1,7,0xb2d105b5d
19826.41,1.0,20,2,2,2,6,0xb2d62666
89937.64,1.0,3,3,2,4,9,0xb2d6d940
218418.55,2.0,31,3,3,2,8,0xb2d3c58dd
4.72,6.0,75,1,4,1,6,0xb2d2ae35d
496.51,2.0,16,1,3,2,6,0x3b9b2dc8d
910023.63,5.0,3,4,4,4,12,0xb2d6fd6d
85297.77,3.0,8,3,4,3,10,0xb2d95091
20083.31,1.0,92,2,2,1,5,0xb2d2bd4e
35354.92,2.0,0,2,3,4,9,0xb2d4c193
70094.48,2.0,104,3,3,1,7,0xb2d50508
10079.91,2.0,31,2,3,2,7,0xb2d65c47d
9792.08,1.0,5,2,2,3,7,0xb2d8fd85
1376077.16,4.0,104,4,4,1,9,0xb2d32120d
155062.61,2.0,52,3,3,2,8,0xb2d28fb9
183259.21,5.0,11,3,4,3,10,0xb2d3a494
500012.11,2.0,9,4,3,3,10,0xb2d85b75
400134.3,3.0,19,4,4,2,10,0xb2d0b44a
1518.5,1.0,23,1,2,2,5,0xb2d8dbd5
1140012.03,3.0,20,4,4,2,10,0xb2d17944d
650000.0,3.0,6,4,4,3,11,0xb2da2a92
300019.35,3.0,3,3,4,4,11,0xb2d4b8a7
266432.34,2.0,12,3,3,3,9,0xb2d5ffea
3703.51,1.0,1,2,2,4,8,0xb2d6fee1
6523.85,1.0,0,2,2,4,8,0xb2d39089
211495.12,3.0,40,3,4,2,9,0xb2d5ad44
20.27,1.0,60,1,2,2,5,0xb2d9b053
82957.5,2.0,21,3,3,2,8,0xb2d475ffd
219563.55,3.0,6,3,4,3,10,0xb2d4ac8a
251.61,1.0,3,1,2,4,7,0xb2d309ac
11131.04,1.0,144,2,2,1,5,0xb2d22292d
100319.5,1.0,3,3,2,4,9,0xb2d21a99
301076.27,2.0,30,4,3,2,9,0xb2d9c0ca
520794.27,1.0,1,4,2,4,10,0xb2d68ff8
20424.81,1.0,25,2,2,2,6,0xb2d6c035
50002.93,2.0,94,2,3,1,6,0xb2d604cf
1954380.62,8.0,1,4,4,4,12,0xb2d30612d
450014.25,2.0,11,4,3,3,10,0xb2da3da6
287121.21,11.0,0,3,4,4,11,0xb2d09cfa
0.32,2.0,83,1,3,1,5,0xb2d55be2d
200.16,1.0,0,1,2,4,7,0xb2d641d1
2236.09,1.0,81,1,2,1,4,0xb2d9655d
2596.28,1.0,2,1,2,4,7,0xb2d1387b
20.23,1.0,111,1,2,1,4,0xb2d35a27d
204827.26,2.0,39,3,3,2,8,0xb2d68eb3
201505.86,2.0,18,3,3,2,8,0xb2d9b281
40006.2,3.0,14,2,4,3,9,0xb2d4ec08
156455.09,2.0,10,3,3,3,9,0xb2d7806f
261.14,2.0,11,1,3,3,7,0x3b9b4343d
505330.66,2.0,87,4,3,1,8,0xb2d949d2
365722.78,3.0,11,4,4,3,11,0xb2d41958d
321257.24,2.0,38,4,3,2,9,0xb2d4a9f3
500092.21,3.0,6,4,4,3,11,0xb2d263ff
9003.61,1.0,0,2,2,4,8,0xb2d55990d
2926.67,1.0,49,2,2,2,6,0xb2d58825
11000.15,1.0,5,2,2,3,7,0xb2d8db1d
1.69,1.0,18,1,2,2,5,0xb2d177c6
202664.32,6.0,97,3,4,1,8,0xb2d41632
400000.0,2.0,0,4,3,4,11,0xb2da3bee
900264.48,1.0,0,4,2,4,10,0xb2d32375
212000.04,2.0,21,3,3,2,8,0xb2d9102ad
2536.43,1.0,99,1,2,1,4,0xb2d32f5f
1157123.94,8.0,4,4,4,4,12,0x3b9b2831d
3.51,1.0,26,1,2,2,5,0xb2d9de7b
10810.01,4.0,15,2,4,3,9,0xb2d17ee5
2779.08,1.0,1,1,2,4,7,0xb2d8f539
824.02,1.0,0,1,2,4,7,0xb2d92b0d
28.32,1.0,25,1,2,2,5,0xb2d50dbb
10386.67,2.0,67,2,3,1,6,0xb2d67fc8d
385087.82,1.0,0,4,2,4,10,0xb2d573b5
2535.41,1.0,92,1,2,1,4,0xb2d13f4f
500080.41,2.0,22,4,3,2,9,0xb2d8cccd
300037.51,2.0,11,3,3,3,9,0xb2d2186d
100007.3,2.0,118,3,3,1,7,0xb2d4cafad
350014.26,2.0,4,4,3,4,11,0xb2d4d08e
171769.26,5.0,13,3,4,3,10,0xb2d60174
148708.42,3.0,1,3,4,4,11,0xb2d5efbcd
503712.16,2.0,54,4,3,2,9,0xb2d6ce7dd
6386.2,1.0,0,2,2,4,8,0xb2d5400b
400062.72,3.0,11,4,4,3,11,0xb2d9322d
48.26,1.0,4,1,2,4,7,0xb2d4fde4d
5218.13,1.0,0,2,2,4,8,0xb2d85b70
611953.58,5.0,76,4,4,1,9,0xb2d253c3
224785.59,3.0,31,3,4,2,9,0xb2d268ae
508217.45,2.0,100,4,3,1,8,0xb2d6e06e
1550.1,1.0,184,1,2,1,4,0xb2d1098f
353190.71,3.0,0,4,4,4,12,0xb2d26791
1201231.27,4.0,32,4,4,2,10,0xb2d07baf
9.49,1.0,69,1,2,1,4,0xb2d67ea8
13733.43,1.0,7,2,2,3,7,0xb2d1edaa
120425.94,2.0,41,3,3,2,8,0xb2d58a5dd
21334.61,2.0,0,2,3,4,9,0xb2d28c91
26.22,2.0,6,1,3,3,7,0xb2d2c606
2408.9,1.0,92,1,2,1,4,0xb2d26112d
2.11,1.0,60,1,2,2,5,0xb2d7fd59
250030.06,3.0,10,3,4,3,10,0xb2d591b0
353431.71,2.0,53,4,3,2,9,0xb2d29814
7308.61,1.0,8,2,2,3,7,0xb2d801abd
39.14,1.0,18,1,2,2,5,0xb2d26b7b
30953.61,2.0,66,2,3,2,7,0xb2d5df29
0.74,1.0,0,1,2,4,7,0xb2d685e0
480090.36,5.0,63,4,4,2,10,0xb2d67ff5
1.61,1.0,6,1,2,3,6,0xb2d59ede
254443.35,2.0,18,3,3,2,8,0xb2d6c450d
4205.9,1.0,24,2,2,2,6,0xb2d45456
1353545.9,7.0,1,4,4,4,12,0xb2d59463d
310871.64,7.0,32,4,4,2,10,0xb2d23217
52000.0,1.0,4,2,2,4,8,0xb2d37aad
170.59,1.0,7,1,2,3,6,0xb2d2e5d1d
1.09,1.0,21,1,2,2,5,0xb2d1b47a
65005.5,3.0,13,3,4,3,10,0xb2d6528ed
1496.6,1.0,217,1,2,1,4,0xb2d3077cd
0.1,1.0,92,1,2,1,4,0xb2d29fa1
21122.94,1.0,22,2,2,2,6,0xb2d22289
110020.6,3.0,132,3,4,1,8,0xb2d20ad0d
1098.3,1.0,10,1,2,3,6,0xb2d2a794
89.54,1.0,51,1,2,2,5,0xb2d6e9fd
1028.31,1.0,184,1,2,1,4,0xb2d1175f
270005.36,3.0,90,3,4,1,8,0xb2d60b9c
297002.61,3.0,0,3,4,4,11,0xb2d90f94d
145515.47,1.0,184,3,2,1,6,0xb2d42d31d
5246.71,1.0,4,2,2,4,8,0xb2d54f12
500000.28,2.0,6,4,3,3,10,0xb2d9d417
927.13,1.0,8,1,2,3,6,0xb2d31236
1511923.39,1.0,1,4,2,4,10,0xb2d55d99d
134.99,1.0,75,1,2,1,4,0xb2d330bb
30310.18,1.0,184,2,2,1,5,0xb2d2acfb
120014.45,2.0,63,3,3,2,8,0xb2d63b63
270905.76,6.0,4,3,4,4,11,0xb2d6cb34d
512571.23,5.0,5,4,4,3,11,0xb2d93280
52075.67,2.0,64,2,3,2,7,0xb2d363fc
3096.18,1.0,184,2,2,1,5,0xb2d0c779
368.27,1.0,62,1,2,2,5,0xb2d242fd
75053.4,2.0,92,3,3,1,7,0xb2d3492b
5873.83,2.0,184,2,3,1,6,0xb2d0a699
85.77,1.0,42,1,2,2,5,0xb2d8c3bd
31306.06,1.0,0,2,2,4,8,0xb2d19249
860007.06,17.0,13,4,4,3,11,0xb2d5857fd
80001.69,2.0,25,3,3,2,8,0xb2d197c0
282.73,1.0,9,1,2,3,6,0xb2d56a3dd
2.74,1.0,8,1,2,3,6,0xb2da4722
100742.9,2.0,6,3,3,3,9,0xb2d415d0
1.27,1.0,20,1,2,2,5,0xb2da1cc7
17926.81,1.0,0,2,2,4,8,0xb2d6af38
70003.69,2.0,13,3,3,3,9,0xb2d95a7b
1886.16,1.0,9,1,2,3,6,0xb2d44943d
1005.73,1.0,92,1,2,1,4,0xb2d33a2e
806697.0,4.0,18,4,4,2,10,0xb2d1aaa9
51433.56,2.0,27,2,3,2,7,0xb2d0ff4c
300128.25,2.0,8,4,3,3,10,0xb2d8ecc3
171.82,1.0,0,1,2,4,7,0xb2d6dac9
133242.66,2.0,20,3,3,2,8,0xb2d94eddd
0.0,2.0,60,1,3,2,6,0xb2d8fc52
220899.08,2.0,144,3,3,1,7,0xb2d08bbd
7511.42,2.0,40,2,3,2,7,0xb2d6fe84
999364.11,3.0,84,4,4,1,9,0xb2d6189e
270011.4,3.0,20,3,4,2,9,0xb2d3f0fbd
4354.83,1.0,10,2,2,3,7,0xb2d3991d
200094.71,2.0,4,3,3,4,10,0xb2d6ab40
123865.88,2.0,4,3,3,4,10,0xb2d3cea3d
195013.29,2.0,50,3,3,2,8,0xb2d9c998
54072.46,1.0,0,3,2,4,9,0xb2d3f630
802389.79,3.0,14,4,4,3,11,0xb2d4829e
150041.79,2.0,53,3,3,2,8,0xb2d9cc0c
4553.76,1.0,184,2,2,1,5,0xb2d4c29f
39332.36,4.0,0,2,4,4,10,0xb2d0952ad
5459.43,1.0,16,2,2,2,6,0xb2d08168
404096.89,3.0,27,4,4,2,10,0xb2d17be9
150060.73,2.0,159,3,3,1,7,0xb2d10b0c
200240.09,3.0,23,3,4,2,9,0xb2d5bf24
168174.52,2.0,3,3,3,4,10,0xb2d8f8f1d
75000.79,3.0,55,3,4,2,9,0xb2d6eab7d
33.61,2.0,24,1,3,2,6,0xb2d2e1c4d
1170039.44,10.0,0,4,4,4,12,0xb2d5b79b
4049.93,1.0,17,2,2,2,6,0xb2d21f28
187096.55,3.0,10,3,4,3,10,0xb2d1a859
752807.41,4.0,0,4,4,4,12,0xb2d6e57ad
1338.08,1.0,9,1,2,3,6,0xb2d43c0e
100008.41,4.0,0,3,4,4,11,0xb2d5b3b7
350009.57,3.0,95,4,4,1,9,0xb2d43134
30000000.0,2.0,5,4,3,3,10,0xb2d92ef0d
100003.17,3.0,49,3,4,2,9,0xb2d9d364
303197.91,2.0,101,4,3,1,8,0xb2d96da1
4784.21,1.0,14,2,2,3,7,0xb2d272d4
250102.96,3.0,97,3,4,1,8,0xb2d29cf3
10041.18,2.0,35,2,3,2,7,0xb2d9f89b
3360077.61,5.0,19,4,4,2,10,0xb2d626e1
16.67,1.0,18,1,2,2,5,0xb2d27293
50038.21,2.0,18,2,3,2,7,0xb2d93b98
1710038.75,7.0,10,4,4,3,11,0xb2d28e79
2173.06,1.0,20,1,2,2,5,0xb2d3382c
21576.78,1.0,0,2,2,4,8,0xb2d2111a
400020.83,2.0,19,4,3,2,9,0xb2d9d6d6
151006.27,1.0,10,3,2,3,8,0xb2d91a42
10.0,1.0,73,1,2,1,4,0xb2d6e1c3d
966.41,1.0,0,1,2,4,7,0xb2d311aa
100284.45,1.0,198,3,2,1,6,0xb2d2c58c
100001.06,2.0,39,3,3,2,8,0xb2d9f195
71219.36,2.0,92,3,3,1,7,0x3b9b405ed
10384.19,1.0,8,2,2,3,7,0xb2d70761
550.95,1.0,9,1,2,3,6,0xb2d4fe44
60035.65,2.0,6,3,3,3,9,0xb2d4a5ac
1.98,1.0,40,1,2,2,5,0xb2d65167
6645.05,1.0,3,2,2,4,8,0xb2d6d080
210000.86,2.0,14,3,3,3,9,0xb2d6c522
2620142.39,3.0,32,4,4,2,10,0xb2d234bcd
4227.37,1.0,13,2,2,3,7,0xb2d52dcdd
14.16,1.0,8,1,2,3,6,0xb2d1d49cd
176010.21,2.0,104,3,3,1,7,0xb2d1b26ad
1803.55,2.0,125,1,3,1,5,0xb2d517ed
827.57,1.0,28,1,2,2,5,0xb2d631a3
16364.15,1.0,0,2,2,4,8,0xb2d89161
2667.99,1.0,3,1,2,4,7,0xb2d1bcbc
471.81,1.0,15,1,2,3,6,0xb2d37c92
9700000.0,2.0,5,4,3,3,10,0xb2d97144d
500076.04,2.0,7,4,3,3,10,0xb2d92cac
342.53,1.0,24,1,2,2,5,0xb2d2fd6c
30000.32,2.0,48,2,3,2,7,0xb2d9128c
947.12,1.0,9,1,2,3,6,0xb2d426f5
500000.44,3.0,11,4,4,3,11,0xb2d93d28
410086.68,6.0,38,4,4,2,10,0xb2d5a67c
300000.0,2.0,25,3,3,2,8,0xb2d94a78
221563.24,2.0,75,3,3,1,7,0xb2d581b9
100046.62,2.0,66,3,3,2,8,0xb2d63197
1408.76,1.0,17,1,2,2,5,0xb2d10984
412.99,1.0,0,1,2,4,7,0xb2d79167
10121.56,2.0,144,2,3,1,6,0xb2d6d2aed
155717.97,2.0,76,3,3,1,7,0xb2d58411
120781.12,3.0,32,3,4,2,9,0xb2d32329d
50036.82,2.0,143,2,3,1,6,0xb2d6138a
1715.49,1.0,9,1,2,3,6,0xb2d24630
1447.63,1.0,6,1,2,3,6,0xb2d227aa
358000.0,4.0,0,4,4,4,12,0xb2d3afb4d
23.28,1.0,6,1,2,3,6,0xb2d19852
3889.48,1.0,8,2,2,3,7,0xb2d2b7a0
1.01,1.0,53,1,2,2,5,0xb2d7066f
1205.18,1.0,184,1,2,1,4,0xb2d27e50
2762.75,1.0,0,1,2,4,7,0xb2d0daeb
741002.59,9.0,31,4,4,2,10,0xb2d3a5aa
101404.4,2.0,0,3,3,4,10,0xb2d96f27
2202.36,1.0,4,1,2,4,7,0xb2d6a10d
427711.84,9.0,0,4,4,4,12,0xb2d36db8
612.98,1.0,0,1,2,4,7,0xb2d9954b
4001.26,1.0,25,2,2,2,6,0xb2d99803
88884.14,1.0,21,3,2,2,7,0xb2d39216d
51732.45,1.0,20,2,2,2,6,0xb2d56964
314834.47,1.0,92,4,2,1,7,0x3b9b2536
2074.2,3.0,166,1,4,1,6,0xb2d26cecd
91.33,1.0,0,1,2,4,7,0xb2d3a114
3603.43,1.0,172,2,2,1,5,0xb2d2a481
309088.7,4.0,3,4,4,4,12,0xb2d0d515
907133.97,3.0,1,4,4,4,12,0xb2d938d8d
505431.87,2.0,35,4,3,2,9,0xb2d8fed3d
4008919.93,12.0,0,4,4,4,12,0xb2d26e65
500000.0,1.0,0,4,2,4,10,0xb2d563edd
1.28,1.0,48,1,2,2,5,0xb2d6b4de
1203.3,1.0,1,1,2,4,7,0xb2d926c0d
691642.6,8.0,3,4,4,4,12,0xb2d079b8
200047.39,5.0,13,3,4,3,10,0xb2d20481
450014.91,4.0,8,4,4,3,11,0xb2d2dee2
145915.69,3.0,0,3,4,4,11,0xb2d06782
1237.8,1.0,18,1,2,2,5,0xb2d244d6
230953.86,2.0,3,3,3,4,10,0xb2d2196d
3013160.63,5.0,70,4,4,1,9,0xb2d112a9d
890117.53,5.0,18,4,4,2,10,0xb2d62135
1534.72,1.0,0,1,2,4,7,0xb2d6a42a
113000.4,1.0,2,3,2,4,9,0xb2da4c9d
21.11,1.0,60,1,2,2,5,0xb2d9b8e8
29.99,1.0,55,1,2,2,5,0xb2d3f88e
1598622.4,12.0,13,4,4,3,11,0xb2d2d7aad
1000156.39,2.0,20,4,3,2,9,0xb2d78c5c
652112.96,9.0,11,4,4,3,11,0xb2d59092
940089.04,11.0,3,4,4,4,12,0x3b9b387e
299.48,1.0,6,1,2,3,6,0xb2d54026d
50001.73,2.0,4,2,3,4,9,0xb2d9cd18
210001.7,2.0,14,3,3,3,9,0xb2d91535
504387.2,5.0,98,4,4,1,9,0xb2d61f03
821950.48,1.0,92,4,2,1,7,0xb2d13f25
12050.11,1.0,184,2,2,1,5,0xb2d4b696d
3464.5,2.0,92,2,3,1,6,0xb2d064c8
2249.81,1.0,2,1,2,4,7,0xb2d6a901
257161.02,4.0,24,3,4,2,9,0xb2d0a838
15.83,1.0,77,1,2,1,4,0xb2d98c27
701296.01,1.0,0,4,2,4,10,0xb2d3bcc6
331016.59,4.0,18,4,4,2,10,0xb2d2ae1bd
640929.33,11.0,0,4,4,4,12,0xb2d43c49d
245762.29,1.0,11,3,2,3,8,0xb2d7546dd
1.58,1.0,91,1,2,1,4,0xb2d96dd0
828898.97,3.0,0,4,4,4,12,0xb2d3c9e6
13.02,1.0,41,1,2,2,5,0xb2d436d5
546.19,1.0,34,1,2,2,5,0xb2d429a9
60315.77,1.0,92,3,2,1,6,0xb2d2db84
0.69,1.0,4,1,2,4,7,0xb2d8c6fa
314269.89,2.0,1,4,3,4,11,0xb2d6dfd5d
1400000.57,5.0,7,4,4,3,11,0xb2d91390
37979.76,3.0,6,2,4,3,9,0xb2d5ac1ed
1426.44,1.0,47,1,2,2,5,0xb2d23574d
15004.25,2.0,23,2,3,2,7,0xb2d2bd8c
523387.79,3.0,25,4,4,2,10,0xb2d5c485
51019.49,2.0,77,2,3,1,6,0xb2d3b457
30378.03,2.0,7,2,3,3,8,0xb2d9e7c5
300329.82,2.0,1,4,3,4,11,0xb2d6d37cd
206039.0,2.0,1,3,3,4,10,0xb2d97c99d
21652.67,1.0,30,2,2,2,6,0xb2d3a4f0
412.65,1.0,9,1,2,3,6,0xb2d38f1b
410956.95,3.0,0,4,4,4,12,0xb2d5ba83
1303.98,1.0,2,1,2,4,7,0xb2d48e5d
12.03,1.0,60,1,2,2,5,0xb2d6fd37
2346.13,1.0,0,1,2,4,7,0xb2d615eb
10044.09,1.0,92,2,2,1,5,0xb2d52902
3427.72,1.0,11,2,2,3,7,0xb2d7830f
19763.78,1.0,232,2,2,1,5,0xb2d3f46f
79945.33,1.0,0,3,2,4,9,0xb2d646ff
0.0,1.0,184,1,2,1,4,0xb2d2ddbb
1552.92,1.0,0,1,2,4,7,0xb2d78677
10000.92,2.0,41,2,3,2,7,0xb2d9e551
986334.31,5.0,83,4,4,1,9,0xb2d580d5
220043.7,2.0,172,3,3,1,7,0xb2d26d15
208.51,1.0,69,1,2,1,4,0xb2d4dd44
430060.46,2.0,1,4,3,4,11,0xb2d5de8a
261368.59,4.0,69,3,4,1,8,0xb2d07ff8
12519.01,2.0,112,2,3,1,6,0xb2d69f0ad
4894.42,1.0,92,2,2,1,5,0xb2d395e0
62248.13,2.0,92,3,3,1,7,0xb2d0e731d
220227.0,3.0,82,3,4,1,8,0xb2d36f2b
500010.57,2.0,165,4,3,1,8,0xb2d8e206d
244.96,1.0,134,1,2,1,4,0xb2d2883a
7671.69,1.0,92,2,2,1,5,0xb2d37a3b
3900097.5,2.0,0,4,3,4,11,0xb2da6c4e
32965.42,5.0,92,2,4,1,7,0x3b9af522
207.19,1.0,4,1,2,4,7,0xb2d24dde
1212.76,1.0,92,1,2,1,4,0xb2d227b4d
204978.78,2.0,92,3,3,1,7,0xb2d6580b
200059.02,2.0,18,3,3,2,8,0xb2d60812d
79.89,1.0,6,1,2,3,6,0xb2d34f81
162919.85,4.0,216,3,4,1,8,0xb2d1500cd
20000.0,2.0,4,2,3,4,9,0xb2da5a3c
50000.0,2.0,57,2,3,2,7,0xb2d6b224
3701.21,1.0,8,2,2,3,7,0xb2d7f187
13.51,1.0,42,1,2,2,5,0xb2d37e63
306371.13,3.0,0,4,4,4,12,0xb2d4a570
92816.8,2.0,67,3,3,1,7,0xb2d5cfa2
632757.24,3.0,0,4,4,4,12,0xb2d57faa
28523.28,1.0,2,2,2,4,8,0xb2d346ed
11.77,1.0,92,1,2,1,4,0xb2d2d459
1.06,1.0,46,1,2,2,5,0xb2d5408f
238000.0,2.0,42,3,3,2,8,0xb2d2a3d3
22.13,1.0,1,1,2,4,7,0xb2d220ae
34000.0,1.0,0,2,2,4,8,0xb2d3a816
60.34,3.0,112,1,4,1,6,0xb2d945c3
206148.87,5.0,6,3,4,3,10,0xb2d0cfa2d
1552.64,1.0,92,1,2,1,4,0xb2d5720bd
62.98,1.0,47,1,2,2,5,0xb2d4a5e9
231240.12,1.0,211,3,2,1,6,0xb2d4f13dd
501776.21,2.0,49,4,3,2,9,0xb2d9d998
81.34,1.0,11,1,2,3,6,0xb2d324a3
2005703.04,1.0,1,4,2,4,10,0xb2d33198
40001.45,4.0,42,2,4,2,8,0xb2d62326d
129298.72,2.0,0,3,3,4,10,0xb2da06cd
80593.85,2.0,3,3,3,4,10,0xb2d67e89
666.29,1.0,4,1,2,4,7,0xb2d6cbd7
43615.65,1.0,5,2,2,3,7,0xb2d33d9fd
305192.41,2.0,26,4,3,2,9,0xb2d23067
1701787.85,6.0,26,4,4,2,10,0xb2d218dad
260759.72,3.0,24,3,4,2,9,0xb2d9f067
2137.35,17.0,13,1,4,3,8,0xb2d171c8d
110037.3,2.0,179,3,3,1,7,0xb2d56634d
75289.83,7.0,20,3,4,2,9,0xb2d69c68
32083.01,1.0,0,2,2,4,8,0xb2d1775b
61333.58,3.0,92,3,4,1,8,0xb2d090e1d
79660.21,3.0,103,3,4,1,8,0xb2d555fa
50001.06,2.0,92,2,3,1,6,0xb2d63b34
2338.37,2.0,92,1,3,1,5,0xb2d3bc03d
470088.41,4.0,10,4,4,3,11,0xb2d5bfc6
124.24,1.0,6,1,2,3,6,0xb2d234ad
270008.42,4.0,0,3,4,4,11,0xb2d954c9
843.36,2.0,4,1,3,4,8,0xb2d8f98b
121013.72,2.0,92,3,3,1,7,0xb2d63276d
574.16,1.0,23,1,2,2,5,0xb2d1e301
50008.21,2.0,38,2,3,2,7,0xb2d4e860
911.85,1.0,0,1,2,4,7,0xb2d278c6
237.09,1.0,8,1,2,3,6,0xb2d23823
384636.82,2.0,0,4,3,4,11,0xb2d598fdd
17.09,1.0,95,1,2,1,4,0xb2d62cb8
203592.93,1.0,7,3,2,3,8,0xb2d2f89c
10000.43,2.0,27,2,3,2,7,0xb2d64860d
743820.77,4.0,13,4,4,3,11,0xb2d07074d
803256.89,4.0,21,4,4,2,10,0xb2d8f75e
151823.14,2.0,52,3,3,2,8,0xb2d6d17e
20000.21,2.0,98,2,3,1,6,0xb2d96f6e
81.52,1.0,5,1,2,3,6,0xb2d2b419
3010.97,1.0,92,2,2,1,5,0xb2d59b37d
257434.47,1.0,0,3,2,4,9,0xb2d63335d
210004.43,2.0,25,3,3,2,8,0xb2da1179
3.35,1.0,59,1,2,2,5,0xb2d24722d
181.19,1.0,1,1,2,4,7,0xb2d5dd3e
11.38,1.0,52,1,2,2,5,0xb2d3107e
4229.69,1.0,184,2,2,1,5,0xb2d31bfb
1182009.52,24.0,4,4,4,4,12,0x3b9b471f
28.17,1.0,39,1,2,2,5,0xb2d5dcba
4239.55,1.0,24,2,2,2,6,0xb2d8f09e
95001.0,2.0,27,3,3,2,8,0xb2d94350
1003158.58,2.0,0,4,3,4,11,0xb2d31196
455881.73,1.0,184,4,2,1,7,0xb2d2a1add
100007.76,3.0,59,3,4,2,9,0xb2d4cf4bd
1105692.29,6.0,18,4,4,2,10,0xb2d06f02
6493.08,1.0,0,2,2,4,8,0xb2d972cf
81013.11,2.0,231,3,3,1,7,0xb2d3c7ae
53000.0,2.0,4,3,3,4,10,0xb2d28dfb
1091037.04,7.0,0,4,4,4,12,0xb2d682d9
10000.53,2.0,34,2,3,2,7,0xb2d9f446
300042.47,2.0,10,3,3,3,9,0xb2d1c9a2
2304.72,1.0,0,1,2,4,7,0xb2d41b9fd
495009.25,15.0,0,4,4,4,12,0xb2d5697f
92158.1,4.0,188,3,4,1,8,0xb2d58cd1d
70006.19,2.0,94,3,3,1,7,0xb2d2d7e5
0.31,2.0,27,1,3,2,6,0xb2d60073
4575521.33,4.0,48,4,4,2,10,0xb2d11956
200062.67,2.0,28,3,3,2,8,0xb2d782e7
34090.67,1.0,9,2,2,3,7,0xb2d2076dd
1.71,1.0,2,1,2,4,7,0xb2d7c44e
15000.48,2.0,45,2,3,2,7,0xb2d9156c
51581.85,2.0,157,2,3,1,6,0xb2d52135d
180122.86,1.0,9,3,2,3,8,0xb2d5c1f1
208022.05,2.0,5,3,3,3,9,0xb2d3e60c
6450000.0,43.0,1,4,4,4,12,0xb2d0f2d7d
3494.79,1.0,0,2,2,4,8,0xb2d9ad24
145076.54,2.0,205,3,3,1,7,0xb2d6eaded
7628.8,1.0,223,2,2,1,5,0xb2d27a71d
200096.44,2.0,1,3,3,4,10,0xb2d3c1c2
600018.02,4.0,0,4,4,4,12,0xb2d559c1
23623.98,1.0,0,2,2,4,8,0xb2d51e72
12800.0,2.0,127,2,3,1,6,0xb2d93296
10101.68,1.0,34,2,2,2,6,0xb2d92457
50774.89,2.0,65,2,3,2,7,0xb2d40eb5
2000.78,1.0,47,1,2,2,5,0xb2d9d77d
20000.21,2.0,39,2,3,2,7,0xb2d9f1f4
45642.54,2.0,27,2,3,2,7,0xb2d61f9d
200000.0,2.0,19,3,3,2,8,0xb2da3244
150008.45,3.0,32,3,4,2,9,0xb2d9f588
161427.68,2.0,12,3,3,3,9,0xb2d622eb
10858.73,1.0,0,2,2,4,8,0xb2d15bfed
10099.76,1.0,92,2,2,1,5,0xb2d18e63
7.33,1.0,30,1,2,2,5,0xb2d8c845
6.72,1.0,104,1,2,1,4,0xb2d95e9d
50029.54,2.0,116,2,3,1,6,0xb2d2cc32
3654.28,1.0,2,2,2,4,8,0xb2d0cbc1d
58.47,1.0,27,1,2,2,5,0xb2d9975b
73007.36,3.0,31,3,4,2,9,0xb2d8596f
30000000.05,2.0,85,4,3,1,8,0xb2d6a689d
5.48,1.0,11,1,2,3,6,0xb2d5632a
66.46,1.0,45,1,2,2,5,0xb2d2a77a
7226.46,1.0,21,2,2,2,6,0xb2d60a52
330071.3,2.0,11,4,3,3,10,0xb2d52762
271624.64,4.0,66,3,4,2,9,0xb2d58246d
100001.72,3.0,69,3,4,1,8,0xb2d63ffe
316970.27,21.0,7,4,4,3,11,0x3b9af2d1d
235073.17,5.0,18,3,4,2,9,0xb2d0dd0a
278.27,1.0,10,1,2,3,6,0xb2d9e4b2
804617.39,5.0,13,4,4,3,11,0xb2d3778ad
2351.28,1.0,0,1,2,4,7,0xb2d50bac
80000.0,2.0,0,3,3,4,10,0xb2d98130d
459.98,1.0,11,1,2,3,6,0xb2d2a08f
380339.33,2.0,0,4,3,4,11,0xb2d1b63dd
2181.08,1.0,92,1,2,1,4,0xb2d5976c
13405.07,1.0,6,2,2,3,7,0xb2d2b5d2
257009.26,3.0,10,3,4,3,10,0xb2d39227
90.13,1.0,18,1,2,2,5,0xb2d3bb8d
617371.63,4.0,34,4,4,2,10,0xb2d426dfd
1.31,1.0,10,1,2,3,6,0xb2d43ed1
50000.0,2.0,0,2,3,4,9,0xb2d97db2d
615633.42,4.0,18,4,4,2,10,0xb2d1c8ba
652611.43,5.0,0,4,4,4,12,0xb2d1a09b
380239.45,3.0,17,4,4,2,10,0xb2d25309
86721.92,4.0,32,3,4,2,9,0xb2d17a09d
7250.18,1.0,92,2,2,1,5,0xb2d29f77
480077.79,1.0,24,4,2,2,8,0xb2d99991
704985.49,2.0,82,4,3,1,8,0xb2d62801
301813.12,2.0,6,4,3,3,10,0xb2d648d4
235326.78,4.0,14,3,4,3,10,0xb2d54896
930651.42,6.0,0,4,4,4,12,0xb2d5b173d
315000.12,2.0,27,4,3,2,9,0xb2d5f0f9
351858.73,7.0,0,4,4,4,12,0x3b9b2f8fd
4386.94,1.0,31,2,2,2,6,0xb2d6d0bb
233471.63,9.0,0,3,4,4,11,0x3b9b4605
5.02,1.0,10,1,2,3,6,0xb2d998e2
4540.78,1.0,15,2,2,3,7,0xb2d93ede
1037467.0,5.0,11,4,4,3,11,0xb2d11eaf
1066122.28,4.0,26,4,4,2,10,0xb2d0f877d
2352.05,1.0,184,1,2,1,4,0xb2d2c2f6
173.43,13.0,19,1,4,2,7,0xb2d2fff5d
703039.56,9.0,6,4,4,3,11,0xb2d1710e
687626.14,4.0,4,4,4,4,12,0x3b9b4514
1060.89,1.0,142,1,2,1,4,0xb2d905cc
73.93,1.0,4,1,2,4,7,0xb2d0a156
238097.33,4.0,25,3,4,2,9,0xb2d4e979d
260092.57,6.0,3,3,4,4,11,0xb2d21b51
524503.39,3.0,62,4,4,2,10,0xb2d7784ad
52719.05,2.0,10,3,3,3,9,0xb2d28e2e
16117.05,24.0,33,2,4,2,8,0xb2d217d8d
30000.99,1.0,0,2,2,4,8,0xb2d6b30dd
1200000.57,5.0,12,4,4,3,11,0xb2d92441
0.24,1.0,6,1,2,3,6,0xb2d3157c
110097.02,3.0,34,3,4,2,9,0xb2d62b5f
511936.17,1.0,24,4,2,2,8,0xb2d5a96ed
1100091.51,6.0,13,4,4,3,11,0xb2d95d85
1.15,1.0,57,1,2,2,5,0x3b9b32c8
303198.95,2.0,96,4,3,1,8,0xb2d647cc
76.81,1.0,34,1,2,2,5,0xb2d39060
6517.17,1.0,0,2,2,4,8,0xb2d78662d
9.3,1.0,3,1,2,4,7,0xb2d36382
13410.19,1.0,4,2,2,4,8,0xb2d2d3bbd
289.75,1.0,77,1,2,1,4,0xb2d3971dd
20200.0,1.0,2,2,2,4,8,0xb2d9452d
10005.06,2.0,47,2,3,2,7,0xb2d91588d
10367.02,1.0,24,2,2,2,6,0xb2d15b36
1.98,1.0,80,1,2,1,4,0xb2d6b520d
51376.77,1.0,3,2,2,4,8,0xb2d4c8b5
352963.96,4.0,3,4,4,4,12,0xb2d61112d
6122.51,1.0,11,2,2,3,7,0xb2d42f67
177.19,2.0,78,1,3,1,5,0xb2d8cb49
3200.32,1.0,92,2,2,1,5,0xb2d0f0df
49906.77,1.0,22,2,2,2,6,0xb2d5e561
3364.73,1.0,11,2,2,3,7,0xb2d26939
33856.93,1.0,2,2,2,4,8,0xb2d221af
2496.27,1.0,184,1,2,1,4,0xb2d272c9d
604.49,3.0,0,1,4,4,9,0xb2d39c03
1804.85,1.0,184,1,2,1,4,0xb2d404cad
62092.7,2.0,26,3,3,2,8,0xb2d176fed
21020.13,1.0,2,2,2,4,8,0xb2d98943
432037.82,5.0,0,4,4,4,12,0xb2d36b39
17.7,1.0,67,1,2,1,4,0xb2d56e68
3.06,1.0,3,1,2,4,7,0xb2d4ad5b
50075.42,2.0,74,2,3,1,6,0xb2d8ce59
80001.68,2.0,92,3,3,1,7,0xb2d65b7c
161490.51,2.0,92,3,3,1,7,0xb2d5b16e
9.92,1.0,7,1,2,3,6,0xb2d554a7
381058.45,4.0,0,4,4,4,12,0x3b9b1c05
600000.0,3.0,4,4,4,4,12,0xb2da4c7a
501818.51,3.0,17,4,4,2,10,0xb2d9841cd
9336.62,1.0,15,2,2,3,7,0xb2d30dd4
1001984.57,2.0,7,4,3,3,10,0xb2d68bc3d
1189.34,1.0,0,1,2,4,7,0xb2d55c24
5849.11,1.0,48,2,2,2,6,0xb2d3cccc
690649.96,3.0,87,4,4,1,9,0xb2d600d9d
500010.15,3.0,16,4,4,2,10,0xb2d90f88
159641.2,3.0,104,3,4,1,8,0xb2d3cc8e
300013.84,3.0,20,3,4,2,9,0xb2d6038ad
118000.78,4.0,6,3,4,3,10,0xb2d9651c
10105.75,1.0,184,2,2,1,5,0xb2d219c0
3781.18,1.0,3,2,2,4,8,0xb2d91f51
3830.24,1.0,0,2,2,4,8,0xb2d9188a
206336.7,1.0,21,3,2,2,7,0xb2d19114d
1999294.69,6.0,2,4,4,4,12,0xb2d255ae
640448.95,5.0,42,4,4,2,10,0xb2d3b6a4
1665.9,1.0,0,1,2,4,7,0xb2d1a495
454.9,1.0,0,1,2,4,7,0xb2d6bbda
405686.8,3.0,126,4,4,1,9,0x3b9b3646
70001.48,2.0,39,3,3,2,8,0xb2d9eacf
14621.79,1.0,79,2,2,1,5,0xb2d79120d
6888.96,1.0,0,2,2,4,8,0xb2d786a1d
23152.75,2.0,0,2,3,4,9,0xb2d06be1
108462.3,2.0,0,3,3,4,10,0xb2d5f562
120306.75,3.0,4,3,4,4,11,0xb2d1a91fd
634.29,1.0,0,1,2,4,7,0xb2d903c1
216017.5,10.0,0,3,4,4,11,0xb2d62d6dd
550080.37,3.0,4,4,4,4,12,0xb2d8c968
1332973.71,7.0,20,4,4,2,10,0xb2d5ab60d
11901.35,1.0,20,2,2,2,6,0xb2d6b7b2
1488.03,5.0,92,1,4,1,6,0xb2d19731d
237.03,1.0,0,1,2,4,7,0xb2d906a9d
2048.18,1.0,85,1,2,1,4,0xb2d331b0
50030.06,2.0,158,2,3,1,6,0xb2d24343
776574.63,12.0,27,4,4,2,10,0xb2d069c1
418743.1,4.0,9,4,4,3,11,0xb2d1da6a
66708.71,1.0,0,3,2,4,9,0xb2d9f0bd
500024.17,2.0,8,4,3,3,10,0xb2d9304a
0.0,1.0,4,1,2,4,7,0xb2da4b02
1483.7,1.0,36,1,2,2,5,0xb2d0a4bf
153046.49,2.0,74,3,3,1,7,0xb2d21000
343014.35,3.0,256,4,4,1,9,0xb2d23da1
730101.43,6.0,1,4,4,4,12,0xb2d55c8a
0.6,2.0,73,1,3,1,5,0xb2d8c3c8
113568.26,2.0,32,3,3,2,8,0xb2d0e625d
8002.28,1.0,13,2,2,3,7,0xb2d744aa
130017.49,2.0,17,3,3,2,8,0xb2d744ca
300717.67,3.0,27,4,4,2,10,0xb2d6178ad
80098.8,1.0,44,3,2,2,7,0xb2d432c0d
21724.32,1.0,92,2,2,1,5,0xb2d37c12d
44228.7,2.0,0,2,3,4,9,0xb2d6cd16
4.89,1.0,67,1,2,1,4,0xb2d1b2dfd
452.66,1.0,9,1,2,3,6,0xb2d8ca85
100063.33,2.0,10,3,3,3,9,0xb2d5fcc9
117.42,1.0,7,1,2,3,6,0xb2d267d3
1009.57,3.0,184,1,4,1,6,0x3b9af4f6
49562.12,1.0,8,2,2,3,7,0xb2da2716
478948.27,3.0,95,4,4,1,9,0xb2d22ff7
260008.68,3.0,216,3,4,1,8,0xb2d643ea
200000.42,2.0,20,3,3,2,8,0xb2d1ad3f
215052.67,3.0,10,3,4,3,10,0xb2d2b04fd
328.13,1.0,6,1,2,3,6,0xb2d7c004
500102.58,2.0,143,4,3,1,8,0xb2d1b916d
91.72,1.0,70,1,2,1,4,0xb2d5aa64
2292152.23,15.0,0,4,4,4,12,0xb2d103eb
200708.47,2.0,0,3,3,4,10,0xb2d9bd28
1920026.48,3.0,18,4,4,2,10,0xb2d5ed7c
10355.88,2.0,18,2,3,2,7,0xb2d5fe73d
30182.71,1.0,0,2,2,4,8,0xb2d69fd8
6966.89,1.0,92,2,2,1,5,0xb2d38373d
19977.09,1.0,0,2,2,4,8,0xb2d6a66c
18538.14,1.0,0,2,2,4,8,0xb2d69c99
2170.7,1.0,0,1,2,4,7,0xb2d439b5
407361.47,1.0,26,4,2,2,8,0xb2d8b387
1881.66,1.0,17,1,2,2,5,0x3b9b2d91d
10047.35,1.0,0,2,2,4,8,0xb2d61bf3d
36276.69,1.0,21,2,2,2,6,0xb2d60ade
10495.35,1.0,21,2,2,2,6,0xb2d349b7
1023.48,1.0,34,1,2,2,5,0xb2d91f8d
35221.26,1.0,14,2,2,3,7,0xb2d6a247
12922.31,1.0,0,2,2,4,8,0xb2d4dbdf
900097.47,4.0,6,4,4,3,11,0xb2d6f50c
5.81,1.0,93,1,2,1,4,0xb2d96f07d
1331.35,1.0,10,1,2,3,6,0xb2d5d5c2
40836.57,1.0,0,2,2,4,8,0xb2d88daa
49.33,13.0,17,1,4,2,7,0xb2d6c1c1
13.63,1.0,80,1,2,1,4,0xb2d83a0f
0.38,1.0,11,1,2,3,6,0xb2d4d65ad
205000.0,5.0,0,3,4,4,11,0xb2d502a8d
1615.45,1.0,92,1,2,1,4,0xb2d22222
1603.76,1.0,92,1,2,1,4,0xb2d16974
700000.59,4.0,5,4,4,3,11,0xb2d92e2ad
6.86,1.0,10,1,2,3,6,0xb2d0ac59
775000.0,4.0,0,4,4,4,12,0xb2d9f7a0
712878.73,5.0,10,4,4,3,11,0xb2d1ac79d
1546.78,1.0,0,1,2,4,7,0xb2d996d8
163337.53,3.0,4,3,4,4,11,0xb2d3788a
8.07,1.0,1,1,2,4,7,0xb2d31ed3
209.73,1.0,4,1,2,4,7,0xb2d93556
14074.17,1.0,0,2,2,4,8,0xb2d27108
80004.7,4.0,62,3,4,2,9,0x3b9b2c18
103069.69,2.0,70,3,3,1,7,0xb2d67f45d
4330106.55,10.0,32,4,4,2,10,0xb2d250ef
1672171.58,80.0,89,4,4,1,9,0xb2d159b8d
60797.58,2.0,0,3,3,4,10,0xb2d436b6
351409.85,6.0,25,4,4,2,10,0xb2d139af
95549.07,3.0,101,3,4,1,8,0xb2d645fb
144221.0,3.0,62,3,4,2,9,0xb2d8da1fd
82661.23,2.0,157,3,3,1,7,0xb2d3ba7c
286.7,1.0,41,1,2,2,5,0xb2d3657fd
2839.72,1.0,3,1,2,4,7,0xb2d4f6a4
3022.16,1.0,184,2,2,1,5,0xb2d33466d
220000.65,12.0,8,3,4,3,10,0xb2d30e3fd
901962.82,5.0,1,4,4,4,12,0xb2d49114
305649.62,5.0,55,4,4,2,10,0xb2d5820ed
50093.84,2.0,27,2,3,2,7,0xb2d0b1e5d
1824000.0,7.0,0,4,4,4,12,0xb2d17ddbd
1703.88,1.0,67,1,2,1,4,0xb2d2e5bcd
58307.11,2.0,24,3,3,2,8,0xb2d26602
19294.34,1.0,7,2,2,3,7,0xb2d42113
13867.0,1.0,18,2,2,2,6,0xb2d6e5cf
200284.64,9.0,3,3,4,4,11,0xb2d5e951
8450.6,2.0,0,2,3,4,9,0x3b9af273d
1835006.64,8.0,4,4,4,4,12,0xb2d18589d
704381.6,2.0,2,4,3,4,11,0xb2d59e16
100005.7,2.0,139,3,3,1,7,0xb2d25128
1701964.66,4.0,23,4,4,2,10,0xb2d5c5a1
250.65,1.0,49,1,2,2,5,0xb2d379b0
60036.1,2.0,0,3,3,4,10,0xb2d9c86c
326007.51,4.0,26,4,4,2,10,0xb2d55e79
500048.05,3.0,202,4,4,1,9,0xb2d227dcd
330092.39,5.0,0,4,4,4,12,0x3b9b1329
100056.06,2.0,14,3,3,3,9,0xb2d21405
50017.0,2.0,4,2,3,4,9,0xb2d5d694
216054.42,3.0,4,3,4,4,11,0xb2d24e44
643.08,2.0,0,1,3,4,8,0x3b9b4709d
4.22,1.0,11,1,2,3,6,0xb2da3a42
300006.33,2.0,6,3,3,3,9,0xb2d966a1d
2699.29,1.0,1,1,2,4,7,0xb2d3d68b
1313517.93,4.0,41,4,4,2,10,0xb2d639ba
1840.48,1.0,10,1,2,3,6,0xb2d1f1aa
2088.61,1.0,9,1,2,3,6,0xb2d651c3
1617.88,1.0,92,1,2,1,4,0xb2d8dc30
4.22,1.0,126,1,2,1,4,0xb2d92ebcd
1425.81,2.0,184,1,3,1,5,0xb2d1d222
156118.09,2.0,92,3,3,1,7,0xb2d220d0
100003.17,2.0,24,3,3,2,8,0xb2d944d2
50034.19,4.0,165,2,4,1,7,0x3b9ade07
0.0,1.0,5,1,2,3,6,0xb2d612e1
100004.42,2.0,259,3,3,1,7,0xb2d4391d
2600.91,1.0,42,1,2,2,5,0xb2d623f8
52429.31,2.0,171,3,3,1,7,0xb2d39d1b
12940.62,1.0,92,2,2,1,5,0x3b9b2ea6d
5574.85,1.0,5,2,2,3,7,0xb2d6f22a
35088.0,1.0,92,2,2,1,5,0xb2d0dc43d
500000.0,11.0,6,4,4,3,11,0xb2d59ebe
200000.72,2.0,1,3,3,4,10,0xb2d54194
1303070.99,11.0,7,4,4,3,11,0xb2d23fb1d
153000.0,2.0,6,3,3,3,9,0xb2d970d3
0.03,16.0,92,1,4,1,6,0xb2d2299f
904.72,1.0,27,1,2,2,5,0xb2d1b8b5
4870.68,1.0,10,2,2,3,7,0xb2d9af30
55348.3,1.0,9,3,2,3,8,0xb2d5d5c8
526525.73,2.0,70,4,3,1,8,0xb2d5b628
460.55,1.0,0,1,2,4,7,0xb2d8cded
10164.82,2.0,210,2,3,1,6,0xb2d6484f
130202.54,3.0,27,3,4,2,9,0xb2d90889d
4876.13,1.0,92,2,2,1,5,0xb2d2f57a
957.82,1.0,6,1,2,3,6,0xb2d66539d
10020.07,2.0,41,2,3,2,7,0xb2d9e99b
100942.08,2.0,26,3,3,2,8,0xb2d69a8a
712574.27,6.0,62,4,4,2,10,0xb2d12560
9550.63,1.0,0,2,2,4,8,0xb2d69e93
45920.99,1.0,92,2,2,1,5,0xb2d26168
21.94,1.0,3,1,2,4,7,0xb2d5d145
771.39,1.0,3,1,2,4,7,0xb2d6a833
500005.28,3.0,3,4,4,4,12,0xb2d93052
671299.88,4.0,97,4,4,1,9,0xb2d15f4fd
0.0,1.0,4,1,2,4,7,0xb2d98c16
30000.42,3.0,74,2,4,1,7,0xb2d95eced
101190.44,3.0,62,3,4,2,9,0xb2d5d88a
148879.24,3.0,20,3,4,2,9,0xb2d3d3e2
257048.9,4.0,14,3,4,3,10,0xb2d270e4
1293.1,1.0,92,1,2,1,4,0xb2d20439d
1002365.88,6.0,3,4,4,4,12,0xb2d14e94d
43525.01,2.0,0,2,3,4,9,0xb2d16788
9753.99,1.0,0,2,2,4,8,0xb2d3039cd
432048.02,2.0,1,4,3,4,11,0xb2d0d07c
485492.77,4.0,27,4,4,2,10,0xb2d502aed
220000.0,2.0,28,3,3,2,8,0xb2da0d7a
228034.91,26.0,4,3,4,4,11,0x3b9b2579d
87191.57,1.0,1,3,2,4,9,0xb2d23288
202909.38,2.0,101,3,3,1,7,0xb2d68153
302135.43,4.0,77,4,4,1,9,0xb2d9946b
221349.84,1.0,0,3,2,4,9,0xb2d16822d
7986.46,1.0,0,2,2,4,8,0xb2d6b7cfd
4179.36,1.0,0,2,2,4,8,0xb2d6af1f
364381.77,10.0,0,4,4,4,12,0x3b9af1ac
155495.81,2.0,11,3,3,3,9,0xb2d13e8f
10291.21,1.0,3,2,2,4,8,0xb2d16525
1200000.0,8.0,6,4,4,3,11,0xb2d42dd5
162.86,1.0,7,1,2,3,6,0xb2d2306a
59.33,1.0,12,1,2,3,6,0xb2d2fe31
50559.74,2.0,21,2,3,2,7,0xb2d27abfd
10012.08,2.0,0,2,3,4,9,0xb2d62e34
350003.69,2.0,18,4,3,2,9,0xb2d9554f
301768.92,5.0,14,4,4,3,11,0x3b9b4569
200000.0,2.0,26,3,3,2,8,0xb2da162b
11051.07,1.0,15,2,2,3,7,0xb2d68a60
500104.22,3.0,1,4,4,4,12,0xb2d8524c
150006.34,2.0,182,3,3,1,7,0xb2d8a79bd
200008.13,3.0,20,3,4,2,9,0xb2d10446
90121.45,1.0,0,3,2,4,9,0xb2d0f274
1012.03,1.0,184,1,2,1,4,0xb2d18147
500119.57,3.0,11,4,4,3,11,0xb2d44acd
2801.17,1.0,0,1,2,4,7,0xb2d700a9d
16.63,1.0,34,1,2,2,5,0xb2d9dae9
101690.99,3.0,1,3,4,4,11,0xb2d23a22d
144.49,2.0,15,1,3,3,7,0xb2d0e0d7
1017853.75,3.0,17,4,4,2,10,0xb2d36621
4365.23,1.0,11,2,2,3,7,0xb2d90046
2195694.21,7.0,4,4,4,4,12,0xb2d40700d
100252.28,2.0,2,3,3,4,10,0xb2d09fb4
241013.17,2.0,73,3,3,1,7,0xb2d60a61d
950635.58,17.0,0,4,4,4,12,0x3b9af2a2d
1016.08,1.0,184,1,2,1,4,0xb2d1169c
160811.68,1.0,81,3,2,1,6,0xb2d2b398d
7109.31,1.0,29,2,2,2,6,0xb2d7ae70
1305.63,1.0,5,1,2,3,6,0xb2d2426d
600006.4,4.0,182,4,4,1,9,0xb2d07744d
30227.16,1.0,92,2,2,1,5,0xb2d0d329
500000.0,2.0,7,4,3,3,10,0xb2da518a
99007.3,2.0,0,3,3,4,10,0xb2d341f9
122854.09,1.0,32,3,2,2,7,0xb2d3bbefd
100002.39,2.0,25,3,3,2,8,0xb2d585b3d
105.34,1.0,20,1,2,2,5,0xb2d8eb35
31.89,1.0,17,1,2,2,5,0xb2d93568d
123.75,1.0,10,1,2,3,6,0xb2d224e2d
1046089.14,3.0,154,4,4,1,9,0xb2d3a909
40002.0,3.0,48,2,4,2,8,0xb2d858bdd
261021.64,2.0,69,3,3,1,7,0xb2d5ca07d
740014.12,6.0,2,4,4,4,12,0xb2d24ce4
302344.84,3.0,21,4,4,2,10,0xb2d44454d
20000.21,2.0,206,2,3,1,6,0xb2d69020
1432.73,1.0,92,1,2,1,4,0xb2d3155ed
1126.03,1.0,184,1,2,1,4,0xb2d25146
500081.09,2.0,259,4,3,1,8,0xb2d5f416
5.51,1.0,16,1,2,2,5,0xb2d2602ad
5.0,1.0,0,1,2,4,7,0xb2d8e117
38784.56,7.0,0,2,4,4,10,0x3b9b132b
1964022.12,8.0,51,4,4,2,10,0xb2d3f6f8d
460050.16,6.0,18,4,4,2,10,0xb2d598c3
7757.98,1.0,18,2,2,2,6,0xb2d9c3d5
70012.62,3.0,122,3,4,1,8,0xb2d616a0
200071.01,2.0,0,3,3,4,10,0xb2d0832bd
1519167.81,3.0,200,4,4,1,9,0xb2d24c89
334017.12,2.0,139,4,3,1,8,0xb2d53f9a
6326.17,1.0,0,2,2,4,8,0xb2d3613c
0.0,1.0,5,1,2,3,6,0xb2d21dfe
1020040.28,5.0,0,4,4,4,12,0xb2d32dd7
1731.88,1.0,92,1,2,1,4,0xb2d0c9c3
30776.26,2.0,0,2,3,4,9,0x3b9af2c1d
581345.25,2.0,92,4,3,1,8,0xb2d180d4d
36629.15,1.0,21,2,2,2,6,0xb2d1e087
800000.0,3.0,10,4,4,3,11,0xb2d929aed
50005.32,1.0,12,2,2,3,7,0xb2d68dc1
60749.47,4.0,13,3,4,3,10,0xb2d249c3
10000.0,3.0,95,2,4,1,7,0xb2d91236d
17849.95,2.0,260,2,3,1,6,0xb2d225fbd
1.82,1.0,92,1,2,1,4,0xb2d2e90a
217474.59,2.0,136,3,3,1,7,0xb2d07e7ad
80.75,1.0,1,1,2,4,7,0xb2d9c626
210000.01,2.0,3,3,3,4,10,0xb2da032a
559608.01,2.0,1,4,3,4,11,0xb2d644f3
258.06,1.0,1,1,2,4,7,0xb2d36e59d
260037.04,2.0,2,3,3,4,10,0xb2d576f1
50001.58,2.0,4,2,3,4,9,0xb2d99926
890028.21,2.0,164,4,3,1,8,0xb2d6c7bf
1747.71,1.0,184,1,2,1,4,0xb2d25153
5.77,1.0,33,1,2,2,5,0xb2d6ce13
200000.0,2.0,1,3,3,4,10,0xb2d9c62f
44544.54,1.0,0,2,2,4,8,0xb2d94933
50009.72,2.0,203,2,3,1,6,0xb2d56a84
3805.94,1.0,28,2,2,2,6,0xb2d4548e
219.75,1.0,10,1,2,3,6,0xb2d2d46b
50102.64,1.0,14,2,2,3,7,0xb2d5e77f
61577.04,1.0,0,3,2,4,9,0xb2d6af0f
9340254.13,7.0,2,4,4,4,12,0xb2d0e5bf
10578.29,1.0,0,2,2,4,8,0xb2d85948
216052.26,2.0,111,3,3,1,7,0xb2d3c86d
421498.15,5.0,18,4,4,2,10,0xb2d1c09d
203604.68,2.0,54,3,3,2,8,0xb2d5e654
122573.76,2.0,19,3,3,2,8,0xb2d78368
192025.29,4.0,73,3,4,1,8,0xb2d244a4
600356.33,5.0,8,4,4,3,11,0xb2d94fded
580.28,1.0,6,1,2,3,6,0xb2d31009
1278.16,1.0,92,1,2,1,4,0xb2d2e646d
204978.31,2.0,235,3,3,1,7,0xb2d6ed9cd
410000.0,14.0,0,4,4,4,12,0xb2d708a0
10.83,1.0,33,1,2,2,5,0xb2d91943
87642.94,1.0,1,3,2,4,9,0xb2d62777
2953.89,1.0,0,2,2,4,8,0xb2d88c77
47.1,1.0,12,1,2,3,6,0xb2d42b33d
742.49,1.0,0,1,2,4,7,0xb2d6f370d
1381.89,1.0,0,1,2,4,7,0xb2d69c89
2752.41,1.0,0,1,2,4,7,0xb2d69230
1437.96,2.0,92,1,3,1,5,0x3b9b48ce
3656.22,1.0,10,2,2,3,7,0xb2d42d70
38003.85,5.0,111,2,4,1,7,0x3b9b4841d
1058003.97,6.0,3,4,4,4,12,0xb2d12b74d
2404.88,1.0,0,1,2,4,7,0xb2d8f51e
1058773.09,3.0,47,4,4,2,10,0xb2d3e5e2
60.41,1.0,67,1,2,1,4,0xb2d24b6a
53459.86,1.0,15,3,2,3,8,0xb2d56613
6580.64,1.0,92,2,2,1,5,0xb2d386a4
926550.51,4.0,52,4,4,2,10,0xb2d113d0
468565.91,3.0,13,4,4,3,11,0xb2d24635d
452818.44,8.0,0,4,4,4,12,0xb2d3a2a8d
2086.24,2.0,92,1,3,1,5,0xb2d06cd7
13579.8,1.0,9,2,2,3,7,0xb2d8f69bd
64.23,1.0,9,1,2,3,6,0xb2d430a1
23.99,1.0,57,1,2,2,5,0xb2d23310
2072.48,1.0,18,1,2,2,5,0xb2d7077e
208031.34,2.0,0,3,3,4,10,0xb2d4ac8ad
5869.82,1.0,92,2,2,1,5,0xb2d21274
8240.71,1.0,0,2,2,4,8,0xb2d9173f
645122.27,4.0,105,4,4,1,9,0xb2d6944e
44071.6,1.0,13,2,2,3,7,0xb2d21a6c
400005.97,2.0,2,4,3,4,11,0xb2d8f883
9740.64,1.0,0,2,2,4,8,0xb2d93958
882009.31,2.0,92,4,3,1,8,0xb2d98020
3377.77,1.0,0,2,2,4,8,0xb2d5bdbb
50514.21,3.0,31,2,4,2,8,0xb2d2696e
10840.25,2.0,0,2,3,4,9,0xb2d57a6f
249203.74,5.0,0,3,4,4,11,0x3b9af285d
3474.65,1.0,0,2,2,4,8,0xb2d6bdf1
2119.82,1.0,2,1,2,4,7,0xb2d22f2d
203319.68,2.0,25,3,3,2,8,0xb2d2a311
210003.22,2.0,172,3,3,1,7,0xb2d8d889d
221427.35,3.0,42,3,4,2,9,0xb2d997a0
302830.08,2.0,21,4,3,2,9,0xb2d108ae
2411263.89,6.0,3,4,4,4,12,0xb2d309bd
101406.89,2.0,9,3,3,3,9,0xb2d3777c
630023.34,5.0,0,4,4,4,12,0xb2d5f02b
152.81,1.0,26,1,2,2,5,0xb2d12073
816.12,1.0,82,1,2,1,4,0xb2d62c02
10039.87,1.0,92,2,2,1,5,0xb2d2e8e7
0.21,1.0,66,1,2,2,5,0xb2d6cd3b
224701.22,2.0,33,3,3,2,8,0xb2d686fe
201421.05,2.0,69,3,3,1,7,0xb2d9ae7b
220044.8,4.0,47,3,4,2,9,0xb2d2d62a
9730.63,1.0,22,2,2,2,6,0xb2d1f71ed
713398.92,5.0,13,4,4,3,11,0xb2d39d01
30119.88,1.0,184,2,2,1,5,0xb2d60c8f
475439.09,8.0,6,4,4,3,11,0xb2d9a267
0.88,1.0,7,1,2,3,6,0xb2d4c10b
220000.0,2.0,3,3,3,4,10,0xb2d97d01
122001.29,2.0,34,3,3,2,8,0xb2d92e47
81954.83,1.0,1,3,2,4,9,0xb2d2d2e6
110009.56,2.0,10,3,3,3,9,0xb2d60e63
1162877.7,2.0,10,4,3,3,10,0xb2d4ff2a
280014.39,6.0,10,3,4,3,10,0xb2d3a5ffd
1.38,1.0,17,1,2,2,5,0xb2da07a8
25002.05,2.0,162,2,3,1,6,0xb2d6a01c
6643.14,1.0,9,2,2,3,7,0xb2d6383d
8615.29,2.0,184,2,3,1,6,0xb2d30df2d
153113.47,2.0,39,3,3,2,8,0xb2d28720d
267.23,1.0,7,1,2,3,6,0xb2d1c887d
60002.54,6.0,80,3,4,1,8,0xb2d2a5bed
4.61,1.0,110,1,2,1,4,0xb2d540d0
851038.93,5.0,31,4,4,2,10,0xb2d6b49e
13311.63,1.0,11,2,2,3,7,0xb2d423e5
27000.99,1.0,0,2,2,4,8,0xb2d3ec72
15768.97,1.0,0,2,2,4,8,0xb2d318a3
1180092.48,5.0,18,4,4,2,10,0xb2d3adcf
352.42,1.0,0,1,2,4,7,0xb2d6a758
5001.98,1.0,4,2,2,4,8,0xb2d9451a
189232.54,2.0,32,3,3,2,8,0xb2d518b1d
310006.54,2.0,25,4,3,2,9,0xb2da11a1
4.41,1.0,33,1,2,2,5,0xb2d185ae
3249.14,1.0,92,2,2,1,5,0xb2d1116c
0.53,2.0,52,1,3,2,6,0xb2d1e27ed
0.0,1.0,3,1,2,4,7,0xb2d3566ad
10016.81,2.0,31,2,3,2,7,0xb2d6d6ce
50002.11,2.0,55,2,3,2,7,0xb2d90297d
201649.64,2.0,6,3,3,3,9,0xb2d98f77
180.12,1.0,0,1,2,4,7,0xb2d3c0ce
10311.66,4.0,0,2,4,4,10,0xb2d943d6
217428.1,1.0,0,3,2,4,9,0xb2d8d3d3
500000.0,1.0,0,4,2,4,10,0xb2da5ed4
1105691.05,3.0,25,4,4,2,10,0xb2d6fa6b
39.19,1.0,1,1,2,4,7,0xb2d56df9
39.8,1.0,74,1,2,1,4,0xb2d780b9
2334.07,1.0,92,1,2,1,4,0xb2d42bee
2041711.88,2.0,12,4,3,3,10,0x3b9af6ea
720789.07,9.0,0,4,4,4,12,0x3b9af16c
50043.78,2.0,193,2,3,1,6,0xb2d5d404d
1070620.56,6.0,0,4,4,4,12,0xb2d0d4f6d
3141959.09,15.0,0,4,4,4,12,0x3b9b19b6
401421.69,2.0,30,4,3,2,9,0xb2d9baa6
961487.0,2.0,39,4,3,2,9,0xb2d1081f
501776.21,2.0,19,4,3,2,9,0xb2d6c357
23510.32,1.0,18,2,2,2,6,0xb2d6edf2d
48455.0,2.0,2,2,3,4,9,0xb2d96c86
1.05,1.0,11,1,2,3,6,0xb2d85bbc
1334.3,1.0,92,1,2,1,4,0xb2d346f7d
282000.0,1.0,3,3,2,4,9,0xb2d96ed7
0.49,5.0,1,1,4,4,9,0xb2d3d6d9
4578.52,1.0,0,2,2,4,8,0xb2d41427
100042.65,3.0,3,3,4,4,11,0xb2d418b1
1000118.43,2.0,70,4,3,1,8,0xb2d55599
480030.96,2.0,6,4,3,3,10,0xb2d6b01bd
170001.8,3.0,80,3,4,1,8,0xb2d6a9e3
4930.93,1.0,3,2,2,4,8,0xb2d211fc
160000.0,2.0,1,3,3,4,10,0xb2d5b161
13771.27,1.0,0,2,2,4,8,0xb2d78777
4038.07,1.0,92,2,2,1,5,0xb2d31cd7
120459.05,3.0,27,3,4,2,9,0xb2d5e576d
110000.0,1.0,5,3,2,3,8,0xb2d970ea
200063.3,3.0,16,3,4,2,9,0xb2d08870d
12294.24,1.0,0,2,2,4,8,0xb2d68abb
1659430.43,3.0,1,4,4,4,12,0xb2d552b8
1586644.64,4.0,53,4,4,2,10,0xb2d52de4d
68002.32,4.0,97,3,4,1,8,0xb2d25784
1110.16,1.0,4,1,2,4,7,0xb2d5d75a
230031.4,4.0,109,3,4,1,8,0xb2d5fe0e
290034.67,2.0,25,3,3,2,8,0xb2d4edf5d
1012.03,1.0,223,1,2,1,4,0xb2d64bd9d
20019.42,1.0,102,2,2,1,5,0xb2d64dd9d
31.56,1.0,3,1,2,4,7,0xb2d60a44
175005.55,2.0,25,3,3,2,8,0xb2d5c054d
800000.0,2.0,28,4,3,2,9,0xb2d941b0
30320.12,3.0,1,2,4,4,10,0xb2d63e1a
1278.79,1.0,33,1,2,2,5,0xb2d0ca2d
454987.9,9.0,2,4,4,4,12,0xb2d29692
278.91,1.0,11,1,2,3,6,0xb2d59060
510029.31,5.0,14,4,4,3,11,0xb2d69265d
18190.13,2.0,30,2,3,2,7,0xb2d68238
100002.11,2.0,53,3,3,2,8,0xb2d9ccbb
4578.76,1.0,0,2,2,4,8,0xb2d54abed
156.03,1.0,8,1,2,3,6,0xb2d8ca0f
1.99,1.0,93,1,2,1,4,0xb2d23167
130001.79,3.0,77,3,4,1,8,0xb2d99193
12.67,1.0,84,1,2,1,4,0xb2d8cc9a
165540.27,2.0,1,3,3,4,10,0xb2d5f37fd
1483.23,1.0,184,1,2,1,4,0xb2d34a09
11714.96,1.0,1,2,2,4,8,0xb2d8ea17
55940.61,1.0,10,3,2,3,8,0xb2d6e7dcd
35314.7,1.0,29,2,2,2,6,0xb2d6bb01d
110361.56,4.0,0,3,4,4,11,0xb2d07727d
1721095.51,19.0,6,4,4,3,11,0xb2d08142
1043380.37,13.0,0,4,4,4,12,0xb2d2449b
162824.55,5.0,0,3,4,4,11,0xb2d0d62a
1404.63,1.0,92,1,2,1,4,0xb2d0d873
1111.06,1.0,92,1,2,1,4,0xb2d2bcf6
61.4,1.0,76,1,2,1,4,0xb2d21173
10366133.7,2.0,5,4,3,3,10,0xb2d5a9bb
50001.35,4.0,10,2,4,3,9,0xb2d5c247
627.19,1.0,12,1,2,3,6,0xb2d6466c
497784.45,3.0,75,4,4,1,9,0xb2d3d4f4d
119003.56,4.0,56,3,4,2,9,0xb2d06a70d
6059.96,1.0,184,2,2,1,5,0xb2d27bacd
7326.51,9.0,1,2,4,4,10,0x3b9b32e3d
1163.99,1.0,3,1,2,4,7,0xb2d0e15d
50171.76,1.0,92,2,2,1,5,0xb2d5d2e4d
10010.25,2.0,81,2,3,1,6,0xb2d57e67
100003.92,2.0,0,3,3,4,10,0xb2d2fd2f
600000.0,3.0,5,4,4,3,11,0xb2d6a8e2d
360001.5,2.0,19,4,3,2,9,0xb2d8d828
2414123.67,12.0,0,4,4,4,12,0xb2d10d67
34.21,1.0,96,1,2,1,4,0xb2d51df1
400030.19,3.0,4,4,4,4,12,0xb2d6919f
500153.53,2.0,10,4,3,3,10,0xb2d8e7df
1644.71,1.0,184,1,2,1,4,0xb2d323f6d
594.67,1.0,19,1,2,2,5,0xb2d672bd
100448.49,1.0,92,3,2,1,6,0xb2d0dd26
124976.29,1.0,29,3,2,2,7,0xb2d50d28
500761.56,4.0,33,4,4,2,10,0xb2d6692b
151166.74,3.0,101,3,4,1,8,0xb2d54abb
307346.34,1.0,184,4,2,1,7,0xb2d3ac33d
7124.44,1.0,21,2,2,2,6,0xb2d21c12d
1323.88,1.0,0,1,2,4,7,0xb2d4ea1a
101987.66,1.0,24,3,2,2,7,0xb2d12230d
1490034.48,9.0,5,4,4,3,11,0x3b9b0fa0
90322.9,2.0,1,3,3,4,10,0xb2d6326d
50196.17,2.0,73,2,3,1,6,0xb2d78783
250043.45,5.0,90,3,4,1,8,0xb2d2f349
203239.86,2.0,37,3,3,2,8,0xb2d0c638
604659.93,3.0,43,4,4,2,10,0xb2d40cae
49372.44,1.0,21,2,2,2,6,0xb2d53662
85.68,1.0,1,1,2,4,7,0xb2d42b19
311080.17,3.0,28,4,4,2,10,0xb2d54f2b
58212.74,1.0,0,3,2,4,9,0xb2d553cd
837.92,1.0,50,1,2,2,5,0xb2d5ec3c
202132.03,2.0,105,3,3,1,7,0xb2d953ce
620086.84,4.0,10,4,4,3,11,0xb2d60728d
7612.0,1.0,82,2,2,1,5,0xb2d4d3da
7871.92,1.0,10,2,2,3,7,0xb2d3c2d9
1.58,1.0,42,1,2,2,5,0xb2d9e437
3.1,1.0,14,1,2,3,6,0xb2d61c26
33857.71,1.0,10,2,2,3,7,0xb2d2b7bad
4672693.82,6.0,53,4,4,2,10,0xb2d6ed3d
362011.89,6.0,0,4,4,4,12,0xb2d4caf4d
1065.98,1.0,145,1,2,1,4,0xb2d2cb73
1225.0,1.0,92,1,2,1,4,0xb2d06820
2.64,1.0,184,1,2,1,4,0xb2d2aef1
50067.88,2.0,193,2,3,1,6,0xb2d5e566d
528.2,1.0,9,1,2,3,6,0xb2d3f4acd
102357.94,1.0,13,3,2,3,8,0xb2d2c135d
1290034.92,9.0,0,4,4,4,12,0x3b9b124a
377001.56,8.0,24,4,4,2,10,0xb2d4e29b
211492.09,2.0,68,3,3,1,7,0xb2d9aea2
334304.37,3.0,21,4,4,2,10,0xb2d5d5ae
38898.19,1.0,21,2,2,2,6,0xb2da08ad
0.55,5.0,7,1,4,3,8,0xb2d3d6d9d
3289.14,1.0,27,2,2,2,6,0xb2d6c3ce
200031.85,2.0,0,3,3,4,10,0xb2d79020
814217.04,5.0,5,4,4,3,11,0xb2d6d792
27382.48,1.0,182,2,2,1,5,0xb2d4ead9
0.07,1.0,15,1,2,3,6,0xb2d67de0
5358.78,1.0,92,2,2,1,5,0x3b9af4d8
12886.63,1.0,6,2,2,3,7,0xb2d262f0d
1960.49,1.0,92,1,2,1,4,0xb2d0a618
1507208.58,11.0,0,4,4,4,12,0xb2d41eac
200560.67,2.0,184,3,3,1,7,0xb2d0b8d7
1604023.38,4.0,0,4,4,4,12,0xb2d264ad
114523.72,1.0,0,3,2,4,9,0xb2d35bd6d
2046.8,1.0,92,1,2,1,4,0xb2d333f3
9881.57,1.0,0,2,2,4,8,0xb2d95c75
828752.12,5.0,80,4,4,1,9,0xb2d64989d
949.18,1.0,3,1,2,4,7,0xb2d8a122
8.34,1.0,28,1,2,2,5,0xb2d4744a
2.0,2.0,33,1,3,2,6,0xb2d532bd
300436.49,2.0,122,4,3,1,8,0xb2d3cfb6d
2677.99,1.0,184,1,2,1,4,0xb2d2543e
311707.43,5.0,1,4,4,4,12,0xb2d56c06
96577.96,2.0,228,3,3,1,7,0xb2d609eb
112.42,1.0,80,1,2,1,4,0xb2d8b21e
2197.72,1.0,0,1,2,4,7,0xb2d33dc1d
380480.74,2.0,49,4,3,2,9,0xb2d17019
243236.55,5.0,77,3,4,1,8,0xb2d4b8e5d
60608.96,2.0,45,3,3,2,8,0xb2d6dc8d
32219.19,3.0,18,2,4,2,8,0x3b9af1a2
4012.48,1.0,21,2,2,2,6,0xb2d1535ad
28.37,1.0,34,1,2,2,5,0xb2d9a69b
910003.84,6.0,0,4,4,4,12,0xb2d59c5b
200000.0,2.0,6,3,3,3,9,0xb2da5abf
68011.55,3.0,111,3,4,1,8,0xb2d4a5a7d
143333.18,2.0,0,3,3,4,10,0xb2d21352
101827.1,1.0,40,3,2,2,7,0xb2d15074
301065.63,2.0,31,4,3,2,9,0xb2d93ef8
1485.33,1.0,0,1,2,4,7,0xb2d12b42
1507.28,1.0,92,1,2,1,4,0xb2d3863e
1894636.16,9.0,1,4,4,4,12,0x3b9b3858
451501.39,5.0,4,4,4,4,12,0xb2d981c7
200000.0,2.0,0,3,3,4,10,0xb2d970fe
855115.95,10.0,1,4,4,4,12,0xb2d64a1ad
125275.04,2.0,62,3,3,2,8,0xb2d4f5ed
300003.17,2.0,31,3,3,2,8,0xb2d93a7b
80866.24,2.0,139,3,3,1,7,0xb2d63bff
21110.52,1.0,305,2,2,1,5,0xb2d3cf06
71.81,1.0,13,1,2,3,6,0xb2d27cac
50008.44,1.0,4,2,2,4,8,0xb2d900c4
53613.97,2.0,174,3,3,1,7,0xb2d386ee
100047.36,2.0,97,3,3,1,7,0xb2d26c14d
81298.24,1.0,6,3,2,3,8,0xb2d18f63
568162.9,3.0,7,4,4,3,11,0xb2d435c3
130002.74,2.0,62,3,3,2,8,0xb2d8f6e8
1120036.24,13.0,13,4,4,3,11,0xb2d57a92
100002.12,3.0,48,3,4,2,9,0xb2d6ef45d
1050.42,1.0,9,1,2,3,6,0xb2d413d0
400062.67,3.0,11,4,4,3,11,0xb2d81e73
1691.3,1.0,10,1,2,3,6,0xb2d4234fd
50062.31,2.0,63,2,3,2,7,0xb2d8e690
2762.33,1.0,184,1,2,1,4,0xb2d20d2cd
110037.5,3.0,125,3,4,1,8,0xb2d1d51c
1165.92,1.0,18,1,2,2,5,0xb2d6039c
4.34,1.0,40,1,2,2,5,0xb2d6b726
6339.97,1.0,15,2,2,3,7,0xb2d95a19
61202.41,2.0,171,3,3,1,7,0xb2d07aab
30001.58,2.0,203,2,3,1,6,0xb2d78921
508159.13,3.0,14,4,4,3,11,0xb2d109d0
401454.61,3.0,21,4,4,2,10,0xb2d23db7
12211.14,1.0,184,2,2,1,5,0xb2d09bf0d
13.49,1.0,112,1,2,1,4,0xb2d22b3f
1000088.1,3.0,11,4,4,3,11,0xb2d7f37dd
2.95,3.0,20,1,4,2,7,0xb2d09f59
258382.63,8.0,0,3,4,4,11,0x3b9ad187d
37025.86,1.0,15,2,2,3,7,0xb2d8c8eed
189.34,1.0,6,1,2,3,6,0xb2d2e944
281746.46,4.0,3,3,4,4,11,0xb2d64ef8
220063.27,2.0,17,3,3,2,8,0xb2d985bd
3884.84,1.0,144,2,2,1,5,0xb2d1d03a
25287.33,1.0,9,2,2,3,7,0xb2d6b7dc
2640004.67,8.0,0,4,4,4,12,0xb2d29361
970066.45,15.0,11,4,4,3,11,0xb2d49138
1142.57,1.0,210,1,2,1,4,0xb2d2da25d
2815738.93,4.0,0,4,4,4,12,0xb2d3b609
1792.27,2.0,49,1,3,2,6,0xb2d95f76
204007.04,2.0,38,3,3,2,8,0xb2d54f2bd
335430.79,4.0,130,4,4,1,9,0xb2d15b61
31366.7,1.0,1,2,2,4,8,0xb2d1cbb3
1992.64,1.0,99,1,2,1,4,0xb2d59493d
190665.0,1.0,12,3,2,3,8,0xb2d3ca52
105061.59,2.0,12,3,3,3,9,0xb2d0705c
3392985.23,6.0,108,4,4,1,9,0xb2d16fe8
95265.48,1.0,20,3,2,2,7,0xb2d24129
200000.0,2.0,20,3,3,2,8,0xb2d953ded
401318.37,3.0,4,4,4,4,12,0xb2d62949d
534000.41,3.0,0,4,4,4,12,0xb2d5cc82d
65268.72,10.0,74,3,4,1,8,0xb2d1077ed
224148.58,5.0,12,3,4,3,10,0xb2d69269
400666.71,3.0,20,4,4,2,10,0xb2d27211d
61923.04,2.0,142,3,3,1,7,0xb2d38466
8334.44,1.0,9,2,2,3,7,0xb2d5cfc1
9084.15,2.0,6,2,3,3,8,0xb2d4138fd
136907.14,4.0,1,3,4,4,11,0xb2d31d65
1996.04,1.0,66,1,2,2,5,0xb2d38e91
284005.62,2.0,34,3,3,2,8,0xb2d9fc16
120089.44,2.0,108,3,3,1,7,0xb2d5735c
20141.85,1.0,139,2,2,1,5,0xb2d342ed
530000.84,5.0,84,4,4,1,9,0xb2d596d5d
670035.6,3.0,9,4,4,3,11,0xb2d3ca43
3613.3,1.0,0,2,2,4,8,0xb2d4ace6d
1665.02,1.0,0,1,2,4,7,0xb2d0f997
42635.99,1.0,11,2,2,3,7,0xb2d25df1d
1486.7,1.0,92,1,2,1,4,0xb2d21d45
8852.21,1.0,7,2,2,3,7,0xb2d0fc9ed
28245.37,1.0,9,2,2,3,7,0xb2d3a2b0
107.23,1.0,4,1,2,4,7,0xb2d213bc
151.77,1.0,24,1,2,2,5,0xb2d3f9c3
400712.54,3.0,10,4,4,3,11,0xb2d6fb19
687002.35,4.0,10,4,4,3,11,0xb2d40bf2
21995.68,1.0,81,2,2,1,5,0xb2d3107ed
1500575.25,10.0,0,4,4,4,12,0xb2d21feb
4126.3,1.0,160,2,2,1,5,0xb2d65d4a
56.99,1.0,12,1,2,3,6,0xb2d5faa0
1874.77,3.0,184,1,4,1,6,0x3b9b18bfd
544.54,1.0,6,1,2,3,6,0xb2d95a98
302918.4,4.0,62,4,4,2,10,0xb2d3aa7ed
600065.28,2.0,16,4,3,2,9,0xb2d62900
556.92,1.0,2,1,2,4,7,0xb2d579e4
4173.37,1.0,0,2,2,4,8,0xb2d210d7d
4499.26,1.0,181,2,2,1,5,0xb2d2b1af
1000239.59,2.0,24,4,3,2,9,0xb2d4e702d
45171.99,3.0,0,2,4,4,10,0xb2d695d4d
135.91,1.0,73,1,2,1,4,0xb2d60c58
8414.8,1.0,3,2,2,4,8,0xb2d15767d
120331.29,2.0,245,3,3,1,7,0xb2d6167e
100012.17,2.0,0,3,3,4,10,0xb2d90796
87981.41,1.0,10,3,2,3,8,0xb2d3ccc0
5012.78,1.0,252,2,2,1,5,0xb2d6d380
2409.81,1.0,92,1,2,1,4,0xb2d59be9
100046.09,2.0,124,3,3,1,7,0xb2d61b0e
165110.03,3.0,0,3,4,4,11,0xb2d27b7d
140188.98,5.0,40,3,4,2,9,0xb2d5f18c
1636.9,1.0,92,1,2,1,4,0xb2d35d40
50000.53,2.0,80,2,3,1,6,0xb2d367c3
160000.0,4.0,0,3,4,4,11,0xb2d15f13d
52925.22,2.0,0,3,3,4,10,0xb2d1741e
348.13,1.0,5,1,2,3,6,0xb2d53b20
716037.73,5.0,6,4,4,3,11,0xb2d13f15
83.92,1.0,1,1,2,4,7,0xb2d47301
1001776.29,3.0,12,4,4,3,11,0xb2d9d24f
250006.97,4.0,4,3,4,4,11,0xb2d57e30d
252244.09,3.0,76,3,4,1,8,0xb2d6cbc5d
1219.42,1.0,0,1,2,4,7,0xb2d5c93e
1624063.96,7.0,0,4,4,4,12,0xb2d62be1
401883.31,2.0,14,4,3,3,10,0xb2d9c95d
0.6,1.0,8,1,2,3,6,0xb2d31ec8
8229.54,1.0,1,2,2,4,8,0xb2d75624
657630.4,10.0,0,4,4,4,12,0xb2d0db79d
65.99,1.0,49,1,2,2,5,0xb2d28e92
225782.3,2.0,185,3,3,1,7,0xb2d1aa13
350013.11,2.0,0,4,3,4,11,0xb2da0ed5
3751.57,1.0,12,2,2,3,7,0xb2d3ef21
675.27,1.0,7,1,2,3,6,0xb2d2a64b
66068.76,2.0,31,3,3,2,8,0xb2d3f461
20054.43,1.0,0,2,2,4,8,0xb2d603d5d
65.28,2.0,5,1,3,3,7,0xb2d1742b
2113.66,1.0,92,1,2,1,4,0xb2d12f9cd
50000.0,2.0,6,2,3,3,8,0xb2da4659
268.89,1.0,1,1,2,4,7,0xb2d58472
420000.46,3.0,140,4,4,1,9,0xb2d57a8a
200003.5,3.0,18,3,4,2,9,0xb2d5ef6fd
300006.33,3.0,69,3,4,1,8,0xb2d8d792d
3277.96,1.0,10,2,2,3,7,0xb2d9fc47
156545.44,3.0,20,3,4,2,9,0xb2d50ccad
662.47,2.0,10,1,3,3,7,0xb2d20ebfd
438.62,2.0,20,1,3,2,6,0xb2d0c838
91271.19,3.0,18,3,4,2,9,0xb2d40990
6625.7,2.0,184,2,3,1,6,0xb2d073ed
0.04,2.0,30,1,3,2,6,0xb2da0613
17342.57,1.0,92,2,2,1,5,0xb2d53b67d
1079.94,1.0,184,1,2,1,4,0xb2d20f9bd
39692.77,1.0,1,2,2,4,8,0xb2d3f9e1
100000.0,4.0,0,3,4,4,11,0xb2d92c21
308266.69,2.0,39,4,3,2,9,0xb2d416c5d
531423.05,1.0,3,4,2,4,10,0xb2d49f32d
24983.86,1.0,20,2,2,2,6,0xb2d6bafc
128801.03,2.0,25,3,3,2,8,0xb2d1ef29
272200.8,3.0,32,3,4,2,9,0xb2d0b79b
50373.35,1.0,20,2,2,2,6,0xb2d987ad
4539.79,1.0,0,2,2,4,8,0xb2d56e9d
68.36,1.0,14,1,2,3,6,0xb2d97d39
2999.48,1.0,14,2,2,3,7,0xb2d594a4
1632.14,3.0,92,1,4,1,6,0xb2d0933b
30917.64,1.0,0,2,2,4,8,0xb2d6a649
9663.64,1.0,11,2,2,3,7,0xb2d5c7de
60485.24,3.0,116,3,4,1,8,0xb2d568c9d
51736.08,2.0,13,2,3,3,8,0xb2d8e419
221424.43,2.0,43,3,3,2,8,0xb2d1b018
2749.53,1.0,10,1,2,3,6,0xb2d6d3e4
6209.64,1.0,4,2,2,4,8,0xb2d26a98
13.1,1.0,9,1,2,3,6,0xb2d78653
2024028.69,4.0,6,4,4,3,11,0xb2d5d097
227.09,1.0,5,1,2,3,6,0xb2d29d2e
510114.37,4.0,0,4,4,4,12,0xb2d90f6b
1015.51,1.0,184,1,2,1,4,0xb2d1481ed
416833.21,2.0,77,4,3,1,8,0xb2d12cc6
1124.95,1.0,92,1,2,1,4,0xb2d25146d
5256.77,1.0,8,2,2,3,7,0xb2d2072b
430002.79,7.0,52,4,4,2,10,0x3b9b0e34
2702.16,1.0,16,1,2,2,5,0xb2d8c5fe
500087.65,8.0,25,4,4,2,10,0x3b9b47f6
505036.7,6.0,0,4,4,4,12,0xb2d1b24a
221748.62,2.0,189,3,3,1,7,0xb2d49198d
150002.31,4.0,80,3,4,1,8,0xb2d6256fd
672590.59,3.0,0,4,4,4,12,0xb2d19523
178572.05,3.0,27,3,4,2,9,0xb2d4418e
12.36,1.0,184,1,2,1,4,0xb2d280a6
200067.16,4.0,25,3,4,2,9,0xb2d245ae
351.5,1.0,3,1,2,4,7,0xb2d3d403
7.55,1.0,19,1,2,2,5,0xb2d6bb26d
550053.29,3.0,8,4,4,3,11,0xb2d118c7
97749.58,1.0,184,3,2,1,6,0xb2d10c56d
11696.13,1.0,92,2,2,1,5,0xb2d1dc6dd
642.89,1.0,1,1,2,4,7,0xb2d9411f
79555.36,1.0,3,3,2,4,9,0xb2d23d32
190000.68,1.0,4,3,2,4,9,0xb2d91d4ad
3995.15,1.0,18,2,2,2,6,0xb2d94dd6
1002.88,3.0,92,1,4,1,6,0xb2d32dc9
3891.06,1.0,92,2,2,1,5,0xb2d2bbe1
1209.42,1.0,12,1,2,3,6,0xb2d324b2
85063.93,1.0,12,3,2,3,8,0xb2d2d866
367986.08,3.0,0,4,4,4,12,0xb2d60997
37562.31,1.0,13,2,2,3,7,0xb2d486d9
6083759.29,2.0,196,4,3,1,8,0xb2d68897
23502.89,1.0,5,2,2,3,7,0xb2d4b04a
277868.13,1.0,184,3,2,1,6,0xb2d2d9d4
1225.63,1.0,11,1,2,3,6,0xb2d99770
111863.99,2.0,108,3,3,1,7,0xb2d249be
10.92,1.0,27,1,2,2,5,0xb2d5b003
203031.0,3.0,133,3,4,1,8,0xb2d5b2df
5055.27,1.0,184,2,2,1,5,0xb2d28807
508885.21,2.0,154,4,3,1,8,0xb2d8fb82
0.58,1.0,64,1,2,2,5,0xb2d8926ad
58.91,1.0,36,1,2,2,5,0xb2d599a2d
2278005.08,16.0,11,4,4,3,11,0x3b9b288fd
13.77,1.0,21,1,2,2,5,0xb2d0cba3
57638.03,1.0,67,3,2,1,6,0xb2d68a13d
285074.58,4.0,52,3,4,2,9,0xb2d3f255
10931.95,1.0,34,2,2,2,6,0xb2d51e2c
370000.0,2.0,7,4,3,3,10,0xb2da5476
150011.17,2.0,70,3,3,1,7,0xb2d6905a
6908.92,1.0,184,2,2,1,5,0xb2d321c9
3692.85,1.0,67,2,2,1,5,0xb2d30f85
0.32,1.0,6,1,2,3,6,0xb2d6f35b
164764.91,2.0,104,3,3,1,7,0xb2d5b9dc
308404.98,1.0,0,4,2,4,10,0xb2d6de7e
18501.51,2.0,184,2,3,1,6,0x3b9b37eb
4604.21,1.0,184,2,2,1,5,0xb2d10b1b
1200000.0,2.0,1,4,3,4,11,0xb2d46e57d
3061133.15,6.0,0,4,4,4,12,0x3b9b1826
20000.42,2.0,59,2,3,2,7,0xb2d8fdead
308129.36,3.0,8,4,4,3,11,0xb2d5162e
26003.8,2.0,63,2,3,2,7,0xb2d96075
44556.11,1.0,21,2,2,2,6,0xb2d41637
204488.72,4.0,34,3,4,2,9,0xb2d08e5a
22043.71,3.0,0,2,4,4,10,0xb2d54df2
7.39,1.0,73,1,2,1,4,0xb2d8d62f
80140.55,3.0,0,3,4,4,11,0xb2d3632d
10966.98,1.0,0,2,2,4,8,0xb2d912dbd
1296.18,1.0,92,1,2,1,4,0xb2d4da9fd
1353.14,1.0,110,1,2,1,4,0xb2d0d271
3144.05,1.0,9,2,2,3,7,0xb2d47064
100000.0,2.0,4,3,3,4,10,0xb2da5a6e
300000.0,4.0,2,3,4,4,11,0xb2d14eb5
101133.02,2.0,7,3,3,3,9,0xb2d34559
7189.17,1.0,184,2,2,1,5,0xb2d0dbb2d
7334.85,1.0,11,2,2,3,7,0xb2d8b198d
229187.5,11.0,42,3,4,2,9,0xb2d61b4cd
225.07,1.0,29,1,2,2,5,0xb2d68559
5421.65,2.0,13,2,3,3,8,0x3b9b3bc8
5746.79,3.0,155,2,4,1,7,0xb2d6ba5e
425.53,1.0,29,1,2,2,5,0xb2d39109
300012.16,2.0,1,3,3,4,10,0xb2d948edd
13112.96,1.0,3,2,2,4,8,0xb2d99e92
10877.87,1.0,25,2,2,2,6,0xb2d68fdf
200141.19,2.0,6,3,3,3,9,0xb2d4f6b9d
192612.63,10.0,1,3,4,4,11,0xb2d6b12e
70573.45,1.0,0,3,2,4,9,0xb2d5974a
419104.48,2.0,5,4,3,3,10,0xb2d4a564d
1571732.08,12.0,13,4,4,3,11,0xb2d1266dd
97271.83,2.0,15,3,3,3,9,0xb2d5feb1
11995.85,1.0,40,2,2,2,6,0xb2d6bf17
133.41,1.0,25,1,2,2,5,0xb2d5eb80
586.7,1.0,18,1,2,2,5,0xb2d0f7a3
81086.77,4.0,0,3,4,4,11,0xb2d2b302
3114.83,1.0,0,2,2,4,8,0xb2d34efd
20645.38,2.0,6,2,3,3,8,0xb2d5b60dd
2729.24,1.0,6,1,2,3,6,0xb2d43374
2344.18,1.0,0,1,2,4,7,0xb2d7c11e
68922.52,2.0,6,3,3,3,9,0xb2d12a8d
200657.17,10.0,0,3,4,4,11,0xb2d592c2
100007.45,2.0,53,3,3,2,8,0xb2d2905c
1104.85,1.0,0,1,2,4,7,0xb2d7bfced
43.18,1.0,0,1,2,4,7,0xb2d96062d
11065.39,1.0,184,2,2,1,5,0xb2d68136
122505.51,5.0,0,3,4,4,11,0xb2d21130
350000.0,2.0,5,4,3,3,10,0xb2da5e76
680000.0,3.0,10,4,4,3,11,0xb2d52a52
508032.07,2.0,0,4,3,4,11,0xb2d5d902
321754.44,1.0,17,4,2,2,8,0xb2d906aad
500900.04,3.0,13,4,4,3,11,0xb2d08ce4
43000.17,2.0,10,2,3,3,8,0xb2d96e54
52011.92,3.0,14,2,4,3,9,0xb2d2a97f
5.31,1.0,88,1,2,1,4,0xb2d6b15b
3420.82,2.0,168,2,3,1,6,0x3b9b30c3
60545.12,1.0,7,3,2,3,8,0xb2d4023f
550009.16,4.0,1,4,4,4,12,0xb2d98b6b
427000.0,2.0,1,4,3,4,11,0xb2da6657
4.32,2.0,0,1,3,4,8,0xb2d26c80
1320806.26,8.0,1,4,4,4,12,0xb2d5b79bd
2268.98,1.0,9,1,2,3,6,0xb2d52c65
228000.0,4.0,0,3,4,4,11,0xb2d2fb86
8266.35,4.0,0,2,4,4,10,0x3b9b4583
200007.96,2.0,9,3,3,3,9,0xb2d24fc9
4730874.94,1.0,216,4,2,1,7,0xb2d6f16e
5370.9,1.0,9,2,2,3,7,0xb2d397cc
157.62,1.0,12,1,2,3,6,0xb2d3b96d
8212.83,1.0,0,2,2,4,8,0xb2d31e08
1035.81,1.0,0,1,2,4,7,0xb2d8f8b5
175624.18,1.0,0,3,2,4,9,0xb2d30db7
176.56,1.0,46,1,2,2,5,0xb2d7abbfd
340716.0,4.0,17,4,4,2,10,0xb2d919ff
1.44,1.0,89,1,2,1,4,0xb2d20534
486.87,1.0,27,1,2,2,5,0xb2d49f23
566280.61,3.0,108,4,4,1,9,0xb2d561a3
2244.06,1.0,82,1,2,1,4,0xb2d2e3ce
157004.82,3.0,231,3,4,1,8,0xb2d6ea76
300016.11,3.0,132,3,4,1,8,0xb2d20261
1000.6,1.0,1,1,2,4,7,0xb2d2587e
1145548.13,4.0,66,4,4,2,10,0xb2d22d02d
115.59,1.0,15,1,2,3,6,0xb2d8266d
4803.73,1.0,92,2,2,1,5,0xb2d20721d
411024.53,4.0,66,4,4,2,10,0xb2d0bbab
1155.7,1.0,17,1,2,2,5,0xb2d430c1
53555.27,2.0,228,3,3,1,7,0xb2d38b22
2122.66,1.0,0,1,2,4,7,0xb2d510cf
3367.69,1.0,10,2,2,3,7,0xb2d355bed
1393578.24,10.0,6,4,4,3,11,0xb2d10512
276.23,1.0,18,1,2,2,5,0xb2d30ede
112218.05,3.0,41,3,4,2,9,0xb2d61fd2
321406.17,7.0,129,4,4,1,9,0xb2d623edd
491720.59,7.0,13,4,4,3,11,0xb2d1b632
252388.76,3.0,87,3,4,1,8,0xb2d3abe4
457.49,1.0,124,1,2,1,4,0xb2d62436
715556.9,5.0,0,4,4,4,12,0xb2d079d4
10207.88,1.0,0,2,2,4,8,0xb2d78d24
29664.37,1.0,4,2,2,4,8,0xb2d2e880
60697.96,1.0,5,3,2,3,8,0xb2d251a0
22.9,1.0,15,1,2,3,6,0xb2da23b0
500000.0,2.0,22,4,3,2,9,0xb2da21ca
200000.0,2.0,21,3,3,2,8,0xb2d98d56
450127.98,2.0,24,4,3,2,9,0xb2d89054
28201.85,1.0,210,2,2,1,5,0xb2d34984
5046.91,1.0,92,2,2,1,5,0xb2d2c3c2
197594.96,1.0,2,3,2,4,9,0xb2d23767
25084.12,1.0,2,2,2,4,8,0xb2d32d33
300021.14,4.0,126,3,4,1,8,0xb2d3fe60
2400.83,1.0,14,1,2,3,6,0xb2d8c5fd
270044.67,3.0,73,3,4,1,8,0xb2d2f60e
8137.1,1.0,92,2,2,1,5,0xb2d5a8a3
56862.55,4.0,0,3,4,4,11,0x3b9af477d
200193.04,2.0,34,3,3,2,8,0xb2d6f617
314340.04,4.0,9,4,4,3,11,0xb2d2aa52
5763.02,1.0,2,2,2,4,8,0xb2da3d61
40396.2,1.0,19,2,2,2,6,0xb2d53465
50001.58,2.0,14,2,3,3,8,0xb2da36ce
151226.72,8.0,80,3,4,1,8,0xb2d5a9acd
45511.31,1.0,4,2,2,4,8,0xb2d29379
3195.91,1.0,0,2,2,4,8,0xb2d5ff55
365.7,1.0,66,1,2,2,5,0xb2d41f03
401021.9,4.0,0,4,4,4,12,0x3b9af0fb
400000.6,2.0,0,4,3,4,11,0xb2d3c375
650078.96,5.0,70,4,4,1,9,0xb2d197d0
72500.01,3.0,25,3,4,2,9,0xb2d0f44a
229338.63,2.0,63,3,3,2,8,0xb2d5d9f6
853888.09,3.0,39,4,4,2,10,0xb2d64905
300006.33,2.0,60,3,3,2,8,0xb2d9bc35
12881000.0,19.0,3,4,4,4,12,0xb2d5de60
3530.59,1.0,184,2,2,1,5,0xb2d3bb23
200079.34,2.0,10,3,3,3,9,0xb2d67e7ad
110032.73,5.0,10,3,4,3,10,0xb2d0edd0d
2330.39,2.0,92,1,3,1,5,0xb2d110d5
425.57,3.0,17,1,4,2,7,0xb2d2bc3f
40170.26,2.0,184,2,3,1,6,0xb2d3be4d
51004.4,2.0,67,2,3,1,6,0xb2d64446d
3024518.53,2.0,41,4,3,2,9,0xb2d76326d
151427.94,4.0,19,3,4,2,9,0xb2d32195d
1041.35,1.0,216,1,2,1,4,0xb2d19ffc
2271.02,2.0,92,1,3,1,5,0xb2d0716e
230.82,1.0,10,1,2,3,6,0xb2d25878
1399.69,2.0,2,1,3,4,8,0xb2d14910
6635.94,1.0,6,2,2,3,7,0xb2d42d13
456849.14,3.0,0,4,4,4,12,0xb2d24e93
120048.36,1.0,22,3,2,2,7,0xb2d2aeccd
516327.19,3.0,9,4,4,3,11,0xb2d6ffbad
631.44,1.0,9,1,2,3,6,0xb2d9122b
0.53,1.0,34,1,2,2,5,0xb2d9a1f9
3590.3,1.0,11,2,2,3,7,0xb2d26a8a
10300.08,2.0,184,2,3,1,6,0xb2d18082d
16647.8,1.0,92,2,2,1,5,0xb2d0da7a
71442.29,1.0,12,3,2,3,8,0xb2d7c272
102.57,1.0,26,1,2,2,5,0xb2d2f817
1568331.08,2.0,49,4,3,2,9,0xb2d158d4d
2539.39,1.0,184,1,2,1,4,0xb2d46045
3909.49,1.0,92,2,2,1,5,0xb2d2c822
100000.0,2.0,0,3,3,4,10,0xb2d97dc7
181435.48,1.0,184,3,2,1,6,0xb2d1b040
400016.8,4.0,13,4,4,3,11,0xb2d118ac
240.36,1.0,4,1,2,4,7,0xb2d90ae7
110886.91,1.0,9,3,2,3,8,0xb2d2c731d
300345.6,4.0,59,4,4,2,10,0xb2d42859
444060.84,3.0,24,4,4,2,10,0xb2d11ffed
325285.86,2.0,0,4,3,4,11,0xb2d0e8bd
1.72,1.0,77,1,2,1,4,0xb2d8239cd
436552.36,3.0,16,4,4,2,10,0x3b9b3601
166476.9,7.0,0,3,4,4,11,0xb2d12701d
2.05,1.0,4,1,2,4,7,0xb2d80080
8545.84,1.0,184,2,2,1,5,0xb2d1a57ed
1181335.45,10.0,1,4,4,4,12,0x3b9adcc5
24000.0,2.0,76,2,3,1,6,0xb2d68999
12250.2,1.0,18,2,2,2,6,0xb2d70503
140011.9,2.0,101,3,3,1,7,0xb2d2aae4d
406001.95,8.0,80,4,4,1,9,0xb2d108e3
340000.0,2.0,17,4,3,2,9,0xb2d8dc5ad
51142.87,1.0,5,2,2,3,7,0xb2d6c6fb
796797.35,5.0,1,4,4,4,12,0xb2d20956
32241.86,7.0,0,2,4,4,10,0x3b9af11ed
50000.0,1.0,0,2,2,4,8,0xb2d9793f
50007.28,2.0,1,2,3,4,9,0xb2da1af0
3586.27,1.0,10,2,2,3,7,0xb2d3726b
5298046.34,3.0,63,4,4,2,10,0xb2d5b537
82.76,1.0,53,1,2,2,5,0xb2d9b8d0
194067.85,5.0,11,3,4,3,10,0xb2d8d37b
200031.08,2.0,168,3,3,1,7,0xb2d6822e
20226.25,1.0,29,2,2,2,6,0xb2d57aa4
230072.81,2.0,3,3,3,4,10,0xb2d6fed8d
60740.61,4.0,0,3,4,4,11,0xb2d5b5afd
1.65,1.0,44,1,2,2,5,0xb2d7c3e1
19649.91,1.0,26,2,2,2,6,0xb2d6db33d
20102.58,2.0,0,2,3,4,9,0xb2d8ee74
36183.23,1.0,5,2,2,3,7,0xb2d7c3ddd
6969.64,1.0,0,2,2,4,8,0xb2d37945
97.88,1.0,58,1,2,2,5,0xb2d68cd9d
1090.84,2.0,92,1,3,1,5,0x3b9b1636
10153.75,1.0,0,2,2,4,8,0xb2d8c880d
1170978.35,7.0,11,4,4,3,11,0xb2d0d1d3
39.86,1.0,7,1,2,3,6,0xb2d5931e
30000.32,2.0,13,2,3,3,8,0xb2d95dca
23845.22,1.0,21,2,2,2,6,0xb2da086a
51349.81,1.0,5,2,2,3,7,0xb2d620d8
1070045.27,2.0,214,4,3,1,8,0xb2d13aae
100065.81,3.0,19,3,4,2,9,0xb2d68757
2754477.59,4.0,7,4,4,3,11,0xb2d1cf59
50000.0,2.0,1,2,3,4,9,0xb2d62395d
4964.84,1.0,5,2,2,3,7,0xb2d6d30e
102138.41,2.0,245,3,3,1,7,0xb2d622f3
20623.38,4.0,3,2,4,4,10,0xb2d65247
92.45,1.0,19,1,2,2,5,0xb2d35dbf
438115.97,5.0,11,4,4,3,11,0xb2d3eea8
4194.02,1.0,254,2,2,1,5,0xb2d5ac65
90738.97,2.0,0,3,3,4,10,0xb2d553abd
260005.92,5.0,14,3,4,3,10,0xb2d8ef2d
51073.43,2.0,92,2,3,1,6,0xb2d68428
1256866.37,1.0,10,4,2,3,9,0xb2d37069
100003.17,2.0,80,3,3,1,7,0xb2d98a38
6021.96,1.0,94,2,2,1,5,0xb2d3e9fed
598744.89,4.0,83,4,4,1,9,0xb2d5ffc5d
400017.97,2.0,18,4,3,2,9,0xb2d2104f
25360.92,1.0,1,2,2,4,8,0xb2d2d7d0
81.61,1.0,18,1,2,2,5,0xb2d2c1a2
2826.5,1.0,1,1,2,4,7,0xb2d212a7
1233.36,1.0,184,1,2,1,4,0xb2d3085c
18718.26,190.0,10,2,4,3,9,0xb2d4a6a8
1014.6,1.0,92,1,2,1,4,0xb2d294b6
2331.93,1.0,2,1,2,4,7,0xb2d5dc59
9967.86,1.0,0,2,2,4,8,0xb2d3f2bc
192.79,1.0,10,1,2,3,6,0xb2d2ffd6
1807.69,1.0,10,1,2,3,6,0xb2d55da9
1000027.76,6.0,8,4,4,3,11,0xb2d0f93bd
82056.72,5.0,27,3,4,2,9,0xb2d1979a
60250.86,3.0,1,3,4,4,11,0xb2d448fed
205323.93,8.0,7,3,4,3,10,0xb2d5fb58
11526.57,1.0,2,2,2,4,8,0xb2d1b151
500005.29,2.0,101,4,3,1,8,0xb2d81f04
193277.24,1.0,0,3,2,4,9,0xb2d14196
1086176.89,13.0,6,4,4,3,11,0xb2d14bf2d
9446.23,1.0,21,2,2,2,6,0xb2da1691
2.72,5.0,80,1,4,1,6,0xb2d487a7
1874.45,1.0,196,1,2,1,4,0xb2d3272e
301194.92,2.0,7,4,3,3,10,0xb2d71a60d
1011.92,1.0,10,1,2,3,6,0xb2d9ee53
500032.31,4.0,59,4,4,2,10,0xb2d55a62
52742.24,3.0,66,3,4,2,9,0xb2d15c1e
170000.0,2.0,3,3,3,4,10,0xb2d979a0
1211559.22,7.0,3,4,4,4,12,0xb2d10b90
942034.71,6.0,14,4,4,3,11,0xb2d24dafd
1881.98,1.0,2,1,2,4,7,0xb2d25531
19280.73,1.0,143,2,2,1,5,0xb2d565f7
11.5,1.0,77,1,2,1,4,0xb2d37a41d
374009.77,8.0,105,4,4,1,9,0xb2d408f6d
79046.77,3.0,80,3,4,1,8,0xb2d590e7d
168.63,1.0,14,1,2,3,6,0xb2d3b2dd
70003.69,2.0,216,3,3,1,7,0xb2d67ea8d
8.02,1.0,67,1,2,1,4,0xb2d6d36c
2233.82,1.0,0,1,2,4,7,0xb2d9220d
351000.0,8.0,5,4,4,3,11,0xb2d1b51f
823713.17,4.0,16,4,4,2,10,0xb2d5c0a1d
30033.73,3.0,4,2,4,4,10,0xb2d09d75
140131.4,7.0,3,3,4,4,11,0xb2d5a41dd
170034.51,2.0,202,3,3,1,7,0xb2d5cb8ad
4531.36,1.0,92,2,2,1,5,0xb2d3a431
101178.08,2.0,19,3,3,2,8,0xb2d633a9d
790044.6,4.0,5,4,4,3,11,0xb2d24349d
500088.97,4.0,0,4,4,4,12,0xb2d8d621
10101.28,2.0,14,2,3,3,8,0xb2d6ebab
10002.24,2.0,18,2,3,2,7,0xb2da2551
495737.58,4.0,32,4,4,2,10,0xb2d558ae
207567.2,2.0,101,3,3,1,7,0xb2d58dd5
10919.57,2.0,1,2,3,4,9,0xb2da3103
1181358.47,6.0,1,4,4,4,12,0xb2d6e426
30559.28,1.0,3,2,2,4,8,0xb2d686fd
230164.9,6.0,10,3,4,3,10,0xb2d19a1e
624.04,1.0,0,1,2,4,7,0xb2d604dd
102.77,1.0,9,1,2,3,6,0xb2d5d2a3
50094.05,2.0,18,2,3,2,7,0xb2d694c0d
110004.3,3.0,46,3,4,2,9,0xb2d286a7
200710.98,2.0,25,3,3,2,8,0xb2d94e33d
20262.53,1.0,155,2,2,1,5,0xb2d62978
275238.92,2.0,14,3,3,3,9,0xb2d50ab9
1731.78,1.0,184,1,2,1,4,0xb2d3a1a2d
350005.39,4.0,38,4,4,2,10,0xb2d67169d
369721.71,4.0,26,4,4,2,10,0xb2d56d0c
3319.61,1.0,13,2,2,3,7,0xb2d32dc2d
437000.5,4.0,14,4,4,3,11,0xb2d8dc3a
1604.43,1.0,0,1,2,4,7,0xb2d2fdf6d
164585.39,3.0,1,3,4,4,11,0xb2d636edd
1357.58,1.0,9,1,2,3,6,0xb2d83ca4
109052.55,3.0,8,3,4,3,10,0xb2d54e55
51017.37,2.0,8,2,3,3,8,0xb2d11608
202175.77,2.0,40,3,3,2,8,0xb2d64c39d
4966.24,1.0,1,2,2,4,8,0xb2d34389
5687.72,1.0,20,2,2,2,6,0xb2d6a067
409.73,1.0,0,1,2,4,7,0xb2d6c05c
4985.21,1.0,14,2,2,3,7,0xb2d33fbb
458270.08,3.0,110,4,4,1,9,0x3b9b4293d
202811.32,2.0,9,3,3,3,9,0xb2d6a74f
1044.52,2.0,184,1,3,1,5,0x3b9b1975
54488.84,1.0,0,3,2,4,9,0xb2d9761b
31.57,1.0,20,1,2,2,5,0xb2d31b5d
200001.58,2.0,6,3,3,3,9,0xb2d95882
178065.3,4.0,3,3,4,4,11,0xb2d135d7
200008.46,2.0,77,3,3,1,7,0xb2d145ff
101285.2,2.0,143,3,3,1,7,0xb2d1aa97d
1594.14,1.0,25,1,2,2,5,0xb2d1d5ce
145.97,1.0,71,1,2,1,4,0xb2d50bbd
720505.57,5.0,4,4,4,4,12,0xb2d5e734
100646.11,2.0,221,3,3,1,7,0xb2d3a3abd
2235001.98,2.0,167,4,3,1,8,0xb2d59929d
200041.71,2.0,15,3,3,3,9,0xb2d6f4c4
14085.1,1.0,15,2,2,3,7,0xb2d70561
10043.22,2.0,0,2,3,4,9,0xb2d6b4aa
885340.86,2.0,9,4,3,3,10,0xb2d2cb62d
178.42,1.0,11,1,2,3,6,0xb2d5b99cd
32.77,1.0,0,1,2,4,7,0xb2d96f27d
500000.0,2.0,0,4,3,4,11,0xb2d9844a
8354.0,2.0,96,2,3,1,6,0xb2d97878d
273.64,1.0,0,1,2,4,7,0xb2d9141e
192034.23,4.0,102,3,4,1,8,0xb2d10beb
514.54,12.0,0,1,4,4,9,0x3b9b1856
101787.99,2.0,206,3,3,1,7,0xb2d55d5fd
55298.82,1.0,0,3,2,4,9,0xb2d21400
23096.84,1.0,3,2,2,4,8,0xb2d5d58d
200015.95,2.0,105,3,3,1,7,0xb2d25085
110163.08,2.0,6,3,3,3,9,0xb2d4b3a3
13778.89,1.0,48,2,2,2,6,0xb2d60e8ed
58.89,1.0,184,1,2,1,4,0xb2d0bf22d
300006.33,2.0,18,3,3,2,8,0xb2da2a2c
8948.11,1.0,20,2,2,2,6,0xb2d92996
1593.79,1.0,36,1,2,2,5,0xb2d21152
1703.01,1.0,3,1,2,4,7,0xb2d6c1d2
100000.0,2.0,1,3,3,4,10,0xb2d3fe01d
20000.21,2.0,83,2,3,1,6,0xb2d8d021
1324.3,1.0,12,1,2,3,6,0xb2d27231
3216.81,1.0,4,2,2,4,8,0xb2d20bb9
5000620.34,3.0,33,4,4,2,10,0xb2d45abc
100317.21,1.0,0,3,2,4,9,0xb2d5f017d
450040.38,3.0,0,4,4,4,12,0xb2d67d57
101397.12,3.0,5,3,4,3,10,0xb2d4182d
303017.15,2.0,17,4,3,2,9,0xb2d0890c
1123.49,1.0,0,1,2,4,7,0xb2d8d991
437.21,1.0,3,1,2,4,7,0xb2d5c514
500024.76,4.0,70,4,4,1,9,0xb2d253ad
1605.18,1.0,73,1,2,1,4,0xb2d5dc06
4288.98,2.0,14,2,3,3,8,0xb2d0ada3d
8153.0,1.0,1,2,2,4,8,0xb2d460e8d
66251.85,1.0,184,3,2,1,6,0xb2d62aa2
1057.54,1.0,184,1,2,1,4,0xb2d17c56d
6867.64,1.0,23,2,2,2,6,0xb2d6ca22
603550.44,6.0,11,4,4,3,11,0xb2d5bcf6
943.85,1.0,19,1,2,2,5,0xb2d2e606d
88628.13,3.0,12,3,4,3,10,0xb2d7437a
600025.57,4.0,11,4,4,3,11,0xb2d120f3d
25339.39,1.0,0,2,2,4,8,0xb2d3b47e
390000.0,7.0,8,4,4,3,11,0xb2d763ef
28035.37,1.0,74,2,2,1,5,0xb2d18859d
810.71,3.0,50,1,4,2,7,0xb2d8a74ed
50000.0,2.0,4,2,3,4,9,0xb2d5916b
642079.86,8.0,26,4,4,2,10,0x3b9b3ebd
11000.44,2.0,4,2,3,4,9,0xb2d24d96
100240.03,1.0,2,3,2,4,9,0xb2d709cb
52535.44,2.0,123,3,3,1,7,0xb2d1181f
10000.32,2.0,60,2,3,2,7,0xb2d9b930
300072.27,3.0,16,3,4,2,9,0xb2d95757d
1990003.97,3.0,1,4,4,4,12,0xb2d18989
1430923.82,221.0,0,4,4,4,12,0xb2d4a6a8d
1158.01,1.0,92,1,2,1,4,0xb2d504b7
81.6,1.0,1,1,2,4,7,0xb2da0477
100.18,1.0,10,1,2,3,6,0xb2d553b4
88.74,1.0,9,1,2,3,6,0xb2d2c725
6635.35,1.0,15,2,2,3,7,0xb2da084f
7019020.05,6.0,3,4,4,4,12,0xb2d6db3f
10504.33,1.0,13,2,2,3,7,0xb2d8c8e4
220.92,1.0,9,1,2,3,6,0xb2d294b5d
10001.43,2.0,48,2,3,2,7,0xb2d56346
490011.61,11.0,0,4,4,4,12,0xb2d6c883
10264.78,2.0,48,2,3,2,7,0xb2d2a2d3
50295.51,1.0,1,2,2,4,8,0xb2d9dd8a
100006.46,3.0,20,3,4,2,9,0xb2d68ba0
23391.34,1.0,208,2,2,1,5,0xb2d59ebad
16310.4,1.0,76,2,2,1,5,0xb2d3779c
667.87,1.0,3,1,2,4,7,0xb2d1873f
504381.96,5.0,6,4,4,3,11,0xb2d61f03d
630000.0,6.0,1,4,4,4,12,0xb2d103ea
844215.24,4.0,0,4,4,4,12,0xb2d5a917d
51001.36,2.0,0,2,3,4,9,0xb2d5575b
326176.16,1.0,1,4,2,4,10,0xb2d238f4
29765.3,1.0,36,2,2,2,6,0xb2d1bfafd
300028.33,6.0,25,3,4,2,9,0xb2d57ab4d
404630.57,3.0,19,4,4,2,10,0xb2d42b94
201423.1,2.0,53,3,3,2,8,0xb2d9c14c
1298.73,1.0,0,1,2,4,7,0xb2d4c9bd
270020.43,7.0,13,3,4,3,10,0xb2d122a8
600000.59,4.0,1,4,4,4,12,0xb2d5e914
470418.48,4.0,13,4,4,3,11,0xb2d68dcb
2473.19,1.0,4,1,2,4,7,0xb2d963d0
101656.67,3.0,63,3,4,2,9,0xb2d2323d
605064.85,10.0,4,4,4,4,12,0xb2d265e8d
502917.42,5.0,42,4,4,2,10,0xb2d1fe60
741.61,1.0,32,1,2,2,5,0x3b9b3b46
130000.67,2.0,1,3,3,4,10,0xb2d6b46dd
390860.01,2.0,52,4,3,2,9,0xb2d576e0d
982298.4,7.0,31,4,4,2,10,0xb2d16ed4
70010.34,2.0,63,3,3,2,8,0xb2d94493
50113.83,2.0,214,2,3,1,6,0xb2d417f6
12197.72,7.0,13,2,4,3,9,0xb2d20ab8
39504.38,1.0,184,2,2,1,5,0xb2d41bc9d
200001.72,2.0,10,3,3,3,9,0xb2d95460d
19192.06,1.0,6,2,2,3,7,0xb2d6e89cd
419.71,1.0,14,1,2,3,6,0xb2d95e59
431066.77,7.0,0,4,4,4,12,0x3b9b0e36d
401421.0,3.0,30,4,4,2,10,0xb2d8fb9a
1638.51,1.0,10,1,2,3,6,0xb2da396e
103372.35,2.0,73,3,3,1,7,0xb2d5d0b2
683015.89,8.0,3,4,4,4,12,0xb2d52650
275.92,1.0,15,1,2,3,6,0xb2d4ebb0
302576.72,3.0,41,4,4,2,10,0xb2d42f96d
800116.67,7.0,19,4,4,2,10,0xb2d06a31
398.72,1.0,27,1,2,2,5,0xb2d6d3ac
56.96,1.0,0,1,2,4,7,0xb2d34558
7290.15,1.0,7,2,2,3,7,0xb2d68ddb
203836.09,2.0,166,3,3,1,7,0xb2d6b1e3
620137.78,2.0,161,4,3,1,8,0xb2d5b358
1.6,1.0,29,1,2,2,5,0xb2d6bcb3
8138.67,1.0,185,2,2,1,5,0xb2d52710
15367.92,1.0,10,2,2,3,7,0xb2d56ecd
0.82,1.0,22,1,2,2,5,0xb2d46a0a
10210.31,3.0,23,2,4,2,8,0xb2d676a5d
110070.61,2.0,78,3,3,1,7,0xb2d46dff
218.22,1.0,0,1,2,4,7,0xb2d9222c
0.53,2.0,75,1,3,1,5,0xb2d12990
10533.91,1.0,14,2,2,3,7,0xb2d74317
13909.05,1.0,3,2,2,4,8,0xb2d2b7a6
46.3,1.0,84,1,2,1,4,0xb2d62394
138245.4,1.0,0,3,2,4,9,0xb2d534d8
390000.0,4.0,2,4,4,4,12,0xb2d5a5dc
485.52,1.0,21,1,2,2,5,0xb2d2f4a7d
2592.25,1.0,8,1,2,3,6,0xb2d254a7
600.0,2.0,0,1,3,4,8,0x3b9b46dc
23030.46,3.0,77,2,4,1,7,0xb2d06ebe
10309.5,1.0,25,2,2,2,6,0xb2d42e1d
300045.8,3.0,1,3,4,4,11,0xb2d58a9f
206402.62,2.0,111,3,3,1,7,0xb2d65a1fd
1961.38,1.0,8,1,2,3,6,0xb2d29d02
23527.54,1.0,141,2,2,1,5,0xb2d16006
202935.19,2.0,151,3,3,1,7,0xb2d6c644d
20846.94,1.0,184,2,2,1,5,0xb2d1b142
2300235.3,6.0,76,4,4,1,9,0xb2d22db6d
98012.51,3.0,92,3,4,1,8,0xb2d85c80
338989.56,2.0,1,4,3,4,11,0xb2d1bfdc
64951.25,1.0,125,3,2,1,6,0xb2d22164
7344.84,1.0,21,2,2,2,6,0xb2d609cf
480084.51,3.0,1,4,4,4,12,0xb2d9847c
349.12,1.0,14,1,2,3,6,0xb2d617e9
1003557.39,6.0,36,4,4,2,10,0xb2d65928
218565.45,1.0,8,3,2,3,8,0xb2d3b130d
375245.93,5.0,31,4,4,2,10,0xb2d18083d
3872.88,1.0,2,2,2,4,8,0xb2d2a894
240.9,3.0,1,1,4,4,9,0x3b9ad6f8
1115.85,1.0,184,1,2,1,4,0xb2d3db59
60670.54,1.0,7,3,2,3,8,0xb2d19d1b
3037.39,1.0,3,2,2,4,8,0xb2d1873fd
55684.96,2.0,6,3,3,3,9,0xb2d12e8dd
281073.98,2.0,25,3,3,2,8,0xb2d0d028
69.06,1.0,13,1,2,3,6,0xb2d58dbb
1725125.38,4.0,16,4,4,2,10,0xb2d5041b
908782.52,9.0,0,4,4,4,12,0x3b9ad188
4604.58,1.0,92,2,2,1,5,0xb2d0dfb2
100578.69,3.0,0,3,4,4,11,0xb2d2bd67d
321734.86,2.0,14,4,3,3,10,0xb2d41d35
400000.0,3.0,5,4,4,3,11,0xb2da5bf3
539.37,1.0,8,1,2,3,6,0xb2d5e45f
270395.2,2.0,0,3,3,4,10,0xb2d5f88e
15303.42,1.0,0,2,2,4,8,0xb2d8e66b
100489.79,2.0,213,3,3,1,7,0xb2d64341
51350.08,2.0,112,2,3,1,6,0xb2d40f65d
3731.16,1.0,3,2,2,4,8,0xb2d87dba
10015.25,3.0,168,2,4,1,7,0xb2d1ab87
8262.48,1.0,0,2,2,4,8,0xb2d6b4fb
904009.37,4.0,1,4,4,4,12,0xb2d646c5
255516.57,3.0,13,3,4,3,10,0xb2d65e5d
266910.66,2.0,37,3,3,2,8,0xb2d2a3e2
50003.17,2.0,20,2,3,2,7,0xb2da0b68
490030.4,6.0,0,4,4,4,12,0xb2d081f2
415509.55,3.0,11,4,4,3,11,0xb2d27f6c
53.5,1.0,5,1,2,3,6,0xb2d92b0dd
170982.12,2.0,0,3,3,4,10,0xb2d512ad
1349732.58,10.0,8,4,4,3,11,0xb2d1490cd
280092.26,2.0,3,3,3,4,10,0xb2d5b74d
4770.59,1.0,40,2,2,2,6,0xb2d30287
8050.21,2.0,184,2,3,1,6,0xb2d62518
60001.27,2.0,39,3,3,2,8,0xb2d9ef1e
366005.12,7.0,0,4,4,4,12,0xb2d16e62d
285084.42,4.0,34,3,4,2,9,0xb2d10d78
500100.02,2.0,22,4,3,2,9,0xb2da0d93
14614.94,1.0,6,2,2,3,7,0xb2d0e00ad
1066363.51,3.0,1,4,4,4,12,0xb2d4cb16
229000.0,2.0,14,3,3,3,9,0xb2d95df6
181050.09,3.0,3,3,4,4,11,0xb2d61495
310098.42,2.0,192,4,3,1,8,0xb2d27feb
392073.01,2.0,22,4,3,2,9,0xb2da23d7
130006.87,2.0,139,3,3,1,7,0xb2d6d4b6
360780.2,5.0,6,4,4,3,11,0xb2d24e99d
1.56,1.0,15,1,2,3,6,0xb2d6d4da
537087.98,18.0,1,4,4,4,12,0xb2d12690d
240006.56,2.0,82,3,3,1,7,0xb2d98544
82066.9,1.0,15,3,2,3,8,0xb2d69905d
280002.96,2.0,60,3,3,2,8,0xb2d9c042
2182.22,1.0,6,1,2,3,6,0xb2d38ba6
2232.9,1.0,0,1,2,4,7,0xb2d2a88c
648.97,1.0,9,1,2,3,6,0xb2d56496d
380.5,1.0,14,1,2,3,6,0xb2d26498d
150668.42,1.0,116,3,2,1,6,0xb2d94f02
16000.34,2.0,92,2,3,1,6,0xb2d588f9
10493.45,1.0,10,2,2,3,7,0xb2d68abbd
715451.76,10.0,0,4,4,4,12,0x3b9af27ed
530086.81,5.0,49,4,4,2,10,0xb2d28494d
504277.36,2.0,55,4,3,2,9,0xb2d4ed0d
1354146.59,2.0,146,4,3,1,8,0xb2d3c524
274411.76,5.0,3,3,4,4,11,0xb2d21240
4539.05,6.0,184,2,4,1,7,0xb2d0788b
368363.98,1.0,9,4,2,3,9,0xb2d88cdf
957.78,1.0,21,1,2,2,5,0xb2d205f2
250000.0,2.0,18,3,3,2,8,0xb2da35c5
894.99,3.0,56,1,4,2,7,0xb2d8d43c
12.78,1.0,104,1,2,1,4,0xb2d6b7a1
1460078.34,4.0,25,4,4,2,10,0xb2d14b5e
202863.99,2.0,115,3,3,1,7,0xb2d8c386
68061.47,2.0,66,3,3,2,8,0xb2d110a9d
974.67,1.0,167,1,2,1,4,0xb2d3ba64
750000.0,11.0,7,4,4,3,11,0xb2d41093d
100095.55,3.0,27,3,4,2,9,0xb2d6b407
307.69,1.0,9,1,2,3,6,0xb2d8e285
1009.83,1.0,184,1,2,1,4,0xb2d2a3bcd
10000.11,2.0,67,2,3,1,6,0xb2d9aff6
6791.7,2.0,184,2,3,1,6,0xb2d5e95e
1789.77,1.0,9,1,2,3,6,0xb2d4803c
21.12,5.0,26,1,4,2,7,0xb2d33bcfd
3053564.81,2.0,92,4,3,1,8,0xb2d5901fd
12033.84,1.0,92,2,2,1,5,0xb2d62f3e
7006.21,1.0,1,2,2,4,8,0xb2d6fd3dd
208241.53,2.0,97,3,3,1,7,0xb2d54ac4
386.94,2.0,1,1,3,4,8,0x3b9b3c3f
78726.25,5.0,3,3,4,4,11,0xb2d28924
380009.69,5.0,11,4,4,3,11,0xb2d43492
101719.99,3.0,18,3,4,2,9,0xb2d4dbedd
571911.19,4.0,18,4,4,2,10,0xb2d22fc1d
323511.39,1.0,4,4,2,4,10,0xb2d2fd6f
9852.45,1.0,24,2,2,2,6,0xb2d36e30d
103000.0,2.0,9,3,3,3,9,0xb2d2869c
304200.43,4.0,11,4,4,3,11,0xb2d56fc5
51114.18,1.0,36,2,2,2,6,0xb2d17136
122096.17,3.0,0,3,4,4,11,0xb2d149ff
149958.65,1.0,0,3,2,4,9,0xb2d2fdb6
407066.61,5.0,4,4,4,4,12,0xb2d14f7c
938179.36,8.0,41,4,4,2,10,0xb2d10841
7236.13,1.0,92,2,2,1,5,0x3b9b23de
1013.32,1.0,24,1,2,2,5,0xb2d4a9d7
528062.91,10.0,3,4,4,4,12,0xb2d2538e
1826.37,1.0,184,1,2,1,4,0xb2d40034d
273796.73,5.0,8,3,4,3,10,0xb2d239e5
761580.36,6.0,13,4,4,3,11,0x3b9b37bb
1003621.74,3.0,32,4,4,2,10,0xb2d614d5
353479.33,5.0,11,4,4,3,11,0xb2d10efb
360688.25,3.0,69,4,4,1,9,0xb2d60089
240639.53,4.0,18,3,4,2,9,0xb2d5611d
2130.1,1.0,92,1,2,1,4,0xb2d0e8dfd
281587.28,2.0,68,3,3,1,7,0xb2d27a37
1523038.85,9.0,5,4,4,3,11,0xb2d3bb87d
403263.11,5.0,1,4,4,4,12,0xb2d0c9b6
43859.03,2.0,4,2,3,4,9,0xb2d60f1d
102956.06,1.0,5,3,2,3,8,0xb2d17aacd
4468498.98,10.0,1,4,4,4,12,0x3b9b409f
200710.42,2.0,32,3,3,2,8,0xb2da065c
13.38,1.0,46,1,2,2,5,0xb2d90b58
270006.2,3.0,13,3,4,3,10,0xb2d2d7e5d
3933.94,1.0,42,2,2,2,6,0xb2d21020
1326562.81,42.0,1,4,4,4,12,0xb2d56d6c
46386.59,2.0,11,2,3,3,8,0xb2d53fa8d
589171.28,7.0,3,4,4,4,12,0xb2d304fe
3159213.67,3.0,4,4,4,4,12,0xb2d59dd4
1481.03,1.0,193,1,2,1,4,0xb2d5b3d3
140.41,2.0,2,1,3,4,8,0xb2d25f22
4100.42,1.0,8,2,2,3,7,0xb2d70706
8248.24,1.0,18,2,2,2,6,0xb2d9172cd
370029.34,8.0,21,4,4,2,10,0xb2d0676b
4360.33,1.0,2,2,2,4,8,0xb2d5519fd
0.0,2.0,21,1,3,2,6,0xb2d93cb1
2365.09,1.0,184,1,2,1,4,0xb2d58a4a
2277.42,1.0,54,1,2,2,5,0xb2d261f5
121138.29,2.0,0,3,3,4,10,0xb2d6c290d
6482.02,3.0,63,2,4,2,8,0xb2d0a61d
504105.42,2.0,62,4,3,2,9,0xb2d92d28
1762297.59,7.0,18,4,4,2,10,0xb2d0e07c
396.84,1.0,0,1,2,4,7,0xb2d49f76
700341.84,6.0,0,4,4,4,12,0xb2d657ec
24423.29,1.0,14,2,2,3,7,0xb2d319ce
28511.97,1.0,6,2,2,3,7,0xb2d5d1bd
8813.37,3.0,0,2,4,4,10,0xb2d0a6aa
486.63,1.0,14,1,2,3,6,0xb2d434c8
36756.84,2.0,92,2,3,1,6,0xb2d0c1f3
25007420.71,7.0,33,4,4,2,10,0xb2d19a08
230885.19,6.0,67,3,4,1,8,0xb2d0add4
350282.11,5.0,24,4,4,2,10,0xb2d421c7
227559.57,4.0,27,3,4,2,9,0xb2d3fa57
280018.31,3.0,116,3,4,1,8,0xb2d108b4
4144203.38,7.0,0,4,4,4,12,0xb2d63027
831.02,1.0,20,1,2,2,5,0xb2d5d676
735534.7,5.0,8,4,4,3,11,0xb2d15422d
532852.51,3.0,32,4,4,2,10,0xb2d3b590d
200005.07,3.0,59,3,4,2,9,0xb2d8350b
66.74,1.0,14,1,2,3,6,0xb2d6813d
250023.23,2.0,77,3,3,1,7,0xb2d99325
11751.19,1.0,133,2,2,1,5,0xb2d6dc58
12967.15,1.0,0,2,2,4,8,0xb2d8f348
323.18,1.0,18,1,2,2,5,0xb2d69719
200000.42,2.0,13,3,3,3,9,0xb2d9e985
1503151.82,4.0,59,4,4,2,10,0xb2d77ff2
313095.33,3.0,7,4,4,3,11,0xb2d2eb7a
1424.66,1.0,250,1,2,1,4,0xb2d41b18d
459344.18,2.0,4,4,3,4,11,0xb2d0cba8d
30401.07,2.0,145,2,3,1,6,0x3b9b4909
1005.36,1.0,92,1,2,1,4,0xb2d249f7
98.72,1.0,12,1,2,3,6,0xb2d0ffc6
1151.96,2.0,10,1,3,3,7,0xb2d0e3c3
101821.87,3.0,12,3,4,3,10,0xb2d653d0d
472237.88,6.0,35,4,4,2,10,0xb2d5f122d
5100.57,1.0,10,2,2,3,7,0xb2d7076a
1070059.66,3.0,4,4,4,4,12,0xb2d931dfd
68.93,1.0,53,1,2,2,5,0xb2d60787
37.27,1.0,82,1,2,1,4,0xb2d239c0
382103.15,3.0,56,4,4,2,10,0xb2d6d960d
98812.52,3.0,46,3,4,2,9,0xb2d07efbd
700000.0,2.0,19,4,3,2,9,0xb2d58c95
400105.94,3.0,27,4,4,2,10,0xb2d13f36
220023.6,3.0,83,3,4,1,8,0xb2d62cdf
1228.09,1.0,284,1,2,1,4,0xb2d5e183
410003.3,3.0,9,4,4,3,11,0xb2d691f6
50000.58,2.0,52,2,3,2,7,0xb2d90225
0.84,2.0,64,1,3,2,6,0xb2d4ab2a
45051.73,2.0,0,2,3,4,9,0xb2d50643
961.01,1.0,0,1,2,4,7,0xb2d24ff7
1.99,1.0,11,1,2,3,6,0xb2d5b1ef
150043.49,5.0,74,3,4,1,8,0xb2d0f9bb
17704.7,1.0,5,2,2,3,7,0xb2d93bd5
446000.8,4.0,0,4,4,4,12,0xb2d10727
341207.71,2.0,36,4,3,2,9,0xb2d9f9ff
1003000.0,2.0,2,4,3,4,11,0xb2d1882ad
1.11,1.0,184,1,2,1,4,0xb2d2a02fd
140088.37,3.0,53,3,4,2,9,0xb2d18cf4
218013.84,3.0,4,3,4,4,11,0xb2d6c09b
450017.63,3.0,0,4,4,4,12,0xb2d78ddb
2.59,1.0,7,1,2,3,6,0xb2d7ec6d
4814.37,1.0,1,2,2,4,8,0xb2d13d3dd
8.3,1.0,2,1,2,4,7,0xb2d2626d
70.03,1.0,3,1,2,4,7,0xb2d8c79c
78913.9,50.0,67,3,4,1,8,0xb2d282a1
165000.0,8.0,2,3,4,4,11,0xb2d146eb
452959.9,5.0,122,4,4,1,9,0xb2d17adb
50609.23,2.0,41,2,3,2,7,0xb2d6dfea
3108.54,1.0,4,2,2,4,8,0xb2d0b31dd
2477.32,2.0,29,1,3,2,6,0xb2d935f9
400099.28,4.0,20,4,4,2,10,0xb2d274b3
5117.37,1.0,4,2,2,4,8,0xb2d3dc87
82715.68,2.0,38,3,3,2,8,0xb2d0b3bed
30.93,1.0,101,1,2,1,4,0xb2d632be
310881.94,5.0,0,4,4,4,12,0x3b9af17e
104133.52,2.0,5,3,3,3,9,0xb2d6d0b4
2178991.27,4.0,18,4,4,2,10,0xb2d63631
14386.88,1.0,1,2,2,4,8,0xb2d35b04d
200000.0,2.0,15,3,3,3,9,0xb2d9f260
276000.0,9.0,9,3,4,3,10,0xb2d5b385
142.82,1.0,19,1,2,2,5,0xb2d6c823
40859.35,3.0,15,2,4,3,9,0xb2d23d94
1154.45,1.0,92,1,2,1,4,0xb2d17f57
106007.85,2.0,174,3,3,1,7,0xb2d20fcdd
10782.59,1.0,0,2,2,4,8,0xb2d2eb23
1334168.0,1.0,0,4,2,4,10,0xb2d278fb
35002.05,1.0,0,2,2,4,8,0xb2d5dcbed
296146.13,1.0,194,3,2,1,6,0xb2d5ea98
7172.55,1.0,184,2,2,1,5,0xb2d2b1fd
8083803.07,3.0,19,4,4,2,10,0xb2d68897d
3347.61,3.0,0,2,4,4,10,0x3b9b376b
24752.53,1.0,7,2,2,3,7,0xb2d6ab8b
410727.19,3.0,0,4,4,4,12,0xb2d19c80d
885.1,1.0,6,1,2,3,6,0xb2d973a1
50071.78,2.0,27,2,3,2,7,0xb2d59151
50562.5,2.0,38,2,3,2,7,0xb2d3c5d4
500076.18,2.0,19,4,3,2,9,0xb2d9ca2c
1500047.5,2.0,10,4,3,3,10,0xb2d95fea
13021.45,1.0,38,2,2,2,6,0xb2d1ed02
354000.0,6.0,6,4,4,3,11,0xb2d2fb58
843058.01,4.0,214,4,4,1,9,0xb2d0dd27d
180459.49,2.0,84,3,3,1,7,0xb2d77f0ed
251380.35,2.0,48,3,3,2,8,0xb2d9da3b
1604055.58,4.0,92,4,4,1,9,0xb2d264add
3867.17,1.0,7,2,2,3,7,0xb2d3e969d
113.6,1.0,14,1,2,3,6,0xb2d348e0
420014.98,6.0,1,4,4,4,12,0xb2da2f8c
300059.31,2.0,0,3,3,4,10,0xb2d8f0ed
143.74,1.0,74,1,2,1,4,0xb2d4446f
282.03,2.0,22,1,3,2,6,0xb2d9dbc1
20430.26,2.0,5,2,3,3,8,0xb2d5054d
272040.55,4.0,63,3,4,2,9,0xb2d284f7d
40544.85,1.0,21,2,2,2,6,0xb2d60a91
91731.64,1.0,2,3,2,4,9,0xb2d3c3a4d
4.28,1.0,120,1,2,1,4,0xb2d28108
164528.89,3.0,60,3,4,2,9,0xb2d5d0b2d
860.39,1.0,0,1,2,4,7,0xb2d1140d
87867.67,1.0,0,3,2,4,9,0xb2d34fdcd
12008.52,2.0,94,2,3,1,6,0xb2d92481d
17374.91,1.0,6,2,2,3,7,0xb2d68096
1120.57,1.0,184,1,2,1,4,0xb2d2494b
12.12,1.0,9,1,2,3,6,0xb2d343e7
200000.0,2.0,20,3,3,2,8,0xb2d95439d
474.24,1.0,0,1,2,4,7,0xb2d31b4cd
685042.17,3.0,1,4,4,4,12,0xb2d0eedad
51.77,1.0,56,1,2,2,5,0xb2d2d132
202851.06,2.0,133,3,3,1,7,0xb2d2b566
583452.08,5.0,0,4,4,4,12,0xb2d88e18
2871.91,1.0,9,1,2,3,6,0xb2d8b194
74129.0,3.0,8,3,4,3,10,0xb2d8d71ed
153617.72,3.0,8,3,4,3,10,0xb2d59f9e
50646.58,1.0,8,2,2,3,7,0xb2d945f3d
1465796.22,10.0,0,4,4,4,12,0x3b9b0fc0
39.46,35.0,18,1,4,2,7,0xb2d1c9d3
6809.21,1.0,28,2,2,2,6,0xb2d0fd17d
2740.42,2.0,184,1,3,1,5,0xb2d0d462d
370015.41,7.0,45,4,4,2,10,0xb2d135e6d
842950.73,6.0,24,4,4,2,10,0xb2d0b453
28.08,1.0,6,1,2,3,6,0xb2d6bb4fd
528001.0,5.0,4,4,4,4,12,0xb2d93165
10058.12,2.0,1,2,3,4,9,0xb2d7198d
203645.03,2.0,36,3,3,2,8,0xb2d3d3a6
2796.83,2.0,6,1,3,3,7,0xb2d5b477
101002.13,2.0,80,3,3,1,7,0xb2d652d2
310101.8,2.0,18,4,3,2,9,0xb2d0e470
203052.87,6.0,74,3,4,1,8,0xb2d12aa3d
1511.2,1.0,15,1,2,3,6,0xb2d5e093
780633.22,9.0,7,4,4,3,11,0xb2d596c6d
393002.54,3.0,10,4,4,3,11,0xb2d17764
1973.05,1.0,184,1,2,1,4,0xb2d21a2e
3937.72,1.0,134,2,2,1,5,0xb2d21020d
150097.56,3.0,41,3,4,2,9,0xb2d3e7d4
3891.69,1.0,0,2,2,4,8,0xb2d14f46
200710.42,2.0,34,3,3,2,8,0xb2d9fe5e
242587.3,2.0,98,3,3,1,7,0xb2d7876f
111144.89,13.0,0,3,4,4,11,0xb2d6879b
1495.36,1.0,92,1,2,1,4,0xb2d3e775d
608025.67,2.0,83,4,3,1,8,0xb2d8ce5f
95121.14,2.0,235,3,3,1,7,0xb2d3fe0cd
16.84,9.0,4,1,4,4,9,0xb2d2c67f
19895.74,1.0,12,2,2,3,7,0xb2d4103d
439000.0,3.0,6,4,4,3,11,0xb2d70837d
70.13,1.0,208,1,2,1,4,0xb2d1500a
188014.42,8.0,12,3,4,3,10,0xb2d8d27c
432009.48,11.0,3,4,4,4,12,0xb2d24d92
170136.71,3.0,5,3,4,3,10,0xb2d472ef
500000.0,3.0,1,4,4,4,12,0xb2da67b7
500627.5,1.0,4,4,2,4,10,0xb2d6de2d
182010.52,3.0,11,3,4,3,10,0xb2d5f334d
23388.25,3.0,0,2,4,4,10,0xb2d09539
414.04,1.0,1,1,2,4,7,0xb2d25b5b
0.86,1.0,5,1,2,3,6,0xb2d6a4d4
2769.26,1.0,25,1,2,2,5,0xb2d50ce6d
520546.06,5.0,0,4,4,4,12,0xb2d602cdd
701816.71,3.0,20,4,4,2,10,0xb2d6f50cd
201421.16,2.0,16,3,3,2,8,0xb2d8db89d
2798.99,1.0,92,1,2,1,4,0xb2d22c1d
30062.39,2.0,5,2,3,3,8,0xb2d3b9a6
66000.07,6.0,0,3,4,4,11,0xb2d06941d
937065.92,6.0,50,4,4,2,10,0xb2d0e650
31100.93,1.0,82,2,2,1,5,0xb2d55c7b
110000.0,4.0,6,3,4,3,10,0xb2d30cdf
800001.28,5.0,7,4,4,3,11,0xb2d8ea35
100987.25,1.0,42,3,2,2,7,0xb2d763b1d
67.27,1.0,42,1,2,2,5,0xb2d54f7e
801569.64,1.0,0,4,2,4,10,0xb2d633e3
200005.35,4.0,62,3,4,2,9,0xb2d54fd3d
1722.74,1.0,67,1,2,1,4,0xb2d4fe04
209403.21,2.0,3,3,3,4,10,0xb2d1b775
3212.31,2.0,184,2,3,1,6,0x3b9af29c
4104.41,2.0,0,2,3,4,9,0xb2d5304ad
8264.33,1.0,168,2,2,1,5,0xb2d69817d
500011.08,3.0,9,4,4,3,11,0xb2d188ae
32.72,1.0,21,1,2,2,5,0xb2d24c7a
50874.58,1.0,0,2,2,4,8,0xb2d214bc
4926.61,1.0,184,2,2,1,5,0xb2d2ddc5
8101.12,1.0,161,2,2,1,5,0xb2d22ae9
872559.96,12.0,47,4,4,2,10,0xb2d51fcf
423306.6,4.0,0,4,4,4,12,0xb2d50292
5034.01,1.0,21,2,2,2,6,0xb2d54068
528.21,1.0,52,1,2,2,5,0xb2d8f469
290922.51,3.0,48,3,4,2,9,0xb2d487bd
300480.36,3.0,53,4,4,2,10,0xb2d18b3dd
505338.56,2.0,22,4,3,2,9,0xb2d5fe7cd
42.43,1.0,11,1,2,3,6,0xb2da3934
1032.69,1.0,286,1,2,1,4,0xb2d36559
371732.42,3.0,179,4,4,1,9,0xb2d59e64
5779.06,2.0,0,2,3,4,9,0xb2d10bd1
89031.03,1.0,18,3,2,2,7,0xb2d34066d
455521.04,6.0,2,4,4,4,12,0xb2d0a52d
11412.68,1.0,0,2,2,4,8,0xb2d5aecdd
984951.13,3.0,1,4,4,4,12,0xb2d0f6df
782792.38,9.0,4,4,4,4,12,0xb2d50f2c
51.75,1.0,6,1,2,3,6,0xb2d37613
0.81,1.0,3,1,2,4,7,0xb2d6dc62
1920.56,1.0,184,1,2,1,4,0xb2d1d323
6398.18,1.0,92,2,2,1,5,0xb2d104fc
7694.1,1.0,0,2,2,4,8,0xb2d6b45f
20050.88,2.0,92,2,3,1,6,0xb2d633d9
896588.7,4.0,9,4,4,3,11,0xb2d087a5
133947.12,1.0,22,3,2,2,7,0xb2d38865
113000.29,4.0,3,3,4,4,11,0xb2d17123
730.94,1.0,9,1,2,3,6,0xb2d433fb
1419.33,1.0,10,1,2,3,6,0xb2d463edd
2160016.22,5.0,20,4,4,2,10,0xb2d254f1d
50388.47,2.0,213,2,3,1,6,0xb2d2982ed
16417.39,1.0,28,2,2,2,6,0xb2d34c2e
2088.5,1.0,19,1,2,2,5,0xb2d41494
611180.58,2.0,9,4,3,3,10,0xb2d8d6eb
13498.06,1.0,14,2,2,3,7,0xb2d2bdc7
48.74,1.0,28,1,2,2,5,0xb2d3c1d5d
149440.56,2.0,48,3,3,2,8,0xb2d13bc2d
200032.95,6.0,0,3,4,4,11,0xb2d38831
301065.63,2.0,36,4,3,2,9,0xb2d9fa64
1677.49,1.0,23,1,2,2,5,0xb2d8cfc7
5726.39,1.0,19,2,2,2,6,0xb2d6af99
147417.87,5.0,12,3,4,3,10,0xb2d5c1bb
154808.78,2.0,21,3,3,2,8,0xb2d311cb
443494.17,6.0,0,4,4,4,12,0xb2d209c5
134808.61,1.0,98,3,2,1,6,0xb2d5fa6cd
4092.05,1.0,9,2,2,3,7,0xb2d57092d
8.91,1.0,25,1,2,2,5,0xb2d1e01d
100000.0,2.0,0,3,3,4,10,0xb2d62185d
6001.08,1.0,0,2,2,4,8,0xb2d700b8
100005.29,2.0,104,3,3,1,7,0xb2d7a753
556.27,1.0,10,1,2,3,6,0xb2d2ba41
110049.77,2.0,147,3,3,1,7,0xb2d452d3
27005.55,2.0,31,2,3,2,7,0xb2d313fb
178.62,1.0,20,1,2,2,5,0xb2d8c869
2388.84,1.0,0,1,2,4,7,0xb2d2d6fc
1010661.67,2.0,90,4,3,1,8,0xb2d93f5b
342004.05,5.0,10,4,4,3,11,0xb2d2285ad
20447.4,1.0,184,2,2,1,5,0xb2d31273
700000.0,6.0,6,4,4,3,11,0xb2d31110d
1012207.95,2.0,228,4,3,1,8,0xb2d15bee
16662.94,1.0,20,2,2,2,6,0xb2d6bd30d
447249.0,16.0,0,4,4,4,12,0x3b9af264d
4469.75,1.0,71,2,2,1,5,0xb2d64ef2
516564.51,5.0,20,4,4,2,10,0xb2d19568
1814.19,1.0,0,1,2,4,7,0xb2d4cb38
10000.32,2.0,95,2,3,1,6,0xb2d9726e
3866.59,1.0,10,2,2,3,7,0xb2d1d500
250889.06,2.0,30,3,3,2,8,0xb2d9b971
3285.97,1.0,184,2,2,1,5,0xb2d14990
10153.54,2.0,11,2,3,3,8,0xb2d1af3d
420055.8,11.0,11,4,4,3,11,0xb2d135a3
1505.29,1.0,184,1,2,1,4,0xb2d14b41
300098.44,4.0,27,3,4,2,9,0xb2d61f4b
50000.0,3.0,3,2,4,4,10,0xb2d3d6c3
1963.07,1.0,3,1,2,4,7,0xb2d2088f
26457.91,1.0,0,2,2,4,8,0xb2d21128
5070.14,1.0,184,2,2,1,5,0xb2d16c20
1000096.53,7.0,3,4,4,4,12,0xb2d1a256
101251.88,2.0,3,3,3,4,10,0xb2d5df06
308781.46,4.0,87,4,4,1,9,0xb2d50f3c
728579.55,1.0,21,4,2,2,8,0xb2d2b3dad
111935.98,1.0,34,3,2,2,7,0xb2d21a0f
540010.34,3.0,167,4,4,1,9,0xb2d5a1cc
603068.54,6.0,4,4,4,4,12,0xb2d6f110d
254.09,1.0,6,1,2,3,6,0xb2d51eba
200000.0,2.0,8,3,3,3,9,0xb2da509e
415293.97,5.0,60,4,4,2,10,0xb2d10afc
256031.59,6.0,4,3,4,4,11,0xb2d2e32ed
5027.64,1.0,2,2,2,4,8,0xb2d44d9bd
28919.32,1.0,0,2,2,4,8,0xb2d69b83
374000.0,13.0,0,4,4,4,12,0x3b9b3512d
409398.26,1.0,35,4,2,2,8,0xb2d560e2d
129.95,1.0,7,1,2,3,6,0xb2d31cc7
63580.52,2.0,35,3,3,2,8,0xb2d5fe3d
350003.63,4.0,80,4,4,1,9,0xb2d2866ed
178.77,1.0,20,1,2,2,5,0xb2d29582
8881.88,1.0,92,2,2,1,5,0xb2d3a450
348.7,1.0,66,1,2,2,5,0xb2d4b70c
12507.04,3.0,160,2,4,1,7,0xb2d286a4
280120.87,2.0,14,3,3,3,9,0xb2d8e188
75080.39,4.0,1,3,4,4,11,0xb2d0d88a
55984.51,2.0,15,3,3,3,9,0xb2d5102f
148000.38,4.0,0,3,4,4,11,0xb2d90f5d
747.22,1.0,0,1,2,4,7,0xb2d15bf0
91218.27,1.0,13,3,2,3,8,0xb2d2d902d
1101724.08,2.0,5,4,3,3,10,0xb2d9698d
125011.42,3.0,18,3,4,2,9,0xb2d58a33
576551.36,3.0,61,4,4,2,10,0xb2d38814d
253.53,1.0,6,1,2,3,6,0xb2d51007
200000.05,2.0,10,3,3,3,9,0xb2d06ec1d
1570.11,1.0,10,1,2,3,6,0xb2d6d7ecd
408.83,1.0,10,1,2,3,6,0xb2d93e42d
70003.2,4.0,11,3,4,3,10,0xb2d5dcc7
532.56,1.0,16,1,2,2,5,0xb2d5b7cb
108846.04,3.0,11,3,4,3,10,0xb2d3b1c7
1648.89,1.0,4,1,2,4,7,0xb2d92156
102926.45,3.0,0,3,4,4,11,0xb2d2103c
881.62,2.0,0,1,3,4,8,0xb2d06a6a
257458.06,3.0,46,3,4,2,9,0xb2d58ccb
52520.18,2.0,10,3,3,3,9,0xb2d91d00
178136.02,3.0,131,3,4,1,8,0xb2d5dbd8
100000.0,2.0,3,3,3,4,10,0xb2d680c2
6066.33,1.0,184,2,2,1,5,0xb2d200f4
50145.28,1.0,92,2,2,1,5,0xb2d62346d
3522.23,1.0,7,2,2,3,7,0xb2d26da6
67101.3,2.0,203,3,3,1,7,0xb2d633e1
90.55,1.0,6,1,2,3,6,0xb2d63f1b
255383.31,5.0,1,3,4,4,11,0xb2d0d5b7
500794.02,7.0,25,4,4,2,10,0xb2d2bd7ed
3357.89,1.0,1,2,2,4,8,0xb2d5e57e
400000.0,3.0,5,4,4,3,11,0xb2d1b669
56.39,1.0,116,1,2,1,4,0xb2d78433d
400000.0,2.0,4,4,3,4,11,0xb2da64c3
432622.67,7.0,2,4,4,4,12,0x3b9b3d23
2093.38,1.0,92,1,2,1,4,0xb2d500f6
1780018.79,2.0,6,4,3,3,10,0xb2d96b4dd
113066.88,4.0,4,3,4,4,11,0xb2d622bfd
852.71,1.0,0,1,2,4,7,0xb2d906b4
913.72,1.0,185,1,2,1,4,0xb2d28dd1d
8536.32,1.0,92,2,2,1,5,0xb2d45341
1553.74,1.0,0,1,2,4,7,0xb2d58a7f
5868.46,1.0,199,2,2,1,5,0xb2d16cc7
2053.94,1.0,4,1,2,4,7,0xb2d68666d
559025.53,9.0,25,4,4,2,10,0xb2d912cbd
100038.29,2.0,12,3,3,3,9,0xb2d6a8d8
171905.08,4.0,101,3,4,1,8,0xb2d64a25
11800.07,1.0,92,2,2,1,5,0xb2d285e3
160001.69,2.0,32,3,3,2,8,0xb2da0318
100000.0,1.0,0,3,2,4,9,0xb2d9819fd
80.08,1.0,44,1,2,2,5,0xb2d285a2d
16651.52,1.0,9,2,2,3,7,0xb2d23828
101186.58,2.0,46,3,3,2,8,0xb2d623e5
7000022.06,19.0,0,4,4,4,12,0xb2d4ffa2
4.97,1.0,11,1,2,3,6,0xb2d33c2c
11517.27,1.0,92,2,2,1,5,0xb2d10336d
5734.9,1.0,64,2,2,2,6,0xb2d77f8ad
2495.66,1.0,92,1,2,1,4,0xb2d1b90f
2.86,1.0,46,1,2,2,5,0xb2d91011
157708.86,4.0,14,3,4,3,10,0xb2d39f37
1015.2,1.0,92,1,2,1,4,0xb2d10ca6
7549.71,1.0,274,2,2,1,5,0xb2d41d87
82.0,1.0,12,1,2,3,6,0xb2d439e3
10630.98,2.0,63,2,3,2,7,0xb2d4f14b
52149.37,1.0,300,3,2,1,6,0xb2d4a3da
390118.76,3.0,35,4,4,2,10,0xb2d24eefd
155002.54,6.0,6,3,4,3,10,0xb2d8c4a1
400083.97,3.0,8,4,4,3,11,0xb2d6e7ebd
13013.22,1.0,10,2,2,3,7,0xb2d3bd5e
11481.62,1.0,0,2,2,4,8,0xb2d43a48
4016.67,1.0,0,2,2,4,8,0xb2d32260
160001.69,2.0,80,3,3,1,7,0xb2d8d8e6
280.64,1.0,0,1,2,4,7,0xb2d96820
200017.11,2.0,38,3,3,2,8,0xb2d92d16
430230.38,8.0,0,4,4,4,12,0xb2d168ce
50074.81,2.0,87,2,3,1,6,0xb2d65a05d
2567.51,1.0,92,1,2,1,4,0xb2d0ba68
5.3,2.0,20,1,3,2,6,0xb2d36514
420737.81,8.0,4,4,4,4,12,0xb2d514c4d
333806.51,7.0,31,4,4,2,10,0xb2d086bed
30000.34,3.0,0,2,4,4,10,0xb2d09c71
650.97,1.0,2,1,2,4,7,0xb2d9957b
69048.48,1.0,3,3,2,4,9,0xb2d1800b
1421449.23,8.0,1,4,4,4,12,0xb2d140cb
11308.12,2.0,59,2,3,2,7,0xb2d15426d
683000.0,2.0,21,4,3,2,9,0xb2d950b7
439213.35,5.0,143,4,4,1,9,0xb2d13f88
405498.36,6.0,0,4,4,4,12,0xb2d548b6d
20.58,1.0,26,1,2,2,5,0xb2d92090
1360.82,1.0,184,1,2,1,4,0xb2d1f80bd
150119.24,2.0,101,3,3,1,7,0xb2d5ed95
12912.39,1.0,0,2,2,4,8,0xb2d16eea
176181.4,2.0,25,3,3,2,8,0xb2d304f4
29.36,1.0,39,1,2,2,5,0xb2d4348b
200867.99,2.0,31,3,3,2,8,0xb2d2228b
8370.51,2.0,146,2,3,1,6,0xb2d0d29dd
2035000.26,20.0,6,4,4,3,11,0xb2d1b27c
703256.06,4.0,95,4,4,1,9,0xb2d110c8
673419.72,1.0,4,4,2,4,10,0xb2d3d05ed
21662.19,1.0,187,2,2,1,5,0xb2d4278f
377426.86,5.0,18,4,4,2,10,0xb2d087be
35402.0,1.0,0,2,2,4,8,0xb2d2dfa5d
1095.33,1.0,14,1,2,3,6,0xb2d23a9b
1525.11,1.0,7,1,2,3,6,0xb2d34540
4.04,1.0,19,1,2,2,5,0xb2d0e15e
5209.93,2.0,92,2,3,1,6,0xb2d28f72
20642.6,2.0,66,2,3,2,7,0xb2d0c015
292007.32,5.0,14,3,4,3,10,0xb2d1ef58
602353.67,3.0,24,4,4,2,10,0xb2d6ba10
1760165.99,5.0,18,4,4,2,10,0xb2d1b29c
202127.53,2.0,3,3,3,4,10,0xb2d6db2a
47.5,1.0,28,1,2,2,5,0xb2d91958
7193.15,2.0,92,2,3,1,6,0x3b9b199ed
161160.09,3.0,1,3,4,4,11,0xb2d3af74d
18578.69,1.0,0,2,2,4,8,0xb2d653c7d
802577.67,7.0,80,4,4,1,9,0xb2d12560d
5000.53,1.0,20,2,2,2,6,0xb2da2b64
0.71,1.0,8,1,2,3,6,0xb2d58585d
1550011.47,3.0,14,4,4,3,11,0xb2d6448b
600086.66,8.0,8,4,4,3,11,0xb2d98663
30387.33,1.0,92,2,2,1,5,0xb2d204c9d
537.15,1.0,0,1,2,4,7,0xb2d3ea08d
6163.33,15.0,0,2,4,4,10,0x3b9b1b22
4583.24,1.0,22,2,2,2,6,0xb2d26569d
96625.28,1.0,0,3,2,4,9,0xb2d34186
102027.81,1.0,63,3,2,2,7,0xb2d3ff54
300067.73,2.0,0,3,3,4,10,0xb2d6cabe
1872.11,1.0,8,1,2,3,6,0xb2d25dd3
513061.92,9.0,12,4,4,3,11,0xb2d97a51
1.62,1.0,50,1,2,2,5,0xb2d2985d
6019.47,1.0,0,2,2,4,8,0xb2d426d5
210097.2,3.0,0,3,4,4,11,0xb2d390bcd
700352.7,2.0,140,4,3,1,8,0xb2d2e806d
3117.89,2.0,184,2,3,1,6,0x3b9b1685d
1735.25,1.0,22,1,2,2,5,0xb2d20638
38383.26,1.0,19,2,2,2,6,0xb2d68c5e
40775.9,5.0,0,2,4,4,10,0xb2d6a35ad
50000.0,2.0,0,2,3,4,9,0xb2da0e55
1032329.05,8.0,43,4,4,2,10,0x3b9b336d
100666.17,3.0,8,3,4,3,10,0xb2d422fc
240005.05,3.0,46,3,4,2,9,0xb2d56bc2d
200020.86,2.0,13,3,3,3,9,0xb2d9a085
41411.32,1.0,0,2,2,4,8,0xb2d699f3
60002.43,3.0,18,3,4,2,9,0xb2d94051d
55581.79,2.0,213,3,3,1,7,0xb2d23a40d
153.49,1.0,42,1,2,2,5,0xb2d1b7c5d
125.08,1.0,40,1,2,2,5,0xb2d97f01
167.16,1.0,20,1,2,2,5,0xb2d69ed7
240.44,1.0,10,1,2,3,6,0xb2d34bc2d
12.59,1.0,51,1,2,2,5,0xb2d6e653
203240.16,2.0,6,3,3,3,9,0xb2d695db
432050.03,3.0,0,4,4,4,12,0xb2d3bc69
200710.42,2.0,39,3,3,2,8,0xb2d9f6ec
5639.63,1.0,0,2,2,4,8,0xb2d6ab07d
972.95,1.0,1,1,2,4,7,0xb2d83947
41476.05,1.0,6,2,2,3,7,0xb2d7074fd
50000.53,2.0,27,2,3,2,7,0xb2d9434f
102129.04,3.0,46,3,4,2,9,0xb2d58672
660019.14,2.0,1,4,3,4,11,0xb2d1c1e8d
858927.65,6.0,34,4,4,2,10,0xb2d308efd
1047625.15,10.0,0,4,4,4,12,0xb2d288ae
111083.57,4.0,26,3,4,2,9,0xb2d4525a
100060.2,2.0,62,3,3,2,8,0xb2d5962d
1030173.38,5.0,6,4,4,3,11,0xb2d5e671
550000.0,3.0,10,4,4,3,11,0xb2d6fc0bd
3255.93,1.0,184,2,2,1,5,0xb2d244db
7461.84,2.0,108,2,3,1,6,0xb2d0664b
6630.14,1.0,0,2,2,4,8,0xb2d69b53
0.42,1.0,27,1,2,2,5,0xb2d68a00d
7152.83,1.0,9,2,2,3,7,0xb2d26885
2946.68,1.0,32,2,2,2,6,0xb2d9a425
270008.05,2.0,4,3,3,4,10,0xb2d96497
223006.47,3.0,95,3,4,1,8,0xb2d90144d
530068.46,2.0,129,4,3,1,8,0xb2d36b18
375734.01,3.0,0,4,4,4,12,0xb2d69c6ed
100608.81,2.0,144,3,3,1,7,0xb2d6d2b8
100003.17,2.0,18,3,3,2,8,0xb2d6400b
225.36,1.0,66,1,2,2,5,0xb2d2abbfd
3043.32,1.0,92,2,2,1,5,0xb2d1d119
561415.2,4.0,27,4,4,2,10,0xb2d25b37
1467847.58,13.0,10,4,4,3,11,0xb2d60649
4007.43,3.0,2,2,4,4,10,0xb2d6d01e
23799.35,2.0,70,2,3,1,6,0xb2d63808
260004.98,4.0,70,3,4,1,8,0xb2d65956
2220143.06,2.0,83,4,3,1,8,0xb2d60bfe
159980.36,1.0,49,3,2,2,7,0xb2d0ea82d
1016373.76,2.0,228,4,3,1,8,0xb2d636e1
200062.03,2.0,67,3,3,1,7,0xb2d248dad
62.39,1.0,7,1,2,3,6,0xb2d60720d
16373.38,2.0,3,2,3,4,9,0xb2d311a7d
820.07,1.0,10,1,2,3,6,0xb2d91f5b
400000.0,3.0,3,4,4,4,12,0xb2d2a89c
1948727.48,4.0,0,4,4,4,12,0xb2d5aab4d
491000.56,12.0,3,4,4,4,12,0xb2d6295a
50336.85,2.0,4,2,3,4,9,0xb2d777a0d
752843.11,5.0,14,4,4,3,11,0xb2d6d037
48.03,1.0,40,1,2,2,5,0xb2d99459
200000.0,1.0,0,3,2,4,9,0xb2d8f697
375.02,8.0,74,1,4,1,6,0xb2d2c132
4683.85,1.0,0,2,2,4,8,0xb2d67e65
6194.93,1.0,0,2,2,4,8,0xb2d2a89b
420938.34,1.0,11,4,2,3,9,0xb2d2051b
5499.38,4.0,0,2,4,4,10,0x3b9af0ce
2163.92,1.0,184,1,2,1,4,0xb2d3c937
150003.13,6.0,40,3,4,2,9,0xb2d3bc2bd
120000.0,2.0,8,3,3,3,9,0xb2da4e65
210533.92,3.0,97,3,4,1,8,0xb2d515df
651.22,1.0,208,1,2,1,4,0xb2d103a1
515125.15,6.0,11,4,4,3,11,0xb2d34868d
700652.55,23.0,0,4,4,4,12,0xb2d357f5d
21784.71,1.0,0,2,2,4,8,0xb2d43a65d
200010.98,2.0,0,3,3,4,10,0xb2d12226
1000259.3,1.0,1,4,2,4,10,0xb2d74d88
26272.47,1.0,18,2,2,2,6,0xb2d6c4b3d
1304.22,1.0,165,1,2,1,4,0xb2d6358f
65.49,1.0,64,1,2,2,5,0xb2d3c514d
90299.99,4.0,1,3,4,4,11,0xb2d9f21f
10000.11,2.0,38,2,3,2,7,0xb2d5876a
606408.53,2.0,99,4,3,1,8,0xb2d96a71
2663.0,1.0,12,1,2,3,6,0xb2d6b100
172047.65,6.0,0,3,4,4,11,0xb2d58e19d
28540.98,1.0,18,2,2,2,6,0xb2d6c26e
390074.53,2.0,37,4,3,2,9,0xb2d68368d
2600060.52,3.0,27,4,4,2,10,0xb2d0e7b2
20.52,1.0,25,1,2,2,5,0xb2d628d9
483618.73,5.0,25,4,4,2,10,0xb2d13e02d
113987.59,3.0,52,3,4,2,9,0xb2d1e79f
2195.03,1.0,166,1,2,1,4,0xb2d2923c
10000.11,2.0,35,2,3,2,7,0xb2d9fa9c
23.12,1.0,15,1,2,3,6,0xb2d612fdd
290021.3,8.0,25,3,4,2,9,0xb2d97b49d
32.72,1.0,3,1,2,4,7,0xb2d8cbae
385724.19,3.0,3,4,4,4,12,0xb2d60393
510224.12,3.0,24,4,4,2,10,0x3b9b4923d
50001.58,2.0,59,2,3,2,7,0xb2d22bd3
2002.94,1.0,11,1,2,3,6,0xb2d68bfbd
149227.97,2.0,20,3,3,2,8,0xb2d331ce
50000.0,2.0,6,2,3,3,8,0xb2da4fca
51.9,2.0,47,1,3,2,6,0xb2d211ab
968.36,1.0,50,1,2,2,5,0xb2d5eb96
3701.64,1.0,33,2,2,2,6,0xb2d0f948d
3357.15,1.0,96,2,2,1,5,0xb2d62164
84033.58,3.0,153,3,4,1,8,0xb2d08750
390736.09,4.0,25,4,4,2,10,0xb2d3934c
440163.37,3.0,18,4,4,2,10,0xb2d90d02
381077.05,4.0,90,4,4,1,9,0xb2d4e9a1d
507107.12,2.0,32,4,3,2,9,0xb2d77275
102423.41,1.0,33,3,2,2,7,0xb2d43736d
472455.38,6.0,0,4,4,4,12,0xb2d0e80f
291144.3,10.0,2,3,4,4,11,0xb2d5b973
70000.74,2.0,14,3,3,3,9,0xb2da39c8
1445.79,2.0,92,1,3,1,5,0xb2d102c9d
374.47,1.0,0,1,2,4,7,0xb2d967fe
56130.64,1.0,3,3,2,4,9,0xb2d69b2f
200500.0,2.0,4,3,3,4,10,0xb2da644f
50480.98,3.0,4,2,4,4,10,0xb2d0725a
1563.85,1.0,232,1,2,1,4,0xb2d4128a
4694.28,1.0,74,2,2,1,5,0xb2d20293
580006.13,2.0,126,4,3,1,8,0xb2d92ea9
1860083.81,15.0,25,4,4,2,10,0xb2d16951
427020.74,3.0,216,4,4,1,9,0xb2d67ccf
11495.95,1.0,92,2,2,1,5,0xb2d142f8d
336752.62,3.0,0,4,4,4,12,0xb2d61870
19.39,1.0,66,1,2,2,5,0xb2d34713
5746.67,1.0,92,2,2,1,5,0xb2d196c4
112054.78,1.0,0,3,2,4,9,0xb2d22e4e
93652.67,1.0,14,3,2,3,8,0xb2d3983dd
400000.0,2.0,4,4,3,4,11,0xb2da5b25
252875.17,2.0,66,3,3,2,8,0xb2d6cbb2
240009.71,2.0,11,3,3,3,9,0xb2d9f09d
165384.7,8.0,59,3,4,2,9,0x3b9b3899
2536.31,1.0,0,1,2,4,7,0xb2d6ed98
141678.22,2.0,55,3,3,2,8,0xb2d6bb49
1093.68,5.0,1,1,4,4,9,0xb2d09556
70001.48,2.0,53,3,3,2,8,0xb2d9ccd6
28570.06,1.0,16,2,2,2,6,0xb2d62b61
1919424.55,8.0,34,4,4,2,10,0xb2d4d0ebd
300452.4,3.0,11,4,4,3,11,0xb2d3d6cd
2832.75,1.0,0,1,2,4,7,0xb2d50954
61864.98,2.0,32,3,3,2,8,0xb2d59899
166.69,1.0,43,1,2,2,5,0xb2d106fd
748.81,1.0,0,1,2,4,7,0xb2d9575f
115055.1,6.0,8,3,4,3,10,0xb2d65872
423035.04,3.0,1,4,4,4,12,0xb2d5c613
5121.12,1.0,1,2,2,4,8,0xb2d8c8be
3031.73,1.0,1,2,2,4,8,0xb2d4f15ad
300158.23,2.0,7,4,3,3,10,0xb2d3749c
4200057.28,3.0,0,4,4,4,12,0xb2d9b6fb
0.76,1.0,11,1,2,3,6,0xb2d17b4c
181206.65,3.0,18,3,4,2,9,0xb2d3eb00
1302118.43,7.0,18,4,4,2,10,0xb2d10a04
332011.23,3.0,1,4,4,4,12,0xb2d3d627
40094.37,2.0,21,2,3,2,7,0xb2d2860fd
300006.13,7.0,6,3,4,3,10,0xb2d8f0fb
519276.6,2.0,2,4,3,4,11,0xb2d6c22c
5410543.82,15.0,0,4,4,4,12,0x3b9b287dd
204874.91,5.0,5,3,4,3,10,0xb2d1bb4f
7049.4,1.0,92,2,2,1,5,0xb2d27befd
530517.65,4.0,4,4,4,4,12,0xb2d15c16
120.52,3.0,14,1,4,3,8,0xb2d0b52d
200091.6,2.0,129,3,3,1,7,0xb2d696e4
16866.8,1.0,9,2,2,3,7,0xb2d48696
19328.0,1.0,2,2,2,4,8,0xb2d6bd98
937074.27,7.0,6,4,4,3,11,0xb2d5e7a8
100003.17,2.0,10,3,3,3,9,0xb2d95eedd
270018.23,7.0,6,3,4,3,10,0xb2d61108
1691.56,1.0,196,1,2,1,4,0xb2d42ba9
3979.68,1.0,92,2,2,1,5,0xb2d2a8a8d
15642.25,2.0,184,2,3,1,6,0xb2d16859d
200003.21,2.0,16,3,3,2,8,0xb2d9e3d4
21955.16,1.0,0,2,2,4,8,0xb2d6d52b
4493.17,2.0,2,2,3,4,9,0xb2d383bad
760081.65,7.0,0,4,4,4,12,0xb2d9fb67
9589.26,1.0,15,2,2,3,7,0xb2d9c468
6.27,1.0,19,1,2,2,5,0xb2d4c242
30000.63,2.0,25,2,3,2,7,0xb2da112d
78084.29,4.0,10,3,4,3,10,0xb2d596fb
265140.54,3.0,21,3,4,2,9,0xb2d16f14
240059.74,2.0,6,3,3,3,9,0xb2d6d47d
2891.74,8.0,42,2,4,2,8,0xb2d16405
29.56,1.0,19,1,2,2,5,0xb2d948a5
100080.07,2.0,0,3,3,4,10,0xb2d94aa4d
2004.62,1.0,229,1,2,1,4,0xb2d6f74d
301197.35,2.0,28,4,3,2,9,0xb2d97229
1375.16,1.0,1,1,2,4,7,0xb2d3991e
53106.07,3.0,0,3,4,4,11,0x3b9b4577
210024.33,3.0,87,3,4,1,8,0xb2d126a2
1666.88,1.0,10,1,2,3,6,0xb2d9bc90
518430.7,3.0,1,4,4,4,12,0xb2d365f6
200224.71,1.0,78,3,2,1,6,0xb2d92757
10562.04,1.0,10,2,2,3,7,0xb2d90bbf
1003552.38,2.0,48,4,3,2,9,0xb2d915be
3914.4,1.0,6,2,2,3,7,0xb2d63ac1
120002.53,2.0,76,3,3,1,7,0xb2d2d673d
525863.36,11.0,3,4,4,4,12,0x3b9b3bfad
814045.47,10.0,3,4,4,4,12,0xb2d1b17dd
240053.15,2.0,1,3,3,4,10,0xb2d24ae0
40017.48,3.0,168,2,4,1,7,0xb2d5c35e
109484.06,3.0,73,3,4,1,8,0xb2d25ca3
1673053.93,13.0,3,4,4,4,12,0xb2d238dc
101046.38,4.0,0,3,4,4,11,0xb2d5b3eb
504543.94,3.0,70,4,4,1,9,0xb2d6391f
250002.64,2.0,45,3,3,2,8,0xb2d91876d
398895.49,3.0,4,4,4,4,12,0xb2d1af5b
201000.0,2.0,1,3,3,4,10,0xb2d98066d
50.94,1.0,46,1,2,2,5,0xb2d3f171
213583.26,2.0,47,3,3,2,8,0xb2d5ff89d
3894.8,1.0,184,2,2,1,5,0xb2d2bbe1d
70093.45,3.0,0,3,4,4,11,0xb2d34d49
497423.39,3.0,0,4,4,4,12,0xb2d069d7d
88420.19,4.0,0,3,4,4,11,0x3b9af11b
11899.83,1.0,14,2,2,3,7,0xb2d60928d
4308.37,1.0,1,2,2,4,8,0xb2d90ad1
556.43,1.0,9,1,2,3,6,0xb2d6dd23
1550144.25,4.0,161,4,4,1,9,0xb2d2852f
280035.38,5.0,10,3,4,3,10,0xb2d8f641
19897.08,1.0,0,2,2,4,8,0xb2d3326c
2219.47,1.0,0,1,2,4,7,0xb2d4cb50d
480132.31,3.0,28,4,4,2,10,0xb2d946e2
538.3,1.0,66,1,2,2,5,0xb2d49546
2068.32,1.0,1,1,2,4,7,0xb2d824b5d
525790.01,7.0,18,4,4,2,10,0xb2d44b2e
40049.13,2.0,18,2,3,2,7,0xb2d698b9d
110030.7,8.0,0,3,4,4,11,0xb2d0d706
95074.5,2.0,73,3,3,1,7,0xb2d5d04a
5009735.31,8.0,0,4,4,4,12,0xb2d245de
921107.89,7.0,11,4,4,3,11,0xb2d62349d
500000.0,1.0,0,4,2,4,10,0xb2d98452
111905.91,2.0,0,3,3,4,10,0xb2d15097
559057.39,7.0,11,4,4,3,11,0xb2d24cf5
7031.14,1.0,0,2,2,4,8,0xb2d9bfeb
566815.02,7.0,20,4,4,2,10,0xb2d53905
20000.94,2.0,53,2,3,2,7,0xb2d96933
104398.67,7.0,0,3,4,4,11,0xb2d0a084d
13.26,1.0,0,1,2,4,7,0xb2d58763
101939.14,7.0,73,3,4,1,8,0xb2d5acc1
20000.21,2.0,14,2,3,3,8,0xb2da3787
259.65,1.0,6,1,2,3,6,0xb2d69bb1
15006561.01,1.0,6,4,2,3,9,0xb2d6c9d1
10003.48,2.0,4,2,3,4,9,0xb2d95d32d
81815.3,3.0,87,3,4,1,8,0xb2d47e09
1154.57,1.0,9,1,2,3,6,0xb2d6ec23
430024.95,9.0,112,4,4,1,9,0xb2d6ed4e
640000.08,4.0,3,4,4,4,12,0xb2d3b89b
233100.46,2.0,4,3,3,4,10,0xb2d3efedd
270008.03,3.0,67,3,4,1,8,0xb2d992fe
2119.5,1.0,92,1,2,1,4,0xb2d12603
1111505.98,7.0,102,4,4,1,9,0xb2d1e7ffd
426765.53,5.0,6,4,4,3,11,0xb2d22a71
191628.33,2.0,6,3,3,3,9,0xb2d0c825
1013.78,1.0,184,1,2,1,4,0xb2d2c171d
4774.39,1.0,48,2,2,2,6,0xb2d37c2fd
10097.74,1.0,13,2,2,3,7,0xb2d1a4ed
200710.42,2.0,5,3,3,3,9,0xb2d933dad
220000.5,3.0,14,3,4,3,10,0xb2d9228b
2280208.56,7.0,28,4,4,2,10,0xb2d4dbb1d
10.0,1.0,5,1,2,3,6,0xb2d9bc73
20.04,1.0,60,1,2,2,5,0xb2d8fcbc
529079.05,2.0,143,4,3,1,8,0xb2d3d190d
20649.13,1.0,28,2,2,2,6,0xb2d69020d
378.4,1.0,7,1,2,3,6,0xb2d97bda
5134.19,1.0,16,2,2,2,6,0xb2d483dcd
6412.07,1.0,10,2,2,3,7,0xb2d3e975
322402.47,2.0,4,4,3,4,11,0xb2d39a9b
1687170.18,3.0,59,4,4,2,10,0xb2d6e719
205689.58,2.0,190,3,3,1,7,0xb2d647c4
1184.18,1.0,2,1,2,4,7,0xb2d5227b
1898.0,1.0,16,1,2,2,5,0xb2d59c4fd
150038.4,3.0,62,3,4,2,9,0xb2d434f3
1400.64,2.0,184,1,3,1,5,0xb2d07199d
442010.82,6.0,3,4,4,4,12,0xb2d8c98a
75.9,1.0,1,1,2,4,7,0xb2d2d460
18967.06,1.0,7,2,2,3,7,0xb2d6063cd
5666.29,1.0,18,2,2,2,6,0xb2d989d0
270096.43,4.0,0,3,4,4,11,0xb2d204eb
352232.15,3.0,34,4,4,2,10,0xb2d687cd
21999.63,1.0,9,2,2,3,7,0xb2d4ae10
200002.11,2.0,35,3,3,2,8,0xb2d949ac
3584.46,1.0,3,2,2,4,8,0xb2d6c17a
4010.62,1.0,210,2,2,1,5,0xb2d6beb4
856.65,1.0,3,1,2,4,7,0xb2d63941
786494.48,2.0,7,4,3,3,10,0xb2d635b8d
98587.22,1.0,1,3,2,4,9,0xb2d2f112
50051.3,18.0,17,2,4,2,8,0xb2d2bc31d
379669.79,4.0,19,4,4,2,10,0xb2d1c06a
10000.21,2.0,221,2,3,1,6,0xb2d6ffd2
614086.64,4.0,5,4,4,3,11,0xb2d0ce69
9806.41,1.0,0,2,2,4,8,0xb2d1f7c6d
550019.4,3.0,165,4,4,1,9,0xb2d59401
400010.56,5.0,31,4,4,2,10,0xb2d45923d
553.26,6.0,58,1,4,2,7,0xb2d2d2f2
2022.62,1.0,184,1,2,1,4,0xb2d27dcbd
13838.64,1.0,8,2,2,3,7,0xb2d55bc1d
70559.73,2.0,21,3,3,2,8,0xb2d9434fd
7446.71,1.0,25,2,2,2,6,0xb2d17415
10000.11,2.0,25,2,3,2,7,0xb2da14c0
40923.1,3.0,13,2,4,3,9,0xb2d5818bd
1077201.5,4.0,0,4,4,4,12,0x3b9af1fb
73354.0,3.0,70,3,4,1,8,0xb2d56174
215993.15,2.0,206,3,3,1,7,0xb2d412cf
203902.5,4.0,0,3,4,4,11,0xb2d5f2cc
1021338.35,9.0,95,4,4,1,9,0xb2d1a8af
16857.55,1.0,14,2,2,3,7,0xb2d5d760
1487.5,1.0,0,1,2,4,7,0xb2d85d25
90102.97,2.0,123,3,3,1,7,0xb2d935ac
62868.95,2.0,87,3,3,1,7,0xb2d1c02c
20000.63,2.0,95,2,3,1,6,0xb2d97339
480000.0,3.0,0,4,4,4,12,0xb2d6f925d
269273.53,3.0,76,3,4,1,8,0xb2d38483d
285096.42,9.0,6,3,4,3,10,0xb2d0fc39d
36600.99,4.0,0,2,4,4,10,0xb2d58646d
595764.13,2.0,5,4,3,3,10,0xb2d2285d
1079518.78,5.0,17,4,4,2,10,0xb2d06d53d
500004.47,2.0,10,4,3,3,10,0xb2d6a545
1000049.55,4.0,6,4,4,3,11,0xb2d642f7d
451.18,1.0,8,1,2,3,6,0xb2d9c413
17105.63,1.0,46,2,2,2,6,0xb2d5e0a7
60.18,1.0,204,1,2,1,4,0xb2d6ac6f
164596.02,3.0,1,3,4,4,11,0xb2d0d7b3
0.0,1.0,10,1,2,3,6,0xb2d8d52b
98397.66,1.0,99,3,2,1,6,0xb2d6444a
1573659.34,5.0,18,4,4,2,10,0xb2d19555d
578111.9,8.0,0,4,4,4,12,0xb2d240e3
2083.36,1.0,13,1,2,3,6,0xb2d5f22c
50005.51,3.0,98,2,4,1,7,0x3b9aef53
4885.7,1.0,0,2,2,4,8,0xb2d8dcaa
70023.5,2.0,102,3,3,1,7,0xb2d1b148d
24556.01,1.0,18,2,2,2,6,0xb2d343cdd
3000067.92,2.0,95,4,3,1,8,0xb2d17091
6700031.29,3.0,3,4,4,4,12,0xb2d6273b
1327236.86,8.0,41,4,4,2,10,0xb2d6bbe2
40645.8,2.0,39,2,3,2,7,0xb2d6d6bc
9786.44,1.0,1,2,2,4,8,0xb2d78f2fd
3052.35,1.0,184,2,2,1,5,0xb2d0f336d
35463.95,1.0,116,2,2,1,5,0xb2d2ec8b
336054.79,3.0,4,4,4,4,12,0xb2d3d513
11805.17,1.0,3,2,2,4,8,0xb2d22a06
6110.02,1.0,4,2,2,4,8,0xb2d5bdff
200000.0,2.0,6,3,3,3,9,0xb2d97454d
318737.03,21.0,1,4,4,4,12,0xb2d0f7b3
65256.85,3.0,50,3,4,2,9,0xb2d5c11f
676011.25,12.0,6,4,4,3,11,0xb2d23a8fd
161154.76,3.0,38,3,4,2,9,0xb2d58813
13968.22,1.0,0,2,2,4,8,0xb2d38069
19714.11,1.0,11,2,2,3,7,0xb2d1f81a
0.0,1.0,77,1,2,1,4,0xb2d5e91e
400095.79,5.0,87,4,4,1,9,0xb2d084a3
349129.3,5.0,0,4,4,4,12,0xb2d1870ed
3419.1,1.0,184,2,2,1,5,0xb2d2c8d1d
4003416.64,2.0,4,4,3,4,11,0xb2d90394
40170.84,2.0,171,2,3,1,6,0xb2d68652
6765.13,1.0,92,2,2,1,5,0xb2d2acbb
503555.15,2.0,77,4,3,1,8,0xb2d2166c
238.48,1.0,12,1,2,3,6,0xb2d3459e
6781.31,1.0,6,2,2,3,7,0xb2d29d17
4.04,1.0,9,1,2,3,6,0xb2d4cdf2
5593.54,1.0,4,2,2,4,8,0xb2d9f75b
500000.0,2.0,25,4,3,2,9,0xb2da172a
11587.61,1.0,10,2,2,3,7,0xb2d40286
2084.57,2.0,179,1,3,1,5,0xb2d6e184d
316.63,1.0,17,1,2,2,5,0xb2d35926
413460.11,3.0,16,4,4,2,10,0xb2d364b5
153458.78,3.0,13,3,4,3,10,0xb2d4e870d
2947.28,1.0,10,2,2,3,7,0xb2d8c475
581.38,1.0,45,1,2,2,5,0xb2d45e74
1004269.3,2.0,11,4,3,3,10,0xb2d67d49d
231660.63,10.0,35,3,4,2,9,0xb2d5b315
20002.17,3.0,11,2,4,3,9,0xb2da48af
966312.02,7.0,11,4,4,3,11,0xb2d1d3dd
533.62,1.0,42,1,2,2,5,0xb2d39dd9
5.28,2.0,20,1,3,2,6,0xb2d0fc92
70000.14,2.0,6,3,3,3,9,0xb2d6b2e3d
117030.88,2.0,144,3,3,1,7,0xb2d13e7bd
927.03,1.0,5,1,2,3,6,0xb2d1df24
75002.22,3.0,48,3,4,2,9,0xb2d6ac17
125.99,1.0,14,1,2,3,6,0x3b9b44e1
441123.96,1.0,1,4,2,4,10,0xb2d6dd62
30049.22,1.0,0,2,2,4,8,0xb2d559efd
330214.12,2.0,137,4,3,1,8,0xb2d2455a
10015.94,1.0,161,2,2,1,5,0xb2d8ec90
1.11,1.0,3,1,2,4,7,0xb2d69195d
602.33,1.0,0,1,2,4,7,0xb2d8ebf4
500049.96,2.0,1,4,3,4,11,0xb2da57cb
160022.82,4.0,10,3,4,3,10,0xb2d6013e
500031.32,4.0,38,4,4,2,10,0xb2d1128c
9134.4,1.0,1,2,2,4,8,0xb2d6bafed
5.64,1.0,18,1,2,2,5,0xb2d3a065
25.38,1.0,1,1,2,4,7,0xb2d6575c
12881000.0,19.0,5,4,4,3,11,0xb2d5de60d
61451.37,2.0,20,3,3,2,8,0xb2d206ad
83428.12,1.0,1,3,2,4,9,0xb2d3d581
430066.21,3.0,228,4,4,1,9,0xb2d11ad2
368714.64,2.0,1,4,3,4,11,0xb2d269dfd
5357.46,1.0,184,2,2,1,5,0xb2d235f4
32148.86,1.0,49,2,2,2,6,0xb2d56ffa
407217.06,4.0,0,4,4,4,12,0xb2d5857c
31404.9,1.0,4,2,2,4,8,0xb2d29fe7
1700050.09,2.0,106,4,3,1,8,0xb2d93135
5262.96,1.0,0,2,2,4,8,0xb2d2f0b5
87214.05,2.0,56,3,3,2,8,0xb2d2de5f
485.92,1.0,133,1,2,1,4,0xb2d1dbef
720002.33,5.0,8,4,4,3,11,0xb2d9b013
462141.76,6.0,32,4,4,2,10,0xb2d447ad
30824.14,1.0,1,2,2,4,8,0xb2d6cd15
647.68,1.0,13,1,2,3,6,0xb2d2fb5d
401453.71,2.0,33,4,3,2,9,0xb2d5dc17
201421.13,2.0,76,3,3,1,7,0xb2d99c20
1956.43,1.0,184,1,2,1,4,0xb2d2eee2
2100000.1,11.0,1,4,4,4,12,0xb2d9a562
110392.13,1.0,4,3,2,4,9,0xb2d25089
23817.79,1.0,5,2,2,3,7,0xb2d41e49
9429.35,1.0,92,2,2,1,5,0xb2d3b13e
100054.41,2.0,2,3,3,4,10,0xb2d9ccdb
23613.97,1.0,92,2,2,1,5,0xb2d11987d
373522.78,6.0,0,4,4,4,12,0x3b9b102a
1068.09,1.0,3,1,2,4,7,0xb2d62954
191296.99,4.0,11,3,4,3,10,0xb2d63b52d
1001.45,1.0,146,1,2,1,4,0xb2d6c142
376962.99,2.0,10,4,3,3,10,0xb2d34f79d
68048.97,2.0,46,3,3,2,8,0xb2d26c05
105010.67,3.0,70,3,4,1,8,0xb2d0db3c
204412.31,7.0,0,3,4,4,11,0xb2d12c01
480028.31,2.0,21,4,3,2,9,0xb2d784d7
200000.0,2.0,27,3,3,2,8,0xb2da1147
228242.62,3.0,55,3,4,2,9,0xb2d49ec8d
20010.56,1.0,59,2,2,2,6,0xb2d2c050
101.9,1.0,44,1,2,2,5,0xb2d20e91
150003.17,2.0,87,3,3,1,7,0xb2d3b726
100024.91,2.0,116,3,3,1,7,0xb2d36852
201984.63,2.0,50,3,3,2,8,0xb2d6f966
13291.89,2.0,1,2,3,4,9,0xb2d10e24d
120001.69,3.0,4,3,4,4,11,0xb2d95c1a
208806.01,2.0,11,3,3,3,9,0xb2d435c3d
683.12,1.0,2,1,2,4,7,0xb2d5c679
8408.61,1.0,18,2,2,2,6,0xb2d6bfaa
1.79,1.0,5,1,2,3,6,0xb2d6ce5f
0.42,1.0,5,1,2,3,6,0xb2da3bba
557055.07,4.0,11,4,4,3,11,0xb2d2452dd
3557.5,1.0,184,2,2,1,5,0xb2d53cb0d
23320.97,1.0,16,2,2,2,6,0xb2d3969bd
494.61,1.0,0,1,2,4,7,0xb2d34380
61325.17,2.0,92,3,3,1,7,0xb2d0e1c2
0.0,1.0,92,1,2,1,4,0xb2d5264b
100158.89,2.0,47,3,3,2,8,0xb2d10637d
808734.9,3.0,95,4,4,1,9,0xb2d256fa
501963.65,2.0,16,4,3,2,9,0xb2d5e390
3032.71,1.0,0,2,2,4,8,0xb2d8f701d
10000.0,1.0,2,2,2,4,8,0xb2d6bd52
10326.7,1.0,1,2,2,4,8,0xb2d629cb
53059.44,1.0,7,3,2,3,8,0xb2d4d051
479.67,1.0,8,1,2,3,6,0xb2d53500
200000.0,2.0,7,3,3,3,9,0xb2d96eb3d
377008.01,7.0,3,4,4,4,12,0xb2d5f405
4030307.04,6.0,0,4,4,4,12,0xb2d10bc1
15627.33,1.0,31,2,2,2,6,0xb2d6c04a
50034.02,2.0,11,2,3,3,8,0xb2d657f7
105741.24,2.0,80,3,3,1,7,0xb2d3b73bd
12019.35,1.0,10,2,2,3,7,0xb2d342fa
458.52,1.0,5,1,2,3,6,0xb2d2a1dfd
2.96,1.0,18,1,2,2,5,0xb2da2ab8
18191.54,1.0,0,2,2,4,8,0xb2d591e4
8340076.22,14.0,10,4,4,3,11,0x3b9acd5f
70000.0,2.0,0,3,3,4,10,0xb2d98188
601493.04,6.0,0,4,4,4,12,0xb2d0c0bcd
130242.04,3.0,0,3,4,4,11,0xb2d0fdff
400222.77,2.0,0,4,3,4,11,0xb2d8f883d
1401161.66,9.0,4,4,4,4,12,0x3b9b248d
4.01,1.0,10,1,2,3,6,0xb2d3573ad
252356.24,7.0,0,3,4,4,11,0xb2d6354f
761351.56,2.0,53,4,3,2,9,0xb2d59d12
70449.11,1.0,0,3,2,4,9,0xb2d62e40
117000.0,1.0,2,3,2,4,9,0xb2d6e82f
444622.75,4.0,4,4,4,4,12,0xb2d1f7d5
2114.43,2.0,20,1,3,2,6,0x3b9af24b
400004.22,2.0,42,4,3,2,9,0xb2d9e7b4
55203.29,2.0,0,3,3,4,10,0xb2d40fe0d
1062.37,1.0,92,1,2,1,4,0xb2d2d490
3504.59,1.0,67,2,2,1,5,0xb2d63f87
156936.65,2.0,153,3,3,1,7,0xb2d40c6e
68001.62,3.0,76,3,4,1,8,0xb2d43cfd
14125.82,2.0,2,2,3,4,9,0xb2d906c5
14927.65,1.0,18,2,2,2,6,0xb2d5d725
325100.1,3.0,11,4,4,3,11,0xb2d510c9
281301.5,4.0,0,3,4,4,11,0xb2d1ada7
27728.43,1.0,0,2,2,4,8,0xb2d50bc8d
0.32,1.0,11,1,2,3,6,0xb2da3575
2097.47,1.0,0,1,2,4,7,0xb2d34d47
90500.36,3.0,19,3,4,2,9,0xb2d58255
3109.24,1.0,68,2,2,1,5,0xb2d63188
117.25,3.0,32,1,4,2,7,0xb2d0b52dd
208775.47,7.0,3,3,4,4,11,0xb2d10c16
191068.93,3.0,0,3,4,4,11,0xb2d0b162d
200003.16,2.0,14,3,3,3,9,0xb2d8df59
210.62,1.0,0,1,2,4,7,0xb2d4d13b
2263.53,1.0,184,1,2,1,4,0xb2d2cd33d
20826.93,1.0,92,2,2,1,5,0xb2d1b142d
34069.78,1.0,152,2,2,1,5,0xb2d2217d
100010.56,2.0,42,3,3,2,8,0xb2d9d569
755679.84,3.0,31,4,4,2,10,0xb2d5bf5e
170001.53,2.0,1,3,3,4,10,0xb2d643ccd
10702.82,1.0,5,2,2,3,7,0xb2d5d60a
81454.93,27.0,0,3,4,4,11,0x3b9b1816d
165.19,1.0,70,1,2,1,4,0xb2d62898
1100049.31,2.0,0,4,3,4,11,0xb2d5f5fdd
100051.48,2.0,0,3,3,4,10,0xb2d2161ad
8340.48,1.0,184,2,2,1,5,0x3b9ad03ed
17501.04,2.0,66,2,3,2,7,0xb2d194e5d
63.62,1.0,9,1,2,3,6,0xb2d35e49
17741.82,1.0,10,2,2,3,7,0xb2d6cbe7
62997.27,1.0,92,3,2,1,6,0xb2d32df2
131.73,1.0,28,1,2,2,5,0xb2d8f2a6
609.81,1.0,9,1,2,3,6,0xb2d46f80
165003.75,4.0,34,3,4,2,9,0xb2d816b1
2520.12,1.0,9,1,2,3,6,0xb2d2fa85
58.09,1.0,84,1,2,1,4,0xb2d67f49d
110.6,2.0,42,1,3,2,6,0xb2d422dad
774.42,1.0,28,1,2,2,5,0xb2d6f2ee
80925.52,4.0,11,3,4,3,10,0xb2d8d781
350072.97,2.0,3,4,3,4,11,0xb2d74332d
825080.99,10.0,0,4,4,4,12,0xb2d3d2d9d
273079.66,3.0,1,3,4,4,11,0xb2d19b21
80027.56,2.0,10,3,3,3,9,0xb2d58511
75003.17,2.0,188,3,3,1,7,0xb2d6a742d
1051.53,1.0,184,1,2,1,4,0xb2d42ca6
4660.27,4.0,0,2,4,4,10,0x3b9b459e
40066.88,2.0,122,2,3,1,6,0xb2d59607
110143.18,2.0,27,3,3,2,8,0xb2d641ced
223172.73,29.0,0,3,4,4,11,0x3b9af288
83.95,1.0,19,1,2,2,5,0xb2d1efed
38556.98,1.0,0,2,2,4,8,0xb2d98d08
250020.54,3.0,10,3,4,3,10,0xb2d25582
50002.56,2.0,263,2,3,1,6,0xb2d5905b
69882.52,1.0,6,3,2,3,8,0xb2d91873
455969.83,6.0,0,4,4,4,12,0xb2d226b3
34.21,1.0,28,1,2,2,5,0xb2d6cc63
3319.93,1.0,0,2,2,4,8,0xb2d5cf48
55376.26,3.0,172,3,4,1,8,0xb2d294ff
60002.96,2.0,6,3,3,3,9,0xb2d25224
438.42,1.0,10,1,2,3,6,0xb2d94ceb
2000.21,1.0,184,1,2,1,4,0xb2d0ae09d
20.29,1.0,12,1,2,3,6,0xb2d610b6d
20000.42,2.0,92,2,3,1,6,0xb2d63a28d
735588.75,8.0,2,4,4,4,12,0xb2d20ab1
100015.76,2.0,143,3,3,1,7,0xb2d4c838d
105586.22,1.0,1,3,2,4,9,0xb2d3342d
2.15,1.0,3,1,2,4,7,0xb2d5d470
585092.38,6.0,13,4,4,3,11,0xb2d60927
9646.83,2.0,21,2,3,2,7,0xb2d8cb50
1821302.9,4.0,10,4,4,3,11,0xb2d14235
537669.61,4.0,48,4,4,2,10,0xb2d23ea0d
5072.42,1.0,67,2,2,1,5,0xb2d3902a
235963.07,4.0,0,3,4,4,11,0xb2d5c541d
10354.1,2.0,61,2,3,2,7,0xb2d4adc8
222.29,1.0,14,1,2,3,6,0xb2d60ad9
353.0,1.0,1,1,2,4,7,0xb2d6f0cd
50001.06,2.0,213,2,3,1,6,0xb2d6851f
1000000.0,2.0,3,4,3,4,11,0xb2d97d97
550060.22,6.0,20,4,4,2,10,0xb2d6231fd
216769.96,4.0,185,3,4,1,8,0x3b9b3e98
100154.05,3.0,13,3,4,3,10,0xb2d60660d
102.5,1.0,9,1,2,3,6,0xb2d3558f
432272.34,5.0,59,4,4,2,10,0xb2d32d4c
21025.81,1.0,0,2,2,4,8,0xb2d8ede4
15590.82,1.0,15,2,2,3,7,0xb2da2ef5
30011.52,2.0,214,2,3,1,6,0xb2d535c3d
1139811.36,11.0,0,4,4,4,12,0x3b9af270d
4517.65,1.0,184,2,2,1,5,0xb2d406b4d
22466.82,1.0,1,2,2,4,8,0xb2d2e2d5
2074.45,1.0,60,1,2,2,5,0xb2d9559a
1222440.26,6.0,19,4,4,2,10,0xb2d1bb76
250000.05,2.0,21,3,3,2,8,0xb2d9027fd
427000.17,3.0,7,4,4,3,11,0xb2d56340d
46.23,1.0,31,1,2,2,5,0xb2d5cba0
2915.7,1.0,10,2,2,3,7,0xb2d30bf5
68.16,1.0,6,1,2,3,6,0xb2d81144
0.0,1.0,0,1,2,4,7,0xb2d6b35a
379017.93,4.0,13,4,4,3,11,0xb2d1d974
37026.45,1.0,6,2,2,3,7,0xb2d81276
3554.14,1.0,13,2,2,3,7,0xb2d61b39d
0.0,1.0,3,1,2,4,7,0xb2d6ed02
3422.27,1.0,10,2,2,3,7,0xb2d8130c
52643.7,1.0,184,3,2,1,6,0xb2d231ee
60003.17,3.0,18,3,4,2,9,0xb2d93b98d
0.55,1.0,66,1,2,2,5,0xb2d6c63a
30000.0,2.0,6,2,3,3,8,0xb2da50b7
1053.25,1.0,184,1,2,1,4,0xb2d3f85fd
220000.95,2.0,4,3,3,4,10,0xb2d67ffe
542337.0,6.0,21,4,4,2,10,0xb2d5095d
991440.43,5.0,29,4,4,2,10,0xb2d15fa8
450492.58,3.0,14,4,4,3,11,0xb2d8e1c1
310674.64,2.0,74,4,3,1,8,0xb2d66a6a
1.59,2.0,0,1,3,4,8,0xb2d1b1d3
5872.76,1.0,9,2,2,3,7,0xb2d92f63
10482.52,2.0,33,2,3,2,7,0xb2d54980d
305233.89,5.0,1,4,4,4,12,0xb2d201ced
279078.67,3.0,0,3,4,4,11,0xb2d2623f
303881.98,8.0,15,4,4,3,11,0xb2d5890ed
550570.88,6.0,69,4,4,1,9,0xb2d20b47
1190737.72,11.0,0,4,4,4,12,0x3b9b1005
577101.59,6.0,9,4,4,3,11,0x3b9b419cd
1002935.88,2.0,5,4,3,3,10,0xb2d24f70
237321.44,3.0,80,3,4,1,8,0xb2d07231
1500000.0,6.0,153,4,4,1,9,0xb2d6d337
560005.91,3.0,62,4,4,2,10,0xb2d8ef78
500000.0,2.0,4,4,3,4,11,0xb2da6361
8329.41,1.0,277,2,2,1,5,0xb2d16331d
478433.71,4.0,179,4,4,1,9,0xb2d400cb
80010.69,2.0,143,3,3,1,7,0xb2d1ea5b
1810.62,1.0,18,1,2,2,5,0xb2d3107ad
1368393.29,3.0,25,4,4,2,10,0xb2d3c524d
0.0,1.0,1,1,2,4,7,0xb2da68a9
243568.48,3.0,11,3,4,3,10,0xb2d2d08d
880009.31,3.0,104,4,4,1,9,0xb2d66532
1170.45,1.0,39,1,2,2,5,0xb2d1f9d4
110094.51,5.0,0,3,4,4,11,0xb2d27d11d
805594.67,4.0,52,4,4,2,10,0xb2d1aab4
39903.75,1.0,38,2,2,2,6,0xb2d425f4
512539.22,3.0,5,4,4,3,11,0xb2d59f5b
14575.52,1.0,0,2,2,4,8,0xb2d9955f
3627.61,1.0,10,2,2,3,7,0xb2d2e2cf
204008.63,2.0,92,3,3,1,7,0xb2d65957
200000.0,2.0,21,3,3,2,8,0xb2da2560
200010.45,3.0,55,3,4,2,9,0xb2d7ed90
7722.31,2.0,0,2,3,4,9,0xb2d36033
49428.55,1.0,1,2,2,4,8,0xb2d320fdd
14867.56,1.0,5,2,2,3,7,0xb2d791e4d
3.41,1.0,14,1,2,3,6,0xb2d946fc
11803.05,1.0,1,2,2,4,8,0xb2d2b612d
15000.16,2.0,111,2,3,1,6,0xb2d78b3cd
84.44,1.0,27,1,2,2,5,0xb2da07b2
9348.35,1.0,9,2,2,3,7,0xb2d6f4d7
22016.45,1.0,2,2,2,4,8,0xb2d60df8
4924.29,1.0,0,2,2,4,8,0xb2d9ca0b
361774.13,3.0,172,4,4,1,9,0xb2d3f6f7d
53515.65,2.0,1,3,3,4,10,0xb2d54aee
74.87,1.0,14,1,2,3,6,0xb2d10770
1085209.82,5.0,0,4,4,4,12,0xb2d1531f
294979.48,3.0,15,3,4,3,10,0xb2d11b81
500000.53,3.0,21,4,4,2,10,0xb2da1bde
2.15,1.0,13,1,2,3,6,0xb2d9431ad
1623.65,1.0,73,1,2,1,4,0xb2d4ba30
1000000.0,1.0,0,4,2,4,10,0xb2da6c61
1706576.75,10.0,25,4,4,2,10,0xb2d0b2f6d
7853.1,1.0,60,2,2,2,6,0xb2d2a30f
44147.44,5.0,25,2,4,2,8,0xb2d781fc
1140000.39,5.0,1,4,4,4,12,0xb2d1bd8f
201325.73,1.0,1,3,2,4,9,0xb2d0f531
400095.44,3.0,33,4,4,2,10,0xb2d619b3
0.0,1.0,1,1,2,4,7,0xb2da387b
221.41,1.0,12,1,2,3,6,0xb2d2d1d2
213644.22,2.0,7,3,3,3,9,0xb2d2b0b1
26146.46,1.0,92,2,2,1,5,0xb2d0e9de
0.04,1.0,59,1,2,2,5,0xb2d4fa5c
225010.32,3.0,67,3,4,1,8,0xb2d146cd
275331.65,2.0,0,3,3,4,10,0x3b9b2d44
100004.22,2.0,83,3,3,1,7,0xb2d8cdac
208.41,1.0,3,1,2,4,7,0xb2d55f1fd
3251.54,1.0,17,2,2,2,6,0xb2d6d30ed
1035.28,1.0,0,1,2,4,7,0xb2d2031d
661303.08,2.0,17,4,3,2,9,0xb2da25c9
0.0,1.0,7,1,2,3,6,0xb2d90d15
3471.43,1.0,184,2,2,1,5,0xb2d2034a
30680.41,1.0,15,2,2,3,7,0xb2d5d783d
128500.0,10.0,0,3,4,4,11,0xb2d280bb
22.86,1.0,36,1,2,2,5,0xb2d5980b
1779.67,1.0,175,1,2,1,4,0xb2d41d5e
407838.42,7.0,0,4,4,4,12,0xb2d3fe80
50000.53,2.0,18,2,3,2,7,0xb2d952e7d
4767.14,1.0,92,2,2,1,5,0xb2d166ce
1702.26,1.0,173,1,2,1,4,0xb2d6b99ad
42503.2,2.0,184,2,3,1,6,0xb2d438f3
1326.59,1.0,129,1,2,1,4,0xb2d92b84
72554.62,1.0,99,3,2,1,6,0xb2d6286ed
70001.48,2.0,75,3,3,1,7,0xb2d2de9c
601163.1,3.0,24,4,4,2,10,0xb2d5e852
16.85,2.0,16,1,3,2,6,0xb2d515b9d
20003.98,2.0,208,2,3,1,6,0xb2d31322
234095.62,6.0,4,3,4,4,11,0xb2d5ce70d
1443748.49,3.0,7,4,4,3,11,0xb2d5f5c6
61429.98,1.0,12,3,2,3,8,0xb2d147a5d
8840.85,1.0,1,2,2,4,8,0xb2d2d28dd
765001.48,13.0,31,4,4,2,10,0xb2d4f036
1092263.55,8.0,86,4,4,1,9,0xb2d59c7ad
58055.99,5.0,0,3,4,4,11,0xb2d06896
56213.7,3.0,181,3,4,1,8,0xb2d63fc2
1156.38,1.0,0,1,2,4,7,0xb2d3491d
430872.98,6.0,3,4,4,4,12,0xb2d49581d
408543.79,11.0,1,4,4,4,12,0x3b9af24c
352000.0,2.0,20,4,3,2,9,0xb2d78b6d
460.46,1.0,19,1,2,2,5,0xb2d4385d
27293.74,1.0,14,2,2,3,7,0xb2d406d0
7004.22,1.0,9,2,2,3,7,0xb2d50bbdd
435063.36,6.0,0,4,4,4,12,0xb2d42552d
3347.69,1.0,12,2,2,3,7,0xb2d23999
22075.77,1.0,0,2,2,4,8,0xb2d1a052
16074.99,1.0,96,2,2,1,5,0xb2d1bf96
2373.08,1.0,1,1,2,4,7,0xb2d35478
650016.7,2.0,0,4,3,4,11,0xb2d8d7aad
1630.94,1.0,10,1,2,3,6,0xb2d650e0
512801.78,3.0,57,4,4,2,10,0xb2d6aa04
0.94,1.0,10,1,2,3,6,0xb2d9b36a
697321.98,5.0,228,4,4,1,9,0xb2d2dc91d
3130.06,1.0,184,2,2,1,5,0xb2d1104fd
321696.94,8.0,0,4,4,4,12,0x3b9af1d1
2304.3,1.0,9,1,2,3,6,0xb2d27dc0d
907.89,1.0,4,1,2,4,7,0xb2d4ed5f
3191.33,1.0,67,2,2,1,5,0xb2d5d996
10005.45,2.0,90,2,3,1,6,0xb2d88c6c
4254.77,1.0,175,2,2,1,5,0xb2d36b1f
4040.26,1.0,20,2,2,2,6,0xb2d6dd10
572030.16,4.0,97,4,4,1,9,0xb2d22068
104964.38,2.0,208,3,3,1,7,0xb2d48e56
14.06,1.0,5,1,2,3,6,0xb2d4fcfb
1097133.56,5.0,8,4,4,3,11,0xb2d0da82
100214.43,3.0,11,3,4,3,10,0xb2d6c388
19142.08,1.0,184,2,2,1,5,0xb2d2554c
2669.3,1.0,9,1,2,3,6,0xb2d5f614
582.16,1.0,18,1,2,2,5,0xb2d446d6
3019.63,1.0,92,2,2,1,5,0xb2d2e6d1d
180008.24,3.0,144,3,4,1,8,0xb2d207d5
247049.6,10.0,12,3,4,3,10,0xb2d279b5
6094.41,1.0,11,2,2,3,7,0xb2d9b47f
2.49,1.0,29,1,2,2,5,0xb2d6ee8a
1049.07,1.0,158,1,2,1,4,0xb2d2ea3e
589.61,1.0,0,1,2,4,7,0xb2d88fbf
200421.06,2.0,3,3,3,4,10,0xb2d9a964
12.59,1.0,10,1,2,3,6,0xb2d4cdf2d
142352.25,5.0,4,3,4,4,11,0xb2d09a86
3068963.26,20.0,7,4,4,3,11,0x3b9adca7
1350348.92,3.0,11,4,4,3,11,0xb2d24b9e
829.29,1.0,22,1,2,2,5,0xb2d1c122
333501.38,3.0,1,4,4,4,12,0xb2d412a1d
30931.11,1.0,7,2,2,3,7,0xb2d6b55b
118311.97,3.0,0,3,4,4,11,0xb2d4ba4cd
201955.07,2.0,0,3,3,4,10,0xb2d6a409d
100068.2,2.0,4,3,3,4,10,0xb2d2c2fb
468451.87,1.0,12,4,2,3,9,0xb2d910d4
199.41,1.0,2,1,2,4,7,0xb2d7ed72d
11564.82,1.0,0,2,2,4,8,0xb2d3c2fe
4302.31,1.0,0,2,2,4,8,0xb2d8e87a
1010.73,1.0,184,1,2,1,4,0xb2d2a825d
300000.14,4.0,18,3,4,2,9,0xb2d186e0
430050.71,2.0,174,4,3,1,8,0xb2d118c7d
1119646.72,7.0,6,4,4,3,11,0xb2d97108
9918.72,1.0,64,2,2,2,6,0xb2d2cbd0d
1232.5,1.0,184,1,2,1,4,0xb2d29d99
42.56,1.0,56,1,2,2,5,0xb2d4e205
422082.25,3.0,0,4,4,4,12,0xb2d3659dd
1.68,1.0,4,1,2,4,7,0xb2d206ba
1668.98,1.0,11,1,2,3,6,0xb2d2692a
260002.74,3.0,19,3,4,2,9,0xb2d9931e
60000.0,1.0,1,3,2,4,9,0xb2da6645
249490.14,3.0,70,3,4,1,8,0xb2d10c7d
6565752.58,14.0,25,4,4,2,10,0xb2d31b19d
594195.38,5.0,92,4,4,1,9,0x3b9af3fbd
300173.69,2.0,11,4,3,3,10,0xb2d124e0
206802.11,2.0,83,3,3,1,7,0xb2d5611e
38.01,1.0,49,1,2,2,5,0xb2d8cdd7
3112.99,1.0,78,2,2,1,5,0xb2d95098
44451.7,1.0,13,2,2,3,7,0xb2d5d11fd
5020.38,1.0,5,2,2,3,7,0xb2d5ff6a
11001.15,1.0,92,2,2,1,5,0xb2d2f12cd
1015.28,1.0,92,1,2,1,4,0xb2d106efd
33493.04,1.0,19,2,2,2,6,0xb2d6ee9b
250195.05,2.0,0,3,3,4,10,0xb2d9abaa
1385.71,1.0,1,1,2,4,7,0xb2d8cd89d
2282.67,10.0,184,1,4,1,6,0x3b9b2a57d
22129.84,1.0,7,2,2,3,7,0xb2d8100ed
358.75,1.0,14,1,2,3,6,0xb2d67e83
57.31,2.0,16,1,3,2,6,0xb2d3d13a
310000.0,9.0,4,4,4,4,12,0xb2d3cf22d
205774.81,2.0,41,3,3,2,8,0xb2d16da2d
4041.95,1.0,184,2,2,1,5,0xb2d31cd7d
595205.61,1.0,6,4,2,3,9,0xb2d30196d
321436.16,4.0,52,4,4,2,10,0xb2d9afbe
394128.09,4.0,18,4,4,2,10,0xb2d6b6b1
1.16,1.0,27,1,2,2,5,0xb2d5954bd
1733.13,1.0,57,1,2,2,5,0xb2d8e1ac
600004.22,4.0,18,4,4,2,10,0xb2d94100
5214.39,1.0,184,2,2,1,5,0xb2d2b2a1d
80145.31,2.0,18,3,3,2,8,0xb2d0a2db
648.98,1.0,1,1,2,4,7,0xb2d6e3eb
10001.59,2.0,139,2,3,1,6,0xb2d6da66
1000044.23,8.0,1,4,4,4,12,0xb2d29c70
216004.56,4.0,143,3,4,1,8,0xb2d65ad5d
6475.04,1.0,273,2,2,1,5,0xb2d2ad2ed
120915.81,5.0,10,3,4,3,10,0xb2d58f60d
2603.09,1.0,8,1,2,3,6,0xb2d291d1
20087.53,1.0,0,2,2,4,8,0xb2d3482e
1651518.84,4.0,11,4,4,3,11,0xb2d64491
1280.32,3.0,92,1,4,1,6,0xb2d22eadd
330745.64,7.0,0,4,4,4,12,0xb2d2a0a0d
10329.32,1.0,18,2,2,2,6,0xb2d5d306d
10086.07,1.0,92,2,2,1,5,0xb2d2b000d
0.67,1.0,3,1,2,4,7,0xb2d5ce42
500002.11,3.0,25,4,4,2,10,0xb2da14d5
39.27,1.0,32,1,2,2,5,0xb2d8f79d
218008.61,2.0,200,3,3,1,7,0xb2d5c1e3d
1166.26,1.0,15,1,2,3,6,0xb2d8d24ed
257.51,1.0,60,1,2,2,5,0xb2d63353
7917.48,1.0,0,2,2,4,8,0xb2d9b990
105037.05,4.0,11,3,4,3,10,0xb2d23daf
90003.8,2.0,34,3,3,2,8,0xb2d92ef6
33.19,1.0,31,1,2,2,5,0xb2d4bd6c
15107.23,1.0,5,2,2,3,7,0xb2d41f92d
1977.89,1.0,11,1,2,3,6,0xb2d69d70
411230.24,6.0,0,4,4,4,12,0xb2d0d7d3
450071.62,4.0,7,4,4,3,11,0xb2d71939
1272.28,1.0,184,1,2,1,4,0xb2d13a2cd
302688.49,2.0,52,4,3,2,9,0xb2d94090d
242.38,1.0,0,1,2,4,7,0xb2d69ac9
725015.38,8.0,20,4,4,2,10,0xb2d557a5
250400.01,2.0,11,3,3,3,9,0xb2d968d0d
1180779.89,14.0,20,4,4,2,10,0xb2d2865dd
5671.54,1.0,18,2,2,2,6,0xb2d91745d
2503.06,1.0,19,1,2,2,5,0xb2d243b3d
1825294.81,8.0,13,4,4,3,11,0xb2d4c819
23.4,1.0,147,1,2,1,4,0xb2d260c3
9176.35,2.0,92,2,3,1,6,0xb2d28a81
376101.01,3.0,1,4,4,4,12,0xb2d0d486
5345.86,1.0,92,2,2,1,5,0xb2d2456dd
624052.9,3.0,42,4,4,2,10,0xb2d4df14
910011.83,5.0,38,4,4,2,10,0xb2d68090
10321.56,2.0,144,2,3,1,6,0xb2d594ccd
437896.39,2.0,12,4,3,3,10,0xb2d5c4f1d
12.64,1.0,208,1,2,1,4,0xb2d78408
11.52,1.0,48,1,2,2,5,0xb2d58c9b
50008.92,2.0,26,2,3,2,7,0xb2d5753f
7296.76,1.0,7,2,2,3,7,0xb2d29242
14265.29,1.0,0,2,2,4,8,0xb2d1c122d
250767.17,3.0,27,3,4,2,9,0xb2d68ab6
23779.4,1.0,0,2,2,4,8,0xb2d3aad1
173.5,1.0,0,1,2,4,7,0xb2d1c343
1224.45,2.0,184,1,3,1,5,0x3b9b28b6
19445.73,1.0,6,2,2,3,7,0xb2d2a8ced
954315.21,1.0,7,4,2,3,9,0xb2d2a7e8d
100331.8,5.0,92,3,4,1,8,0xb2d087de
422158.43,2.0,14,4,3,3,10,0xb2d10ffb
0.54,1.0,2,1,2,4,7,0xb2d43bb3
577000.0,14.0,8,4,4,3,11,0xb2d0d7acd
4483.69,1.0,10,2,2,3,7,0xb2d91a05d
3003.12,1.0,13,2,2,3,7,0xb2d5bc1b
246603.78,2.0,89,3,3,1,7,0xb2d20b4d
76602.5,1.0,16,3,2,2,7,0xb2d2f3dfd
1100003.37,7.0,18,4,4,2,10,0xb2d5e3c5
48811.62,1.0,184,2,2,1,5,0xb2d1224b
8580.45,1.0,12,2,2,3,7,0xb2d95f15
150003.69,3.0,66,3,4,2,9,0xb2d8c5fbd
2022.21,1.0,92,1,2,1,4,0xb2d0e210d
110039.0,2.0,18,3,3,2,8,0xb2d4eaa1
2398838.39,1.0,1,4,2,4,10,0xb2d64c98d
2146047.04,18.0,0,4,4,4,12,0x3b9adea1
52.97,1.0,12,1,2,3,6,0xb2d6b685
51637.37,2.0,168,2,3,1,6,0xb2d5bf8a
4990.4,1.0,0,2,2,4,8,0xb2d6af1fd
304473.05,3.0,80,4,4,1,9,0xb2d529b5d
40369.0,1.0,19,2,2,2,6,0xb2d53465d
500000.0,2.0,11,4,3,3,10,0xb2d9674b
16107.34,1.0,7,2,2,3,7,0xb2d5e15d
572027.06,3.0,33,4,4,2,10,0xb2d16940
200000.0,2.0,1,3,3,4,10,0xb2d9834e
13.84,1.0,1,1,2,4,7,0xb2d8eac8
257018.41,2.0,17,3,3,2,8,0xb2d63933
31.04,1.0,13,1,2,3,6,0xb2d0c447
21835.71,1.0,0,2,2,4,8,0xb2d6aa27d
465674.39,11.0,6,4,4,3,11,0xb2d1f4fcd
130004.12,2.0,108,3,3,1,7,0xb2d78dde
300071.25,3.0,133,3,4,1,8,0xb2d5aaa3
3503.79,1.0,21,2,2,2,6,0xb2d6de94
5133.62,1.0,8,2,2,3,7,0xb2d68eb6
15233.49,2.0,29,2,3,2,7,0xb2d2c186
6411.01,1.0,0,2,2,4,8,0xb2d5893ed
61102.01,1.0,0,3,2,4,9,0xb2d34d6d
1526.31,1.0,5,1,2,3,6,0xb2d6e646d
276070.61,2.0,13,3,3,3,9,0xb2d24c10d
158411.46,1.0,0,3,2,4,9,0xb2d4c059
250052.28,2.0,6,3,3,3,9,0xb2d91cee
6740.75,1.0,170,2,2,1,5,0xb2d6ba3e
1526000.0,30.0,0,4,4,4,12,0xb2d2a5f7d
6474.85,1.0,13,2,2,3,7,0xb2d6c4ac
50003.03,3.0,10,2,4,3,9,0xb2d61a1ed
742606.49,4.0,5,4,4,3,11,0xb2d68cbcd
180084.99,4.0,5,3,4,3,10,0xb2d64e80
4174.16,1.0,184,2,2,1,5,0xb2d1af34d
11.73,1.0,89,1,2,1,4,0xb2d62559
70000.84,5.0,0,3,4,4,11,0xb2d53e00
15.2,1.0,10,1,2,3,6,0xb2d2e186d
1119.47,1.0,1,1,2,4,7,0xb2d32c15
497186.99,4.0,0,4,4,4,12,0xb2d4ead6
54485.67,2.0,11,3,3,3,9,0xb2d378d0d
5.44,1.0,10,1,2,3,6,0xb2d9623a
50002.11,2.0,14,2,3,3,8,0xb2da176e
1092371.81,3.0,7,4,4,3,11,0xb2d9ed31
2159.89,1.0,0,1,2,4,7,0xb2d23d8e
792.15,1.0,70,1,2,1,4,0xb2d626ddd
370003.24,3.0,116,4,4,1,9,0xb2d568b9
200008.04,2.0,0,3,3,4,10,0xb2d12063
601055.49,3.0,19,4,4,2,10,0xb2d8d045
2886.57,1.0,1,1,2,4,7,0xb2d8c82c
210746.05,2.0,54,3,3,2,8,0xb2d9ce1a
5001720.28,1.0,0,4,2,4,10,0xb2d7007f
19951.89,1.0,18,2,2,2,6,0xb2d376cf
50004.78,2.0,266,2,3,1,6,0xb2d5ef7a
11325.21,1.0,184,2,2,1,5,0xb2d2835e
71472.3,1.0,2,3,2,4,9,0xb2d37136
10000.0,2.0,92,2,3,1,6,0xb2d5c1e2d
150003.17,2.0,1,3,3,4,10,0xb2d944cdd
6127.81,1.0,82,2,2,1,5,0xb2d256d3
5.58,1.0,60,1,2,2,5,0xb2d5d2dcd
42206.59,3.0,63,2,4,2,8,0xb2d6c615
200006.11,5.0,18,3,4,2,9,0xb2d53cc8
307357.3,4.0,52,4,4,2,10,0xb2d15c1ed
0.0,1.0,5,1,2,3,6,0xb2d696b0
10.03,1.0,28,1,2,2,5,0xb2d4877d
0.0,2.0,83,1,3,1,5,0xb2d97727d
202512.62,3.0,118,3,4,1,8,0xb2d6be3c
1219.77,1.0,92,1,2,1,4,0xb2d0b9a0
473084.69,3.0,0,4,4,4,12,0xb2d91f16d
1861651.68,6.0,104,4,4,1,9,0xb2d2c838
783.89,1.0,0,1,2,4,7,0xb2d6bd0e
490081.09,2.0,6,4,3,3,10,0xb2d8ef6e
311359.4,3.0,12,4,4,3,11,0xb2d0d275d
158200.0,2.0,0,3,3,4,10,0xb2d2d211d
243251.55,7.0,25,3,4,2,9,0xb2d55e32d
8981.2,1.0,15,2,2,3,7,0xb2d6a03e
4887.05,1.0,15,2,2,3,7,0xb2d9b444
145001.53,2.0,59,3,3,2,8,0xb2d8ff45
50449.76,2.0,83,2,3,1,6,0xb2d3a8c5d
4550.44,1.0,53,2,2,2,6,0xb2d56e94
630573.77,4.0,25,4,4,2,10,0xb2d1c3a9d
52863.49,1.0,267,3,2,1,6,0xb2d534c3
200000.0,1.0,4,3,2,4,9,0xb2da6223
83775.74,1.0,2,3,2,4,9,0xb2d769e3d
34593.62,1.0,203,2,2,1,5,0xb2d4543d
1204.75,1.0,92,1,2,1,4,0xb2d0e4c5d
0.68,1.0,0,1,2,4,7,0xb2d0d517d
90006.83,2.0,171,3,3,1,7,0xb2d4683f
5087.08,1.0,0,2,2,4,8,0xb2d386a9d
2568.38,1.0,10,1,2,3,6,0xb2d22fff
540.73,1.0,15,1,2,3,6,0xb2d29f1d
90248.03,1.0,0,3,2,4,9,0xb2d77372d
30.9,1.0,124,1,2,1,4,0xb2d59eb1d
427781.54,5.0,0,4,4,4,12,0xb2d304c2
3074.59,1.0,10,2,2,3,7,0xb2d949f1
8056.99,1.0,10,2,2,3,7,0xb2d33c66
254638.24,4.0,1,3,4,4,11,0xb2d0761a
100170.48,2.0,101,3,3,1,7,0xb2d25fc9
10338.61,1.0,6,2,2,3,7,0xb2d6c287
14.92,1.0,0,1,2,4,7,0xb2d6b8c9
200000.0,2.0,27,3,3,2,8,0xb2da1102
29614.39,1.0,0,2,2,4,8,0xb2d2444e
602910.9,3.0,0,4,4,4,12,0xb2d7b15ed
184.27,1.0,119,1,2,1,4,0xb2d781fb
565003.96,13.0,12,4,4,3,11,0xb2d5fb70
81031.19,2.0,122,3,3,1,7,0xb2d6699b
473247.86,3.0,17,4,4,2,10,0xb2d17fc2d
50000.0,1.0,2,2,2,4,8,0xb2d96dd0d
116069.08,3.0,14,3,4,3,10,0xb2d572f5
716.36,1.0,10,1,2,3,6,0xb2d5d53fd
2.14,1.0,26,1,2,2,5,0xb2d755f4
286303.53,6.0,83,3,4,1,8,0xb2d3aded
163010.14,3.0,74,3,4,1,8,0xb2d1d906
530.95,1.0,25,1,2,2,5,0xb2d3018bd
250000.0,2.0,13,3,3,3,9,0xb2da3fa2
1000021.17,3.0,97,4,4,1,9,0xb2d68abcd
109002.3,2.0,92,3,3,1,7,0xb2d62fa5
2110.67,1.0,184,1,2,1,4,0xb2d26dee
200930.43,2.0,2,3,3,4,10,0xb2d20b25
36820.77,3.0,6,2,4,3,9,0xb2d25252
19262.51,1.0,18,2,2,2,6,0xb2d27c47
15490.71,1.0,1,2,2,4,8,0xb2d6249f
9.24,1.0,14,1,2,3,6,0xb2d303cf
195305.48,2.0,119,3,3,1,7,0xb2d63771d
106.26,1.0,10,1,2,3,6,0xb2d90637
417237.38,4.0,8,4,4,3,11,0xb2d32488
422274.56,3.0,23,4,4,2,10,0xb2d9a436
8366.28,1.0,9,2,2,3,7,0xb2d28e27
13721.35,1.0,14,2,2,3,7,0xb2d3662c
2055094.26,12.0,1,4,4,4,12,0xb2d2ff1e
6333.35,1.0,25,2,2,2,6,0xb2d6c4aed
1800025.84,7.0,0,4,4,4,12,0xb2d907ecd
4.11,1.0,90,1,2,1,4,0xb2d26e74
525007.44,4.0,3,4,4,4,12,0xb2d88af6
50003.17,2.0,32,2,3,2,7,0xb2d96b73
44.77,1.0,26,1,2,2,5,0xb2d2d50c
29771.95,1.0,167,2,2,1,5,0xb2d684c6d
6185.41,1.0,20,2,2,2,6,0xb2d38c92
14211.29,1.0,9,2,2,3,7,0xb2d20985
579802.28,1.0,1,4,2,4,10,0xb2d217bcd
9837.27,1.0,169,2,2,1,5,0xb2d56c2e
3781.18,1.0,5,2,2,3,7,0xb2d4548ed
0.0,1.0,1,1,2,4,7,0xb2d370a2d
301065.63,2.0,40,4,3,2,9,0xb2d929a3
5145.19,1.0,8,2,2,3,7,0xb2d9c482
700600.0,4.0,0,4,4,4,12,0xb2d220b0
871.77,1.0,0,1,2,4,7,0xb2d43936
1914.85,1.0,184,1,2,1,4,0xb2d08cc6
400000.04,3.0,2,4,4,4,12,0xb2d6babc
180174.68,2.0,92,3,3,1,7,0xb2d16ef4
10062.44,1.0,184,2,2,1,5,0xb2d476e6d
3264.34,1.0,187,2,2,1,5,0xb2d132c1
3421.18,1.0,41,2,2,2,6,0xb2d48669
955165.26,2.0,5,4,3,3,10,0xb2d68502d
500308.92,4.0,14,4,4,3,11,0xb2d3b6d7
65237.88,3.0,48,3,4,2,9,0xb2d286ad
383.57,1.0,3,1,2,4,7,0xb2d5d52f
14.79,1.0,70,1,2,1,4,0xb2d32420
6.58,2.0,78,1,3,1,5,0x3b9b3b55
2135461.17,5.0,4,4,4,4,12,0xb2d0cbd1
200552.38,2.0,0,3,3,4,10,0xb2d6ddcd
168406.27,6.0,1,3,4,4,11,0xb2d65a34
112364.17,2.0,235,3,3,1,7,0xb2d23b23
330086.16,4.0,83,4,4,1,9,0xb2d458f6
750072.73,6.0,3,4,4,4,12,0xb2d23ef6
669102.77,9.0,41,4,4,2,10,0xb2d28b11
402673.17,3.0,1,4,4,4,12,0xb2d6840d
50000.0,2.0,4,2,3,4,9,0xb2da53f1
3724.6,1.0,0,2,2,4,8,0xb2d1bdf5d
1022.46,1.0,92,1,2,1,4,0xb2d5318b
4.75,2.0,27,1,3,2,6,0xb2d1f560
2587.99,1.0,92,1,2,1,4,0xb2d440d9
975.93,1.0,10,1,2,3,6,0xb2d30765
31232.57,1.0,8,2,2,3,7,0xb2d6f206
400007.06,3.0,12,4,4,3,11,0xb2d4e6f5
475297.18,4.0,14,4,4,3,11,0xb2d2d578d
2260365.51,4.0,182,4,4,1,9,0xb2d25181
9231.67,2.0,2,2,3,4,9,0x3b9b0f57
74.73,1.0,71,1,2,1,4,0xb2d17917
3069.34,1.0,184,2,2,1,5,0xb2d2d8b5
1382908.65,2.0,0,4,3,4,11,0xb2d33229
104090.52,2.0,249,3,3,1,7,0xb2d248e2d
90001.9,2.0,94,3,3,1,7,0xb2d88067d
3314.65,1.0,5,2,2,3,7,0xb2d1d14d
13781.55,1.0,0,2,2,4,8,0xb2d3476e
53243.31,2.0,18,3,3,2,8,0xb2d29f5a
510332.1,18.0,3,4,4,4,12,0xb2d8d3d5
38.86,1.0,42,1,2,2,5,0xb2d56cedd
807.06,1.0,32,1,2,2,5,0xb2d945c2d
220002.31,3.0,67,3,4,1,8,0xb2d652fa
9251.1,1.0,4,2,2,4,8,0xb2d5cf81
271.4,1.0,0,1,2,4,7,0xb2d7841a
502029.94,3.0,11,4,4,3,11,0xb2d50c20
1281.5,1.0,184,1,2,1,4,0xb2d17ed5d
1313668.62,13.0,0,4,4,4,12,0xb2d186f1
552635.37,5.0,19,4,4,2,10,0xb2d573b8
12009.1,1.0,23,2,2,2,6,0xb2d132eb
114716.29,3.0,242,3,4,1,8,0x3b9b28c3d
3236.51,1.0,184,2,2,1,5,0xb2d2ef75
2122736.04,5.0,0,4,4,4,12,0x3b9b186b
500000.24,2.0,18,4,3,2,9,0xb2d7af25
6000.55,1.0,46,2,2,2,6,0xb2d1ed93
514.3,1.0,1,1,2,4,7,0xb2d329a1
125.46,1.0,10,1,2,3,6,0xb2d35380
91952.43,3.0,195,3,4,1,8,0xb2d06632
1045.49,1.0,0,1,2,4,7,0xb2d7a85e
1936.53,1.0,6,1,2,3,6,0xb2d2fa62d
1162.81,1.0,92,1,2,1,4,0xb2d26a92
0.72,1.0,18,1,2,2,5,0xb2d5bd99
667.3,2.0,0,1,3,4,8,0xb2d0a1eb
481159.63,5.0,0,4,4,4,12,0xb2d56de9
484134.81,4.0,10,4,4,3,11,0xb2d2a07b
179294.86,4.0,95,3,4,1,8,0xb2d4a5a6
10873.48,1.0,10,2,2,3,7,0xb2d305e9d
573.61,1.0,112,1,2,1,4,0xb2d1f1ab
400064.89,5.0,34,4,4,2,10,0xb2d13f62d
38.08,1.0,6,1,2,3,6,0xb2d90829
10069.84,1.0,5,2,2,3,7,0xb2d98a98
5545.1,1.0,184,2,2,1,5,0xb2d345ce
73984.72,1.0,184,3,2,1,6,0xb2d20760
5738.73,1.0,8,2,2,3,7,0xb2d6c5d6
50113.56,2.0,12,2,3,3,8,0xb2d554c0
215176.48,4.0,0,3,4,4,11,0xb2d29bf2d
230693.78,3.0,0,3,4,4,11,0xb2d1b962d
11751.3,1.0,0,2,2,4,8,0xb2da088f
775.16,1.0,20,1,2,2,5,0xb2d2e185
701602.22,4.0,22,4,4,2,10,0xb2d42233
202606.43,4.0,20,3,4,2,9,0xb2d405c3
1218.98,1.0,184,1,2,1,4,0xb2d0d939
572.47,1.0,10,1,2,3,6,0xb2d929ad
458281.98,4.0,4,4,4,4,12,0xb2d16f8a
200039.99,7.0,0,3,4,4,11,0xb2d61fad
216.9,1.0,19,1,2,2,5,0xb2d5efae
40041.82,3.0,69,2,4,1,7,0xb2d62a60d
60578.82,1.0,281,3,2,1,6,0xb2d64760
18851.82,1.0,0,2,2,4,8,0xb2d6bb61
15540.11,2.0,184,2,3,1,6,0xb2d39023
477396.06,2.0,33,4,3,2,9,0xb2d16a6d
73811.65,2.0,92,3,3,1,7,0xb2d62e55
1.24,1.0,20,1,2,2,5,0xb2d94c65
400200.7,3.0,121,4,4,1,9,0xb2d76a9d
1251000.0,3.0,0,4,4,4,12,0xb2d236b6
203162.92,5.0,2,3,4,4,11,0xb2d11135
7470.23,1.0,146,2,2,1,5,0xb2d67db5d
1002.03,1.0,68,1,2,1,4,0xb2d8df87
187001.48,9.0,6,3,4,3,10,0xb2d64891d
1000152.64,2.0,76,4,3,1,8,0xb2d3668bd
35000000.0,1.0,0,4,2,4,10,0xb2d079cd
30588.14,1.0,0,2,2,4,8,0xb2d90d94d
341000.33,12.0,3,4,4,4,12,0xb2d62483
78.34,1.0,8,1,2,3,6,0xb2d1eeaf
201425.27,2.0,67,3,3,1,7,0xb2d9ad30
4702.73,1.0,0,2,2,4,8,0xb2d61c4c
0.75,1.0,1,1,2,4,7,0xb2d313e7d
600143.16,3.0,8,4,4,3,11,0xb2d19b6a
86324.22,1.0,0,3,2,4,9,0xb2d0d5c5
1161.86,1.0,20,1,2,2,5,0x3b9b49ab
7838.53,1.0,0,2,2,4,8,0xb2d6b507
5024.95,1.0,17,2,2,2,6,0xb2d693e1
0.63,2.0,14,1,3,3,7,0xb2d6d041
500165.05,5.0,34,4,4,2,10,0xb2d3ecb6
6845.38,1.0,3,2,2,4,8,0xb2d457d4d
325689.26,2.0,153,4,3,1,8,0xb2d6debd
100622.41,3.0,26,3,4,2,9,0xb2d0f4de
1239.59,1.0,63,1,2,2,5,0xb2d3bcc6d
1028.13,2.0,68,1,3,1,5,0xb2d45bbc
7739.97,1.0,184,2,2,1,5,0xb2d2fab6d
402.95,1.0,17,1,2,2,5,0xb2d5c44bd
603553.51,4.0,5,4,4,3,11,0xb2d2c90ad
535413.84,2.0,87,4,3,1,8,0xb2d40297
45476.48,1.0,0,2,2,4,8,0xb2d54f38
14525.3,1.0,0,2,2,4,8,0xb2d32775
258112.28,3.0,14,3,4,3,10,0xb2d61758
966.76,1.0,0,1,2,4,7,0xb2d6544a
13807.13,1.0,20,2,2,2,6,0xb2d642b2d
10172.7,2.0,160,2,3,1,6,0xb2d5d41a
334.18,1.0,9,1,2,3,6,0xb2d4a5a5
2293.01,1.0,106,1,2,1,4,0xb2d8c61f
272.81,1.0,13,1,2,3,6,0xb2d4ade7
8.64,1.0,252,1,2,1,4,0xb2d283df
126482.36,1.0,9,3,2,3,8,0xb2d42071d
62673.68,2.0,11,3,3,3,9,0xb2d5b841
100466.11,2.0,67,3,3,1,7,0xb2d6085ad
768.73,1.0,0,1,2,4,7,0xb2d69513
30304.2,2.0,24,2,3,2,7,0xb2d69c7c
38688.74,1.0,9,2,2,3,7,0xb2d36b35
2.51,1.0,32,1,2,2,5,0xb2d8dcd0
7684.9,1.0,20,2,2,2,6,0xb2d60a88d
201007.44,3.0,130,3,4,1,8,0xb2d90268d
240003.49,3.0,13,3,4,3,10,0xb2d439d7
4.33,1.0,1,1,2,4,7,0xb2d8d2d7
20285.11,1.0,7,2,2,3,7,0xb2d964d9
496041.31,9.0,0,4,4,4,12,0xb2d132a8d
800.29,1.0,0,1,2,4,7,0xb2d93c41
4696.51,1.0,6,2,2,3,7,0xb2d2af3d
703616.84,4.0,37,4,4,2,10,0xb2d4336cd
4277.8,1.0,34,2,2,2,6,0xb2d5dcfc
225740.62,2.0,83,3,3,1,7,0xb2d41aac
1719711.38,6.0,11,4,4,3,11,0x3b9b4929d
454.64,1.0,10,1,2,3,6,0xb2d6f414
402.57,1.0,10,1,2,3,6,0xb2d24d9c
229239.12,4.0,73,3,4,1,8,0xb2d10fcd
1278.16,1.0,0,1,2,4,7,0xb2d5beae
50008.8,2.0,108,2,3,1,6,0xb2d4c1dfd
796.18,1.0,0,1,2,4,7,0xb2d790b2
60.98,1.0,4,1,2,4,7,0xb2d21785
330000.0,7.0,5,4,4,3,11,0xb2d30fc9
50876.3,1.0,6,2,2,3,7,0xb2d60d99d
57954.11,1.0,3,3,2,4,9,0xb2d2e38a
8055.14,1.0,0,2,2,4,8,0xb2d6b8f4d
460101.89,3.0,111,4,4,1,9,0xb2d10540d
0.0,1.0,0,1,2,4,7,0xb2d96048
374173.09,4.0,74,4,4,1,9,0xb2d22b6fd
706100.0,17.0,0,4,4,4,12,0xb2d221d9
1070.68,2.0,0,1,3,4,8,0xb2d06581
46669.54,1.0,139,2,2,1,5,0xb2d40fbcd
110002.14,2.0,74,3,3,1,7,0xb2d61c65
456042.01,10.0,0,4,4,4,12,0xb2d3bc52
466428.46,14.0,4,4,4,4,12,0xb2d1342cd
706.64,1.0,1,1,2,4,7,0xb2d625b0
1561.22,1.0,23,1,2,2,5,0xb2d325f4
70014.07,3.0,102,3,4,1,8,0xb2d2cd4b
51940.77,1.0,40,2,2,2,6,0xb2d55f90
574.79,1.0,6,1,2,3,6,0xb2d2a89e
100005.28,2.0,56,3,3,2,8,0xb2d9c059
402841.43,3.0,4,4,4,4,12,0xb2d7442cd
202426.41,3.0,110,3,4,1,8,0xb2d62e31
1129.83,1.0,184,1,2,1,4,0xb2d39a55
210072.64,3.0,3,3,4,4,11,0xb2d2d955
18.92,1.0,9,1,2,3,6,0xb2d1c493
246214.51,3.0,6,3,4,3,10,0xb2d4f795d
15.84,1.0,41,1,2,2,5,0xb2d9a4d1
75.98,1.0,7,1,2,3,6,0xb2d3e1c5
20043.55,2.0,17,2,3,2,7,0xb2d09159
3.1,1.0,24,1,2,2,5,0xb2d143c0
1001.16,1.0,120,1,2,1,4,0xb2d919f5
500806.89,3.0,69,4,4,1,9,0xb2d59bbcd
520016.47,2.0,92,4,3,1,8,0xb2d97cc7
14.23,1.0,124,1,2,1,4,0xb2d169b7
337264.82,8.0,14,4,4,3,11,0xb2d225cf
150937.65,3.0,0,3,4,4,11,0xb2d3533c
460010.13,5.0,25,4,4,2,10,0xb2d5cb63
380451.61,2.0,80,4,3,1,8,0xb2d3052f
40597.8,5.0,13,2,4,3,9,0xb2d70047d
4344.34,1.0,139,2,2,1,5,0xb2d33530
814300.82,3.0,18,4,4,2,10,0xb2d62ff1d
1001313.8,1.0,4,4,2,4,10,0xb2d4091c
992.75,1.0,116,1,2,1,4,0xb2d239bad
52398.98,2.0,245,3,3,1,7,0xb2d2f49a
10000.53,2.0,48,2,3,2,7,0xb2d9d4e7
674.67,1.0,1,1,2,4,7,0xb2d6c072
110145.74,2.0,129,3,3,1,7,0xb2d2ba33
4318.35,1.0,0,2,2,4,8,0xb2d6b5a1
8.44,1.0,167,1,2,1,4,0xb2d53ccf
130221.17,3.0,14,3,4,3,10,0xb2d562b1d
308029.05,7.0,31,4,4,2,10,0x3b9b34f4d
48.92,1.0,11,1,2,3,6,0xb2d36c21
6212.72,1.0,4,2,2,4,8,0xb2d30c2f
350236.47,3.0,56,4,4,2,10,0xb2d5796bd
50000.53,2.0,92,2,3,1,6,0xb2d6420d
96022.4,2.0,48,3,3,2,8,0xb2d9bcff
4050050.63,8.0,20,4,4,2,10,0x3b9b2a27
48764.78,1.0,92,2,2,1,5,0xb2d1224bd
70476.12,2.0,2,3,3,4,10,0xb2d584dad
16334.09,1.0,0,2,2,4,8,0xb2d43399
474166.94,3.0,0,4,4,4,12,0xb2d6059ed
1031.51,4.0,92,1,4,1,6,0xb2d254b9
236053.83,3.0,11,3,4,3,10,0xb2d5d954d
0.0,1.0,11,1,2,3,6,0xb2d3a154
666440.78,2.0,0,4,3,4,11,0xb2d5b4fa
8266.75,1.0,21,2,2,2,6,0xb2da1640
4095.26,1.0,184,2,2,1,5,0xb2d33503
623.24,1.0,8,1,2,3,6,0xb2d967e2
1000013.3,2.0,25,4,3,2,9,0xb2da14fe
921539.2,2.0,28,4,3,2,9,0xb2d9e7db
750012.38,5.0,4,4,4,4,12,0xb2d690ce
27.3,1.0,82,1,2,1,4,0xb2d2de52
39076.15,1.0,92,2,2,1,5,0xb2d1b51b
300010.03,2.0,11,3,3,3,9,0xb2da22d9
150074.02,3.0,6,3,4,3,10,0xb2d5f333
764.01,1.0,1,1,2,4,7,0xb2d4963e
251093.15,2.0,11,3,3,3,9,0xb2d6095e
729.21,1.0,77,1,2,1,4,0xb2d0f30a
0.0,1.0,101,1,2,1,4,0xb2d629ff
200049.0,2.0,14,3,3,3,9,0xb2d59193d
6.98,1.0,60,1,2,2,5,0xb2d38dad
342771.32,6.0,0,4,4,4,12,0xb2d56437
306.13,3.0,1,1,4,4,9,0x3b9af1ed
351286.68,2.0,54,4,3,2,9,0xb2d1c4ee
1255.94,1.0,11,1,2,3,6,0xb2d92f13
380249.58,2.0,0,4,3,4,11,0xb2d598e1
330034.46,3.0,157,4,4,1,9,0xb2d17bf4
20472.88,2.0,80,2,3,1,6,0xb2d5a913
2514785.73,4.0,37,4,4,2,10,0xb2d0d2bc
51590.37,2.0,8,2,3,3,8,0xb2d64a55
502406.59,2.0,37,4,3,2,9,0xb2d70050d
1001.74,1.0,133,1,2,1,4,0xb2d64e01d
16313.91,1.0,184,2,2,1,5,0xb2d0f8c4d
133087.18,4.0,74,3,4,1,8,0xb2d372fe
4624.87,1.0,10,2,2,3,7,0xb2d6f05bd
23530.64,1.0,70,2,2,1,5,0xb2d41c92
2263.42,1.0,1,1,2,4,7,0xb2d27748d
100001.47,3.0,32,3,4,2,9,0xb2d99343
1457.06,1.0,22,1,2,2,5,0xb2d4f6ca
4572.97,1.0,6,2,2,3,7,0xb2d3bca4
10004.46,2.0,92,2,3,1,6,0xb2d576ed
268707.75,3.0,4,3,4,4,11,0xb2d37f3f
2513.62,1.0,0,1,2,4,7,0xb2d69a48
200804.94,2.0,28,3,3,2,8,0xb2d6499a
11515.61,1.0,0,2,2,4,8,0xb2d31564
61141.86,2.0,26,3,3,2,8,0xb2d636db
1197863.61,8.0,64,4,4,2,10,0xb2d2c719
20380.9,2.0,3,2,3,4,9,0xb2d1ee88d
367.87,1.0,76,1,2,1,4,0xb2d63d29
86.6,3.0,77,1,4,1,6,0xb2d223be
280295.56,3.0,19,3,4,2,9,0xb2d69939d
789903.59,7.0,41,4,4,2,10,0xb2d0bc3f
200547.62,4.0,0,3,4,4,11,0xb2d7f421
226832.73,7.0,0,3,4,4,11,0x3b9b18f2
2.2,1.0,23,1,2,2,5,0xb2d392a6
214388.49,2.0,22,3,3,2,8,0xb2d501ac
829674.9,7.0,4,4,4,4,12,0xb2d15e86d
200000.0,2.0,0,3,3,4,10,0xb2d227da
200004.54,3.0,20,3,4,2,9,0xb2da1a51
1351100.67,6.0,1,4,4,4,12,0xb2d67d21
896156.49,1.0,95,4,2,1,7,0x3b9b1882d
4.12,1.0,60,1,2,2,5,0xb2d9baf4
4150.72,1.0,92,2,2,1,5,0xb2d58d20
260443.13,4.0,52,3,4,2,9,0xb2d6e5e4
100000.0,2.0,8,3,3,3,9,0xb2d1c41c
208.29,1.0,44,1,2,2,5,0xb2d66597
1762260.68,7.0,64,4,4,2,10,0xb2d0e07cd
110018.45,2.0,213,3,3,1,7,0xb2d29138d
744830.38,6.0,83,4,4,1,9,0xb2d22a55d
500028.23,2.0,14,4,3,3,10,0xb2d95fc0
141960.94,4.0,87,3,4,1,8,0xb2d24a72d
34035.51,1.0,46,2,2,2,6,0xb2d252c4d
50001.24,4.0,4,2,4,4,10,0xb2d5c247d
68.41,1.0,10,1,2,3,6,0xb2d9aae7
1420233.93,6.0,4,4,4,4,12,0xb2d6fdae
200002.11,2.0,62,3,3,2,8,0xb2d8f74a
220009.12,4.0,42,3,4,2,9,0xb2d13902
148052.74,3.0,6,3,4,3,10,0xb2d23978
333921.31,4.0,184,4,4,1,9,0xb2d44601
57029.09,2.0,0,3,3,4,10,0xb2d5e8e5d
430794.73,1.0,28,4,2,2,8,0xb2d31f8a
1941.63,1.0,2,1,2,4,7,0xb2d4891a
219958.7,5.0,0,3,4,4,11,0xb2d06a80
102004.31,2.0,92,3,3,1,7,0xb2d65e74
1050022.41,4.0,21,4,4,2,10,0xb2d69883
358710.69,2.0,129,4,3,1,8,0xb2d72536
382225.8,10.0,3,4,4,4,12,0xb2d3b6c0
101.99,1.0,6,1,2,3,6,0xb2d29729
10000.11,2.0,182,2,3,1,6,0xb2d8a8e8
436000.0,7.0,0,4,4,4,12,0xb2d0b489
30887.11,2.0,59,2,3,2,7,0xb2d968fb
3177.55,1.0,25,2,2,2,6,0xb2d61bf6d
65034.43,2.0,97,3,3,1,7,0xb2d81ed8d
1814.17,1.0,9,1,2,3,6,0xb2d2e315
11616.48,1.0,0,2,2,4,8,0xb2d6af18
565.48,3.0,3,1,4,4,9,0xb2d315a8
564.29,1.0,35,1,2,2,5,0xb2d910e9d
24.52,1.0,19,1,2,2,5,0xb2d37936
371.33,2.0,19,1,3,2,6,0x3b9b333c
139.33,1.0,47,1,2,2,5,0xb2d95128
73.69,1.0,80,1,2,1,4,0xb2d5a9ef
264853.21,3.0,59,3,4,2,9,0xb2d676ac
75460.57,6.0,12,3,4,3,10,0xb2d5a0dd
79002.07,2.0,6,3,3,3,9,0xb2d305d4
1118939.61,8.0,46,4,4,2,10,0xb2d59760
220008.58,2.0,235,3,3,1,7,0xb2d4b65cd
9029.96,1.0,184,2,2,1,5,0xb2d52c59d
430826.24,3.0,81,4,4,1,9,0xb2d63762
2753.65,1.0,25,1,2,2,5,0xb2d9398b
0.34,2.0,70,1,3,1,5,0xb2d6fd66
25.8,1.0,34,1,2,2,5,0xb2d94318
5468.42,1.0,92,2,2,1,5,0xb2d41902
700088.6,3.0,28,4,4,2,10,0xb2d43365d
89578.13,1.0,184,3,2,1,6,0xb2d3c242
1910020.16,2.0,18,4,3,2,9,0xb2d953c2d
2.13,1.0,19,1,2,2,5,0xb2d79082
1570112.14,5.0,0,4,4,4,12,0xb2d93d67
200000.0,2.0,1,3,3,4,10,0xb2d98182d
394517.08,6.0,92,4,4,1,9,0xb2d08489
560785.02,6.0,4,4,4,4,12,0xb2d35b30d
461032.42,2.0,130,4,3,1,8,0xb2d6dd7c
221421.98,4.0,69,3,4,1,8,0xb2d973ac
70000.74,2.0,10,3,3,3,9,0xb2d96980
3232.33,1.0,92,2,2,1,5,0xb2d1f9c1d
345.62,4.0,3,1,4,4,9,0x3b9b3b1e
70.36,1.0,0,1,2,4,7,0xb2d6f5e3
8524.51,1.0,1,2,2,4,8,0xb2d8ea15d
8689.02,1.0,0,2,2,4,8,0xb2d170b9
330206.48,4.0,17,4,4,2,10,0xb2d6366a
1.15,1.0,14,1,2,3,6,0xb2d78daed
808.96,1.0,15,1,2,3,6,0xb2d88cd1
200072.89,2.0,1,3,3,4,10,0xb2d65313d
2970.05,1.0,4,2,2,4,8,0xb2d94542
134485.94,2.0,92,3,3,1,7,0xb2d5a813
29.08,1.0,41,1,2,2,5,0xb2d369bf
674327.41,8.0,1,4,4,4,12,0xb2d39abb
340008.76,17.0,14,4,4,3,11,0xb2d0c37d
1846167.41,4.0,26,4,4,2,10,0xb2d32722d
401446.93,3.0,5,4,4,3,11,0xb2d683e4
42715.51,1.0,49,2,2,2,6,0xb2d37cae
604715.52,3.0,31,4,4,2,10,0xb2d6f0f3
202842.83,2.0,123,3,3,1,7,0xb2d93ef4
5653.99,1.0,184,2,2,1,5,0xb2d275be
570000.63,8.0,0,4,4,4,12,0xb2d15604
537159.56,3.0,0,4,4,4,12,0xb2d50b4f
111095.98,6.0,11,3,4,3,10,0xb2d5e705
500032.69,2.0,8,4,3,3,10,0xb2d703ef
42926.66,3.0,0,2,4,4,10,0x3b9b36b0
236151.95,5.0,97,3,4,1,8,0xb2d428b9
4.96,1.0,39,1,2,2,5,0xb2d5f4b9d
104008.65,3.0,160,3,4,1,8,0x3b9b1b92
1655.6,2.0,92,1,3,1,5,0xb2d18ac4
577026.98,8.0,13,4,4,3,11,0xb2d4eb65
6.03,1.0,166,1,2,1,4,0xb2d8dd8a
2608.68,1.0,184,1,2,1,4,0xb2d40e58
51689.0,1.0,7,2,2,3,7,0xb2d621a7
23635.35,1.0,184,2,2,1,5,0xb2d30f64
0.31,2.0,9,1,3,3,7,0xb2d0b4dd
315281.81,9.0,6,4,4,3,11,0xb2d225cfd
112646.5,2.0,24,3,3,2,8,0x3b9b4a15
101004.01,6.0,1,3,4,4,11,0xb2d5699e
20061.07,1.0,92,2,2,1,5,0xb2d45870
641.28,1.0,0,1,2,4,7,0xb2d2b360
1845000.74,3.0,43,4,4,2,10,0xb2d37902
4426035.49,6.0,59,4,4,2,10,0xb2d0a1bd
9709698.26,2.0,17,4,3,2,9,0xb2d9ac85
830000.0,4.0,5,4,4,3,11,0xb2d354fbd
515806.54,3.0,0,4,4,4,12,0xb2d1a20f
280071.58,9.0,0,3,4,4,11,0xb2d12a23
100012.79,2.0,202,3,3,1,7,0xb2d6cde2
440841.15,12.0,0,4,4,4,12,0x3b9af12a
304634.7,2.0,77,4,3,1,8,0xb2d58f2c
20179.41,2.0,77,2,3,1,6,0xb2d65a4a
402326.39,3.0,1,4,4,4,12,0xb2d1ab29
411728.63,3.0,40,4,4,2,10,0xb2d4f4fcd
3200000.0,3.0,4,4,4,4,12,0xb2da55ec
2900049.02,14.0,18,4,4,2,10,0xb2d0c13d
458.17,1.0,6,1,2,3,6,0xb2d375d4d
292414.46,4.0,34,3,4,2,9,0xb2d1e30d
108313.46,2.0,76,3,3,1,7,0xb2d34a14
510000.29,12.0,0,4,4,4,12,0xb2d06b84
76003.62,2.0,138,3,3,1,7,0xb2d5792f
583745.72,3.0,90,4,4,1,9,0xb2d1492dd
200062.08,2.0,92,3,3,1,7,0xb2d593da
400027.88,3.0,47,4,4,2,10,0xb2d56356
21.12,1.0,81,1,2,1,4,0xb2d4c85e
56303.15,3.0,92,3,4,1,8,0xb2d1b711
304265.15,2.0,115,4,3,1,8,0xb2d90e3d
94059.84,3.0,1,3,4,4,11,0xb2d62958d
2188.75,1.0,12,1,2,3,6,0xb2d5cf80
29.4,1.0,29,1,2,2,5,0xb2d43a20
80019.16,2.0,111,3,3,1,7,0xb2d6038dd
24.59,1.0,89,1,2,1,4,0xb2d8016f
407116.8,2.0,34,4,3,2,9,0xb2d6d947
20228.24,1.0,7,2,2,3,7,0xb2d611c3d
5420.53,1.0,3,2,2,4,8,0xb2d0daf1
2781713.77,8.0,31,4,4,2,10,0x3b9b3e9ad
3255.24,1.0,5,2,2,3,7,0xb2d59ce1
2087.28,1.0,10,1,2,3,6,0xb2d6ec23d
19890.49,1.0,0,2,2,4,8,0xb2d6b7dcd
2020696.94,3.0,40,4,4,2,10,0xb2d94056
1200528.37,3.0,119,4,4,1,9,0xb2d1648dd
250007.18,3.0,60,3,4,2,9,0xb2d9b77f
6199.28,1.0,9,2,2,3,7,0xb2d37988
3456.69,1.0,3,2,2,4,8,0xb2d8f51ed
67035.22,2.0,5,3,3,3,9,0xb2d5cf2c
82188.71,1.0,1,3,2,4,9,0xb2d48e6b
1116.84,1.0,10,1,2,3,6,0xb2d75c1d
10000.32,2.0,12,2,3,3,8,0xb2d93ef2
479468.54,14.0,0,4,4,4,12,0xb2d1c8d2
1324.81,1.0,167,1,2,1,4,0xb2d5bd12
21977.38,4.0,0,2,4,4,10,0xb2d19a3d
2.38,1.0,8,1,2,3,6,0xb2d6caa7
164833.66,4.0,0,3,4,4,11,0xb2d27996
2000100.01,1.0,1,4,2,4,10,0xb2da307e
400987.69,3.0,5,4,4,3,11,0xb2d3c989
592472.49,2.0,46,4,3,2,9,0xb2d504af
3022.27,2.0,184,2,3,1,6,0xb2d3eed4
250001.18,2.0,15,3,3,3,9,0xb2d6cf79
332147.68,3.0,14,4,4,3,11,0xb2d138c1d
70853.43,3.0,90,3,4,1,8,0xb2d60405
1812.2,1.0,184,1,2,1,4,0xb2d3bff4
1.14,1.0,63,1,2,2,5,0xb2d68e66
828.03,1.0,9,1,2,3,6,0xb2d6e6f9d
300062.58,2.0,9,3,3,3,9,0xb2d92b49d
48.43,1.0,9,1,2,3,6,0xb2d62783
2.83,1.0,27,1,2,2,5,0xb2d6bae8
178860.0,1.0,5,3,2,3,8,0xb2d91fbc
1583.33,1.0,21,1,2,2,5,0xb2d68106d
1337921.66,6.0,1,4,4,4,12,0x3b9b0fd1
100000.81,2.0,149,3,3,1,7,0xb2d61634
517777.32,2.0,15,4,3,3,10,0xb2d5b0e5
11.32,1.0,31,1,2,2,5,0xb2d5fd88
48083.79,3.0,53,2,4,2,8,0xb2d91290
400008.97,2.0,25,4,3,2,9,0xb2d9f7b7
2225.6,1.0,17,1,2,2,5,0xb2d49030
540065.77,2.0,221,4,3,1,8,0xb2d5583e
6270.39,1.0,92,2,2,1,5,0xb2d29470d
10004.69,2.0,11,2,3,3,8,0xb2d68999d
579.6,1.0,0,1,2,4,7,0xb2d90be4
500014.99,2.0,20,4,3,2,9,0xb2d242ee
100001.06,2.0,66,3,3,2,8,0xb2d8f219
20000.63,2.0,32,2,3,2,7,0xb2d20e85d
24806.03,1.0,16,2,2,2,6,0xb2d27806
3010.46,1.0,92,2,2,1,5,0xb2d5c958
48109.46,2.0,0,2,3,4,9,0xb2d6dde0
21019.4,1.0,92,2,2,1,5,0xb2d3b70f
406117.78,3.0,0,4,4,4,12,0xb2d682cf
101388.3,1.0,0,3,2,4,9,0xb2d24bddd
31788.38,1.0,1,2,2,4,8,0xb2d627d4d
991282.77,6.0,41,4,4,2,10,0xb2d16560d
489586.28,7.0,32,4,4,2,10,0xb2d24fd7
10.34,1.0,33,1,2,2,5,0xb2d8c96c
150009.26,2.0,70,3,3,1,7,0xb2d6482cd
409596.97,5.0,0,4,4,4,12,0xb2d14b0f
48.76,1.0,35,1,2,2,5,0xb2d64e04
1040637.77,4.0,7,4,4,3,11,0xb2d17ed0
50002.57,2.0,136,2,3,1,6,0xb2d638de
225161.61,2.0,168,3,3,1,7,0xb2d1a632
31.67,1.0,24,1,2,2,5,0xb2d1d268
4897.35,1.0,0,2,2,4,8,0xb2d989ae
4029.94,1.0,4,2,2,4,8,0xb2d9a736
1187003.91,12.0,16,4,4,2,10,0xb2d5934e
94070.27,2.0,156,3,3,1,7,0xb2d463b2
773689.15,7.0,25,4,4,2,10,0xb2d289c8d
9200.46,1.0,8,2,2,3,7,0xb2d3a62fd
213732.28,2.0,166,3,3,1,7,0xb2d6c9af
7695.08,1.0,54,2,2,2,6,0xb2d24fa1d
171222.64,3.0,0,3,4,4,11,0x3b9af240
12355.57,1.0,2,2,2,4,8,0xb2d6a901d
98117.0,3.0,0,3,4,4,11,0xb2d56965
0.0,1.0,23,1,2,2,5,0xb2d65af6
11489.49,1.0,46,2,2,2,6,0xb2d8dba9
83036.1,3.0,196,3,4,1,8,0xb2d0f887d
101006.02,1.0,184,3,2,1,6,0xb2d069e3
62914.95,2.0,160,3,3,1,7,0xb2d26ed8
2191878.91,17.0,25,4,4,2,10,0xb2d3c5f8d
7893.3,1.0,184,2,2,1,5,0xb2d1f5ed
1000057.97,3.0,214,4,4,1,9,0xb2d21ed9
2035547.4,2.0,82,4,3,1,8,0xb2d8d87d
590006.3,5.0,77,4,4,1,9,0xb2d82422
174192.71,4.0,119,3,4,1,8,0xb2d63b77
100000.0,1.0,0,3,2,4,9,0xb2d98328
2398.17,1.0,0,1,2,4,7,0xb2d57c3b
140003.38,3.0,53,3,4,2,9,0xb2d0d49b
264085.96,3.0,12,3,4,3,10,0xb2d64b6bd
220020.29,2.0,60,3,3,2,8,0xb2d2ee3ad
60029.69,2.0,122,3,3,1,7,0xb2d563dfd
57.49,6.0,1,1,4,4,9,0xb2d12787
327671.37,13.0,11,4,4,3,11,0xb2d576a1
2.97,1.0,55,1,2,2,5,0xb2d15a8f
151383.58,3.0,19,3,4,2,9,0xb2d646ced
1318021.27,9.0,21,4,4,2,10,0x3b9b29e9
1954.13,1.0,0,1,2,4,7,0xb2d6b1e6
100042.92,1.0,50,3,2,2,7,0xb2d685f1
200012.67,2.0,0,3,3,4,10,0xb2d95b78
109934.77,2.0,259,3,3,1,7,0xb2d2a7c9d
508854.96,2.0,88,4,3,1,8,0xb2d8e916d
1867.1,1.0,92,1,2,1,4,0xb2d6539e
50000.0,2.0,4,2,3,4,9,0xb2da4d0a
522.18,1.0,0,1,2,4,7,0xb2d8ea1d
5000.0,2.0,60,2,3,2,7,0xb2d8ff5a
25247.39,2.0,1,2,3,4,9,0xb2d23974d
9549.44,1.0,146,2,2,1,5,0xb2d7913b
24101.6,1.0,3,2,2,4,8,0xb2d39195d
3560099.6,12.0,0,4,4,4,12,0xb2d1e733d
15161.05,1.0,92,2,2,1,5,0xb2d5c581
160.51,1.0,14,1,2,3,6,0xb2d0cdded
1889.99,1.0,13,1,2,3,6,0xb2d9070f
806008.2,14.0,0,4,4,4,12,0xb2d0d1d9
74.83,1.0,4,1,2,4,7,0xb2d3ecbc
305822.75,2.0,0,4,3,4,11,0xb2d0e6fe
12478.79,1.0,14,2,2,3,7,0xb2d32c35d
200011.12,2.0,147,3,3,1,7,0xb2d6e23f
1161.47,1.0,184,1,2,1,4,0xb2d3a955
88645.19,1.0,11,3,2,3,8,0xb2d20108
68543.84,1.0,161,3,2,1,6,0xb2d54984
2126.81,1.0,9,1,2,3,6,0xb2d42ef6d
155530.03,1.0,175,3,2,1,6,0xb2d51b1f
36397.37,2.0,11,2,3,3,8,0xb2d337b3
205144.52,2.0,60,3,3,2,8,0xb2d17eb3
260423.36,5.0,3,3,4,4,11,0xb2d8e67d
754234.36,3.0,56,4,4,2,10,0xb2d54e7a
10983.38,2.0,4,2,3,4,9,0xb2d12654
7.75,1.0,0,1,2,4,7,0xb2d2124d
780004.45,4.0,7,4,4,3,11,0xb2d6c983
200081.04,2.0,92,3,3,1,7,0xb2d17eb3d
770194.71,8.0,0,4,4,4,12,0xb2d5ca03
245022.17,5.0,47,3,4,2,9,0xb2d2dd53d
65.65,14.0,6,1,4,3,8,0x3b9b36cd
200710.41,3.0,7,3,4,3,10,0xb2d92e29
53427.5,1.0,28,3,2,2,7,0xb2d34151d
1920030.88,8.0,55,4,4,2,10,0xb2d1687ed
80.74,1.0,37,1,2,2,5,0xb2d5aa12
110003.48,2.0,20,3,3,2,8,0xb2d94fed
1000021.15,2.0,206,4,3,1,8,0xb2d5cd24
30051.39,1.0,18,2,2,2,6,0xb2d4c83e
33249.46,1.0,20,2,2,2,6,0xb2d32064
70000.74,2.0,45,3,3,2,8,0xb2d91b51
468.63,1.0,1,1,2,4,7,0xb2d53f34d
50000.0,16.0,1,2,4,4,10,0xb2d0866d
8669.69,2.0,92,2,3,1,6,0x3b9b15d5d
139.5,1.0,19,1,2,2,5,0xb2d4f7bcd
273471.01,4.0,7,3,4,3,10,0xb2d5501f
208960.84,1.0,1,3,2,4,9,0xb2d1845c
600061.42,4.0,1,4,4,4,12,0xb2d5fbc6d
5000.74,1.0,1,2,2,4,8,0xb2d1fd8ed
60050.3,3.0,19,3,4,2,9,0xb2d8ce95
111599.71,2.0,66,3,3,2,8,0xb2d5e7cd
230960.97,1.0,11,3,2,3,8,0xb2d25c5cd
100044.33,2.0,98,3,3,1,7,0xb2d1af6a
158.05,1.0,5,1,2,3,6,0xb2d2e067
11872.52,1.0,1,2,2,4,8,0xb2d3aacc
177.51,1.0,3,1,2,4,7,0xb2d1f250
0.7,1.0,45,1,2,2,5,0xb2d3af10
50005.11,2.0,55,2,3,2,7,0xb2d3afaa
250000.0,2.0,26,3,3,2,8,0xb2da1670
50920.77,1.0,92,2,2,1,5,0xb2d405a9
66513.42,2.0,77,3,3,1,7,0xb2d63e25d
772.1,2.0,85,1,3,1,5,0xb2d8efe5d
70002.57,3.0,92,3,4,1,8,0xb2d61b74d
50170.55,3.0,25,2,4,2,8,0xb2d068fb
140089.67,2.0,7,3,3,3,9,0xb2d93160
15592.81,1.0,14,2,2,3,7,0xb2d6e539
4001.31,1.0,10,2,2,3,7,0xb2d8cb3a
1015.57,2.0,92,1,3,1,5,0xb2d0f4e5
4271.14,1.0,0,2,2,4,8,0xb2d9d5d7
385325.83,4.0,27,4,4,2,10,0x3b9b2d2ed
300001.81,2.0,14,3,3,3,9,0xb2d997cb
7204.4,1.0,82,2,2,1,5,0xb2d967c7
113328.73,3.0,0,3,4,4,11,0xb2d4d3b0
874413.91,5.0,67,4,4,1,9,0xb2d96b96
10000.53,2.0,55,2,3,2,7,0xb2d90038d
744200.85,2.0,181,4,3,1,8,0xb2d5e624d
676000.0,11.0,0,4,4,4,12,0xb2d42b9bd
470051.17,4.0,0,4,4,4,12,0xb2d952bb
750003.53,5.0,3,4,4,4,12,0xb2d5df9c
1312.99,1.0,92,1,2,1,4,0xb2d290ded
1011.07,1.0,92,1,2,1,4,0xb2d3f811d
17300.8,1.0,21,2,2,2,6,0xb2d2b877d
256124.76,3.0,2,3,4,4,11,0xb2d58e03
32195.46,1.0,260,2,2,1,5,0xb2d30f88
1002962.5,4.0,2,4,4,4,12,0xb2d6f494
64518.43,4.0,0,3,4,4,11,0xb2d08481
1500130.93,2.0,20,4,3,2,9,0xb2d0e349d
200026.98,2.0,20,3,3,2,8,0xb2d57cfb
1697.11,1.0,7,1,2,3,6,0xb2d25139
239018.95,3.0,11,3,4,3,10,0xb2d657cf
975.45,1.0,9,1,2,3,6,0xb2d2cb5a
500017.62,2.0,11,4,3,3,10,0xb2d38a57
1699342.66,7.0,3,4,4,4,12,0xb2d23198
5317.64,1.0,296,2,2,1,5,0xb2d19dde
141.21,1.0,48,1,2,2,5,0xb2d9badd
2128.22,1.0,92,1,2,1,4,0xb2d2b3c1
4171.46,1.0,1,2,2,4,8,0xb2d1c6fcd
727092.82,5.0,4,4,4,4,12,0xb2d56d24
2183.66,1.0,207,1,2,1,4,0xb2d5e950
200010.43,2.0,5,3,3,3,9,0xb2d9eea9
190007.44,4.0,95,3,4,1,8,0xb2d1c971
20000.66,2.0,0,2,3,4,9,0xb2d91342d
1005.62,1.0,92,1,2,1,4,0xb2d31119d
917871.04,18.0,0,4,4,4,12,0xb2d6d76e
363588.12,2.0,1,4,3,4,11,0xb2d56f10
13040.1,1.0,5,2,2,3,7,0xb2d68096d
50047.31,2.0,110,2,3,1,6,0xb2d5ece7
504.4,1.0,10,1,2,3,6,0xb2d9206d
763.54,1.0,10,1,2,3,6,0xb2d8b49d
91112.93,4.0,0,3,4,4,11,0xb2d0b99bd
150084.68,2.0,13,3,3,3,9,0xb2d63dadd
170053.89,4.0,139,3,4,1,8,0x3b9b2c17
61.23,1.0,18,1,2,2,5,0xb2d9961f
1892.31,1.0,0,1,2,4,7,0xb2d6c3f1
6671.88,1.0,184,2,2,1,5,0xb2d14e0c
187013.92,4.0,1,3,4,4,11,0xb2d98fcc
539000.0,7.0,9,4,4,3,11,0xb2d5a29e
221.27,1.0,0,1,2,4,7,0xb2d28c8a
18401.67,2.0,13,2,3,3,8,0xb2d0694f
2493.21,1.0,24,1,2,2,5,0xb2d67d79
106018.04,2.0,95,3,3,1,7,0xb2d433e8d
118500.22,2.0,10,3,3,3,9,0xb2d2cbf1
429.32,1.0,37,1,2,2,5,0xb2d35233
829.09,1.0,10,1,2,3,6,0xb2d42c8e
301000.78,4.0,4,4,4,4,12,0xb2d62bcd
224.04,1.0,16,1,2,2,5,0xb2d2c418
50336.54,2.0,3,2,3,4,9,0xb2d4147e
871.84,1.0,9,1,2,3,6,0xb2d479e0
112.23,1.0,0,1,2,4,7,0xb2d5abe6
201168.32,4.0,83,3,4,1,8,0xb2d3c886d
202131.82,2.0,93,3,3,1,7,0xb2d980eb
462052.81,6.0,67,4,4,1,9,0xb2d18381
143422.02,7.0,0,3,4,4,11,0xb2d09f85
19245.08,1.0,3,2,2,4,8,0xb2d2272f
20200.37,1.0,2,2,2,4,8,0xb2d8f71a
432833.67,5.0,1,4,4,4,12,0xb2d1b262d
1034.94,1.0,95,1,2,1,4,0xb2d5ff1d
92148.92,2.0,92,3,3,1,7,0xb2d3bca6d
11895.21,2.0,0,2,3,4,9,0xb2d084ee
190085.18,7.0,7,3,4,3,10,0xb2d9647b
100002.53,5.0,74,3,4,1,8,0xb2d5c539
638.96,1.0,0,1,2,4,7,0xb2d5c1cfd
1066444.86,7.0,22,4,4,2,10,0xb2d3d867
1065.88,1.0,3,1,2,4,7,0xb2d2a12e
82.42,1.0,58,1,2,2,5,0xb2d2b473
122193.95,3.0,97,3,4,1,8,0xb2d58a33d
324079.86,2.0,0,4,3,4,11,0x3b9b35b6d
620062.81,2.0,19,4,3,2,9,0xb2d8d79d
10037.88,2.0,55,2,3,2,7,0xb2d6c3ccd
436049.59,7.0,4,4,4,4,12,0xb2d59b0c
2937.49,1.0,0,2,2,4,8,0xb2d1f2c2d
104586.4,2.0,11,3,3,3,9,0xb2d44b0fd
270105.59,4.0,186,3,4,1,8,0xb2d1890d
617584.75,5.0,6,4,4,3,11,0xb2d3bb1dd
301065.72,2.0,48,4,3,2,9,0xb2d9defd
2220000.0,11.0,0,4,4,4,12,0xb2d3c3ab
53439.71,2.0,181,3,3,1,7,0xb2d06a53d
104156.55,2.0,48,3,3,2,8,0xb2d482a9d
52740.8,1.0,60,3,2,2,7,0xb2d64272d
125507.79,3.0,69,3,4,1,8,0xb2d06823
500031.81,2.0,12,4,3,3,10,0xb2d41dfc
502053.59,3.0,8,4,4,3,11,0xb2d707a9d
90096.61,2.0,114,3,3,1,7,0xb2d3b596
100625.26,4.0,1,3,4,4,11,0xb2d5da0c
3413.18,1.0,4,2,2,4,8,0xb2d22455
31467.24,2.0,83,2,3,1,6,0xb2d58989
932221.55,3.0,94,4,4,1,9,0xb2d335c6
1065051.16,5.0,0,4,4,4,12,0xb2d23dc2
12694.02,1.0,3,2,2,4,8,0xb2d34397d
1924.89,2.0,1,1,3,4,8,0x3b9af2da
276722.55,2.0,17,3,3,2,8,0xb2d65b33
38.63,1.0,28,1,2,2,5,0xb2d9dc57
2106006.3,7.0,5,4,4,3,11,0xb2d56ce7d
1249359.33,6.0,95,4,4,1,9,0xb2d38da9d
7308.99,1.0,0,2,2,4,8,0xb2d6a57c
737193.02,6.0,0,4,4,4,12,0xb2d3f61bd
110017.65,2.0,4,3,3,4,10,0xb2d5943b
460012.4,6.0,10,4,4,3,11,0xb2d155f1d
786004.07,4.0,59,4,4,2,10,0xb2d258d1d
5650060.17,3.0,7,4,4,3,11,0xb2d9193b
105001.12,2.0,138,3,3,1,7,0xb2d5b8c8
8788.31,1.0,10,2,2,3,7,0xb2d6e51a
649.92,1.0,39,1,2,2,5,0xb2d1fa7e
165912.52,3.0,3,3,4,4,11,0xb2d60d0d
439908.73,9.0,1,4,4,4,12,0xb2d1de65d
110000.85,3.0,0,3,4,4,11,0xb2d6f303
1700.0,1.0,0,1,2,4,7,0xb2d14263
379069.3,2.0,168,4,3,1,8,0xb2d62231d
380431.67,4.0,48,4,4,2,10,0xb2d5776e
5284.05,1.0,184,2,2,1,5,0xb2d171cfd
1022.32,1.0,185,1,2,1,4,0xb2d5d3dc
283375.4,3.0,27,3,4,2,9,0xb2d60393d
263119.26,2.0,1,3,3,4,10,0xb2d983c0
143645.38,3.0,18,3,4,2,9,0xb2d181fd
542.94,1.0,5,1,2,3,6,0xb2d5fcd4
3824.37,1.0,11,2,2,3,7,0xb2d39eded
550012.14,4.0,21,4,4,2,10,0xb2d943ac
100822.14,2.0,28,3,3,2,8,0xb2d1e5cb
50001.06,1.0,11,2,2,3,7,0xb2d968bcd
2342.58,2.0,184,1,3,1,5,0xb2d0c899
500001.6,7.0,27,4,4,2,10,0xb2d548b9
61220.8,2.0,0,3,3,4,10,0xb2d2c55e
20001.12,2.0,165,2,3,1,6,0xb2d568c4
2.15,1.0,134,1,2,1,4,0xb2d55824
251186.71,3.0,24,3,4,2,9,0xb2d25f5dd
1400996.91,2.0,1,4,3,4,11,0xb2d2bf0e
13.27,1.0,68,1,2,1,4,0xb2d5d118
708000.95,4.0,77,4,4,1,9,0xb2d68271d
20060.86,1.0,92,2,2,1,5,0xb2d2ed25
436003.65,9.0,4,4,4,4,12,0xb2d21fc4d
3012616.46,11.0,35,4,4,2,10,0xb2d1bcf1
750199.7,1.0,0,4,2,4,10,0xb2d92317
487127.46,18.0,4,4,4,4,12,0xb2d57ed8
6033.36,1.0,0,2,2,4,8,0xb2d64ec4
22254.14,4.0,92,2,4,1,7,0xb2d07bb7d
25029.66,1.0,103,2,2,1,5,0xb2d63dc3
140244.35,2.0,0,3,3,4,10,0xb2d2b4dd
278210.72,3.0,0,3,4,4,11,0xb2d23e03
371184.15,7.0,14,4,4,3,11,0xb2d0fea0d
9.04,1.0,12,1,2,3,6,0xb2d2305c
883009.53,13.0,1,4,4,4,12,0xb2d10242
382.81,1.0,26,1,2,2,5,0xb2d8c95a
1562.94,1.0,122,1,2,1,4,0xb2d457c2
15168.26,1.0,19,2,2,2,6,0xb2d34c81d
1048.45,1.0,106,1,2,1,4,0xb2d6d2e1
10021.23,1.0,211,2,2,1,5,0xb2d781d9d
600000.0,3.0,22,4,4,2,10,0xb2da1fd4
112000.94,3.0,74,3,4,1,8,0xb2d2b37c
29877.29,1.0,278,2,2,1,5,0xb2d3ae8b
300030.0,2.0,21,3,3,2,8,0xb2d95146
1142584.93,6.0,31,4,4,2,10,0xb2d10addd
2301.13,1.0,17,1,2,2,5,0xb2d3780d
500000.0,2.0,0,4,3,4,11,0xb2d9845bd
5771.37,1.0,10,2,2,3,7,0xb2d5a2cc
500001.86,6.0,1,4,4,4,12,0xb2d6828d
201611.74,2.0,54,3,3,2,8,0xb2d680c1
23.22,1.0,67,1,2,1,4,0xb2d86780
63578.86,1.0,1,3,2,4,9,0xb2d2e007
77815.1,2.0,6,3,3,3,9,0xb2d0d83a
200000.0,2.0,21,3,3,2,8,0xb2da2605
376030.05,3.0,140,4,4,1,9,0xb2d13d86
110103.12,2.0,0,3,3,4,10,0xb2d9e0d1
101635.96,2.0,115,3,3,1,7,0xb2d692e7d
0.0,1.0,9,1,2,3,6,0xb2d95ca4
100017.94,2.0,224,3,3,1,7,0xb2d587edd
8.97,1.0,41,1,2,2,5,0xb2d59b29
530764.28,3.0,0,4,4,4,12,0xb2d13adb
30001.54,2.0,38,2,3,2,7,0xb2d584d8
10000.21,2.0,11,2,3,3,8,0xb2da4036
95.73,1.0,69,1,2,1,4,0xb2d5ae5ad
5929.81,1.0,184,2,2,1,5,0xb2d3f2de
90006.59,4.0,62,3,4,2,9,0xb2d55111
917024.58,8.0,20,4,4,2,10,0xb2d8e233
320085.26,2.0,192,4,3,1,8,0xb2d5dc1b
100007.41,2.0,210,3,3,1,7,0xb2d74373d
401429.51,3.0,30,4,4,2,10,0xb2d5c0cd
10393.75,2.0,8,2,3,3,8,0xb2d5b2b8
214774.2,1.0,104,3,2,1,6,0xb2d2f636d
13096.95,1.0,3,2,2,4,8,0xb2d8cb01d
11394.59,1.0,184,2,2,1,5,0xb2d3b8b7
74786.57,2.0,34,3,3,2,8,0xb2d1887d
5409.53,1.0,0,2,2,4,8,0xb2d5a750d
10000001.0,2.0,3,4,3,4,11,0xb2d228a6
33.03,1.0,87,1,2,1,4,0xb2d8364f
394188.73,2.0,99,4,3,1,8,0xb2d6ce47
100870.59,3.0,122,3,4,1,8,0xb2d065f6
111750.33,4.0,92,3,4,1,8,0xb2d64f9bd
232748.68,4.0,31,3,4,2,9,0x3b9b2c08
50111.57,1.0,92,2,2,1,5,0xb2d54ff9
66.41,1.0,1,1,2,4,7,0xb2d68fe9
983000.0,14.0,4,4,4,4,12,0xb2d17c82
5.51,2.0,80,1,3,1,5,0xb2d069e7
5.01,1.0,36,1,2,2,5,0xb2d9036c
23.7,1.0,11,1,2,3,6,0xb2da4534
575018.73,6.0,31,4,4,2,10,0xb2d2669fd
122260.95,1.0,0,3,2,4,9,0xb2d16172d
0.66,1.0,7,1,2,3,6,0xb2d31747
13056.5,1.0,9,2,2,3,7,0xb2d3430bd
81397.07,2.0,192,3,3,1,7,0xb2d5dc2b
2.56,1.0,84,1,2,1,4,0xb2d9282e
20940.41,1.0,0,2,2,4,8,0xb2d1fc4d
120066.95,4.0,60,3,4,2,9,0xb2d11051
602099.32,4.0,59,4,4,2,10,0xb2d41f01
100600.26,4.0,0,3,4,4,11,0x3b9b17fd
703978.39,5.0,27,4,4,2,10,0xb2d4170c
155234.75,1.0,0,3,2,4,9,0xb2d748a4
35.41,3.0,0,1,4,4,9,0xb2d2af76
0.0,1.0,3,1,2,4,7,0xb2d96c2a
687158.61,7.0,22,4,4,2,10,0xb2d38753
1024.98,1.0,19,1,2,2,5,0xb2d29789
9.47,1.0,2,1,2,4,7,0xb2d5b70fd
98769.99,2.0,118,3,3,1,7,0xb2d5658cd
30812.5,2.0,118,2,3,1,6,0xb2d41795d
1610.93,2.0,91,1,3,1,5,0xb2d06ffbd
1064656.26,7.0,0,4,4,4,12,0xb2d0f582
1394.96,1.0,10,1,2,3,6,0xb2d348ca
38.12,1.0,18,1,2,2,5,0xb2d8cb08
139000.1,2.0,0,3,3,4,10,0xb2d40167
647.41,1.0,27,1,2,2,5,0xb2d32ba0
166.69,1.0,60,1,2,2,5,0xb2d30db4d
5543.53,1.0,0,2,2,4,8,0xb2d408fd
13.25,1.0,89,1,2,1,4,0xb2d1042f
5.77,1.0,31,1,2,2,5,0xb2d6c877
200050.99,3.0,92,3,4,1,8,0xb2d06737d
1272.45,1.0,8,1,2,3,6,0xb2d395a2
206.9,1.0,53,1,2,2,5,0xb2d5cf7f
0.8,2.0,84,1,3,1,5,0xb2d97e7f
5083675.86,3.0,6,4,4,3,11,0xb2d26d98d
51528.99,2.0,87,2,3,1,6,0xb2d5adba
642073.0,3.0,7,4,4,3,11,0xb2d4e1f0
232877.75,5.0,25,3,4,2,9,0xb2d2fa8b
1273.63,1.0,117,1,2,1,4,0xb2d2d510
4000000.0,1.0,0,4,2,4,10,0xb2da6b7a
136000.0,8.0,0,3,4,4,11,0xb2d4cc95
279607.32,2.0,109,3,3,1,7,0xb2d65b33d
3157.63,3.0,184,2,4,1,7,0xb2d114b0
2352.46,1.0,0,1,2,4,7,0xb2d94f48
182401.93,4.0,41,3,4,2,9,0xb2d2dd46
37742.02,2.0,60,2,3,2,7,0xb2d0d4e4
4380244.81,6.0,0,4,4,4,12,0x3b9b38e0
82.88,1.0,111,1,2,1,4,0xb2d6eabfd
1494.4,1.0,92,1,2,1,4,0xb2d17379d
200310.13,3.0,35,3,4,2,9,0xb2d4f170
4466.07,2.0,92,2,3,1,6,0x3b9b32d1d
10009.62,2.0,108,2,3,1,6,0xb2d65a7dd
1382.29,1.0,92,1,2,1,4,0xb2d4bcfd
5980.96,1.0,18,2,2,2,6,0xb2d5cfb0
500021.47,2.0,89,4,3,1,8,0xb2d10491
894075.79,8.0,25,4,4,2,10,0xb2d0f793d
81802.52,3.0,20,3,4,2,9,0xb2d6443e
10105.64,1.0,184,2,2,1,5,0xb2d2b71b
1712167.55,2.0,4,4,3,4,11,0xb2d449e1
5877.14,1.0,0,2,2,4,8,0xb2d53500d
51657.89,1.0,92,2,2,1,5,0xb2d2d04cd
506.37,3.0,43,1,4,2,7,0xb2d1c262d
273713.17,3.0,78,3,4,1,8,0xb2d5c8bdd
89.31,1.0,48,1,2,2,5,0xb2d37c69
20055.55,2.0,186,2,3,1,6,0xb2d66734
1200063.83,2.0,48,4,3,2,9,0xb2d143b0
290038.93,2.0,29,3,3,2,8,0xb2d18573
4844.59,1.0,2,2,2,4,8,0xb2d170ac
50388.27,2.0,116,2,3,1,6,0xb2d68128d
151.58,1.0,11,1,2,3,6,0x3b9b2895
30000001.0,2.0,185,4,3,1,8,0xb2d6aa98
315526.3,9.0,1,4,4,4,12,0x3b9b2c61
4045.15,1.0,252,2,2,1,5,0xb2d60d50
8.17,1.0,3,1,2,4,7,0xb2d27958
3260.39,1.0,184,2,2,1,5,0x3b9b2bbed
6640.8,2.0,4,2,3,4,9,0xb2d2dfb7d
180.78,1.0,0,1,2,4,7,0xb2d0ca38
507107.17,2.0,124,4,3,1,8,0xb2d76a7b
2555.6,1.0,92,1,2,1,4,0xb2d347c9d
700017.77,3.0,82,4,4,1,9,0xb2d25fa4
8019.57,1.0,121,2,2,1,5,0xb2d2dfadd
122.4,1.0,1,1,2,4,7,0xb2d2ce0a
133.25,2.0,46,1,3,2,6,0xb2d37839
510639.04,5.0,10,4,4,3,11,0xb2d4c814d
11922.5,1.0,6,2,2,3,7,0xb2da0c7b
141911.77,2.0,3,3,3,4,10,0xb2d5e342d
288013.44,3.0,111,3,4,1,8,0xb2d207f0d
142264.88,1.0,0,3,2,4,9,0xb2d5fdf2
250000.59,6.0,1,3,4,4,11,0xb2d55f9d
401553.41,3.0,22,4,4,2,10,0xb2d980ad
9495.65,1.0,82,2,2,1,5,0xb2d1d3e0
2.73,1.0,83,1,2,1,4,0xb2d31546
30679.65,1.0,23,2,2,2,6,0xb2d0c243
10.67,1.0,80,1,2,1,4,0xb2d8d38b
21985.97,1.0,1,2,2,4,8,0xb2d6a1eb
109000.0,8.0,59,3,4,2,9,0xb2d59bd4d
11823.02,1.0,0,2,2,4,8,0xb2d3e60bd
502005.33,3.0,34,4,4,2,10,0xb2d50db4
213329.04,1.0,95,3,2,1,6,0xb2d42baf
623252.78,3.0,8,4,4,3,11,0xb2d21fe7
53656.45,1.0,0,3,2,4,9,0xb2d30558
385251.76,3.0,3,4,4,4,12,0xb2d1ac14d
405011.65,3.0,28,4,4,2,10,0xb2d76898
85728.1,2.0,55,3,3,2,8,0xb2d429b6d
392.27,1.0,47,1,2,2,5,0xb2d6c264
526.48,1.0,0,1,2,4,7,0xb2d8c7b0
4944.3,1.0,15,2,2,3,7,0xb2d9b313
2061.87,1.0,159,1,2,1,4,0xb2d63c5c
171977.21,5.0,0,3,4,4,11,0x3b9af13d
645.83,1.0,9,1,2,3,6,0xb2d3cbff
331.5,1.0,9,1,2,3,6,0xb2d2d9ca
283104.93,6.0,2,3,4,4,11,0xb2d187fb
300036.24,2.0,0,3,3,4,10,0xb2d33dee
11.95,1.0,13,1,2,3,6,0xb2d2305cd
7210.95,1.0,92,2,2,1,5,0xb2d24684
50726.36,2.0,80,2,3,1,6,0xb2d69047
318.45,1.0,8,1,2,3,6,0xb2d5d52dd
1500000.84,3.0,10,4,4,3,11,0xb2da4b3f
13391.85,1.0,184,2,2,1,5,0x3b9b1969
2.66,1.0,26,1,2,2,5,0xb2d6a57cd
1697.3,2.0,0,1,3,4,8,0xb2d51ee9
320023.05,2.0,4,4,3,4,11,0xb2d30e4e
101881.45,1.0,0,3,2,4,9,0xb2d6135c
201068.98,3.0,47,3,4,2,9,0xb2d6d594d
481141.26,2.0,0,4,3,4,11,0xb2d4f4f7d
70.79,1.0,14,1,2,3,6,0xb2d62302
16.75,1.0,33,1,2,2,5,0xb2d9f95a
228272.46,3.0,7,3,4,3,10,0xb2d557d4
280345.15,2.0,83,3,3,1,7,0xb2d23f75
14898.54,1.0,19,2,2,2,6,0xb2d9570e
490104.06,8.0,0,4,4,4,12,0x3b9b4637
285000.91,3.0,1,3,4,4,11,0xb2d14f0b
10.4,1.0,39,1,2,2,5,0xb2d395c2
30510.36,2.0,169,2,3,1,6,0xb2d63ca3
205019.05,2.0,11,3,3,3,9,0xb2d3929b
50166.08,2.0,4,2,3,4,9,0xb2d640a2
1.22,1.0,180,1,2,1,4,0xb2d5d3d0
239914.72,4.0,92,3,4,1,8,0xb2d1877d
9845.56,1.0,8,2,2,3,7,0xb2da475b
873.11,1.0,9,1,2,3,6,0xb2d68b35
189.05,1.0,5,1,2,3,6,0xb2d21c7ed
1483.94,1.0,192,1,2,1,4,0xb2d45a53d
100298.7,3.0,70,3,4,1,8,0xb2d07fa6
36921.55,1.0,23,2,2,2,6,0xb2d303da
1500.0,1.0,3,1,2,4,7,0xb2d1a2a6
115534.51,6.0,0,3,4,4,11,0xb2d2adbdd
2903.53,1.0,15,2,2,3,7,0xb2d8ca7b
414427.28,4.0,23,4,4,2,10,0xb2d12345
914617.15,2.0,42,4,3,2,9,0xb2d354c5d
445248.01,4.0,13,4,4,3,11,0xb2d56797d
790939.25,11.0,3,4,4,4,12,0xb2d3981c
0.44,1.0,1,1,2,4,7,0xb2d69907
14627.95,1.0,92,2,2,1,5,0xb2d19c11d
1893.55,1.0,4,1,2,4,7,0xb2d1df24d
4734.23,1.0,184,2,2,1,5,0xb2d33c50d
375187.73,6.0,18,4,4,2,10,0xb2d0c21a
80288.26,2.0,70,3,3,1,7,0xb2d64e65d
570019.27,8.0,25,4,4,2,10,0xb2d15604d
100002.28,4.0,69,3,4,1,8,0xb2d5c5df
1545.16,1.0,184,1,2,1,4,0xb2d37bb3
877677.81,3.0,1,4,4,4,12,0xb2d1c78dd
152622.93,2.0,185,3,3,1,7,0xb2d5e578
301137.57,2.0,0,4,3,4,11,0xb2d6ba3f
250000.06,2.0,14,3,3,3,9,0xb2d7e013
69730.29,1.0,92,3,2,1,6,0xb2d32295d
200000.0,2.0,14,3,3,3,9,0xb2d95d25d
250085.97,2.0,29,3,3,2,8,0xb2d20c15
58.07,1.0,39,1,2,2,5,0xb2d977b6
480073.21,3.0,53,4,4,2,10,0xb2d133ac
100048.04,2.0,3,3,3,4,10,0xb2da5b08
6512190.54,43.0,1,4,4,4,12,0x3b9b21a3d
340168.46,3.0,23,4,4,2,10,0xb2d4270f
500000.25,2.0,15,4,3,3,10,0xb2d6bb2c
36.16,1.0,61,1,2,2,5,0xb2d54068d
106734.63,2.0,11,3,3,3,9,0xb2d61413d
6356.79,1.0,17,2,2,2,6,0xb2d6c4c9d
236061.5,5.0,0,3,4,4,11,0xb2d304bad
2239.54,1.0,87,1,2,1,4,0xb2d311f9
300007.66,3.0,11,3,4,3,10,0xb2d9c6ec
328004.68,8.0,14,4,4,3,11,0xb2d333d0
136.32,1.0,22,1,2,2,5,0xb2d1f15b
16880.93,1.0,19,2,2,2,6,0xb2d2531f
30204.43,1.0,184,2,2,1,5,0xb2d14559d
9.9,1.0,18,1,2,2,5,0xb2d925f5
164.45,1.0,7,1,2,3,6,0xb2d783dd
21798.48,1.0,4,2,2,4,8,0xb2d3c777
6.91,1.0,11,1,2,3,6,0xb2d31e91
2181761.95,3.0,9,4,4,3,11,0xb2d63631d
303199.81,2.0,84,4,3,1,8,0xb2d94fca
198.07,1.0,0,1,2,4,7,0xb2d4ce23
696.51,1.0,68,1,2,1,4,0xb2d41d59
14667.22,1.0,20,2,2,2,6,0xb2d60a8a
130141.74,5.0,80,3,4,1,8,0xb2d699bd
4271.37,1.0,9,2,2,3,7,0xb2d5be11
126297.2,1.0,164,3,2,1,6,0xb2d2b4de
200000.0,2.0,5,3,3,3,9,0xb2da5dda
500005.31,4.0,15,4,4,3,11,0xb2d97dc6
60002.33,3.0,73,3,4,1,8,0xb2d620e5
104604.99,1.0,7,3,2,3,8,0xb2d58f2cd
41.54,1.0,23,1,2,2,5,0xb2d32283
4665.77,1.0,0,2,2,4,8,0xb2d915bc
977.87,1.0,12,1,2,3,6,0xb2d5485d
73.29,1.0,13,1,2,3,6,0xb2d37c24
16.44,1.0,74,1,2,1,4,0xb2d3a435
125.4,1.0,4,1,2,4,7,0xb2d96781
220002.32,2.0,63,3,3,2,8,0xb2d9b6a9
570715.23,4.0,29,4,4,2,10,0xb2d0cd07
324882.69,1.0,10,4,2,3,9,0xb2d0d183d
481035.24,4.0,4,4,4,4,12,0xb2d5e978d
5100430.18,5.0,0,4,4,4,12,0xb2d1fe72
201095.8,4.0,49,3,4,2,9,0xb2d5aa26
5.74,1.0,16,1,2,2,5,0xb2d12a06
10173.46,1.0,12,2,2,3,7,0xb2d6bc8c
357734.13,3.0,101,4,4,1,9,0xb2d4e74bd
31531.48,1.0,10,2,2,3,7,0xb2d6f277
25781.91,1.0,56,2,2,2,6,0xb2d1f463d
11331864.42,1.0,0,4,2,4,10,0xb2d8e629d
11.13,1.0,2,1,2,4,7,0xb2d636a2
660000.0,2.0,24,4,3,2,9,0xb2d94e97
5022.14,1.0,0,2,2,4,8,0xb2d6c1f9d
611.12,2.0,0,1,3,4,8,0xb2d3246e
688.7,1.0,16,1,2,2,5,0xb2d623d4
200022.5,2.0,16,3,3,2,8,0xb2da27ab
25010.6,2.0,37,2,3,2,7,0xb2d46d90
12914.42,1.0,2,2,2,4,8,0xb2d5d3c4
4175.89,1.0,104,2,2,1,5,0xb2d354e6d
107.67,1.0,67,1,2,1,4,0xb2d91e4e
1489.53,2.0,174,1,3,1,5,0xb2d144d8
28802.11,1.0,2,2,2,4,8,0xb2d603ead
322324.23,3.0,12,4,4,3,11,0xb2d1a45ed
66005.48,3.0,69,3,4,1,8,0xb2d5947dd
1598115.57,4.0,135,4,4,1,9,0x3b9b34e4
802716.03,6.0,11,4,4,3,11,0xb2d5c947
400050.32,2.0,188,4,3,1,8,0xb2d20c75
437315.31,6.0,0,4,4,4,12,0xb2d0d4ac
471445.42,3.0,94,4,4,1,9,0xb2d0b104
131046.64,4.0,110,3,4,1,8,0xb2d57a7e
3868.77,1.0,0,2,2,4,8,0xb2d4cb65
152974.38,4.0,0,3,4,4,11,0x3b9af2c6
96.12,1.0,21,1,2,2,5,0xb2d60a3e
10354.53,1.0,5,2,2,3,7,0xb2d92356
42336.92,1.0,10,2,2,3,7,0xb2d3210dd
400000.0,2.0,21,4,3,2,9,0xb2da2179
69484.13,7.0,0,3,4,4,11,0xb2d0ae5dd
536285.05,10.0,0,4,4,4,12,0xb2d439eed
2300.04,2.0,46,1,3,2,6,0xb2d96473
2492.62,1.0,167,1,2,1,4,0xb2d68962
3383.41,1.0,48,2,2,2,6,0xb2d2bebd
46342.88,3.0,0,2,4,4,10,0xb2d1e84e
70006.06,5.0,42,3,4,2,9,0xb2d5fafc
2914.78,1.0,3,2,2,4,8,0xb2d4b646
558215.98,1.0,0,4,2,4,10,0xb2d59db4
460000.0,3.0,7,4,4,3,11,0xb2d9b095
30515.17,1.0,0,2,2,4,8,0xb2d69a3b
70753.06,1.0,184,3,2,1,6,0xb2d11100d
318565.12,3.0,228,4,4,1,9,0xb2d2bc4c
10095.34,1.0,4,2,2,4,8,0xb2d9e625
14180.58,1.0,29,2,2,2,6,0xb2d91ec4
5581.99,1.0,92,2,2,1,5,0xb2d5792bd
170005.17,3.0,38,3,4,2,9,0xb2d1c7b1
20000.84,2.0,41,2,3,2,7,0xb2d91eb5
1862.55,1.0,20,1,2,2,5,0xb2d7690d
5004.25,1.0,8,2,2,3,7,0xb2d144e2
23714.39,1.0,67,2,2,1,5,0xb2d18d41
1247.51,1.0,184,1,2,1,4,0xb2d15ecbd
1325.17,3.0,21,1,4,2,7,0xb2d080d4d
135821.47,3.0,0,3,4,4,11,0xb2d0f30b
1010.19,1.0,17,1,2,2,5,0xb2d2925e
5047.91,1.0,92,2,2,1,5,0xb2d2b81e
577047.62,11.0,0,4,4,4,12,0xb2d18b2d
279907.68,4.0,0,3,4,4,11,0xb2d3169bd
782844.8,6.0,1,4,4,4,12,0xb2d46e70d
1137.81,1.0,246,1,2,1,4,0xb2d16227
1450618.21,5.0,42,4,4,2,10,0xb2d32777d
20084.59,1.0,184,2,2,1,5,0xb2d40b61
2052.73,1.0,2,1,2,4,7,0xb2d5d74d
61468.52,2.0,12,3,3,3,9,0xb2d5efbfd
90059.2,4.0,92,3,4,1,8,0xb2d60e65d
4798.52,1.0,49,2,2,2,6,0xb2d37cf7
1806.78,1.0,0,1,2,4,7,0xb2d2fb5dd
263368.02,2.0,17,3,3,2,8,0xb2d5fdc7d
100903.8,1.0,16,3,2,2,7,0xb2d3eaf4d
771.34,1.0,10,1,2,3,6,0xb2d430d5
182001.93,3.0,28,3,4,2,9,0xb2da03ed
301224.2,3.0,21,4,4,2,10,0xb2d787d7d
4001.69,1.0,0,2,2,4,8,0xb2d6fd2c
200758.92,2.0,33,3,3,2,8,0xb2d56666d
2500.13,1.0,106,1,2,1,4,0xb2d4351b
51974.13,1.0,7,2,2,3,7,0xb2d3c9eb
21.86,1.0,61,1,2,2,5,0xb2d205a3d
596099.5,10.0,19,4,4,2,10,0xb2d21adbd
100021.02,2.0,92,3,3,1,7,0xb2d10446d
2185.96,1.0,184,1,2,1,4,0xb2d1db75d
500405.43,2.0,18,4,3,2,9,0xb2d1249f
3545.8,1.0,1,2,2,4,8,0xb2d970aa
102003.35,2.0,97,3,3,1,7,0xb2d68871
264.83,1.0,8,1,2,3,6,0xb2d49272
300150.94,3.0,11,4,4,3,11,0xb2d63f2c
43745.58,3.0,0,2,4,4,10,0xb2d52c6ad
162004.47,7.0,0,3,4,4,11,0xb2d08bd4
82.99,1.0,0,1,2,4,7,0xb2d4f6bdd
186052.99,2.0,74,3,3,1,7,0xb2d16ef4d
4566.36,1.0,0,2,2,4,8,0xb2d1d8b5
5024.01,1.0,11,2,2,3,7,0xb2d20687
1255.38,1.0,92,1,2,1,4,0xb2d121c9
29.73,1.0,3,1,2,4,7,0xb2d5f634
2.01,1.0,35,1,2,2,5,0xb2d0983a
2786.8,1.0,9,1,2,3,6,0xb2d0a816
100064.24,2.0,179,3,3,1,7,0xb2d3eaae
1503.15,1.0,2,1,2,4,7,0xb2d2ed5d
15377.34,1.0,6,2,2,3,7,0xb2d51ec6d
500000.06,2.0,24,4,3,2,9,0xb2d9cdf5
6.32,1.0,21,1,2,2,5,0xb2d9384ad
376.58,1.0,0,1,2,4,7,0xb2d52c5b
6.86,1.0,11,1,2,3,6,0xb2d94ebf
10289.34,1.0,0,2,2,4,8,0xb2d2ac7d
925000.0,9.0,1,4,4,4,12,0xb2d4ac92d
26268.82,1.0,10,2,2,3,7,0xb2d4c2ca
80222.29,2.0,110,3,3,1,7,0xb2d0a2dbd
18220.79,1.0,18,2,2,2,6,0xb2d6262ed
546135.55,4.0,0,4,4,4,12,0xb2d0b36bd
56243.96,1.0,184,3,2,1,6,0xb2d31d06
28951.1,1.0,10,2,2,3,7,0xb2d455f1
19611.71,1.0,10,2,2,3,7,0xb2d2b7bbd
200002.11,2.0,19,3,3,2,8,0xb2d8fb1c
412067.27,3.0,19,4,4,2,10,0x3b9b3610d
10210000.0,3.0,95,4,4,1,9,0xb2d8f78e
340032.08,7.0,6,4,4,3,11,0xb2d5b40b
32919.06,2.0,47,2,3,2,7,0xb2d32619d
481060.36,5.0,8,4,4,3,11,0xb2d5873c
507190.74,2.0,111,4,3,1,8,0xb2d6b1c5
30040.23,2.0,5,2,3,3,8,0xb2d3fb26
1338.82,1.0,184,1,2,1,4,0xb2d3bcadd
44837.22,2.0,146,2,3,1,6,0xb2d61f9dd
180009.39,2.0,46,3,3,2,8,0xb2d1e006
30015.84,1.0,0,2,2,4,8,0xb2d93afa
612.66,1.0,0,1,2,4,7,0xb2d354a1d
3262.07,1.0,4,2,2,4,8,0xb2d8efd1
421257.3,4.0,3,4,4,4,12,0x3b9b1277d
134.93,3.0,35,1,4,2,7,0x3b9b1762
111105.18,4.0,92,3,4,1,8,0xb2d6466cd
1170.66,1.0,9,1,2,3,6,0xb2d6e2c4d
2256.26,1.0,6,1,2,3,6,0xb2d39921
8000.0,1.0,184,2,2,1,5,0xb2d2b377
685.22,2.0,0,1,3,4,8,0x3b9af1f5
335126.99,5.0,101,4,4,1,9,0xb2d59963
6585.02,1.0,4,2,2,4,8,0xb2d184d2
2.63,1.0,49,1,2,2,5,0xb2d52cf6
488507.39,3.0,8,4,4,3,11,0xb2d6d305
304438.67,6.0,33,4,4,2,10,0xb2d1af4fd
6550159.84,3.0,0,4,4,4,12,0xb2d3f475
1600026.39,6.0,1,4,4,4,12,0xb2d4305d
400000.0,2.0,18,4,3,2,9,0xb2d95b7c
133532.26,2.0,235,3,3,1,7,0xb2d20936d
50855.16,2.0,245,2,3,1,6,0xb2d61c24d
6590.62,1.0,0,2,2,4,8,0xb2d54683
1.9,1.0,18,1,2,2,5,0xb2d95849d
1126.56,1.0,184,1,2,1,4,0xb2d2017c
500018.84,6.0,21,4,4,2,10,0xb2d59587
37.08,1.0,23,1,2,2,5,0xb2d9268a
13727.63,1.0,6,2,2,3,7,0xb2d29da4
459.37,1.0,4,1,2,4,7,0xb2d2aab8d
10000105.56,2.0,75,4,3,1,8,0xb2d97282
60964.51,1.0,92,3,2,1,6,0xb2d42e8ad
265.8,1.0,0,1,2,4,7,0xb2d96830
10295.49,1.0,4,2,2,4,8,0xb2d1be43d
200000.93,2.0,3,3,3,4,10,0xb2d26f06
113062.24,2.0,34,3,3,2,8,0xb2d42787
22090.04,1.0,4,2,2,4,8,0xb2da6163
11769.9,1.0,0,2,2,4,8,0xb2d9a3a8
11704.57,1.0,1,2,2,4,8,0xb2d6b0e7
551.13,1.0,1,1,2,4,7,0xb2d67ebf
172.6,1.0,81,1,2,1,4,0xb2d5ab27
200016.44,2.0,54,3,3,2,8,0xb2d8e7e0
451.66,1.0,1,1,2,4,7,0xb2d41396
0.53,1.0,92,1,2,1,4,0xb2d28b59
200719.38,2.0,30,3,3,2,8,0xb2d54194d
1050002.76,7.0,11,4,4,3,11,0xb2d2502ad
430294.81,4.0,91,4,4,1,9,0xb2d0e94ad
501921.53,2.0,16,4,3,2,9,0xb2d5d3bf
53898.93,1.0,92,3,2,1,6,0xb2d24c4fd
976899.94,2.0,28,4,3,2,9,0xb2d45bbf
314191.86,7.0,3,4,4,4,12,0xb2d45509d
300012.67,4.0,24,3,4,2,9,0xb2d940e9d
6907.18,1.0,15,2,2,3,7,0xb2d68bbb
3015336.79,1.0,92,4,2,1,7,0xb2d29a47
2084.56,2.0,70,1,3,1,5,0xb2d141e7
457767.54,7.0,13,4,4,3,11,0xb2d1d6d4
871.21,1.0,0,1,2,4,7,0xb2d86d4f
780271.84,10.0,0,4,4,4,12,0xb2d1dd31
7098.39,1.0,184,2,2,1,5,0xb2d31e4ad
93549.17,2.0,6,3,3,3,9,0xb2d38466d
30773.25,1.0,20,2,2,2,6,0xb2d37697
60001.27,3.0,53,3,4,2,9,0xb2d2c6b6
500000.39,5.0,6,4,4,3,11,0xb2d9e19e
1000052.08,2.0,18,4,3,2,9,0xb2d91055d
66001.66,6.0,34,3,4,2,9,0xb2d1798b
567196.03,5.0,9,4,4,3,11,0xb2d4fe0d
50000.53,2.0,34,2,3,2,7,0xb2d5a2a4
29429.42,1.0,24,2,2,2,6,0xb2d2bebdd
1890839.2,3.0,94,4,4,1,9,0xb2d24f4e
251016.11,4.0,13,3,4,3,10,0xb2d6251cd
9773.27,1.0,4,2,2,4,8,0xb2d3eba4
560000.0,5.0,0,4,4,4,12,0xb2d107b8d
6665.48,1.0,92,2,2,1,5,0xb2d14e0cd
302419.17,2.0,60,4,3,2,9,0xb2d4caee
4.22,1.0,18,1,2,2,5,0xb2d95533
1449.84,1.0,3,1,2,4,7,0xb2d6a078
70254.73,6.0,17,3,4,2,9,0xb2d3118a
15143.8,1.0,8,2,2,3,7,0xb2d69b90
20.57,1.0,3,1,2,4,7,0xb2d2eaef
1050782.84,5.0,0,4,4,4,12,0xb2d60c99d
13551.4,1.0,8,2,2,3,7,0xb2d0c6b7
438339.65,3.0,60,4,4,2,10,0xb2d081e4
55399.78,1.0,4,3,2,4,9,0xb2d0fba6d
1179.89,1.0,0,1,2,4,7,0xb2d50ca5
17.88,1.0,23,1,2,2,5,0xb2d333a7
401422.59,2.0,35,4,3,2,9,0xb2d97671d
20251.66,1.0,75,2,2,1,5,0xb2d6b9e1
50596.89,2.0,62,2,3,2,7,0xb2d6c35e
850617.32,6.0,0,4,4,4,12,0xb2d2b3a9d
11752.23,3.0,0,2,4,4,10,0xb2d170add
2007.48,1.0,10,1,2,3,6,0xb2d3c2da
320011.71,2.0,62,4,3,2,9,0xb2d8f6fb
700000.0,6.0,9,4,4,3,11,0xb2d137c5
150031.08,2.0,179,3,3,1,7,0xb2d288b3
1504752.44,5.0,34,4,4,2,10,0xb2d5bba4d
34982.31,3.0,17,2,4,2,8,0xb2d70028
55746.63,2.0,4,3,3,4,10,0xb2d6264f
100158.92,1.0,159,3,2,1,6,0xb2d67d2bd
50002.27,2.0,74,2,3,1,6,0xb2d1ee7d
33.12,1.0,74,1,2,1,4,0xb2d4d9acd
826027.9,5.0,5,4,4,3,11,0xb2d48515
38.48,1.0,50,1,2,2,5,0xb2d5e4d4d
8139.43,1.0,0,2,2,4,8,0xb2d20fbad
300211.08,2.0,6,4,3,3,10,0xb2d648d4d
100809.75,2.0,116,3,3,1,7,0xb2d6a6bb
4906.62,1.0,184,2,2,1,5,0xb2d2f788d
16125.14,1.0,0,2,2,4,8,0xb2d2fb03
250013.0,3.0,21,3,4,2,9,0xb2d5f6f1d
22.82,1.0,0,1,2,4,7,0xb2d559a8d
58294.58,1.0,0,3,2,4,9,0xb2d592bf
10050.33,2.0,92,2,3,1,6,0xb2d5e905d
8.43,1.0,1,1,2,4,7,0xb2d67f82
4730.1,1.0,0,2,2,4,8,0xb2d3745c
480661.44,8.0,0,4,4,4,12,0xb2d5aa48
200001.0,2.0,0,3,3,4,10,0xb2d98233d
5500.44,1.0,0,2,2,4,8,0xb2d2f72ed
874.62,1.0,2,1,2,4,7,0xb2d6c9bf
24471.79,1.0,0,2,2,4,8,0xb2d69f89d
57565.57,1.0,0,3,2,4,9,0xb2d26aad
210521.38,2.0,59,3,3,2,8,0xb2d4d033
203487.95,3.0,12,3,4,3,10,0xb2d18067d
68.4,1.0,15,1,2,3,6,0xb2d2ca62
53085.76,1.0,20,3,2,2,7,0xb2d6bbc0
500004.41,3.0,3,4,4,4,12,0xb2d90d57
57001.46,4.0,28,3,4,2,9,0xb2da08b8
504926.01,4.0,60,4,4,2,10,0xb2d1dd26d
9088.36,1.0,92,2,2,1,5,0xb2d19b18d
12733.25,1.0,0,2,2,4,8,0xb2d6dc8cd
51310.47,2.0,0,2,3,4,9,0xb2d62c42d
20000.0,4.0,83,2,4,1,7,0xb2d09ee7
61.65,1.0,69,1,2,1,4,0xb2d78233
13420.9,1.0,0,2,2,4,8,0xb2d30f6c
200006.33,2.0,60,3,3,2,8,0xb2d9b5b6
1019807.82,6.0,55,4,4,2,10,0xb2d0b84b
11811.15,1.0,0,2,2,4,8,0xb2d6af0d
6195.14,1.0,5,2,2,3,7,0xb2d386fc
66000.53,3.0,4,3,4,4,11,0xb2d91779d
315370.19,4.0,6,4,4,3,11,0xb2d270f5
2.2,1.0,12,1,2,3,6,0xb2d2e572
20000.84,2.0,98,2,3,1,6,0xb2d96a74
16150.64,6.0,0,2,4,4,10,0x3b9acde2
2000005.28,6.0,4,4,4,4,12,0xb2da4c71
8197.28,2.0,70,2,3,1,6,0xb2d8a223
988000.0,19.0,2,4,4,4,12,0xb2d16ed9d
180055.68,4.0,132,3,4,1,8,0xb2d2bd1c
132372.49,8.0,1,3,4,4,11,0xb2d5cdd1d
26189.17,1.0,92,2,2,1,5,0xb2d359a3d
100012.14,1.0,1,3,2,4,9,0xb2d9b460
10972.63,1.0,192,2,2,1,5,0xb2d3a19ed
310000.0,4.0,0,4,4,4,12,0xb2d5ba3fd
30000.0,2.0,10,2,3,3,8,0xb2d0db1c
10401.3,2.0,179,2,3,1,6,0xb2d5ac9b
2136.85,1.0,92,1,2,1,4,0xb2d30c25
1672.1,1.0,1,1,2,4,7,0xb2d4cb3dd
60011.81,2.0,101,3,3,1,7,0xb2d5a61f
53000.98,3.0,165,3,4,1,8,0xb2d19466
992.37,1.0,0,1,2,4,7,0xb2d782c3
201421.04,2.0,68,3,3,1,7,0xb2d9b164
1637.36,1.0,184,1,2,1,4,0xb2d1b254
1518.9,1.0,184,1,2,1,4,0xb2d20fdf
400725.4,3.0,19,4,4,2,10,0xb2d65715
11667.06,1.0,7,2,2,3,7,0xb2d601ac
500400.03,2.0,17,4,3,2,9,0xb2da35cc
7714.17,1.0,92,2,2,1,5,0xb2d20502
1314.68,1.0,9,1,2,3,6,0xb2d6bd4a
200748.85,2.0,11,3,3,3,9,0xb2d4c22d
669821.81,2.0,76,4,3,1,8,0xb2d2267ed
1371.88,1.0,184,1,2,1,4,0xb2d2b353d
3804.61,1.0,125,2,2,1,5,0xb2d93ab7
510004.77,3.0,16,4,4,2,10,0xb2d5e056
860.19,1.0,1,1,2,4,7,0xb2d0de90
410000.02,5.0,0,4,4,4,12,0xb2d9c686
403174.91,4.0,0,4,4,4,12,0xb2d1bedb
109093.79,1.0,3,3,2,4,9,0xb2d81540
2002.27,1.0,4,1,2,4,7,0xb2d156e2
1301354.77,7.0,19,4,4,2,10,0x3b9b185d
102729.97,2.0,213,3,3,1,7,0xb2d554ab
151322.9,4.0,0,3,4,4,11,0xb2d5c979
12400.48,1.0,0,2,2,4,8,0xb2d5fb7b
0.35,1.0,6,1,2,3,6,0xb2d52932
5.35,1.0,46,1,2,2,5,0xb2d63985
10444.28,1.0,15,2,2,3,7,0xb2d5d0b1d
204977.46,2.0,96,3,3,1,7,0xb2d7445a
66236.96,2.0,101,3,3,1,7,0xb2d23946d
545049.61,5.0,69,4,4,1,9,0xb2d12803
97498.05,2.0,1,3,3,4,10,0xb2d3acb8
51.95,1.0,9,1,2,3,6,0xb2d243d6
162974.48,2.0,31,3,3,2,8,0xb2d29820
2861575.67,4.0,3,4,4,4,12,0xb2d3c80b
30002.4,3.0,4,2,4,4,10,0xb2d631c8
2051.76,1.0,1,1,2,4,7,0xb2d6ffc3
0.0,1.0,10,1,2,3,6,0xb2d62f21
0.57,1.0,89,1,2,1,4,0xb2d8a581
373301.39,2.0,0,4,3,4,11,0xb2d5a847
155179.97,4.0,4,3,4,4,11,0xb2d1f14d
475.67,2.0,2,1,3,4,8,0x3b9b2570
77.02,1.0,12,1,2,3,6,0xb2d243c4
92003.5,3.0,188,3,4,1,8,0xb2d6a58e
1705030.98,3.0,4,4,4,4,12,0xb2d5c0d7d
50022.52,2.0,123,2,3,1,6,0xb2d165c4
200064.14,1.0,0,3,2,4,9,0xb2d3fb6c
302299.89,13.0,1,4,4,4,12,0xb2d560f6
1294.98,2.0,92,1,3,1,5,0xb2d1acdbd
6475.54,1.0,14,2,2,3,7,0xb2d32e9e
545555.78,5.0,43,4,4,2,10,0xb2d60ee9
1635.56,1.0,1,1,2,4,7,0xb2d2dd0c
16567.23,1.0,9,2,2,3,7,0xb2d3f575
40001.81,3.0,18,2,4,2,8,0xb2d649cd
1554.98,1.0,92,1,2,1,4,0xb2d32626d
98.62,1.0,39,1,2,2,5,0xb2d20062
3002.07,1.0,6,2,2,3,7,0xb2d29415
558850.83,3.0,87,4,4,1,9,0xb2d299af
105092.33,2.0,132,3,3,1,7,0xb2d49d65d
72010.18,4.0,73,3,4,1,8,0xb2d58ef3
280000.0,3.0,90,3,4,1,8,0xb2d0bea4d
5087.08,1.0,10,2,2,3,7,0xb2da2db1
4639.58,1.0,1,2,2,4,8,0xb2d4040f
3631.55,1.0,0,2,2,4,8,0xb2d532e3
103771.86,1.0,7,3,2,3,8,0xb2d1141a
162331.7,1.0,0,3,2,4,9,0xb2d32b44d
0.0,2.0,7,1,3,3,7,0xb2d67d9a
880032.63,7.0,3,4,4,4,12,0xb2d0e9f6
20238.99,2.0,69,2,3,1,6,0xb2d6b947d
3260.29,1.0,8,2,2,3,7,0xb2d2a67d
1262.35,2.0,10,1,3,3,7,0xb2d32741
427525.55,4.0,108,4,4,1,9,0xb2d1b9db
632646.95,2.0,5,4,3,3,10,0xb2d178e0d
510208.21,3.0,56,4,4,2,10,0xb2d1c210
3112.09,1.0,184,2,2,1,5,0xb2d0d6f8d
1805.59,1.0,220,1,2,1,4,0xb2d40aba
450003.36,8.0,11,4,4,3,11,0xb2d255d1
250034.29,3.0,22,3,4,2,9,0xb2d119df
10211.23,1.0,294,2,2,1,5,0xb2d54e90d
1220706.51,4.0,11,4,4,3,11,0xb2d11198
7284.88,1.0,13,2,2,3,7,0xb2d9a927
100267.63,2.0,75,3,3,1,7,0xb2d41eee
340007.18,2.0,24,4,3,2,9,0xb2d94598
8445748.18,10.0,4,4,4,4,12,0x3b9b316a
51609.39,2.0,80,2,3,1,6,0xb2d4826a
22272.38,2.0,0,2,3,4,9,0xb2d555ad
101277.55,2.0,1,3,3,4,10,0xb2d5c8f8
200392.85,2.0,95,3,3,1,7,0xb2d4b6f1
190375.07,5.0,94,3,4,1,8,0xb2d6aed5
50012.14,1.0,32,2,2,2,6,0xb2d93bc9
221142.14,2.0,0,3,3,4,10,0xb2d315acd
1012.37,1.0,92,1,2,1,4,0xb2d1fe3fd
2741.45,3.0,8,1,4,3,8,0xb2d19263d
10080875.83,4.0,0,4,4,4,12,0xb2d2e574
4866.55,1.0,13,2,2,3,7,0xb2d4eab7
403578.4,3.0,81,4,4,1,9,0xb2d10b3f
8091.95,1.0,8,2,2,3,7,0xb2d51170
1052.74,1.0,217,1,2,1,4,0xb2d33e4dd
505387.38,2.0,29,4,3,2,9,0xb2d901e8
10973.77,1.0,251,2,2,1,5,0xb2d58a39d
305.46,1.0,10,1,2,3,6,0xb2d5b421
3683.55,1.0,0,2,2,4,8,0xb2d46f47
110.21,1.0,83,1,2,1,4,0xb2d2430dd
0.0,1.0,10,1,2,3,6,0xb2d55653
411088.29,2.0,0,4,3,4,11,0xb2d0dc49
7254.73,1.0,0,2,2,4,8,0xb2d9b941
101517.08,5.0,59,3,4,2,9,0xb2d2b27c
30001.97,2.0,185,2,3,1,6,0xb2d68bdf
217.95,1.0,2,1,2,4,7,0xb2d6b743
10073.05,1.0,2,2,2,4,8,0xb2d7565d
413924.89,5.0,1,4,4,4,12,0xb2d4ea03d
455068.14,8.0,6,4,4,3,11,0xb2d17fc6
1323.9,1.0,36,1,2,2,5,0xb2d1bf8c
352199.57,2.0,0,4,3,4,11,0xb2d1066ed
440004.64,2.0,77,4,3,1,8,0xb2d99663
166018.57,3.0,8,3,4,3,10,0xb2d541cdd
182669.6,1.0,10,3,2,3,8,0xb2d6e099
9924.45,1.0,15,2,2,3,7,0xb2d9c3e1
512443.38,2.0,125,4,3,1,8,0xb2d76480d
40000.0,2.0,4,2,3,4,9,0xb2da53de
2487.64,1.0,184,1,2,1,4,0xb2d3f0ac
412803.47,3.0,34,4,4,2,10,0xb2d61de5
1001.59,1.0,161,1,2,1,4,0xb2d6ad0a
220.12,1.0,9,1,2,3,6,0xb2d414dcd
400145.57,2.0,126,4,3,1,8,0xb2d65716
3097.54,1.0,0,2,2,4,8,0xb2d2dcf7
210018.94,4.0,109,3,4,1,8,0xb2d235fc
2861689.82,14.0,0,4,4,4,12,0xb2d33936
3097.14,1.0,3,2,2,4,8,0xb2d6e7f2d
10000.0,2.0,13,2,3,3,8,0xb2d95fc4
100028.17,4.0,42,3,4,2,9,0xb2d12694
62624.0,1.0,92,3,2,1,6,0xb2d3492c
30091.54,1.0,3,2,2,4,8,0xb2d68533d
86.54,1.0,3,1,2,4,7,0xb2d5decfd
200001.26,2.0,22,3,3,2,8,0xb2d950a8
1000058.54,3.0,28,4,4,2,10,0xb2d132fc
4592.29,1.0,92,2,2,1,5,0xb2d33075
95.22,1.0,11,1,2,3,6,0xb2d4f7bd
246.92,1.0,10,1,2,3,6,0xb2d910cf
352506.55,5.0,5,4,4,3,11,0xb2d0e45fd
718.43,1.0,10,1,2,3,6,0xb2d90518
951.49,1.0,10,1,2,3,6,0xb2d3479c
1435.68,1.0,25,1,2,2,5,0xb2d34d3ad
1510039.99,5.0,0,4,4,4,12,0xb2d1c0f8
352.36,1.0,7,1,2,3,6,0xb2d3438dd
400065.96,3.0,101,4,4,1,9,0xb2d2430a
100141.25,3.0,20,3,4,2,9,0xb2d94eb9
311567.25,4.0,1,4,4,4,12,0xb2d52ffcd
1223000.0,23.0,0,4,4,4,12,0xb2d1c75a
386334.3,2.0,1,4,3,4,11,0xb2d3b5f8
500998.58,3.0,13,4,4,3,11,0xb2d636cc
100011.09,1.0,0,3,2,4,9,0xb2da6808
21225.92,3.0,4,2,4,4,10,0xb2d51771
51.8,1.0,8,1,2,3,6,0xb2d33587
3046337.33,7.0,0,4,4,4,12,0xb2d1a41e
2181438.85,15.0,3,4,4,4,12,0xb2d4f3a1d
53347.18,2.0,155,3,3,1,7,0xb2d42f36
300000.03,2.0,5,3,3,3,9,0xb2d86b50
20417.04,2.0,0,2,3,4,9,0xb2d15a43
80558.71,1.0,3,3,2,4,9,0xb2d2bf50
9578.52,1.0,6,2,2,3,7,0xb2d6db64
50638.12,1.0,92,2,2,1,5,0xb2d1d8a0
5028.52,1.0,184,2,2,1,5,0xb2d4dacb
13513.28,1.0,0,2,2,4,8,0xb2d53059
900010.51,3.0,7,4,4,3,11,0xb2d62183
1000161.3,8.0,5,4,4,3,11,0xb2d13648
360011.41,2.0,189,4,3,1,8,0xb2d84357
1774.16,1.0,0,1,2,4,7,0xb2d2ead7
46257.19,3.0,19,2,4,2,8,0xb2d2d926
1400635.66,3.0,14,4,4,3,11,0xb2d9d262
61003.24,3.0,25,3,4,2,9,0xb2d4080f
47550.69,1.0,137,2,2,1,5,0xb2d1ce14
200000.0,2.0,1,3,3,4,10,0xb2d98116d
480030.03,7.0,11,4,4,3,11,0xb2d31799
140033.1,2.0,95,3,3,1,7,0xb2d623add
13869.76,1.0,3,2,2,4,8,0xb2d21e57
985018.8,7.0,0,4,4,4,12,0xb2d68a29d
15.71,1.0,28,1,2,2,5,0xb2d08ea3
61720.23,2.0,66,3,3,2,8,0xb2d5f1c4d
149169.09,1.0,7,3,2,3,8,0xb2d29921
10489.74,1.0,21,2,2,2,6,0xb2d54f30
1006482.35,19.0,0,4,4,4,12,0xb2d11ed3
1257.15,1.0,9,1,2,3,6,0xb2d75a27
101927.12,2.0,77,3,3,1,7,0xb2d3942dd
1298.52,1.0,200,1,2,1,4,0xb2d6e26c
552138.93,2.0,5,4,3,3,10,0xb2d539e6
4763.64,1.0,184,2,2,1,5,0xb2d2df07
500000.1,3.0,10,4,4,3,11,0xb2d8c7f6
220045.26,6.0,13,3,4,3,10,0xb2d57f4b
20002.79,2.0,125,2,3,1,6,0xb2d58735
99.07,1.0,3,1,2,4,7,0xb2d6c9e8d
926.7,1.0,4,1,2,4,7,0xb2d3da7c
10070.5,1.0,184,2,2,1,5,0xb2d297e7
920792.52,5.0,0,4,4,4,12,0xb2d69c87d
626.52,1.0,9,1,2,3,6,0xb2d9b316
1518.54,1.0,2,1,2,4,7,0xb2d8f747
330083.36,3.0,20,4,4,2,10,0xb2d9ad5d
29.54,1.0,17,1,2,2,5,0xb2d6b999
30.2,1.0,81,1,2,1,4,0xb2d6e274
28172.71,2.0,60,2,3,2,7,0xb2d8f1be
501776.13,2.0,45,4,3,2,9,0xb2d91f32d
10000.21,2.0,39,2,3,2,7,0xb2d9eaae
239171.89,2.0,73,3,3,1,7,0xb2d17699
450055.68,3.0,83,4,4,1,9,0xb2d5dbd9d
660.07,1.0,17,1,2,2,5,0xb2d96212
8693.62,1.0,0,2,2,4,8,0xb2d8d391d
3000.5,1.0,84,2,2,1,5,0xb2d1d46cd
100001.06,2.0,98,3,3,1,7,0xb2d97035
250008.54,2.0,8,3,3,3,9,0xb2d9ae3c
210056.54,4.0,11,3,4,3,10,0xb2d26f1b
157.66,1.0,23,1,2,2,5,0xb2d2f493
8894.34,1.0,3,2,2,4,8,0xb2d75624d
10.67,1.0,16,1,2,2,5,0xb2d27c72
1781.54,1.0,10,1,2,3,6,0xb2d946d2
570000.0,3.0,2,4,4,4,12,0xb2d16940d
9212.09,1.0,0,2,2,4,8,0xb2d6b70a
2932.75,1.0,92,2,2,1,5,0xb2d216db
500006.17,2.0,18,4,3,2,9,0xb2d903d2
688547.15,3.0,4,4,4,4,12,0xb2d12cb0d
0.06,1.0,298,1,2,1,4,0xb2d290d1d
503553.11,2.0,22,4,3,2,9,0xb2d8d33c
1753.33,1.0,29,1,2,2,5,0xb2d4d107
50000.0,1.0,0,2,2,4,8,0xb2da08d8
100015.91,1.0,104,3,2,1,6,0xb2d6c609
5056.78,1.0,92,2,2,1,5,0xb2d2be6c
123705.48,2.0,60,3,3,2,8,0xb2d5d879d
260015.17,4.0,42,3,4,2,9,0xb2d26d65
214423.53,4.0,1,3,4,4,11,0xb2d285d3
283205.26,3.0,9,3,4,3,10,0xb2d6443b
621720.77,6.0,0,4,4,4,12,0xb2d92520
764.28,1.0,0,1,2,4,7,0xb2d2a7da
1889.31,2.0,307,1,3,1,5,0xb2d6148e
2131.65,2.0,184,1,3,1,5,0xb2d095d1
1415.13,4.0,92,1,4,1,6,0x3b9aeed2
1009075.03,2.0,0,4,3,4,11,0xb2d0c7ba
35002.21,2.0,4,2,3,4,9,0xb2d1baf0
2.82,1.0,1,1,2,4,7,0xb2d29128
60002.0,1.0,0,3,2,4,9,0xb2d66904d
4047.47,1.0,12,2,2,3,7,0xb2d3c7cc
4.3,1.0,20,1,2,2,5,0xb2d22efc
410058.81,4.0,11,4,4,3,11,0xb2d1a551
338011.31,2.0,0,4,3,4,11,0xb2d6ed36
0.0,1.0,9,1,2,3,6,0xb2d3191f
10014.15,1.0,84,2,2,1,5,0xb2d97fd9
3500.0,2.0,81,2,3,1,6,0xb2d5ffc9
2027957.8,5.0,0,4,4,4,12,0xb2d2707d
2400.83,1.0,14,1,2,3,6,0xb2d8cd3cd
122002.58,2.0,66,3,3,2,8,0xb2d8ef51
516003.16,2.0,0,4,3,4,11,0xb2d4da0e
809.9,1.0,34,1,2,2,5,0xb2d496b9
400348.54,4.0,0,4,4,4,12,0xb2d67ea1d
202132.34,2.0,90,3,3,1,7,0xb2d945a6
750278.08,5.0,5,4,4,3,11,0xb2d5000e
472297.18,5.0,136,4,4,1,9,0xb2d1d018
5338.02,1.0,9,2,2,3,7,0xb2d92bde
14065.55,1.0,2,2,2,4,8,0xb2d5302dd
150242.07,2.0,70,3,3,1,7,0xb2d1952e
1052.81,1.0,263,1,2,1,4,0xb2d332e1
54687.78,1.0,70,3,2,1,6,0xb2d6bbad
590069.31,9.0,0,4,4,4,12,0xb2d12830
500018.12,3.0,27,4,4,2,10,0xb2d948f3d
1046.18,1.0,9,1,2,3,6,0xb2d249d9
12603.47,1.0,1,2,2,4,8,0xb2d9dd75
100011.58,2.0,15,3,3,3,9,0xb2da0e0b
50000.53,2.0,144,2,3,1,6,0xb2d90c60
64888.92,1.0,33,3,2,2,7,0xb2d22164d
83836.28,1.0,184,3,2,1,6,0x3b9b304ad
204442.12,2.0,4,3,3,4,10,0xb2d1482d
7992.25,1.0,21,2,2,2,6,0xb2d390e1
234224.0,3.0,1,3,4,4,11,0xb2d5fcf1d
50030.77,4.0,11,2,4,3,9,0xb2d596fc
563.62,1.0,76,1,2,1,4,0xb2d1ce14d
130020.41,2.0,209,3,3,1,7,0xb2d25e30
8917000.0,3.0,10,4,4,3,11,0xb2d50a92
200710.42,2.0,31,3,3,2,8,0xb2d93ee7d
39.24,2.0,44,1,3,2,6,0xb2d8dffb
21520.94,1.0,12,2,2,3,7,0xb2d43546
233003.19,4.0,44,3,4,2,9,0xb2d24a7b
45250.08,1.0,7,2,2,3,7,0xb2d6b4c9
504446.42,3.0,6,4,4,3,11,0xb2d6e045d
364.48,1.0,32,1,2,2,5,0xb2d5cf0fd
5048.83,1.0,18,2,2,2,6,0xb2d67dec
1317.29,1.0,184,1,2,1,4,0xb2d52c48
8025.64,1.0,29,2,2,2,6,0xb2d31536
16550.05,1.0,0,2,2,4,8,0xb2d264ab
101233.94,2.0,33,3,3,2,8,0xb2d6d276
121865.0,5.0,21,3,4,2,9,0xb2d6c3c4d
3500.06,1.0,2,2,2,4,8,0x3b9b481e
17242.63,1.0,1,2,2,4,8,0xb2d6ddb0
15781.96,1.0,5,2,2,3,7,0xb2d30d06
0.84,1.0,6,1,2,3,6,0xb2d5d7f1
300113.06,2.0,18,4,3,2,9,0xb2da149f
273210.69,3.0,8,3,4,3,10,0xb2d699d9
1537.47,2.0,2,1,3,4,8,0xb2d3c2d3
7.92,1.0,47,1,2,2,5,0xb2d0d9a4
1533164.54,8.0,33,4,4,2,10,0xb2d2b768
314.88,1.0,9,1,2,3,6,0xb2d4fac9
1038.41,1.0,14,1,2,3,6,0x3b9b31ca
2689.65,1.0,32,1,2,2,5,0xb2d6d9bbd
174969.54,4.0,27,3,4,2,9,0xb2d296aed
205310.43,1.0,0,3,2,4,9,0xb2d24567
160007.62,2.0,4,3,3,4,10,0xb2d39b32
270608.84,2.0,53,3,3,2,8,0xb2d9cb0f
53038.34,2.0,108,3,3,1,7,0xb2d1c40bd
10000.11,2.0,56,2,3,2,7,0xb2d9c5f6
102504.87,3.0,2,3,4,4,11,0xb2d8dd13
11187.11,1.0,0,2,2,4,8,0xb2d2f023
99499.0,4.0,0,3,4,4,11,0xb2d84858
419603.66,4.0,133,4,4,1,9,0xb2d19787
155.0,1.0,9,1,2,3,6,0xb2d2f8ca
4619.99,1.0,1,2,2,4,8,0xb2d60a90
460.8,1.0,21,1,2,2,5,0xb2d697a6
268948.14,7.0,0,3,4,4,11,0x3b9b326d
2044.48,2.0,184,1,3,1,5,0x3b9b25bbd
488421.2,6.0,125,4,4,1,9,0xb2d230efd
846005.06,7.0,3,4,4,4,12,0xb2d1a23f
14.18,1.0,75,1,2,1,4,0xb2d29f34
91757.15,2.0,2,3,3,4,10,0xb2d2dde5
24130.79,1.0,38,2,2,2,6,0xb2d3ab3bd
150155.57,3.0,70,3,4,1,8,0xb2d6c96b
101615.73,2.0,102,3,3,1,7,0xb2d39632
137.65,1.0,57,1,2,2,5,0xb2d40577
18639.58,1.0,4,2,2,4,8,0xb2d6283e
136263.79,1.0,0,3,2,4,9,0xb2d5e868d
267563.66,2.0,1,3,3,4,10,0xb2d6c35fd
230002.43,4.0,0,3,4,4,11,0xb2d8ef2dd
500062.73,3.0,5,4,4,3,11,0xb2d87a1b
50002.15,2.0,129,2,3,1,6,0xb2d6257cd
2674.4,1.0,9,1,2,3,6,0xb2d90bbfd
110128.53,2.0,80,3,3,1,7,0xb2d185bc
31.67,1.0,72,1,2,1,4,0xb2d96928
650001.47,24.0,6,4,4,3,11,0xb2d2d96fd
727.46,11.0,92,1,4,1,6,0xb2d1c77c
19000.0,1.0,7,2,2,3,7,0xb2d906ac
150079.89,3.0,0,3,4,4,11,0xb2d5b584d
600000.0,3.0,9,4,4,3,11,0xb2d56eed
602145.94,3.0,80,4,4,1,9,0xb2d157df
39004.46,3.0,76,2,4,1,7,0xb2d187c5
35134.27,2.0,129,2,3,1,6,0xb2d55461
465886.88,4.0,19,4,4,2,10,0xb2d33c49d
106554.79,3.0,9,3,4,3,10,0xb2d41671
100001.06,2.0,98,3,3,1,7,0xb2d91a74
2395.65,1.0,3,1,2,4,7,0xb2d62b51
28.05,1.0,9,1,2,3,6,0xb2d9f06a
3542.76,2.0,92,2,3,1,6,0xb2d073d2
13.21,1.0,20,1,2,2,5,0xb2d9476c
28.49,1.0,21,1,2,2,5,0xb2d68618
500021.15,2.0,196,4,3,1,8,0xb2d7bd69d
15257.01,1.0,210,2,2,1,5,0xb2d3d138
1000032.29,4.0,12,4,4,3,11,0xb2d1d4c4
265453.11,9.0,0,3,4,4,11,0xb2d642f6
8289.66,1.0,1,2,2,4,8,0xb2d5eaca
260033.83,3.0,59,3,4,2,9,0xb2d1f885
100007.86,3.0,80,3,4,1,8,0xb2d5d3ea
12062.57,1.0,10,2,2,3,7,0xb2d26d38
229326.94,5.0,0,3,4,4,11,0xb2d54f60d
158597.86,3.0,24,3,4,2,9,0xb2d2781a
110012.75,4.0,0,3,4,4,11,0xb2d5c62c
100020.15,2.0,24,3,3,2,8,0xb2d0cb10d
158000.0,5.0,5,3,4,3,10,0xb2d5e9e5
254632.38,2.0,82,3,3,1,7,0xb2d4261d
500042.43,2.0,87,4,3,1,8,0xb2d69902
124328.34,2.0,108,3,3,1,7,0xb2d1347b
120003.8,2.0,59,3,3,2,8,0xb2d8f64d
680059.55,6.0,1,4,4,4,12,0xb2d6bfd3
80044.08,2.0,60,3,3,2,8,0xb2d4eca3
511110.02,7.0,18,4,4,2,10,0xb2d25c5a
340000.0,2.0,1,4,3,4,11,0xb2da664d
2163.24,1.0,10,1,2,3,6,0xb2d40460
496880.99,2.0,20,4,3,2,9,0xb2d50c00
7600.9,1.0,0,2,2,4,8,0xb2d6d99e
22250.94,1.0,6,2,2,3,7,0xb2d74babd
680001.9,3.0,18,4,4,2,10,0xb2da306d
800117.83,2.0,101,4,3,1,8,0xb2d18b01
1997.72,1.0,136,1,2,1,4,0xb2d370ec
440315.36,2.0,13,4,3,3,10,0xb2d6b3ded
54945.2,2.0,20,3,3,2,8,0xb2d4f4d0
695001.22,4.0,10,4,4,3,11,0xb2d6ef5dd
670024.99,5.0,26,4,4,2,10,0xb2d13747d
4090.27,1.0,3,2,2,4,8,0xb2d13f58
514323.54,2.0,78,4,3,1,8,0xb2d6c718d
200002.11,2.0,25,3,3,2,8,0xb2da153a
235034.53,4.0,3,3,4,4,11,0xb2d5b9b6d
18226.06,2.0,33,2,3,2,7,0xb2d563c7
148721.49,2.0,3,3,3,4,10,0x3b9b2dc4
518023.68,3.0,80,4,4,1,9,0xb2d3dfeb
91901.08,2.0,55,3,3,2,8,0xb2d1cb35d
31000.94,5.0,7,2,4,3,9,0xb2d092b5
500005.28,2.0,80,4,3,1,8,0xb2d98fd5
340730.87,4.0,7,4,4,3,11,0xb2d6af7c
0.0,2.0,84,1,3,1,5,0xb2d78b47
1170.15,1.0,22,1,2,2,5,0xb2d6c87b
4268.7,1.0,194,2,2,1,5,0xb2d23c6cd
301295.49,3.0,4,4,4,4,12,0xb2d944d2d
1863.41,1.0,300,1,2,1,4,0xb2d58cb4d
30029.99,3.0,47,2,4,2,8,0xb2d0aa8ed
997.0,1.0,5,1,2,3,6,0xb2d12f04
200002.58,2.0,2,3,3,4,10,0xb2d6db7e
873.51,2.0,18,1,3,2,6,0xb2d262fa
52675.36,1.0,6,3,2,3,8,0xb2d4c65ad
60008.92,2.0,48,3,3,2,8,0xb2d5d24f
100588.65,2.0,34,3,3,2,8,0xb2d2611d
220050.25,3.0,11,3,4,3,10,0xb2da14a9
857.27,1.0,76,1,2,1,4,0xb2d1fd2f
877.36,2.0,2,1,3,4,8,0xb2d087d0
331287.92,3.0,16,4,4,2,10,0xb2d11900
25.86,1.0,30,1,2,2,5,0xb2d29bce
2478.85,1.0,0,1,2,4,7,0xb2d24996
6751697.03,1.0,0,4,2,4,10,0xb2d54b7a
50002.49,2.0,26,2,3,2,7,0xb2d9a4e7
22524.47,1.0,1,2,2,4,8,0xb2d609ad
3000000.0,2.0,0,4,3,4,11,0xb2d97bbf
317082.33,3.0,80,4,4,1,9,0xb2d34df2
200006.97,2.0,87,3,3,1,7,0xb2d5d059
276311.51,4.0,0,3,4,4,11,0xb2d0d6d6
4761.67,3.0,0,2,4,4,10,0x3b9b0e48
465020.94,8.0,0,4,4,4,12,0xb2d68198d
100020.02,2.0,189,3,3,1,7,0xb2d51707
217583.83,9.0,26,3,4,2,9,0xb2d07cf7
120005.28,3.0,1,3,4,4,11,0xb2da07b1
83284.42,1.0,92,3,2,1,6,0xb2d1ffa7
301495.77,2.0,0,4,3,4,11,0xb2d41719
350000.0,3.0,4,4,4,4,12,0xb2da4b7c
216200.19,2.0,179,3,3,1,7,0xb2d2a263
82.25,1.0,18,1,2,2,5,0xb2d4fc25
60014.77,2.0,20,3,3,2,8,0xb2d9f0ce
150004.75,2.0,67,3,3,1,7,0xb2d9a953
400014.73,4.0,32,4,4,2,10,0xb2d9b0d6
481108.67,4.0,70,4,4,1,9,0xb2d1c351
611003.14,4.0,4,4,4,4,12,0xb2d3045b
38810.69,1.0,6,2,2,3,7,0xb2d6c2b1d
36316.35,1.0,184,2,2,1,5,0xb2d61b54d
317324.78,2.0,70,4,3,1,8,0xb2d60348
40465.45,2.0,11,2,3,3,8,0xb2d94e72d
501776.2,2.0,30,4,3,2,9,0xb2d8ff93
27.11,1.0,3,1,2,4,7,0xb2d650b9
13.04,1.0,13,1,2,3,6,0xb2d39056
520000.0,2.0,3,4,3,4,11,0xb2d979dd
305331.91,2.0,78,4,3,1,8,0xb2d8dcb1
367065.58,4.0,21,4,4,2,10,0xb2d40672
26.4,1.0,3,1,2,4,7,0xb2d21272
131356.27,5.0,1,3,4,4,11,0xb2d07f9a
50070.05,2.0,4,2,3,4,9,0xb2d67dd0d
1101.46,1.0,0,1,2,4,7,0xb2d68a48
32322.95,1.0,92,2,2,1,5,0xb2d3375b
500006.1,2.0,8,4,3,3,10,0xb2d8eb24
120000.0,1.0,5,3,2,3,8,0xb2d6aa12
210371.98,2.0,94,3,3,1,7,0xb2d0a7fa
540013.39,4.0,47,4,4,2,10,0xb2d63d7f
28247.02,1.0,0,2,2,4,8,0xb2d315ba
34.97,1.0,9,1,2,3,6,0xb2d2e8f4
9.43,1.0,5,1,2,3,6,0xb2d6a4ea
281202.58,3.0,101,3,4,1,8,0xb2d6a215
103007.64,3.0,159,3,4,1,8,0xb2d3d370
202033.15,2.0,11,3,3,3,9,0xb2d615e8
50659.03,1.0,184,2,2,1,5,0xb2d315a2d
23.9,1.0,0,1,2,4,7,0xb2d6d4f1
200101.08,4.0,1,3,4,4,11,0xb2d574dd
5379.29,1.0,0,2,2,4,8,0xb2d915e0
40000.42,2.0,39,2,3,2,7,0xb2d9e961
6584.89,1.0,35,2,2,2,6,0xb2d33f45
2316.4,1.0,23,1,2,2,5,0xb2d27b34
52.3,1.0,7,1,2,3,6,0xb2d238a0
3244.22,1.0,6,2,2,3,7,0xb2d1a7ff
8828.58,1.0,14,2,2,3,7,0xb2d6bda5d
20167.87,2.0,92,2,3,1,6,0xb2d1141e
20.44,1.0,6,1,2,3,6,0xb2d551aa
118.41,1.0,28,1,2,2,5,0xb2d25086d
479.28,1.0,5,1,2,3,6,0xb2d42a64
201421.0,2.0,61,3,3,2,8,0xb2d9c151
32.03,1.0,9,1,2,3,6,0xb2da26d5
5100.78,1.0,4,2,2,4,8,0xb2d90002
2369.77,1.0,23,1,2,2,5,0xb2d1d268d
936510.12,10.0,31,4,4,2,10,0xb2d0a55ed
200710.42,2.0,6,3,3,3,9,0xb2d9b626
413281.7,2.0,3,4,3,4,11,0xb2d31e50d
210005.39,1.0,11,3,2,3,8,0xb2da3dbc
163508.75,3.0,0,3,4,4,11,0xb2d62b1cd
200048.52,3.0,168,3,4,1,8,0xb2d1ab15
120362.04,3.0,60,3,4,2,9,0xb2d78dd3d
26.6,1.0,60,1,2,2,5,0xb2d69da9
28985.0,1.0,0,2,2,4,8,0xb2d2f023d
113841.41,2.0,0,3,3,4,10,0xb2d62f04d
65001.37,2.0,95,3,3,1,7,0xb2d65c4a
10385.07,1.0,24,2,2,2,6,0xb2d1948e
240000.0,2.0,19,3,3,2,8,0xb2d956f6d
500083.43,2.0,19,4,3,2,9,0xb2d62d5cd
110001.16,2.0,97,3,3,1,7,0xb2d856fd
66.85,1.0,22,1,2,2,5,0xb2d21aee
974.86,2.0,0,1,3,4,8,0xb2d06bca
1650.17,1.0,92,1,2,1,4,0xb2d0e57c
3.94,1.0,1,1,2,4,7,0xb2d3cd1a
10968.0,1.0,8,2,2,3,7,0xb2d1376d
42002.29,1.0,21,2,2,2,6,0xb2d45a0d
49952.58,2.0,239,2,3,1,6,0xb2d290dcd
5603.66,1.0,1,2,2,4,8,0xb2d78899
627365.31,3.0,83,4,4,1,9,0xb2d331cfd
122048.0,4.0,0,3,4,4,11,0xb2d07742
92.24,1.0,14,1,2,3,6,0xb2d9a4bd
1815.14,1.0,92,1,2,1,4,0xb2d30225d
202404.4,2.0,5,3,3,3,9,0xb2d441afd
230.89,2.0,6,1,3,3,7,0xb2d716a3
831.76,1.0,10,1,2,3,6,0xb2d41aad
150109.84,4.0,6,3,4,3,10,0xb2d62bf5
5640.43,1.0,10,2,2,3,7,0xb2d5c848
1.53,1.0,45,1,2,2,5,0xb2d110ad
1794.43,1.0,272,1,2,1,4,0xb2d4beaa
20096.28,2.0,25,2,3,2,7,0xb2d26576
51015.16,2.0,40,2,3,2,7,0xb2d63355
1516621.63,7.0,1,4,4,4,12,0xb2d3fba0
445476.06,2.0,157,4,3,1,8,0xb2d4caeed
675322.36,8.0,12,4,4,3,11,0xb2d29b9e
62958.39,5.0,0,3,4,4,11,0xb2d1ef20d
20065.32,1.0,92,2,2,1,5,0xb2d40b61d
500000.0,2.0,23,4,3,2,9,0xb2d8f57e
70781.92,1.0,0,3,2,4,9,0xb2d94f6dd
10043.23,1.0,92,2,2,1,5,0xb2d539d4
74171.88,8.0,0,3,4,4,11,0x3b9ad18a
10027.08,1.0,3,2,2,4,8,0xb2d3d21d
200069.38,3.0,28,3,4,2,9,0xb2d086b6d
500037.07,2.0,92,4,3,1,8,0xb2d370e0
191544.56,3.0,65,3,4,2,9,0xb2d06fa9
69347.6,1.0,2,3,2,4,9,0xb2d4b2be
456.52,1.0,47,1,2,2,5,0xb2d42b06
1028628.18,7.0,5,4,4,3,11,0xb2d5c87f
510666.47,2.0,207,4,3,1,8,0xb2d690b5
420057.28,5.0,7,4,4,3,11,0xb2d60989
3826.2,1.0,9,2,2,3,7,0xb2d2f9c8d
400024.84,3.0,2,4,4,4,12,0xb2d6e427d
1038.24,1.0,106,1,2,1,4,0xb2d54b3e
218.89,1.0,10,1,2,3,6,0xb2d3db09
164022.71,3.0,59,3,4,2,9,0xb2d535b3
1563.24,2.0,92,1,3,1,5,0x3b9af41f
200002.11,2.0,80,3,3,1,7,0xb2d98fba
291996.91,4.0,24,3,4,2,9,0xb2d5d10d
14314.48,1.0,10,2,2,3,7,0xb2d2b604
500183.2,2.0,92,4,3,1,8,0xb2d5e4a4
4.12,2.0,22,1,3,2,6,0xb2d62742d
13628.91,1.0,21,2,2,2,6,0xb2d96785
20388.18,1.0,196,2,2,1,5,0xb2d5d95e
358965.42,9.0,8,4,4,3,11,0xb2d190f5d
178887.02,3.0,25,3,4,2,9,0xb2d0a394d
381010.49,5.0,5,4,4,3,11,0xb2d57f8e
516723.58,1.0,15,4,2,3,9,0xb2d330bf
2661.93,2.0,29,1,3,2,6,0xb2d9d7ef
100001.06,3.0,77,3,4,1,8,0xb2d99788
1339.55,1.0,0,1,2,4,7,0xb2d30489
497713.03,4.0,4,4,4,4,12,0xb2d5e0bc
51189.07,2.0,25,2,3,2,7,0xb2d31aa0
300204.28,4.0,19,4,4,2,10,0xb2d3d172
533654.37,4.0,76,4,4,1,9,0xb2d45d1dd
125081.55,8.0,1,3,4,4,11,0xb2d2237bd
50171.76,1.0,92,2,2,1,5,0xb2d5d2f5
60004.79,3.0,11,3,4,3,10,0xb2d637ded
113267.59,3.0,6,3,4,3,10,0xb2d219bb
736200.62,6.0,18,4,4,2,10,0xb2d64c12d
35000.74,2.0,73,2,3,1,6,0xb2d6274c
4923.49,2.0,184,2,3,1,6,0x3b9b356ed
201117.85,2.0,29,3,3,2,8,0xb2d281ec
1224.82,1.0,92,1,2,1,4,0xb2d0e2a1
510009.53,2.0,4,4,3,4,11,0xb2d27febd
50940.3,2.0,235,2,3,1,6,0xb2d61496d
25.92,1.0,11,1,2,3,6,0xb2d5cc89
1164.29,1.0,37,1,2,2,5,0xb2d1bd26
220005.28,2.0,20,3,3,2,8,0xb2da1ad1
16490.6,1.0,36,2,2,2,6,0xb2d1bf96d
50027.4,3.0,97,2,4,1,7,0xb2d5770a
5515.38,1.0,0,2,2,4,8,0xb2d4fcb7
70731.32,4.0,40,3,4,2,9,0xb2d54698
100047.23,2.0,66,3,3,2,8,0xb2d1998bd
41040.06,1.0,4,2,2,4,8,0xb2d28d1c
400004.22,2.0,28,4,3,2,9,0xb2da0ba6
580000.0,2.0,13,4,3,3,10,0xb2da4104
7.53,1.0,11,1,2,3,6,0x3b9b4695d
1242792.82,24.0,0,4,4,4,12,0xb2d3a2c0
2094.52,1.0,9,1,2,3,6,0xb2d8dad3
87.3,2.0,26,1,3,2,6,0xb2d4784e
2617.89,1.0,92,1,2,1,4,0xb2d2bf02
1051.76,7.0,184,1,4,1,6,0x3b9b1798
120053.8,1.0,28,3,2,2,7,0xb2d48ea2
202512.13,3.0,26,3,4,2,9,0xb2d6be3cd
72605.43,2.0,14,3,3,3,9,0xb2d0b8a3
902.73,1.0,2,1,2,4,7,0xb2d9918a
82589.63,2.0,80,3,3,1,7,0xb2d5cb2cd
52612.49,2.0,189,3,3,1,7,0xb2d51499
81073.48,2.0,10,3,3,3,9,0xb2d43632
44.38,1.0,0,1,2,4,7,0xb2d214ba
505451.62,2.0,4,4,3,4,11,0xb2d2de3dd
4735.6,1.0,1,2,2,4,8,0xb2d96426
10080.71,2.0,3,2,3,4,9,0xb2da0c9c
7859.14,2.0,0,2,3,4,9,0xb2d38a14
4.22,1.0,82,1,2,1,4,0xb2d42a14
0.0,1.0,92,1,2,1,4,0xb2d5b838
220000.21,3.0,24,3,4,2,9,0xb2d9482d
185.94,1.0,0,1,2,4,7,0xb2d58e58
70000.0,3.0,3,3,4,4,11,0xb2d61cac
512.97,1.0,56,1,2,2,5,0xb2d63c33
14214.71,1.0,20,2,2,2,6,0xb2d2b0a9
6126.85,1.0,5,2,2,3,7,0xb2d2a8ef
356357.2,5.0,19,4,4,2,10,0xb2d26868
98.1,1.0,9,1,2,3,6,0xb2d557eb
146736.71,6.0,3,3,4,4,11,0xb2d1291ed
168677.08,1.0,1,3,2,4,9,0xb2d6a59c
2464.89,1.0,190,1,2,1,4,0xb2d3731f
110001.06,3.0,3,3,4,4,11,0xb2d948e5d
6375.32,1.0,0,2,2,4,8,0xb2d2c67c
20582.2,1.0,3,2,2,4,8,0xb2d6545f
59698.81,1.0,4,3,2,4,9,0xb2d62266d
3283577.78,9.0,11,4,4,3,11,0x3b9b2d30d
11648.27,1.0,0,2,2,4,8,0xb2d5812c
97533.5,31.0,20,3,4,2,9,0x3b9af10e
98957.93,1.0,184,3,2,1,6,0xb2d30186
1352776.48,12.0,0,4,4,4,12,0xb2d08ba3
1196688.02,4.0,8,4,4,3,11,0xb2d0a23c
950000.0,6.0,9,4,4,3,11,0xb2d50f42
2778096.74,5.0,16,4,4,2,10,0xb2d0c7ce
201890.4,5.0,18,3,4,2,9,0xb2d593e5
3898.9,1.0,0,2,2,4,8,0xb2d55466
8208.97,1.0,92,2,2,1,5,0xb2d2eaad
13134.19,1.0,184,2,2,1,5,0xb2d22b63
50119.69,1.0,0,2,2,4,8,0xb2d5617cd
970073.69,5.0,4,4,4,4,12,0xb2d5e16dd
133227.08,3.0,0,3,4,4,11,0xb2d4de8ad
36.47,1.0,40,1,2,2,5,0xb2d1c414
305.86,1.0,0,1,2,4,7,0xb2d5e764
2118.69,1.0,0,1,2,4,7,0xb2d6e7ba
26028.9,1.0,9,2,2,3,7,0xb2d37807d
130860.64,2.0,0,3,3,4,10,0xb2d60d91
50059.24,1.0,3,2,2,4,8,0xb2d3aa2c
520000.0,2.0,0,4,3,4,11,0xb2d97cc7d
1445.12,1.0,2,1,2,4,7,0xb2d5827a
81036.04,3.0,106,3,4,1,8,0xb2d14385
13.3,1.0,27,1,2,2,5,0xb2d9ac77
101021.47,2.0,148,3,3,1,7,0xb2d0efef
803.08,1.0,9,1,2,3,6,0xb2d8da2a
1181216.14,6.0,25,4,4,2,10,0xb2d18645
33.25,1.0,32,1,2,2,5,0xb2d93217
302259.14,1.0,7,4,2,3,9,0xb2d23e7d
173637.86,3.0,3,3,4,4,11,0xb2d33142d
7030.85,1.0,4,2,2,4,8,0xb2d379b0d
285.83,1.0,10,1,2,3,6,0xb2d3a009
87.76,1.0,1,1,2,4,7,0xb2d63939d
2782.05,1.0,227,1,2,1,4,0xb2d07073
330393.95,2.0,20,4,3,2,9,0xb2d250f0
31363.55,1.0,92,2,2,1,5,0xb2d3f71dd
3506.96,1.0,20,2,2,2,6,0xb2d57ee2d
15393.2,1.0,92,2,2,1,5,0xb2d3c141
7898.67,1.0,38,2,2,2,6,0xb2d8fe42d
1957.74,2.0,138,1,3,1,5,0xb2d5041a
100002.11,2.0,53,3,3,2,8,0xb2d9cdb2
1465.22,1.0,184,1,2,1,4,0xb2d2bc1a
1383751.61,2.0,0,4,3,4,11,0xb2d3fddf
50263.43,2.0,0,2,3,4,9,0xb2d3b64ad
1228.38,1.0,0,1,2,4,7,0xb2d9aca3
240716.32,1.0,184,3,2,1,6,0xb2d3fb6ed
364000.83,6.0,0,4,4,4,12,0xb2d6155d
52171.4,1.0,7,3,2,3,8,0xb2d34329
21157.81,2.0,184,2,3,1,6,0xb2d0bf04
150016.91,2.0,118,3,3,1,7,0xb2d709d4d
1.0,1.0,4,1,2,4,7,0xb2d6e9e5
2412.83,1.0,68,1,2,1,4,0xb2d59ef8
17556.19,2.0,0,2,3,4,9,0xb2d06b71
434.21,1.0,10,1,2,3,6,0xb2d8e87d
379.71,1.0,1,1,2,4,7,0xb2d967ce
124830.05,1.0,42,3,2,2,7,0xb2d5e5d5
20001.13,2.0,10,2,3,3,8,0xb2d81504
334.77,1.0,68,1,2,1,4,0xb2d41aa9
280084.61,4.0,9,3,4,3,10,0xb2d128e8
10009.5,1.0,55,2,2,2,6,0xb2d5487c
210413.47,2.0,10,3,3,3,9,0xb2d277e9
1174.42,1.0,92,1,2,1,4,0xb2d131b3
500036.9,3.0,0,4,4,4,12,0xb2d0911c
95474.52,2.0,56,3,3,2,8,0xb2d65e51d
119147.35,2.0,0,3,3,4,10,0xb2d212e2d
290087.19,6.0,27,3,4,2,9,0xb2d0da6a
2975.42,1.0,7,2,2,3,7,0xb2d1a5fc
4011.82,1.0,92,2,2,1,5,0xb2d5fd1b
6002.8,2.0,3,2,3,4,9,0xb2d07fe6
6688.08,1.0,92,2,2,1,5,0xb2d07205
7659.24,1.0,0,2,2,4,8,0xb2d8fec4
6329.94,1.0,92,2,2,1,5,0xb2d4be73
5352.32,1.0,92,2,2,1,5,0xb2d235f4d
1200028.53,3.0,19,4,4,2,10,0xb2d69665d
50660.08,1.0,92,2,2,1,5,0xb2d13303d
100003.34,2.0,118,3,3,1,7,0xb2d1544ed
118.8,2.0,0,1,3,4,8,0xb2d589b5d
12576.48,2.0,13,2,3,3,8,0xb2d581d5
950000.0,3.0,0,4,4,4,12,0xb2d8ea8b
320017.54,3.0,143,4,4,1,9,0xb2d5b4f3d
132.03,3.0,21,1,4,2,7,0xb2d35e85
15000.48,2.0,11,2,3,3,8,0xb2d94a40
603.79,1.0,0,1,2,4,7,0xb2d2d10dd
205689.34,2.0,32,3,3,2,8,0xb2d651ecd
161326.48,4.0,3,3,4,4,11,0xb2d069de
4534.15,2.0,48,2,3,2,7,0xb2d6d8c5d
222.63,1.0,3,1,2,4,7,0xb2d5ee09
4969.9,1.0,3,2,2,4,8,0xb2d573f0
3884.27,1.0,31,2,2,2,6,0xb2d7096d
1014.58,1.0,92,1,2,1,4,0xb2d1457d
4817.71,1.0,9,2,2,3,7,0xb2d30222
1197.37,1.0,3,1,2,4,7,0xb2d78fa6
105230.08,1.0,19,3,2,2,7,0xb2d17bf8
41.48,1.0,0,1,2,4,7,0xb2d6aa3c
26174.5,1.0,29,2,2,2,6,0xb2d1c9fb
19354.59,1.0,5,2,2,3,7,0x3b9b3290d
4894.94,1.0,0,2,2,4,8,0xb2d2ed21d
40000.42,2.0,56,2,3,2,7,0xb2d9c619
11780.6,1.0,10,2,2,3,7,0xb2d2dfa3
1415496.71,7.0,14,4,4,3,11,0xb2d4fef9
2008.4,1.0,92,1,2,1,4,0xb2d55725d
528000.0,8.0,0,4,4,4,12,0xb2d3cf93
11004.73,1.0,0,2,2,4,8,0xb2d68809
500004.72,5.0,11,4,4,3,11,0xb2d439aa
200010.42,2.0,25,3,3,2,8,0xb2d6df97d
160002.32,3.0,186,3,4,1,8,0xb2d716b6d
7531.37,1.0,5,2,2,3,7,0xb2da0a37
100003.17,2.0,206,3,3,1,7,0xb2d68ca2
395604.12,5.0,92,4,4,1,9,0xb2d07851
60002.54,2.0,73,3,3,1,7,0xb2d5984d
12.79,1.0,4,1,2,4,7,0xb2d7172e
140000.0,2.0,3,3,3,4,10,0xb2d9746a
200013.25,2.0,4,3,3,4,10,0xb2d17026d
255689.89,3.0,125,3,4,1,8,0xb2d6dee2
107988.59,1.0,184,3,2,1,6,0xb2d0f243
8025.43,1.0,1,2,2,4,8,0xb2d59262
230230.67,5.0,4,3,4,4,11,0xb2d23217d
866.27,1.0,184,1,2,1,4,0xb2d268d4
0.67,1.0,10,1,2,3,6,0xb2d27882
949101.11,8.0,5,4,4,3,11,0xb2d58068
228086.28,3.0,0,3,4,4,11,0xb2d17caad
200056.56,3.0,34,3,4,2,9,0xb2d12e8a
18296.55,3.0,0,2,4,4,10,0xb2d0d612
700000.0,2.0,21,4,3,2,9,0xb2da257b
200016.49,2.0,12,3,3,3,9,0xb2d51306
19305.36,2.0,0,2,3,4,9,0x3b9b2344
210201.84,2.0,182,3,3,1,7,0xb2d3f448
3328.26,1.0,0,2,2,4,8,0xb2d474ab
100096.5,2.0,21,3,3,2,8,0xb2d623cc
150853.61,2.0,52,3,3,2,8,0xb2d24cac
0.0,1.0,10,1,2,3,6,0xb2d5cf12
200000.0,2.0,0,3,3,4,10,0xb2da3c36
50100.54,2.0,21,2,3,2,7,0xb2da2346
598044.5,7.0,16,4,4,2,10,0xb2d1d9e2
1503279.64,1.0,217,4,2,1,7,0xb2d75374
740000.0,6.0,99,4,4,1,9,0xb2d23b83
66053.9,5.0,104,3,4,1,8,0xb2d0ec08
7394.14,1.0,1,2,2,4,8,0xb2d353f6d
320010.16,3.0,6,4,4,3,11,0xb2d66613
28026.38,1.0,1,2,2,4,8,0xb2d6bf7d
1151.6,1.0,0,1,2,4,7,0xb2d36060
12283.93,1.0,10,2,2,3,7,0xb2d932ad
143032.26,8.0,0,3,4,4,11,0xb2d5699ed
28001.84,2.0,6,2,3,3,8,0xb2d5775bd
1510248.89,3.0,12,4,4,3,11,0xb2d4e3c0d
1711.33,1.0,264,1,2,1,4,0xb2d2cb2bd
500710.47,3.0,5,4,4,3,11,0xb2d9e272
263062.73,11.0,0,3,4,4,11,0xb2d064b5d
502915.64,3.0,27,4,4,2,10,0xb2d68ab6d
211024.08,3.0,10,3,4,3,10,0xb2d63334
27064.61,4.0,3,2,4,4,10,0xb2d7900c
248049.92,1.0,3,3,2,4,9,0xb2d52915d
10030.72,1.0,11,2,2,3,7,0xb2d7911b
292.73,1.0,82,1,2,1,4,0xb2d65485
502066.62,3.0,136,4,4,1,9,0xb2d148ded
8020.88,1.0,18,2,2,2,6,0xb2d5d757d
325478.28,5.0,253,4,4,1,9,0x3b9acf47
50000.53,2.0,18,2,3,2,7,0xb2da3100
229085.05,3.0,39,3,4,2,9,0xb2d3b474
8655.85,1.0,20,2,2,2,6,0xb2d60a81d
9954.64,1.0,0,2,2,4,8,0xb2d3fe43
41533.95,1.0,0,2,2,4,8,0xb2d36271d
16973.0,1.0,0,2,2,4,8,0xb2d205e0
140737.54,3.0,90,3,4,1,8,0xb2d102e6
40294.24,2.0,27,2,3,2,7,0xb2d94ee3
4001.91,1.0,92,2,2,1,5,0x3b9b0e54
56251.46,1.0,4,3,2,4,9,0xb2d9415b
180069.48,2.0,7,3,3,3,9,0xb2d1556a
251310.26,3.0,26,3,4,2,9,0xb2d3dc29
20092.31,2.0,12,2,3,3,8,0xb2d6aa18
264.23,1.0,5,1,2,3,6,0xb2d6af62d
1015.48,1.0,92,1,2,1,4,0xb2d0fe43
303672.4,1.0,203,4,2,1,7,0xb2d0901b
210711.79,4.0,35,3,4,2,9,0xb2d954ec
8334.41,2.0,1,2,3,4,9,0xb2d683e5d
22.24,1.0,25,1,2,2,5,0xb2d6e0f2
50365.86,1.0,81,2,2,1,5,0xb2d5520cd
101178.0,2.0,40,3,3,2,8,0xb2d6ccf4d
1419.08,1.0,92,1,2,1,4,0xb2d1b596
300295.44,3.0,92,4,4,1,9,0x3b9b4754
2263282.11,20.0,0,4,4,4,12,0x3b9ae3ff
250003.89,3.0,62,3,4,2,9,0xb2d27178
10179.2,2.0,13,2,3,3,8,0xb2d69226d
580007.46,3.0,11,4,4,3,11,0xb2d1a642
50005982.89,4.0,8,4,4,3,11,0xb2d61280
20062.77,1.0,307,2,2,1,5,0xb2d654cbd
90087.53,3.0,40,3,4,2,9,0x3b9b2874
49001.03,2.0,18,2,3,2,7,0xb2d781ae
602131.32,4.0,32,4,4,2,10,0xb2d6cf44
470022.02,4.0,13,4,4,3,11,0xb2d11109
288789.16,7.0,1,3,4,4,11,0xb2d36c76
0.31,1.0,35,1,2,2,5,0xb2d5df7a
285289.83,2.0,6,3,3,3,9,0xb2d1ba92
170001.79,3.0,49,3,4,2,9,0xb2d0784b
6060.85,1.0,92,2,2,1,5,0xb2d27b76
33792.25,1.0,0,2,2,4,8,0xb2d31603d
20043.82,1.0,89,2,2,1,5,0xb2d153bfd
80002.98,2.0,53,3,3,2,8,0xb2d119f5
104214.1,1.0,0,3,2,4,9,0xb2d487b9
334953.54,5.0,12,4,4,3,11,0xb2d1aa6c
224157.94,6.0,14,3,4,3,10,0xb2d2613dd
380007.26,3.0,4,4,4,4,12,0xb2d5b74dd
97.54,1.0,21,1,2,2,5,0xb2d90787
15407.99,1.0,184,2,2,1,5,0xb2d3c141d
10655.56,1.0,32,2,2,2,6,0xb2d3a68e
871139.04,6.0,31,4,4,2,10,0xb2d31dbd
969000.0,14.0,1,4,4,4,12,0xb2d4242cd
625003.99,2.0,9,4,3,3,10,0xb2d8c6a4
408.13,1.0,9,1,2,3,6,0xb2d6b7d1
213.06,2.0,19,1,3,2,6,0xb2d9367f
400004.22,2.0,116,4,3,1,8,0xb2d78714
41681.65,1.0,23,2,2,2,6,0x3b9b3789
5.76,1.0,237,1,2,1,4,0xb2d26d67
231.64,1.0,46,1,2,2,5,0xb2d99fda
51.46,1.0,10,1,2,3,6,0xb2d97236
10000.32,2.0,11,2,3,3,8,0xb2d59152
15.83,1.0,67,1,2,1,4,0xb2d6edfe
250008.22,6.0,63,3,4,2,9,0xb2d53cc8d
5517.47,1.0,92,2,2,1,5,0xb2d17637
539.2,1.0,20,1,2,2,5,0xb2d96474
300005.72,4.0,0,3,4,4,11,0xb2d3a2ab
117102.13,3.0,76,3,4,1,8,0xb2d1243c
267530.68,1.0,0,3,2,4,9,0xb2d3c2a1
180014.91,5.0,48,3,4,2,9,0xb2d54f56d
7817.8,1.0,92,2,2,1,5,0xb2d38da2
3030.68,1.0,92,2,2,1,5,0xb2d2ced8
600000.02,3.0,4,4,4,4,12,0xb2d4a59a
18750.9,5.0,10,2,4,3,9,0xb2d2c6e3
3119.74,1.0,216,2,2,1,5,0xb2d27232
800008.45,4.0,10,4,4,3,11,0xb2d2b912
151920.98,2.0,34,3,3,2,8,0xb2d1dafd
6.75,1.0,21,1,2,2,5,0xb2d6f048
286897.26,5.0,4,3,4,4,11,0xb2d8e67dd
40018.67,3.0,181,2,4,1,7,0xb2d40167d
51.15,1.0,90,1,2,1,4,0xb2d5e18d
21555.0,1.0,11,2,2,3,7,0xb2d9bba3
214748.21,2.0,18,3,3,2,8,0xb2d431e1d
85079.58,3.0,53,3,4,2,9,0xb2d5ec61
20396.86,1.0,273,2,2,1,5,0xb2d5f588
7100.32,1.0,89,2,2,1,5,0xb2d6a6af
1291.97,1.0,184,1,2,1,4,0xb2d29461
198370.64,1.0,0,3,2,4,9,0xb2d43704d
25255.38,1.0,16,2,2,2,6,0xb2d6c864d
128007.53,2.0,231,3,3,1,7,0xb2d53a60
100169.52,1.0,19,3,2,2,7,0xb2d3b3e7
424.9,1.0,0,1,2,4,7,0xb2d6355a
150004.43,4.0,92,3,4,1,8,0xb2d6379a
4017.08,1.0,25,2,2,2,6,0xb2d7c0e8
1903624.37,9.0,24,4,4,2,10,0xb2d6ab80
870061.37,6.0,48,4,4,2,10,0xb2d1a404
100001.16,3.0,0,3,4,4,11,0xb2da0306
52.66,1.0,69,1,2,1,4,0xb2d433e7
1035463.84,7.0,6,4,4,3,11,0xb2d09270
53031.61,2.0,196,3,3,1,7,0xb2d0ff84d
2058.36,1.0,8,1,2,3,6,0xb2d28f22
495008.86,3.0,27,4,4,2,10,0xb2d78566
200009.86,2.0,22,3,3,2,8,0xb2d4eb29
501776.08,2.0,42,4,3,2,9,0xb2d9237b
100195.45,4.0,1,3,4,4,11,0xb2d93f57d
12000.25,2.0,80,2,3,1,6,0xb2d98e55
1.84,1.0,83,1,2,1,4,0xb2d65893
1000001.55,4.0,19,4,4,2,10,0xb2d08944
5.21,1.0,25,1,2,2,5,0xb2d944f1d
1184.45,1.0,9,1,2,3,6,0xb2d90597
61941.54,1.0,0,3,2,4,9,0xb2d592bfd
0.0,1.0,0,1,2,4,7,0xb2d5f42d
2249.29,1.0,7,1,2,3,6,0xb2d70585
453760.79,5.0,60,4,4,2,10,0xb2d57878
1000033.36,3.0,0,4,4,4,12,0xb2d8a12e
190000.0,4.0,8,3,4,3,10,0xb2d5f3e6
40795.24,3.0,0,2,4,4,10,0xb2d51eb3
1242997.77,5.0,0,4,4,4,12,0xb2d9259a
1379.41,1.0,7,1,2,3,6,0xb2d94a2f
100008.29,2.0,77,3,3,1,7,0xb2d8d4abd
10042.58,2.0,56,2,3,2,7,0xb2d124e5d
2079294.7,10.0,6,4,4,3,11,0xb2d0a5ce
8950.58,2.0,0,2,3,4,9,0x3b9b484a
219605.75,3.0,25,3,4,2,9,0xb2d15a4ed
2506.43,1.0,215,1,2,1,4,0xb2d56092
549627.37,17.0,0,4,4,4,12,0xb2d07e1dd
524114.26,7.0,1,4,4,4,12,0xb2d83c35
8000.0,2.0,92,2,3,1,6,0xb2d57643
1030502.91,5.0,116,4,4,1,9,0xb2d4c7f4d
0.28,1.0,4,1,2,4,7,0xb2d27427
1000055.13,3.0,0,4,4,4,12,0xb2d503b8d
2401.01,1.0,0,1,2,4,7,0xb2d7025d
6312.78,1.0,184,2,2,1,5,0x3b9acf08d
35.56,1.0,0,1,2,4,7,0xb2d59f5dd
170013.84,3.0,14,3,4,3,10,0xb2d29a38
200000.0,2.0,10,3,3,3,9,0xb2d98faa
400710.63,3.0,8,4,4,3,11,0xb2d0e9aa
60011.91,6.0,7,3,4,3,10,0xb2d65517
10021.38,1.0,47,2,2,2,6,0xb2d90f3dd
103596.5,3.0,25,3,4,2,9,0xb2d5bf70d
0.58,1.0,7,1,2,3,6,0xb2d3c849
204985.76,2.0,225,3,3,1,7,0xb2d2b566d
50002.03,2.0,53,2,3,2,7,0xb2d3d51d
3608.83,1.0,2,2,2,4,8,0xb2d31543d
204279.35,2.0,4,3,3,4,10,0xb2d3784d
350000.0,4.0,0,4,4,4,12,0xb2d8c6c1d
15404.96,3.0,92,2,4,1,7,0xb2d130dc
2273.2,2.0,184,1,3,1,5,0xb2d0716ed
10507.29,1.0,40,2,2,2,6,0xb2d5b6b3d
149031.37,5.0,75,3,4,1,8,0xb2d5833a
9145.95,1.0,92,2,2,1,5,0xb2d25e38
547004.0,8.0,3,4,4,4,12,0xb2d5a29ed
262085.14,4.0,193,3,4,1,8,0xb2d1a20bd
2848.81,1.0,9,1,2,3,6,0xb2d929add
475.2,1.0,2,1,2,4,7,0xb2d47666
100001.06,2.0,10,3,3,3,9,0xb2d96857
1861398.55,23.0,5,4,4,3,11,0xb2d62f64d
9600.14,1.0,2,2,2,4,8,0xb2d128d8
122285.57,2.0,123,3,3,1,7,0xb2d4e773
62746.26,1.0,3,3,2,4,9,0xb2d2d904d
9537.23,1.0,18,2,2,2,6,0xb2d71898d
1500034.59,4.0,6,4,4,3,11,0xb2d07877d
50000.0,6.0,0,2,4,4,10,0xb2d9802f
200000.0,4.0,8,3,4,3,10,0xb2d6ba66
313355.9,8.0,5,4,4,3,11,0xb2d11b2f
1065109.05,3.0,0,4,4,4,12,0xb2d5077dd
406.8,1.0,4,1,2,4,7,0xb2d6bcbf
1704.81,1.0,0,1,2,4,7,0xb2d41639
11.87,1.0,63,1,2,2,5,0xb2d5915c
140672.01,3.0,49,3,4,2,9,0xb2d425e2
0.0,1.0,9,1,2,3,6,0xb2d93c9f
89.76,1.0,1,1,2,4,7,0xb2d1b9e9
90.68,1.0,45,1,2,2,5,0xb2d64e9c
770045.24,1.0,13,4,2,3,9,0xb2d14d11d
463025.94,4.0,4,4,4,4,12,0xb2d1761a
160005.98,18.0,25,3,4,2,9,0x3b9b4362
635043.62,3.0,0,4,4,4,12,0xb2d2b7d0
80026.62,2.0,9,3,3,3,9,0xb2d0eb5dd
0.25,1.0,3,1,2,4,7,0xb2d8d84e
218503.34,1.0,5,3,2,3,8,0xb2d3bec6
4020.2,1.0,16,2,2,2,6,0xb2d41729
160062.52,5.0,42,3,4,2,9,0xb2d0765e
463023.78,3.0,18,4,4,2,10,0xb2d62236
9632.54,1.0,3,2,2,4,8,0xb2d34051
19891.96,1.0,0,2,2,4,8,0xb2d62cea
1446239.51,7.0,62,4,4,2,10,0xb2d145d5d
435114.73,3.0,125,4,4,1,9,0xb2d117b1d
541283.97,10.0,4,4,4,4,12,0xb2d0d7ae
203013.93,9.0,48,3,4,2,9,0xb2d5ab46
18478.42,1.0,0,2,2,4,8,0xb2d6b985
11562.59,1.0,27,2,2,2,6,0xb2d3a92f
550258.0,1.0,3,4,2,4,10,0xb2d414ced
5337.84,1.0,92,2,2,1,5,0xb2d2a0f1
183.1,1.0,147,1,2,1,4,0xb2d45829
117.41,1.0,79,1,2,1,4,0xb2d274cc
100002.43,2.0,14,3,3,3,9,0xb2da01c1
70045.45,2.0,33,3,3,2,8,0xb2d2dc28d
45183.77,1.0,6,2,2,3,7,0xb2d6097f
1933.15,1.0,184,1,2,1,4,0xb2d0fc67
141099.32,7.0,10,3,4,3,10,0xb2d53f54d
60646.96,1.0,98,3,2,1,6,0xb2d31167d
146855.09,4.0,101,3,4,1,8,0xb2d55378d
80902.26,3.0,10,3,4,3,10,0xb2d58dd7
63693.73,1.0,15,3,2,3,8,0xb2d53cd1
85.02,1.0,2,1,2,4,7,0xb2d2663e
5.46,1.0,77,1,2,1,4,0xb2d5b0fa
512683.71,4.0,188,4,4,1,9,0xb2d5e258d
162249.92,3.0,27,3,4,2,9,0xb2d4d11b
33.77,1.0,42,1,2,2,5,0xb2d9ac99
301553.19,1.0,4,4,2,4,10,0xb2d25436d
177044.91,5.0,25,3,4,2,9,0xb2d253d9
1.2,1.0,27,1,2,2,5,0xb2d5bfa4
6750.0,1.0,8,2,2,3,7,0xb2d1bdbbd
0.0,1.0,4,1,2,4,7,0xb2da542d
281001.24,3.0,10,3,4,3,10,0xb2d4b3f1
9639.38,1.0,1,2,2,4,8,0xb2d9f89f
1270842.03,15.0,11,4,4,3,11,0xb2d0e88f
217665.64,7.0,0,3,4,4,11,0x3b9b1845
858884.54,3.0,46,4,4,2,10,0xb2d91d1f
700012.26,4.0,14,4,4,3,11,0xb2d786b1
50001.06,2.0,66,2,3,2,7,0xb2d8ef4dd
400020.3,2.0,35,4,3,2,9,0xb2d5265e
2788.91,1.0,0,1,2,4,7,0xb2d6c45c
245811.77,2.0,8,3,3,3,9,0xb2d3a8b3
295697.45,1.0,14,3,2,3,8,0xb2d444d0
233567.52,3.0,3,3,4,4,11,0xb2d5f69fd
341088.27,3.0,0,4,4,4,12,0xb2d104e7
23338.22,1.0,0,2,2,4,8,0xb2d315f3
3890.84,1.0,2,2,2,4,8,0xb2d8fcb0d
4408.63,1.0,0,2,2,4,8,0xb2d2ff5b
5359.6,2.0,9,2,3,3,8,0xb2d34cc4
452965.86,3.0,49,4,4,2,10,0xb2d19b1a
100003.17,2.0,92,3,3,1,7,0xb2d97d59
20080.53,1.0,46,2,2,2,6,0xb2d5dfa9
35528.0,3.0,6,2,4,3,9,0xb2d5aca0
124870.22,2.0,56,3,3,2,8,0xb2d1a9f3d
1300064.61,8.0,8,4,4,3,11,0xb2d55aba
1000117.54,2.0,10,4,3,3,10,0xb2d9f42b
128.66,1.0,24,1,2,2,5,0xb2d43070
1122941.68,9.0,4,4,4,4,12,0xb2d1234cd
97049.81,2.0,18,3,3,2,8,0xb2d5feb1d
1.8,1.0,9,1,2,3,6,0xb2d2a438
397066.67,2.0,34,4,3,2,9,0xb2d4c04b
62052.58,3.0,179,3,4,1,8,0xb2d589ac
100003.17,2.0,102,3,3,1,7,0xb2d961b9
7115.77,1.0,0,2,2,4,8,0xb2d58a2b
574.02,1.0,14,1,2,3,6,0xb2d1d459
9024.04,1.0,11,2,2,3,7,0xb2d96766
300003.74,4.0,18,3,4,2,9,0xb2d90ba9d
577277.39,7.0,7,4,4,3,11,0xb2d361fed
277.19,1.0,82,1,2,1,4,0xb2d5e5de
10004.49,2.0,34,2,3,2,7,0xb2d5c1c7
200000.0,2.0,3,3,3,4,10,0xb2d97978
800009.48,4.0,8,4,4,3,11,0xb2d526e5d
212438.01,3.0,193,3,4,1,8,0xb2d0fed0
0.04,1.0,1,1,2,4,7,0xb2d4367f
82383.72,2.0,19,3,3,2,8,0xb2d6935a
458307.0,3.0,37,4,4,2,10,0xb2d2d8f2d
1701.82,1.0,18,1,2,2,5,0xb2d8c840
501836.76,2.0,32,4,3,2,9,0xb2d55e3e
11017.56,1.0,4,2,2,4,8,0xb2d8edc9d
150.59,3.0,0,1,4,4,9,0x3b9b39b6
6450.53,1.0,4,2,2,4,8,0xb2d52c24
400506.84,1.0,0,4,2,4,10,0xb2d34df7
4044000.0,1.0,0,4,2,4,10,0xb2d98434
679785.5,5.0,11,4,4,3,11,0xb2d99da7
5898.87,1.0,125,2,2,1,5,0xb2d1818c
150007.43,4.0,98,3,4,1,8,0xb2d6eba9d
253658.91,2.0,3,3,3,4,10,0xb2d6e4c6
100006.24,2.0,231,3,3,1,7,0xb2d61042
1182241.52,9.0,11,4,4,3,11,0x3b9af53a
4331.13,1.0,39,2,2,2,6,0xb2d27701d
460003.07,19.0,4,4,4,4,12,0xb2d4faa4
2306.39,3.0,29,1,4,2,7,0xb2d9d8b1
640000.55,8.0,42,4,4,2,10,0xb2d8cd86d
172.4,1.0,7,1,2,3,6,0xb2d21895d
18754.73,1.0,29,2,2,2,6,0xb2d6cab6d
201219.73,3.0,139,3,4,1,8,0xb2d6d4dc
204346.97,2.0,17,3,3,2,8,0xb2d38a37
574014.15,4.0,27,4,4,2,10,0xb2d176add
460076.78,4.0,15,4,4,3,11,0xb2d43844
20000.84,2.0,92,2,3,1,6,0xb2d64008
110076.86,3.0,92,3,4,1,8,0xb2d13685
4241.96,1.0,41,2,2,2,6,0xb2d41d01
644.08,1.0,2,1,2,4,7,0xb2d24163
1870000.0,7.0,4,4,4,4,12,0xb2d5f5d3
31513.71,1.0,227,2,2,1,5,0xb2d4e78c
3107.82,1.0,184,2,2,1,5,0xb2d55382d
112021.54,3.0,52,3,4,2,9,0xb2d4544dd
50192.85,6.0,121,2,4,1,7,0xb2d162a1d
19123.71,1.0,92,2,2,1,5,0xb2d2554cd
73.23,1.0,14,1,2,3,6,0xb2d5effd
2747.72,1.0,3,1,2,4,7,0xb2d29b80
5843.64,1.0,7,2,2,3,7,0xb2d45ac5
393033.53,2.0,7,4,3,3,10,0xb2d649df
178008.14,3.0,11,3,4,3,10,0xb2d5d2af
296.69,1.0,11,1,2,3,6,0xb2d243f8
20228.24,1.0,4,2,2,4,8,0xb2d47bea
965026.85,11.0,1,4,4,4,12,0x3b9b387ed
942336.51,8.0,14,4,4,3,11,0xb2d10057
400014.79,3.0,10,4,4,3,11,0xb2d68263
130620.83,4.0,24,3,4,2,9,0xb2d4c5e6
1461.39,1.0,0,1,2,4,7,0xb2d8e465
350072.05,10.0,9,4,4,3,11,0xb2d54a97
8626.89,2.0,0,2,3,4,9,0xb2d298c8
25354.6,1.0,2,2,2,4,8,0xb2d5ea61
39489.57,1.0,18,2,2,2,6,0xb2d25b09
270040.62,4.0,32,3,4,2,9,0xb2d0c27d
58.78,1.0,294,1,2,1,4,0xb2d3654d
1028.8,1.0,92,1,2,1,4,0xb2d403ee
49.71,1.0,10,1,2,3,6,0xb2d6f815
3535.55,2.0,211,2,3,1,6,0xb2d2fac5
4633.12,1.0,92,2,2,1,5,0xb2d20ef8
2009.1,1.0,184,1,2,1,4,0xb2d48aed
4853.77,3.0,92,2,4,1,7,0x3b9b2c85
16403.89,1.0,92,2,2,1,5,0x3b9af42ed
261786.35,3.0,50,3,4,2,9,0xb2d62cfc
800850.09,6.0,7,4,4,3,11,0xb2d52ea5d
43651.37,1.0,10,2,2,3,7,0xb2d8e902
4947.67,2.0,22,2,3,2,7,0xb2d9367fd
50065.18,2.0,139,2,3,1,6,0xb2d23498
177021.75,4.0,144,3,4,1,8,0xb2d1d24cd
859.24,1.0,25,1,2,2,5,0xb2d93842
301098.01,2.0,0,4,3,4,11,0xb2d5df06d
471025.48,4.0,76,4,4,1,9,0xb2d1c351d
351043.34,4.0,139,4,4,1,9,0xb2d06f5b
11941.26,2.0,0,2,3,4,9,0xb2d1192ad
20011.32,2.0,10,2,3,3,8,0xb2d1f0d4
431845.9,3.0,18,4,4,2,10,0xb2d5b569
2.34,1.0,33,1,2,2,5,0xb2d5d0a5
1200005.9,3.0,21,4,4,2,10,0xb2d548c7
850108.31,6.0,25,4,4,2,10,0xb2d249cb
290013.31,2.0,136,3,3,1,7,0xb2d637b7
800.0,6.0,0,1,4,4,9,0xb2d2dd4e
1747.99,1.0,1,1,2,4,7,0xb2d93863
3591.42,1.0,83,2,2,1,5,0xb2d25f5bd
18.75,4.0,14,1,4,3,8,0xb2d3609b
147360.64,5.0,0,3,4,4,11,0xb2d20f9ed
104018.25,2.0,18,3,3,2,8,0xb2d2ceb1
312.58,1.0,1,1,2,4,7,0xb2d6ffd9
200062.59,2.0,11,3,3,3,9,0xb2d81e4c
20000.21,2.0,28,2,3,2,7,0xb2da0a8b
9443.26,1.0,0,2,2,4,8,0xb2d6d07a
300000.42,2.0,4,3,3,4,10,0xb2d28518d
844.63,1.0,15,1,2,3,6,0xb2d08cfcd
4444.08,1.0,9,2,2,3,7,0xb2d2ac8f
415010.08,6.0,1,4,4,4,12,0xb2d24ca8d
1568680.5,2.0,221,4,3,1,8,0x3b9b3882
500155.56,6.0,4,4,4,4,12,0xb2d3bd3a
1889.0,1.0,132,1,2,1,4,0xb2d5811e
1041.97,1.0,184,1,2,1,4,0xb2d34d70d
10292.48,2.0,1,2,3,4,9,0x3b9b3549d
20001.24,2.0,63,2,3,2,7,0xb2d98ccf
10000.32,2.0,60,2,3,2,7,0xb2d9ba75
367002.4,4.0,70,4,4,1,9,0xb2d61558
370051.35,4.0,1,4,4,4,12,0xb2d6375fd
640205.44,1.0,0,4,2,4,10,0xb2d8c94d
111004.13,3.0,42,3,4,2,9,0xb2d1e79fd
3670021.26,4.0,0,4,4,4,12,0xb2d8a679d
3421961.77,14.0,4,4,4,4,12,0xb2d20fde
369589.83,3.0,33,4,4,2,10,0xb2d5200f
10421.95,2.0,0,2,3,4,9,0x3b9af2c0
3535.48,1.0,95,2,2,1,5,0xb2d10db4
600035.5,2.0,144,4,3,1,8,0xb2d3515dd
320104.33,4.0,20,4,4,2,10,0xb2d614b2d
2.86,1.0,16,1,2,2,5,0xb2d37c55
402172.17,3.0,74,4,4,1,9,0xb2d65e04d
2050.31,1.0,10,1,2,3,6,0xb2d8a988
50095.5,2.0,20,2,3,2,7,0xb2d5b7e6
244866.78,3.0,11,3,4,3,10,0xb2d3f3a5
10355.53,1.0,7,2,2,3,7,0xb2d6255d
327575.93,3.0,31,4,4,2,10,0xb2d58a32d
50176.3,2.0,66,2,3,2,7,0xb2d5b6ddd
1146.75,2.0,62,1,3,2,6,0xb2d63ffed
1100.48,1.0,92,1,2,1,4,0xb2d13121
815026.72,6.0,1,4,4,4,12,0xb2d244c9d
202327.07,3.0,172,3,4,1,8,0xb2d6536b
109025.8,1.0,209,3,2,1,6,0xb2d2b6bad
1337693.73,6.0,33,4,4,2,10,0xb2d5eb5ed
50007.89,2.0,31,2,3,2,7,0xb2d204c4
465.45,9.0,6,1,4,3,8,0xb2d11eb0
13595.32,1.0,6,2,2,3,7,0xb2d3a269
2254.28,1.0,184,1,2,1,4,0xb2d320a1
38.81,1.0,10,1,2,3,6,0xb2d6a952
261356.04,3.0,132,3,4,1,8,0xb2d1a120
73172.41,1.0,10,3,2,3,8,0xb2d2aaa2
1916.69,1.0,92,1,2,1,4,0xb2d1c03f
102.54,1.0,7,1,2,3,6,0xb2d88a64
21705.86,1.0,10,2,2,3,7,0xb2d48696d
1896.02,2.0,0,1,3,4,8,0xb2d14961
682668.78,6.0,31,4,4,2,10,0xb2d4d916
6791.41,1.0,10,2,2,3,7,0xb2d5d31b
242939.41,2.0,30,3,3,2,8,0xb2d6ef24d
278.23,1.0,10,1,2,3,6,0xb2d5e194
202842.85,2.0,124,3,3,1,7,0xb2d93d47
3013.56,2.0,97,2,3,1,6,0xb2d2d47f
4456.97,1.0,45,2,2,2,6,0xb2d366a2
673032.67,10.0,3,4,4,4,12,0xb2d1b67c
534793.99,3.0,4,4,4,4,12,0xb2d6d5f9
50271.84,4.0,8,2,4,3,9,0xb2d68782
1200013.3,6.0,69,4,4,1,9,0xb2d367f8
2084.22,2.0,17,1,3,2,6,0xb2d09191
221563.21,2.0,43,3,3,2,8,0xb2d8e6e1d
500017.94,3.0,14,4,4,3,11,0xb2d9c950
1321.57,2.0,184,1,3,1,5,0xb2d0a669d
587.44,1.0,85,1,2,1,4,0xb2d202f2
210018.62,2.0,83,3,3,1,7,0xb2d282c3
10109.46,1.0,184,2,2,1,5,0xb2d18e63d
1992.0,1.0,10,1,2,3,6,0xb2d42e48
40514.06,1.0,85,2,2,1,5,0xb2d86fbd
20000.21,2.0,13,2,3,3,8,0xb2d95ea3
222410.78,3.0,5,3,4,3,10,0xb2d9e5a5
4.53,1.0,18,1,2,2,5,0xb2d331ef
210977.31,3.0,12,3,4,3,10,0xb2d5b5e7
120599.9,5.0,0,3,4,4,11,0xb2d5f6bb
1167304.88,4.0,15,4,4,3,11,0xb2d0763a
112088.13,2.0,2,3,3,4,10,0xb2d5ee5a
52.96,1.0,10,1,2,3,6,0xb2d2efd3
27412.69,1.0,15,2,2,3,7,0xb2d6845c
3004.94,1.0,0,2,2,4,8,0xb2d912c4d
95413.85,2.0,104,3,3,1,7,0xb2d4256d
480031.7,2.0,73,4,3,1,8,0xb2d550e9
5406.92,1.0,1,2,2,4,8,0xb2d94e26
42.41,1.0,17,1,2,2,5,0xb2d31eaa
3.42,3.0,4,1,4,4,9,0xb2d0f701d
11500.0,1.0,0,2,2,4,8,0xb2d6ec76
640004.64,3.0,31,4,4,2,10,0xb2d1f457
502688.0,3.0,50,4,4,2,10,0xb2d68223
900.01,1.0,23,1,2,2,5,0xb2d25b21
250050.0,2.0,19,3,3,2,8,0xb2da2b28
200077.24,3.0,27,3,4,2,9,0xb2d90cd8
1601030.0,3.0,25,4,4,2,10,0xb2d9c779
586307.14,4.0,123,4,4,1,9,0xb2d0c21d
2443.42,4.0,0,1,4,4,9,0x3b9b3f59
174.41,1.0,5,1,2,3,6,0xb2d12f8c
10990.19,1.0,97,2,2,1,5,0xb2d67ee0
109348.41,2.0,110,3,3,1,7,0xb2d2ff49
102439.97,2.0,105,3,3,1,7,0xb2d503ce
496199.25,3.0,1,4,4,4,12,0xb2d072afd
2257.62,1.0,92,1,2,1,4,0xb2d1b524d
235.94,1.0,67,1,2,1,4,0xb2d176a6
1.81,1.0,9,1,2,3,6,0xb2d2cfd5
153054.32,1.0,67,3,2,1,6,0xb2d6d1cf
58.62,1.0,9,1,2,3,6,0xb2d957bd
657835.53,20.0,0,4,4,4,12,0xb2d09505
32589.7,4.0,0,2,4,4,10,0x3b9b472cd
301123.98,8.0,1,4,4,4,12,0xb2d2f072
9368.68,1.0,4,2,2,4,8,0xb2d30ee8
3100.93,1.0,146,2,2,1,5,0xb2d2e742
300066.85,2.0,7,3,3,3,9,0xb2d903a4
0.98,1.0,14,1,2,3,6,0xb2d698a3
12.42,5.0,33,1,4,2,7,0xb2d991e8
1239.41,1.0,184,1,2,1,4,0xb2d152ee
174018.77,3.0,4,3,4,4,11,0xb2d57e83
1793.33,1.0,9,1,2,3,6,0xb2d96f79d
162327.49,7.0,25,3,4,2,9,0xb2d41dbe
10043.13,1.0,92,2,2,1,5,0xb2d53d3cd
1000103.71,2.0,0,4,3,4,11,0xb2d6ff8d
17.02,2.0,4,1,3,4,8,0xb2da3a24
120005.37,2.0,63,3,3,2,8,0xb2d2a5b5d
2423.34,1.0,203,1,2,1,4,0xb2d3e5f6
90094.63,3.0,12,3,4,3,10,0xb2d5536a
100000.0,1.0,7,3,2,3,8,0xb2d37916
5010.41,1.0,206,2,2,1,5,0xb2d6922f
46029.62,1.0,112,2,2,1,5,0xb2d4877ed
1564.44,1.0,214,1,2,1,4,0xb2d457c2d
100019.3,2.0,11,3,3,3,9,0xb2d60666
145103.62,4.0,67,3,4,1,8,0xb2d1f955d
5720.2,1.0,0,2,2,4,8,0xb2d2ac91
603.19,1.0,0,1,2,4,7,0xb2d0dee6
357.1,2.0,89,1,3,1,5,0xb2d24342
39.9,1.0,46,1,2,2,5,0xb2d90364
22085.06,3.0,14,2,4,3,9,0xb2d94588
17339.59,1.0,9,2,2,3,7,0xb2d6fa11
400004.22,2.0,63,4,3,2,9,0xb2d9b7c6
159.85,1.0,32,1,2,2,5,0xb2d2e970
2858.58,1.0,92,1,2,1,4,0xb2d19cff
27539.15,1.0,1,2,2,4,8,0xb2d2df6c
300010.96,4.0,0,3,4,4,11,0xb2d5b10c
2484.13,1.0,16,1,2,2,5,0xb2d4095d
281577.62,4.0,3,3,4,4,11,0xb2d4292b
32672.25,2.0,2,2,3,4,9,0x3b9af24f
80023.54,2.0,53,3,3,2,8,0xb2d5677ed
64532.36,2.0,6,3,3,3,9,0xb2d2eca1
38998.41,4.0,0,2,4,4,10,0xb2d4e7e7
16181.46,1.0,1,2,2,4,8,0xb2d36b9b
1100000.61,1.0,1,4,2,4,10,0xb2d1fc31
1703.81,1.0,92,1,2,1,4,0xb2d5404ad
100004.22,2.0,224,3,3,1,7,0xb2d6f8ab
200010.46,2.0,15,3,3,3,9,0xb2d9d7b2
3912.86,2.0,0,2,3,4,9,0xb2d0d237
170369.8,2.0,77,3,3,1,7,0xb2d62581
31001.0,2.0,0,2,3,4,9,0xb2d970b8d
5231.26,1.0,2,2,2,4,8,0xb2d37d0b
380034.48,7.0,8,4,4,3,11,0xb2d1e0db
2062707.14,3.0,7,4,4,3,11,0xb2d130b0
4520.78,1.0,0,2,2,4,8,0xb2d6d069
50005.45,2.0,62,2,3,2,7,0xb2d5b70cd
437103.31,20.0,1,4,4,4,12,0xb2d48cdbd
1180102.21,4.0,8,4,4,3,11,0xb2d96e79
23501.71,1.0,131,2,2,1,5,0xb2d581c4
100011.14,2.0,147,3,3,1,7,0xb2d3ac49
1001957.45,5.0,38,4,4,2,10,0xb2d78b82d
445000.0,4.0,4,4,4,4,12,0xb2d5fb66
1373.24,1.0,143,1,2,1,4,0xb2d6901a
224000.0,2.0,1,3,3,4,10,0xb2da35af
50943.0,1.0,3,2,2,4,8,0xb2d39585
11543.77,1.0,10,2,2,3,7,0xb2d2e24cd
235904.84,2.0,11,3,3,3,9,0xb2d983f3
208655.02,5.0,0,3,4,4,11,0x3b9b242d
2563470.01,2.0,122,4,3,1,8,0xb2d7789ed
3.04,1.0,76,1,2,1,4,0xb2d6255dd
503697.29,3.0,92,4,4,1,9,0xb2d62b36d
73003.08,2.0,98,3,3,1,7,0xb2d96c74d
3600.65,1.0,2,2,2,4,8,0xb2d9423bd
740021.11,3.0,20,4,4,2,10,0xb2d94da6
1025283.71,4.0,13,4,4,3,11,0xb2d432d6
50036.76,2.0,51,2,3,2,7,0xb2d6b404
2.61,1.0,75,1,2,1,4,0xb2d65923d
387.32,1.0,7,1,2,3,6,0xb2d94bc4d
220000.21,3.0,14,3,4,3,10,0xb2d9228bd
105005.91,2.0,82,3,3,1,7,0xb2d8c9d0
200005.05,2.0,156,3,3,1,7,0xb2d8d5ed
1003557.36,2.0,39,4,3,2,9,0xb2d777c7
32518.88,1.0,5,2,2,3,7,0xb2d51b66
15005.34,2.0,213,2,3,1,6,0xb2d685acd
1996.45,1.0,4,1,2,4,7,0xb2d8d55b
10041.52,2.0,88,2,3,1,6,0xb2d90aca
300000.0,2.0,7,3,3,3,9,0xb2d96e71d
1042.96,1.0,184,1,2,1,4,0xb2d2018cd
496.19,1.0,2,1,2,4,7,0xb2d835fb
466008.76,2.0,109,4,3,1,8,0xb2d65c50
360816.73,6.0,21,4,4,2,10,0xb2d16d50d
222712.77,3.0,1,3,4,4,11,0xb2d24da5
2191.77,1.0,208,1,2,1,4,0xb2d45b1f
1939.23,1.0,1,1,2,4,7,0xb2d3cd1f
70238.7,3.0,130,3,4,1,8,0xb2d1ca9f
257830.13,3.0,16,3,4,2,9,0xb2d206d0d
200027.05,3.0,34,3,4,2,9,0xb2d3e44c
1908.71,1.0,92,1,2,1,4,0xb2d2bac0
440212.52,3.0,20,4,4,2,10,0xb2d95465d
51144.64,5.0,53,2,4,2,8,0xb2d557e7
320391.9,3.0,1,4,4,4,12,0xb2d51e30d
8228.85,1.0,0,2,2,4,8,0xb2d0ee2ed
3701.34,1.0,92,2,2,1,5,0xb2d29c53
1226171.26,5.0,70,4,4,1,9,0xb2d1cf34d
42.35,1.0,21,1,2,2,5,0xb2d21556
352.83,1.0,57,1,2,2,5,0xb2d1bf5a
129.37,2.0,58,1,3,2,6,0xb2d5edb5
220646.54,2.0,9,3,3,3,9,0xb2d2fb5e
6.39,1.0,10,1,2,3,6,0xb2d20813
120003.93,6.0,11,3,4,3,10,0xb2d69afe
11248.22,1.0,119,2,2,1,5,0xb2d1c965
7093684.14,2.0,1,4,3,4,11,0xb2d429b4
33252.75,2.0,7,2,3,3,8,0xb2d0b746d
3217.4,1.0,0,2,2,4,8,0xb2d6efc7d
5.61,1.0,10,1,2,3,6,0xb2d2c8b0
205746.23,6.0,55,3,4,2,9,0xb2d20308d
2.01,1.0,15,1,2,3,6,0xb2d9d542
402842.29,2.0,77,4,3,1,8,0xb2d99773
2448807.46,2.0,67,4,3,1,8,0xb2d6867b
7158.77,1.0,8,2,2,3,7,0xb2d0d672
1064.27,1.0,301,1,2,1,4,0xb2d5e75d
2.64,1.0,20,1,2,2,5,0xb2d94adb
10336.85,1.0,0,2,2,4,8,0xb2d6e7e5d
142261.55,3.0,2,3,4,4,11,0xb2d38cbd
821.86,1.0,88,1,2,1,4,0xb2d14f90
100021.7,2.0,18,3,3,2,8,0xb2d26c26d
4829.78,1.0,92,2,2,1,5,0xb2d1ef2d
2868.3,2.0,184,1,3,1,5,0x3b9b3410d
100633.73,3.0,12,3,4,3,10,0xb2d1b0ff
120000.95,5.0,3,3,4,4,11,0xb2d0c1dbd
7508.47,2.0,92,2,3,1,6,0xb2d17800
4234.25,1.0,0,2,2,4,8,0xb2d2124c
100099.14,2.0,92,3,3,1,7,0xb2d979fd
275445.44,1.0,1,3,2,4,9,0xb2d52cc4d
2601.22,1.0,16,1,2,2,5,0xb2d8de15
353335.89,5.0,63,4,4,2,10,0xb2d5e7c9
8795.66,1.0,139,2,2,1,5,0xb2d63808d
116.38,1.0,6,1,2,3,6,0xb2d95fc9
8523.35,1.0,0,2,2,4,8,0xb2d50bcc
1007.98,1.0,121,1,2,1,4,0xb2d16061
370060.18,6.0,14,4,4,3,11,0xb2d64881
418930.55,4.0,0,4,4,4,12,0xb2d239abd
105027.1,2.0,92,3,3,1,7,0xb2d26129
156284.74,2.0,235,3,3,1,7,0xb2d3b5b2d
23238.34,1.0,6,2,2,3,7,0xb2d3878ed
4938.97,1.0,12,2,2,3,7,0xb2d39c35
1679.66,1.0,33,1,2,2,5,0xb2d8dac0
5228.02,1.0,1,2,2,4,8,0xb2d2cfe0
11717.1,1.0,8,2,2,3,7,0xb2d609ddd
10004.92,2.0,20,2,3,2,7,0xb2d71827d
991.0,1.0,2,1,2,4,7,0xb2d91224
1258.51,2.0,13,1,3,3,7,0xb2d6a3e4
107106.56,2.0,4,3,3,4,10,0xb2d4243c
22223.24,1.0,5,2,2,3,7,0xb2d18d28d
8.01,1.0,12,1,2,3,6,0xb2d39099d
55033.51,7.0,101,3,4,1,8,0xb2d0aa8a
5321.79,1.0,184,2,2,1,5,0xb2d29d8cd
60.97,1.0,4,1,2,4,7,0xb2d473b2d
1767.56,1.0,157,1,2,1,4,0xb2d8f4fb
20477.86,2.0,154,2,3,1,6,0xb2d5d3d1
40115.81,2.0,0,2,3,4,9,0xb2d6225dd
289395.03,1.0,4,3,2,4,9,0xb2d1238cd
99020.61,1.0,2,3,2,4,9,0xb2d6b553d
57.43,1.0,7,1,2,3,6,0xb2d355a6d
500000.0,2.0,0,4,3,4,11,0xb2da6846
88002.51,3.0,27,3,4,2,9,0xb2d9940e
504631.18,4.0,27,4,4,2,10,0xb2d92476d
1244.26,1.0,181,1,2,1,4,0xb2d52bb9d
2171.19,3.0,0,1,4,4,9,0xb2d2082c
211.11,1.0,62,1,2,2,5,0xb2d9a7e1
400177.77,3.0,17,4,4,2,10,0xb2d6f24cd
191702.78,5.0,0,3,4,4,11,0xb2d3e5a3
500000.0,2.0,0,4,3,4,11,0xb2da691b
8572.12,2.0,184,2,3,1,6,0xb2d39f1f
1688.99,2.0,10,1,3,3,7,0x3b9b29c9d
1844581.66,21.0,18,4,4,2,10,0xb2d08142d
1547379.51,4.0,0,4,4,4,12,0xb2d3db5f
41.83,1.0,45,1,2,2,5,0xb2d5f648d
13.73,1.0,77,1,2,1,4,0xb2d88a2d
1.32,1.0,76,1,2,1,4,0xb2d16002d
84048.9,1.0,0,3,2,4,9,0xb2d6b737d
82.34,1.0,98,1,2,1,4,0xb2d6110e
647542.89,5.0,11,4,4,3,11,0xb2d3e437
480290.37,6.0,0,4,4,4,12,0xb2d25a21
194729.32,8.0,27,3,4,2,9,0xb2d92e8dd
20101.17,2.0,111,2,3,1,6,0xb2d7892d
1691114.0,11.0,1,4,4,4,12,0xb2d0a1b9
14043.75,1.0,20,2,2,2,6,0xb2d99c08
2178.89,1.0,92,1,2,1,4,0xb2d23a69
700012.88,4.0,3,4,4,4,12,0xb2d8e34a
52300.87,2.0,199,3,3,1,7,0xb2d2ce80
0.02,1.0,47,1,2,2,5,0xb2d94e12
645179.11,8.0,8,4,4,3,11,0xb2d45278
210082.0,9.0,1,3,4,4,11,0xb2d66a11
605241.8,7.0,7,4,4,3,11,0xb2d26a71
56.7,1.0,1,1,2,4,7,0xb2d58dee
1926.15,1.0,184,1,2,1,4,0xb2d47083d
195100.64,4.0,38,3,4,2,9,0xb2d259b7
523041.52,4.0,70,4,4,1,9,0xb2d5ab1b
126346.98,5.0,0,3,4,4,11,0x3b9b2f0b
110009.57,2.0,102,3,3,1,7,0xb2d60e63d
1000155.51,2.0,1,4,3,4,11,0xb2d97b81
872921.03,7.0,0,4,4,4,12,0xb2d268c7
150016.84,2.0,95,3,3,1,7,0xb2d1b7db
201420.01,2.0,17,3,3,2,8,0xb2d9b78a
1493.5,1.0,184,1,2,1,4,0xb2d406e5
600.16,3.0,0,1,4,4,9,0xb2d067eb
12115.96,1.0,184,2,2,1,5,0xb2d1f710
14595.73,2.0,0,2,3,4,9,0x3b9b45d8
16849.75,1.0,184,2,2,1,5,0xb2d2106fd
4691.93,1.0,0,2,2,4,8,0xb2d4f5ce
30252.87,2.0,9,2,3,3,8,0xb2d86719
220006.23,8.0,69,3,4,1,8,0xb2d06a4c
1352.33,1.0,92,1,2,1,4,0xb2d2655e
1021858.18,2.0,25,4,3,2,9,0xb2d937c7
206184.88,2.0,101,3,3,1,7,0xb2d21d71
126012.05,2.0,63,3,3,2,8,0xb2d35bbed
250042.31,2.0,122,3,3,1,7,0xb2d56a5f
125.42,1.0,10,1,2,3,6,0xb2d6f384
474081.12,2.0,11,4,3,3,10,0xb2d43853
375000.0,5.0,0,4,4,4,12,0xb2d580ca
200000.0,2.0,22,3,3,2,8,0xb2da20bb
100003.17,2.0,80,3,3,1,7,0xb2d988c1
1480000.0,3.0,0,4,4,4,12,0xb2d0d450
205725.83,4.0,0,3,4,4,11,0xb2d5edfbd
2452.08,1.0,0,1,2,4,7,0xb2d5d299
180091.71,4.0,0,3,4,4,11,0xb2d22d2f
558461.72,3.0,29,4,4,2,10,0xb2d32494d
288817.48,11.0,18,3,4,2,9,0xb2d6af45
6497.67,1.0,184,2,2,1,5,0x3b9b3030
5598.16,1.0,0,2,2,4,8,0xb2d0b145d
46.52,2.0,7,1,3,3,7,0x3b9b3c47
100424.69,4.0,3,3,4,4,11,0xb2d6b6da
7.5,1.0,6,1,2,3,6,0xb2d3912d
5036.65,1.0,92,2,2,1,5,0xb2d2add1
51060.62,2.0,28,2,3,2,7,0xb2d8fa67
132231.68,2.0,139,3,3,1,7,0xb2d62b16d
1416.58,1.0,9,1,2,3,6,0xb2d56c9e
603422.55,3.0,80,4,4,1,9,0xb2d5db75
6828301.27,5.0,0,4,4,4,12,0xb2d905c0d
1918993.18,6.0,7,4,4,3,11,0xb2d56fb2
499.05,1.0,26,1,2,2,5,0xb2d1d6e7
126.67,1.0,4,1,2,4,7,0xb2d99a23
19.52,1.0,60,1,2,2,5,0xb2d5e7cb
100913.37,2.0,189,3,3,1,7,0xb2d3606b
100434.15,1.0,5,3,2,3,8,0xb2d1757ad
501075.18,3.0,21,4,4,2,10,0xb2d6b2ef
82000.87,2.0,63,3,3,2,8,0xb2d9b841
500003.8,2.0,6,4,3,3,10,0xb2d28ec1
300119.84,2.0,92,4,3,1,8,0xb2d4446fd
4331.07,3.0,60,2,4,2,8,0xb2d6330b
25000.0,1.0,5,2,2,3,7,0xb2d6f20d
105267.91,3.0,39,3,4,2,9,0xb2d4ec12d
80371.43,1.0,152,3,2,1,6,0xb2d2cbb4
279458.4,2.0,9,3,3,3,9,0xb2d2aef3
15819.73,1.0,0,2,2,4,8,0xb2d6c051
100001.06,2.0,56,3,3,2,8,0xb2d9c5ef
318352.26,4.0,1,4,4,4,12,0xb2d1222d
8065.59,1.0,0,2,2,4,8,0xb2d0d222
163742.72,1.0,0,3,2,4,9,0xb2d3cbe6
675851.08,4.0,118,4,4,1,9,0xb2d0ce33
580042.86,2.0,11,4,3,3,10,0xb2d95b45d
500000.0,2.0,6,4,3,3,10,0xb2d96e9a
13904.37,1.0,0,2,2,4,8,0xb2d3db80
20804.72,1.0,74,2,2,1,5,0xb2d5ec54
250008.54,3.0,129,3,4,1,8,0xb2d1bbcfd
0.0,2.0,83,1,3,1,5,0xb2d53a6f
14426.73,1.0,2,2,2,4,8,0xb2d32782d
647060.96,3.0,0,4,4,4,12,0xb2d281e2
8156.97,1.0,0,2,2,4,8,0xb2d6ceb2
164979.92,3.0,70,3,4,1,8,0xb2d267c0
51500.96,1.0,102,2,2,1,5,0xb2d5d535
143594.01,1.0,10,3,2,3,8,0xb2d5d6e1d
0.0,1.0,2,1,2,4,7,0xb2d53c28
86083629.37,7.0,0,4,4,4,12,0xb2d65892d
550010.0,3.0,60,4,4,2,10,0xb2d61b20d
51900.04,2.0,18,2,3,2,7,0xb2d3d564
3800000.0,15.0,6,4,4,3,11,0xb2d176a7
4989.05,1.0,0,2,2,4,8,0xb2d3ed9e
98006.41,3.0,27,3,4,2,9,0xb2d63465
231769.59,2.0,132,3,3,1,7,0xb2d22c8d
376.62,1.0,10,1,2,3,6,0xb2d96adc
46120.57,3.0,18,2,4,2,8,0xb2d5e0d3
35003.66,2.0,60,2,3,2,7,0xb2d6e309
70888.93,1.0,60,3,2,2,7,0xb2d32571d
471621.57,1.0,92,4,2,1,7,0xb2d2094ed
641804.9,15.0,1,4,4,4,12,0x3b9af203
5813.51,1.0,2,2,2,4,8,0xb2d470f4
4.85,1.0,71,1,2,1,4,0xb2d12734
10000.14,2.0,92,2,3,1,6,0xb2d632d8
200000.0,2.0,6,3,3,3,9,0xb2da5773
252358.8,2.0,0,3,3,4,10,0xb2d39b08
692645.51,4.0,1,4,4,4,12,0xb2d9c630
50000.53,3.0,6,2,4,3,9,0xb2d96cd4
5248.11,1.0,139,2,2,1,5,0xb2d5b53f
250000.0,6.0,4,3,4,4,11,0xb2d28ed7
28418.49,1.0,18,2,2,2,6,0xb2d69530d
500007.67,3.0,1,4,4,4,12,0xb2d951f8
105649461.65,9.0,15,4,4,3,11,0xb2d5169cd
2117.15,1.0,92,1,2,1,4,0xb2d1ccc1
100011.84,3.0,83,3,4,1,8,0xb2d8c5e3
125009.33,3.0,6,3,4,3,10,0xb2d5705e
3861.49,1.0,8,2,2,3,7,0xb2d2fdfc
70424.07,1.0,184,3,2,1,6,0xb2d3b626
58370.02,3.0,92,3,4,1,8,0x3b9b2db8
1323160.92,5.0,13,4,4,3,11,0xb2d5ea40
258829.67,7.0,0,3,4,4,11,0xb2d630b9
3005.57,1.0,186,2,2,1,5,0xb2d8a1f6d
92.69,1.0,10,1,2,3,6,0xb2d9643b
1012304.44,4.0,0,4,4,4,12,0xb2d18f35
320190.86,4.0,13,4,4,3,11,0xb2d074b5
23786.6,1.0,82,2,2,1,5,0xb2d57ebb
0.0,1.0,4,1,2,4,7,0xb2d6a1f8
748024.04,4.0,8,4,4,3,11,0xb2d3bd4d
1405.98,1.0,184,1,2,1,4,0xb2d0d873d
122.35,1.0,0,1,2,4,7,0xb2d43a46
574.46,1.0,13,1,2,3,6,0xb2d62a0c
13.72,1.0,35,1,2,2,5,0xb2d606c3
283112.24,4.0,26,3,4,2,9,0xb2d4090f
95017.75,3.0,151,3,4,1,8,0xb2d643b4d
92.17,3.0,16,1,4,2,7,0xb2d11a32
20000.21,2.0,231,2,3,1,6,0xb2d649d4
4158.19,1.0,0,2,2,4,8,0xb2d3b0f3d
12.14,1.0,33,1,2,2,5,0xb2d950e0
841901.64,2.0,27,4,3,2,9,0xb2d35d49
17.57,1.0,73,1,2,1,4,0xb2d2c25f
662302.75,7.0,3,4,4,4,12,0xb2d1410a
331646.08,2.0,11,4,3,3,10,0xb2d5f7add
133150.21,4.0,14,3,4,3,10,0xb2d132cc
0.07,1.0,4,1,2,4,7,0xb2d3b569
113552.31,2.0,18,3,3,2,8,0xb2d69a8dd
0.0,1.0,1,1,2,4,7,0xb2d2fab5
220288.2,2.0,53,3,3,2,8,0xb2d176e1d
57398.9,1.0,92,3,2,1,6,0xb2d398dbd
540000.0,4.0,6,4,4,3,11,0xb2d0fb98
1.38,1.0,67,1,2,1,4,0xb2d956e3
14.32,1.0,5,1,2,3,6,0xb2d2c0b3
19070.07,1.0,3,2,2,4,8,0xb2d5f91c
76836.9,2.0,5,3,3,3,9,0xb2d21aa3
3057.03,1.0,29,2,2,2,6,0xb2d92d24
601177.84,4.0,0,4,4,4,12,0xb2d281f3d
105854.65,2.0,87,3,3,1,7,0xb2d323e7d
14025.89,1.0,92,2,2,1,5,0xb2d53489d
404055.82,4.0,1,4,4,4,12,0xb2d22b0c
530052.09,5.0,101,4,4,1,9,0xb2d06427
4415.2,1.0,60,2,2,2,6,0xb2d5dfc8d
274010.25,5.0,60,3,4,2,9,0xb2d4329e
414443.39,12.0,0,4,4,4,12,0xb2d090cad
14775.06,1.0,3,2,2,4,8,0xb2d6e7edd
10211.59,2.0,263,2,3,1,6,0xb2d1a5b0d
3449189.87,3.0,1,4,4,4,12,0xb2d14835
241.76,1.0,1,1,2,4,7,0xb2d18b0ad
8072.0,1.0,184,2,2,1,5,0xb2d369c2
2161.84,1.0,92,1,2,1,4,0xb2d3c937d
578.11,1.0,10,1,2,3,6,0xb2d4cae6
468.59,1.0,14,1,2,3,6,0xb2d628d9d
132891.92,4.0,44,3,4,2,9,0xb2d4f03ed
1989.81,1.0,10,1,2,3,6,0xb2d8ed98
52823.44,3.0,27,3,4,2,9,0xb2d50dd3d
800741.75,5.0,9,4,4,3,11,0xb2d9a13f
23870.76,10.0,0,2,4,4,10,0xb2d140aa
470000.0,2.0,25,4,3,2,9,0xb2d93c99d
7.6,1.0,60,1,2,2,5,0xb2d8f52e
260111.72,4.0,110,3,4,1,8,0xb2d10448d
23002.65,3.0,63,2,4,2,8,0xb2d9a9a7
101876.99,2.0,4,3,3,4,10,0xb2d5777f
5137.64,1.0,4,2,2,4,8,0xb2d83b56d
711043.18,5.0,6,4,4,3,11,0xb2d197f0
502508.4,5.0,42,4,4,2,10,0xb2d11c1a
15018.35,1.0,3,2,2,4,8,0xb2d2d63b
436539.7,3.0,92,4,4,1,9,0xb2d3bc69d
442024.7,5.0,199,4,4,1,9,0xb2d232e9
867502.06,8.0,0,4,4,4,12,0x3b9af160d
10000.19,2.0,55,2,3,2,7,0xb2d62749
1202185.91,3.0,30,4,4,2,10,0xb2d554ff
1207116.48,1.0,0,4,2,4,10,0xb2d3a04b
320903.52,4.0,133,4,4,1,9,0xb2d36762
10413.39,1.0,184,2,2,1,5,0xb2d28c67d
800006.68,2.0,6,4,3,3,10,0xb2d716a4d
650736.76,2.0,12,4,3,3,10,0xb2d92388d
707674.4,5.0,31,4,4,2,10,0xb2d1290dd
85108.77,3.0,0,3,4,4,11,0xb2d367b1
2401000.0,101.0,0,4,4,4,12,0xb2d16921
543352.41,5.0,139,4,4,1,9,0xb2d25067
210751.96,2.0,167,3,3,1,7,0xb2d389d6
143098.14,5.0,80,3,4,1,8,0xb2d38b7fd
15882.31,1.0,20,2,2,2,6,0xb2d1df74
5595.84,1.0,0,2,2,4,8,0xb2d3dfead
1080.01,1.0,0,1,2,4,7,0xb2d6d394d
48533.64,1.0,3,2,2,4,8,0xb2d23cc4
25.64,1.0,11,1,2,3,6,0xb2d31eb5
358702.02,1.0,10,4,2,3,9,0xb2d95f20
0.47,1.0,6,1,2,3,6,0xb2d9d1df
500063.45,2.0,92,4,3,1,8,0xb2d612ecd
10000.11,2.0,95,2,3,1,6,0xb2d6237b
1484142.78,14.0,22,4,4,2,10,0xb2d48682d
1806204.57,5.0,7,4,4,3,11,0xb2d5ee7fd
62177.28,4.0,21,3,4,2,9,0xb2d60848
107080.96,1.0,25,3,2,2,7,0xb2d25812d
2043.99,1.0,3,1,2,4,7,0xb2d396fcd
947.66,1.0,1,1,2,4,7,0xb2d907cc
103006.87,1.0,125,3,2,1,6,0xb2d613e6
301067.59,2.0,30,4,3,2,9,0xb2d5c7a6
2594.01,1.0,92,1,2,1,4,0xb2d0aff0
200010.42,2.0,1,3,3,4,10,0xb2d93022
25019.23,1.0,16,2,2,2,6,0xb2d6b17c
105004.43,2.0,69,3,3,1,7,0xb2d8e7c7
8539.6,5.0,0,2,4,4,10,0xb2d21137
2563.78,1.0,92,1,2,1,4,0xb2d0b232d
850725.1,4.0,20,4,4,2,10,0xb2d5a919d
165438.62,3.0,189,3,4,1,8,0xb2d46ca6
42102.38,2.0,17,2,3,2,7,0xb2d21132
100003.17,2.0,73,3,3,1,7,0xb2d8e00b
200001.91,2.0,7,3,3,3,9,0xb2d6e880
103824.43,2.0,101,3,3,1,7,0xb2d56a35
110836.04,4.0,4,3,4,4,11,0xb2d186ddd
3072.57,7.0,2,2,4,4,10,0x3b9af126
503605.78,2.0,82,4,3,1,8,0xb2d63404
4621.45,1.0,0,2,2,4,8,0xb2d104d4
1356133.78,10.0,14,4,4,3,11,0xb2d54eb8d
25004.71,2.0,4,2,3,4,9,0xb2d936fb
120051.49,2.0,136,3,3,1,7,0xb2d16eb5d
76083.4,5.0,3,3,4,4,11,0xb2d5b37d
12.93,1.0,10,1,2,3,6,0xb2d95dc7
53242.4,1.0,16,3,2,2,7,0xb2d177cb
97057.66,1.0,19,3,2,2,7,0xb2d69d31
1767.82,1.0,4,1,2,4,7,0xb2d1dc42d
108026.38,2.0,0,3,3,4,10,0xb2d1cc1b
1200107.06,3.0,208,4,4,1,9,0xb2d1ae9a
50542.89,3.0,1,2,4,4,10,0xb2d5bfb1
50349.25,2.0,143,2,3,1,6,0xb2d686f5
337.98,1.0,1,1,2,4,7,0xb2d256d2
1125732.7,15.0,0,4,4,4,12,0x3b9ad21f
1007.72,1.0,92,1,2,1,4,0xb2d35726
1290.11,1.0,254,1,2,1,4,0xb2d5afa9d
500004.77,2.0,21,4,3,2,9,0xb2d63c99
456978.69,6.0,4,4,4,4,12,0xb2d3c165
304.58,1.0,17,1,2,2,5,0xb2d941c6
1788000.0,4.0,0,4,4,4,12,0xb2d0b25c
412675.22,7.0,0,4,4,4,12,0xb2d5c37d
210.17,1.0,2,1,2,4,7,0xb2d16204
2092252.03,4.0,4,4,4,4,12,0xb2d26816
20041.94,3.0,0,2,4,4,10,0xb2d86811
218077.52,2.0,15,3,3,3,9,0xb2d6c8d6
50213.5,1.0,0,2,2,4,8,0xb2da64ea
22890534.45,2.0,195,4,3,1,8,0xb2d0c690
204254.61,5.0,0,3,4,4,11,0xb2d61357
170040.99,7.0,1,3,4,4,11,0xb2d06b84d
160756.83,4.0,0,3,4,4,11,0x3b9af12f
3201.45,2.0,40,2,3,2,7,0xb2d2f5b5d
2160.0,1.0,1,1,2,4,7,0xb2d75a27d
35129.63,2.0,12,2,3,3,8,0xb2d5d7da
30112.9,2.0,0,2,3,4,9,0x3b9b3efbd
2594.76,1.0,92,1,2,1,4,0xb2d36750d
931.78,1.0,22,1,2,2,5,0xb2d325f4d
245951.02,4.0,31,3,4,2,9,0xb2d4f803d
499.12,1.0,9,1,2,3,6,0xb2d7882a
173378.26,2.0,116,3,3,1,7,0xb2d11618
303711.57,6.0,48,4,4,2,10,0xb2d1b40dd
3499.91,1.0,6,2,2,3,7,0xb2d8f585
100379.48,1.0,184,3,2,1,6,0xb2d5b303d
538.96,4.0,7,1,4,3,8,0x3b9b0ff8
52.82,1.0,10,1,2,3,6,0xb2d1de72
1.27,1.0,33,1,2,2,5,0xb2da002d
4144.48,1.0,13,2,2,3,7,0xb2d69a1c
23640.05,2.0,10,2,3,3,8,0xb2d48768d
332.61,1.0,46,1,2,2,5,0xb2d4828b
3807.13,1.0,124,2,2,1,5,0xb2d64872
1922016.95,7.0,6,4,4,3,11,0xb2d656a5
76.04,5.0,57,1,4,2,7,0xb2d9b47b
1070.78,1.0,161,1,2,1,4,0xb2d34817
37.09,1.0,82,1,2,1,4,0xb2d1b317
19037.21,1.0,0,2,2,4,8,0xb2d0d9b4
70383.45,2.0,48,3,3,2,8,0xb2d6240f
18819.39,1.0,13,2,2,3,7,0xb2d2dfb6
20137.42,1.0,92,2,2,1,5,0xb2d1bf6b
1000057.11,1.0,0,4,2,4,10,0xb2d2cc42
40000.84,4.0,27,2,4,2,8,0xb2d8d061d
1118171.51,3.0,22,4,4,2,10,0xb2d93aded
90073.71,4.0,27,3,4,2,9,0xb2d4d894
120248.59,2.0,3,3,3,4,10,0xb2d94ee4d
1048.32,1.0,184,1,2,1,4,0x3b9b308d
2126.57,1.0,18,1,2,2,5,0xb2d2ad77
194059.34,7.0,4,3,4,4,11,0xb2d643d8
113623.65,3.0,76,3,4,1,8,0xb2d13685d
1148.67,1.0,0,1,2,4,7,0xb2d69eb2
51494.71,1.0,92,2,2,1,5,0xb2d376ea
541509.15,6.0,80,4,4,1,9,0xb2d5dd7f
156485.46,3.0,122,3,4,1,8,0xb2d17274d
300003.17,2.0,67,3,3,1,7,0xb2d9afef
10360.12,2.0,69,2,3,1,6,0xb2d64131d
3.04,1.0,81,1,2,1,4,0xb2d6545fd
200000.0,2.0,3,3,3,4,10,0xb2d97439d
2096693.75,2.0,58,4,3,2,9,0xb2d46f1f
24381.92,2.0,111,2,3,1,6,0xb2d5ccde
110685.29,2.0,53,3,3,2,8,0xb2d2db45d
200054.67,2.0,30,3,3,2,8,0xb2d98adf
92848.39,1.0,193,3,2,1,6,0xb2d24b7e
21.11,1.0,77,1,2,1,4,0xb2d98953
50002.11,2.0,188,2,3,1,6,0xb2d6a69b
29543.73,1.0,1,2,2,4,8,0xb2d57c14
270.17,1.0,10,1,2,3,6,0xb2d0f380d
252000.0,5.0,3,3,4,4,11,0xb2d35f54
153367.18,3.0,3,3,4,4,11,0xb2d1f7c2
7570.04,1.0,92,2,2,1,5,0xb2d29069
43.79,2.0,54,1,3,2,6,0xb2d13a51
310386.23,2.0,3,4,3,4,11,0xb2d8ce6e
3693.81,1.0,0,2,2,4,8,0xb2d6bb57
100071.03,3.0,6,3,4,3,10,0xb2d45a65
50001.06,2.0,25,2,3,2,7,0xb2da0b97
148670.94,2.0,53,3,3,2,8,0xb2d6198a
849.02,1.0,11,1,2,3,6,0xb2d98458d
312.24,2.0,60,1,3,2,6,0xb2d26ed6
1795.25,1.0,17,1,2,2,5,0xb2d37c27
11762.93,1.0,9,2,2,3,7,0xb2d69337
200000.0,2.0,5,3,3,3,9,0xb2d97737
500015.87,2.0,10,4,3,3,10,0xb2d5ff79
5704.71,1.0,20,2,2,2,6,0xb2d2a4b4
549.25,1.0,3,1,2,4,7,0xb2d20fbd
19978.84,1.0,92,2,2,1,5,0xb2d30ba0d
301389.14,5.0,26,4,4,2,10,0xb2d4dfee
8815.82,1.0,1,2,2,4,8,0xb2d38fb6
3300902.74,12.0,0,4,4,4,12,0xb2d61cca
200064.61,2.0,2,3,3,4,10,0xb2d694cd
75112.11,2.0,58,3,3,2,8,0xb2d29e49
53.31,1.0,3,1,2,4,7,0xb2d68031
932731.95,2.0,5,4,3,3,10,0xb2d1fa6a
210031.5,3.0,34,3,4,2,9,0xb2d5a836
80189.78,1.0,10,3,2,3,8,0xb2d6a914d
451787.8,3.0,0,4,4,4,12,0xb2d403c9
51490.14,1.0,82,2,2,1,5,0xb2d5bd2b
600030.66,5.0,41,4,4,2,10,0xb2d21e22
15838.74,1.0,49,2,2,2,6,0xb2d6da13
500016.89,4.0,41,4,4,2,10,0xb2d92983
70003.31,3.0,76,3,4,1,8,0xb2d10827
1641.91,1.0,2,1,2,4,7,0xb2d30121
586005.94,6.0,1,4,4,4,12,0xb2d170c3
620000.0,15.0,0,4,4,4,12,0xb2d0da60
701102.92,5.0,8,4,4,3,11,0xb2d9e0e0
210183.88,2.0,7,3,3,3,9,0xb2d6fd7a
150303.32,3.0,101,3,4,1,8,0xb2d290f4d
56667.62,1.0,11,3,2,3,8,0xb2d6f626
100745.75,4.0,6,3,4,3,10,0xb2d585b4
46000.98,4.0,4,2,4,4,10,0xb2d9619d
3650971.44,7.0,0,4,4,4,12,0xb2d564ba
5666.62,1.0,2,2,2,4,8,0xb2d2b5ce
30022.65,1.0,41,2,2,2,6,0xb2d78d1d
147.46,1.0,0,1,2,4,7,0xb2d6aa4c
1000176.26,11.0,21,4,4,2,10,0xb2d54c65
498485.07,2.0,12,4,3,3,10,0xb2d2981c
1050.75,7.0,92,1,4,1,6,0x3b9b1798d
57904.07,1.0,178,3,2,1,6,0xb2d512b6d
200000.43,2.0,18,3,3,2,8,0xb2d9d751
51916.91,2.0,83,2,3,1,6,0xb2d5959bd
656453.27,3.0,7,4,4,3,11,0xb2d98a29
450217.25,2.0,6,4,3,3,10,0xb2d41009
2564.8,1.0,213,1,2,1,4,0xb2d64b90
20000.0,2.0,6,2,3,3,8,0xb2d96d97d
243.1,6.0,13,1,4,3,8,0xb2d424c4
29919.66,1.0,92,2,2,1,5,0xb2d3facf
200407.29,3.0,87,3,4,1,8,0xb2d30db0
2963.36,1.0,0,2,2,4,8,0xb2d1f1de
280021.76,5.0,5,3,4,3,10,0xb2d39482
5680889.72,4.0,3,4,4,4,12,0xb2d6cf12
50221.28,1.0,1,2,2,4,8,0xb2d8f47a
4.05,1.0,0,1,2,4,7,0xb2d5e041
426807.75,3.0,26,4,4,2,10,0xb2d6bab6d
6235.09,1.0,142,2,2,1,5,0xb2d248cb
95414.25,2.0,196,3,3,1,7,0xb2d4256dd
26359.04,1.0,28,2,2,2,6,0xb2d5c8ef
4870391.65,4.0,97,4,4,1,9,0xb2d1a537
155170.69,3.0,20,3,4,2,9,0xb2d1c505
2113.87,1.0,194,1,2,1,4,0xb2d0beac
400016.0,5.0,2,4,4,4,12,0xb2d626d1d
23737.17,1.0,159,2,2,1,5,0xb2d18d41d
21.78,1.0,9,1,2,3,6,0xb2d4ef10
40.47,1.0,1,1,2,4,7,0xb2d3965d
5035.37,1.0,92,2,2,1,5,0xb2d3a4c9
12.8,1.0,3,1,2,4,7,0xb2d0dca6
807663.13,13.0,0,4,4,4,12,0xb2d58dc6
550017.95,4.0,92,4,4,1,9,0xb2d975b4
17235.07,1.0,0,2,2,4,8,0xb2d5515e
51.07,1.0,8,1,2,3,6,0xb2d85d63d
1405.27,1.0,2,1,2,4,7,0xb2d5cf92
38374.0,1.0,0,2,2,4,8,0xb2d30d29
1000000.05,5.0,6,4,4,3,11,0xb2d9c939
1.03,2.0,20,1,3,2,6,0xb2d119a0
330819.09,3.0,32,4,4,2,10,0xb2d988b0
9138.27,1.0,18,2,2,2,6,0xb2d9dc17
110003.48,2.0,112,3,3,1,7,0xb2d94fedd
1159.99,1.0,9,1,2,3,6,0xb2d6f864
30527.79,2.0,122,2,3,1,6,0xb2d5cc22
15379.3,1.0,14,2,2,3,7,0xb2d685cf
100199.05,3.0,26,3,4,2,9,0xb2d2323dd
12549.15,1.0,1,2,2,4,8,0xb2d942ce
270059.07,2.0,18,3,3,2,8,0xb2d9db54
653568.56,3.0,13,4,4,3,11,0xb2d626a4
405685.69,2.0,123,4,3,1,8,0xb2d776e7
13157.9,1.0,0,2,2,4,8,0xb2d59d46
5026.37,1.0,112,2,2,1,5,0xb2d5d9d4
20375.71,2.0,18,2,3,2,7,0xb2d6535a
64158.94,1.0,10,3,2,3,8,0xb2d9b502
100001.06,2.0,18,3,3,2,8,0xb2d95693
70184.95,3.0,33,3,4,2,9,0xb2d94acf
79.83,1.0,9,1,2,3,6,0xb2d5b0aa
53001.14,2.0,21,3,3,2,8,0xb2d297c0
10101.71,1.0,29,2,2,2,6,0xb2d94c90
50185.53,2.0,9,2,3,3,8,0xb2d961a1
5074.58,1.0,6,2,2,3,7,0xb2d2acd4
9712.3,1.0,50,2,2,2,6,0xb2d0b47b
300032.54,2.0,4,3,3,4,10,0xb2d55e55
50050.0,1.0,1,2,2,4,8,0xb2da65dc
259984.3,6.0,1,3,4,4,11,0xb2d3cc49d
600020.53,2.0,21,4,3,2,9,0xb2d15ffe
479501.81,3.0,35,4,4,2,10,0xb2d13891
120068.22,5.0,0,3,4,4,11,0xb2d578df
8222.11,1.0,184,2,2,1,5,0xb2d288ec
5724.14,1.0,4,2,2,4,8,0xb2d50b22
1118.31,1.0,8,1,2,3,6,0xb2d93863d
51834.77,1.0,0,2,2,4,8,0xb2d8df89
0.0,1.0,3,1,2,4,7,0xb2da5c3a
979421.78,9.0,0,4,4,4,12,0xb2d58725
60037.06,2.0,52,3,3,2,8,0xb2d6d1b8d
359958.67,3.0,0,4,4,4,12,0xb2d1523c
0.0,1.0,8,1,2,3,6,0xb2d2b9cf
1015.84,1.0,92,1,2,1,4,0x3b9aee6f
1.33,1.0,12,1,2,3,6,0xb2d921fb
1151.82,1.0,92,1,2,1,4,0xb2d3f308d
1252084.51,18.0,0,4,4,4,12,0x3b9addb5
680082.61,10.0,25,4,4,2,10,0xb2d5cc8d
370006.44,6.0,24,4,4,2,10,0xb2d68972
103858.3,2.0,174,3,3,1,7,0xb2d27811
50079.45,2.0,73,2,3,1,6,0xb2d575c1d
201420.99,2.0,60,3,3,2,8,0xb2d9c285
89.52,1.0,83,1,2,1,4,0xb2d682fcd
10003.48,2.0,31,2,3,2,7,0xb2d593c8d
1162110.77,5.0,6,4,4,3,11,0xb2d50418
14456.04,1.0,49,2,2,2,6,0xb2d6e2b1
10077.38,1.0,111,2,2,1,5,0xb2d5a88c
3819.55,1.0,3,2,2,4,8,0xb2d4cf15
19.53,1.0,25,1,2,2,5,0xb2d9c6a6
4373.77,1.0,92,2,2,1,5,0xb2d0dca2d
4984.38,1.0,10,2,2,3,7,0xb2d94379
31214.6,3.0,60,2,4,2,8,0xb2d560d7d
7900.96,1.0,3,2,2,4,8,0xb2d226f9d
353672.58,2.0,3,4,3,4,11,0xb2d164d3
830050.48,4.0,4,4,4,4,12,0xb2d5e084
150019.13,2.0,144,3,3,1,7,0xb2d6d480
1569.25,2.0,12,1,3,3,7,0xb2d1aea1d
13.03,1.0,79,1,2,1,4,0xb2d0eae4
260076.12,3.0,104,3,4,1,8,0xb2d578ded
42681.26,1.0,5,2,2,3,7,0xb2d12741
50002.64,2.0,92,2,3,1,6,0xb2d62d08
1494479.98,6.0,8,4,4,3,11,0xb2d22bd4
1306.29,3.0,43,1,4,2,7,0xb2d2bc1ed
50002.11,2.0,192,2,3,1,6,0xb2d69e84d
1017770.6,2.0,32,4,3,2,9,0xb2d657be
593306.45,2.0,13,4,3,3,10,0xb2d3505b
2752.1,1.0,184,1,2,1,4,0xb2d073f2
1105.56,1.0,184,1,2,1,4,0xb2d60d52
1000000.0,2.0,6,4,3,3,10,0xb2d972b1d
7425.31,1.0,0,2,2,4,8,0xb2d4fb8c
2227.84,1.0,8,1,2,3,6,0xb2d6b111
622668.57,5.0,0,4,4,4,12,0x3b9b460e
5069.22,3.0,92,2,4,1,7,0xb2d26835
8.52,1.0,36,1,2,2,5,0xb2d8e91e
730766.1,8.0,1,4,4,4,12,0xb2d625fed
51696.91,2.0,0,2,3,4,9,0xb2d06775d
51058.2,1.0,184,2,2,1,5,0xb2d3361e
1560.81,1.0,15,1,2,3,6,0xb2d8e18d
250000.0,2.0,14,3,3,3,9,0xb2da3dcd
400010.42,3.0,7,4,4,3,11,0xb2d9ebfd
8239.1,1.0,2,2,2,4,8,0xb2d21c87
780003.08,8.0,9,4,4,3,11,0xb2d64d23d
50020.07,2.0,80,2,3,1,6,0xb2d94769
455.24,1.0,77,1,2,1,4,0xb2d06945
101834.88,2.0,0,3,3,4,10,0xb2d38399
30655.67,1.0,1,2,2,4,8,0xb2d1e9a6d
6967.62,1.0,184,2,2,1,5,0xb2d339d6
52833.79,1.0,184,3,2,1,6,0xb2d11b97
130003.88,6.0,10,3,4,3,10,0xb2d41bbe
176087.48,4.0,104,3,4,1,8,0xb2d191a6
451425.95,12.0,1,4,4,4,12,0x3b9b2c6b
28494.51,1.0,18,2,2,2,6,0xb2d1b628d
235616.96,3.0,18,3,4,2,9,0xb2d4f62bd
1530759.98,3.0,27,4,4,2,10,0xb2d1b41ed
406157.95,3.0,4,4,4,4,12,0xb2d2488d
2000000.0,2.0,25,4,3,2,9,0xb2da0c6d
100097.07,2.0,92,3,3,1,7,0xb2d38cb5
174084.3,4.0,19,3,4,2,9,0xb2d2490d
6000336.74,3.0,2,4,4,4,12,0xb2d755c7
2724.12,1.0,6,1,2,3,6,0xb2d54896d
15000.42,2.0,11,2,3,3,8,0xb2d95ffcd
350595.85,1.0,1,4,2,4,10,0xb2d36cd9
211.3,1.0,8,1,2,3,6,0xb2d3102b
603553.11,3.0,29,4,4,2,10,0xb2d606fad
30000.59,3.0,1,2,4,4,10,0xb2d612ea
346008.0,4.0,80,4,4,1,9,0xb2d78153
0.0,1.0,2,1,2,4,7,0xb2d266f2
200306.67,2.0,11,3,3,3,9,0xb2da0f1b
78.21,1.0,99,1,2,1,4,0xb2d64b5dd
250145.63,5.0,59,3,4,2,9,0xb2d41e2bd
588.51,4.0,1,1,4,4,9,0xb2d5290cd
20146.33,2.0,0,2,3,4,9,0xb2d5f40ad
18125.46,1.0,184,2,2,1,5,0xb2d3c1f9
51411.48,1.0,1,2,2,4,8,0xb2d570b4d
3974.45,1.0,0,2,2,4,8,0xb2d0ee48
585134.56,6.0,24,4,4,2,10,0xb2d973cdd
300009.59,3.0,48,3,4,2,9,0xb2d6481e
206498.69,3.0,2,3,4,4,11,0xb2d6eaf6
2100000.0,7.0,4,4,4,4,12,0xb2d65e0dd
109762.78,6.0,101,3,4,1,8,0xb2d62c9b
400016.77,3.0,4,4,4,4,12,0xb2d35732d
817270.16,8.0,5,4,4,3,11,0xb2d56668d
360081.05,4.0,76,4,4,1,9,0xb2d35396d
8544.52,1.0,184,2,2,1,5,0xb2d45341d
620.3,1.0,34,1,2,2,5,0xb2d3cfce
50013.97,2.0,6,2,3,3,8,0xb2d63c19
8407.78,1.0,59,2,2,2,6,0xb2d44d19
13242.87,1.0,0,2,2,4,8,0xb2d258d4
8749.47,1.0,20,2,2,2,6,0xb2d97ac7
143775.87,1.0,0,3,2,4,9,0xb2d47a7d
440712.85,21.0,0,4,4,4,12,0xb2d21249
75048.69,2.0,178,3,3,1,7,0xb2d0bcd6
4757.54,1.0,50,2,2,2,6,0xb2d97ca9
132499.69,3.0,3,3,4,4,11,0xb2d631f9d
28596.69,1.0,15,2,2,3,7,0xb2d704bb
780.66,1.0,0,1,2,4,7,0xb2d5b2ac
2568.45,1.0,14,1,2,3,6,0xb2d31093
109035.25,9.0,0,3,4,4,11,0xb2d4efe0
555480.6,1.0,0,4,2,4,10,0xb2d39c51
7858.12,1.0,0,2,2,4,8,0xb2d3aabbd
60030.89,2.0,83,3,3,1,7,0xb2d1fc13d
447857.54,2.0,166,4,3,1,8,0xb2d4f1b5
630090.7,8.0,8,4,4,3,11,0xb2d579da
201421.04,2.0,68,3,3,1,7,0xb2d9b02c
6370.36,1.0,3,2,2,4,8,0xb2d2b5e4
22355.3,1.0,10,2,2,3,7,0xb2d5d4b9d
6674.6,1.0,0,2,2,4,8,0xb2d99116
0.89,1.0,88,1,2,1,4,0xb2d564b0
3480122.11,3.0,60,4,4,2,10,0xb2d60791d
7100.0,2.0,5,2,3,3,8,0xb2d9f1da
100004.98,1.0,0,3,2,4,9,0xb2d567e0
17.76,1.0,5,1,2,3,6,0xb2d8a64a
238045.27,3.0,104,3,4,1,8,0xb2d24584
2253.39,1.0,184,1,2,1,4,0xb2d3280e
4.65,1.0,69,1,2,1,4,0xb2d6234ad
6566.19,1.0,5,2,2,3,7,0xb2d3a44b
693.93,1.0,77,1,2,1,4,0xb2d6ab42
120002.6,3.0,20,3,4,2,9,0xb2d2aa0b
4151.07,1.0,14,2,2,3,7,0xb2d8d6b2
217942.4,2.0,3,3,3,4,10,0xb2d2a296
62563.91,1.0,0,3,2,4,9,0xb2d34920
1210608.31,13.0,6,4,4,3,11,0xb2d26448
509072.73,5.0,95,4,4,1,9,0xb2d14d18d
1043.6,1.0,92,1,2,1,4,0xb2d1fe42d
2745.95,1.0,92,1,2,1,4,0xb2d10779
63253.62,6.0,18,3,4,2,9,0xb2d0dd69
120001.25,1.0,0,3,2,4,9,0xb2d78afb
61325.65,1.0,184,3,2,1,6,0xb2d2ad7a
1782.29,1.0,8,1,2,3,6,0xb2d6ec3c
200853.02,3.0,6,3,4,3,10,0xb2d0695cd
8374.14,1.0,9,2,2,3,7,0xb2d5cf6d
17803.54,1.0,1,2,2,4,8,0xb2d6c2b6
8013.99,1.0,3,2,2,4,8,0xb2d265e0
1082.21,1.0,0,1,2,4,7,0xb2d99310
181.01,1.0,10,1,2,3,6,0xb2d3964e
100003.12,2.0,53,3,3,2,8,0xb2d398a5
8018.45,1.0,0,2,2,4,8,0xb2d26714
62.19,1.0,27,1,2,2,5,0xb2d6ce10
380035.61,4.0,13,4,4,3,11,0x3b9b1c05d
1295006.46,9.0,11,4,4,3,11,0xb2d367f8d
58.84,1.0,4,1,2,4,7,0xb2d60a37
4254.19,1.0,92,2,2,1,5,0xb2d22c01
1816134.07,16.0,10,4,4,3,11,0xb2d0c957
1000000.27,4.0,2,4,4,4,12,0xb2d62bbc
1286.85,1.0,19,1,2,2,5,0xb2d68c8b
50112.18,2.0,20,2,3,2,7,0xb2d16cc2
11396.78,1.0,173,2,2,1,5,0xb2d682f5
600160.08,4.0,27,4,4,2,10,0xb2d62330
530128.61,2.0,164,4,3,1,8,0xb2d1daad
300003.52,2.0,20,3,3,2,8,0xb2d6ee05
508016.91,1.0,0,4,2,4,10,0xb2d31f72d
43255.13,1.0,80,2,2,1,5,0xb2d627e6d
13137.43,1.0,5,2,2,3,7,0xb2d6abc3
2.64,1.0,19,1,2,2,5,0xb2d94e91d
649000.93,4.0,1,4,4,4,12,0xb2d6f0f3d
79129.72,1.0,92,3,2,1,6,0xb2d1aa9e
36623.53,1.0,92,2,2,1,5,0xb2d4081c
1309277.69,6.0,8,4,4,3,11,0xb2d567ebd
3585.9,1.0,19,2,2,2,6,0xb2d3107d
15.64,1.0,4,1,2,4,7,0xb2d40bb0
2420.24,1.0,184,1,2,1,4,0xb2d31308
487.36,1.0,7,1,2,3,6,0xb2d47912d
93011.64,2.0,76,3,3,1,7,0xb2d2fbf6
442364.13,4.0,32,4,4,2,10,0xb2d312e8d
1271.05,1.0,6,1,2,3,6,0xb2d62b69
360540.12,4.0,0,4,4,4,12,0xb2d1b97a
150369.75,5.0,28,3,4,2,9,0xb2d2b27cd
2338.81,1.0,14,1,2,3,6,0xb2d8c5a5
51742.47,1.0,0,2,2,4,8,0xb2d5a922
102003.23,2.0,73,3,3,1,7,0xb2d8df9b
56204.8,2.0,12,3,3,3,9,0xb2d3edc7d
300099.91,2.0,235,4,3,1,8,0xb2d182dcd
1062000.0,4.0,4,4,4,4,12,0xb2d15318
16086.23,1.0,10,2,2,3,7,0xb2d2dfb6d
610007.04,11.0,31,4,4,2,10,0xb2d1149d
170002.16,1.0,2,3,2,4,9,0xb2d1d534
480694.26,3.0,111,4,4,1,9,0xb2d6c35bd
6.57,1.0,71,1,2,1,4,0xb2d3669a
14208.89,1.0,0,2,2,4,8,0xb2d5cf00d
329681.5,3.0,25,4,4,2,10,0xb2d61b02
12800.31,1.0,92,2,2,1,5,0xb2d10f9d
59622.24,1.0,15,3,2,3,8,0xb2d06c16
200015.71,2.0,19,3,3,2,8,0xb2d64f7dd
97282.2,3.0,59,3,4,2,9,0xb2d58a64
6.75,1.0,31,1,2,2,5,0xb2d9158e
97281.07,1.0,23,3,2,2,7,0xb2d1c1e3
1019698.78,4.0,26,4,4,2,10,0xb2d16dc0
800783.67,4.0,15,4,4,3,11,0xb2d11c2d
200004.19,3.0,0,3,4,4,11,0xb2d5ed7d
615000.27,3.0,31,4,4,2,10,0xb2d189aa
1059.29,1.0,102,1,2,1,4,0xb2d15931
20000.21,2.0,25,2,3,2,7,0xb2da0d80
810106.74,6.0,11,4,4,3,11,0xb2d2ac56
250010.58,2.0,92,3,3,1,7,0xb2d65eb8d
1093.82,1.0,7,1,2,3,6,0xb2d3e9ff
5751.01,1.0,0,2,2,4,8,0xb2d5c5a5
11459.6,1.0,2,2,2,4,8,0xb2d33225
38.62,1.0,20,1,2,2,5,0xb2d62c73
5300.81,1.0,4,2,2,4,8,0xb2d221a5
212115.96,2.0,34,3,3,2,8,0xb2d16c9d
100000.0,2.0,0,3,3,4,10,0xb2d9799cd
12160.69,8.0,0,2,4,4,10,0xb2d0d473
3047.26,1.0,184,2,2,1,5,0xb2d13306
200010.84,2.0,2,3,3,4,10,0xb2d0fb77
1140779.12,6.0,27,4,4,2,10,0xb2d218bc
2692.85,1.0,3,1,2,4,7,0xb2d4c94c
3670.5,1.0,0,2,2,4,8,0xb2d96e7e
370031.47,3.0,1,4,4,4,12,0xb2d9d268
41256.93,1.0,0,2,2,4,8,0xb2d28f46d
262095.89,2.0,221,3,3,1,7,0xb2d5c202
20293.26,1.0,184,2,2,1,5,0xb2d0dad8
10372.57,2.0,4,2,3,4,9,0xb2d59b9f
500000.17,2.0,10,4,3,3,10,0xb2d96d9d
33143.11,1.0,0,2,2,4,8,0xb2d55fd2
25690.68,1.0,106,2,2,1,5,0xb2d61fd9
30262.83,2.0,20,2,3,2,7,0xb2d27197
200000.0,2.0,1,3,3,4,10,0xb2da6800
755654.09,2.0,3,4,3,4,11,0xb2d1479cd
320840.76,4.0,3,4,4,4,12,0xb2d19be0
2.3,1.0,47,1,2,2,5,0xb2d6e3e3
33000.0,4.0,0,2,4,4,10,0xb2d20e53
333906.43,7.0,8,4,4,3,11,0xb2d60d7c
2000000.0,2.0,26,4,3,2,9,0xb2da129d
0.0,1.0,3,1,2,4,7,0xb2d717b0
320007.2,7.0,0,4,4,4,12,0xb2d5a7a3
250026.88,3.0,3,3,4,4,11,0xb2d681e9d
1613.91,1.0,1,1,2,4,7,0xb2d40833
302134.53,6.0,77,4,4,1,9,0xb2d680f4
1911352.97,15.0,0,4,4,4,12,0x3b9b125a
5561.36,2.0,184,2,3,1,6,0xb2d16da6
120117.51,3.0,18,3,4,2,9,0xb2d8cf4ed
30001.27,2.0,70,2,3,1,6,0xb2d9a3dd
2780.3,3.0,274,1,4,1,6,0x3b9b2302d
650333.09,2.0,1,4,3,4,11,0xb2d122b1
3.78,1.0,12,1,2,3,6,0xb2d25daa
124.15,1.0,16,1,2,2,5,0xb2d436eb
1932942.47,2.0,155,4,3,1,8,0xb2d1d192
65045.13,3.0,158,3,4,1,8,0xb2d5dd35
40064.71,5.0,20,2,4,2,8,0xb2d63eaad
1924.16,1.0,55,1,2,2,5,0xb2d8909b
0.22,1.0,24,1,2,2,5,0xb2d41b4b
1509.8,1.0,92,1,2,1,4,0xb2d3e646
290005.59,3.0,18,3,4,2,9,0xb2d90c97
6822.31,1.0,0,2,2,4,8,0xb2d3bbd3d
4299351.61,2.0,6,4,3,3,10,0xb2d1782d
1396.22,1.0,2,1,2,4,7,0xb2d1fdc5
936.45,1.0,9,1,2,3,6,0xb2d5ef10
307396.3,4.0,13,4,4,3,11,0xb2d5b74b
60031.45,2.0,4,3,3,4,10,0xb2d50961
233063.77,1.0,1,3,2,4,9,0xb2d1b873d
3173.75,1.0,11,2,2,3,7,0xb2d2d5a6
2.46,1.0,21,1,2,2,5,0xb2d91b9f
8200.0,2.0,5,2,3,3,8,0xb2d93911
1191043.28,7.0,66,4,4,2,10,0xb2d1e64cd
210010.53,3.0,3,3,4,4,11,0xb2da0364
2012.72,2.0,0,1,3,4,8,0xb2d1d45e
469.69,1.0,20,1,2,2,5,0xb2d2e2acd
112210.19,4.0,94,3,4,1,8,0xb2d50d36
307000.0,2.0,1,4,3,4,11,0xb2d4d15cd
1270001.36,8.0,23,4,4,2,10,0xb2d60d44
120007.36,2.0,136,3,3,1,7,0xb2d60d2bd
101897.06,2.0,224,3,3,1,7,0xb2d25b19d
24628.88,1.0,2,2,2,4,8,0xb2d4fcf2d
1201.97,1.0,8,1,2,3,6,0xb2d5e69ad
2024.93,2.0,184,1,3,1,5,0xb2d06af0d
530.35,1.0,62,1,2,2,5,0xb2d31866
914427.91,3.0,1,4,4,4,12,0xb2d68516
852904.91,3.0,306,4,4,1,9,0xb2d34985d
1947.95,1.0,23,1,2,2,5,0xb2d8e41c
7200.9,1.0,169,2,2,1,5,0xb2d21166d
10.0,2.0,47,1,3,2,6,0xb2d50012
20000.63,2.0,92,2,3,1,6,0xb2d97eec
545000.0,2.0,22,4,3,2,9,0xb2d2812a
253000.0,7.0,6,3,4,3,10,0xb2d54ff0
164050.61,9.0,1,3,4,4,11,0xb2d212e8d
310082.72,5.0,18,4,4,2,10,0xb2d69d7dd
150024.7,3.0,13,3,4,3,10,0xb2d3143ad
27204.7,3.0,5,2,4,3,9,0xb2d2283e
446022.96,13.0,8,4,4,3,11,0xb2d2b26dd
155886.4,2.0,1,3,3,4,10,0xb2da4b2b
380096.33,5.0,0,4,4,4,12,0xb2d40d16
7096.72,1.0,13,2,2,3,7,0xb2d6d4bc
20000.21,2.0,14,2,3,3,8,0xb2da3a4d
764504.46,5.0,10,4,4,3,11,0xb2d5a0bfd
3647.82,1.0,2,2,2,4,8,0xb2d253b1
200000.0,2.0,16,3,3,2,8,0xb2d6f481
587338.27,12.0,0,4,4,4,12,0xb2d11fb8
6222.85,2.0,92,2,3,1,6,0xb2d158a5d
6048.62,1.0,12,2,2,3,7,0xb2d6980fd
43153.29,1.0,3,2,2,4,8,0xb2d38823
36.43,1.0,1,1,2,4,7,0xb2d43bff
1.12,1.0,16,1,2,2,5,0xb2d77f61
7847.74,1.0,3,2,2,4,8,0xb2d6f2d5d
200094.21,2.0,13,3,3,3,9,0xb2d1af9a
104711.81,2.0,0,3,3,4,10,0xb2d6282a
330579.3,5.0,0,4,4,4,12,0xb2d459aad
307048.23,6.0,13,4,4,3,11,0xb2d7fd08d
1018.83,1.0,3,1,2,4,7,0xb2d3c9c2
200008.44,2.0,76,3,3,1,7,0xb2d8db3ed
424462.0,6.0,0,4,4,4,12,0xb2d6199e
796028.37,18.0,4,4,4,4,12,0x3b9b48a9
150006.34,2.0,125,3,3,1,7,0xb2d71747
230012.04,11.0,1,3,4,4,11,0xb2d54e66
202876.01,2.0,140,3,3,1,7,0xb2d4141a
1000030.17,6.0,6,4,4,3,11,0xb2d23c53d
297.47,1.0,8,1,2,3,6,0xb2d24670
300030.04,2.0,195,3,3,1,7,0xb2d121c5d
10000.42,2.0,216,2,3,1,6,0xb2d67cc0
2101.78,1.0,0,1,2,4,7,0xb2d906ded
931019.68,2.0,80,4,3,1,8,0xb2d51dc8d
70015.69,2.0,39,3,3,2,8,0xb2d9e7bb
1502771.4,4.0,12,4,4,3,11,0xb2d69a21
1009.52,1.0,92,1,2,1,4,0xb2d2bb53d
210000.0,2.0,6,3,3,3,9,0xb2d97725
700041.56,2.0,63,4,3,2,9,0xb2d14fda
212743.18,2.0,116,3,3,1,7,0xb2d14ab3
1204.25,2.0,184,1,3,1,5,0x3b9b2bf7
12002.34,1.0,15,2,2,3,7,0xb2d8e056
80000.84,2.0,13,3,3,3,9,0xb2d95d73
30375.79,1.0,112,2,2,1,5,0xb2d5b443
13835.53,1.0,17,2,2,2,6,0xb2d24524
210801.39,2.0,206,3,3,1,7,0xb2d41010d
100000.21,2.0,104,3,3,1,7,0xb2d74be9
111134.58,3.0,14,3,4,3,10,0xb2d636dbd
0.71,1.0,6,1,2,3,6,0xb2d983ff
468858.45,1.0,144,4,2,1,7,0xb2d1ca6f
654.72,1.0,4,1,2,4,7,0xb2d7c785
7102.22,1.0,2,2,2,4,8,0xb2d62dda
4133.73,1.0,0,2,2,4,8,0xb2d14d6f
264.53,1.0,61,1,2,2,5,0xb2d6c562
200000.42,2.0,6,3,3,3,9,0xb2d9f94d
4365000.0,6.0,4,4,4,4,12,0xb2d6992cd
315026.36,2.0,6,4,3,3,10,0xb2d1a9bb
400012.67,2.0,90,4,3,1,8,0xb2d8b387d
6109.51,1.0,157,2,2,1,5,0xb2d28f3fd
51552.57,1.0,15,2,2,3,7,0xb2d60f11
1098.49,1.0,184,1,2,1,4,0xb2d1fd2ad
297.78,1.0,21,1,2,2,5,0xb2d3fef1
2027503.61,3.0,11,4,4,3,11,0xb2d0af30
13983.11,1.0,36,2,2,2,6,0xb2d425c6
127016.67,7.0,199,3,4,1,8,0xb2d1543b
168840.21,2.0,11,3,3,3,9,0xb2d14725
64058.1,1.0,0,3,2,4,9,0xb2d2da2a
1663208.96,11.0,5,4,4,3,11,0xb2d11cd2d
1729.71,1.0,297,1,2,1,4,0xb2d5a721
349570.41,5.0,0,4,4,4,12,0xb2d08154
1737.63,1.0,188,1,2,1,4,0xb2d49f4f
41.5,1.0,28,1,2,2,5,0xb2d49103
3.54,1.0,13,1,2,3,6,0xb2d6044f
1200383.59,6.0,6,4,4,3,11,0xb2d6cc94d
17076.02,1.0,9,2,2,3,7,0xb2d4460fd
908459.22,7.0,10,4,4,3,11,0xb2d5f8b9
426233.66,1.0,0,4,2,4,10,0xb2d97a8cd
5046.43,1.0,184,2,2,1,5,0xb2d303be
607522.62,4.0,137,4,4,1,9,0xb2d2bfea
207222.39,2.0,259,3,3,1,7,0xb2d1c3c3
5.61,1.0,14,1,2,3,6,0xb2d85049
33699.28,2.0,10,2,3,3,8,0xb2d9aa3c
33887.27,1.0,15,2,2,3,7,0xb2d31945
13769.41,2.0,10,2,3,3,8,0xb2d5c227
420.82,1.0,7,1,2,3,6,0xb2d6bb43
26.58,1.0,65,1,2,2,5,0xb2d6a741
1133003.73,5.0,123,4,4,1,9,0xb2d0c2cbd
339271.37,2.0,3,4,3,4,11,0xb2d13f49
30007.89,2.0,130,2,3,1,6,0xb2d5eb8d
8285.4,1.0,0,2,2,4,8,0xb2d96799
80000.0,3.0,1,3,4,4,11,0xb2d3b704
2026396.18,12.0,4,4,4,4,12,0xb2d19208d
315136.89,1.0,184,4,2,1,7,0x3b9b2536d
1511251.96,2.0,0,4,3,4,11,0xb2d4422d
73284.74,3.0,140,3,4,1,8,0xb2d4f4eb
6.96,1.0,39,1,2,2,5,0xb2d3075d
116791.9,4.0,157,3,4,1,8,0xb2d592cb
800021.98,8.0,18,4,4,2,10,0xb2d417b4
15.83,1.0,41,1,2,2,5,0xb2d99314
100002.11,2.0,179,3,3,1,7,0xb2d6b571
266.68,1.0,0,1,2,4,7,0xb2d3109c
6.04,1.0,12,1,2,3,6,0xb2d42539
6103.94,2.0,19,2,3,2,7,0xb2d0aa1a
160072.5,2.0,192,3,3,1,7,0xb2d304d3
86.88,1.0,60,1,2,2,5,0xb2d1cb70
615635.28,3.0,92,4,4,1,9,0xb2d57ca2
826525.08,6.0,0,4,4,4,12,0xb2d5634c
91923.38,1.0,98,3,2,1,6,0xb2d1b768
500152.59,2.0,21,4,3,2,9,0xb2d78a5e
265103.78,4.0,200,3,4,1,8,0xb2d0bf18
38003.4,2.0,1,2,3,4,9,0xb2d3ec8d
200002.64,3.0,67,3,4,1,8,0xb2d9ac5b
0.7,1.0,0,1,2,4,7,0xb2d9b041
242269.98,2.0,143,3,3,1,7,0xb2d25cdb
50002.12,2.0,98,2,3,1,6,0xb2d505d1
25048.42,2.0,13,2,3,3,8,0xb2d95bef
84.04,1.0,184,1,2,1,4,0xb2d22b38
500010.56,2.0,80,4,3,1,8,0xb2d8d632
2.8,1.0,9,1,2,3,6,0xb2d66a34d
109064.11,3.0,102,3,4,1,8,0x3b9b2c75d
305005.12,4.0,12,4,4,3,11,0xb2d2377a
931191.11,27.0,0,4,4,4,12,0x3b9b38df
0.0,1.0,1,1,2,4,7,0xb2d9c6a3
260005.5,2.0,18,3,3,2,8,0xb2d39665
1700074.05,8.0,6,4,4,3,11,0xb2d1c41f
78000.0,4.0,9,3,4,3,10,0xb2d0c2e6
7442.11,1.0,5,2,2,3,7,0xb2d78969d
673.53,1.0,19,1,2,2,5,0xb2d2d2ec
20184.76,2.0,235,2,3,1,6,0xb2d5c4b2d
157811.39,2.0,69,3,3,1,7,0xb2d59cca
50007.77,2.0,11,2,3,3,8,0xb2d95a11
140004.18,3.0,61,3,4,2,9,0xb2d0c1e9
2849.86,1.0,184,1,2,1,4,0xb2d0e636
353760.62,2.0,0,4,3,4,11,0xb2d6221d
102530.18,3.0,0,3,4,4,11,0xb2d609d7
200959.79,2.0,56,3,3,2,8,0xb2d46f45d
40034.45,2.0,102,2,3,1,6,0xb2d14526
4399.4,1.0,3,2,2,4,8,0xb2d56edb
236402.58,6.0,49,3,4,2,9,0xb2d240d2d
100091.58,2.0,129,3,3,1,7,0xb2d24bb9
17904.34,1.0,10,2,2,3,7,0xb2d5bf95d
10690.96,1.0,74,2,2,1,5,0xb2d6b14d
275328.32,2.0,0,3,3,4,10,0xb2d6ab26
10.66,2.0,18,1,3,2,6,0xb2d6fc2a
483.39,1.0,9,1,2,3,6,0xb2d0c2b9
7604.47,1.0,92,2,2,1,5,0xb2d591d6
20057.85,2.0,14,2,3,3,8,0xb2d23e6c
3590.95,2.0,92,2,3,1,6,0x3b9b159e
269.78,1.0,1,1,2,4,7,0xb2d3ee41
641.29,1.0,0,1,2,4,7,0xb2d91ce0
819.13,1.0,1,1,2,4,7,0xb2d6c1b4
6123.78,3.0,0,2,4,4,10,0xb2d09a8cd
83055.84,3.0,17,3,4,2,9,0xb2d62943d
121051.93,3.0,17,3,4,2,9,0xb2d554c5d
303198.51,2.0,27,4,3,2,9,0xb2d705b0
477216.92,6.0,35,4,4,2,10,0xb2d5751ad
251.37,1.0,6,1,2,3,6,0xb2d5f625
68009.76,2.0,68,3,3,1,7,0xb2d30e6a
3.54,1.0,37,1,2,2,5,0xb2d6c458
0.46,1.0,7,1,2,3,6,0xb2d16ec1
132.82,1.0,60,1,2,2,5,0xb2d6a337d
102012.44,2.0,92,3,3,1,7,0xb2d526b8
370000.0,3.0,4,4,4,4,12,0xb2d6bd50d
2210100.0,1.0,0,4,2,4,10,0xb2da6b54
260139.23,2.0,28,3,3,2,8,0xb2d5bcd2
20176.54,1.0,182,2,2,1,5,0xb2d651ea
60000.63,2.0,235,3,3,1,7,0xb2d63461
23490.19,1.0,5,2,2,3,7,0xb2d18d34d
5017.57,1.0,0,2,2,4,8,0xb2d7c166
2411.55,1.0,20,1,2,2,5,0xb2d60a9a
200719.4,4.0,10,3,4,3,10,0xb2d67e70
206401.66,2.0,279,3,3,1,7,0xb2d6ac8c
187044.44,3.0,3,3,4,4,11,0xb2d08287d
82468.5,4.0,0,3,4,4,11,0xb2d41aefd
240000.0,4.0,3,3,4,4,11,0xb2d24fcf
5001272.05,2.0,25,4,3,2,9,0xb2d41b52
180282.47,6.0,6,3,4,3,10,0xb2d2c320d
2708.0,1.0,10,1,2,3,6,0xb2d1a854
44.14,1.0,14,1,2,3,6,0xb2d402d2
2541006.3,19.0,0,4,4,4,12,0xb2d8dcd4d
100002.5,2.0,13,3,3,3,9,0xb2d635b5
200000.0,1.0,0,3,2,4,9,0xb2da6b34
308.02,1.0,1,1,2,4,7,0xb2d19d55d
11612.41,1.0,92,2,2,1,5,0xb2d2ad12d
6803.28,3.0,11,2,4,3,9,0xb2da0a78
0.8,1.0,66,1,2,2,5,0xb2d6bfb2
227199.74,5.0,8,3,4,3,10,0xb2d5e34f
716020.92,4.0,8,4,4,3,11,0xb2d6ef5fd
50100.46,5.0,37,2,4,2,8,0xb2d24cfa
96013.66,1.0,104,3,2,1,6,0xb2d081b4
41930.14,3.0,1,2,4,4,10,0xb2d1b074d
7000927.91,2.0,13,4,3,3,10,0xb2d334fb
830000.0,1.0,0,4,2,4,10,0xb2d982fa
874198.14,2.0,92,4,3,1,8,0xb2d1e9b0
259332.38,3.0,38,3,4,2,9,0xb2d58caf
352106.65,3.0,130,4,4,1,9,0xb2d23711
27055.55,1.0,7,2,2,3,7,0xb2d6b619
71.17,1.0,10,1,2,3,6,0xb2d1c20f
55002.21,2.0,111,3,3,1,7,0xb2d18f18
100063.03,2.0,0,3,3,4,10,0xb2d6d479
4541.57,1.0,184,2,2,1,5,0xb2d22de7d
166005.34,2.0,92,3,3,1,7,0xb2d25587
411002.03,4.0,3,4,4,4,12,0xb2d4e3c6d
400000.0,9.0,4,4,4,4,12,0xb2d30fc9d
995.18,4.0,3,1,4,4,9,0xb2d065c1
1.58,1.0,13,1,2,3,6,0xb2d6181a
355741.32,3.0,5,4,4,3,11,0xb2d30fc3
0.78,1.0,3,1,2,4,7,0xb2d4a333
65200.49,2.0,0,3,3,4,10,0xb2d1ef08
153092.37,1.0,1,3,2,4,9,0xb2d1ec42
518005.02,4.0,1,4,4,4,12,0xb2d26b29
179008.01,3.0,34,3,4,2,9,0x3b9b3ce1
1476.82,1.0,18,1,2,2,5,0xb2d39f50
650011.65,3.0,94,4,4,1,9,0xb2d3c7cfd
266018.06,2.0,24,3,3,2,8,0xb2d395f4d
1008.42,1.0,184,1,2,1,4,0xb2d37161
20002.16,2.0,14,2,3,3,8,0xb2da29b4
206727.26,5.0,39,3,4,2,9,0xb2d23d7e
4.58,2.0,11,1,3,3,7,0xb2d94f1e
3026.54,1.0,77,2,2,1,5,0xb2d11810
1038.41,1.0,1,1,2,4,7,0xb2d427b2
75.43,1.0,8,1,2,3,6,0xb2d39a8dd
519463.73,2.0,11,4,3,3,10,0xb2d9d552
2.72,1.0,68,1,2,1,4,0xb2d5536c
1051.31,1.0,26,1,2,2,5,0xb2d92a4fd
1004115.92,6.0,0,4,4,4,12,0xb2d0d8d7d
250108.51,3.0,13,3,4,3,10,0xb2d5648cd
4.31,1.0,74,1,2,1,4,0xb2d64522d
111073.26,3.0,27,3,4,2,9,0xb2d5999c
120006.04,1.0,5,3,2,3,8,0xb2d2df64
4249.45,1.0,13,2,2,3,7,0xb2d96ee0
53355.74,1.0,1,3,2,4,9,0xb2d4f59f
5.87,1.0,70,1,2,1,4,0xb2d2037f
795896.36,6.0,27,4,4,2,10,0xb2d4cbbe
2524.03,1.0,0,1,2,4,7,0xb2d41730
261017.53,8.0,15,3,4,3,10,0xb2d6c535
7259.96,1.0,184,2,2,1,5,0xb2d25544d
159048.72,2.0,158,3,3,1,7,0xb2d5d427d
932974.4,5.0,0,4,4,4,12,0xb2d48c24d
106978.75,7.0,11,3,4,3,10,0x3b9adafc
17857.93,1.0,46,2,2,2,6,0xb2d968b3
262123.56,6.0,0,3,4,4,11,0xb2d3c13c
6000.32,1.0,15,2,2,3,7,0xb2d9a88f
37.12,1.0,0,1,2,4,7,0xb2d138c6
147870.17,12.0,0,3,4,4,11,0xb2d4efe0d
59807.7,1.0,10,3,2,3,8,0xb2d6e176
23458.69,1.0,35,2,2,2,6,0xb2d8faae
1541.18,2.0,184,1,3,1,5,0x3b9b32c3
7287.23,1.0,131,2,2,1,5,0xb2d3b78e
486379.35,2.0,0,4,3,4,11,0xb2d30e8fd
520285.48,4.0,7,4,4,3,11,0xb2d5d2c1d
22420.31,1.0,14,2,2,3,7,0xb2d5b206d
175019.52,2.0,42,3,3,2,8,0xb2d281f7d
632320.25,4.0,35,4,4,2,10,0xb2d5aa85
450012.16,4.0,231,4,4,1,9,0xb2d6a1fcd
20013.04,1.0,14,2,2,3,7,0xb2d19f18d
0.0,1.0,184,1,2,1,4,0xb2d2f990d
22595.35,1.0,0,2,2,4,8,0xb2d2abac
160231.06,3.0,0,3,4,4,11,0xb2d667ae
5105.49,1.0,184,2,2,1,5,0xb2d13ab6d
45.36,1.0,56,1,2,2,5,0xb2d62d03
12.61,1.0,19,1,2,2,5,0xb2d36965
10.17,1.0,20,1,2,2,5,0xb2d94c42
203555.12,2.0,181,3,3,1,7,0xb2d6b4c3d
300000.0,2.0,27,3,3,2,8,0xb2da13c5
1640.86,11.0,0,1,4,4,9,0xb2d0692c
10069.12,1.0,11,2,2,3,7,0xb2d7ed4f
50001.58,2.0,39,2,3,2,7,0xb2d9ec3f
12945.52,1.0,184,2,2,1,5,0x3b9b35b1d
1956.8,1.0,19,1,2,2,5,0xb2d1f7c1d
277976.57,2.0,60,3,3,2,8,0xb2d57f58
3102.79,1.0,1,2,2,4,8,0xb2d1e009
653.89,2.0,0,1,3,4,8,0xb2d1a316
15791.38,1.0,92,2,2,1,5,0x3b9b23bd
685225.51,15.0,0,4,4,4,12,0xb2d1882ed
507464.3,3.0,26,4,4,2,10,0xb2d6aa04d
774.15,1.0,19,1,2,2,5,0xb2d2e185d
50000.53,2.0,74,2,3,1,6,0xb2d9a161
67126.16,2.0,0,3,3,4,10,0xb2d34928
4503.39,1.0,0,2,2,4,8,0xb2d4fb73
5103.95,1.0,10,2,2,3,7,0xb2d28f8bd
3869.13,1.0,80,2,2,1,5,0xb2d78d08d
70008.24,2.0,161,3,3,1,7,0xb2d5a7d6
35090.45,1.0,76,2,2,1,5,0xb2d88eeed
9051.46,1.0,25,2,2,2,6,0xb2d96cab
200000.0,2.0,13,3,3,3,9,0xb2d960c6
450.89,1.0,4,1,2,4,7,0xb2d5f1bb
6005.28,1.0,5,2,2,3,7,0xb2d20bfc
242303.66,3.0,0,3,4,4,11,0xb2d28776
12474.2,1.0,20,2,2,2,6,0xb2d66090
505.18,1.0,2,1,2,4,7,0xb2d2c4b9
60.39,1.0,4,1,2,4,7,0xb2d212f7d
997000.23,11.0,1,4,4,4,12,0xb2d64eb4d
200842.85,4.0,17,3,4,2,9,0x3b9b499f
200000.84,2.0,0,3,3,4,10,0xb2d8fa70
1161368.02,4.0,137,4,4,1,9,0xb2d3edae
577.56,1.0,1,1,2,4,7,0xb2d6c2c7
300031.39,4.0,40,3,4,2,9,0xb2d6d4fc
621134.59,5.0,0,4,4,4,12,0xb2d13b11
3780.47,1.0,92,2,2,1,5,0xb2d22102d
1011873.18,5.0,1,4,4,4,12,0xb2d14c5b
2138516.26,18.0,0,4,4,4,12,0x3b9adcdfd
738632.92,8.0,3,4,4,4,12,0xb2d2ad03d
22.06,3.0,27,1,4,2,7,0xb2d8a7ea
561992.96,3.0,29,4,4,2,10,0xb2d641a1
104012.18,1.0,0,3,2,4,9,0xb2d27d07
18392.17,2.0,40,2,3,2,7,0xb2d198e0
3960.48,2.0,184,2,3,1,6,0x3b9af0a4d
200010.57,2.0,105,3,3,1,7,0xb2d95a0a
1.58,1.0,60,1,2,2,5,0x3b9b30e5
950151.31,5.0,6,4,4,3,11,0xb2d7830e
201559.42,2.0,4,3,3,4,10,0xb2d93b6d
1638.57,1.0,209,1,2,1,4,0xb2d68d3f
968.19,4.0,0,1,4,4,9,0xb2d0f851
310043.06,4.0,11,4,4,3,11,0xb2d5107a
100021.38,3.0,11,3,4,3,10,0xb2d6018b
6131.1,1.0,6,2,2,3,7,0xb2d7563ed
782.34,1.0,0,1,2,4,7,0xb2d78f0d
517491.75,2.0,4,4,3,4,11,0xb2d5b628d
50005.94,2.0,259,2,3,1,6,0xb2d65a55
9423.07,1.0,10,2,2,3,7,0xb2d694a3d
251120.38,5.0,10,3,4,3,10,0xb2d69c3bd
1268.23,1.0,200,1,2,1,4,0xb2d5ca09d
4247.73,2.0,3,2,3,4,9,0xb2d4f810d
577351.47,6.0,0,4,4,4,12,0xb2d45f6a
302825.47,2.0,20,4,3,2,9,0xb2d108aed
4000298.19,1.0,8,4,2,3,9,0xb2d9559ad
3508872.36,7.0,4,4,4,4,12,0xb2d379df
160021.38,2.0,24,3,3,2,8,0xb2d93bf9d
0.0,1.0,8,1,2,3,6,0xb2d3db2b
100013.89,2.0,160,3,3,1,7,0xb2d43992
1029.71,1.0,15,1,2,3,6,0xb2d5d583
10109.34,1.0,0,2,2,4,8,0xb2d88fd6
330084.31,3.0,1,4,4,4,12,0xb2d58773d
1.22,1.0,26,1,2,2,5,0xb2d3afb8
13662.06,2.0,11,2,3,3,8,0xb2d3e37c
404329.42,3.0,108,4,4,1,9,0xb2d06e65d
167857.05,4.0,1,3,4,4,11,0xb2d51e3f
33081.54,3.0,25,2,4,2,8,0xb2d6a9d9
843.98,1.0,26,1,2,2,5,0xb2d1dda4
1000000.0,2.0,306,4,3,1,8,0xb2d665ed
4324.73,1.0,9,2,2,3,7,0xb2d600f4
119955.14,2.0,0,3,3,4,10,0xb2d3c362
200365.89,3.0,127,3,4,1,8,0xb2d8d2ac
67049.91,2.0,0,3,3,4,10,0xb2d23eaa
2.56,1.0,6,1,2,3,6,0xb2d9d6af
11929.27,1.0,2,2,2,4,8,0xb2d4f504d
4.15,1.0,4,1,2,4,7,0xb2d909dc
77602.25,2.0,0,3,3,4,10,0xb2d2124bd
468102.5,6.0,54,4,4,2,10,0xb2d515cdd
6.97,1.0,20,1,2,2,5,0xb2d9489a
77466.34,3.0,1,3,4,4,11,0xb2d066c0
16494.85,1.0,21,2,2,2,6,0xb2d60ad5
10687.73,1.0,2,2,2,4,8,0xb2d302e6d
50118.32,1.0,234,2,2,1,5,0xb2d6cd81
3834.0,1.0,2,2,2,4,8,0xb2d5db25
50196.62,1.0,184,2,2,1,5,0xb2d61564
252678.48,3.0,7,3,4,3,10,0xb2d7894dd
100056.01,2.0,200,3,3,1,7,0xb2d5ef70
609615.01,4.0,67,4,4,1,9,0xb2d288fd
12089.31,20.0,69,2,4,1,7,0xb2d0f855
15506.17,1.0,7,2,2,3,7,0xb2d776cc
5000000.0,2.0,3,4,3,4,11,0xb2d944e8
43636.38,1.0,0,2,2,4,8,0xb2d55fc6
164264.73,3.0,0,3,4,4,11,0xb2d34923
434926.2,3.0,37,4,4,2,10,0xb2d2680fd
3093.77,1.0,184,2,2,1,5,0xb2d24fd6
2673.91,1.0,0,1,2,4,7,0xb2d5e710
1166.27,1.0,92,1,2,1,4,0xb2d087ce
553.84,1.0,77,1,2,1,4,0xb2d25bdc
6.0,1.0,3,1,2,4,7,0xb2d19873
1350555.71,4.0,4,4,4,4,12,0xb2d223bf
258912.98,4.0,15,3,4,3,10,0xb2d1fe68d
423235.92,2.0,8,4,3,3,10,0xb2d274bad
16093.51,1.0,0,2,2,4,8,0xb2d68f05
84486.31,2.0,87,3,3,1,7,0xb2d20bfa
282704.93,1.0,17,3,2,2,7,0xb2d280e8d
24.27,1.0,11,1,2,3,6,0xb2d62640d
503556.32,3.0,5,4,4,3,11,0xb2d59eee
59.75,1.0,10,1,2,3,6,0xb2d4132d
336877.54,2.0,14,4,3,3,10,0xb2d4ff14
2405005.09,17.0,0,4,4,4,12,0xb2d6b6a2d
43.53,1.0,4,1,2,4,7,0xb2d6cd33
450009.5,3.0,6,4,4,3,11,0xb2da3f8c
1896.57,1.0,184,1,2,1,4,0xb2d1dd19
5994.7,3.0,0,2,4,4,10,0xb2d09539d
5839.3,1.0,47,2,2,2,6,0xb2d9aab0
231.81,1.0,64,1,2,2,5,0xb2d1ac25
71064.93,3.0,10,3,4,3,10,0xb2d4c936
431821.35,5.0,49,4,4,2,10,0xb2d65574
0.0,1.0,10,1,2,3,6,0xb2d300d2d
7831.92,1.0,184,2,2,1,5,0xb2d1679d
345163.85,2.0,136,4,3,1,8,0xb2d5ed35
110.28,1.0,70,1,2,1,4,0xb2d37a40
17166.77,1.0,7,2,2,3,7,0xb2d9680f
6052.91,1.0,32,2,2,2,6,0xb2d9a405
101454.57,2.0,182,3,3,1,7,0xb2d62bc2
22798.35,1.0,1,2,2,4,8,0xb2d301f4
127863.25,2.0,76,3,3,1,7,0xb2d4294ad
3839.68,2.0,12,2,3,3,8,0xb2d06ea3
7373.25,1.0,92,2,2,1,5,0xb2d55aded
7143390.08,1.0,3,4,2,4,10,0xb2d338dd
200052.18,2.0,19,3,3,2,8,0xb2d86d4a
9276.82,1.0,1,2,2,4,8,0xb2d8d516
511850.79,3.0,27,4,4,2,10,0xb2d665b5
50000.53,2.0,83,2,3,1,6,0xb2d8d194d
6498.82,1.0,0,2,2,4,8,0xb2d4267f
6756.68,1.0,1,2,2,4,8,0xb2d3274e
3.17,1.0,88,1,2,1,4,0xb2d8a672
38456.29,1.0,5,2,2,3,7,0xb2d33911
60166.02,2.0,0,3,3,4,10,0xb2d1f712
60962.18,2.0,3,3,3,4,10,0xb2d0d96f
55652.97,1.0,172,3,2,1,6,0xb2d08661d
4722.69,1.0,168,2,2,1,5,0xb2d20df9
266.83,1.0,7,1,2,3,6,0xb2d2d158
104924.23,2.0,5,3,3,3,9,0xb2d4f8bfd
43691.09,1.0,5,2,2,3,7,0xb2d55be7
690435.11,4.0,58,4,4,2,10,0xb2d10db0
37898.07,1.0,1,2,2,4,8,0xb2d6cca9
42623.23,1.0,24,2,2,2,6,0x3b9b3789d
12213.03,3.0,5,2,4,3,9,0xb2d095d7
515204.61,2.0,102,4,3,1,8,0xb2d06a4e
19.2,1.0,25,1,2,2,5,0xb2d53662d
668.92,1.0,7,1,2,3,6,0xb2d19479
90001.59,2.0,18,3,3,2,8,0xb2d5d980
1807.91,1.0,0,1,2,4,7,0xb2d6c2b5d
5086.41,1.0,92,2,2,1,5,0xb2d0ed25
1.86,1.0,79,1,2,1,4,0xb2d2652e
1501.82,1.0,92,1,2,1,4,0x3b9af4e6
500000.0,2.0,5,4,3,3,10,0xb2d6a545d
910.3,1.0,39,1,2,2,5,0xb2d27567
41611.44,1.0,2,2,2,4,8,0xb2d2bb9c
65804.17,1.0,92,3,2,1,6,0xb2d1c270
6183.33,1.0,15,2,2,3,7,0xb2da0814
26531.93,1.0,3,2,2,4,8,0xb2d2f1b8d
42403.39,1.0,92,2,2,1,5,0xb2d2b48a
21.17,1.0,77,1,2,1,4,0xb2d49029
1323615.46,9.0,0,4,4,4,12,0xb2d396e1d
815093.16,2.0,0,4,3,4,11,0xb2d598c9
36.83,1.0,8,1,2,3,6,0xb2d1e127
18394.43,1.0,16,2,2,2,6,0xb2d24151
11000.35,2.0,25,2,3,2,7,0xb2da0d92
4.82,2.0,28,1,3,2,6,0xb2d91461d
20106.28,1.0,150,2,2,1,5,0xb2d7009ed
556000.0,10.0,1,4,4,4,12,0xb2d3a65c
186.5,1.0,1,1,2,4,7,0xb2d3108b
278598.03,4.0,6,3,4,3,10,0xb2d26eba
3.21,1.0,84,1,2,1,4,0xb2d591c2
10000.53,2.0,182,2,3,1,6,0xb2d6f67ad
74914.39,8.0,0,3,4,4,11,0x3b9ae61b
74326.42,1.0,10,3,2,3,8,0xb2d6f352
339195.29,1.0,189,4,2,1,7,0xb2d1fcf3d
250631.27,4.0,17,3,4,2,9,0xb2d6eb0f
4355.5,1.0,1,2,2,4,8,0xb2d58bf7
32279.72,8.0,7,2,4,3,9,0x3b9b0f32d
4937.93,1.0,0,2,2,4,8,0xb2d6ab65
2401896.7,28.0,7,4,4,3,11,0xb2d60dc1d
302131.48,2.0,60,4,3,2,9,0xb2d9c3e6
1075.79,2.0,299,1,3,1,5,0x3b9b23dad
71887.18,3.0,5,3,4,3,10,0xb2d1b381
22.67,1.0,11,1,2,3,6,0xb2d64530
467000.0,6.0,3,4,4,4,12,0xb2d40fc2
7.33,1.0,39,1,2,2,5,0xb2d987a6
433056.24,2.0,21,4,3,2,9,0xb2d0edcf
0.0,2.0,0,1,3,4,8,0xb2da5b0c
650000.73,3.0,6,4,4,3,11,0xb2d4cafe
4002.37,1.0,12,2,2,3,7,0xb2d83d7b
30603.3,1.0,8,2,2,3,7,0xb2d6090e
5109.05,1.0,23,2,2,2,6,0xb2d47f1dd
1119.11,1.0,92,1,2,1,4,0xb2d1a2ce
300027.12,3.0,80,3,4,1,8,0xb2d3eadcd
205161.26,4.0,18,3,4,2,9,0xb2d3eeab
576.61,1.0,4,1,2,4,7,0xb2d59717
61240.78,4.0,10,3,4,3,10,0xb2d63337
1008.59,1.0,184,1,2,1,4,0xb2d10104
450000.88,2.0,12,4,3,3,10,0xb2d9a589
22300.36,2.0,2,2,3,4,9,0x3b9b3485
12366.04,1.0,0,2,2,4,8,0xb2d6aa83d
163917.09,3.0,0,3,4,4,11,0xb2d9e9f2
1800.25,1.0,6,1,2,3,6,0xb2d2207b
956.64,1.0,6,1,2,3,6,0xb2d32b7d
2963.59,11.0,119,2,4,1,7,0xb2d209f5
10121.89,2.0,14,2,3,3,8,0xb2d91c2c
2126300.65,15.0,0,4,4,4,12,0x3b9af15d
3.09,1.0,59,1,2,2,5,0xb2d5cc4d
14070.02,1.0,184,2,2,1,5,0x3b9b3ed7d
3342.71,1.0,33,2,2,2,6,0xb2d39044
600689.32,2.0,0,4,3,4,11,0xb2d502c0
0.0,1.0,0,1,2,4,7,0xb2d8f964
6941.22,1.0,2,2,2,4,8,0xb2d3a9bc
6262.47,1.0,92,2,2,1,5,0xb2d283b7
400799.93,3.0,36,4,4,2,10,0xb2d6eeb7
20345.07,1.0,1,2,2,4,8,0xb2d5e62a
400042.5,2.0,1,4,3,4,11,0xb2d5dbe2d
340140.53,2.0,11,4,3,3,10,0xb2d57dd5d
2000000.0,5.0,0,4,4,4,12,0xb2d5fd5d
360099.96,3.0,0,4,4,4,12,0xb2d1bb13d
2025.66,2.0,92,1,3,1,5,0xb2d1a7f8
120004.83,2.0,134,3,3,1,7,0xb2d8ef05
57641.21,4.0,139,3,4,1,8,0xb2d31a26
1570010.56,4.0,6,4,4,3,11,0xb2d94799
29515.86,1.0,10,2,2,3,7,0xb2d42e1fd
14566.37,1.0,0,2,2,4,8,0xb2d6c9e6
325787.48,5.0,0,4,4,4,12,0xb2d25553
253011.56,4.0,22,3,4,2,9,0xb2d80e50d
33100.48,2.0,97,2,3,1,6,0xb2d60738
103433.96,3.0,95,3,4,1,8,0xb2d4b443
29792.55,1.0,200,2,2,1,5,0xb2d623e2
202845.14,2.0,54,3,3,2,8,0xb2d61e3dd
200000.62,2.0,5,3,3,3,9,0xb2d18468
30834.84,1.0,4,2,2,4,8,0xb2d3eb9b
5783.15,2.0,0,2,3,4,9,0xb2d10bd1d
285972.47,2.0,105,3,3,1,7,0xb2d7fc69
7928.25,1.0,29,2,2,2,6,0xb2d9283e
109310.38,2.0,200,3,3,1,7,0xb2d5bcfad
543945.68,2.0,0,4,3,4,11,0xb2d9347f
16329.16,1.0,3,2,2,4,8,0xb2d4aa1d
1687000.7,32.0,3,4,4,4,12,0xb2d21edb
283603.39,3.0,32,3,4,2,9,0xb2d6a215d
8999.78,1.0,0,2,2,4,8,0xb2d534d8d
103611.24,2.0,26,3,3,2,8,0xb2d0f3a6
1500060.3,3.0,20,4,4,2,10,0xb2d95187d
0.0,1.0,7,1,2,3,6,0xb2d6924f
10826.87,2.0,6,2,3,3,8,0xb2d3cbb5
121625.81,3.0,3,3,4,4,11,0xb2d9bca8
753999.18,5.0,3,4,4,4,12,0xb2d41097
348000.61,2.0,6,4,3,3,10,0xb2d57e97
310085.17,5.0,3,4,4,4,12,0xb2d4c84dd
60083.13,3.0,3,3,4,4,11,0xb2d61dff
693700.92,5.0,10,4,4,3,11,0xb2d64ee2d
900038.02,3.0,94,4,4,1,9,0xb2d7c6dfd
52657.44,1.0,10,3,2,3,8,0xb2d2d3c6
50000.53,2.0,20,2,3,2,7,0xb2d930e3
208000.0,11.0,0,3,4,4,11,0xb2d6b168
271382.47,3.0,8,3,4,3,10,0xb2d90143
540.52,1.0,12,1,2,3,6,0xb2d245a7
6902.77,1.0,2,2,2,4,8,0xb2d6972bd
810048.49,8.0,2,4,4,4,12,0xb2d06827
1718.1,2.0,184,1,3,1,5,0xb2d07447
2424388.33,15.0,0,4,4,4,12,0x3b9b0e6a
100002.22,3.0,122,3,4,1,8,0xb2d48276
385010.99,3.0,62,4,4,2,10,0xb2d2c460d
10103.12,2.0,60,2,3,2,7,0xb2d9bb38
21698.38,9.0,47,2,4,2,8,0xb2d2ef25
446001.88,4.0,3,4,4,4,12,0xb2d8d2e3
172009.08,2.0,34,3,3,2,8,0xb2d92bdc
95312.68,1.0,3,3,2,4,9,0xb2d25a62
206178.79,5.0,18,3,4,2,9,0xb2d1b946d
100005.44,2.0,27,3,3,2,8,0xb2d6f235
61988.87,2.0,179,3,3,1,7,0xb2d52e61
2134.86,1.0,10,1,2,3,6,0xb2d358a6
90012.04,3.0,27,3,4,2,9,0xb2d5f1fdd
748366.04,18.0,0,4,4,4,12,0x3b9b183c
46.11,2.0,20,1,3,2,6,0xb2d2bbf2
43993.1,1.0,1,2,2,4,8,0xb2d43712d
400000.01,3.0,4,4,4,4,12,0xb2d9e75f
532608.01,6.0,18,4,4,2,10,0xb2d14c57
239176.95,2.0,24,3,3,2,8,0xb2d63d6b
4059.92,1.0,20,2,2,2,6,0xb2d19d4e
5216.12,1.0,14,2,2,3,7,0xb2d67decd
0.0,1.0,8,1,2,3,6,0xb2d3d34f
185.14,1.0,7,1,2,3,6,0xb2d8e80f
3015.6,4.0,105,2,4,1,7,0xb2d0fbc7
30000.0,2.0,1,2,3,4,9,0xb2da5046
10013.17,1.0,6,2,2,3,7,0xb2d81041
21.85,1.0,39,1,2,2,5,0xb2d68bd3
88000.59,6.0,6,3,4,3,10,0xb2d58d00
249509.1,1.0,0,3,2,4,9,0xb2d57612
209278.21,5.0,11,3,4,3,10,0xb2d3422fd
367979.56,5.0,13,4,4,3,11,0xb2d20b0e
250030.0,3.0,6,3,4,3,10,0xb2da4f5e
94791.74,3.0,2,3,4,4,11,0xb2d1ae92
62085.04,3.0,12,3,4,3,10,0xb2d4a334
200303.92,3.0,7,3,4,3,10,0xb2d97277
7790.54,1.0,10,2,2,3,7,0xb2d6adff
343441.42,5.0,13,4,4,3,11,0xb2d62891
585701.16,4.0,0,4,4,4,12,0xb2d34e4bd
14627.16,1.0,40,2,2,2,6,0xb2d323f4
200222.64,2.0,202,3,3,1,7,0xb2d06d49d
500000.14,2.0,8,4,3,3,10,0xb2d625fb
2018.05,1.0,9,1,2,3,6,0xb2d8f436
914.24,1.0,0,1,2,4,7,0xb2d438c5d
200005.3,3.0,28,3,4,2,9,0xb2d3c0eb
450001.0,4.0,6,4,4,3,11,0xb2d6297c
575761.77,2.0,3,4,3,4,11,0xb2d1c6e3
540006.98,3.0,38,4,4,2,10,0xb2d68222d
26.1,1.0,29,1,2,2,5,0xb2d2c9ee
100009.64,2.0,189,3,3,1,7,0xb2d58e3d
1024.14,1.0,92,1,2,1,4,0xb2d2cd6ad
44444.81,1.0,4,2,2,4,8,0xb2d6097fd
90102.84,2.0,0,3,3,4,10,0xb2d2b96ad
169217.11,10.0,4,3,4,4,11,0xb2d4b32f
731137.43,10.0,6,4,4,3,11,0xb2d43c3a
189347.43,4.0,0,3,4,4,11,0xb2d1febc
2384.54,3.0,0,1,4,4,9,0xb2d315a4
1459.27,1.0,184,1,2,1,4,0xb2d2e34fd
10168.13,2.0,52,2,3,2,7,0xb2d2c50c
167214.28,3.0,104,3,4,1,8,0xb2d43444
61061.73,1.0,247,3,2,1,6,0xb2d2dc22
30139.48,2.0,1,2,3,4,9,0xb2d59421
10757.72,1.0,26,2,2,2,6,0xb2d5d3c1
193194.82,1.0,104,3,2,1,6,0xb2d5ff74
1131.11,1.0,184,1,2,1,4,0xb2d14f1b
800042.22,2.0,83,4,3,1,8,0xb2d98525
270044.71,3.0,165,3,4,1,8,0xb2d2f60ed
200000.0,2.0,15,3,3,3,9,0xb2da376e
20289.53,2.0,99,2,3,1,6,0xb2d772e8d
49.32,1.0,55,1,2,2,5,0xb2d45260
480000.05,2.0,11,4,3,3,10,0xb2d6f8e7d
11975.68,1.0,14,2,2,3,7,0xb2d8c8ba
7073.67,1.0,20,2,2,2,6,0xb2d297f7d
11.38,1.0,26,1,2,2,5,0xb2d58472d
673058.93,11.0,24,4,4,2,10,0xb2d2891b
580062.16,4.0,1,4,4,4,12,0xb2d10d4ad
3185.08,1.0,92,2,2,1,5,0xb2d40e4ad
54001.14,2.0,4,3,3,4,10,0xb2d9be0a
5037.7,1.0,92,2,2,1,5,0xb2d2349c
255421.15,12.0,0,3,4,4,11,0xb2d0691ed
324253.66,2.0,68,4,3,1,8,0xb2d39ffad
150034.22,2.0,224,3,3,1,7,0xb2d2ad3b
3.64,1.0,71,1,2,1,4,0xb2d1a224
230248.73,6.0,0,3,4,4,11,0xb2d56a2bd
50095.8,1.0,0,2,2,4,8,0xb2d910cfd
1001.16,1.0,120,1,2,1,4,0xb2d91a24
21244.16,1.0,10,2,2,3,7,0xb2d6c9d1d
20559.86,1.0,11,2,2,3,7,0xb2d6868a
152533.68,2.0,125,3,3,1,7,0xb2d55e64
17183.99,1.0,0,2,2,4,8,0xb2d18c1e
328626.58,3.0,35,4,4,2,10,0xb2d6298bd
254545.63,4.0,0,3,4,4,11,0xb2d22f35d
1282.68,1.0,184,1,2,1,4,0xb2d38a6f
11.48,1.0,19,1,2,2,5,0xb2d95167
845.26,1.0,1,1,2,4,7,0xb2d8c61ad
3601.0,1.0,9,2,2,3,7,0xb2d9083e
10101.64,1.0,1,2,2,4,8,0xb2d27c5a
50002.11,2.0,83,2,3,1,6,0xb2d8ce59d
20375.65,1.0,92,2,2,1,5,0xb2d3efba
600008.75,2.0,15,4,3,3,10,0xb2d6f78e
1000000.21,2.0,7,4,3,3,10,0xb2d92e97d
152972.48,2.0,60,3,3,2,8,0xb2d14f80
6769.42,3.0,92,2,4,1,7,0xb2d0a682
250998.69,3.0,1,3,4,4,11,0xb2d9b01f
351767.16,4.0,0,4,4,4,12,0xb2d64631
383665.09,7.0,7,4,4,3,11,0xb2d1c06ad
91.99,1.0,9,1,2,3,6,0xb2d4dc00
44.04,1.0,13,1,2,3,6,0xb2d1eb03
105684.83,7.0,1,3,4,4,11,0xb2d064a6d
245094.56,3.0,10,3,4,3,10,0xb2d10805d
570909.28,6.0,11,4,4,3,11,0xb2d41380
10018.59,1.0,185,2,2,1,5,0xb2d6a14bd
129.0,1.0,4,1,2,4,7,0xb2d94165
580722.02,2.0,42,4,3,2,9,0xb2d1c71f
290003.06,2.0,98,3,3,1,7,0xb2d96cc6
590000.0,3.0,3,4,4,4,12,0xb2d94b96d
18000.57,2.0,60,2,3,2,7,0xb2d9b9db
1003.27,1.0,184,1,2,1,4,0xb2d5cf71
100015.29,2.0,18,3,3,2,8,0xb2d31429
2737.18,1.0,0,1,2,4,7,0xb2d5d487d
2518.94,1.0,92,1,2,1,4,0xb2d2c37ad
1203.63,1.0,280,1,2,1,4,0xb2d22324d
300000.0,2.0,18,3,3,2,8,0xb2da347b
93401.12,2.0,62,3,3,2,8,0xb2d6379ad
182.72,1.0,38,1,2,2,5,0xb2d6f88e
6610.32,1.0,14,2,2,3,7,0xb2d6bffd
12476.72,1.0,102,2,2,1,5,0xb2d52108
202708.23,2.0,54,3,3,2,8,0xb2d17ce9d
100290.98,2.0,187,3,3,1,7,0xb2d1b59d
1261292.55,8.0,4,4,4,4,12,0xb2d5e76c
2.94,1.0,9,1,2,3,6,0xb2d904ea
2632.57,1.0,238,1,2,1,4,0xb2d60b88
101003.48,8.0,13,3,4,3,10,0xb2d12d64
10.11,1.0,11,1,2,3,6,0xb2d11c1d
10029.19,2.0,11,2,3,3,8,0xb2d9f8a8
55062.36,1.0,31,3,2,2,7,0xb2d10ec8
0.05,1.0,6,1,2,3,6,0xb2d901da
191.69,1.0,15,1,2,3,6,0xb2d8f6e5
500016.12,2.0,165,4,3,1,8,0xb2d4f1bad
34.29,1.0,75,1,2,1,4,0xb2d2ad6f
500042.86,2.0,144,4,3,1,8,0xb2d1845ed
290.42,1.0,10,1,2,3,6,0xb2d767d8d
2051.29,1.0,30,1,2,2,5,0xb2d2e5ec
1842.78,1.0,1,1,2,4,7,0xb2d6bb61d
12814.06,1.0,64,2,2,2,6,0xb2d4e560
205.57,1.0,0,1,2,4,7,0xb2d1965d
600083.97,6.0,3,4,4,4,12,0xb2d957ded
19482.87,1.0,112,2,2,1,5,0xb2d4c27bd
1018516.48,3.0,101,4,4,1,9,0xb2d92b0cd
662943.98,2.0,0,4,3,4,11,0xb2d1a313
5026.13,1.0,92,2,2,1,5,0xb2d42d1d
1000005.7,3.0,18,4,4,2,10,0xb2da29d5
41073.79,1.0,16,2,2,2,6,0xb2d259a8
20757.92,1.0,4,2,2,4,8,0xb2d575b5
200738.43,2.0,31,3,3,2,8,0xb2d58c9f
5870.21,1.0,183,2,2,1,5,0xb2d613cdd
72481.18,2.0,3,3,3,4,10,0xb2d26050
2943.25,1.0,19,2,2,2,6,0xb2d6c240d
21694.67,2.0,74,2,3,1,6,0xb2d35b51
180019.11,2.0,98,3,3,1,7,0xb2d23de1
2000000.51,3.0,0,4,4,4,12,0xb2d3a8e6
52613.71,3.0,5,3,4,3,10,0xb2d0f792
670045.48,4.0,92,4,4,1,9,0xb2d12833d
400004.22,3.0,8,4,4,3,11,0xb2da47a5
150080.08,3.0,14,3,4,3,10,0xb2d21fb5d
2352030.48,1.0,0,4,2,4,10,0xb2d2e1fad
399706.82,2.0,124,4,3,1,8,0xb2d71748
8178.63,1.0,10,2,2,3,7,0xb2d32d1ad
6631.58,1.0,13,2,2,3,7,0xb2d6e230
47303.32,2.0,14,2,3,3,8,0xb2d51d06
300000.0,2.0,0,3,3,4,10,0xb2da61e9
513.85,1.0,29,1,2,2,5,0xb2d39045
8.44,1.0,74,1,2,1,4,0xb2d9905e
760000.0,12.0,0,4,4,4,12,0xb2d520ccd
89822.1,28.0,0,3,4,4,11,0xb2d210e3
233101.87,3.0,4,3,4,4,11,0xb2d1e72ed
6266.73,3.0,5,2,4,3,9,0xb2d0c428
1272843.77,7.0,1,4,4,4,12,0xb2d5ad17
1250066.93,5.0,165,4,4,1,9,0xb2d41f43d
70030.0,2.0,66,3,3,2,8,0xb2d6c6f8
450220.68,3.0,150,4,4,1,9,0xb2d8c6d3
191.33,1.0,11,1,2,3,6,0xb2d3404ad
5091.97,1.0,184,2,2,1,5,0xb2d10933
330569.5,3.0,20,4,4,2,10,0xb2d5c7af
187.79,1.0,70,1,2,1,4,0xb2d16b2dd
328.77,1.0,7,1,2,3,6,0xb2d5f2ccd
405686.05,2.0,131,4,3,1,8,0xb2d70084
760016.25,4.0,18,4,4,2,10,0xb2d8ef11d
20320.75,2.0,4,2,3,4,9,0xb2d16f3e
400.47,1.0,4,1,2,4,7,0xb2d69ee1
100001.59,2.0,14,3,3,3,9,0xb2d24dac
3992.47,1.0,28,2,2,2,6,0xb2d275a3d
7.54,1.0,35,1,2,2,5,0xb2d08da8
4480.64,1.0,184,2,2,1,5,0xb2d18f89d
3064.63,1.0,92,2,2,1,5,0xb2d2a77ad
410003.0,2.0,0,4,3,4,11,0xb2d96dd5
9.14,1.0,60,1,2,2,5,0xb2d657d5
10005.81,1.0,147,2,2,1,5,0xb2d63476
203501.15,2.0,235,3,3,1,7,0xb2d60d97
18996.37,1.0,2,2,2,4,8,0xb2d34426d
200092.42,2.0,95,3,3,1,7,0xb2d35cf0
3728281.23,3.0,2,4,4,4,12,0xb2d0f15a
161.67,1.0,9,1,2,3,6,0xb2d3c36f
307122.65,3.0,77,4,4,1,9,0xb2d657b9d
1278.01,1.0,13,1,2,3,6,0xb2d282cdd
1081875.47,5.0,0,4,4,4,12,0xb2d48277
5997.04,1.0,0,2,2,4,8,0xb2d3fe3d
500061.74,3.0,18,4,4,2,10,0xb2d68a79
1103246.72,5.0,26,4,4,2,10,0xb2d0da82d
150610.61,4.0,24,3,4,2,9,0xb2d19cedd
2019.79,1.0,9,1,2,3,6,0xb2d4e9e6
400062.83,2.0,0,4,3,4,11,0xb2d6b1d8d
0.05,1.0,3,1,2,4,7,0xb2d8de7b
330093.88,5.0,77,4,4,1,9,0xb2d1e518
796789.74,6.0,17,4,4,2,10,0xb2d1072a
53699.77,1.0,108,3,2,1,6,0xb2d2ffdf
1886.55,1.0,0,1,2,4,7,0xb2d64d4b
276.53,1.0,12,1,2,3,6,0xb2d67ecf
70014.24,3.0,11,3,4,3,10,0xb2d9f3a5
50060.73,2.0,62,2,3,2,7,0xb2d8e69cd
10585.43,1.0,92,2,2,1,5,0x3b9b3f78
836048.91,7.0,27,4,4,2,10,0xb2d5d2ab
200687.03,6.0,168,3,4,1,8,0xb2d07573
189.07,1.0,2,1,2,4,7,0xb2d10980
93670.56,4.0,75,3,4,1,8,0xb2d62337
51009.42,2.0,27,2,3,2,7,0xb2d686f5d
488783.0,7.0,24,4,4,2,10,0xb2d1a664d
1003657.62,2.0,42,4,3,2,9,0xb2d9632bd
35939.68,1.0,0,2,2,4,8,0xb2da5094
530052.81,4.0,21,4,4,2,10,0xb2d957c6
130181.82,3.0,4,3,4,4,11,0xb2d44310
1269.48,1.0,18,1,2,2,5,0xb2d43c8ad
5209.95,1.0,0,2,2,4,8,0xb2d0b46a
1014.69,1.0,184,1,2,1,4,0xb2d13da5
100600.0,2.0,0,3,3,4,10,0xb2d6b9cc
561651.22,1.0,0,4,2,4,10,0xb2d327b8
10033.28,1.0,92,2,2,1,5,0xb2d5e07f
40044.01,1.0,25,2,2,2,6,0xb2d5de69d
313321.2,2.0,102,4,3,1,8,0xb2d48fa5
361831.98,5.0,3,4,4,4,12,0x3b9b4120
6524.54,1.0,58,2,2,2,6,0xb2d347dd
300000.0,2.0,19,3,3,2,8,0xb2d9577fd
281625.93,2.0,213,3,3,1,7,0xb2d1e99dd
24389.32,2.0,184,2,3,1,6,0xb2d232d0d
2151.87,1.0,0,1,2,4,7,0xb2d6809d
3919.27,1.0,3,2,2,4,8,0xb2d78334
955963.66,2.0,1,4,3,4,11,0xb2d3a1db
4001.61,4.0,27,2,4,2,8,0xb2d5833ad
11063.98,2.0,80,2,3,1,6,0xb2d11054d
200006.33,2.0,53,3,3,2,8,0xb2d9c5e2
224978.09,3.0,34,3,4,2,9,0xb2d686f3d
1650047.96,5.0,0,4,4,4,12,0xb2d703ee
10250.59,2.0,97,2,3,1,6,0xb2d638d6
142.69,2.0,14,1,3,3,7,0xb2d93261
132896.35,5.0,0,3,4,4,11,0xb2d21130d
1650000.7,7.0,7,4,4,3,11,0xb2d64741d
100009.97,2.0,85,3,3,1,7,0xb2d379f1
11730.89,1.0,6,2,2,3,7,0xb2d8eb93
153.81,1.0,44,1,2,2,5,0xb2d22519
213328.07,2.0,27,3,3,2,8,0xb2d1b6d1d
160209.12,2.0,139,3,3,1,7,0xb2d55704d
1552.66,1.0,0,1,2,4,7,0xb2d6c651
19181.84,1.0,11,2,2,3,7,0xb2d4c1e0d
269509.47,1.0,91,3,2,1,6,0xb2d4f577d
35000.37,2.0,60,2,3,2,7,0xb2d9bf39
1150025.83,3.0,4,4,4,4,12,0xb2d90cc5
16457.02,1.0,0,2,2,4,8,0xb2d69a28
310005.84,4.0,23,4,4,2,10,0xb2d59213d
140011.96,2.0,13,3,3,3,9,0xb2d2c354d
10.25,5.0,11,1,4,3,8,0xb2d06481
70809.82,2.0,63,3,3,2,8,0xb2d8df66
270925.27,5.0,116,3,4,1,8,0x3b9b1339
190040.5,4.0,55,3,4,2,9,0xb2d40044d
203585.87,2.0,128,3,3,1,7,0xb2d2d956
546.8,1.0,15,1,2,3,6,0xb2d314e2
40851.31,2.0,3,2,3,4,9,0xb2d5e609d
587314.14,8.0,39,4,4,2,10,0xb2d4dee3
528077.5,4.0,35,4,4,2,10,0xb2d416cf
1750625.09,4.0,45,4,4,2,10,0xb2d07d23d
820319.69,3.0,24,4,4,2,10,0xb2d690cd
2.14,1.0,77,1,2,1,4,0xb2d5f081
6497.92,1.0,0,2,2,4,8,0xb2d30db8
1600072.38,4.0,200,4,4,1,9,0xb2d5e71dd
130001.37,3.0,62,3,4,2,9,0xb2d6d69f
24028.35,1.0,20,2,2,2,6,0xb2d64a82
3053.34,1.0,32,2,2,2,6,0xb2d5c7a2
1061386.18,9.0,63,4,4,2,10,0xb2d4519ad
201682.21,2.0,12,3,3,3,9,0xb2d9590a
10222.09,1.0,184,2,2,1,5,0xb2d297cb
264644.7,4.0,27,3,4,2,9,0xb2d2050bd
2106.31,1.0,0,1,2,4,7,0xb2d21f03
1946.67,1.0,92,1,2,1,4,0xb2d35d29
1114450.83,4.0,56,4,4,2,10,0xb2d5eb9fd
5604.23,2.0,9,2,3,3,8,0xb2d90c11
546721.64,3.0,68,4,4,1,9,0xb2d567bdd
11652.29,1.0,115,2,2,1,5,0xb2d94702d
710.28,1.0,4,1,2,4,7,0xb2d2e1e3
172908.06,5.0,0,3,4,4,11,0x3b9b463dd
423138.38,3.0,18,4,4,2,10,0xb2d9466ad
391.58,1.0,17,1,2,2,5,0xb2d2b5d7d
108212.85,1.0,28,3,2,2,7,0xb2d425e0
140032.59,3.0,47,3,4,2,9,0xb2d0f99fd
500485.03,2.0,3,4,3,4,11,0xb2d22512
1617.0,1.0,184,1,2,1,4,0xb2d22222d
500051.79,3.0,37,4,4,2,10,0xb2d22398
4506.22,1.0,110,2,2,1,5,0xb2d3bc89d
50013.96,2.0,208,2,3,1,6,0xb2d5efca
220000.21,3.0,25,3,4,2,9,0xb2da174f
1014.05,1.0,184,1,2,1,4,0xb2d2b2e0
34.38,3.0,1,1,4,4,9,0xb2d2394c
305007.21,2.0,11,4,3,3,10,0xb2d612b5d
1030.52,1.0,0,1,2,4,7,0xb2d8dbd1
33595.25,2.0,138,2,3,1,6,0xb2d613e9
122155.14,4.0,147,3,4,1,8,0xb2d0f233
2131.04,1.0,29,1,2,2,5,0xb2d399c4
2202.62,1.0,22,1,2,2,5,0xb2d21f96
100018.66,3.0,42,3,4,2,9,0xb2d69c97
498094.17,6.0,0,4,4,4,12,0xb2d2389ed
65.32,1.0,9,1,2,3,6,0xb2d8ced4
0.77,1.0,5,1,2,3,6,0xb2d27b70
600.48,1.0,6,1,2,3,6,0xb2d6b5fb
148042.32,5.0,25,3,4,2,9,0xb2d09916
401385.26,2.0,0,4,3,4,11,0xb2d5c082d
1147000.0,21.0,4,4,4,4,12,0xb2d14d98
534185.21,5.0,18,4,4,2,10,0xb2d0d2d3d
30092.89,4.0,4,2,4,4,10,0xb2d6530e
403.08,1.0,40,1,2,2,5,0xb2d96617
76.82,1.0,71,1,2,1,4,0xb2d6ba33
200001.18,2.0,6,3,3,3,9,0xb2d9dd37
28.1,1.0,77,1,2,1,4,0xb2d2da1c
100010.59,2.0,18,3,3,2,8,0xb2d3f1f3
1735089.54,12.0,6,4,4,3,11,0xb2d4ac36d
200000.0,2.0,20,3,3,2,8,0xb2d8dd00
1548000.0,12.0,1,4,4,4,12,0xb2d2dd2dd
435054.24,2.0,125,4,3,1,8,0xb2d69f5ed
2136.47,1.0,97,1,2,1,4,0xb2d6265bd
552139.62,6.0,60,4,4,2,10,0xb2d92130
467161.65,7.0,12,4,4,3,11,0xb2d22a69
1.06,1.0,55,1,2,2,5,0xb2d9c5e3
52.2,1.0,5,1,2,3,6,0xb2d8e2e5
450200.67,5.0,7,4,4,3,11,0xb2d64ecad
1006.35,1.0,92,1,2,1,4,0xb2d3e601
396.4,2.0,84,1,3,1,5,0xb2d93561
52199.62,1.0,7,3,2,3,8,0xb2d68361d
6469.01,1.0,3,2,2,4,8,0xb2d6e8e3
12550.79,1.0,106,2,2,1,5,0xb2d3d6e3
1117.3,1.0,0,1,2,4,7,0xb2d69f52
1056898.45,9.0,49,4,4,2,10,0xb2d174bd
14974.23,1.0,0,2,2,4,8,0xb2d18332
16036.51,1.0,0,2,2,4,8,0xb2d4dc66d
12862.75,1.0,11,2,2,3,7,0xb2d9959e
66.7,1.0,5,1,2,3,6,0xb2d30e96
600.0,4.0,0,1,4,4,9,0x3b9af0c5
30000.32,2.0,6,2,3,3,8,0xb2d96baa
975850.4,17.0,3,4,4,4,12,0xb2d1c544
102400.29,1.0,92,3,2,1,6,0xb2d35f76d
279616.46,2.0,48,3,3,2,8,0xb2d5e3af
11500.0,1.0,0,2,2,4,8,0xb2d6e704d
140003.14,2.0,55,3,3,2,8,0xb2d5bd11
194491.11,4.0,3,3,4,4,11,0xb2d181fdd
217.89,1.0,38,1,2,2,5,0xb2d34fc9
9089.55,1.0,184,2,2,1,5,0xb2d1b556
100015.96,3.0,77,3,4,1,8,0xb2d54defd
700000.0,6.0,0,4,4,4,12,0xb2d11a74
517236.97,2.0,110,4,3,1,8,0xb2d4ae11
52690.51,2.0,1,3,3,4,10,0xb2d61fbd
400007.74,3.0,13,4,4,3,11,0xb2d1b6d6
406404.31,3.0,49,4,4,2,10,0xb2d784fa
7004.37,1.0,0,2,2,4,8,0xb2d40bd2
1035009.65,8.0,11,4,4,3,11,0xb2d12643
299019.14,6.0,0,3,4,4,11,0xb2d43e3e
109115.17,4.0,0,3,4,4,11,0xb2d212fed
100002.11,2.0,52,3,3,2,8,0xb2d90a09
89.52,1.0,57,1,2,2,5,0xb2d68bf9
1250.38,1.0,184,1,2,1,4,0xb2d28201
129.75,1.0,3,1,2,4,7,0xb2d2c957d
536175.22,8.0,4,4,4,4,12,0xb2d37214
960021.67,4.0,18,4,4,2,10,0xb2d8dab0
10664.46,5.0,0,2,4,4,10,0xb2d07df6
623.61,1.0,82,1,2,1,4,0xb2d6d9df
210375.71,3.0,161,3,4,1,8,0xb2d3e626
1254.36,1.0,184,1,2,1,4,0xb2d3aa61
30017.27,1.0,10,2,2,3,7,0xb2d6f017d
202845.74,2.0,39,3,3,2,8,0xb2d67e90
468190.79,2.0,80,4,3,1,8,0xb2d38b2d
104410.23,3.0,83,3,4,1,8,0xb2d4ce3cd
56.41,1.0,6,1,2,3,6,0xb2d37cb2
67.83,1.0,11,1,2,3,6,0xb2d3e77ad
33563.32,1.0,7,2,2,3,7,0xb2d2e1d4
307397.86,6.0,0,4,4,4,12,0xb2d659ad
0.57,1.0,3,1,2,4,7,0xb2d11af5
503841.69,3.0,69,4,4,1,9,0xb2d29b66
425377.78,5.0,11,4,4,3,11,0xb2d1c09dd
2077.49,2.0,92,1,3,1,5,0xb2d286ffd
97034.36,1.0,179,3,2,1,6,0xb2d2aff7d
22.9,1.0,12,1,2,3,6,0xb2d2991c
251776.53,2.0,82,3,3,1,7,0xb2d98e42
382594.92,6.0,25,4,4,2,10,0xb2d6c596
180055.63,4.0,40,3,4,2,9,0xb2d2bd1cd
49.64,2.0,12,1,3,3,7,0xb2d07555d
42379.06,1.0,10,2,2,3,7,0xb2d20985d
10182.16,3.0,1,2,4,4,10,0xb2d0d27f
474679.31,3.0,87,4,4,1,9,0xb2d125f6d
3693.52,1.0,0,2,2,4,8,0xb2d2bcd4
402890.01,3.0,136,4,4,1,9,0xb2d4028e
13000.69,2.0,48,2,3,2,7,0xb2d9d374
10603.77,2.0,0,2,3,4,9,0xb2d6ac80
50019.85,1.0,0,2,2,4,8,0xb2d65b0e
100002.11,2.0,48,3,3,2,8,0xb2d9d877
6070.16,1.0,92,2,2,1,5,0xb2d117dbd
13008.53,1.0,11,2,2,3,7,0xb2d6e651d
200020.08,2.0,1,3,3,4,10,0xb2d67f24
2400.16,1.0,180,1,2,1,4,0xb2d2e175
19834.46,1.0,4,2,2,4,8,0xb2d62d39
32402.39,1.0,0,2,2,4,8,0xb2d53522
2554738.92,25.0,0,4,4,4,12,0xb2d0f1cb
22030.51,1.0,1,2,2,4,8,0xb2d6c046
200000.0,2.0,28,3,3,2,8,0xb2d94085
730018.52,3.0,18,4,4,2,10,0xb2d1b51dd
50000.53,2.0,14,2,3,3,8,0xb2da3a2b
4383.62,1.0,13,2,2,3,7,0xb2d27be0
95.95,2.0,18,1,3,2,6,0xb2d364c5
637842.15,3.0,15,4,4,3,11,0xb2d10deb
80558.89,33.0,15,3,4,3,10,0xb2d13227
1343.14,1.0,9,1,2,3,6,0xb2d0f6ddd
20016.09,2.0,123,2,3,1,6,0xb2d62d89
2000013.76,1.0,0,4,2,4,10,0xb2d6137b
4083.79,1.0,0,2,2,4,8,0xb2d7bd1f
6003.55,1.0,13,2,2,3,7,0xb2d8ef20
1338.31,1.0,246,1,2,1,4,0xb2d6582fd
491757.52,3.0,11,4,4,3,11,0xb2d58786d
6.2,1.0,2,1,2,4,7,0xb2d968cf
230000.0,4.0,1,3,4,4,11,0xb2d3abac
17.99,13.0,1,1,4,4,9,0xb2d8f683
2225.96,1.0,2,1,2,4,7,0xb2d6ec92
5710.48,4.0,9,2,4,3,9,0xb2d3e680d
10168.62,1.0,184,2,2,1,5,0xb2d19975
133005.65,3.0,175,3,4,1,8,0xb2d539d6
600000.0,45.0,0,4,4,4,12,0xb2d1f6d3
11.39,1.0,21,1,2,2,5,0xb2d696bdd
109862.71,1.0,4,3,2,4,9,0xb2d58bc6
1257.88,1.0,13,1,2,3,6,0xb2d35016
4130.71,1.0,5,2,2,3,7,0xb2d3a17c
10055.24,1.0,1,2,2,4,8,0xb2d5c368
425.93,1.0,0,1,2,4,7,0xb2d912d6
2250000.25,6.0,0,4,4,4,12,0xb2da264e
14.12,1.0,8,1,2,3,6,0xb2d9bb08
2250.61,1.0,7,1,2,3,6,0xb2d6863ad
81960.82,4.0,6,3,4,3,10,0xb2d65872d
612.72,1.0,74,1,2,1,4,0xb2d65fad
5987.47,1.0,184,2,2,1,5,0xb2d54bf9
100046.42,3.0,95,3,4,1,8,0xb2d418b1d
74971.19,1.0,0,3,2,4,9,0xb2d12144
66785.43,1.0,23,3,2,2,7,0xb2d62e18
8807.75,1.0,92,2,2,1,5,0xb2d1affc
400067.24,5.0,0,4,4,4,12,0xb2d63c53
100001.27,2.0,25,3,3,2,8,0xb2da0eb5
286001.34,2.0,10,3,3,3,9,0xb2d9f53b
842935.8,7.0,4,4,4,4,12,0xb2d06bafd
4172.74,1.0,58,2,2,2,6,0xb2d5dfb9
25336.37,1.0,8,2,2,3,7,0xb2d58328
201692.89,2.0,5,3,3,3,9,0xb2d1335a
1056.09,2.0,184,1,3,1,5,0xb2d08a58d
151.99,1.0,3,1,2,4,7,0xb2d6d3e0
708.8,1.0,9,1,2,3,6,0xb2d598a0
89.8,1.0,16,1,2,2,5,0xb2d5d744
389460.33,6.0,0,4,4,4,12,0xb2d0db75d
397939.99,3.0,0,4,4,4,12,0xb2d433b4
128181.67,5.0,25,3,4,2,9,0xb2d5fd52
551006.38,3.0,13,4,4,3,11,0xb2d6f8a6
469168.94,2.0,2,4,3,4,11,0xb2d31d07d
202666.54,3.0,66,3,4,2,9,0xb2d8ef1c
2106.8,1.0,92,1,2,1,4,0xb2d2cf38d
363.32,1.0,22,1,2,2,5,0xb2d3fef1d
488.86,1.0,0,1,2,4,7,0xb2d6b585
136183.75,2.0,94,3,3,1,7,0xb2d6ac02
160001.69,4.0,32,3,4,2,9,0xb2d91cbf
429.99,1.0,0,1,2,4,7,0xb2d24dbe
3.64,1.0,19,1,2,2,5,0xb2d6bd0b
15249.72,1.0,92,2,2,1,5,0xb2d28565
912133.7,5.0,11,4,4,3,11,0xb2d68462
95.62,1.0,53,1,2,2,5,0xb2d381e5d
2007.64,1.0,125,1,2,1,4,0xb2d29793
55016.2,2.0,0,3,3,4,10,0xb2d8f6ee
7098.53,1.0,1,2,2,4,8,0xb2d3d6f4
89.22,1.0,20,1,2,2,5,0xb2d1b3a0
68329.89,1.0,67,3,2,1,6,0xb2d53540
1818.87,1.0,10,1,2,3,6,0xb2d584a4d
46697.04,2.0,0,2,3,4,9,0x3b9af24fd
240419.62,2.0,177,3,3,1,7,0xb2d16216
576.31,1.0,0,1,2,4,7,0xb2d4c955d
902217.55,4.0,4,4,4,4,12,0xb2d6d205
60125.96,1.0,18,3,2,2,7,0xb2d5d892
4006.38,1.0,0,2,2,4,8,0xb2d21885
1000010.56,2.0,62,4,3,2,9,0xb2d0ee71
710094.04,3.0,143,4,4,1,9,0xb2d38c44d
4042030.2,11.0,0,4,4,4,12,0xb2d893f5d
2776.66,1.0,2,1,2,4,7,0xb2d1f95e
83.28,1.0,0,1,2,4,7,0xb2d2e2b8
254466.35,2.0,19,3,3,2,8,0xb2d0c2db
9.87,1.0,28,1,2,2,5,0xb2d2b7fa
10009.56,1.0,24,2,2,2,6,0xb2d175a8
4203.77,1.0,2,2,2,4,8,0xb2d15c64
21.74,1.0,57,1,2,2,5,0xb2d9c102
603596.59,2.0,0,4,3,4,11,0xb2d69690
100002.11,2.0,74,3,3,1,7,0xb2d99bfe
400000.0,3.0,1,4,4,4,12,0xb2d8e786
102.12,1.0,13,1,2,3,6,0xb2d4889f
2464.61,1.0,0,1,2,4,7,0xb2d59c1d
16191.7,1.0,0,2,2,4,8,0xb2d43f00
24642.32,1.0,30,2,2,2,6,0xb2d64a7ed
27.61,6.0,18,1,4,2,7,0xb2d1de30
50002.36,2.0,30,2,3,2,7,0xb2d21e61d
2215.33,1.0,4,1,2,4,7,0xb2d12924d
270011.41,3.0,104,3,4,1,8,0xb2d6f8a3
6207.99,1.0,132,2,2,1,5,0xb2d928e5
209656.0,4.0,129,3,4,1,8,0xb2d8f369
4000543.08,2.0,38,4,3,2,9,0xb2d8cf8f
5.06,1.0,304,1,2,1,4,0xb2d28f8d
54632.57,3.0,0,3,4,4,11,0xb2d8f1c0d
600188.34,3.0,12,4,4,3,11,0xb2d97adb
12654.65,1.0,1,2,2,4,8,0xb2d29d95
1106511.48,7.0,17,4,4,2,10,0xb2d397cb
201610.81,2.0,0,3,3,4,10,0xb2d6f2a9d
494148.91,3.0,32,4,4,2,10,0xb2d1bcb4
104.86,1.0,19,1,2,2,5,0xb2d30b1b
400785.9,3.0,95,4,4,1,9,0x3b9b2e0c
101002.43,2.0,10,3,3,3,9,0xb2d5fada
76670.51,1.0,0,3,2,4,9,0xb2d280b3d
4.12,1.0,67,1,2,1,4,0xb2d648f6
25374.13,1.0,7,2,2,3,7,0xb2d6b68e
602131.89,3.0,13,4,4,3,11,0xb2d93ebcd
1380.16,1.0,4,1,2,4,7,0xb2d32e28
4198.35,1.0,12,2,2,3,7,0xb2d693a3
1024.27,1.0,184,1,2,1,4,0xb2d138af
500076.04,2.0,11,4,3,3,10,0xb2d922f0
50031.49,3.0,154,2,4,1,7,0xb2d6c9c9d
17306.25,1.0,6,2,2,3,7,0xb2d2bb04
1863.39,1.0,6,1,2,3,6,0xb2d8e2c3
580074.79,3.0,3,4,4,4,12,0xb2d91da2
65.55,1.0,84,1,2,1,4,0xb2d982fad
13.92,1.0,14,1,2,3,6,0xb2d2e4ded
6308.27,1.0,22,2,2,2,6,0xb2d9bd0e
1034669.63,9.0,4,4,4,4,12,0xb2d4c8d5
146.9,1.0,66,1,2,2,5,0xb2d6a0cd
850008.92,8.0,3,4,4,4,12,0xb2d3dc28
587.03,2.0,41,1,3,2,6,0xb2d4b9fe
400000.0,2.0,17,4,3,2,9,0xb2d7a7fa
70001.46,2.0,172,3,3,1,7,0xb2d64be5
106286.5,2.0,184,3,3,1,7,0x3b9b27b9
750711.65,10.0,132,4,4,1,9,0xb2d4b5f9
11.93,1.0,20,1,2,2,5,0xb2d8d05b
50576.54,3.0,46,2,4,2,8,0xb2d45c22d
400380.4,9.0,28,4,4,2,10,0xb2d6c44d
81750.4,1.0,0,3,2,4,9,0xb2d15fb3d
313956.83,2.0,11,4,3,3,10,0xb2d56c20
100212.5,2.0,21,3,3,2,8,0xb2d24965d
1048.8,2.0,113,1,3,1,5,0xb2d5faa6
540003.11,6.0,6,4,4,3,11,0xb2d085f3
5875.56,2.0,0,2,3,4,9,0xb2d0a004
200000.0,2.0,15,3,3,3,9,0xb2d9c2d7
1637151.61,11.0,25,4,4,2,10,0xb2d118a9
5.51,1.0,15,1,2,3,6,0xb2d6d9b0
1270467.84,6.0,0,4,4,4,12,0xb2d5c489
3089781.98,10.0,5,4,4,3,11,0xb2d2ee73
11001.16,1.0,18,2,2,2,6,0xb2d9dc76
1016.9,2.0,307,1,3,1,5,0xb2d11ea0
780224.65,3.0,136,4,4,1,9,0xb2d0660e
613470.01,2.0,7,4,3,3,10,0xb2d6e04f
1048750.0,9.0,8,4,4,3,11,0xb2d0a43f
31.07,1.0,8,1,2,3,6,0xb2d954a2
220026.16,2.0,2,3,3,4,10,0xb2d7546bd
235499.63,8.0,6,3,4,3,10,0xb2d87abcd
402131.48,3.0,7,4,4,3,11,0xb2d9a912
6823.01,1.0,29,2,2,2,6,0xb2d28547
280081.25,4.0,73,3,4,1,8,0x3b9b41e2d
10304.17,1.0,1,2,2,4,8,0xb2d5c0a5
805.43,1.0,1,1,2,4,7,0xb2d0e9d2
30000.95,2.0,214,2,3,1,6,0xb2d7538d
2.38,1.0,53,1,2,2,5,0xb2d0ecf6
50097.25,2.0,73,2,3,1,6,0xb2d5b06b
23805.81,1.0,25,2,2,2,6,0xb2d2cc01
2435.56,1.0,92,1,2,1,4,0xb2d3f283
761853.33,5.0,1,4,4,4,12,0xb2d07a20
390032.32,6.0,87,4,4,1,9,0xb2d2a02e
1577.64,1.0,184,1,2,1,4,0xb2d0827e
18754.47,1.0,6,2,2,3,7,0xb2d6c1b5
465568.14,3.0,31,4,4,2,10,0xb2d37553
10709.47,1.0,92,2,2,1,5,0xb2d1f960d
150113.59,3.0,41,3,4,2,9,0xb2d26164
50034.83,1.0,75,2,2,1,5,0x3b9b44e1d
10013.86,1.0,26,2,2,2,6,0xb2d5e0b9
9028.25,1.0,169,2,2,1,5,0xb2d5697bd
196001.82,6.0,0,3,4,4,11,0xb2d64e6ed
560025.51,5.0,171,4,4,1,9,0xb2d5f359d
150011.85,3.0,139,3,4,1,8,0xb2d45344d
1347299.33,9.0,9,4,4,3,11,0xb2d13a1e
63.33,1.0,74,1,2,1,4,0xb2d8a157
427000.5,9.0,0,4,4,4,12,0xb2d47281
50206.92,2.0,6,2,3,3,8,0xb2d69facd
506439.22,2.0,88,4,3,1,8,0xb2d6edbad
2400.07,1.0,0,1,2,4,7,0xb2d623f4
2111.4,1.0,132,1,2,1,4,0xb2d5109e
12446.57,1.0,0,2,2,4,8,0xb2d8ec1b
30000.0,2.0,1,2,3,4,9,0xb2da6254
855477.35,4.0,66,4,4,2,10,0xb2d40d38
61790.2,2.0,1,3,3,4,10,0xb2d6e130
117822.57,3.0,2,3,4,4,11,0xb2d3ff91d
654380.82,2.0,16,4,3,2,9,0xb2d5c35f
53848.45,2.0,97,3,3,1,7,0xb2d3d9d5d
484534.04,7.0,0,4,4,4,12,0xb2d24786
3874.38,1.0,2,2,2,4,8,0xb2d4a73f
324.71,1.0,36,1,2,2,5,0xb2d34c2ed
154013.01,2.0,69,3,3,1,7,0xb2d5cba5d
150012.68,3.0,51,3,4,2,9,0xb2d3a110
2958768.44,11.0,4,4,4,4,12,0xb2d1d2b1
1332.09,1.0,133,1,2,1,4,0xb2d53af8
302604.11,2.0,55,4,3,2,9,0xb2d0dc9bd
33007.29,1.0,4,2,2,4,8,0xb2d90e05
6778.61,1.0,0,2,2,4,8,0xb2d6b132
1734.23,1.0,0,1,2,4,7,0xb2d6923f
55090.52,2.0,14,3,3,3,9,0xb2d53b31
305483.34,3.0,37,4,4,2,10,0xb2d58693d
110020.64,3.0,18,3,4,2,9,0xb2d208d3d
2748.7,1.0,15,1,2,3,6,0xb2d3479f
10113.81,1.0,19,2,2,2,6,0xb2d41d01d
210864.32,2.0,32,3,3,2,8,0xb2d6b9f6d
250720.25,3.0,19,3,4,2,9,0xb2d5a93d
2.47,1.0,15,1,2,3,6,0xb2d1fcdb
1058.74,1.0,76,1,2,1,4,0xb2d25209
526454.52,1.0,3,4,2,4,10,0xb2d4cb6bd
79.63,1.0,11,1,2,3,6,0xb2d91bd7
300000.0,2.0,19,3,3,2,8,0xb2d956ce
9463.11,1.0,9,2,2,3,7,0xb2d2e830
1250517.86,4.0,1,4,4,4,12,0xb2d20ebb
40260.41,3.0,2,2,4,4,10,0xb2d6daf4d
9298.17,6.0,0,2,4,4,10,0xb2d0839dd
398476.12,1.0,0,4,2,4,10,0xb2d56fbc
386.97,1.0,10,1,2,3,6,0xb2d2ec36d
176389.36,2.0,125,3,3,1,7,0xb2d69f20d
19579.82,1.0,184,2,2,1,5,0xb2d1204bd
80.83,1.0,9,1,2,3,6,0xb2d3b1d7
692.87,2.0,83,1,3,1,5,0xb2d93bfa
411008.26,6.0,14,4,4,3,11,0xb2d43844d
1385.74,1.0,144,1,2,1,4,0xb2d65abd
570755.86,4.0,18,4,4,2,10,0xb2d685ded
200041.76,2.0,2,3,3,4,10,0xb2d93022d
645760.9,4.0,67,4,4,1,9,0xb2d0f784
20020.01,2.0,122,2,3,1,6,0xb2d5e708
783.04,1.0,147,1,2,1,4,0xb2d249e8
1000.0,1.0,5,1,2,3,6,0xb2d343b1
93.82,1.0,30,1,2,2,5,0xb2d3b7af
401732.91,3.0,20,4,4,2,10,0xb2d8c4a2
111882.87,2.0,174,3,3,1,7,0xb2d5f38bd
291746.89,1.0,17,3,2,2,7,0xb2d21e69
300136.23,3.0,10,4,4,3,11,0xb2d7c6c0
10093.44,1.0,1,2,2,4,8,0xb2d6aa20
1613.45,1.0,0,1,2,4,7,0xb2d2aca2
150209.18,2.0,116,3,3,1,7,0xb2d46349
136.3,1.0,6,1,2,3,6,0xb2d2dc84d
500000.0,1.0,0,4,2,4,10,0xb2d98358d
30316.83,2.0,11,2,3,3,8,0xb2d959a8
20113.01,1.0,184,2,2,1,5,0xb2d09343
1152.55,1.0,184,1,2,1,4,0xb2d3ba20
338573.44,3.0,10,4,4,3,11,0xb2d248aa
12817.07,1.0,1,2,2,4,8,0xb2d9ac46
100099.23,3.0,12,3,4,3,10,0xb2d5305c
4746.38,6.0,0,2,4,4,10,0xb2d51eab
13.91,1.0,0,1,2,4,7,0xb2d24a16
135.85,1.0,29,1,2,2,5,0xb2d187d4
50000.0,1.0,1,2,2,4,8,0xb2da64e1
4406.45,1.0,0,2,2,4,8,0xb2d8ca8e
1063.13,1.0,57,1,2,2,5,0xb2d2e1c6
200000.0,3.0,7,3,4,3,10,0xb2d97ba0
7839.45,1.0,18,2,2,2,6,0xb2d909ecd
1085.94,1.0,184,1,2,1,4,0xb2d353c7d
253506.43,2.0,14,3,3,3,9,0xb2d33fe8d
235000.12,6.0,4,3,4,4,11,0xb2d5dfb7d
362.74,1.0,35,1,2,2,5,0xb2d563a4
201.74,1.0,69,1,2,1,4,0xb2d1adde
300087.75,2.0,0,3,3,4,10,0xb2d7549c
1.87,1.0,20,1,2,2,5,0xb2d60f52
2772.71,1.0,21,1,2,2,5,0xb2d82705
500188.73,2.0,8,4,3,3,10,0xb2d78b50
156943.31,2.0,245,3,3,1,7,0xb2d40c6ed
83256.34,3.0,35,3,4,2,9,0xb2d5a098
56745.7,1.0,35,3,2,2,7,0xb2d37c83
37886.57,3.0,8,2,4,3,9,0xb2d4600f
17015.34,2.0,0,2,3,4,9,0xb2d0b46b
1675.93,1.0,106,1,2,1,4,0xb2d2073b
217.39,1.0,93,1,2,1,4,0xb2d95131d
221719.03,5.0,1,3,4,4,11,0xb2d41331
357024.92,4.0,136,4,4,1,9,0xb2d43c8b
207715.34,3.0,10,3,4,3,10,0xb2d1875cd
121428.24,2.0,9,3,3,3,9,0xb2d617d6
1176.67,1.0,9,1,2,3,6,0xb2d5fd89
1.12,1.0,82,1,2,1,4,0xb2d8248d
1769.86,1.0,92,1,2,1,4,0xb2d1c5c2
140102.65,6.0,4,3,4,4,11,0x3b9b4973
20452.97,1.0,11,2,2,3,7,0xb2d6f564
2435.24,1.0,1,1,2,4,7,0xb2d65a59
3.62,1.0,10,1,2,3,6,0xb2d81144d
7.16,1.0,40,1,2,2,5,0xb2d1ea53
2946.96,1.0,6,2,2,3,7,0xb2d6f5e7
469817.7,6.0,5,4,4,3,11,0xb2d5348f
500016.2,2.0,25,4,3,2,9,0xb2d5cd24d
2492105.25,2.0,87,4,3,1,8,0xb2d11363
200715.81,2.0,239,3,3,1,7,0xb2d617e2
81001.1,3.0,26,3,4,2,9,0xb2d5bcbd
6065.56,1.0,184,2,2,1,5,0x3b9b37dd
190.8,1.0,0,1,2,4,7,0xb2d32c75
11157.03,1.0,0,2,2,4,8,0xb2d34aff
10.98,1.0,47,1,2,2,5,0xb2d992e2
190011.87,3.0,10,3,4,3,10,0xb2d2d151d
1117895.42,9.0,1,4,4,4,12,0xb2d238dcd
23983.13,1.0,18,2,2,2,6,0xb2d6bf70
74533.1,3.0,0,3,4,4,11,0xb2d0b7fcd
202160.43,2.0,103,3,3,1,7,0xb2d255b7
6060.34,1.0,17,2,2,2,6,0xb2d1cc57
85594.22,2.0,77,3,3,1,7,0xb2d12ef2
16233.17,1.0,144,2,2,1,5,0xb2d2a1e5
25039.93,3.0,0,2,4,4,10,0xb2d2a078
15559.81,1.0,5,2,2,3,7,0xb2d488d0
1206.71,2.0,213,1,3,1,5,0xb2d09f4d
1035.86,1.0,12,1,2,3,6,0xb2d3b122d
3553.51,1.0,0,2,2,4,8,0xb2d6c4a6
0.57,2.0,92,1,3,1,5,0xb2d141bf
245303.69,3.0,263,3,4,1,8,0x3b9b10a2
100012.31,2.0,80,3,3,1,7,0xb2d51179
220043.66,2.0,80,3,3,1,7,0xb2d26d15d
8947.52,1.0,5,2,2,3,7,0xb2d8c62fd
4.55,1.0,167,1,2,1,4,0xb2d68703
21904.24,1.0,92,2,2,1,5,0xb2d61d1fd
420419.69,4.0,11,4,4,3,11,0xb2d1be18
62.96,1.0,9,1,2,3,6,0xb2d4e130d
4428.77,1.0,0,2,2,4,8,0xb2d688e9
500731.8,3.0,7,4,4,3,11,0xb2d5a51a
699720.67,5.0,1,4,4,4,12,0xb2d5e939
568000.0,12.0,0,4,4,4,12,0xb2d174d4d
503001.08,5.0,17,4,4,2,10,0xb2d63c03
88.15,1.0,14,1,2,3,6,0xb2d6c13b
1379090.04,4.0,0,4,4,4,12,0xb2d6549f
110014.92,2.0,39,3,3,2,8,0xb2d623b9
250.14,1.0,0,1,2,4,7,0xb2d1d9d9
14107.27,1.0,92,2,2,1,5,0xb2d2dd0b
7797.73,2.0,1,2,3,4,9,0xb2d55f20
262033.29,3.0,0,3,4,4,11,0xb2d111ca
300009.96,3.0,5,3,4,3,10,0xb2d628f2
19571.57,1.0,4,2,2,4,8,0xb2d64262d
978326.07,4.0,3,4,4,4,12,0xb2d580d5d
1501837.04,1.0,125,4,2,1,7,0xb2d75374d
51.54,1.0,92,1,2,1,4,0xb2d2b38a
100065.44,2.0,55,3,3,2,8,0xb2d644f1
301740.51,3.0,6,4,4,3,11,0xb2d0e9c9d
2234.59,1.0,119,1,2,1,4,0xb2d37c68
10722.94,1.0,8,2,2,3,7,0xb2d52693d
61.46,1.0,83,1,2,1,4,0xb2d83b85
191002.85,3.0,6,3,4,3,10,0xb2d57cc8
2084606.13,1.0,1,4,2,4,10,0xb2d93063
31826.21,1.0,14,2,2,3,7,0xb2d2dfb0
594019.56,13.0,32,4,4,2,10,0xb2d55c9b
406084.34,2.0,0,4,3,4,11,0xb2d8fd45d
2728.56,2.0,112,1,3,1,5,0xb2d1aafcd
31742.3,2.0,12,2,3,3,8,0xb2d17599
52.61,3.0,92,1,4,1,6,0xb2d154bb
105197.5,2.0,165,3,3,1,7,0xb2d4e9f4d
951.11,1.0,41,1,2,2,5,0xb2d91c33
2.48,1.0,52,1,2,2,5,0xb2d8a590
290708.01,5.0,39,3,4,2,9,0xb2d5583a
2.43,1.0,77,1,2,1,4,0xb2d93c1e
332000.0,2.0,0,4,3,4,11,0xb2d90388
252835.51,3.0,6,3,4,3,10,0xb2d3c16d
58076.63,1.0,4,3,2,4,9,0xb2d2b5dd
4173.83,1.0,2,2,2,4,8,0xb2d2fdf0
1421.19,1.0,184,1,2,1,4,0xb2d375ea
39004.55,2.0,18,2,3,2,7,0xb2d60766
550622.95,4.0,66,4,4,2,10,0xb2d13b3b
239.78,1.0,21,1,2,2,5,0xb2d3197e
2114.93,1.0,15,1,2,3,6,0xb2d8ca68
1709.43,1.0,143,1,2,1,4,0xb2d627a6d
9014.45,1.0,0,2,2,4,8,0xb2d8f4af
315655.04,3.0,5,4,4,3,11,0xb2d6d803
1400163.08,1.0,0,4,2,4,10,0xb2d4b63cd
2.78,1.0,70,1,2,1,4,0xb2d2b5a3
206025.45,3.0,18,3,4,2,9,0xb2d626ae
1008039.02,6.0,1,4,4,4,12,0xb2d92a44
175634.92,1.0,8,3,2,3,8,0xb2d2d99f
288359.41,4.0,35,3,4,2,9,0xb2d3e6bc
41178.08,2.0,92,2,3,1,6,0xb2d0b3b2
1019237.79,5.0,0,4,4,4,12,0xb2d176ffd
14468.62,1.0,2,2,2,4,8,0xb2d4c21ad
100.76,1.0,76,1,2,1,4,0xb2d4fa56
465076.58,4.0,63,4,4,2,10,0xb2d6598c
1037.3,1.0,4,1,2,4,7,0xb2d39212
3816.93,1.0,118,2,2,1,5,0xb2d0a818
882091.6,4.0,0,4,4,4,12,0xb2d23dba
410.99,1.0,0,1,2,4,7,0xb2d4d090d
11912486.16,5.0,5,4,4,3,11,0xb2d111f7
20080.13,1.0,184,2,2,1,5,0xb2d60bab
570036.65,3.0,11,4,4,3,11,0xb2d9331c
212.92,1.0,2,1,2,4,7,0xb2d631f6
500046.68,7.0,1,4,4,4,12,0xb2d3b1a9d
90006.84,2.0,263,3,3,1,7,0xb2d4683fd
50002.11,2.0,90,2,3,1,6,0xb2d8a5eb
983.2,1.0,47,1,2,2,5,0xb2d33f19
461000.0,4.0,1,4,4,4,12,0xb2d632da
0.0,1.0,7,1,2,3,6,0xb2d3010f
3368.96,1.0,11,2,2,3,7,0xb2d91b74
93033.84,4.0,41,3,4,2,9,0xb2d3002c
911191.89,8.0,0,4,4,4,12,0xb2d0dbfb
101.06,2.0,41,1,3,2,6,0x3b9b18e6d
233211.07,3.0,12,3,4,3,10,0xb2d1b22b
0.0,1.0,7,1,2,3,6,0xb2d4feb1
772.94,2.0,14,1,3,3,7,0x3b9b458d
66011.37,2.0,2,3,3,4,10,0xb2d9b5d0
130.37,1.0,9,1,2,3,6,0xb2d4ff84
300077.69,1.0,0,3,2,4,9,0xb2d56062
5527.57,1.0,10,2,2,3,7,0xb2d3ff97
10448.32,1.0,0,2,2,4,8,0xb2d413a4
1199121.67,2.0,82,4,3,1,8,0xb2d1f28f
283.01,1.0,3,1,2,4,7,0xb2d22746
150097.76,3.0,6,3,4,3,10,0xb2d5164a
4991.14,1.0,0,2,2,4,8,0xb2d48c9e
912.83,1.0,57,1,2,2,5,0xb2d5aa67
0.0,1.0,7,1,2,3,6,0xb2d650f2
1717.4,2.0,184,1,3,1,5,0x3b9aee61
481715.25,5.0,24,4,4,2,10,0xb2d57701
51255.67,1.0,0,2,2,4,8,0xb2d68ae4d
104.45,1.0,2,1,2,4,7,0xb2d91b62
12293.84,1.0,21,2,2,2,6,0xb2d8ea14d
50010.1,1.0,1,2,2,4,8,0xb2da66c5
2024.22,1.0,92,1,2,1,4,0xb2d15117
1331.4,1.0,0,1,2,4,7,0xb2d9a1dd
820009.56,3.0,10,4,4,3,11,0xb2d90c8d
12718.36,1.0,0,2,2,4,8,0xb2d5a1e4
2709946.61,7.0,76,4,4,1,9,0xb2d24f2dd
61560.89,1.0,21,3,2,2,7,0xb2d61193d
2.39,1.0,20,1,2,2,5,0xb2d0f48e
4.45,1.0,14,1,2,3,6,0xb2d8e576d
200400.0,1.0,0,3,2,4,9,0xb2da6860
130864.45,2.0,92,3,3,1,7,0xb2d60d91d
1852.2,1.0,92,1,2,1,4,0xb2d2512ed
5088.85,1.0,11,2,2,3,7,0xb2d94e9f
2453.48,1.0,4,1,2,4,7,0xb2d5d191
68430.24,2.0,21,3,3,2,8,0xb2d78368d
6400.77,1.0,92,2,2,1,5,0xb2d24ca6
510023.93,3.0,51,4,4,2,10,0xb2d32da8d
720004.7,4.0,3,4,4,4,12,0xb2d10ca3
123876.78,2.0,18,3,3,2,8,0xb2d69803d
13036.65,2.0,0,2,3,4,9,0xb2d6e7b0
100224.48,3.0,11,3,4,3,10,0xb2d5fb6e
2591.78,1.0,0,1,2,4,7,0xb2d28a5c
586307.11,4.0,85,4,4,1,9,0xb2d68ea6
12.56,1.0,37,1,2,2,5,0xb2d83a0fd
9788.14,3.0,14,2,4,3,9,0xb2d06894d
2.56,1.0,24,1,2,2,5,0xb2d1026c
171066.63,5.0,48,3,4,2,9,0xb2d5be1ad
165038.55,2.0,67,3,3,1,7,0xb2d2da3e
225474.11,3.0,0,3,4,4,11,0xb2d5e05cd
476.41,1.0,10,1,2,3,6,0xb2d31047
32941.71,1.0,1,2,2,4,8,0xb2d25946
0.55,1.0,0,1,2,4,7,0xb2d65b0ed
1016.55,1.0,184,1,2,1,4,0xb2d0f630d
10739.59,1.0,10,2,2,3,7,0xb2d26673d
200112.94,3.0,1,3,4,4,11,0xb2d5677b
141006.08,5.0,69,3,4,1,8,0xb2d0d0dd
40001.0,4.0,0,2,4,4,10,0xb2d97bca
1122.37,1.0,184,1,2,1,4,0xb2d1da6f
150034.25,7.0,27,3,4,2,9,0xb2d5d57ad
600108.96,4.0,11,4,4,3,11,0xb2d694c9d
86.3,1.0,42,1,2,2,5,0xb2d8a8c5
17980.41,1.0,5,2,2,3,7,0xb2d366a9
421.58,1.0,10,1,2,3,6,0xb2d96cf6
55.83,1.0,3,1,2,4,7,0xb2d44dfed
113.48,1.0,1,1,2,4,7,0xb2d613cc
130003.59,2.0,160,3,3,1,7,0xb2d5d2b7
960090.65,2.0,94,4,3,1,8,0xb2d60864
5016.52,1.0,1,2,2,4,8,0xb2d314c4d
1917.5,1.0,1,1,2,4,7,0xb2d8d10a
325096.55,2.0,119,4,3,1,8,0xb2d70442
1075.25,1.0,130,1,2,1,4,0xb2d6d6b2
157067.36,2.0,25,3,3,2,8,0xb2d5e5d0
5004837.92,4.0,33,4,4,2,10,0xb2d90a24
328673.89,4.0,11,4,4,3,11,0xb2d2bfd7
26771.99,1.0,19,2,2,2,6,0xb2d68c3ed
330005.64,3.0,20,4,4,2,10,0xb2d3b725
748.84,1.0,1,1,2,4,7,0xb2d3482ad
216803.0,3.0,4,3,4,4,11,0xb2d6155dd
4.68,1.0,20,1,2,2,5,0xb2d9a1bc
1879.86,1.0,184,1,2,1,4,0xb2d31e1cd
70.98,1.0,15,1,2,3,6,0xb2d29013
1896.6,1.0,0,1,2,4,7,0xb2d92ca3
1598.55,1.0,107,1,2,1,4,0xb2d411e1
133645.09,3.0,82,3,4,1,8,0xb2d5eebe
121.33,1.0,0,1,2,4,7,0xb2d2f084
9942.3,1.0,21,2,2,2,6,0xb2d4c9ea
179.27,1.0,9,1,2,3,6,0xb2d469d8d
787551.31,4.0,92,4,4,1,9,0xb2d5b306
0.61,2.0,53,1,3,2,6,0xb2d6e296
5902859.11,3.0,13,4,4,3,11,0xb2d5b733
115004.08,3.0,38,3,4,2,9,0xb2d5b8ccd
0.0,1.0,5,1,2,3,6,0xb2d622d4
10016.83,2.0,123,2,3,1,6,0xb2d6d6ced
188720.8,4.0,18,3,4,2,9,0xb2d0eab2
1088.85,1.0,26,1,2,2,5,0xb2d5cabdd
471143.78,7.0,5,4,4,3,11,0xb2d0ca5fd
2759.54,1.0,4,1,2,4,7,0xb2d341aa
40601.05,2.0,83,2,3,1,6,0xb2d56158
10104.36,1.0,184,2,2,1,5,0xb2d2bcf5d
418.93,1.0,25,1,2,2,5,0xb2d12428
80599.21,4.0,70,3,4,1,8,0xb2d632b5
500000.0,2.0,5,4,3,3,10,0xb2da4a20
840101.79,19.0,0,4,4,4,12,0xb2d1c53e
100003.91,2.0,95,3,3,1,7,0xb2d97126d
492110.53,4.0,0,4,4,4,12,0xb2d25d53
650055.37,3.0,54,4,4,2,10,0xb2d5bc54
4833.65,1.0,184,2,2,1,5,0xb2d3edbb
1057.98,1.0,184,1,2,1,4,0xb2d1ad10d
94008.5,5.0,18,3,4,2,9,0xb2d62879d
40328.88,3.0,22,2,4,2,8,0xb2d534a0
21954.01,1.0,41,2,2,2,6,0xb2d635a1
2120.91,1.0,184,1,2,1,4,0x3b9ad794d
500045.54,3.0,74,4,4,1,9,0xb2d325ebd
5513.05,1.0,7,2,2,3,7,0xb2d260b1
6.97,1.0,57,1,2,2,5,0xb2d5f514
6465.74,1.0,184,2,2,1,5,0xb2d33f22
362887.19,5.0,32,4,4,2,10,0xb2d12bfbd
1067662.07,11.0,3,4,4,4,12,0xb2d101dd
743.4,1.0,8,1,2,3,6,0xb2d1d445
760354.28,4.0,56,4,4,2,10,0x3b9b3326
203016.89,2.0,167,3,3,1,7,0xb2d2c93b
56281.32,1.0,20,3,2,2,7,0xb2d6aaded
10573.62,1.0,11,2,2,3,7,0xb2d99055
250000.0,2.0,1,3,3,4,10,0xb2d9811dd
516000.0,10.0,4,4,4,4,12,0xb2d22bce
4727.96,1.0,51,2,2,2,6,0xb2d590bd
966710.24,6.0,18,4,4,2,10,0xb2d16d4e
16300.38,1.0,10,2,2,3,7,0xb2d17ef7
70261.65,1.0,174,3,2,1,6,0xb2d68b3dd
447864.62,4.0,18,4,4,2,10,0xb2d99505
50193.98,1.0,184,2,2,1,5,0xb2d621d3
8822.8,1.0,5,2,2,3,7,0xb2d8d917
2688.56,1.0,0,1,2,4,7,0xb2d9738a
1927.21,1.0,18,1,2,2,5,0xb2d6274bd
160009.39,3.0,8,3,4,3,10,0xb2d0f504
1130.45,1.0,0,1,2,4,7,0xb2d6ecb8
0.0,1.0,22,1,2,2,5,0xb2d60c65
247.8,1.0,43,1,2,2,5,0xb2d1fe0d
1870.25,1.0,15,1,2,3,6,0xb2d2637a
2164.52,1.0,0,1,2,4,7,0xb2d3a017
2.64,1.0,6,1,2,3,6,0xb2d2b7e7
320000.0,2.0,1,4,3,4,11,0xb2da4e77
117262.81,1.0,9,3,2,3,8,0xb2d64ead
121519.56,1.0,0,3,2,4,9,0xb2d31bca
150008.0,2.0,206,3,3,1,7,0xb2d5c208
650240.47,5.0,4,4,4,4,12,0xb2d92411
200005.33,5.0,25,3,4,2,9,0xb2da1170
15174060.6,2.0,59,4,3,2,9,0xb2d2e73f
250889.2,2.0,13,3,3,3,9,0xb2d6b2db
522477.89,4.0,10,4,4,3,11,0xb2d41c27
527669.38,1.0,0,4,2,4,10,0xb2d32501
473346.19,7.0,13,4,4,3,11,0xb2d1fa8c
209000.09,5.0,0,3,4,4,11,0xb2d4cd85
181.06,1.0,69,1,2,1,4,0xb2d24ea9d
90987.06,3.0,25,3,4,2,9,0xb2d6a96e
600131.25,2.0,11,4,3,3,10,0xb2d890ef
306953.17,2.0,28,4,3,2,9,0xb2d4b313
1701.32,1.0,27,1,2,2,5,0xb2d24dded
155819.62,1.0,9,3,2,3,8,0xb2d2e847d
12.36,1.0,12,1,2,3,6,0xb2d5b3bb
14141.95,1.0,184,2,2,1,5,0xb2d2d509
3028.03,1.0,184,2,2,1,5,0xb2d202b5d
250005.59,2.0,19,3,3,2,8,0xb2d53a18d
2433.8,1.0,71,1,2,1,4,0xb2d37b8f
55336.62,5.0,3,3,4,4,11,0xb2d5fd1d
91.31,1.0,31,1,2,2,5,0xb2d23d6b
6069.22,2.0,3,2,3,4,9,0xb2d1736c
469864.26,6.0,4,4,4,4,12,0xb2d0c43f
105130.22,2.0,13,3,3,3,9,0xb2d22dc2
153240.74,3.0,38,3,4,2,9,0xb2d4ee0d
50566.71,1.0,12,2,2,3,7,0xb2d13273
16332.29,1.0,92,2,2,1,5,0xb2d33e72
519.02,2.0,34,1,3,2,6,0xb2d16edf
162567.69,3.0,33,3,4,2,9,0xb2d394d4
4854.74,1.0,7,2,2,3,7,0xb2d96902
260918.94,7.0,0,3,4,4,11,0x3b9b2972
266006.97,3.0,87,3,4,1,8,0xb2d0fd89
300003.02,2.0,22,3,3,2,8,0xb2d238f3
373.19,3.0,1,1,4,4,9,0xb2d78813
28712.53,1.0,49,2,2,2,6,0xb2d37c37
1371.75,1.0,0,1,2,4,7,0xb2d906af
522482.51,2.0,74,4,3,1,8,0xb2d55502d
50000.2,3.0,6,2,4,3,9,0xb2d0ee16
2.48,1.0,12,1,2,3,6,0xb2d870c0
1120588.38,7.0,0,4,4,4,12,0xb2d5f18e
12281.52,1.0,3,2,2,4,8,0xb2d5b085
839455.43,5.0,0,4,4,4,12,0xb2d17739d
1210000.08,10.0,7,4,4,3,11,0xb2d5cb4c
1364108.3,10.0,13,4,4,3,11,0xb2d5f97e
70081.21,3.0,77,3,4,1,8,0xb2d8c98ad
230009.35,3.0,1,3,4,4,11,0xb2d96baad
3013.3,1.0,5,2,2,3,7,0xb2d4dce6
3640.62,1.0,4,2,2,4,8,0xb2d91f4c
18484.04,1.0,92,2,2,1,5,0xb2d0a05d
2300000.0,1.0,3,4,2,4,10,0xb2da1b78
350060.61,5.0,27,4,4,2,10,0xb2d117f0d
500000.0,2.0,1,4,3,4,11,0xb2d2e71ad
300812.68,3.0,30,4,4,2,10,0xb2d9c29c
1251.15,1.0,92,1,2,1,4,0xb2d3953fd
200002.11,2.0,139,3,3,1,7,0xb2d9151ad
300046.81,3.0,18,3,4,2,9,0xb2d23b33d
5692.57,1.0,92,2,2,1,5,0xb2d1fdf3
4866.56,1.0,0,2,2,4,8,0xb2d6b4f4
200101.21,2.0,8,3,3,3,9,0xb2da1775
420000.0,2.0,7,4,3,3,10,0xb2d96ffcd
414.25,1.0,15,1,2,3,6,0xb2d5ea9d
600030.34,3.0,170,4,4,1,9,0xb2d3487a
152028.61,3.0,193,3,4,1,8,0xb2d4f38d
475000.0,2.0,3,4,3,4,11,0xb2d5cf41d
815102.15,20.0,5,4,4,3,11,0xb2d5877ad
3632.07,1.0,2,2,2,4,8,0xb2d8da73
10095.94,1.0,92,2,2,1,5,0xb2d2b71bd
104409.27,2.0,20,3,3,2,8,0xb2d43537
200010.42,2.0,19,3,3,2,8,0xb2d9db02
400041.13,2.0,206,4,3,1,8,0xb2d22518
52542.97,2.0,53,3,3,2,8,0xb2d51c99
608.12,1.0,0,1,2,4,7,0xb2d1fb65
120080.8,3.0,27,3,4,2,9,0xb2d6b27dd
27550.3,1.0,19,2,2,2,6,0xb2d30432d
240012.83,3.0,122,3,4,1,8,0xb2d18a74
87.05,2.0,4,1,3,4,8,0xb2d6fb81
401502.05,5.0,38,4,4,2,10,0xb2d562e1
20000.21,2.0,193,2,3,1,6,0xb2d3fd08
200056.64,2.0,1,3,3,4,10,0xb2d64dd0d
33.06,1.0,65,1,2,2,5,0xb2d3dc8e
50001.58,2.0,92,2,3,1,6,0xb2d62a44d
58963.47,1.0,295,3,2,1,6,0xb2d29ecf
602000.0,10.0,0,4,4,4,12,0xb2d4142c
48.86,1.0,40,1,2,2,5,0xb2d368d4d
9204.58,1.0,3,2,2,4,8,0xb2d6b558
361640.84,6.0,0,4,4,4,12,0xb2d3c54f
31315.37,1.0,0,2,2,4,8,0xb2d28b1e
2.22,2.0,67,1,3,1,5,0xb2d1bd70
200000.0,2.0,20,3,3,2,8,0xb2da2c5a
228320.63,2.0,1,3,3,4,10,0xb2d35823
1269.11,1.0,10,1,2,3,6,0xb2d5e0f7d
10106.88,2.0,263,2,3,1,6,0xb2d19962d
254128.81,2.0,1,3,3,4,10,0xb2d6a622
260523.33,4.0,29,3,4,2,9,0xb2d2118f
200000.84,3.0,20,3,4,2,9,0xb2d9905a
680151.72,3.0,119,4,4,1,9,0xb2d53ca2
378011.75,4.0,97,4,4,1,9,0x3b9b0e2a
721677.86,2.0,11,4,3,3,10,0xb2d60616d
439061.71,7.0,0,4,4,4,12,0xb2d06bf0
50056.57,1.0,0,2,2,4,8,0xb2d635a9
300.41,1.0,1,1,2,4,7,0xb2d5cf53
175004.18,2.0,3,3,3,4,10,0xb2d146cdd
10677.54,2.0,1,2,3,4,9,0xb2d1b434
360.75,1.0,12,1,2,3,6,0xb2d434fd
3170.68,1.0,173,2,2,1,5,0xb2d4ac63
1051.03,1.0,184,1,2,1,4,0xb2d21fb4d
530159.99,4.0,139,4,4,1,9,0xb2d0873b
110010.03,1.0,2,3,2,4,9,0xb2d0a836
925876.0,12.0,5,4,4,3,11,0xb2d20b64d
4234.23,1.0,0,2,2,4,8,0xb2d61109
488392.2,4.0,8,4,4,3,11,0xb2d2be1b
300012.68,2.0,188,3,3,1,7,0xb2d6a76bd
1464795.67,6.0,0,4,4,4,12,0xb2d3bd46d
0.0,1.0,8,1,2,3,6,0xb2d41cb0
460000.0,4.0,3,4,4,4,12,0xb2d78b10
200000.0,2.0,53,3,3,2,8,0xb2d90ce5
110047.42,2.0,11,3,3,3,9,0xb2d16c14d
1072011.37,6.0,18,4,4,2,10,0xb2d5ba56
50773.33,2.0,10,2,3,3,8,0xb2d40f71
11147.68,1.0,0,2,2,4,8,0xb2d6f6a0
150128.42,3.0,56,3,4,2,9,0xb2d6b58d
201000.0,2.0,5,3,3,3,9,0xb2d2eee5d
100004.19,4.0,18,3,4,2,9,0xb2d6382c
517996.7,5.0,4,4,4,4,12,0xb2d3a644d
20008.92,1.0,6,2,2,3,7,0xb2d7562e
2275.14,1.0,123,1,2,1,4,0xb2d42f63
841511.12,1.0,3,4,2,4,10,0xb2d54c56
110282.87,5.0,0,3,4,4,11,0xb2d0d6f9
103902.89,1.0,0,3,2,4,9,0xb2d17e84
30623.66,1.0,7,2,2,3,7,0xb2da4035
4470.97,1.0,92,2,2,1,5,0xb2d0c5b2d
71012.79,3.0,8,3,4,3,10,0xb2d640f7
11330.97,1.0,10,2,2,3,7,0xb2d6f090
151956.02,4.0,136,3,4,1,8,0xb2d5ba1d
12.41,1.0,46,1,2,2,5,0xb2d8df51
366631.04,4.0,64,4,4,2,10,0xb2d248f2
51.38,1.0,49,1,2,2,5,0xb2d1527f
83.45,1.0,1,1,2,4,7,0xb2d6b9fe
340102.0,4.0,1,4,4,4,12,0xb2d3ba40
226018.28,2.0,2,3,3,4,10,0xb2d9c088
203554.63,2.0,16,3,3,2,8,0xb2d6c62f
25.41,1.0,21,1,2,2,5,0xb2d254a1
535063.6,17.0,14,4,4,3,11,0xb2d579ffd
300689.97,3.0,164,4,4,1,9,0xb2d07240
11214.71,1.0,92,2,2,1,5,0xb2d38538d
12447.76,1.0,6,2,2,3,7,0xb2d6bf62
203917.83,2.0,0,3,3,4,10,0xb2d68371
700000.98,5.0,6,4,4,3,11,0xb2d64c0dd
286041.85,4.0,42,3,4,2,9,0xb2d5753e
300908.52,5.0,0,4,4,4,12,0xb2d097fbd
1300004.37,3.0,22,4,4,2,10,0xb2d6e666
242875.04,1.0,0,3,2,4,9,0xb2d20c15d
946.44,1.0,35,1,2,2,5,0xb2d36749
510000.0,17.0,0,4,4,4,12,0xb2d21fa5d
132.87,2.0,13,1,3,3,7,0xb2d62282
200000.0,2.0,3,3,3,4,10,0xb2d97233d
221209.35,2.0,13,3,3,3,9,0xb2d91e83d
2060.93,1.0,9,1,2,3,6,0xb2d8e384
137350.49,1.0,13,3,2,3,8,0xb2d360bf
40244.93,2.0,10,2,3,3,8,0xb2d8f4d7
501011.78,2.0,123,4,3,1,8,0xb2d6439d
435046.91,15.0,0,4,4,4,12,0xb2d5ae40
1493485.48,4.0,0,4,4,4,12,0xb2d10ab0
45.56,1.0,4,1,2,4,7,0xb2d6d750
50002.57,2.0,19,2,3,2,7,0xb2d27b10
159693.72,2.0,92,3,3,1,7,0xb2d45064d
800071.63,3.0,11,4,4,3,11,0xb2d6a2ead
5015.59,1.0,62,2,2,2,6,0xb2d6835ad
50713.98,2.0,70,2,3,1,6,0xb2d64442d
110059.07,2.0,97,3,3,1,7,0xb2d614a2d
22.09,1.0,69,1,2,1,4,0xb2d407f2
300073.85,2.0,74,3,3,1,7,0xb2d54b15
563065.02,4.0,7,4,4,3,11,0xb2d22a6d
2.46,1.0,5,1,2,3,6,0xb2d86938
1157851.89,5.0,15,4,4,3,11,0xb2d1774cd
12439.02,1.0,92,2,2,1,5,0xb2d35afad
10426.55,1.0,184,2,2,1,5,0x3b9af650d
2760.73,1.0,92,1,2,1,4,0xb2d395bb
120008.87,2.0,27,3,3,2,8,0xb2d9c56e
6794.49,1.0,69,2,2,1,5,0xb2d0baf0
453219.54,4.0,75,4,4,1,9,0xb2d21e7cd
624309.43,4.0,43,4,4,2,10,0xb2d24d38
1.06,1.0,60,1,2,2,5,0xb2d9bc39
97.43,1.0,0,1,2,4,7,0xb2d6a6bd
38.95,1.0,70,1,2,1,4,0xb2d5ed9b
20000.0,1.0,5,2,2,3,7,0xb2d975f6
100003.17,2.0,92,3,3,1,7,0xb2d97e1e
50821.27,2.0,129,2,3,1,6,0xb2d63aff
9100.98,1.0,18,2,2,2,6,0xb2d5d269d
260112.55,2.0,216,3,3,1,7,0xb2d299ec
35717.64,1.0,1,2,2,4,8,0xb2d69281d
1511.87,1.0,92,1,2,1,4,0xb2d24d24
14022.03,2.0,13,2,3,3,8,0xb2d5ad74d
61.96,1.0,6,1,2,3,6,0xb2d8362cd
100451.29,3.0,110,3,4,1,8,0xb2d414a0
4189.04,1.0,0,2,2,4,8,0xb2d6b740d
70006.39,2.0,172,3,3,1,7,0xb2d6b465
500000.74,3.0,3,4,4,4,12,0xb2d91c29
3608.81,1.0,2,2,2,4,8,0xb2d9c490
131265.13,3.0,235,3,4,1,8,0xb2d60b79
606.27,1.0,0,1,2,4,7,0xb2d64e5d
23908.82,1.0,92,2,2,1,5,0xb2d1038cd
500026.77,2.0,168,4,3,1,8,0xb2d0dd86d
10341.18,1.0,0,2,2,4,8,0xb2d1031a
150016.54,3.0,10,3,4,3,10,0xb2d61668d
942787.75,14.0,13,4,4,3,11,0xb2d0e111d
60143.6,2.0,47,3,3,2,8,0xb2d42341d
163000.7,2.0,13,3,3,3,9,0xb2d54c07
29.82,1.0,19,1,2,2,5,0xb2d2eea6
25.44,1.0,14,1,2,3,6,0xb2d9891e
16091.1,2.0,9,2,3,3,8,0x3b9b22f7
263468.09,4.0,189,3,4,1,8,0xb2d5d5b6
104318.68,7.0,0,3,4,4,11,0x3b9af23e
100001.06,2.0,42,3,3,2,8,0xb2d9e7e7
201421.12,2.0,75,3,3,1,7,0xb2d99f56
8216.22,1.0,184,2,2,1,5,0xb2d3986c
5020.87,1.0,2,2,2,4,8,0xb2d51e51d
45827.89,1.0,1,2,2,4,8,0xb2d5b451d
1000133.52,4.0,0,4,4,4,12,0xb2d698c3
5726.44,1.0,11,2,2,3,7,0xb2d14685
1163.18,4.0,0,1,4,4,9,0x3b9b47e7d
100975.6,2.0,97,3,3,1,7,0xb2d2e5c5
29535.13,1.0,9,2,2,3,7,0xb2d5649d
621828.14,8.0,1,4,4,4,12,0xb2d553d4
1071.64,1.0,109,1,2,1,4,0xb2d41798
100698.31,2.0,53,3,3,2,8,0xb2d5912cd
232800.99,4.0,0,3,4,4,11,0xb2d42b5fd
310000.0,2.0,6,4,3,3,10,0xb2da5043
202703.1,2.0,77,3,3,1,7,0xb2d30db0d
220121.79,1.0,4,3,2,4,9,0xb2d0e2a8
501269.64,2.0,2,4,3,4,11,0xb2d5ee64
70002.58,7.0,41,3,4,2,9,0xb2d5141c
80000.84,2.0,175,3,3,1,7,0xb2d8d042
35417.77,4.0,0,2,4,4,10,0xb2d06809
54007.79,1.0,9,3,2,3,8,0xb2d317b1
2036315.86,2.0,131,4,3,1,8,0xb2d5e843d
50062.56,1.0,0,2,2,4,8,0xb2d25f51
1967.56,1.0,15,1,2,3,6,0xb2d2d9dbd
1000.03,1.0,24,1,2,2,5,0xb2d94f4b
430.9,1.0,1,1,2,4,7,0xb2d09f46
388155.98,1.0,13,4,2,3,9,0xb2d95500
6.03,1.0,3,1,2,4,7,0xb2d2df64d
188.27,1.0,16,1,2,2,5,0xb2d23e0b
470275.34,2.0,11,4,3,3,10,0xb2d5947b
321.84,1.0,6,1,2,3,6,0xb2d28b98
0.0,1.0,9,1,2,3,6,0xb2d5f48e
1217074.63,3.0,13,4,4,3,11,0xb2d3314f
63409.16,2.0,87,3,3,1,7,0xb2d4876fd
2822.35,1.0,10,1,2,3,6,0xb2d6f080
500567.37,4.0,1,4,4,4,12,0xb2d2a07bd
500107.56,3.0,55,4,4,2,10,0xb2d5c667
509908.17,4.0,80,4,4,1,9,0xb2d309c0d
90287.19,2.0,95,3,3,1,7,0xb2d3c4f1
90629.84,4.0,9,3,4,3,10,0xb2d29707
3370691.1,13.0,12,4,4,3,11,0xb2d156f4
40045.52,2.0,80,2,3,1,6,0xb2d6b68c
10131.16,2.0,160,2,3,1,6,0xb2d63097d
596.45,1.0,5,1,2,3,6,0xb2d41628
3251.89,1.0,184,2,2,1,5,0xb2d3db42d
1990.58,1.0,92,1,2,1,4,0x3b9ae0f2
220022.73,2.0,174,3,3,1,7,0xb2d64eef
200528.86,2.0,47,3,3,2,8,0xb2d1a4b5d
83829.99,2.0,129,3,3,1,7,0xb2d41f30
14626.13,1.0,0,2,2,4,8,0xb2d6e8b7
680097.15,4.0,5,4,4,3,11,0xb2d6d6e2
500005.28,2.0,25,4,3,2,9,0xb2d92da4d
1691.84,1.0,92,1,2,1,4,0xb2d20dd4
125854.89,1.0,10,3,2,3,8,0xb2da3b22
584.06,1.0,41,1,2,2,5,0xb2d38ebbd
3.6,1.0,10,1,2,3,6,0xb2d9f719
13258.45,4.0,0,2,4,4,10,0xb2d06491
2176.99,1.0,9,1,2,3,6,0xb2d7004cd
104053.43,1.0,9,3,2,3,8,0xb2d2f297d
294501.66,9.0,11,3,4,3,10,0xb2d218cfd
301131.29,2.0,29,4,3,2,9,0xb2d9bc44
260135.25,3.0,87,3,4,1,8,0xb2d0f9a3
158523.67,2.0,132,3,3,1,7,0xb2d41a29d
220027.88,4.0,1,3,4,4,11,0xb2d98b17
50005.53,2.0,36,2,3,2,7,0xb2d64333d
821.28,1.0,12,1,2,3,6,0xb2d265d1
252160.81,5.0,4,3,4,4,11,0xb2d5997cd
206417.93,2.0,88,3,3,1,7,0xb2d50c07
54607.15,2.0,0,3,3,4,10,0xb2d3c74d
6956.26,1.0,6,2,2,3,7,0xb2d60aaf
22591.39,1.0,0,2,2,4,8,0xb2d17674
4257898.98,9.0,1,4,4,4,12,0xb2d0c55f
772204.63,25.0,7,4,4,3,11,0xb2d06b21
525016.63,2.0,21,4,3,2,9,0xb2da1e4f
119.96,1.0,33,1,2,2,5,0xb2d6b66a
320091.4,4.0,0,4,4,4,12,0xb2d17977d
244136.64,3.0,4,3,4,4,11,0xb2d5ee5c
1411.9,1.0,10,1,2,3,6,0xb2d2bdbdd
590316.7,11.0,3,4,4,4,12,0xb2d43d77
392771.35,2.0,62,4,3,2,9,0xb2d9ad45
144.01,1.0,86,1,2,1,4,0xb2d3ea18
183416.73,2.0,21,3,3,2,8,0xb2d196b4d
300016.9,2.0,6,3,3,3,9,0xb2d0deb4d
306.19,1.0,20,1,2,2,5,0xb2d69f75
10000.11,2.0,133,2,3,1,6,0xb2d923c3d
8043.05,1.0,45,2,2,2,6,0xb2d9a30e
8496.29,1.0,184,2,2,1,5,0xb2d3db4b
14884.02,1.0,1,2,2,4,8,0xb2d3b195
122285.3,2.0,31,3,3,2,8,0xb2d4e773d
280016.21,3.0,8,3,4,3,10,0xb2d63535d
31243495.85,1.0,3,4,2,4,10,0xb2d13a09
103489.2,2.0,5,3,3,3,9,0xb2d58b51d
965.15,3.0,0,1,4,4,9,0x3b9b1a3b
152.88,1.0,167,1,2,1,4,0xb2d43757d
417881.18,3.0,3,4,4,4,12,0xb2d28417
131196.24,4.0,3,3,4,4,11,0xb2d558ab
400008.57,3.0,83,4,4,1,9,0xb2d52e4e
99001.84,4.0,1,3,4,4,11,0xb2d18ba8d
1500233.18,5.0,0,4,4,4,12,0xb2d0e386
3092.56,1.0,4,2,2,4,8,0xb2d942e5
9500000.0,2.0,5,4,3,3,10,0xb2d6dccd
50608.8,2.0,139,2,3,1,6,0xb2d64e5fd
998.85,1.0,1,1,2,4,7,0xb2d38645
49812.78,3.0,13,2,4,3,9,0xb2d3c785
5.64,1.0,14,1,2,3,6,0xb2d1784ad
468939.72,7.0,0,4,4,4,12,0xb2d16d98d
3998488.77,21.0,0,4,4,4,12,0xb2d0697e
2311.32,1.0,125,1,2,1,4,0xb2d5e958
200000.0,2.0,1,3,3,4,10,0xb2da6981
13123.54,1.0,92,2,2,1,5,0xb2d28198
50724.74,2.0,306,2,3,1,6,0xb2d0c00c
1.02,1.0,0,1,2,4,7,0xb2d212a4
500000.0,2.0,8,4,3,3,10,0xb2d92c93
78331.72,1.0,10,3,2,3,8,0xb2d307fbd
40029.43,2.0,30,2,3,2,7,0xb2d6e454
1939.79,5.0,0,1,4,4,9,0xb2d0a6f7
3018063.23,14.0,11,4,4,3,11,0xb2d1e297d
73326.8,1.0,50,3,2,2,7,0xb2d18ac3
3.26,1.0,73,1,2,1,4,0xb2d5a786
17133.3,1.0,0,2,2,4,8,0xb2d6a074
144.73,1.0,60,1,2,2,5,0xb2d3bd01
1907.41,3.0,184,1,4,1,6,0xb2d08c99
206624.72,4.0,62,3,4,2,9,0xb2d1a451
10498.48,2.0,18,2,3,2,7,0xb2d559a2
600000.08,4.0,4,4,4,4,12,0xb2d59c14
35523.4,1.0,1,2,2,4,8,0xb2d6cc76
608340.44,7.0,69,4,4,1,9,0xb2d3c356
91.0,1.0,67,1,2,1,4,0xb2d2ef4d
400000.95,3.0,15,4,4,3,11,0xb2d9acb9
799.47,1.0,35,1,2,2,5,0xb2d93a15
2.14,1.0,32,1,2,2,5,0xb2d3b3de
3244.08,1.0,92,2,2,1,5,0xb2d206f6
4.72,1.0,64,1,2,2,5,0xb2d7f4e6
555660.04,3.0,4,4,4,4,12,0xb2d0a896
50936.91,2.0,28,2,3,2,7,0xb2d23c71d
2208.73,1.0,0,1,2,4,7,0xb2d3084b
4865180.89,97.0,5,4,4,3,11,0xb2d0bb89
51085.35,1.0,16,2,2,2,6,0xb2d0e06e
43.02,2.0,53,1,3,2,6,0xb2d5f06fd
10248.31,2.0,87,2,3,1,6,0xb2d58385
31083.85,1.0,5,2,2,3,7,0xb2d6cda1
108.49,1.0,51,1,2,2,5,0xb2d41628d
1842.87,1.0,106,1,2,1,4,0xb2d5fbd1
50052.55,2.0,179,2,3,1,6,0xb2d5f41f
248.62,1.0,1,1,2,4,7,0xb2d906d5
3.69,1.0,42,1,2,2,5,0xb2d580dd
100068.14,2.0,10,3,3,3,9,0xb2d5fc9fd
2586.23,4.0,13,1,4,3,8,0xb2d6ef8a
115483.26,6.0,18,3,4,2,9,0xb2d5fc21
890.35,1.0,92,1,2,1,4,0xb2d25406
900067.07,5.0,203,4,4,1,9,0xb2d16dc2d
0.0,1.0,3,1,2,4,7,0xb2d6d17d
1.58,1.0,63,1,2,2,5,0xb2d313fbd
333.52,1.0,12,1,2,3,6,0xb2d2e2a4
158.75,1.0,9,1,2,3,6,0xb2d33b12
8183.29,1.0,1,2,2,4,8,0xb2d21ba9
18345.47,1.0,6,2,2,3,7,0xb2d929abd
1000.92,1.0,97,1,2,1,4,0xb2d9672d
152.84,1.0,9,1,2,3,6,0xb2d470e3
312042.61,5.0,27,4,4,2,10,0xb2d6c1bfd
282009.66,3.0,38,3,4,2,9,0xb2d55df0d
20297.79,1.0,20,2,2,2,6,0xb2d8e255d
50380.52,2.0,101,2,3,1,6,0xb2d56d24d
969348.92,10.0,0,4,4,4,12,0xb2d1c370d
1100047.14,3.0,70,4,4,1,9,0xb2d1bf29d
506725.97,4.0,21,4,4,2,10,0xb2d5ef7dd
340831.01,2.0,27,4,3,2,9,0xb2d6d12d
1010276.4,2.0,24,4,3,2,9,0xb2d2b320
4.75,2.0,1,1,3,4,8,0xb2d32547
215821.23,2.0,30,3,3,2,8,0xb2d365abd
1714.23,1.0,1,1,2,4,7,0xb2d19508
18058.04,1.0,2,2,2,4,8,0xb2d3b359
29464.53,1.0,16,2,2,2,6,0xb2d660ff
105444.87,6.0,90,3,4,1,8,0xb2d58764d
544051.35,3.0,23,4,4,2,10,0xb2d6e77a
2624.89,1.0,92,1,2,1,4,0xb2d2277e
3022.23,1.0,184,2,2,1,5,0xb2d26356
29503.95,1.0,0,2,2,4,8,0xb2d9e270
85.06,1.0,5,1,2,3,6,0xb2d96501
100383.15,2.0,21,3,3,2,8,0xb2d09330d
100454.33,2.0,87,3,3,1,7,0xb2d138f7d
4452.86,1.0,6,2,2,3,7,0xb2d3220fd
402181.95,3.0,46,4,4,2,10,0xb2d9820ad
205295.43,1.0,92,3,2,1,6,0xb2d0e291
550348.89,5.0,19,4,4,2,10,0xb2d0c348
5621.33,1.0,7,2,2,3,7,0xb2d2acd4d
110003.68,2.0,249,3,3,1,7,0xb2d61018
1373.08,1.0,0,1,2,4,7,0xb2d240df
226.59,1.0,60,1,2,2,5,0xb2d6b1cf
130082.56,3.0,0,3,4,4,11,0xb2d57a02
500003.06,3.0,6,4,4,3,11,0xb2d94d8cd
220086.4,4.0,5,3,4,3,10,0xb2d1603e
3053.43,1.0,18,2,2,2,6,0xb2d405ba
103000.0,3.0,3,3,4,4,11,0xb2d972b0d
30466.26,2.0,73,2,3,1,6,0xb2d55601
523883.77,2.0,6,4,3,3,10,0xb2d3c437
212843.67,3.0,26,3,4,2,9,0xb2d6e1d5
151.11,1.0,12,1,2,3,6,0xb2d99948
12205.46,1.0,14,2,2,3,7,0xb2d5d186
350055.0,2.0,1,4,3,4,11,0xb2d8d621d
502444.49,2.0,9,4,3,3,10,0xb2d39a6bd
1782973.83,9.0,7,4,4,3,11,0xb2d1c0dad
5182.69,2.0,8,2,3,3,8,0xb2d1ece0
180101.96,2.0,21,3,3,2,8,0xb2d9900c
1542.38,1.0,24,1,2,2,5,0xb2d61ba6
1503.34,2.0,1,1,3,4,8,0xb2d2e028
35049.35,1.0,2,2,2,4,8,0xb2d2e13a
7301.84,1.0,0,2,2,4,8,0xb2d59247
2084.51,1.0,0,1,2,4,7,0xb2d441c5
953.45,1.0,16,1,2,2,5,0xb2d2f6b3
200008.04,2.0,97,3,3,1,7,0xb2d5f5a2d
218.53,1.0,0,1,2,4,7,0xb2d95762
30704.35,1.0,7,2,2,3,7,0xb2d43a32d
8.94,2.0,33,1,3,2,6,0xb2d2430ad
5397.7,2.0,0,2,3,4,9,0x3b9ad002
30000.95,2.0,24,2,3,2,7,0xb2d945a5d
580534.01,11.0,4,4,4,4,12,0xb2d17106d
190012.7,2.0,122,3,3,1,7,0xb2d5a5aa
2035.87,1.0,92,1,2,1,4,0xb2d1cbfdd
200017.32,2.0,104,3,3,1,7,0xb2d69030
150006.35,2.0,217,3,3,1,7,0xb2d71747d
1779478.95,25.0,8,4,4,3,11,0x3b9af2a5
440420.85,5.0,4,4,4,4,12,0x3b9af281d
3250.51,1.0,7,2,2,3,7,0xb2d39355
320003.38,2.0,98,4,3,1,8,0xb2d96aded
450001.58,3.0,27,4,4,2,10,0xb2d7b0a2d
460353.25,2.0,184,4,3,1,8,0x3b9ad3ddd
72463.79,2.0,90,3,3,1,7,0xb2d4971b
167.69,1.0,0,1,2,4,7,0xb2d1e652
1710.03,1.0,184,1,2,1,4,0xb2d3a09a
11.08,1.0,3,1,2,4,7,0xb2d9056b
263202.72,2.0,4,3,3,4,10,0xb2d85c3ed
318485.04,3.0,18,4,4,2,10,0xb2d2b28f
6795.2,1.0,1,2,2,4,8,0xb2d6fc38d
50446.9,1.0,0,2,2,4,8,0xb2d2d865
288491.33,3.0,1,3,4,4,11,0xb2d2112a
5102.94,1.0,61,2,2,2,6,0xb2d8dabc
2245.61,1.0,12,1,2,3,6,0xb2d5ad7d
6402.33,1.0,0,2,2,4,8,0xb2d4f6fdd
130006.41,5.0,108,3,4,1,8,0xb2d61b38
203213.36,2.0,10,3,3,3,9,0xb2d64768
44213.17,1.0,0,2,2,4,8,0xb2d451f8d
230392.87,2.0,14,3,3,3,9,0xb2d23eb4
200004.61,2.0,21,3,3,2,8,0xb2d40c71
852400.76,7.0,7,4,4,3,11,0xb2d6e0f1
6362.58,1.0,9,2,2,3,7,0xb2d1c1e4
10676.52,1.0,92,2,2,1,5,0xb2d0f67a
123917.17,2.0,73,3,3,1,7,0xb2d5c912d
150011.93,4.0,3,3,4,4,11,0xb2d2afb7
401428.91,2.0,51,4,3,2,9,0xb2d8d638
9100.62,1.0,11,2,2,3,7,0xb2d6fb09
90081.91,6.0,74,3,4,1,8,0xb2d56ad9
74244.05,2.0,0,3,3,4,10,0xb2d0d0a5
30032.33,1.0,72,2,2,1,5,0xb2d2c265
549017.67,16.0,10,4,4,3,11,0xb2d31723
200009.23,2.0,172,3,3,1,7,0xb2d4d9d3d
265000.0,2.0,0,3,3,4,10,0xb2da1cad
2844.47,1.0,184,1,2,1,4,0xb2d2bca2d
4373.15,1.0,5,2,2,3,7,0xb2d6b8d4d
909158.35,7.0,32,4,4,2,10,0xb2d0adb9
1141.77,2.0,67,1,3,1,5,0xb2d467d5d
2583.53,1.0,184,1,2,1,4,0xb2d3939fd
300804.32,3.0,51,4,4,2,10,0xb2d62eed
1806266.92,8.0,0,4,4,4,12,0xb2d6890b
4325.58,4.0,63,2,4,2,8,0xb2d11fcb
2726.8,1.0,0,1,2,4,7,0xb2d3f2b3
326848.95,8.0,0,4,4,4,12,0x3b9b233c
8343.08,1.0,3,2,2,4,8,0xb2d6e861
4403.12,1.0,187,2,2,1,5,0xb2d540c6d
5015.87,2.0,92,2,3,1,6,0x3b9b159fd
2084.34,1.0,7,1,2,3,6,0xb2d2d42c
50104.32,2.0,11,2,3,3,8,0xb2d315c3
20000.0,2.0,4,2,3,4,9,0xb2da5a83
13.2,1.0,60,1,2,2,5,0xb2d8a507
120112.97,3.0,172,3,4,1,8,0xb2d5a55a
82559.2,1.0,19,3,2,2,7,0xb2d2e296
71050.46,2.0,126,3,3,1,7,0xb2d5dc30
3682.75,1.0,15,2,2,3,7,0xb2d2b9b9
200000.0,2.0,19,3,3,2,8,0xb2d958eed
1700.74,1.0,0,1,2,4,7,0xb2d5cf66
17357.5,1.0,0,2,2,4,8,0xb2d1a7c2d
859254.29,14.0,0,4,4,4,12,0x3b9af1e1
6140.02,1.0,3,2,2,4,8,0xb2d99df7
43.04,1.0,67,1,2,1,4,0xb2d67dc0
3400004.76,5.0,13,4,4,3,11,0xb2d616dad
115.45,1.0,42,1,2,2,5,0xb2d6e9bf
195.83,1.0,10,1,2,3,6,0xb2d5ee3a
98847.71,1.0,6,3,2,3,8,0xb2d29781
32543.24,1.0,15,2,2,3,7,0xb2d6b8b5
14693.25,1.0,18,2,2,2,6,0xb2d70700
255013.47,7.0,6,3,4,3,10,0xb2d43692d
230025.45,3.0,4,3,4,4,11,0xb2d4207a
399140.4,2.0,158,4,3,1,8,0xb2d5b0cc
853188.9,5.0,0,4,4,4,12,0xb2d49e86
1078.65,1.0,17,1,2,2,5,0xb2da08c6
101227.07,1.0,0,3,2,4,9,0xb2d30d61
501158.26,2.0,11,4,3,3,10,0xb2d78c2b
113085.99,4.0,83,3,4,1,8,0xb2d28456d
122115.99,5.0,0,3,4,4,11,0x3b9b468a
167184.79,4.0,3,3,4,4,11,0xb2d210bf
986798.28,10.0,1,4,4,4,12,0xb2d0a515
11331.51,2.0,4,2,3,4,9,0xb2d1605f
94.48,1.0,78,1,2,1,4,0xb2d95c8a
19480.34,1.0,7,2,2,3,7,0xb2d8fecfd
24326.48,1.0,21,2,2,2,6,0xb2d6ddded
265110.32,4.0,0,3,4,4,11,0xb2d3f668
4806.69,1.0,185,2,2,1,5,0xb2d2911b
2551.87,1.0,109,1,2,1,4,0xb2d70471d
10000.32,2.0,92,2,3,1,6,0xb2d63ee7
60044.76,2.0,0,3,3,4,10,0xb2d91628
19835.68,1.0,184,2,2,1,5,0xb2d221fe
50.03,1.0,1,1,2,4,7,0xb2d6d1f1
151301.52,2.0,92,3,3,1,7,0xb2d53c8f
0.0,1.0,3,1,2,4,7,0xb2d12eab
145001.53,3.0,56,3,4,2,9,0xb2d958aad
17.48,1.0,6,1,2,3,6,0xb2d2623d
354909.54,2.0,0,4,3,4,11,0xb2d42b4cd
875.05,1.0,1,1,2,4,7,0xb2d57edd
100041.82,2.0,129,3,3,1,7,0xb2d3afef
482781.16,2.0,116,4,3,1,8,0xb2d9438c
274005.3,3.0,0,3,4,4,11,0xb2d075c0
1888665.24,6.0,13,4,4,3,11,0xb2d63309
70003.33,3.0,51,3,4,2,9,0xb2d65003
820990.55,3.0,23,4,4,2,10,0xb2d98096
50000.06,3.0,0,2,4,4,10,0xb2da4754
46122.95,7.0,41,2,4,2,8,0x3b9ad55fd
4478.53,1.0,6,2,2,3,7,0xb2d12daa
630104.32,4.0,0,4,4,4,12,0xb2d6c8f2
17060.51,2.0,53,2,3,2,7,0xb2d3dfabd
40664.68,1.0,0,2,2,4,8,0xb2d15b01
20.5,1.0,84,1,2,1,4,0xb2d5820f
567474.89,4.0,1,4,4,4,12,0xb2d632e1
2043.6,1.0,3,1,2,4,7,0xb2d94165d
1473.64,1.0,1,1,2,4,7,0xb2d323df
5602.72,4.0,92,2,4,1,7,0x3b9b1a60
1290.73,1.0,92,1,2,1,4,0xb2d29461d
3396.92,1.0,0,2,2,4,8,0xb2d85d2b
3292.64,1.0,92,2,2,1,5,0xb2d33c39
38282.09,2.0,251,2,3,1,6,0xb2d5a27b
0.68,1.0,2,1,2,4,7,0xb2d26504
8037.97,1.0,0,2,2,4,8,0xb2d6bfaf
71315.25,1.0,3,3,2,4,9,0xb2d69012
200051.17,2.0,216,3,3,1,7,0xb2d5ab88
6512.13,1.0,1,2,2,4,8,0xb2d0bc7c
62457.47,2.0,104,3,3,1,7,0xb2d55e02d
190.82,1.0,9,1,2,3,6,0xb2d68df3
50127.21,2.0,6,2,3,3,8,0xb2d95993d
23.38,1.0,55,1,2,2,5,0xb2d260c3d
4867.81,4.0,36,2,4,2,8,0xb2d64177
1691.27,1.0,184,1,2,1,4,0xb2d2efb8
201.41,1.0,56,1,2,2,5,0xb2d6eaf3
277991.69,2.0,116,3,3,1,7,0xb2d321bdd
6450043.23,14.0,0,4,4,4,12,0xb2d17275d
3050.79,1.0,92,2,2,1,5,0x3b9b2544d
53.19,6.0,0,1,4,4,9,0xb2d5d180d
1001.35,1.0,138,1,2,1,4,0xb2d919ef
947456.43,2.0,5,4,3,3,10,0xb2d3a1dbd
136420.76,3.0,181,3,4,1,8,0xb2d1cf54d
8.72,1.0,67,1,2,1,4,0xb2d64143
900.79,1.0,11,1,2,3,6,0xb2d2509c
1139.73,1.0,16,1,2,2,5,0xb2d2e146
993134.34,7.0,3,4,4,4,12,0xb2d1b5a9d
30809.84,1.0,253,2,2,1,5,0xb2d422ba
6093.12,2.0,92,2,3,1,6,0xb2d194f7d
3112.15,1.0,184,2,2,1,5,0xb2d39909d
1376575.45,9.0,0,4,4,4,12,0xb2d35ac6
57147.6,2.0,27,3,3,2,8,0xb2d24283
500108.72,2.0,8,4,3,3,10,0xb2d6c06d
482668.89,2.0,0,4,3,4,11,0xb2d4effa
32.7,1.0,5,1,2,3,6,0xb2d97953
50027.84,2.0,144,2,3,1,6,0xb2d249a3
7.07,1.0,19,1,2,2,5,0xb2d981cc
203661.23,2.0,181,3,3,1,7,0xb2d6acac
62975.38,2.0,252,3,3,1,7,0xb2d26ed8d
591165.01,5.0,0,4,4,4,12,0xb2d2ba68
1805.95,1.0,184,1,2,1,4,0xb2d30b33
0.91,1.0,4,1,2,4,7,0xb2d8e03c
100429.06,2.0,306,3,3,1,7,0xb2d140f3d
54535.63,2.0,200,3,3,1,7,0xb2d44610d
82.64,1.0,11,1,2,3,6,0xb2d910b2d
600004.24,2.0,6,4,3,3,10,0xb2d503c0
1200000.0,2.0,92,4,3,1,8,0xb2d5ae67d
85.82,1.0,7,1,2,3,6,0xb2d94a41
585098.69,4.0,4,4,4,4,12,0xb2d5fc33
270078.4,3.0,5,3,4,3,10,0xb2d928f4d
204384.05,2.0,17,3,3,2,8,0xb2d5d44e
451683.28,2.0,29,4,3,2,9,0xb2d5d120
32617.51,1.0,29,2,2,2,6,0xb2d4fd6fd
17797.43,1.0,14,2,2,3,7,0xb2d57bbdd
1442127.25,5.0,0,4,4,4,12,0xb2d189e3d
414424.09,3.0,95,4,4,1,9,0xb2d3d063
800180.71,7.0,3,4,4,4,12,0xb2d56cbfd
216740.09,3.0,85,3,4,1,8,0x3b9b45ea
51886.31,1.0,9,2,2,3,7,0xb2d24f93
6826.2,1.0,0,2,2,4,8,0xb2d53059d
130140.99,6.0,0,3,4,4,11,0xb2d598a6d
200710.86,2.0,16,3,3,2,8,0xb2d97430d
25002.38,2.0,92,2,3,1,6,0xb2d6586f
2.36,1.0,13,1,2,3,6,0xb2d912ec
113247.34,3.0,21,3,4,2,9,0xb2d93030
741249.67,3.0,42,4,4,2,10,0xb2d1c83d
3130.36,1.0,18,2,2,2,6,0xb2d1346a
19.73,1.0,8,1,2,3,6,0xb2d688d2
0.11,1.0,103,1,2,1,4,0xb2d48627d
400677.72,2.0,0,4,3,4,11,0xb2d2faff
28468.05,1.0,0,2,2,4,8,0xb2d5d506d
530029.41,6.0,70,4,4,1,9,0xb2d148cd
1180261.28,7.0,18,4,4,2,10,0xb2d478e7
150032.05,5.0,35,3,4,2,9,0xb2d0765ed
350006.86,4.0,53,4,4,2,10,0xb2d92453
500.75,2.0,47,1,3,2,6,0xb2d52c98
320854.02,3.0,63,4,4,2,10,0xb2d14d02d
501776.21,2.0,25,4,3,2,9,0xb2d8e989
10000.05,5.0,1,2,4,4,10,0xb2d0a03ed
1746.27,1.0,10,1,2,3,6,0xb2d6c322
5785.86,1.0,21,2,2,2,6,0xb2d91bec
1269089.53,9.0,5,4,4,3,11,0xb2d6aa63d
58.38,1.0,21,1,2,2,5,0xb2d68ee2
510666.05,2.0,204,4,3,1,8,0xb2d78022
1157.01,1.0,92,1,2,1,4,0xb2d1c073
1401.8,1.0,60,1,2,2,5,0xb2d39d62
200001.64,3.0,1,3,4,4,11,0xb2d2d6d0
200713.13,2.0,32,3,3,2,8,0xb2d249b9
12565.79,1.0,0,2,2,4,8,0xb2d78f1dd
438008.15,4.0,18,4,4,2,10,0xb2d12eb7d
150000.0,12.0,1,3,4,4,11,0xb2d6812c
5322.43,4.0,131,2,4,1,7,0x3b9b194e
0.0,1.0,1,1,2,4,7,0xb2d973fbd
10000.21,2.0,21,2,3,2,7,0xb2da1f27
130002.58,4.0,6,3,4,3,10,0xb2da3913
50464.39,2.0,139,2,3,1,6,0xb2d603d3
195.86,2.0,40,1,3,2,6,0xb2d92317d
4779.89,1.0,16,2,2,2,6,0xb2d35ca6
120.55,2.0,10,1,3,3,7,0xb2d267b5
220000.42,3.0,18,3,4,2,9,0xb2d95417
2577.21,1.0,0,1,2,4,7,0xb2d86bd3
5.2,1.0,40,1,2,2,5,0xb2d6e774
94.09,1.0,16,1,2,2,5,0xb2d2a374
11155.23,2.0,34,2,3,2,7,0xb2d6158e
367.29,1.0,10,1,2,3,6,0xb2d421d8
6.67,1.0,40,1,2,2,5,0xb2d27184
216.84,1.0,19,1,2,2,5,0xb2d90201
6000.13,3.0,4,2,4,4,10,0xb2d95694
4.46,1.0,46,1,2,2,5,0xb2d94ecb
215969.83,6.0,62,3,4,2,9,0xb2d2ae18
261348.26,1.0,82,3,2,1,6,0xb2d43751
11747.72,1.0,11,2,2,3,7,0xb2d27c4bd
150303.73,9.0,4,3,4,4,11,0xb2d0c872d
5588.1,1.0,184,2,2,1,5,0xb2d33588
19411.14,1.0,0,2,2,4,8,0xb2d8eeaa
501776.08,2.0,42,4,3,2,9,0xb2d1c61cd
380408.47,5.0,55,4,4,2,10,0xb2d5621ed
200041.84,2.0,19,3,3,2,8,0xb2d6e6e0
120532.63,2.0,164,3,3,1,7,0xb2d0cb67
50009.56,2.0,18,2,3,2,7,0xb2d5b27bd
70007.93,4.0,18,3,4,2,9,0xb2d96720
465269.41,5.0,27,4,4,2,10,0xb2d4d356
60052.02,3.0,32,3,4,2,9,0xb2d92ff0d
957.93,1.0,0,1,2,4,7,0xb2d31b04
200000.84,1.0,0,3,2,4,9,0xb2d3f016
200001.04,2.0,102,3,3,1,7,0xb2d9030fd
391.16,1.0,24,1,2,2,5,0xb2d3480c
61001.17,3.0,199,3,4,1,8,0xb2d5e919
151454.66,3.0,56,3,4,2,9,0xb2d69a8ad
804504.26,7.0,1,4,4,4,12,0xb2d55115
10191.79,2.0,161,2,3,1,6,0xb2d65614d
2048.23,1.0,184,1,2,1,4,0xb2d1dab2
8564.94,1.0,10,2,2,3,7,0xb2d44419d
91495.88,4.0,18,3,4,2,9,0xb2d0a76f
80000.84,2.0,53,3,3,2,8,0xb2d9d03c
447045.75,3.0,249,4,4,1,9,0xb2d0e9e4
9288.12,1.0,1,2,2,4,8,0xb2d3f302
2652.86,1.0,235,1,2,1,4,0xb2d53b00
80639.98,3.0,7,3,4,3,10,0xb2d5f562d
61315850.88,3.0,3,4,4,4,12,0xb2d32933
912889.14,6.0,11,4,4,3,11,0xb2d68defd
160054.87,2.0,11,3,3,3,9,0xb2d5ea16d
45007.63,3.0,59,2,4,2,8,0xb2d286add
1619.24,1.0,18,1,2,2,5,0xb2d37b49
50026.06,2.0,200,2,3,1,6,0xb2d6b0ed
20675.6,1.0,0,2,2,4,8,0xb2d30b81
4024.93,1.0,211,2,2,1,5,0xb2d112c7
9407.79,1.0,184,2,2,1,5,0xb2d0d430
2133.68,2.0,92,1,3,1,5,0xb2d07d3f
356089.07,6.0,3,4,4,4,12,0xb2d57954
350032.08,5.0,0,4,4,4,12,0xb2d428fbd
2125463.13,11.0,49,4,4,2,10,0xb2d0a5ced
158.29,2.0,20,1,3,2,6,0xb2d0a2a6
34385.23,1.0,0,2,2,4,8,0xb2d5b0a1d
2527.48,1.0,7,1,2,3,6,0xb2d22e95
256912.03,2.0,33,3,3,2,8,0xb2d12660
131197.08,3.0,160,3,4,1,8,0xb2d5c921
350167.24,6.0,3,4,4,4,12,0xb2d3251fd
61160.7,1.0,92,3,2,1,6,0xb2d34d6dd
2248.19,1.0,116,1,2,1,4,0xb2d3536e
202131.99,2.0,103,3,3,1,7,0xb2d80e49d
400029.93,2.0,6,4,3,3,10,0xb2d1f714
14029.89,2.0,27,2,3,2,7,0xb2d0c851
60001.9,2.0,186,3,3,1,7,0xb2d868b3
119452.0,5.0,0,3,4,4,11,0xb2d2471e
10093.93,1.0,4,2,2,4,8,0xb2d7f22f
5.5,1.0,32,1,2,2,5,0xb2d68323
37039.54,1.0,22,2,2,2,6,0xb2d4ed3ed
806638.87,4.0,60,4,4,2,10,0xb2d26de0
297219.21,4.0,32,3,4,2,9,0xb2d154bbd
2158.9,5.0,184,1,4,1,6,0xb2d0dd7ad
36352.28,1.0,19,2,2,2,6,0xb2d68ccd
105217.56,1.0,39,3,2,2,7,0xb2d432ac
353855.56,3.0,0,4,4,4,12,0xb2d591c0
2000000.0,2.0,26,4,3,2,9,0xb2d94876
900000.74,6.0,11,4,4,3,11,0xb2d1cde4
4411.22,1.0,92,2,2,1,5,0xb2d16c3ed
24107.47,1.0,0,2,2,4,8,0xb2d603cb
100158.92,1.0,159,3,2,1,6,0xb2d683e7
10092.21,2.0,6,2,3,3,8,0xb2da21e5
50013.15,2.0,35,2,3,2,7,0xb2d28711d
393.88,1.0,79,1,2,1,4,0xb2d681ad
3794.05,37.0,92,2,4,1,7,0xb2d218e7d
602.29,1.0,0,1,2,4,7,0xb2d52c0b
706221.37,8.0,3,4,4,4,12,0xb2d4112f
965.85,1.0,2,1,2,4,7,0xb2d50371
0.0,1.0,2,1,2,4,7,0xb2d65512
21859.06,1.0,1,2,2,4,8,0xb2d43f00d
61068.79,1.0,20,3,2,2,7,0xb2d6ee9bd
7105.26,1.0,0,2,2,4,8,0xb2d51c94d
32.35,1.0,157,1,2,1,4,0xb2d2b337
1109.85,1.0,177,1,2,1,4,0xb2d1a449
20002.59,3.0,39,2,4,2,8,0xb2d55f80
4516.71,1.0,184,2,2,1,5,0xb2d17955d
2707.97,1.0,0,1,2,4,7,0xb2d2d63f
10341.4,1.0,13,2,2,3,7,0xb2d75b57d
98667.36,3.0,0,3,4,4,11,0xb2d31d65d
67.41,1.0,31,1,2,2,5,0xb2d2fd42
14470.81,1.0,229,2,2,1,5,0xb2d6bd1f
50000.53,2.0,77,2,3,1,6,0xb2d9976b
1180.77,1.0,184,1,2,1,4,0xb2d4e579d
615.69,1.0,0,1,2,4,7,0xb2d55f88
1054.79,1.0,92,1,2,1,4,0xb2d52e8c
364.4,1.0,70,1,2,1,4,0xb2d6c31ad
285004.8,8.0,0,3,4,4,11,0xb2d5b32a
77855.71,7.0,0,3,4,4,11,0xb2d54f13
257.95,1.0,8,1,2,3,6,0xb2d6a110
20916.05,3.0,47,2,4,2,8,0xb2d38fced
834.62,1.0,11,1,2,3,6,0xb2d9a665
1225.07,1.0,9,1,2,3,6,0xb2d6a3ce
102.72,1.0,24,1,2,2,5,0xb2d2dba5
50913.46,2.0,11,2,3,3,8,0xb2d2c163
81708.57,7.0,0,3,4,4,11,0xb2d6675e
1.44,1.0,29,1,2,2,5,0xb2d8ecaa
7716.21,1.0,5,2,2,3,7,0xb2d78b8e
19808.4,1.0,3,2,2,4,8,0xb2d6c147d
235005.8,3.0,56,3,4,2,9,0xb2d9b787
790090.15,5.0,67,4,4,1,9,0xb2d2a056
481081.11,4.0,55,4,4,2,10,0xb2d53775
500000.0,2.0,7,4,3,3,10,0xb2da564c
84477.46,2.0,4,3,3,4,10,0xb2d9c191
1805.43,1.0,2,1,2,4,7,0xb2d6604c
530018.94,7.0,18,4,4,2,10,0xb2d1b779
52663.62,2.0,6,3,3,3,9,0xb2d12851
210221.07,2.0,98,3,3,1,7,0xb2d83bcc
40001.19,2.0,74,2,3,1,6,0xb2d5c86e
80171.54,3.0,10,3,4,3,10,0xb2d9052e
64.05,1.0,81,1,2,1,4,0xb2d3f0b4
5041.59,1.0,92,2,2,1,5,0xb2d303bed
1573.72,1.0,306,1,2,1,4,0xb2d247c6d
808.17,1.0,0,1,2,4,7,0xb2d67099
1934141.58,12.0,1,4,4,4,12,0xb2d475dd
1020000.0,5.0,1,4,4,4,12,0xb2d51492d
42384.08,4.0,0,2,4,4,10,0x3b9b35ba
921083.73,5.0,18,4,4,2,10,0xb2d10a9bd
1448.26,1.0,184,1,2,1,4,0xb2d29844
190049.67,2.0,116,3,3,1,7,0xb2d56bfc
1190220.76,37.0,0,4,4,4,12,0xb2d60638d
41489.29,1.0,6,2,2,3,7,0xb2d2a8cad
52976.17,2.0,21,3,3,2,8,0xb2d21823
522.1,1.0,0,1,2,4,7,0xb2d33b69
10006.43,2.0,5,2,3,3,8,0xb2d38b17d
1.63,1.0,18,1,2,2,5,0xb2d5d1c4
5705.82,1.0,1,2,2,4,8,0xb2d25b1c
89039.38,2.0,11,3,3,3,9,0xb2d302d9
320056.14,3.0,80,4,4,1,9,0xb2d34df2d
90970.38,1.0,0,3,2,4,9,0xb2da4d48
50879.27,1.0,126,2,2,1,5,0xb2d64897
949.07,1.0,10,1,2,3,6,0xb2d925e1
101711.84,2.0,157,3,3,1,7,0xb2d60e68
4698.73,1.0,184,2,2,1,5,0xb2d2d5ea
10033.01,2.0,184,2,3,1,6,0xb2d29db7
145117.54,1.0,5,3,2,3,8,0xb2d37ac7
376344.14,5.0,10,4,4,3,11,0xb2d3a629d
50001.16,3.0,41,2,4,2,8,0xb2d6aa09d
16.86,1.0,39,1,2,2,5,0xb2d22997
1119.49,1.0,92,1,2,1,4,0xb2d2494bd
50083.77,1.0,10,2,2,3,7,0xb2d50f39
13.72,1.0,62,1,2,2,5,0xb2d95f1c
810015.57,3.0,5,4,4,3,11,0xb2d78936d
262392.02,2.0,155,3,3,1,7,0xb2d1ddff
299.25,1.0,24,1,2,2,5,0xb2d90491
101.25,1.0,3,1,2,4,7,0xb2d4f53d
103430.71,3.0,174,3,4,1,8,0xb2d36ee4
60879.65,1.0,184,3,2,1,6,0xb2d27e77
460018.23,2.0,101,4,3,1,8,0xb2d6c09e
240113.65,2.0,4,3,3,4,10,0xb2d9479ed
11259.02,1.0,211,2,2,1,5,0xb2d1c965d
110001.79,4.0,38,3,4,2,9,0xb2d6ef18
300065.64,2.0,9,3,3,3,9,0xb2d9eeea
7896.99,1.0,18,2,2,2,6,0xb2d2e85b
470066.25,3.0,11,4,4,3,11,0xb2d641fd
30001.0,2.0,0,2,3,4,9,0xb2d55f84
3107.28,1.0,21,2,2,2,6,0xb2d9619a
434.67,22.0,11,1,4,3,8,0xb2d62f72
201464.62,2.0,67,3,3,1,7,0xb2d69200d
132.95,1.0,9,1,2,3,6,0xb2d29afc
150000.0,2.0,55,3,3,2,8,0xb2d55859
40003.1,3.0,25,2,4,2,8,0xb2d31453
370023.76,8.0,0,4,4,4,12,0xb2d166c7
17005.66,2.0,66,2,3,2,7,0xb2d192f7
500000.0,2.0,0,4,3,4,11,0xb2d6df2a
20002.98,2.0,11,2,3,3,8,0xb2d9128d
570906.64,6.0,35,4,4,2,10,0xb2d30025
9273.76,1.0,15,2,2,3,7,0xb2d22401
1774785.23,9.0,77,4,4,1,9,0xb2d1b25ed
1147.07,1.0,10,1,2,3,6,0xb2d95e5f
185008.1,3.0,67,3,4,1,8,0xb2d1a49b
1183.49,1.0,89,1,2,1,4,0xb2d93014
3842057.28,17.0,2,4,4,4,12,0xb2d11f9ad
1010711.68,3.0,100,4,4,1,9,0xb2d3076cd
81.21,1.0,21,1,2,2,5,0xb2d0d14a
201097.53,2.0,43,3,3,2,8,0xb2d3c59d
50001.58,2.0,228,2,3,1,6,0xb2d6f1fe
30000.95,2.0,10,2,3,3,8,0xb2d961a8
400790.02,3.0,8,4,4,3,11,0xb2d687f0
600002.5,2.0,20,4,3,2,9,0xb2d98fd1
4331.58,1.0,0,2,2,4,8,0xb2d10fe8d
13078.7,1.0,0,2,2,4,8,0xb2d4ce70d
61768.8,4.0,0,3,4,4,11,0xb2d298c8d
497707.17,1.0,1,4,2,4,10,0xb2d138d5d
3.68,1.0,18,1,2,2,5,0xb2d21dd2
0.74,1.0,115,1,2,1,4,0xb2d38413
605730.15,3.0,18,4,4,2,10,0xb2d63416
256641.45,4.0,0,3,4,4,11,0xb2d411d2
5551.53,1.0,0,2,2,4,8,0xb2d2cd2c
250007.93,2.0,144,3,3,1,7,0xb2d90909
1151.86,1.0,230,1,2,1,4,0xb2d2907f
1220045.97,9.0,6,4,4,3,11,0xb2d32e64
853029.22,4.0,74,4,4,1,9,0xb2d89008d
1358.97,2.0,0,1,3,4,8,0xb2d782cc
2993.48,1.0,184,2,2,1,5,0xb2d143b4
100234.62,2.0,20,3,3,2,8,0xb2d231df
4380.58,1.0,5,2,2,3,7,0xb2d23613
11.43,1.0,75,1,2,1,4,0xb2d38862
4775.58,1.0,184,2,2,1,5,0xb2d0e61e
2427.37,1.0,184,1,2,1,4,0xb2d2d61fd
77.96,1.0,15,1,2,3,6,0xb2d5a008d
2892.58,1.0,0,2,2,4,8,0xb2d32e3b
731.72,1.0,10,1,2,3,6,0xb2d61215
91574.82,1.0,12,3,2,3,8,0xb2d159c0d
2962.0,2.0,102,2,3,1,6,0xb2d622f9d
258559.59,4.0,10,3,4,3,10,0xb2d67e90d
64543.85,4.0,0,3,4,4,11,0xb2d08e52
615883.01,5.0,0,4,4,4,12,0xb2d5df48d
5620.53,1.0,265,2,2,1,5,0xb2d5f05f
539.99,1.0,13,1,2,3,6,0xb2d70121
90004.59,2.0,32,3,3,2,8,0xb2d589c1d
1456.55,1.0,2,1,2,4,7,0xb2d6520c
60000.63,2.0,41,3,3,2,8,0xb2d92280
34.88,1.0,66,1,2,2,5,0xb2d68640d
50000.0,2.0,8,2,3,3,8,0xb2da4e64
251955.56,4.0,4,3,4,4,11,0xb2d989ba
3193870.56,18.0,24,4,4,2,10,0xb2d0678e
932060.3,4.0,75,4,4,1,9,0xb2d0a6c2
600000.0,7.0,1,4,4,4,12,0xb2d5fbc5d
34323.58,1.0,0,2,2,4,8,0xb2d3118fd
17803.74,1.0,0,2,2,4,8,0xb2d85bd1d
662254.95,5.0,10,4,4,3,11,0xb2d86e31d
50000.0,2.0,64,2,3,2,7,0xb2d9b5f8
5.34,1.0,36,1,2,2,5,0xb2d31965
880711.8,5.0,6,4,4,3,11,0xb2d5e084d
110083.15,4.0,13,3,4,3,10,0xb2d80280
303791.74,2.0,0,4,3,4,11,0xb2d3b3c0
131003.02,6.0,10,3,4,3,10,0xb2d10e21
360086.58,3.0,10,4,4,3,11,0xb2d959a6
70824.05,2.0,39,3,3,2,8,0xb2d0b4cf
623828.64,11.0,1,4,4,4,12,0xb2d1ec20
108786.16,1.0,5,3,2,3,8,0xb2d6c2ab
401260.43,2.0,18,4,3,2,9,0xb2d7a953
50.9,1.0,51,1,2,2,5,0xb2d67ee8
247.23,1.0,47,1,2,2,5,0xb2d26f6e
54664.66,2.0,67,3,3,1,7,0xb2d3c37a
1235.92,1.0,92,1,2,1,4,0xb2d2a6f1
989.77,1.0,12,1,2,3,6,0xb2d20741
2220.62,1.0,3,1,2,4,7,0xb2d86afbd
300966.97,2.0,4,4,3,4,11,0xb2d57f26
359957.68,2.0,129,4,3,1,8,0xb2d6d6d4
50035.42,2.0,29,2,3,2,7,0xb2d683bfd
2270.26,1.0,2,1,2,4,7,0xb2d333aad
406018.36,9.0,25,4,4,2,10,0xb2d63585
3052.75,1.0,0,2,2,4,8,0xb2d6cf38
1513.92,1.0,4,1,2,4,7,0xb2d38e3cd
13347.17,1.0,184,2,2,1,5,0x3b9adb55d
504552.71,10.0,0,4,4,4,12,0xb2d4b157
665037.77,9.0,0,4,4,4,12,0xb2d5ae3c
83263.61,2.0,104,3,3,1,7,0xb2d21925d
1049.79,1.0,184,1,2,1,4,0x3b9b2ad8d
1010153.48,3.0,104,4,4,1,9,0xb2d56931d
5859.81,1.0,142,2,2,1,5,0xb2d0fdcd
130341.4,4.0,10,3,4,3,10,0xb2d7801e
650903.22,6.0,69,4,4,1,9,0xb2d415e4d
100004.22,2.0,47,3,3,2,8,0xb2d0ccabd
172094.33,1.0,130,3,2,1,6,0xb2d68653
100004.94,3.0,6,3,4,3,10,0xb2d07fa6d
200075.03,2.0,9,3,3,3,9,0xb2d9f646
514505.58,3.0,31,4,4,2,10,0xb2d648fa
329105.5,2.0,245,4,3,1,8,0xb2d6debdd
0.0,2.0,11,1,3,3,7,0xb2d0b6a9d
60000.63,2.0,70,3,3,1,7,0xb2d9a7c6
471609.62,6.0,6,4,4,3,11,0xb2d3bbd1
1146.1,1.0,184,1,2,1,4,0xb2d26848d
33.59,2.0,0,1,3,4,8,0xb2d212fb
1237047.47,9.0,7,4,4,3,11,0x3b9b35f0
150007.45,2.0,102,3,3,1,7,0xb2d5ae21
300000.0,5.0,6,3,4,3,10,0xb2d2ad2bd
6162.8,1.0,3,2,2,4,8,0xb2d5a91fd
31322.73,1.0,18,2,2,2,6,0xb2d24151d
2.36,1.0,55,1,2,2,5,0xb2d3767b
220002.43,4.0,0,3,4,4,11,0xb2d9f900
25610.67,7.0,181,2,4,1,7,0xb2d3fb2a
1043100.44,12.0,18,4,4,2,10,0xb2d5464c
130007.12,3.0,13,3,4,3,10,0xb2d8c4e2
296194.37,2.0,185,3,3,1,7,0xb2d78c4e
120084.92,3.0,34,3,4,2,9,0xb2d60afd
20576.43,1.0,0,2,2,4,8,0xb2d6bb56
258.2,1.0,18,1,2,2,5,0xb2d21ebf
2874.79,1.0,0,1,2,4,7,0xb2d6076e
5107.45,1.0,92,2,2,1,5,0xb2d13901
15718.1,1.0,0,2,2,4,8,0xb2d8d633d
21542.37,1.0,3,2,2,4,8,0xb2d5d191d
500055.72,2.0,32,4,3,2,9,0xb2d990ed
15425.01,2.0,80,2,3,1,6,0xb2d5f0f7d
215357.41,3.0,0,3,4,4,11,0xb2d55cff
10008.11,2.0,1,2,3,4,9,0xb2d9688cd
669361.56,8.0,0,4,4,4,12,0xb2d12e7ed
226000.0,5.0,14,3,4,3,10,0xb2d402c2d
20002.84,2.0,208,2,3,1,6,0xb2d49da7
6481.93,1.0,10,2,2,3,7,0xb2d4f707
381888.27,2.0,0,4,3,4,11,0xb2d687de
350032.75,2.0,3,4,3,4,11,0xb2d13d05
300017.12,3.0,10,3,4,3,10,0xb2d5e5bfd
5760.09,1.0,7,2,2,3,7,0xb2d4183e
204286.4,2.0,129,3,3,1,7,0xb2d6ccec
152007.56,4.0,1,3,4,4,11,0xb2d1793c
2190.39,1.0,0,1,2,4,7,0xb2d2f819
12038.24,1.0,4,2,2,4,8,0xb2d83ac0
152173.35,2.0,165,3,3,1,7,0xb2d61f94
3.03,1.0,19,1,2,2,5,0xb2d4376f
3.37,2.0,11,1,3,3,7,0xb2d1ea7b
200006.81,2.0,53,3,3,2,8,0xb2d12d99
50.46,1.0,12,1,2,3,6,0xb2d92040
4651.92,1.0,0,2,2,4,8,0xb2d6bb5fd
179812.69,2.0,24,3,3,2,8,0xb2d17e84d
535976.61,6.0,0,4,4,4,12,0xb2d12803d
538.54,1.0,11,1,2,3,6,0xb2d57bb6
1000000.0,4.0,0,4,4,4,12,0xb2d5f5d3d
82396.66,1.0,105,3,2,1,6,0xb2d2c3f4
300010.56,3.0,41,3,4,2,9,0xb2d9e71a
303.59,1.0,11,1,2,3,6,0xb2d4ac2ed
2938862.01,3.0,68,4,4,1,9,0xb2d5f61ad
10000.21,2.0,18,2,3,2,7,0xb2da24e4
71030.04,2.0,129,3,3,1,7,0xb2d55839d
16920.06,1.0,0,2,2,4,8,0xb2d1d9f4d
23739.54,2.0,0,2,3,4,9,0xb2d3188e
3000000.0,1.0,0,4,2,4,10,0xb2d981c5d
81583.32,4.0,11,3,4,3,10,0xb2d2b302d
775020.29,4.0,1,4,4,4,12,0xb2d8f75dd
511126.77,4.0,31,4,4,2,10,0xb2d2409ed
580.0,1.0,9,1,2,3,6,0xb2d38de3d
230018.84,3.0,3,3,4,4,11,0xb2d5e695d
1653.96,1.0,105,1,2,1,4,0xb2d9088f
2026.16,1.0,184,1,2,1,4,0xb2d15117d
514.1,1.0,9,1,2,3,6,0xb2d64d1f
1165035.38,3.0,62,4,4,2,10,0xb2d6ff97d
201.58,1.0,0,1,2,4,7,0xb2d96386
281.17,1.0,21,1,2,2,5,0xb2d4bfabd
150082.29,3.0,154,3,4,1,8,0xb2d3722a
15035.81,1.0,6,2,2,3,7,0xb2d60967d
38342.39,1.0,7,2,2,3,7,0xb2d6b6b2
350000.0,3.0,3,4,4,4,12,0xb2d95a6c
18670.38,1.0,20,2,2,2,6,0xb2d6b0fcd
2260000.0,8.0,2,4,4,4,12,0xb2d59661
892492.64,4.0,3,4,4,4,12,0xb2d9b99a
9001.81,1.0,28,2,2,2,6,0xb2d51e2cd
92.33,1.0,24,1,2,2,5,0xb2d32df6
3941.81,1.0,1,2,2,4,8,0xb2d2b8df
2.18,1.0,66,1,2,2,5,0xb2d32778
62.88,2.0,62,1,3,2,6,0xb2d55728
3913.76,2.0,184,2,3,1,6,0xb2d21b4dd
1077.85,1.0,92,1,2,1,4,0x3b9b3a0c
75.47,1.0,177,1,2,1,4,0xb2d6257b
11950.68,2.0,12,2,3,3,8,0xb2d9b71c
110661.16,4.0,0,3,4,4,11,0xb2d92d58
110007.08,3.0,11,3,4,3,10,0xb2d95bc8
2129.34,5.0,0,1,4,4,9,0xb2d1c5e4d
0.45,1.0,7,1,2,3,6,0xb2d679f2d
4510.69,1.0,5,2,2,3,7,0xb2d252a1
1151.44,1.0,92,1,2,1,4,0xb2d3ba20d
1233.8,1.0,9,1,2,3,6,0xb2d3310dd
124899.5,1.0,0,3,2,4,9,0xb2d43440d
116024.56,4.0,69,3,4,1,8,0xb2d4e1edd
1256.26,1.0,7,1,2,3,6,0xb2d39908
66816.79,3.0,111,3,4,1,8,0xb2d5ea84
25000.9,3.0,195,2,4,1,7,0xb2d3ae61
300843.35,2.0,8,4,3,3,10,0xb2d58b61d
10285.79,1.0,33,2,2,2,6,0xb2d52ad5d
1300417.48,4.0,43,4,4,2,10,0xb2d2b654d
200.59,1.0,5,1,2,3,6,0xb2d23445
83.98,1.0,34,1,2,2,5,0xb2d44402
51079.84,2.0,10,2,3,3,8,0xb2d617d5d
1350.05,1.0,92,1,2,1,4,0xb2d1102d
26185.79,1.0,21,2,2,2,6,0xb2d77f5dd
22978.7,1.0,2,2,2,4,8,0xb2d38cb4d
4018.8,1.0,4,2,2,4,8,0xb2d2ac60
331708.14,3.0,3,4,4,4,12,0xb2d1397ed
1319409.95,5.0,72,4,4,1,9,0xb2d61fbb
71584.11,1.0,0,3,2,4,9,0xb2d8ceef
38.2,1.0,33,1,2,2,5,0xb2d6a7d0d
500000.0,2.0,184,4,3,1,8,0xb2d17a06
4410.62,1.0,13,2,2,3,7,0xb2d55bedd
19728.34,1.0,72,2,2,1,5,0xb2d6f1c1
285013.98,7.0,10,3,4,3,10,0xb2d603c0d
1100000.0,2.0,4,4,3,4,11,0xb2da54f7
2.24,1.0,3,1,2,4,7,0xb2d91617
10.56,1.0,19,1,2,2,5,0xb2d90b42
171707.16,2.0,8,3,3,3,9,0xb2d3b4c3
300873.46,4.0,20,4,4,2,10,0x3b9b2b7a
96898.87,1.0,294,3,2,1,6,0xb2d2ed66
72844.85,2.0,3,3,3,4,10,0xb2d43cc6
2.14,1.0,81,1,2,1,4,0xb2d5bd30
2.23,1.0,15,1,2,3,6,0xb2d53188
5293.8,1.0,119,2,2,1,5,0xb2d2ff14
9.92,1.0,20,1,2,2,5,0xb2d9e0ca
248810.02,1.0,7,3,2,3,8,0xb2d280bc
10052.78,1.0,184,2,2,1,5,0xb2d53ca0
8331.78,1.0,92,2,2,1,5,0xb2d2aae1
86.83,1.0,3,1,2,4,7,0xb2d25cd8
85.95,2.0,80,1,3,1,5,0xb2d0f915
190310.87,4.0,19,3,4,2,9,0x3b9b0fcf
120034.67,3.0,10,3,4,3,10,0xb2d11b58
500000.0,2.0,0,4,3,4,11,0xb2d8fa4e
7.15,4.0,19,1,4,2,7,0x3b9b3d13d
1262.67,1.0,184,1,2,1,4,0xb2d2960ad
1348505.65,9.0,14,4,4,3,11,0xb2d1410ad
6131.67,1.0,92,2,2,1,5,0xb2d311b7
2453.28,1.0,92,1,2,1,4,0xb2d3e1abd
68.38,1.0,1,1,2,4,7,0xb2d790fad
16620.16,1.0,7,2,2,3,7,0xb2d343c8
1361231.3,3.0,0,4,4,4,12,0xb2d23f71d
2366.6,1.0,0,1,2,4,7,0xb2d6bb0b
1.63,1.0,13,1,2,3,6,0xb2d288d9d
165478.4,4.0,25,3,4,2,9,0xb2d2b470
60787.86,2.0,0,3,3,4,10,0xb2d1263d
35839.46,1.0,25,2,2,2,6,0xb2d607bf
7130005.6,4.0,6,4,4,3,11,0xb2d151a0
400008.26,5.0,12,4,4,3,11,0xb2d6cf95
270009.08,2.0,16,3,3,2,8,0xb2d8f7c0
77910.03,1.0,8,3,2,3,8,0x3b9b471b
25.42,1.0,20,1,2,2,5,0xb2d1ffaf
869031.82,19.0,0,4,4,4,12,0xb2d1b744d
0.0,1.0,0,1,2,4,7,0xb2d8dbb8
6393.44,1.0,9,2,2,3,7,0xb2d82306
2981.45,1.0,8,2,2,3,7,0xb2d3f726
532.94,1.0,5,1,2,3,6,0xb2d21fc5d
4236.6,1.0,92,2,2,1,5,0xb2d21564
2012.62,1.0,23,1,2,2,5,0xb2d6c41a
2775.96,1.0,184,1,2,1,4,0xb2d1be54
1797.16,1.0,6,1,2,3,6,0xb2d3721dd
500073.55,2.0,4,4,3,4,11,0xb2d63f89
3313.95,1.0,119,2,2,1,5,0xb2d6943c
46048.04,2.0,92,2,3,1,6,0xb2d23935d
44172.87,2.0,20,2,3,2,7,0xb2d29730
4189.51,1.0,14,2,2,3,7,0xb2d8c8c1
1031.16,1.0,0,1,2,4,7,0xb2d6af14
23833.99,1.0,10,2,2,3,7,0xb2d94c2f
16.93,1.0,14,1,2,3,6,0xb2d1a3c0d
40000.84,2.0,95,2,3,1,6,0xb2d9765b
182.4,1.0,7,1,2,3,6,0xb2d51c9a
9008.05,1.0,5,2,2,3,7,0xb2d29da7
500000.0,2.0,28,4,3,2,9,0xb2da0e95
78262.28,1.0,3,3,2,4,9,0xb2d5f970
1580673.44,68.0,0,4,4,4,12,0x3b9b0e70
88.51,2.0,1,1,3,4,8,0xb2d30e48
50.31,1.0,0,1,2,4,7,0xb2d65c28
155241.58,5.0,3,3,4,4,11,0xb2d31786
53031.63,2.0,26,3,3,2,8,0xb2d4a716
108249.0,3.0,5,3,4,3,10,0xb2d576f8
12029.89,2.0,9,2,3,3,8,0xb2d9a62c
201828.47,2.0,24,3,3,2,8,0xb2d5c8ce
10488.39,1.0,1,2,2,4,8,0xb2d9b531
3492.62,1.0,278,2,2,1,5,0xb2d53b33
33414.06,3.0,92,2,4,1,7,0xb2d21f77d
12228.45,3.0,92,2,4,1,7,0x3b9af4f0
71.91,1.0,64,1,2,2,5,0xb2d4bcd4
120533.14,2.0,256,3,3,1,7,0xb2d0cb67d
310033.59,4.0,27,4,4,2,10,0xb2d9c46a
0.84,1.0,4,1,2,4,7,0xb2d90b3fd
3415.97,2.0,0,2,3,4,9,0xb2d28ab6
250012.02,3.0,14,3,4,3,10,0xb2d98a0c
70002.74,3.0,5,3,4,3,10,0xb2da0654
650030.18,11.0,46,4,4,2,10,0xb2d0b390d
2411.29,1.0,92,1,2,1,4,0xb2d3223c
200.79,1.0,12,1,2,3,6,0xb2d6d368
1150026.76,1.0,0,4,2,4,10,0xb2d6028a
200010.56,2.0,13,3,3,3,9,0xb2d95a0ad
58.72,1.0,202,1,2,1,4,0xb2d3654dd
790056.66,7.0,4,4,4,4,12,0xb2d921b6
26869.07,1.0,9,2,2,3,7,0xb2d27648
474523.72,2.0,0,4,3,4,11,0xb2d32932
65.07,1.0,117,1,2,1,4,0xb2d250df
101394.55,3.0,92,3,4,1,8,0xb2d52283d
150001.58,2.0,13,3,3,3,9,0xb2d95d7bd
722044.64,6.0,74,4,4,1,9,0xb2d62eb2d
500081.83,2.0,9,4,3,3,10,0xb2d8e7dfd
100014.33,7.0,11,3,4,3,10,0xb2d61e94d
29094.51,1.0,0,2,2,4,8,0xb2d8638a
200000.48,2.0,6,3,3,3,9,0xb2d9dd56
1059.07,2.0,92,1,3,1,5,0xb2d0a98b
980032.89,4.0,13,4,4,3,11,0xb2d6eef2
125313.17,7.0,0,3,4,4,11,0xb2d09f73
1427.52,1.0,12,1,2,3,6,0xb2d1cf91
72529.72,3.0,30,3,4,2,9,0xb2d06905
10000.42,2.0,21,2,3,2,7,0xb2d9bf42
1062544.77,7.0,6,4,4,3,11,0xb2d16d52
50005.75,2.0,76,2,3,1,6,0xb2d153a7d
329098.05,5.0,53,4,4,2,10,0xb2d5749b
95.32,1.0,37,1,2,2,5,0xb2d61964
117.67,1.0,0,1,2,4,7,0xb2d33d06
701306.52,4.0,67,4,4,1,9,0xb2d36616
9.68,1.0,2,1,2,4,7,0xb2d69d6c
252674.04,2.0,1,3,3,4,10,0xb2d9ba06
240852.53,3.0,29,3,4,2,9,0xb2d8cce2d
2156.16,1.0,10,1,2,3,6,0xb2d2b136d
3855.25,1.0,88,2,2,1,5,0xb2d60dae
516.76,1.0,18,1,2,2,5,0xb2d0b840
5.58,2.0,20,1,3,2,6,0xb2d09009
1144035.72,1.0,0,4,2,4,10,0xb2d6befb
484020.03,6.0,25,4,4,2,10,0xb2d6b83b
2716.59,1.0,10,1,2,3,6,0xb2d3ba58
3575.22,1.0,1,2,2,4,8,0xb2d6bb5e
18108.07,1.0,92,2,2,1,5,0xb2d3c1f9d
202371.82,3.0,6,3,4,3,10,0xb2d48673
25233.49,2.0,257,2,3,1,6,0xb2d58e01
231222.8,2.0,24,3,3,2,8,0xb2d743b2
245646.05,1.0,184,3,2,1,6,0x3b9b49a5d
3121.0,1.0,0,2,2,4,8,0xb2d52bf0
565.49,1.0,12,1,2,3,6,0xb2d3026d
303255.87,7.0,25,4,4,2,10,0xb2d3c096
25002.87,2.0,3,2,3,4,9,0xb2d28e0bd
1239.61,1.0,16,1,2,2,5,0xb2d91e6c
70097.87,3.0,11,3,4,3,10,0x3b9b29be
32001.16,4.0,11,2,4,3,9,0xb2d09f9a
56.76,1.0,6,1,2,3,6,0xb2d400e2
9963.89,1.0,0,2,2,4,8,0xb2d80e69
336.04,1.0,0,1,2,4,7,0xb2d6bcee
200200.0,2.0,1,3,3,4,10,0xb2da5b94
322617.79,2.0,129,4,3,1,8,0xb2d4337b
610013.44,3.0,77,4,4,1,9,0xb2d4fa9e
597427.31,4.0,6,4,4,3,11,0xb2d37f29
208356.73,2.0,132,3,3,1,7,0xb2d2286dd
124471.26,3.0,53,3,4,2,9,0xb2d299f1
90.68,8.0,20,1,4,2,7,0xb2d14438d
27763.42,1.0,5,2,2,3,7,0xb2d1d69dd
7357.85,1.0,18,2,2,2,6,0xb2d54d26d
12778.33,1.0,18,2,2,2,6,0xb2d6af73
7032.97,1.0,65,2,2,2,6,0xb2d49371
1523.0,1.0,21,1,2,2,5,0xb2d2bce9
104004.3,2.0,21,3,3,2,8,0xb2d9a578
4913.46,1.0,32,2,2,2,6,0xb2d9f608
1.4,1.0,0,1,2,4,7,0xb2d8f52ed
82.0,1.0,13,1,2,3,6,0xb2d344c8
3734.9,1.0,0,2,2,4,8,0xb2d1b5d6
201353.35,2.0,5,3,3,3,9,0xb2d8f555d
30003.07,2.0,97,2,3,1,6,0xb2d61561d
96.01,1.0,15,1,2,3,6,0xb2d0df75
200631.45,3.0,8,3,4,3,10,0xb2d970bed
81.4,1.0,6,1,2,3,6,0xb2d6110ed
1160195.14,3.0,74,4,4,1,9,0xb2d5f6b4
230389.27,4.0,27,3,4,2,9,0xb2d2239f
5.47,1.0,8,1,2,3,6,0xb2d8d941
400008.45,4.0,45,4,4,2,10,0xb2d8d2afd
94606.93,2.0,188,3,3,1,7,0xb2d37884
51642.61,1.0,0,2,2,4,8,0xb2d40589
30000.42,3.0,53,2,4,2,8,0xb2d1fbc2
922104.68,8.0,10,4,4,3,11,0xb2d581d4d
73062.24,6.0,55,3,4,2,9,0xb2d5ec59
504468.93,2.0,8,4,3,3,10,0xb2d92b29
500000.0,6.0,9,4,4,3,11,0xb2d35be5
7.55,2.0,14,1,3,3,7,0x3b9b2908d
2.22,1.0,6,1,2,3,6,0xb2d95f07
280090.74,3.0,1,3,4,4,11,0xb2d101a2d
93500.0,2.0,6,3,3,3,9,0xb2da50b5
14876.98,1.0,50,2,2,2,6,0xb2d16d2c
1223.28,2.0,92,1,3,1,5,0x3b9b28b6d
195006.98,7.0,74,3,4,1,8,0xb2d8c4a1d
80020.27,2.0,76,3,3,1,7,0xb2d769ff
376423.97,2.0,251,4,3,1,8,0xb2d5ef94
500000.04,2.0,24,4,3,2,9,0xb2d90704
40096.9,3.0,3,2,4,4,10,0xb2d5ed8e
2.44,1.0,74,1,2,1,4,0xb2d1a33b
39236.27,1.0,3,2,2,4,8,0xb2d3f30cd
520141.74,3.0,2,4,4,4,12,0xb2d277fad
238181.73,2.0,92,3,3,1,7,0xb2d5efb7
576422.85,3.0,74,4,4,1,9,0xb2d1714f
506.76,1.0,0,1,2,4,7,0xb2d59731
50000.53,2.0,18,2,3,2,7,0xb2da3085
136283.75,3.0,3,3,4,4,11,0xb2d928b7d
102225.59,3.0,90,3,4,1,8,0xb2d38c56d
2508.84,1.0,307,1,2,1,4,0xb2d56092d
163801.11,3.0,80,3,4,1,8,0xb2d2ba1cd
1.96,1.0,13,1,2,3,6,0xb2da0719
137.07,1.0,36,1,2,2,5,0xb2d8ce60
3123.21,1.0,19,2,2,2,6,0xb2d2a706
1.03,1.0,15,1,2,3,6,0xb2d2d259
459195.26,12.0,0,4,4,4,12,0xb2d10a11
952000.22,5.0,5,4,4,3,11,0xb2d6eb77
63.43,1.0,9,1,2,3,6,0xb2d59101
2020075.79,5.0,21,4,4,2,10,0xb2d23ab3
1627035.42,9.0,11,4,4,3,11,0xb2d19453
705107.84,5.0,34,4,4,2,10,0xb2d1a96a
368085.91,4.0,1,4,4,4,12,0xb2d6cbabd
149118.2,7.0,0,3,4,4,11,0xb2d08df5
170007.04,2.0,6,3,3,3,9,0xb2d36c84
700060.09,6.0,0,4,4,4,12,0xb2d5e9db
60000.0,2.0,3,3,3,4,10,0xb2d97321d
4709.76,1.0,10,2,2,3,7,0xb2d4ed9ed
40279.15,2.0,249,2,3,1,6,0xb2d66984d
83.3,1.0,0,1,2,4,7,0xb2d96722
260948.65,2.0,80,3,3,1,7,0xb2d6eec3
20001.19,2.0,4,2,3,4,9,0xb2d5ea4ed
12111.14,1.0,184,2,2,1,5,0xb2d1c1e6d
2259.0,2.0,92,1,3,1,5,0xb2d0ec50d
10003.89,2.0,18,2,3,2,7,0xb2d42e06
2.53,1.0,0,1,2,4,7,0xb2da3a74
6056803.41,2.0,10,4,3,3,10,0xb2d2a9c6d
193047.93,4.0,33,3,4,2,9,0xb2d438fad
0.08,1.0,6,1,2,3,6,0xb2d2d486
4981.53,1.0,10,2,2,3,7,0xb2d27c41
173060.3,6.0,27,3,4,2,9,0xb2d5d571
89.46,1.0,14,1,2,3,6,0xb2d92608
1276.54,1.0,184,1,2,1,4,0xb2d2511a
1805.19,1.0,113,1,2,1,4,0xb2d3a4dc
1620.23,1.0,3,1,2,4,7,0xb2d26652d
302709.26,2.0,29,4,3,2,9,0xb2d64466
123270.3,2.0,210,3,3,1,7,0xb2d3d217
126.73,1.0,87,1,2,1,4,0xb2d22a18
76025.89,2.0,133,3,3,1,7,0xb2d5c307
2294.48,1.0,9,1,2,3,6,0xb2d5893b
1739689.38,6.0,3,4,4,4,12,0xb2d352d1d
309372.41,2.0,21,4,3,2,9,0xb2d60e7c
601001.73,3.0,6,4,4,3,11,0xb2d26f14
19864.44,1.0,10,2,2,3,7,0xb2d8e518
100000.53,2.0,7,3,3,3,9,0xb2da4bed
630.84,1.0,0,1,2,4,7,0xb2d98973
10000.42,2.0,21,2,3,2,7,0xb2da1b37
106.98,1.0,58,1,2,2,5,0xb2d1f3f7
1299561.78,6.0,0,4,4,4,12,0xb2d67d21d
253761.18,4.0,33,3,4,2,9,0xb2d5e1a7d
120000.0,2.0,6,3,3,3,9,0xb2d96434
470014.89,2.0,143,4,3,1,8,0xb2d6e386
306415.27,2.0,5,4,3,3,10,0xb2d3784dd
43647.22,1.0,10,2,2,3,7,0xb2d1fcff
2063310.84,3.0,26,4,4,2,10,0xb2d6bf91
1737440.13,8.0,1,4,4,4,12,0xb2d2e2ea
30382.95,2.0,55,2,3,2,7,0xb2d81ec0
50275.97,1.0,1,2,2,4,8,0xb2d5f557
256000.45,6.0,0,3,4,4,11,0xb2d3a689
21632.47,1.0,0,2,2,4,8,0xb2d69f0e
18821.59,1.0,18,2,2,2,6,0xb2d292c8
0.0,1.0,0,1,2,4,7,0xb2d915a0
5.81,1.0,21,1,2,2,5,0xb2d58158
3451.37,1.0,0,2,2,4,8,0xb2d68ef2
130054.49,3.0,4,3,4,4,11,0xb2d52c6c
500006.97,2.0,22,4,3,2,9,0xb2d5f8c9
241825.07,2.0,58,3,3,2,8,0xb2d6b8d2
8.4,1.0,5,1,2,3,6,0xb2d2c46d
200039.71,3.0,92,3,4,1,8,0xb2d1610e
19.53,1.0,56,1,2,2,5,0xb2d9c0d8
210727.5,8.0,74,3,4,1,8,0xb2d0f1b4
567964.08,2.0,118,4,3,1,8,0xb2d652ef
104.57,1.0,19,1,2,2,5,0xb2d31416
3033.27,1.0,180,2,2,1,5,0xb2d41a4a
2050959.06,8.0,3,4,4,4,12,0xb2d6271d
404365.93,8.0,0,4,4,4,12,0xb2d06730
1562.16,1.0,19,1,2,2,5,0xb2d48626
376032.48,5.0,19,4,4,2,10,0xb2d5792a
50352.69,1.0,8,2,2,3,7,0xb2d1d740
50452.67,2.0,3,2,3,4,9,0xb2d5a55c
20000.0,2.0,7,2,3,3,8,0xb2da25a7
141.96,1.0,16,1,2,2,5,0xb2d1653b
20.13,1.0,1,1,2,4,7,0xb2d912b2
390258.54,4.0,4,4,4,4,12,0xb2da1cea
1005.61,1.0,91,1,2,1,4,0xb2d6d10e
1516.09,1.0,3,1,2,4,7,0xb2d2f880
420037.55,3.0,2,4,4,4,12,0xb2d3a83cd
500027.1,2.0,7,4,3,3,10,0xb2d91877d
2670005.95,4.0,6,4,4,3,11,0xb2d5a9bd
114614.55,2.0,167,3,3,1,7,0xb2d17144
2179.1,1.0,14,1,2,3,6,0xb2d6a26a
1520237.0,4.0,4,4,4,4,12,0xb2d260f9
53745.13,2.0,5,3,3,3,9,0xb2d0e420d
500028.19,2.0,1,4,3,4,11,0xb2d6deaed
100000.76,1.0,1,3,2,4,9,0xb2d11ba9d
1050117.37,4.0,6,4,4,3,11,0xb2d4cb16d
4200000.0,4.0,10,4,4,3,11,0xb2d36744
93951.41,3.0,0,3,4,4,11,0xb2d27e30
503577.39,3.0,95,4,4,1,9,0xb2d4b614
1000015.83,3.0,22,4,4,2,10,0xb2d86d13
2096.35,1.0,0,1,2,4,7,0xb2d37f40
46008.84,2.0,143,2,3,1,6,0xb2d5fe17
200000.0,2.0,1,3,3,4,10,0xb2da6660
11.84,1.0,1,1,2,4,7,0xb2d21fa6
19732.51,4.0,1,2,4,4,10,0xb2d943d6d
8413133.58,18.0,8,4,4,3,11,0xb2d1e276d
1029.29,1.0,184,1,2,1,4,0xb2d25dc9
1.91,1.0,86,1,2,1,4,0xb2d2a479
5931.91,1.0,0,2,2,4,8,0xb2d8da11
20080.76,1.0,184,2,2,1,5,0xb2d39c7ad
1003.06,1.0,104,1,2,1,4,0xb2d62733
2190.42,1.0,84,1,2,1,4,0xb2d3f9d1
72033.21,1.0,14,3,2,3,8,0xb2d31935d
1800007.56,8.0,10,4,4,3,11,0xb2d9a572
1338.09,1.0,16,1,2,2,5,0xb2d0dc2e
710100.2,5.0,39,4,4,2,10,0xb2d179d1
810104.86,6.0,5,4,4,3,11,0xb2d6943fd
1950029.11,7.0,42,4,4,2,10,0xb2d9a9de
423042.11,5.0,1,4,4,4,12,0xb2d0aa29
50097.4,1.0,141,2,2,1,5,0xb2d60488d
30011.9,2.0,48,2,3,2,7,0xb2d6108f
1102133.0,6.0,10,4,4,3,11,0xb2d5b9d5d
131843.44,2.0,256,3,3,1,7,0xb2d294d6d
260023.54,2.0,16,3,3,2,8,0xb2d9e41b
200440.69,3.0,38,3,4,2,9,0xb2d45a2b
505065.46,2.0,206,4,3,1,8,0xb2d241a8
6150419.05,5.0,39,4,4,2,10,0xb2d1a537d
1177.35,1.0,26,1,2,2,5,0xb2d139c4d
210000.0,6.0,0,3,4,4,11,0xb2d64f32d
39242.35,4.0,0,2,4,4,10,0xb2d212a1
1763.18,1.0,10,1,2,3,6,0xb2d4199c
22084.87,1.0,41,2,2,2,6,0xb2d68617
1264.91,1.0,1,1,2,4,7,0xb2d33d98
99.47,1.0,95,1,2,1,4,0xb2d2f0a1
385.83,1.0,14,1,2,3,6,0xb2d2b83f
2.43,1.0,50,1,2,2,5,0xb2d5e355
120004.65,3.0,66,3,4,2,9,0xb2d67ce3
51236.23,1.0,3,2,2,4,8,0xb2d66875
534194.8,5.0,0,4,4,4,12,0xb2d102a6
1634.28,1.0,92,1,2,1,4,0xb2d17d85
10000.0,1.0,7,2,2,3,7,0xb2d65a1d
353779.01,2.0,104,4,3,1,8,0xb2d2a602d
100014.34,2.0,4,3,3,4,10,0xb2d539c5
5.34,1.0,12,1,2,3,6,0xb2d97e8a
109.25,1.0,48,1,2,2,5,0xb2d8f7e2
10.5,1.0,1,1,2,4,7,0xb2d9db06
20143.56,1.0,5,2,2,3,7,0xb2d2b79b
1012.63,1.0,2,1,2,4,7,0xb2d9bfdb
1954.2,1.0,92,1,2,1,4,0xb2d2a193
450224.31,4.0,18,4,4,2,10,0xb2d8252cd
413410.09,3.0,4,4,4,4,12,0xb2d50ab9d
181668.07,3.0,14,3,4,3,10,0xb2d2dcbf
2109164.64,1.0,7,4,2,3,9,0xb2d2fed8d
868.81,1.0,0,1,2,4,7,0xb2d38d87d
3236.78,1.0,69,2,2,1,5,0xb2d327c6d
13185.56,1.0,0,2,2,4,8,0xb2d9bf99
7765.17,1.0,11,2,2,3,7,0xb2d2f44d
564.64,1.0,24,1,2,2,5,0xb2d3e492
10063.75,2.0,15,2,3,3,8,0xb2d8c47d
5708.32,3.0,0,2,4,4,10,0xb2d0be41
254.56,1.0,5,1,2,3,6,0xb2d12b0d
223026.55,5.0,101,3,4,1,8,0xb2d5695c
3209.23,2.0,92,2,3,1,6,0x3b9af29cd
500037.96,2.0,94,4,3,1,8,0xb2d77fae
1200071.45,3.0,1,4,4,4,12,0xb2d922fd
21352.52,1.0,15,2,2,3,7,0xb2d8caff
7400.25,1.0,0,2,2,4,8,0xb2d44d19d
10701.76,1.0,10,2,2,3,7,0xb2d536ded
250000.0,2.0,1,3,3,4,10,0xb2da692b
1252570.12,5.0,1,4,4,4,12,0xb2d37f29d
1867.84,2.0,206,1,3,1,5,0xb2d65052
95014.48,3.0,20,3,4,2,9,0xb2d9a922
450129.96,3.0,18,4,4,2,10,0xb2d6d032
0.01,2.0,12,1,3,3,7,0x3b9b4777
3201362.02,7.0,0,4,4,4,12,0xb2d6991d
280000.0,2.0,1,3,3,4,10,0xb2da67c7
222.18,1.0,47,1,2,2,5,0xb2d8d2d1
200020.9,2.0,5,3,3,3,9,0xb2d6aa28
5.54,1.0,9,1,2,3,6,0xb2d3e684
462818.5,9.0,4,4,4,4,12,0xb2d6442cd
79.73,1.0,0,1,2,4,7,0xb2d5d144
10190.08,1.0,19,2,2,2,6,0xb2d2072bd
4953.43,1.0,0,2,2,4,8,0xb2d3e795d
7150.09,1.0,4,2,2,4,8,0xb2d5739a
607738.46,3.0,147,4,4,1,9,0xb2d295b8
1115630.43,3.0,11,4,4,3,11,0xb2d3f785
1710.6,1.0,184,1,2,1,4,0xb2d34673
2000000.0,2.0,0,4,3,4,11,0xb2da201d
2517.57,1.0,1,1,2,4,7,0xb2d6c3d1
22769.9,1.0,4,2,2,4,8,0xb2d204e9
500008.52,3.0,76,4,4,1,9,0xb2d6206a
790097.32,6.0,67,4,4,1,9,0xb2d103c0d
495075.32,12.0,1,4,4,4,12,0xb2d5ba19
216000.0,6.0,0,3,4,4,11,0xb2d17068
1707.1,7.0,0,1,4,4,9,0x3b9af127
77585.61,2.0,97,3,3,1,7,0xb2d56f85
985.6,1.0,82,1,2,1,4,0xb2d622ec
20307.68,2.0,171,2,3,1,6,0xb2d5ee6b
378.33,1.0,82,1,2,1,4,0xb2d113e0
4475.3,5.0,92,2,4,1,7,0xb2d33589
200262.91,2.0,10,3,3,3,9,0xb2d69cfcd
176909.31,5.0,3,3,4,4,11,0x3b9b124d
25.59,1.0,10,1,2,3,6,0xb2d83ca4d
18623.22,1.0,1,2,2,4,8,0xb2d2e555
1700200.43,2.0,25,4,3,2,9,0xb2d4f55d
1991293.2,5.0,0,4,4,4,12,0xb2d2e6fa
2223.61,1.0,28,1,2,2,5,0xb2d9062a
91.49,1.0,9,1,2,3,6,0xb2d4bd30d
50100.84,2.0,196,2,3,1,6,0xb2d24eae
50988.34,2.0,61,2,3,2,7,0xb2d6159e
520234.47,7.0,4,4,4,4,12,0xb2d43566
10000000.0,2.0,92,4,3,1,8,0xb2d5252bd
14207.49,1.0,21,2,2,2,6,0xb2d965d0
255484.48,7.0,63,3,4,2,9,0xb2d428b9d
1271.33,1.0,7,1,2,3,6,0xb2d7cfbf
64.96,1.0,17,1,2,2,5,0xb2d939b5
360006.49,14.0,14,4,4,3,11,0xb2d6a7d3
257755.84,1.0,0,3,2,4,9,0xb2d3cbb9
810402.38,5.0,20,4,4,2,10,0xb2d63844d
1130.02,1.0,92,1,2,1,4,0xb2d14f1bd
71007909.12,4.0,189,4,4,1,9,0xb2d3a240
0.0,1.0,8,1,2,3,6,0xb2d8f3f5
81.94,1.0,175,1,2,1,4,0xb2d412c4d
3.0,1.0,12,1,2,3,6,0xb2d69a0e
821.02,1.0,1,1,2,4,7,0xb2d32995d
82141.84,1.0,3,3,2,4,9,0xb2d23cae
403461.72,4.0,28,4,4,2,10,0xb2d25a21d
574029.32,8.0,0,4,4,4,12,0xb2d39c43d
477924.0,3.0,103,4,4,1,9,0x3b9b41a7
64.53,1.0,39,1,2,2,5,0xb2d68b46d
700.09,1.0,104,1,2,1,4,0xb2d38895
33.46,1.0,20,1,2,2,5,0xb2d10d8cd
104.0,1.0,131,1,2,1,4,0xb2d45998
2440.12,1.0,0,1,2,4,7,0xb2d68d43
1501313.06,2.0,24,4,3,2,9,0xb2d6e2e0
90001.9,2.0,25,3,3,2,8,0xb2da1374
0.0,1.0,62,1,2,2,5,0xb2d5368dd
3748000.0,13.0,3,4,4,4,12,0xb2d17888
70069.29,1.0,94,3,2,1,6,0xb2d41474
120003.8,2.0,56,3,3,2,8,0xb2d9c560
5011.3,1.0,29,2,2,2,6,0xb2d9bdf6
16354.85,2.0,1,2,3,4,9,0xb2d0d823
15383.58,1.0,201,2,2,1,5,0xb2d5fd3e
350022.17,2.0,32,4,3,2,9,0xb2d9e186
101801.97,3.0,154,3,4,1,8,0xb2d6196ed
50000.95,2.0,21,2,3,2,7,0xb2d0b5e7
6639.76,1.0,206,2,2,1,5,0xb2d64f69d
208074.1,1.0,1,3,2,4,9,0xb2d1f940
440005.3,9.0,7,4,4,3,11,0x3b9af193
939.8,1.0,9,1,2,3,6,0xb2d4337cd
218618.6,6.0,62,3,4,2,9,0xb2d2a132
16379.32,1.0,0,2,2,4,8,0xb2d1289d
34471.57,1.0,2,2,2,4,8,0xb2d38801
7135.87,1.0,7,2,2,3,7,0xb2d488ed
11.68,1.0,82,1,2,1,4,0xb2d50f70
31.39,1.0,71,1,2,1,4,0xb2d62758
30001.9,1.0,3,2,2,4,8,0xb2d43821d
234981.08,5.0,9,3,4,3,10,0xb2d4db65d
20057.15,1.0,171,2,2,1,5,0xb2d38ce7
10965.95,1.0,5,2,2,3,7,0xb2d330a0d
44737.29,2.0,56,2,3,2,7,0xb2d1092fd
0.09,1.0,7,1,2,3,6,0xb2d1768b
220108.39,4.0,3,3,4,4,11,0xb2d50fa0d
1.63,1.0,58,1,2,2,5,0xb2d8d9aa
8.97,1.0,0,1,2,4,7,0xb2d9db74
37370.31,1.0,6,2,2,3,7,0xb2d64465d
557925.02,5.0,4,4,4,4,12,0xb2d575dc
5603.54,1.0,10,2,2,3,7,0xb2d9e704
50002.11,2.0,98,2,3,1,6,0xb2d588f3d
720.07,1.0,71,1,2,1,4,0xb2d68409
40038.15,3.0,0,2,4,4,10,0xb2d57c79
7055.23,1.0,17,2,2,2,6,0xb2d1a96e
242889.95,3.0,105,3,4,1,8,0xb2d7fc33
3073.53,1.0,0,2,2,4,8,0xb2d41d36
26.36,1.0,6,1,2,3,6,0xb2d5518f
50407.86,1.0,92,2,2,1,5,0xb2d3132e
23322.97,1.0,4,2,2,4,8,0xb2d93a92
320000.0,2.0,11,4,3,3,10,0xb2d966fed
180.8,2.0,21,1,3,2,6,0xb2d6cfe7
137270.95,26.0,0,3,4,4,11,0xb2d06526
190.23,3.0,92,1,4,1,6,0x3b9b3218
2882.31,1.0,76,1,2,1,4,0xb2d5cf9bd
401421.94,2.0,23,4,3,2,9,0xb2d8e04a
26689.31,1.0,1,2,2,4,8,0xb2d57a85
30000.63,2.0,60,2,3,2,7,0xb2d9bd61
222821.32,1.0,2,3,2,4,9,0xb2d655d9
20028.35,2.0,39,2,3,2,7,0xb2d52cbd
28740.11,1.0,141,2,2,1,5,0xb2d37c37d
3039.34,1.0,16,2,2,2,6,0xb2d6c170
1449.52,1.0,92,1,2,1,4,0xb2d1300d
21039.59,1.0,184,2,2,1,5,0xb2d3b70fd
1820082.11,1.0,1,4,2,4,10,0xb2d43f2e
12835.64,1.0,0,2,2,4,8,0xb2d2d6ab
280071.11,5.0,11,3,4,3,10,0xb2d0def6
5814.98,1.0,138,2,2,1,5,0xb2d3f49f
1460125.41,4.0,0,4,4,4,12,0xb2d0cb01d
584841.38,8.0,11,4,4,3,11,0xb2d39ea3
1237723.26,7.0,87,4,4,1,9,0x3b9b3ecdd
9297.33,1.0,9,2,2,3,7,0xb2d2efd3d
1462.56,1.0,1,1,2,4,7,0xb2d3d3f4
404259.76,3.0,3,4,4,4,12,0xb2d1cb29
751961.6,4.0,17,4,4,2,10,0xb2d6d492
107316.89,1.0,184,3,2,1,6,0xb2d11a0c
304000.68,2.0,8,4,3,3,10,0xb2d9a9f3
72477.6,2.0,129,3,3,1,7,0xb2d130bed
1076.56,1.0,92,1,2,1,4,0x3b9aefa4
201379.02,3.0,18,3,4,2,9,0xb2d2751d
400000.01,2.0,1,4,3,4,11,0xb2d2381e
302.16,1.0,1,1,2,4,7,0xb2d32a1ad
350001.28,2.0,0,4,3,4,11,0xb2d6940b
1350000.0,5.0,10,4,4,3,11,0xb2d37e13d
71248.74,2.0,216,3,3,1,7,0xb2d5274d
105.04,3.0,64,1,4,2,7,0xb2d6d0c3
1784329.35,18.0,3,4,4,4,12,0x3b9af1c6
4969.8,1.0,7,2,2,3,7,0xb2d46ef6
6066.38,1.0,92,2,2,1,5,0xb2d0d2bf
3457726.3,7.0,8,4,4,3,11,0xb2d8d086
500009.85,4.0,8,4,4,3,11,0xb2d65888d
28002.6,1.0,5,2,2,3,7,0xb2d2c579
747708.21,5.0,25,4,4,2,10,0xb2d5ad75d
10000.11,2.0,10,2,3,3,8,0xb2d9670b
8713.38,1.0,3,2,2,4,8,0xb2d3406a
80627.98,3.0,0,3,4,4,11,0xb2d1525e
70012.24,2.0,66,3,3,2,8,0xb2d44b16
479100.65,5.0,0,4,4,4,12,0x3b9b1a34
1215049.36,9.0,13,4,4,3,11,0xb2d2b138
15958709.11,1.0,0,4,2,4,10,0xb2d5cf6dd
16876.46,1.0,0,2,2,4,8,0xb2d0f33d
1666.88,1.0,184,1,2,1,4,0xb2d0dba1
1.69,1.0,10,1,2,3,6,0xb2d8dcef
707082.93,14.0,1,4,4,4,12,0xb2d5c226d
506205.26,3.0,94,4,4,1,9,0xb2d08ac6
1166016.69,7.0,34,4,4,2,10,0xb2d1cd73d
3009.6,1.0,1,2,2,4,8,0xb2da325b
80555.52,6.0,53,3,4,2,9,0xb2d1ab2b
22017.59,2.0,87,2,3,1,6,0xb2d563ba
61.29,1.0,11,1,2,3,6,0xb2d63a99
50006.37,2.0,144,2,3,1,6,0xb2d6d608
2272.75,1.0,0,1,2,4,7,0xb2d7c057d
1.16,1.0,24,1,2,2,5,0xb2d5ecf8
1177.01,1.0,0,1,2,4,7,0xb2d4009c
4517.69,1.0,15,2,2,3,7,0xb2d69193
228.39,1.0,15,1,2,3,6,0xb2d88b1c
3147.81,1.0,0,2,2,4,8,0xb2d3a8ae
500000.0,3.0,6,4,4,3,11,0xb2d947c5
932458.05,6.0,0,4,4,4,12,0xb2d6a727
237494.49,3.0,11,3,4,3,10,0xb2d19923
7668.24,1.0,13,2,2,3,7,0xb2da3dfd
44.85,12.0,26,1,4,2,7,0xb2d6c1c1d
30014.41,3.0,67,2,4,1,7,0xb2d6b170
2618688.21,11.0,0,4,4,4,12,0xb2d22ed1
20067.29,4.0,12,2,4,3,9,0xb2d7900cd
2.63,1.0,75,1,2,1,4,0xb2d96f36
530846.69,3.0,4,4,4,4,12,0xb2d21e21d
700050.3,3.0,5,4,4,3,11,0xb2d61e22
20393.47,1.0,0,2,2,4,8,0xb2d6254cd
2007111.49,2.0,37,4,3,2,9,0xb2d26d09
120006.57,4.0,16,3,4,2,9,0xb2d6b85ad
1608.11,1.0,184,1,2,1,4,0xb2d24e0b
7725.59,1.0,60,2,2,2,6,0xb2d5f049
641.83,1.0,20,1,2,2,5,0xb2d2102a
213377.25,2.0,130,3,3,1,7,0xb2d69820
213.95,6.0,0,1,4,4,9,0x3b9b4586
6.61,1.0,4,1,2,4,7,0xb2d57b94
1606893.9,9.0,0,4,4,4,12,0xb2d32ee5d
160000.0,3.0,3,3,4,4,11,0xb2d0f504d
600059.4,4.0,46,4,4,2,10,0xb2d57738d
300503.08,3.0,25,4,4,2,10,0xb2d3ee77d
27427.66,1.0,265,2,2,1,5,0xb2d2d818d
15001.23,2.0,18,2,3,2,7,0xb2d68aa4
200714.71,2.0,50,3,3,2,8,0xb2d9c275
110007.65,2.0,101,3,3,1,7,0xb2d5042d
10086.16,1.0,184,2,2,1,5,0xb2d22ba3
5.93,1.0,43,1,2,2,5,0xb2d24cacd
15.83,1.0,74,1,2,1,4,0xb2d99abf
0.13,1.0,0,1,2,4,7,0xb2d52fec
105496.9,9.0,18,3,4,2,9,0xb2d2916fd
1502698.86,3.0,10,4,4,3,11,0xb2d98cab
8225.32,1.0,92,2,2,1,5,0xb2d2dd6bd
2.07,1.0,22,1,2,2,5,0xb2d6ea81
941.84,1.0,10,1,2,3,6,0xb2d555b3d
300012.67,4.0,27,3,4,2,9,0xb2d9b18e
53953.32,3.0,5,3,4,3,10,0x3b9b4592d
23.91,3.0,4,1,4,4,9,0xb2d91314
82832.43,1.0,9,3,2,3,8,0xb2d414b9
16927.08,1.0,116,2,2,1,5,0xb2d5681c
236075.31,19.0,3,3,4,4,11,0xb2d0f7b3d
21731.05,1.0,45,2,2,2,6,0xb2d6bd9ad
3502.07,1.0,59,2,2,2,6,0xb2d6539ad
1913.07,1.0,92,1,2,1,4,0xb2d17f26
28.1,1.0,84,1,2,1,4,0xb2d695ee
13385.42,1.0,10,2,2,3,7,0xb2d5d966
50916.4,1.0,0,2,2,4,8,0xb2d62661
150004.75,2.0,130,3,3,1,7,0xb2d92585
1.8,1.0,12,1,2,3,6,0xb2d95bba
106072.9,1.0,0,3,2,4,9,0xb2d3d93ed
7344.53,1.0,17,2,2,2,6,0xb2d8d810
109655.33,1.0,5,3,2,3,8,0xb2d31f11d
460004.13,3.0,11,4,4,3,11,0xb2d51dde
20007.26,2.0,143,2,3,1,6,0xb2d28471d
84939.92,2.0,92,3,3,1,7,0xb2d64a59
450098.67,2.0,13,4,3,3,10,0xb2d645b4
600280.22,3.0,18,4,4,2,10,0xb2d909b7
202069.44,2.0,10,3,3,3,9,0xb2d68dd9
297.56,1.0,10,1,2,3,6,0xb2d696ae
59509.04,1.0,43,3,2,2,7,0xb2d3b6f6d
70.56,1.0,4,1,2,4,7,0xb2d94408d
2.06,1.0,28,1,2,2,5,0xb2d92a3f
2791.59,1.0,4,1,2,4,7,0xb2d1cc8f
2890.39,1.0,10,2,2,3,7,0xb2d8c7a5
560001.13,2.0,14,4,3,3,10,0xb2d17787
540006.58,23.0,1,4,4,4,12,0xb2d24d28
3259935.8,18.0,0,4,4,4,12,0xb2d06beb
209405.25,5.0,179,3,4,1,8,0xb2d1fe7b
1.47,1.0,12,1,2,3,6,0xb2d20ddf
164148.32,1.0,4,3,2,4,9,0xb2d18c0c
2666.48,1.0,1,1,2,4,7,0xb2d3430f
30000.32,2.0,168,2,3,1,6,0xb2d8a795
202343.0,3.0,3,3,4,4,11,0xb2d66788d
1099438.47,4.0,15,4,4,3,11,0xb2d41bde
210011.03,3.0,18,3,4,2,9,0xb2d99414
50003.25,3.0,13,2,4,3,9,0xb2d6d108d
26944.99,1.0,9,2,2,3,7,0xb2d368c0
328000.01,3.0,0,4,4,4,12,0xb2d63dd9
50685.18,2.0,18,2,3,2,7,0xb2d35a28d
80001.59,5.0,11,3,4,3,10,0xb2d97203d
5003.8,1.0,82,2,2,1,5,0xb2d98c81
583044.8,2.0,0,4,3,4,11,0xb2d1a85f
10190.67,2.0,193,2,3,1,6,0xb2d649f7
1714.83,2.0,184,1,3,1,5,0x3b9acd4ed
96124.18,3.0,0,3,4,4,11,0xb2d681f1
2.17,1.0,41,1,2,2,5,0xb2d4ac31
103716.24,1.0,92,3,2,1,6,0xb2d3a843
111146.18,2.0,0,3,3,4,10,0xb2d681aed
796743.05,6.0,35,4,4,2,10,0xb2d5d06a
1220.25,1.0,9,1,2,3,6,0xb2d44c75
36500.75,1.0,15,2,2,3,7,0xb2d6fdb2d
5114.18,1.0,0,2,2,4,8,0xb2d57276
219083.19,2.0,168,3,3,1,7,0xb2d2850c
720231.18,2.0,18,4,3,2,9,0xb2d482bdd
589.88,1.0,4,1,2,4,7,0xb2d6106ed
53.25,1.0,33,1,2,2,5,0xb2d44692
2599.41,1.0,2,1,2,4,7,0xb2d1da1f
4428382.87,5.0,0,4,4,4,12,0xb2d3a40fd
10000.53,2.0,216,2,3,1,6,0xb2d67cb0
3750.68,1.0,184,2,2,1,5,0xb2d3bbae
1012.27,1.0,189,1,2,1,4,0xb2d5a043d
4768811.84,14.0,0,4,4,4,12,0x3b9b0e19
104034.0,2.0,62,3,3,2,8,0xb2d17027
546.58,1.0,0,1,2,4,7,0xb2d435c6
281015.28,4.0,65,3,4,2,9,0xb2d1cc2a
453494.41,4.0,22,4,4,2,10,0xb2d29ccc
1446.02,1.0,18,1,2,2,5,0xb2d6a121
171321.39,10.0,0,3,4,4,11,0xb2d4bd04d
95.0,1.0,43,1,2,2,5,0xb2d9debd
90044.35,3.0,52,3,4,2,9,0xb2d63906
500005.28,2.0,35,4,3,2,9,0xb2d9f961
392020.48,20.0,19,4,4,2,10,0xb2d59f60
175042.15,1.0,4,3,2,4,9,0xb2d5633c
171224.26,4.0,1,3,4,4,11,0xb2d512add
10091.47,1.0,92,2,2,1,5,0xb2d2d350d
30222.25,4.0,6,2,4,3,9,0xb2d8d866
1180.89,1.0,0,1,2,4,7,0xb2d6b642
4627.41,1.0,10,2,2,3,7,0xb2d6891a
300714.01,5.0,5,4,4,3,11,0xb2d680f4d
100166.53,2.0,106,3,3,1,7,0xb2d59c9fd
244490.46,2.0,81,3,3,1,7,0xb2d5fbadd
0.0,1.0,95,1,2,1,4,0xb2d3b95dd
600.79,1.0,92,1,2,1,4,0xb2d2fbaf
11345.79,1.0,0,2,2,4,8,0xb2d6bf33
200000.0,2.0,13,3,3,3,9,0xb2d95fe8
6192.16,1.0,184,2,2,1,5,0xb2d22c07
11102.8,2.0,51,2,3,2,7,0xb2d0f421
200000.0,2.0,9,3,3,3,9,0xb2d633ac
847000.18,6.0,7,4,4,3,11,0xb2d40a2a
1077.07,1.0,92,1,2,1,4,0xb2d3d395d
119115.65,2.0,9,3,3,3,9,0xb2d396c6
614933.75,4.0,0,4,4,4,12,0xb2d1397fd
19870.46,1.0,172,2,2,1,5,0xb2d41dcdd
19.63,1.0,12,1,2,3,6,0xb2d93496d
36238.65,3.0,0,2,4,4,10,0xb2d1b434d
200039.97,2.0,6,3,3,3,9,0xb2d99a3d
141480.2,3.0,39,3,4,2,9,0xb2d0e7ea
748.14,1.0,13,1,2,3,6,0xb2d24920d
131782.45,2.0,210,3,3,1,7,0xb2d400ed
560132.1,4.0,24,4,4,2,10,0xb2d26bb4
506044.0,3.0,18,4,4,2,10,0xb2d65b7f
150094.78,3.0,60,3,4,2,9,0xb2d4f5a4d
250009.95,2.0,200,3,3,1,7,0xb2d56eda
1067.37,1.0,184,1,2,1,4,0xb2d378b9
9.69,2.0,92,1,3,1,5,0xb2d27f62
255422.04,2.0,47,3,3,2,8,0xb2d298ab
154041.47,2.0,4,3,3,4,10,0xb2d44cec
19979.9,1.0,8,2,2,3,7,0xb2d65987d
2453.36,1.0,77,1,2,1,4,0xb2d6d303d
10.27,1.0,39,1,2,2,5,0xb2d1fbec
259.62,1.0,67,1,2,1,4,0xb2d6497d
266676.04,2.0,8,3,3,3,9,0xb2d0d6ee
661169.08,3.0,11,4,4,3,11,0xb2d9610c
330003.48,2.0,34,4,3,2,9,0xb2d93429
50741.26,2.0,62,2,3,2,7,0xb2d6b11cd
1415.77,1.0,27,1,2,2,5,0xb2d37c39
200234.19,3.0,21,3,4,2,9,0xb2d08dae
2735.34,1.0,14,1,2,3,6,0xb2d6e5c4
775029.56,8.0,1,4,4,4,12,0xb2d3bce0
41740.09,1.0,3,2,2,4,8,0xb2d60d14d
16392.5,1.0,184,2,2,1,5,0xb2d33a9cd
12141.84,2.0,92,2,3,1,6,0xb2d2c426
98.94,1.0,19,1,2,2,5,0xb2d63d8a
30000.32,2.0,55,2,3,2,7,0xb2d905ae
250005.29,2.0,122,3,3,1,7,0xb2d76ab3
61911.2,2.0,0,3,3,4,10,0xb2d2c4b0
29996.92,4.0,2,2,4,4,10,0xb2d2f68d
100093.43,2.0,196,3,3,1,7,0xb2d64587d
5617.18,1.0,3,2,2,4,8,0xb2d6389dd
764883.78,5.0,77,4,4,1,9,0xb2d077c2
283166.37,4.0,3,3,4,4,11,0x3b9b3d9f
500000.64,2.0,9,4,3,3,10,0xb2d58b7e
192.4,1.0,0,1,2,4,7,0xb2d97cc0
280038.52,4.0,18,3,4,2,9,0xb2d23224
5867.96,2.0,11,2,3,3,8,0xb2d63aacd
2315.55,1.0,184,1,2,1,4,0xb2d40f74
57063.58,2.0,206,3,3,1,7,0xb2d16259
60411.14,2.0,231,3,3,1,7,0xb2d4c81fd
36.94,1.0,50,1,2,2,5,0xb2d8f4a2
379.52,1.0,13,1,2,3,6,0xb2d8599d
150043.13,2.0,203,3,3,1,7,0xb2d30366d
353857.73,3.0,60,4,4,2,10,0xb2d06c62
7921.81,1.0,184,2,2,1,5,0x3b9af56c
100001.06,2.0,46,3,3,2,8,0xb2d9e215
15857.13,1.0,27,2,2,2,6,0xb2d696fd
2581.57,1.0,5,1,2,3,6,0xb2d9aaac
907042.09,2.0,8,4,3,3,10,0xb2d377ed
40000.0,2.0,0,2,3,4,9,0xb2d97c80
2554.18,1.0,184,1,2,1,4,0xb2d242c0
3498.18,1.0,92,2,2,1,5,0x3b9b2981
441810.76,9.0,22,4,4,2,10,0xb2d56456
10001810.09,2.0,34,4,3,2,9,0xb2d68bd1
1401.01,1.0,27,1,2,2,5,0xb2d26239
0.0,1.0,6,1,2,3,6,0xb2d3a63b
10203.13,1.0,1,2,2,4,8,0xb2d41b9c
1992.68,1.0,92,1,2,1,4,0xb2d34358d
33.12,1.0,5,1,2,3,6,0xb2d2fda3
150105.02,2.0,1,3,3,4,10,0xb2d40f48
82002.28,3.0,75,3,4,1,8,0xb2d5c031
530397.22,6.0,6,4,4,3,11,0xb2d42ac6
20000.42,2.0,221,2,3,1,6,0xb2d6fff1
1885373.48,5.0,3,4,4,4,12,0xb2d0a4be
22.52,1.0,8,1,2,3,6,0xb2d2bb5ad
1936.21,1.0,10,1,2,3,6,0xb2d4ba9f
3040484.13,1.0,7,4,2,3,9,0xb2d63169
1284.19,14.0,0,1,4,4,9,0xb2d0673f
20175.23,2.0,159,2,3,1,6,0xb2d60cea
94.15,1.0,208,1,2,1,4,0xb2d4a93d
100001.06,3.0,217,3,4,1,8,0xb2d51c08
315010.16,4.0,24,4,4,2,10,0xb2d47787d
1301.76,1.0,1,1,2,4,7,0xb2d3f5c3
700202.69,9.0,0,4,4,4,12,0xb2d20da2d
1008.02,1.0,92,1,2,1,4,0xb2d32b5d
51106.79,3.0,12,2,4,3,9,0xb2d9a6a0
3680.69,1.0,92,2,2,1,5,0xb2d139a9d
300003.17,2.0,38,3,3,2,8,0xb2d92ceb
2170089.56,5.0,1,4,4,4,12,0xb2d2f0b8
503293.7,2.0,32,4,3,2,9,0xb2d5e390d
100076.17,2.0,208,3,3,1,7,0xb2d0b66a
43.17,1.0,63,1,2,2,5,0xb2d29e98
141.44,1.0,4,1,2,4,7,0xb2d23759
3247.09,1.0,132,2,2,1,5,0xb2d2e680
182444.97,4.0,74,3,4,1,8,0xb2d52c9dd
2050.83,1.0,184,1,2,1,4,0xb2d308a3
403876.01,8.0,5,4,4,3,11,0x3b9b0fb3
2923000.18,15.0,0,4,4,4,12,0xb2d0678ed
3031.26,1.0,0,2,2,4,8,0xb2d3a15a
664492.32,3.0,1,4,4,4,12,0xb2d0e5de
696404.33,9.0,0,4,4,4,12,0x3b9b1871
300260.28,2.0,8,4,3,3,10,0xb2d6fd02
2500000.2,4.0,23,4,4,2,10,0xb2d9cd5f
510011.08,3.0,182,4,4,1,9,0xb2d635d3d
2.32,1.0,167,1,2,1,4,0xb2d8dd91d
2136.21,1.0,184,1,2,1,4,0x3b9adcb5d
801500.49,11.0,1,4,4,4,12,0xb2d65a35d
150005.91,2.0,53,3,3,2,8,0xb2d9ace5
131114.45,7.0,3,3,4,4,11,0xb2d6477f
500236.06,2.0,92,4,3,1,8,0xb2d5b191d
29729.22,1.0,0,2,2,4,8,0xb2d209f8
6145.44,1.0,261,2,2,1,5,0xb2d1de5c
113097.22,1.0,48,3,2,2,7,0xb2d1b0d5
20376.07,2.0,110,2,3,1,6,0xb2d6535ad
400000.0,2.0,26,4,3,2,9,0xb2d9c972
1000016.43,2.0,22,4,3,2,9,0xb2d90d56
645929.98,5.0,13,4,4,3,11,0xb2d25b37d
2.22,1.0,21,1,2,2,5,0xb2d5bdf8d
390384.19,6.0,0,4,4,4,12,0xb2d0e657
883.31,1.0,0,1,2,4,7,0xb2d52990
51016.07,2.0,80,2,3,1,6,0xb2d22a0ed
433.94,1.0,77,1,2,1,4,0xb2d3b9f0
8372.1,2.0,92,2,3,1,6,0xb2d0e820
82176.43,3.0,11,3,4,3,10,0xb2d55c3d
724.11,1.0,7,1,2,3,6,0xb2d50924
285.0,1.0,28,1,2,2,5,0xb2d97c2d
1940.7,1.0,184,1,2,1,4,0xb2d1ab3cd
491122.43,1.0,0,4,2,4,10,0xb2d1878c
400426.96,1.0,20,4,2,2,8,0xb2d6d169
172250.55,2.0,1,3,3,4,10,0xb2d58f3cd
809000.25,4.0,77,4,4,1,9,0xb2d1aaa9d
437080.53,4.0,2,4,4,4,12,0xb2d0ebb0
52.6,1.0,20,1,2,2,5,0xb2d951ab
290259.17,3.0,26,3,4,2,9,0xb2d3604d
200054.14,3.0,22,3,4,2,9,0xb2d9397bd
1150000.0,2.0,80,4,3,1,8,0xb2d8cdb1
18812.25,1.0,9,2,2,3,7,0xb2d332e9d
17002.34,1.0,6,2,2,3,7,0xb2d8d624
618048.52,2.0,21,4,3,2,9,0xb2d39a47
1465.19,1.0,184,1,2,1,4,0xb2d1dae6
265489.53,12.0,3,3,4,4,11,0x3b9b18c3
54893.2,2.0,6,3,3,3,9,0xb2d6157b
132441.97,1.0,103,3,2,1,6,0xb2d38990
4534.7,6.0,92,2,4,1,7,0xb2d0788bd
127005.36,2.0,20,3,3,2,8,0xb2d94d88
480000.0,3.0,0,4,4,4,12,0xb2d96b96d
604781.81,4.0,9,4,4,3,11,0xb2d19169
96.06,2.0,184,1,3,1,5,0x3b9b2df7
5506.18,1.0,0,2,2,4,8,0xb2d6bb6a
9.08,1.0,42,1,2,2,5,0xb2d0959b
20001.06,2.0,90,2,3,1,6,0xb2d891bed
584335.33,3.0,11,4,4,3,11,0x3b9b3dca
10000100.0,2.0,3,4,3,4,11,0xb2d78838d
29034.79,2.0,139,2,3,1,6,0xb2d4698a
3478.32,1.0,2,2,2,4,8,0xb2d4fce4
220.38,1.0,19,1,2,2,5,0xb2d6bccf
216.73,1.0,4,1,2,4,7,0xb2d913b7d
310671.13,2.0,127,4,3,1,8,0xb2d6864f
13.27,1.0,50,1,2,2,5,0xb2d9659e
99.33,1.0,67,1,2,1,4,0xb2d5abf1d
337150.78,3.0,28,4,4,2,10,0xb2d23ae1d
31529.18,1.0,41,2,2,2,6,0xb2d5de77d
2590.32,1.0,184,1,2,1,4,0xb2d1a314d
971814.07,4.0,6,4,4,3,11,0xb2d5d203
585015.65,2.0,108,4,3,1,8,0xb2d6b1dbd
10061.28,1.0,92,2,2,1,5,0xb2d1ce78
1547196.23,2.0,203,4,3,1,8,0xb2d782cbd
200773.41,2.0,37,3,3,2,8,0xb2d680e1
6263.39,1.0,1,2,2,4,8,0xb2d98d8b
183001.39,3.0,38,3,4,2,9,0xb2d24a7bd
10000.11,2.0,53,2,3,2,7,0xb2d9d14c
229401.06,5.0,46,3,4,2,9,0x3b9b3c00
528887.23,6.0,0,4,4,4,12,0xb2d49295d
173608.56,8.0,4,3,4,4,11,0xb2d61b13d
1215.92,1.0,115,1,2,1,4,0xb2d6f34e
375209.34,6.0,1,4,4,4,12,0xb2d0e7cc
844.69,1.0,5,1,2,3,6,0xb2d536b0
25880.86,4.0,0,2,4,4,10,0xb2d095c8d
325096.64,2.0,211,4,3,1,8,0xb2d70442d
12143.58,1.0,10,2,2,3,7,0xb2d4006d
144000.0,10.0,1,3,4,4,11,0xb2d55a13d
500066.08,3.0,8,4,4,3,11,0xb2d8fe25
3509.47,1.0,1,2,2,4,8,0xb2d5be3c
44.0,1.0,0,1,2,4,7,0xb2d6062c
1322744.2,5.0,11,4,4,3,11,0xb2d61fbbd
1193.22,1.0,92,1,2,1,4,0xb2d349b0d
259192.35,2.0,129,3,3,1,7,0xb2d11fc0d
20003.56,1.0,15,2,2,3,7,0xb2d6a1df
13.82,1.0,55,1,2,2,5,0xb2d8d626
2136.4,1.0,184,1,2,1,4,0xb2d3872ed
35866.38,1.0,20,2,2,2,6,0xb2d54280
370000.32,6.0,3,4,4,4,12,0xb2d4fbfa
200711.46,2.0,15,3,3,3,9,0xb2d91e4fd
375186.39,2.0,22,4,3,2,9,0xb2d8d2aed
272154.44,10.0,1,3,4,4,11,0xb2d65046d
24734.64,1.0,3,2,2,4,8,0xb2d39588
319991.41,2.0,11,4,3,3,10,0xb2d434fe
190013.35,4.0,123,3,4,1,8,0xb2d6d972
187520298.58,4.0,66,4,4,2,10,0x3b9b2b26
84.58,1.0,0,1,2,4,7,0xb2d34389d
78773.6,3.0,46,3,4,2,9,0xb2d3a824
400013.72,6.0,24,4,4,2,10,0xb2d92d65
799140.93,8.0,0,4,4,4,12,0xb2d52534
16847.09,1.0,3,2,2,4,8,0xb2d343bfd
786014.37,14.0,1,4,4,4,12,0xb2d5b445
25201.15,1.0,187,2,2,1,5,0xb2d417b5
44571.98,1.0,12,2,2,3,7,0xb2d6a7ae
2001.03,1.0,59,1,2,2,5,0xb2d2d2ef
100760.3,4.0,116,3,4,1,8,0xb2d67ff6
11679.57,1.0,49,2,2,2,6,0xb2d37bfd
198.28,3.0,3,1,4,4,9,0xb2d950fd
4.67,1.0,102,1,2,1,4,0xb2d80369
590000.0,3.0,1,4,4,4,12,0xb2da1b5c
200008.53,2.0,122,3,3,1,7,0xb2d6481ed
111400.06,1.0,184,3,2,1,6,0xb2d1bcd7
590006.23,2.0,6,4,3,3,10,0xb2d96a6e
5464.1,1.0,9,2,2,3,7,0xb2d8de9e
9027.18,1.0,250,2,2,1,5,0xb2d2c84a
196119.47,2.0,1,3,3,4,10,0xb2d1e86a
667368.95,10.0,0,4,4,4,12,0x3b9ae3f2
863.87,1.0,10,1,2,3,6,0xb2d510fc
31486.79,4.0,10,2,4,3,9,0xb2d60b2fd
216981.75,1.0,8,3,2,3,8,0xb2d436da
915009.25,10.0,6,4,4,3,11,0xb2d432f0
1045.64,1.0,60,1,2,2,5,0xb2d6aff5
1762.39,1.0,82,1,2,1,4,0xb2d69082
500052.11,2.0,27,4,3,2,9,0xb2d8c968d
828050.28,30.0,5,4,4,3,11,0xb2d1144ed
380000.0,6.0,10,4,4,3,11,0xb2d28285d
931139.59,3.0,25,4,4,2,10,0xb2d0d8cb
788380.19,7.0,28,4,4,2,10,0xb2d4e8f4
400054.32,3.0,6,4,4,3,11,0xb2d65b25
102010.58,2.0,37,3,3,2,8,0xb2d5824f
4876.1,1.0,286,2,2,1,5,0xb2d1b157d
391204.31,3.0,24,4,4,2,10,0xb2d20715d
90577.49,3.0,52,3,4,2,9,0xb2d6c9d5
3.28,1.0,19,1,2,2,5,0xb2d3685b
17690.66,1.0,2,2,2,4,8,0xb2d8ea12
334.91,1.0,2,1,2,4,7,0xb2d26037d
785009.02,4.0,18,4,4,2,10,0xb2d98c2e
7576.04,1.0,5,2,2,3,7,0xb2d16541
1009.3,1.0,184,1,2,1,4,0xb2d2c8c6
920461.71,3.0,4,4,4,4,12,0xb2d5d958
119.79,1.0,8,1,2,3,6,0xb2d3efc0
611001.37,3.0,10,4,4,3,11,0xb2d9f2e5
236875.0,3.0,2,3,4,4,11,0xb2da56e0
234198.91,4.0,0,3,4,4,11,0xb2d86ca0
4792.25,1.0,2,2,2,4,8,0xb2d24144
215242.4,3.0,2,3,4,4,11,0xb2d59e7f
670136.11,5.0,0,4,4,4,12,0xb2d64ece
50484.44,1.0,92,2,2,1,5,0xb2d2916ed
230257.41,1.0,0,3,2,4,9,0xb2d4862c
40874.87,2.0,8,2,3,3,8,0xb2d6270ed
6370.09,1.0,19,2,2,2,6,0xb2d9dd87
1247.34,1.0,92,1,2,1,4,0xb2d2a86f
18104.43,2.0,69,2,3,1,6,0xb2d660a7d
360736.38,4.0,4,4,4,4,12,0xb2d88e18d
51775.44,1.0,76,2,2,1,5,0xb2d2ae48
1633.43,1.0,184,1,2,1,4,0xb2d0720fd
0.0,1.0,0,1,2,4,7,0xb2d92211
265051.14,6.0,18,3,4,2,9,0xb2d64c58
12387.34,1.0,15,2,2,3,7,0xb2d579b8d
2018.37,1.0,0,1,2,4,7,0xb2d467f1
130052.12,4.0,10,3,4,3,10,0xb2d62d48d
140007.41,3.0,216,3,4,1,8,0xb2d67e86
20233.06,2.0,55,2,3,2,7,0xb2d8dfc1d
152585.62,3.0,129,3,4,1,8,0xb2d33a0ed
1688.19,1.0,10,1,2,3,6,0xb2d503c4
2774642.97,9.0,0,4,4,4,12,0x3b9af16b
1300097.4,7.0,9,4,4,3,11,0xb2d437eed
3.17,1.0,11,1,2,3,6,0xb2d273a5
5008.24,1.0,166,2,2,1,5,0xb2d8e59e
30341.89,2.0,171,2,3,1,6,0xb2d60040
3144.28,1.0,92,2,2,1,5,0xb2d1495d
2260515.6,8.0,0,4,4,4,12,0xb2d5bccbd
619430.78,1.0,3,4,2,4,10,0xb2d122b1d
500065.63,3.0,0,4,4,4,12,0xb2d93f30
4376.09,1.0,144,2,2,1,5,0xb2d26684
1935.32,3.0,92,1,4,1,6,0xb2d081d8
30.84,1.0,41,1,2,2,5,0xb2d6d949
160034.02,3.0,35,3,4,2,9,0xb2d6a9e2
339482.93,2.0,123,4,3,1,8,0xb2d262ce
2332.09,1.0,92,1,2,1,4,0xb2d2f34f
964.6,1.0,10,1,2,3,6,0xb2d2e8ca
100017.34,2.0,157,3,3,1,7,0xb2d38743d
1549.69,1.0,0,1,2,4,7,0xb2d7053a
521.88,1.0,81,1,2,1,4,0xb2d334a9d
839.76,1.0,10,1,2,3,6,0xb2d2a03b
1940329.37,1.0,3,4,2,4,10,0xb2d22471d
1508.73,1.0,184,1,2,1,4,0xb2d3863ed
800041.82,3.0,7,4,4,3,11,0xb2d58811
16015.79,2.0,0,2,3,4,9,0xb2d62f3a
242.9,1.0,41,1,2,2,5,0xb2d42630
1781.64,1.0,0,1,2,4,7,0xb2d276f0
3.17,1.0,1,1,2,4,7,0xb2d900c4d
100486.89,2.0,0,3,3,4,10,0xb2d632eb
4771.18,1.0,3,2,2,4,8,0xb2d25ed1d
845842.45,10.0,10,4,4,3,11,0xb2d215fa
750000.58,4.0,14,4,4,3,11,0xb2d5c8b5d
601579.42,4.0,8,4,4,3,11,0xb2d61de5d
3696.06,1.0,7,2,2,3,7,0xb2d1f523d
123365.36,2.0,228,3,3,1,7,0xb2d22b14
106515.27,2.0,18,3,3,2,8,0xb2d1e092d
409349.2,3.0,7,4,4,3,11,0xb2d360a6d
501066.68,3.0,23,4,4,2,10,0xb2d791f7
6905.64,1.0,21,2,2,2,6,0xb2d476c4
50000.53,2.0,221,2,3,1,6,0xb2d70862
3240843.77,5.0,14,4,4,3,11,0xb2d616bd
38637.26,1.0,28,2,2,2,6,0xb2d1ba6f
0.5,1.0,1,1,2,4,7,0xb2d55f5f
8642.63,1.0,0,2,2,4,8,0xb2d2fda9
48.16,1.0,0,1,2,4,7,0xb2d6b584
2370.05,1.0,1,1,2,4,7,0xb2d55741
77190.04,2.0,6,3,3,3,9,0xb2d2076f
80083.2,2.0,10,3,3,3,9,0xb2d28429d
6553.71,1.0,0,2,2,4,8,0xb2d2b1a7
2030165.19,2.0,1,4,3,4,11,0xb2d6b939
1021.88,2.0,179,1,3,1,5,0x3b9b298e
50001.58,2.0,46,2,3,2,7,0xb2d9db39
106.22,1.0,42,1,2,2,5,0xb2d9a99c
39000.0,2.0,0,2,3,4,9,0xb2d62fdcd
10418.05,1.0,6,2,2,3,7,0xb2d56103
155954.94,4.0,18,3,4,2,9,0xb2d421c6
250485.53,5.0,24,3,4,2,9,0xb2d5c1b7d
2631.53,1.0,92,1,2,1,4,0xb2d24338
131581.09,2.0,11,3,3,3,9,0xb2d41549
9456.57,1.0,0,2,2,4,8,0xb2d6e61b
10.99,1.0,3,1,2,4,7,0xb2d95b32
160242.58,3.0,10,3,4,3,10,0xb2d39640
53298.79,4.0,8,3,4,3,10,0xb2d11b77d
300015.59,2.0,60,3,3,2,8,0xb2d1f8b5
370.21,2.0,287,1,3,1,5,0xb2d5dd90
760.24,1.0,0,1,2,4,7,0xb2d6890f
200000.0,2.0,4,3,3,4,10,0xb2da61b7
4209.29,2.0,92,2,3,1,6,0x3b9b324cd
2547.75,1.0,9,1,2,3,6,0xb2d9d42c
100005.29,2.0,143,3,3,1,7,0xb2d6d1cfd
1428.79,2.0,61,1,3,2,6,0x3b9b2e69d
517011.47,3.0,53,4,4,2,10,0xb2d0fdc5d
337.36,1.0,5,1,2,3,6,0xb2d4ec19d
1800287.09,4.0,62,4,4,2,10,0xb2d1e757
1001693.15,7.0,5,4,4,3,11,0xb2d51887d
203510.73,5.0,77,3,4,1,8,0xb2d556fc
10000.21,2.0,31,2,3,2,7,0xb2d93afad
230000.03,5.0,5,3,4,3,10,0xb2d68977d
702486.96,2.0,29,4,3,2,9,0xb2d8f6a4
32049.14,1.0,1,2,2,4,8,0xb2d5bc4d
350018.55,2.0,0,4,3,4,11,0xb2d06d58
410012.12,17.0,4,4,4,4,12,0xb2d1fb57
420798.87,6.0,3,4,4,4,12,0xb2d10f21
10964.86,1.0,1,2,2,4,8,0xb2d193eb
239338.92,3.0,139,3,4,1,8,0xb2d2d08dd
662344.38,2.0,40,4,3,2,9,0xb2d9d41c
2229.92,1.0,92,1,2,1,4,0xb2d1488bd
81129.77,3.0,4,3,4,4,11,0xb2d39854d
3551.65,1.0,4,2,2,4,8,0xb2d17415d
228462.12,1.0,184,3,2,1,6,0x3b9b18b5
13842.69,1.0,10,2,2,3,7,0xb2d6b22f
300885.34,2.0,0,4,3,4,11,0xb2d8f8edd
34900.03,1.0,14,2,2,3,7,0xb2d55414
340024.39,5.0,13,4,4,3,11,0xb2d62d6c
33.71,1.0,2,1,2,4,7,0xb2d213a2
600416.55,3.0,0,4,4,4,12,0xb2d68ebd
341.0,1.0,10,1,2,3,6,0xb2d64dce
204265.95,2.0,40,3,3,2,8,0xb2d6a628d
475035.19,2.0,7,4,3,3,10,0xb2d1c1a7
90479.86,5.0,49,3,4,2,9,0xb2d65952
192826.1,5.0,3,3,4,4,11,0xb2d31c25d
17531.11,1.0,19,2,2,2,6,0xb2d9cf04
405003.28,8.0,33,4,4,2,10,0xb2d20d14
12758.76,1.0,15,2,2,3,7,0xb2d32589
300000.0,2.0,23,3,3,2,8,0xb2d690e1
390013.13,2.0,94,4,3,1,8,0xb2d84de5
2041161.25,3.0,1,4,4,4,12,0xb2d468c5
3423.21,1.0,184,2,2,1,5,0xb2d30fa0
310044.54,4.0,4,4,4,4,12,0xb2d5ce50
162322.8,3.0,1,3,4,4,11,0xb2d5739e
570188.75,2.0,239,4,3,1,8,0xb2d47f5b
16002.09,2.0,87,2,3,1,6,0xb2d8c6cf
13.57,2.0,11,1,3,3,7,0xb2d11f38
2061.79,1.0,184,1,2,1,4,0xb2d5f005d
20000.84,2.0,98,2,3,1,6,0xb2d96cc8
550000.23,5.0,7,4,4,3,11,0xb2d9ad14
200000.84,2.0,17,3,3,2,8,0xb2d8dc49d
183410.64,4.0,25,3,4,2,9,0xb2d2e903d
1094101.88,6.0,1,4,4,4,12,0xb2d10fdf
1076132.23,5.0,60,4,4,2,10,0xb2d11f24
2719.01,1.0,10,1,2,3,6,0xb2d1ad84
8065.52,3.0,0,2,4,4,10,0xb2d9fda8
4390.56,1.0,3,2,2,4,8,0xb2d280f8
1197.23,1.0,13,1,2,3,6,0xb2d6ba41d
50014.8,2.0,167,2,3,1,6,0xb2d5fb1cd
243.03,1.0,21,1,2,2,5,0xb2da0c19
140010.73,3.0,118,3,4,1,8,0xb2d4f129
1150.75,1.0,138,1,2,1,4,0xb2d2907fd
300000.0,2.0,15,3,3,3,9,0xb2da38f4
1400.73,1.0,9,1,2,3,6,0xb2d34bd4
155063.83,2.0,48,3,3,2,8,0xb2d24611d
2970.17,1.0,92,2,2,1,5,0xb2d58fb1
587283.2,1.0,0,4,2,4,10,0xb2d6aba7d
36.22,1.0,12,1,2,3,6,0xb2d37c53
138.7,1.0,20,1,2,2,5,0xb2d15f4c
653395.22,3.0,7,4,4,3,11,0xb2d5aacbd
766.42,1.0,9,1,2,3,6,0xb2d3f422
77.13,1.0,41,1,2,2,5,0xb2d31336
2802.46,1.0,1,1,2,4,7,0xb2d7019f
7945.03,1.0,0,2,2,4,8,0xb2d8c512
66.07,1.0,13,1,2,3,6,0xb2d409f8
30590.8,1.0,184,2,2,1,5,0x3b9b4612
80365.18,1.0,1,3,2,4,9,0xb2d98134
62836.88,4.0,0,3,4,4,11,0xb2d0f323
6392.86,1.0,184,2,2,1,5,0xb2d45e3e
431926.21,3.0,2,4,4,4,12,0xb2d694a9d
8.44,1.0,35,1,2,2,5,0xb2d9e804
263493.44,3.0,39,3,4,2,9,0xb2d1a8dc
750079.77,4.0,77,4,4,1,9,0xb2d2611ad
60085.26,2.0,168,3,3,1,7,0xb2d687a1
10100.61,1.0,92,2,2,1,5,0xb2d28b2b
78.9,1.0,9,1,2,3,6,0xb2d30b45
250009.11,3.0,1,3,4,4,11,0xb2d93038d
1806.08,1.0,92,1,2,1,4,0x3b9b16e5
110092.86,4.0,0,3,4,4,11,0xb2d5efa6
663365.89,4.0,25,4,4,2,10,0xb2d10fce
62437.45,2.0,31,3,3,2,8,0xb2d63d1fd
62067.13,5.0,0,3,4,4,11,0xb2d29feb
351518.03,5.0,62,4,4,2,10,0xb2d6149f
61556.18,1.0,0,3,2,4,9,0xb2d34671d
645000.0,2.0,20,4,3,2,9,0xb2d98f94
365004.17,6.0,11,4,4,3,11,0xb2d55ebc
6147.84,1.0,184,2,2,1,5,0xb2d0d0dad
1194553.43,3.0,16,4,4,2,10,0xb2d7924f
40000.0,3.0,4,2,4,4,10,0xb2d974cb
24085.55,2.0,165,2,3,1,6,0xb2d425e9
1.0,1.0,21,1,2,2,5,0xb2d8ddb5
501137.04,3.0,6,4,4,3,11,0xb2d63146
2482.78,1.0,9,1,2,3,6,0xb2d5839f
3428.97,1.0,0,2,2,4,8,0xb2d78280
11273.0,1.0,3,2,2,4,8,0xb2d4eb7c
380100.0,2.0,1,4,3,4,11,0xb2da688c
2298.41,1.0,2,1,2,4,7,0xb2d65220
1024.74,1.0,53,1,2,2,5,0xb2d62630
2559.7,1.0,1,1,2,4,7,0xb2d6d9de
38004.59,2.0,64,2,3,2,7,0xb2d91050
306465.54,6.0,133,4,4,1,9,0xb2d177a0
500046.08,3.0,70,4,4,1,9,0xb2d069cb
6164.45,2.0,0,2,3,4,9,0xb2d1ed59
446014.75,4.0,18,4,4,2,10,0xb2d25309d
1631.04,1.0,1,1,2,4,7,0xb2d29d5dd
64046.11,3.0,2,3,4,4,11,0xb2d56585
105.48,1.0,10,1,2,3,6,0xb2d5ef10d
63790.5,4.0,41,3,4,2,9,0x3b9b3523
2560.43,1.0,91,1,2,1,4,0xb2d26915
105372.3,2.0,0,3,3,4,10,0xb2d4162a
500076.04,2.0,8,4,3,3,10,0xb2d9f6c3
2501.52,2.0,92,1,3,1,5,0x3b9adb72
3010.69,1.0,92,2,2,1,5,0xb2d1e3d4
313516.57,2.0,70,4,3,1,8,0xb2d2ab37
1877.92,1.0,0,1,2,4,7,0xb2d7f155
0.0,1.0,6,1,2,3,6,0xb2d2c3d9
280631.07,6.0,9,3,4,3,10,0xb2d57d15
418555.79,4.0,0,4,4,4,12,0xb2d31791
100052.35,2.0,82,3,3,1,7,0xb2d1cd32
8208.34,1.0,92,2,2,1,5,0xb2d3986cd
590954.13,4.0,30,4,4,2,10,0xb2d1dd0f
115904.31,5.0,27,3,4,2,9,0xb2d548ce
7761379.7,12.0,0,4,4,4,12,0xb2d16ebe
94784.45,2.0,104,3,3,1,7,0xb2d2d96e
11883.18,1.0,0,2,2,4,8,0xb2d3f2b5
841.48,2.0,81,1,3,1,5,0xb2d0dad6
1750.44,1.0,9,1,2,3,6,0xb2d69efe
300000.64,2.0,26,3,3,2,8,0xb2d9a1d2
5962.05,1.0,63,2,2,2,6,0xb2d6f3ed
90483.22,2.0,4,3,3,4,10,0xb2d5c5e1
416625.85,6.0,1,4,4,4,12,0xb2d5d290
32.71,1.0,82,1,2,1,4,0xb2d5ce86
5329.23,1.0,0,2,2,4,8,0xb2d378b1
5.85,3.0,0,1,4,4,9,0xb2d210c7
1331.41,1.0,23,1,2,2,5,0xb2d6eaaa
4490.75,1.0,111,2,2,1,5,0xb2d6bc7ad
27140.37,1.0,11,2,2,3,7,0xb2d17a47
108999.75,2.0,24,3,3,2,8,0xb2d137c9
568.76,1.0,82,1,2,1,4,0xb2d18be4
50844.32,2.0,56,2,3,2,7,0xb2d59cc6
1162.45,1.0,184,1,2,1,4,0xb2d1a6cdd
500112.74,2.0,228,4,3,1,8,0xb2d30c61
203554.6,2.0,167,3,3,1,7,0xb2d6c391
209.31,3.0,72,1,4,1,6,0xb2d21df5
100001.59,3.0,25,3,4,2,9,0xb2d903e5
520067.47,2.0,66,4,3,2,9,0xb2d407e3d
170067.41,3.0,21,3,4,2,9,0xb2d2431dd
31030.4,1.0,15,2,2,3,7,0xb2d95e03
6128.54,1.0,0,2,2,4,8,0xb2d29a21
11723.96,1.0,0,2,2,4,8,0xb2d964e3
1617.6,1.0,191,1,2,1,4,0xb2d3fd05
255864.69,3.0,30,3,4,2,9,0xb2d39c30
1434533.5,3.0,18,4,4,2,10,0xb2d0c311
301226.63,2.0,21,4,3,2,9,0xb2d4ead2d
700393.45,5.0,1,4,4,4,12,0xb2d1a972
994.46,1.0,6,1,2,3,6,0xb2d45511
10291.1,1.0,3,2,2,4,8,0xb2d65485d
1700000.44,9.0,3,4,4,4,12,0xb2d23bc3
46000.83,3.0,11,2,4,3,9,0xb2d905aed
43.53,1.0,14,1,2,3,6,0xb2d37d09
9745.91,1.0,0,2,2,4,8,0xb2d6da2d
15001.58,1.0,10,2,2,3,7,0xb2d9bdce
171544.58,11.0,0,3,4,4,11,0x3b9b18c3d
161095.5,3.0,1,3,4,4,11,0xb2d0f1d0d
65843.96,5.0,4,3,4,4,11,0xb2d7783cd
1349028.54,5.0,60,4,4,2,10,0xb2d3e443
504334.41,3.0,28,4,4,2,10,0xb2d6af3fd
3.71,1.0,1,1,2,4,7,0xb2d33c7a
50079.71,2.0,119,2,3,1,6,0xb2d28496
0.0,1.0,2,1,2,4,7,0xb2d9deb1
100102.77,3.0,90,3,4,1,8,0xb2d771ea
260100.51,2.0,1,3,3,4,10,0xb2d834f9
50389.15,3.0,4,2,4,4,10,0xb2d8e13dd
10000.32,2.0,92,2,3,1,6,0xb2d56270
8041.05,1.0,15,2,2,3,7,0xb2d99929
2019.53,1.0,184,1,2,1,4,0xb2d2b25bd
80585.93,2.0,1,3,3,4,10,0xb2d2fbd7d
51095.1,2.0,83,2,3,1,6,0xb2d605cdd
1727.6,1.0,0,1,2,4,7,0xb2d2095f
2.64,1.0,69,1,2,1,4,0xb2d58bf4d
2477.1,1.0,45,1,2,2,5,0xb2d9b4ed
240000.0,2.0,13,3,3,3,9,0xb2d78b4d
1792.7,1.0,32,1,2,2,5,0xb2d21da9
794123.01,5.0,137,4,4,1,9,0xb2d54bb0
152028.58,3.0,101,3,4,1,8,0xb2d4f38dd
94.46,1.0,10,1,2,3,6,0xb2d90e30
24486.01,1.0,0,2,2,4,8,0xb2d14e1cd
777795.41,18.0,0,4,4,4,12,0x3b9b183cd
160.82,1.0,34,1,2,2,5,0xb2d1c70bd
10022.94,1.0,214,2,2,1,5,0xb2d29015
2.91,1.0,2,1,2,4,7,0xb2d9b5c8
140058.67,5.0,0,3,4,4,11,0xb2d57cf7
155.74,1.0,14,1,2,3,6,0xb2d4be19d
218879.32,3.0,4,3,4,4,11,0xb2d09a5fd
110114.66,6.0,48,3,4,2,9,0xb2d52ddbd
576.07,1.0,70,1,2,1,4,0xb2d0d16d
2071.57,1.0,0,1,2,4,7,0xb2d599b8d
53.36,1.0,9,1,2,3,6,0xb2d38f3f
15011.95,1.0,14,2,2,3,7,0xb2d78e2ad
29.12,1.0,4,1,2,4,7,0xb2d251c9d
84936.6,2.0,0,3,3,4,10,0xb2d64a59d
249662.1,1.0,0,3,2,4,9,0xb2d2e00c
1430.51,1.0,184,1,2,1,4,0xb2d11a66d
439186.44,2.0,203,4,3,1,8,0xb2d69234
300012.69,2.0,39,3,3,2,8,0xb2d9686c
2007.53,1.0,39,1,2,2,5,0xb2d0e221
185000.4,3.0,4,3,4,4,11,0xb2d6a69bd
20024.12,2.0,216,2,3,1,6,0xb2d5f5f2
85086.63,4.0,136,3,4,1,8,0xb2d4bd03
22082.42,1.0,1,2,2,4,8,0xb2d6c065
1072.21,1.0,92,1,2,1,4,0xb2d53fd3d
305012.58,5.0,21,4,4,2,10,0xb2d63465d
1.26,1.0,23,1,2,2,5,0xb2d40573
0.35,1.0,184,1,2,1,4,0xb2d61a5c
1.62,1.0,53,1,2,2,5,0xb2d408e4
7169.1,1.0,10,2,2,3,7,0xb2d58662
576271.99,4.0,0,4,4,4,12,0xb2d333b4
3115.63,1.0,184,2,2,1,5,0xb2d0983fd
45046.7,3.0,118,2,4,1,7,0xb2d63441
266665.5,3.0,0,3,4,4,11,0xb2d37b43
1162156.0,5.0,3,4,4,4,12,0xb2d0cb6fd
10096.96,1.0,92,2,2,1,5,0xb2d63868
220076.71,4.0,86,3,4,1,8,0xb2d6e9f1d
568306.3,15.0,15,4,4,3,11,0xb2d19a70
1612.86,1.0,0,1,2,4,7,0xb2d9971a
240641.33,2.0,184,3,3,1,7,0xb2d5efb7d
50865.38,2.0,63,2,3,2,7,0xb2d686f6d
501228.09,4.0,26,4,4,2,10,0xb2d3b6d7d
150821.91,2.0,39,3,3,2,8,0xb2d3234a
3458.81,1.0,10,2,2,3,7,0xb2d9be37
54317.99,1.0,271,3,2,1,6,0xb2d4fd4bd
457998.25,2.0,174,4,3,1,8,0xb2d8d4b2d
360009.82,3.0,14,4,4,3,11,0xb2d8e186d
0.0,1.0,0,1,2,4,7,0xb2d20f8e
1.87,1.0,73,1,2,1,4,0xb2d53616
405692.61,3.0,20,4,4,2,10,0xb2d595b4d
500055.8,2.0,3,4,3,4,11,0xb2d682af
264006.37,3.0,29,3,4,2,9,0xb2d11079
762520.07,7.0,3,4,4,4,12,0xb2d5e37dd
113775.36,4.0,18,3,4,2,9,0xb2d515ff
304570.25,1.0,0,4,2,4,10,0xb2d323f4d
300056.18,2.0,6,3,3,3,9,0xb2d1a50ed
3108.14,1.0,12,2,2,3,7,0xb2d3efdcd
10214816.92,3.0,5,4,4,3,11,0xb2d2e934
661064.9,8.0,40,4,4,2,10,0xb2d59612
210002.11,3.0,27,3,4,2,9,0xb2d25e76d
260139.82,3.0,82,3,4,1,8,0xb2d5ad19d
7082.38,1.0,9,2,2,3,7,0xb2d26fbd
462785.58,4.0,34,4,4,2,10,0xb2d5dbc6d
3959002.93,7.0,33,4,4,2,10,0xb2d59174
50001.06,2.0,235,2,3,1,6,0xb2d6e784
105788.24,1.0,0,3,2,4,9,0xb2d12948
50084.9,2.0,133,2,3,1,6,0xb2d64a74
23.99,1.0,5,1,2,3,6,0xb2d981c6
721432.08,4.0,27,4,4,2,10,0xb2d7855dd
120165.45,2.0,17,3,3,2,8,0xb2d57e01d
395057.92,2.0,143,4,3,1,8,0xb2d58bba
3398.66,1.0,0,2,2,4,8,0xb2d22563
8.04,2.0,32,1,3,2,6,0xb2d37c5e
42.12,1.0,5,1,2,3,6,0xb2d6bacdd
4961.85,1.0,10,2,2,3,7,0xb2d3c365
368.99,1.0,0,1,2,4,7,0xb2d906ad
90261.57,4.0,0,3,4,4,11,0xb2d15b84
4497.09,1.0,19,2,2,2,6,0xb2d527dad
250734.58,3.0,104,3,4,1,8,0xb2d07b05
4675.46,1.0,176,2,2,1,5,0xb2d1067cd
410063.73,3.0,38,4,4,2,10,0xb2d5b6e8
9493.2,1.0,29,2,2,2,6,0xb2d77f50
1011.06,1.0,92,1,2,1,4,0xb2d18147d
10888.89,1.0,0,2,2,4,8,0xb2da5129
16049.48,2.0,184,2,3,1,6,0xb2d0dc2a
2259.97,2.0,0,1,3,4,8,0xb2d06878
20000.21,2.0,31,2,3,2,7,0xb2d93c6b
2695.05,1.0,7,1,2,3,6,0xb2d26391
500000.06,2.0,20,4,3,2,9,0xb2d78b41
4308.14,1.0,10,2,2,3,7,0xb2d95a79
56.29,2.0,88,1,3,1,5,0xb2d61c3c
200000.02,2.0,8,3,3,3,9,0xb2d92a61
130182.85,2.0,45,3,3,2,8,0xb2d31be8
11323.28,1.0,0,2,2,4,8,0xb2d6cf55
302986.01,9.0,3,4,4,4,12,0xb2d60e61
1030135.91,2.0,8,4,3,3,10,0xb2d6a227
108.55,1.0,9,1,2,3,6,0xb2d368d3
1231420.84,14.0,0,4,4,4,12,0xb2d0c4dd
3233585.66,14.0,0,4,4,4,12,0xb2d10ba8d
12078.89,1.0,1,2,2,4,8,0xb2d609fe
2692.24,1.0,184,1,2,1,4,0xb2d0adbbd
661810.1,5.0,4,4,4,4,12,0xb2d17536d
313304.32,2.0,93,4,3,1,8,0xb2d97feed
88417.93,1.0,9,3,2,3,8,0xb2d8d159
395.32,4.0,16,1,4,2,7,0xb2d2c31f
20014.81,1.0,37,2,2,2,6,0xb2d2cdd3
669.01,2.0,139,1,3,1,5,0xb2d16640
2007.21,1.0,184,1,2,1,4,0xb2d5d887
5673.11,1.0,302,2,2,1,5,0xb2d3d181d
90.92,1.0,73,1,2,1,4,0xb2d46f41
304000.79,6.0,3,4,4,4,12,0xb2d15657
30019.78,2.0,160,2,3,1,6,0xb2d61a1fd
251.33,1.0,10,1,2,3,6,0xb2d9bc30
506599.9,3.0,43,4,4,2,10,0xb2d67cc7
39.34,2.0,18,1,3,2,6,0xb2d94192
17444.78,1.0,0,2,2,4,8,0xb2d61fc3d
2.35,1.0,30,1,2,2,5,0xb2d63b5c
14.75,1.0,9,1,2,3,6,0xb2d7f6c9
397066.3,6.0,32,4,4,2,10,0xb2d25b79
10716877.94,21.0,4,4,4,4,12,0xb2d395e1d
1656.03,1.0,1,1,2,4,7,0xb2d70026
2232.99,2.0,184,1,3,1,5,0xb2d1f7a4d
50085.99,2.0,153,2,3,1,6,0xb2d287aa
15601.68,1.0,67,2,2,1,5,0xb2d57cda
437009.52,4.0,0,4,4,4,12,0xb2d588fe
494.5,1.0,2,1,2,4,7,0xb2d21f0bd
7056.42,2.0,91,2,3,1,6,0xb2d49462
130045.21,2.0,75,3,3,1,7,0xb2d37476
0.77,1.0,10,1,2,3,6,0xb2d5fb9e
1144074.04,6.0,196,4,4,1,9,0xb2d09547
615731.86,2.0,53,4,3,2,9,0xb2d695a4d
869544.65,3.0,108,4,4,1,9,0xb2d3b58a
1060.31,1.0,194,1,2,1,4,0xb2d15931d
704.98,1.0,0,1,2,4,7,0xb2d2c7c0
296438.56,3.0,15,3,4,3,10,0xb2d41477
284596.88,3.0,28,3,4,2,9,0xb2d6a41a
9258.35,1.0,7,2,2,3,7,0xb2d20c87
2092.74,1.0,0,1,2,4,7,0xb2d60988d
11148.7,1.0,9,2,2,3,7,0xb2d5c464
50045.54,2.0,27,2,3,2,7,0xb2d35717d
1043.56,1.0,184,1,2,1,4,0xb2d40b57d
3530.07,1.0,92,2,2,1,5,0xb2d298e4d
71001.2,2.0,3,3,3,4,10,0xb2d35a80
580158.69,6.0,0,4,4,4,12,0xb2d32d4cd
2483.92,1.0,143,1,2,1,4,0xb2d43828d
4739.72,1.0,10,2,2,3,7,0xb2d50b0d
510565.29,5.0,0,4,4,4,12,0xb2d6c4f5d
1.18,1.0,11,1,2,3,6,0xb2d8f1b5
23500.31,2.0,4,2,3,4,9,0xb2d30580
723.57,1.0,60,1,2,2,5,0xb2d6d2a1
1000267.84,3.0,26,4,4,2,10,0xb2d92507
1416.22,1.0,15,1,2,3,6,0xb2d31dda
2524.54,1.0,166,1,2,1,4,0xb2d5355cd
1211887.78,12.0,7,4,4,3,11,0xb2d12748d
316102.47,1.0,18,4,2,2,8,0xb2d53d48d
1347289.86,3.0,95,4,4,1,9,0xb2d0d516d
46735.46,1.0,0,2,2,4,8,0xb2d68326
4514050.12,34.0,2,4,4,4,12,0x3b9b3c6e
50003.02,2.0,24,2,3,2,7,0xb2d19d53
7201.49,1.0,139,2,2,1,5,0xb2d63933d
900860.76,5.0,0,4,4,4,12,0xb2d5d99cd
96.6,1.0,37,1,2,2,5,0xb2d6fa91
2731229.34,14.0,0,4,4,4,12,0xb2d1e4bc
168412.37,3.0,19,3,4,2,9,0xb2d5601fd
505330.55,2.0,24,4,3,2,9,0xb2d9504ad
418.79,1.0,0,1,2,4,7,0xb2d21104
21.43,1.0,19,1,2,2,5,0xb2d92e50
522044.86,3.0,0,4,4,4,12,0xb2d5f42a
207057.24,3.0,7,3,4,3,10,0x3b9b34b6d
581008.73,4.0,1,4,4,4,12,0xb2d6230a
348103.34,2.0,0,4,3,4,11,0xb2d9bb0e
1931.75,1.0,0,1,2,4,7,0xb2d342f1
82812.04,1.0,0,3,2,4,9,0xb2d29abad
17933.25,3.0,207,2,4,1,7,0xb2d2dff0d
660170.93,2.0,53,4,3,2,9,0xb2d3637cd
11374.63,2.0,0,2,3,4,9,0xb2d2694b
320161.15,2.0,15,4,3,3,10,0xb2d65929d
5931.51,1.0,18,2,2,2,6,0xb2d9e5f4
20157.61,1.0,184,2,2,1,5,0xb2d36d41
139.4,1.0,25,1,2,2,5,0xb2d6c63e
584.1,1.0,0,1,2,4,7,0xb2d1ea87d
93.22,1.0,84,1,2,1,4,0xb2d25fb7d
360227.26,7.0,18,4,4,2,10,0xb2d4eaa5
102775.41,2.0,2,3,3,4,10,0xb2d229b8
164.3,1.0,49,1,2,2,5,0xb2d37ce2
460021.38,2.0,34,4,3,2,9,0xb2d38a57d
2.11,1.0,75,1,2,1,4,0xb2d8e01bd
50240.34,2.0,31,2,3,2,7,0xb2d5952c
91368.66,2.0,263,3,3,1,7,0xb2d5feaf
140028.1,2.0,92,3,3,1,7,0xb2d2a986d
1121472.11,3.0,34,4,4,2,10,0xb2d5c30e
51470.66,1.0,81,2,2,1,5,0xb2d65d52d
158.76,1.0,13,1,2,3,6,0xb2d9dd9f
419881.33,2.0,0,4,3,4,11,0xb2d6042f
10000.21,2.0,74,2,3,1,6,0xb2d99c3f
667521.61,17.0,6,4,4,3,11,0xb2d0b525d
13464.77,1.0,16,2,2,2,6,0x3b9b31b8
254.84,1.0,20,1,2,2,5,0xb2d8ea7e
86500.0,3.0,3,3,4,4,11,0xb2d36455d
26750.0,12.0,0,2,4,4,10,0xb2d2e8e8d
1000.71,9.0,0,1,4,4,9,0x3b9b18f0
302135.02,3.0,92,4,4,1,9,0xb2d97e58d
14.5,1.0,81,1,2,1,4,0xb2d1326c
10945.68,2.0,0,2,3,4,9,0xb2d78a2cd
2801.09,1.0,1,1,2,4,7,0xb2d37173
10291.21,1.0,3,2,2,4,8,0xb2d16505
3175037.63,1.0,0,4,2,4,10,0xb2d39509d
11605.68,1.0,0,2,2,4,8,0xb2d6ad49
240882.86,3.0,182,3,4,1,8,0xb2d27cc3d
274.55,1.0,51,1,2,2,5,0xb2d999de
100000.1,1.0,4,3,2,4,9,0xb2d1071a
32567.91,1.0,11,2,2,3,7,0xb2d2b5d4
287000.0,2.0,20,3,3,2,8,0xb2d95521
463287.51,4.0,1,4,4,4,12,0xb2d560c8
11090.56,1.0,2,2,2,4,8,0xb2d2c8dc
52980.01,2.0,0,3,3,4,10,0xb2d9cc5b
3516.39,1.0,53,2,2,2,6,0xb2d3b97dd
971.23,3.0,0,1,4,4,9,0xb2d2110cd
4154.82,1.0,3,2,2,4,8,0xb2d69730
0.57,1.0,28,1,2,2,5,0xb2d5bf67
87176.98,6.0,0,3,4,4,11,0xb2d0e2f1d
1253.16,1.0,92,1,2,1,4,0xb2d3aa61d
300000.0,2.0,20,3,3,2,8,0xb2d953ea
150486.46,2.0,99,3,3,1,7,0xb2d17c84
13.05,1.0,21,1,2,2,5,0xb2d4130c
2.94,7.0,14,1,4,3,8,0xb2d0f44d
632324.88,7.0,0,4,4,4,12,0x3b9b36d9d
4.15,1.0,5,1,2,3,6,0xb2d9954a
109560.21,3.0,60,3,4,2,9,0xb2d34a14d
30002.76,2.0,27,2,3,2,7,0xb2d649f9
517426.2,1.0,0,4,2,4,10,0xb2d9f399
469159.62,8.0,0,4,4,4,12,0xb2d0daa3
2304.33,1.0,10,1,2,3,6,0xb2d48fb4
1822.89,2.0,0,1,3,4,8,0xb2d0d75c
249226.58,3.0,0,3,4,4,11,0xb2d94578
31044.19,3.0,0,2,4,4,10,0xb2d5539dd
962.58,1.0,10,1,2,3,6,0xb2d40aab
340620.36,11.0,0,4,4,4,12,0xb2d0a945d
177358.11,2.0,151,3,3,1,7,0xb2d4d928
303913.0,5.0,7,4,4,3,11,0xb2d0dbf2d
600710.42,13.0,3,4,4,4,12,0xb2d688f0d
71947.2,2.0,1,3,3,4,10,0xb2d51b07d
7136.66,2.0,0,2,3,4,9,0xb2d5e11d
1216.72,1.0,156,1,2,1,4,0xb2d31fd4
200808.43,3.0,17,3,4,2,9,0xb2d93cead
543879.76,2.0,0,4,3,4,11,0xb2d5931a
1575.71,1.0,92,1,2,1,4,0xb2d0a59ed
2025.76,1.0,184,1,2,1,4,0xb2d208dfd
266074.4,1.0,22,3,2,2,7,0xb2d35efc
350061.44,5.0,0,4,4,4,12,0xb2d6c20dd
2855127.99,7.0,17,4,4,2,10,0xb2d0c7ced
212395.05,4.0,21,3,4,2,9,0xb2d19e9ed
436.71,1.0,15,1,2,3,6,0xb2d9cc76
1336.61,6.0,8,1,4,3,8,0xb2d229d0
200000.0,2.0,14,3,3,3,9,0xb2d11625
230946.43,7.0,0,3,4,4,11,0x3b9af1b2
585052.63,7.0,18,4,4,2,10,0x3b9af1fe
570006.14,7.0,21,4,4,2,10,0xb2d07aeb
2033.6,1.0,184,1,2,1,4,0xb2d17781
5513.02,1.0,34,2,2,2,6,0xb2d1c6d6
220000.0,2.0,1,3,3,4,10,0xb2d6393e
149635.68,4.0,8,3,4,3,10,0xb2d1c0e1
20093.71,1.0,92,2,2,1,5,0xb2d09343d
110027.24,2.0,42,3,3,2,8,0xb2d612c0d
200010.22,3.0,10,3,4,3,10,0xb2d17523d
17.09,1.0,43,1,2,2,5,0xb2d38c76
1742.25,1.0,0,1,2,4,7,0xb2d3ff28
400726.11,3.0,0,4,4,4,12,0xb2d5b6fc
780742.37,5.0,4,4,4,4,12,0xb2d56bba
100036.34,2.0,112,3,3,1,7,0xb2d94d78
3546.89,1.0,24,2,2,2,6,0xb2d30c6d
15209.0,1.0,7,2,2,3,7,0xb2d6b4d9
20186.34,1.0,184,2,2,1,5,0xb2d204d6d
2332.63,2.0,184,1,3,1,5,0xb2d110d5d
30510.71,2.0,0,2,3,4,9,0xb2d2a7d5d
4258.28,1.0,184,2,2,1,5,0xb2d22c01d
153304.44,4.0,55,3,4,2,9,0xb2d61a59d
101855.17,1.0,27,3,2,2,7,0xb2d6355dd
600017.66,4.0,3,4,4,4,12,0xb2d19b1b
250083.37,2.0,92,3,3,1,7,0xb2d11928
392957.06,5.0,1,4,4,4,12,0xb2d3f20d
405.34,1.0,20,1,2,2,5,0xb2d53642
25661.29,34.0,0,2,4,4,10,0x3b9b30d8d
150000.0,2.0,0,3,3,4,10,0xb2d553a5
5366.67,1.0,184,2,2,1,5,0xb2d13ab2
193015.14,6.0,0,3,4,4,11,0xb2d5a689
412161.4,4.0,0,4,4,4,12,0x3b9b38fdd
803605.59,3.0,83,4,4,1,9,0xb2d12649
11360.05,1.0,5,2,2,3,7,0xb2d6158ed
203555.09,2.0,182,3,3,1,7,0xb2d8c757
60004.75,2.0,209,3,3,1,7,0xb2d5adc8d
2278.99,1.0,10,1,2,3,6,0xb2d3f63dd
350017.39,3.0,1,4,4,4,12,0xb2d91c29d
1315.08,8.0,0,1,4,4,9,0x3b9b252dd
250022.67,2.0,0,3,3,4,10,0xb2d142eed
576818.5,4.0,1,4,4,4,12,0xb2d2b384
511555.1,2.0,157,4,3,1,8,0xb2d241dfd
100.0,1.0,6,1,2,3,6,0xb2d1f19c
180036.55,2.0,129,3,3,1,7,0xb2d36921
15.24,2.0,84,1,3,1,5,0xb2d64532
456005.47,10.0,5,4,4,3,11,0xb2d57388d
2663666.24,3.0,63,4,4,2,10,0xb2d3fe29
10085.33,1.0,92,2,2,1,5,0xb2d2a55c
170049.14,3.0,0,3,4,4,11,0xb2d5d815d
743.89,1.0,23,1,2,2,5,0xb2d2fd38
7034.42,1.0,0,2,2,4,8,0xb2d69103
1374.67,1.0,20,1,2,2,5,0xb2d2bce9d
135046.09,4.0,0,3,4,4,11,0xb2d64c58d
1384928.4,5.0,27,4,4,2,10,0xb2d2475f
518.84,1.0,5,1,2,3,6,0xb2d12474
388015.96,6.0,8,4,4,3,11,0xb2d0ed14
771281.77,9.0,15,4,4,3,11,0xb2d1099d
150004.78,4.0,6,3,4,3,10,0xb2d93ed6d
7659.45,1.0,2,2,2,4,8,0xb2d62469
130589.53,3.0,18,3,4,2,9,0xb2d2611dd
47.76,1.0,12,1,2,3,6,0xb2d509bb
248.43,1.0,9,1,2,3,6,0xb2d2ceb0
707.87,1.0,29,1,2,2,5,0xb2d4a364d
265979.74,2.0,42,3,3,2,8,0xb2d229ddd
208135.42,1.0,11,3,2,3,8,0xb2d93abc
855080.31,12.0,0,4,4,4,12,0xb2d5bd73
55002.32,2.0,55,3,3,2,8,0xb2d901b0
6.76,1.0,25,1,2,2,5,0xb2d8ce33d
350005.63,3.0,19,4,4,2,10,0xb2d5e7fc
59237.9,2.0,82,3,3,1,7,0xb2d28b3fd
42912.53,1.0,0,2,2,4,8,0xb2d21301
1532.32,1.0,1,1,2,4,7,0xb2d700a3
444395.46,3.0,38,4,4,2,10,0xb2d57999d
319000.49,9.0,5,4,4,3,11,0xb2d55a49
400123.93,5.0,1,4,4,4,12,0xb2d62379
4642.32,1.0,0,2,2,4,8,0xb2d42e77
271536.32,2.0,122,3,3,1,7,0xb2d3668fd
501.41,1.0,0,1,2,4,7,0xb2d5bdb5
2119.53,1.0,184,1,2,1,4,0xb2d1da1b
151.86,3.0,39,1,4,2,7,0xb2d1fbafd
52866.4,1.0,6,3,2,3,8,0xb2d622ef
20696.78,1.0,3,2,2,4,8,0xb2d5bb30d
385000.81,4.0,2,4,4,4,12,0xb2d1dde9d
9860.61,1.0,2,2,2,4,8,0xb2d55cc4
20217.68,1.0,184,2,2,1,5,0xb2d20c4b
384007.61,8.0,0,4,4,4,12,0xb2d17f77
94328.62,1.0,1,3,2,4,9,0xb2d17374
100007.63,7.0,4,3,4,4,11,0xb2d957c1d
100750.46,2.0,128,3,3,1,7,0xb2d3187dd
2713.39,1.0,0,1,2,4,7,0xb2d685ad
153251.37,2.0,179,3,3,1,7,0xb2d3bd24d
1455.9,1.0,10,1,2,3,6,0xb2d2cfd6
90032.49,5.0,27,3,4,2,9,0xb2d5ac44d
204002.15,2.0,59,3,3,2,8,0xb2d8ff24
1453215.57,7.0,26,4,4,2,10,0xb2d24eb9
60000.63,2.0,32,3,3,2,8,0xb2da045b
100000.0,2.0,0,3,3,4,10,0xb2d97e1ed
170003.17,5.0,52,3,4,2,9,0xb2d80e88d
8418.59,1.0,168,2,2,1,5,0xb2d6bea2
700000.0,3.0,8,4,4,3,11,0xb2da09f5
37564.32,1.0,0,2,2,4,8,0xb2d15b2e
2316.48,1.0,184,1,2,1,4,0xb2d159fe
143297.52,8.0,0,3,4,4,11,0xb2d0b5a6d
0.75,1.0,0,1,2,4,7,0xb2d3f0cc
10000.0,2.0,6,2,3,3,8,0xb2da4c17
857.25,1.0,16,1,2,2,5,0xb2d496b1
3104.54,1.0,11,2,2,3,7,0xb2d553a3d
230029.0,3.0,0,3,4,4,11,0xb2d959ce
30506.4,3.0,92,2,4,1,7,0x3b9b2ec3
530075.38,3.0,193,4,4,1,9,0xb2d5fa94
2000021.11,5.0,8,4,4,3,11,0xb2da4114
2503.91,2.0,184,1,3,1,5,0x3b9adb72d
15046.6,1.0,1,2,2,4,8,0xb2d2040f
2869.48,1.0,4,1,2,4,7,0xb2d43615
200713.84,3.0,31,3,4,2,9,0xb2d16855
16979.42,1.0,5,2,2,3,7,0xb2d61edad
1445.97,1.0,14,1,2,3,6,0xb2d6aa0a
300002.32,3.0,140,3,4,1,8,0xb2d074df
103143.4,1.0,11,3,2,3,8,0xb2d2ef32d
121802.29,3.0,0,3,4,4,11,0xb2d07436
202603.99,2.0,6,3,3,3,9,0xb2d43700
11772.72,1.0,184,2,2,1,5,0xb2d2646b
284487.57,4.0,96,3,4,1,8,0xb2d60b99
686449.2,4.0,136,4,4,1,9,0xb2d36616d
275022.56,3.0,124,3,4,1,8,0xb2d0b79bd
11.96,1.0,74,1,2,1,4,0xb2d0a8b9
20000.42,3.0,45,2,4,2,8,0xb2d9183dd
305479.96,7.0,0,4,4,4,12,0xb2d068c2
2.16,1.0,51,1,2,2,5,0xb2d658a7
80025.56,2.0,186,3,3,1,7,0xb2d1c2d8d
634810.82,10.0,1,4,4,4,12,0x3b9b187fd
100004.23,3.0,188,3,4,1,8,0xb2d32ffdd
38059.73,1.0,7,2,2,3,7,0xb2d2a07c
2935.57,1.0,184,2,2,1,5,0xb2d216dbd
1220000.0,14.0,5,4,4,3,11,0xb2d59bce
726089.84,2.0,139,4,3,1,8,0xb2d53c62
150.89,2.0,10,1,3,3,7,0x3b9b2c21
4729.17,1.0,8,2,2,3,7,0xb2d284d3
292418.24,4.0,2,3,4,4,11,0xb2d598d0
6286.05,3.0,0,2,4,4,10,0x3b9b1571
7411.3,1.0,19,2,2,2,6,0xb2d1c300
144317.71,3.0,6,3,4,3,10,0xb2d5dd9b
448410.16,1.0,70,4,2,1,7,0xb2d288e9d
130117.68,2.0,168,3,3,1,7,0xb2d1b8b0
1410037.31,6.0,4,4,4,4,12,0xb2d260fa
687599.82,5.0,0,4,4,4,12,0xb2d24ab2
53.5,1.0,58,1,2,2,5,0xb2d6892b
590051.39,8.0,24,4,4,2,10,0xb2d7eedc
570.51,1.0,69,1,2,1,4,0xb2d65673
120011.79,3.0,210,3,4,1,8,0xb2d556fd
10951.08,1.0,83,2,2,1,5,0xb2d44d42
555686.75,2.0,63,4,3,2,9,0xb2d39c51d
6000.19,2.0,7,2,3,3,8,0xb2d16bf8
4759.07,1.0,92,2,2,1,5,0xb2d2df07d
4250.3,2.0,4,2,3,4,9,0xb2d07417
541101.25,6.0,39,4,4,2,10,0xb2d51866
500000.0,3.0,0,4,4,4,12,0xb2d93257d
188624.24,3.0,7,3,4,3,10,0xb2d6f38f
95.92,4.0,0,1,4,4,9,0xb2d092fc
5672.52,1.0,92,2,2,1,5,0xb2d1b451d
4552.28,1.0,18,2,2,2,6,0xb2d32dd4
350180.83,2.0,7,4,3,3,10,0xb2d142f9
400027.62,2.0,11,4,3,3,10,0xb2d3dd0cd
4349.59,1.0,4,2,2,4,8,0xb2d3589d
2830000.0,10.0,0,4,4,4,12,0xb2d40091
20579.58,1.0,15,2,2,3,7,0xb2d60a02
90007.31,3.0,66,3,4,2,9,0xb2d64d10
17.61,1.0,8,1,2,3,6,0xb2d79138
550000.11,4.0,0,4,4,4,12,0xb2d6a2cad
28395.36,3.0,9,2,4,3,9,0xb2d509d0
9232.46,1.0,92,2,2,1,5,0xb2d34de7
779.27,1.0,0,1,2,4,7,0xb2d4b352d
2099.38,1.0,184,1,2,1,4,0xb2d0fc60d
80.19,2.0,8,1,3,3,7,0xb2d6f4db
520096.1,3.0,4,4,4,4,12,0xb2d955f0
710405.85,4.0,11,4,4,3,11,0xb2d29100
200122.82,2.0,1,3,3,4,10,0xb2d3a8c7
369000.0,3.0,4,4,4,4,12,0xb2da5668
17743.44,1.0,0,2,2,4,8,0xb2d56443d
5201.61,1.0,7,2,2,3,7,0xb2d2b5e9
1002329.23,4.0,45,4,4,2,10,0xb2d0d2ee
3336.69,1.0,18,2,2,2,6,0xb2d2f8c7
398938.59,3.0,0,4,4,4,12,0xb2d54869d
60244.67,4.0,185,3,4,1,8,0xb2d16450d
1512.79,1.0,0,1,2,4,7,0xb2d26e1bd
135900.0,3.0,5,3,4,3,10,0xb2d1facfd
6420.24,1.0,0,2,2,4,8,0xb2d31965d
100067.14,2.0,10,3,3,3,9,0xb2d78a10
0.0,1.0,0,1,2,4,7,0xb2d1c06c
103051.71,3.0,174,3,4,1,8,0xb2d1d0b6d
51990.66,1.0,132,2,2,1,5,0xb2d55f90d
2047.62,1.0,184,1,2,1,4,0xb2d1eeb1d
1410.58,1.0,131,1,2,1,4,0xb2d4685e
240.94,1.0,20,1,2,2,5,0xb2d4cf1a
1407.82,1.0,184,1,2,1,4,0xb2d1c3d3d
49.4,2.0,56,1,3,2,6,0xb2d3caa8
487000.0,16.0,0,4,4,4,12,0xb2d0cd40d
370026.3,2.0,179,4,3,1,8,0xb2d4e808
3464.57,1.0,92,2,2,1,5,0xb2d2179c
55829.65,1.0,216,3,2,1,6,0xb2d0ebe3
5970.01,1.0,4,2,2,4,8,0xb2d65e9d
93046.93,4.0,41,3,4,2,9,0xb2d5f14fd
661250.99,5.0,32,4,4,2,10,0xb2d0a972
43000.02,2.0,0,2,3,4,9,0xb2da3de0
5968.1,1.0,5,2,2,3,7,0xb2d1faf4
12.8,1.0,4,1,2,4,7,0xb2d0b767
50000.53,2.0,80,2,3,1,6,0xb2d8d225
3017.94,1.0,92,2,2,1,5,0xb2d23d0cd
9627.73,1.0,11,2,2,3,7,0xb2d8da5bd
9897.16,1.0,184,2,2,1,5,0xb2d1b0b0
2113382.34,19.0,0,4,4,4,12,0xb2d415ec
20027.08,1.0,54,2,2,2,6,0xb2d2bdf8
420000.0,1.0,1,4,2,4,10,0xb2da66d5
250503.63,5.0,34,3,4,2,9,0xb2d78174
160026.81,3.0,10,3,4,3,10,0xb2d520ead
324045.82,3.0,102,4,4,1,9,0xb2d17793d
270138.03,9.0,1,3,4,4,11,0xb2d0de29
556167.36,4.0,0,4,4,4,12,0xb2d34d0b
100319.94,3.0,11,3,4,3,10,0xb2d2efdcd
404308.99,2.0,58,4,3,2,9,0xb2d22af2
10007.49,1.0,81,2,2,1,5,0xb2d98daa
2.78,1.0,55,1,2,2,5,0xb2d11326
13.83,1.0,75,1,2,1,4,0xb2d1a6c9
508886.17,2.0,75,4,3,1,8,0xb2d8e477
51006.05,2.0,47,2,3,2,7,0xb2d5c203d
4.74,1.0,2,1,2,4,7,0xb2d37c61
880000.0,2.0,2,4,3,4,11,0xb2d28adb
17.35,1.0,7,1,2,3,6,0xb2d68077
268.34,1.0,1,1,2,4,7,0xb2d6de08
175.72,1.0,6,1,2,3,6,0xb2d2d5bbd
2033.95,1.0,238,1,2,1,4,0xb2d610c6
81.74,1.0,25,1,2,2,5,0xb2d90d47
101279.91,5.0,1,3,4,4,11,0xb2d49e22d
30.11,1.0,1,1,2,4,7,0xb2d683b9d
2077.92,1.0,184,1,2,1,4,0xb2d15dfb
500000.0,2.0,1,4,3,4,11,0xb2da0359
40001.29,2.0,101,2,3,1,6,0xb2d29ee0
1060053.2,11.0,4,4,4,4,12,0xb2d0b251
1101039.97,1.0,1,4,2,4,10,0xb2d212f2
12004.46,1.0,0,2,2,4,8,0xb2d32dcf
1424.11,1.0,0,1,2,4,7,0xb2d20acc
300328.41,2.0,3,4,3,4,11,0xb2d6d8ea
1.84,1.0,59,1,2,2,5,0xb2d584fb
15013.85,2.0,83,2,3,1,6,0xb2d56a4f
7100.57,2.0,5,2,3,3,8,0xb2d258d9
21218.47,1.0,92,2,2,1,5,0xb2d17bad
985.44,1.0,0,1,2,4,7,0xb2d69788
605095.42,5.0,7,4,4,3,11,0xb2d1529e
21415.72,1.0,113,2,2,1,5,0xb2d19f92
1063.04,1.0,14,1,2,3,6,0xb2d1646a
15162.42,1.0,89,2,2,1,5,0xb2d3c28ad
36.16,1.0,54,1,2,2,5,0xb2d30e07
20006.08,1.0,10,2,2,3,7,0xb2d5d2e9d
101696.87,2.0,41,3,3,2,8,0xb2d90e0a
10011.98,1.0,113,2,2,1,5,0xb2d78b14
2002.32,1.0,120,1,2,1,4,0xb2d9415c
80018.64,2.0,1,3,3,4,10,0xb2d13d95d
8747.55,1.0,2,2,2,4,8,0xb2d5168cd
257371.59,3.0,39,3,4,2,9,0xb2d07b05d
4767.53,1.0,92,2,2,1,5,0xb2d2b3ca
259.33,1.0,1,1,2,4,7,0xb2d78dab
88226.03,2.0,67,3,3,1,7,0xb2d0e1c2d
1971.16,1.0,92,1,2,1,4,0xb2d21a2ed
16000.0,2.0,3,2,3,4,9,0xb2d97681
2199.41,2.0,92,1,3,1,5,0xb2d094c6d
4505.57,1.0,0,2,2,4,8,0xb2d21360
62.73,1.0,7,1,2,3,6,0xb2d6f402d
1070.99,1.0,0,1,2,4,7,0xb2d0ef36
1131.92,1.0,92,1,2,1,4,0xb2d1ce27d
341004.63,2.0,93,4,3,1,8,0xb2d30be8
126495.36,7.0,1,3,4,4,11,0xb2d53c6b
600061.79,2.0,27,4,3,2,9,0xb2d23992d
402239.74,3.0,41,4,4,2,10,0xb2d6d93e
1007143.3,2.0,58,4,3,2,9,0xb2d15f06
643601.87,8.0,4,4,4,4,12,0xb2d4a58cd
1051.99,1.0,16,1,2,2,5,0xb2d21839
500004.21,2.0,12,4,3,3,10,0xb2d922f0d
653680.79,2.0,3,4,3,4,11,0xb2d152aa
11092.97,1.0,92,2,2,1,5,0xb2d2eaf9d
452331.39,8.0,12,4,4,3,11,0xb2d29692d
250660.86,3.0,56,3,4,2,9,0xb2d0d1c8d
0.0,1.0,184,1,2,1,4,0xb2d5264bd
15.66,1.0,70,1,2,1,4,0xb2d33474
1005.35,1.0,214,1,2,1,4,0xb2d31d80
597946.27,11.0,3,4,4,4,12,0xb2d0d643
120004.05,4.0,11,3,4,3,10,0xb2d55ae5
1000008.42,2.0,22,4,3,2,9,0xb2d2dce3
118595.27,1.0,4,3,2,4,9,0xb2d5c0a5d
193607.2,4.0,1,3,4,4,11,0xb2d591ab
0.0,1.0,8,1,2,3,6,0xb2d77f2b
3.23,1.0,104,1,2,1,4,0xb2d37ab8d
1483.83,2.0,7,1,3,3,7,0xb2d1a63a
156087.06,2.0,214,3,3,1,7,0xb2d5dc0d
60691.62,1.0,3,3,2,4,9,0xb2d7a699
2474.22,1.0,0,1,2,4,7,0xb2d323f9d
1153625.18,5.0,140,4,4,1,9,0xb2d08310
1519.07,1.0,92,1,2,1,4,0xb2d3dc17d
159504.39,2.0,25,3,3,2,8,0xb2d50ce7
1631.02,1.0,7,1,2,3,6,0xb2d58476
933501.48,6.0,5,4,4,3,11,0xb2d0e650d
3756.34,1.0,0,2,2,4,8,0xb2d5c612
20000.21,2.0,116,2,3,1,6,0xb2d1fbc2d
468000.0,3.0,14,4,4,3,11,0xb2d9580bd
1054.74,1.0,184,1,2,1,4,0xb2d151dd
80383.06,4.0,80,3,4,1,8,0xb2d58f94d
505494.17,2.0,24,4,3,2,9,0xb2d68507d
109905.41,1.0,0,3,2,4,9,0xb2d5546e
1647.8,1.0,22,1,2,2,5,0xb2d91cbd
237832.81,6.0,21,3,4,2,9,0xb2d2a647
64.84,1.0,89,1,2,1,4,0xb2d5786e
355080.88,2.0,76,4,3,1,8,0xb2d65c43
300036.22,2.0,5,3,3,3,9,0xb2d11d89
1.06,1.0,12,1,2,3,6,0xb2d95e76
120330.97,2.0,153,3,3,1,7,0xb2d6167ed
42910.53,1.0,9,2,2,3,7,0xb2d68c08
42.75,1.0,11,1,2,3,6,0xb2d6e103d
1026.93,1.0,184,1,2,1,4,0xb2d21994d
3127.84,1.0,0,2,2,4,8,0xb2d28f7e
20169.59,1.0,41,2,2,2,6,0xb2d90b66
412992.65,2.0,24,4,3,2,9,0xb2d50804d
513932.14,2.0,1,4,3,4,11,0xb2d5edc3
9161.78,1.0,0,2,2,4,8,0xb2d534e0
1269.8,1.0,92,1,2,1,4,0xb2d22cba
186300.13,5.0,42,3,4,2,9,0xb2d65be2
96.01,1.0,14,1,2,3,6,0xb2d0d260
2000121.11,3.0,1,4,4,4,12,0xb2d9f8f9
60855.49,1.0,33,3,2,2,7,0xb2d317ea
1426.64,1.0,1,1,2,4,7,0xb2d2c3c0
129474.68,2.0,0,3,3,4,10,0xb2d906bc
151152.59,3.0,20,3,4,2,9,0xb2d6072ad
24.72,1.0,98,1,2,1,4,0xb2d64b62d
280095.27,5.0,11,3,4,3,10,0x3b9b33cdd
85450.74,2.0,77,3,3,1,7,0xb2d20bfad
3750.98,1.0,20,2,2,2,6,0xb2d9b911
400000.49,2.0,11,4,3,3,10,0xb2d8e04ad
51195.14,1.0,230,2,2,1,5,0xb2d2b3d4
2624.73,1.0,1,1,2,4,7,0xb2d40626
1.99,1.0,7,1,2,3,6,0xb2d5e041d
2053.74,1.0,6,1,2,3,6,0xb2d25a00
114154.09,2.0,217,3,3,1,7,0xb2d38c06d
416000.0,14.0,1,4,4,4,12,0xb2d5af1f
2.7,1.0,60,1,2,2,5,0xb2d8da74
216000.0,2.0,22,3,3,2,8,0xb2da2033
1169.8,1.0,92,1,2,1,4,0xb2d266a2
2162.26,1.0,63,1,2,2,5,0xb2d0a21fd
120735.31,3.0,158,3,4,1,8,0xb2d5db4ad
700000.0,4.0,4,4,4,4,12,0xb2d71884
1468.68,1.0,11,1,2,3,6,0xb2d181a6
5790.79,1.0,14,2,2,3,7,0xb2d0a461
150277.75,2.0,41,3,3,2,8,0xb2d3711e
354296.15,5.0,19,4,4,2,10,0xb2d59dee
42.22,1.0,90,1,2,1,4,0xb2d8a6da
57446.56,2.0,216,3,3,1,7,0x3b9b4828
135443.34,6.0,0,3,4,4,11,0xb2d5e541
2956.4,1.0,6,2,2,3,7,0xb2d74729
1344311.18,7.0,0,4,4,4,12,0x3b9b185dd
100000.0,1.0,1,3,2,4,9,0xb2da6967
730869.64,3.0,0,4,4,4,12,0xb2d62370
1170.36,1.0,184,1,2,1,4,0xb2d3372b
460106.26,3.0,132,4,4,1,9,0xb2d0df03
600000.0,2.0,7,4,3,3,10,0xb2d96e79d
478694.64,2.0,57,4,3,2,9,0xb2d9c75d
60001.42,3.0,39,3,4,2,9,0xb2d5fa82
200005.13,2.0,2,3,3,4,10,0xb2d6db89
55.32,1.0,18,1,2,2,5,0xb2d25934
10.17,1.0,19,1,2,2,5,0xb2d1040dd
1093952.73,6.0,0,4,4,4,12,0xb2d072d4d
6219.69,1.0,0,2,2,4,8,0xb2d6a1fa
469.25,2.0,6,1,3,3,7,0x3b9b2719d
200166.09,2.0,0,3,3,4,10,0xb2d200e1d
6817.0,1.0,0,2,2,4,8,0xb2d6282ad
100017.17,3.0,175,3,4,1,8,0xb2d2cdd0
4127.17,1.0,15,2,2,3,7,0xb2d98594
5003.43,1.0,74,2,2,1,5,0xb2d8e59ed
200000.0,2.0,8,3,3,3,9,0xb2d951e1
212011.98,5.0,0,3,4,4,11,0xb2d5e34fd
100000.0,5.0,9,3,4,3,10,0xb2d26087
808721.22,3.0,3,4,4,4,12,0xb2d256fad
137000.0,6.0,1,3,4,4,11,0x3b9b45e1
300066.16,3.0,8,3,4,3,10,0xb2d26cea
39.9,1.0,35,1,2,2,5,0xb2d8d641
12438.6,1.0,40,2,2,2,6,0xb2d8818d
17006.62,2.0,6,2,3,3,8,0xb2d20a6dd
0.63,1.0,3,1,2,4,7,0xb2d60142
5987.9,1.0,11,2,2,3,7,0xb2d3ed10
1962.81,1.0,18,1,2,2,5,0xb2d8da9a
12659.93,1.0,14,2,2,3,7,0xb2d6e87a
120.66,1.0,12,1,2,3,6,0xb2d3ae68
102307.15,2.0,34,3,3,2,8,0xb2d14337d
990000.98,5.0,0,4,4,4,12,0x3b9b3ffb
1210.54,1.0,9,1,2,3,6,0xb2d737db
2107.26,1.0,1,1,2,4,7,0xb2d6b862
210001.88,2.0,14,3,3,3,9,0xb2d99f40
81635.04,1.0,0,3,2,4,9,0xb2d6d715d
31696.65,1.0,122,2,2,1,5,0xb2d3ca1ad
375194.78,3.0,26,4,4,2,10,0xb2d539fad
15048.31,3.0,92,2,4,1,7,0xb2d97f76
53482.77,2.0,143,3,3,1,7,0xb2d5875b
750017.43,3.0,97,4,4,1,9,0xb2d8ed04
1706.76,1.0,7,1,2,3,6,0xb2d2e3a2
70013.94,3.0,164,3,4,1,8,0xb2d6004dd
332392.43,2.0,13,4,3,3,10,0xb2d411f4d
381012.27,3.0,2,4,4,4,12,0xb2d8ea66d
81022.13,2.0,94,3,3,1,7,0xb2d10aee
7840.92,1.0,2,2,2,4,8,0xb2d5beb8d
444.13,1.0,41,1,2,2,5,0xb2d37c0f
8810.17,1.0,2,2,2,4,8,0xb2d3193a
2860.83,1.0,12,1,2,3,6,0xb2d3904d
150002.64,3.0,122,3,4,1,8,0xb2d5ce66
101254.05,1.0,75,3,2,1,6,0xb2d6bb02
692936.71,7.0,55,4,4,2,10,0xb2d42270
205022.83,2.0,0,3,3,4,10,0xb2d9161c
31022.24,1.0,4,2,2,4,8,0xb2d39911
1576.13,1.0,92,1,2,1,4,0xb2d0827ed
100145.79,2.0,82,3,3,1,7,0xb2d175a9d
1170000.34,4.0,154,4,4,1,9,0xb2d194ed
1799.57,2.0,92,1,3,1,5,0xb2d22eae
300005.28,3.0,17,3,4,2,9,0xb2d913dad
2.38,3.0,50,1,4,2,7,0xb2d2872ad
5443.13,1.0,14,2,2,3,7,0xb2d56bc0
5956.11,1.0,20,2,2,2,6,0xb2d8c85cd
371100.11,4.0,74,4,4,1,9,0xb2d0bf69d
1500026.43,3.0,108,4,4,1,9,0xb2d1c292d
2.98,1.0,61,1,2,2,5,0xb2d3ea2ed
69.01,2.0,9,1,3,3,7,0xb2d7552f
230011.95,8.0,39,3,4,2,9,0xb2d56afd
387.32,1.0,5,1,2,3,6,0xb2d24c16
30150.0,1.0,3,2,2,4,8,0xb2d717c3
27614.27,1.0,3,2,2,4,8,0xb2d0f3cc
147.3,1.0,88,1,2,1,4,0xb2d6a9ac
2493000.0,16.0,0,4,4,4,12,0xb2d069d5d
82331.28,3.0,27,3,4,2,9,0xb2d56ccf
1016.32,1.0,92,1,2,1,4,0xb2d0ddd6
151000.0,7.0,4,3,4,4,11,0xb2d96904
1665.77,1.0,9,1,2,3,6,0xb2d23af9
290050.16,3.0,39,3,4,2,9,0xb2d532dd
10.48,1.0,19,1,2,2,5,0xb2d0eac8
530002.45,4.0,3,4,4,4,12,0xb2d908fd
605732.79,3.0,0,4,4,4,12,0xb2d4085d
150474.92,5.0,112,3,4,1,8,0xb2d649fed
20.59,3.0,90,1,4,1,6,0xb2d86c10d
285820.89,3.0,0,3,4,4,11,0xb2d4d910d
503310.33,2.0,16,4,3,2,9,0xb2d9509f
4387.84,1.0,7,2,2,3,7,0xb2d9acac
45000.0,2.0,3,2,3,4,9,0xb2d9476a
57.38,1.0,1,1,2,4,7,0xb2d632f8
1000001.79,4.0,20,4,4,2,10,0xb2d08944d
945050.71,5.0,34,4,4,2,10,0xb2d2ae76d
95023.53,2.0,22,3,3,2,8,0xb2d1caa3d
1480014.06,7.0,8,4,4,3,11,0xb2d45068
30073.68,2.0,6,2,3,3,8,0xb2d550c2d
1100007.24,12.0,0,4,4,4,12,0xb2d40145
58501.27,5.0,0,3,4,4,11,0xb2d3119f
26.9,1.0,39,1,2,2,5,0xb2d1fa38
713098.38,6.0,133,4,4,1,9,0xb2d102ced
207773.2,1.0,82,3,2,1,6,0xb2d5a601
91333.76,4.0,4,3,4,4,11,0xb2d63b28
250000.0,2.0,21,3,3,2,8,0xb2d951c0
23987.26,1.0,92,2,2,1,5,0xb2d2c873
2.08,2.0,1,1,3,4,8,0xb2d0e22f
1.7,1.0,19,1,2,2,5,0xb2d3afb6d
36143.6,1.0,3,2,2,4,8,0xb2d95d6b
1450008.48,5.0,20,4,4,2,10,0xb2d63741
2438183.23,3.0,28,4,4,2,10,0xb2d08ed2d
2.93,1.0,11,1,2,3,6,0xb2d14f58d
60.56,1.0,184,1,2,1,4,0xb2d28a22d
19783.7,2.0,1,2,3,4,9,0xb2d197a1
61.23,2.0,60,1,3,2,6,0xb2d89003
112000.0,1.0,1,3,2,4,9,0xb2da6991
826729.33,22.0,0,4,4,4,12,0x3b9b38dfd
1264584.87,4.0,19,4,4,2,10,0xb2d3314fd
82.69,1.0,56,1,2,2,5,0xb2d52108d
40095.04,3.0,6,2,4,3,9,0xb2d65578
506.79,1.0,10,1,2,3,6,0xb2d8dba2
37726.76,1.0,184,2,2,1,5,0xb2d29acb
20138.27,1.0,92,2,2,1,5,0xb2d36d41d
400000.0,2.0,11,4,3,3,10,0xb2da4ba4
15748.19,1.0,92,2,2,1,5,0xb2d104b6d
53434.21,2.0,118,3,3,1,7,0xb2d2340d
636892.5,9.0,13,4,4,3,11,0xb2d4fb93d
42171.69,1.0,18,2,2,2,6,0xb2d34049
20164.86,2.0,104,2,3,1,6,0xb2d63742
1974.01,1.0,0,1,2,4,7,0xb2d6bddf
102347.93,2.0,45,3,3,2,8,0xb2d3825a
279647.52,8.0,0,3,4,4,11,0x3b9b1276
20298.43,3.0,31,2,4,2,8,0xb2d5727b
378718.34,6.0,8,4,4,3,11,0x3b9b3bd5
172.59,1.0,4,1,2,4,7,0xb2d5ceb7
314.49,1.0,11,1,2,3,6,0xb2d3a5fb
16920.31,1.0,188,2,2,1,5,0xb2d5c7b1
1664508.8,3.0,0,4,4,4,12,0xb2d18a96d
370349.23,5.0,13,4,4,3,11,0xb2d209f2
200243.14,2.0,14,3,3,3,9,0xb2d5eb82
4283989.86,17.0,3,4,4,4,12,0xb2d62b58
45007.28,2.0,6,2,3,3,8,0xb2d0bf13
244.08,1.0,21,1,2,2,5,0xb2d554dd
30208.0,2.0,12,2,3,3,8,0xb2d9d75d
77803.53,1.0,0,3,2,4,9,0xb2d0e732d
75159.23,2.0,92,3,3,1,7,0xb2d34d56d
50053.76,2.0,39,2,3,2,7,0xb2d521ebd
346153.95,7.0,4,4,4,4,12,0xb2d3e2bf
26.42,1.0,53,1,2,2,5,0xb2d6d135
1527.24,1.0,0,1,2,4,7,0xb2d9b2f2
620295.97,4.0,60,4,4,2,10,0xb2d5b44c
200026.22,5.0,0,3,4,4,11,0xb2d2c33a
200000.0,2.0,7,3,3,3,9,0xb2d9640ad
0.02,1.0,14,1,2,3,6,0xb2d56884d
85020.04,2.0,76,3,3,1,7,0xb2d68dc4
3473.79,1.0,2,2,2,4,8,0xb2d5e42b
116402.51,1.0,29,3,2,2,7,0xb2d6bb3ed
904848.83,4.0,11,4,4,3,11,0xb2d3a3d5d
855.05,1.0,39,1,2,2,5,0xb2d356c7
32.17,1.0,80,1,2,1,4,0xb2d090c1
1520784.77,8.0,0,4,4,4,12,0xb2d42ad7
32523.88,1.0,0,2,2,4,8,0xb2d6c200
300141.12,2.0,27,4,3,2,9,0xb2d6e171
500000.0,2.0,10,4,3,3,10,0xb2d96b1b
460000.1,3.0,13,4,4,3,11,0xb2d633a1d
808.16,1.0,69,1,2,1,4,0xb2d1b52f
137397.86,2.0,10,3,3,3,9,0xb2d2f7d9
2878523.68,1.0,5,4,2,3,9,0xb2d6c34f
875195.44,5.0,13,4,4,3,11,0xb2d572c7
634003.53,3.0,14,4,4,3,11,0xb2da3988
27314.77,1.0,0,2,2,4,8,0xb2d2bfd5d
50833.49,1.0,4,2,2,4,8,0xb2d1a163
300031.67,2.0,42,3,3,2,8,0xb2d96bb3
9903.17,1.0,7,2,2,3,7,0xb2d9ee6b
1972.65,1.0,16,1,2,2,5,0xb2d697acd
81786.84,2.0,11,3,3,3,9,0xb2d65972
2280.88,1.0,2,1,2,4,7,0xb2d58542
420020.6,4.0,1,4,4,4,12,0xb2d6eb66
146.33,2.0,21,1,3,2,6,0xb2d2f458
500005.32,2.0,18,4,3,2,9,0xb2d9912d
179116.74,3.0,25,3,4,2,9,0xb2d42b0cd
172.93,1.0,56,1,2,2,5,0xb2d312c3d
421943.56,1.0,1,4,2,4,10,0xb2d0f3a5d
200021.44,2.0,19,3,3,2,8,0xb2d985cf
515173.33,2.0,3,4,3,4,11,0xb2d65303
5607.03,1.0,5,2,2,3,7,0xb2d3311cd
280.09,2.0,48,1,3,2,6,0xb2d9b30d
116.2,1.0,35,1,2,2,5,0xb2d12f1b
2023.3,1.0,92,1,2,1,4,0xb2d267ccd
446.33,1.0,9,1,2,3,6,0xb2d57504
1082.19,1.0,92,1,2,1,4,0xb2d254d6
311510.87,2.0,13,4,3,3,10,0xb2d60e7cd
2711.61,1.0,10,1,2,3,6,0xb2d4421b
22204.19,2.0,18,2,3,2,7,0xb2d5be50
25.12,1.0,2,1,2,4,7,0xb2d626e6
620237.28,2.0,7,4,3,3,10,0xb2da1bf4
501.82,1.0,0,1,2,4,7,0xb2d6c8b8
34037.55,2.0,7,2,3,3,8,0xb2d0f724d
35437.09,1.0,0,2,2,4,8,0xb2d69c88d
0.27,1.0,9,1,2,3,6,0xb2d5ae81
1279.09,1.0,184,1,2,1,4,0xb2d59df4d
9519.86,1.0,11,2,2,3,7,0xb2d8c3bdd
702051.73,3.0,18,4,4,2,10,0xb2d56c9c
3009.86,1.0,184,2,2,1,5,0xb2d2e0efd
53053.87,5.0,101,3,4,1,8,0xb2d097cf
800105.42,5.0,6,4,4,3,11,0xb2d097eb
12102.44,2.0,0,2,3,4,9,0xb2d3e440
70000.76,2.0,0,3,3,4,10,0xb2d78b0e
15386.73,1.0,6,2,2,3,7,0xb2d33db7
74.77,1.0,9,1,2,3,6,0xb2d561bed
1190.38,1.0,184,1,2,1,4,0xb2d20ca0
274176.03,8.0,0,3,4,4,11,0xb2d2134d
108116.99,2.0,1,3,3,4,10,0xb2d196b6
4615.4,1.0,5,2,2,3,7,0xb2d90869
1411.76,1.0,184,1,2,1,4,0xb2d165ea
500000.05,2.0,4,4,3,4,11,0xb2d8f4d6
624712.23,2.0,235,4,3,1,8,0xb2d5ab68
2.64,1.0,20,1,2,2,5,0xb2d9490e
102106.95,1.0,4,3,2,4,9,0xb2d68a8dd
190666.35,3.0,74,3,4,1,8,0xb2d593eed
300012.68,2.0,147,3,3,1,7,0xb2d900cd
3399.38,1.0,6,2,2,3,7,0xb2d58e7ed
934.56,1.0,0,1,2,4,7,0xb2d288f3
301857.37,3.0,228,4,4,1,9,0xb2d17f42d
30060.89,1.0,33,2,2,2,6,0xb2d34c82
1368.88,1.0,92,1,2,1,4,0x3b9b0f9b
140070.9,4.0,41,3,4,2,9,0xb2d08e15
17519.8,2.0,9,2,3,3,8,0xb2d6981c
15959.17,1.0,12,2,2,3,7,0xb2d75b42
524001.04,9.0,10,4,4,3,11,0xb2d6cca6
20.19,1.0,51,1,2,2,5,0xb2d20341
1883.24,1.0,60,1,2,2,5,0xb2d5559d
22012.86,1.0,121,2,2,1,5,0xb2d23a8dd
439000.0,5.0,4,4,4,4,12,0xb2d38263
1000000.0,2.0,0,4,3,4,11,0xb2da6c41
2000326.5,1.0,1,4,2,4,10,0xb2d1fe89
55846.91,1.0,3,3,2,4,9,0xb2d6266e
6174.75,1.0,48,2,2,2,6,0xb2d3343d
96800.04,4.0,27,3,4,2,9,0xb2d5cc8e
10000.11,2.0,11,2,3,3,8,0xb2da4535
201698.63,3.0,129,3,4,1,8,0xb2d520c5d
351238.99,12.0,1,4,4,4,12,0xb2d2368bd
15198.37,1.0,15,2,2,3,7,0xb2d9006d
46.42,1.0,12,1,2,3,6,0xb2d308eb
0.0,1.0,63,1,2,2,5,0xb2d639ad
3938.5,1.0,9,2,2,3,7,0xb2d6e2e5
81013.1,2.0,139,3,3,1,7,0xb2d3c7aed
871.02,1.0,5,1,2,3,6,0xb2d9d5c6
8102.84,1.0,0,2,2,4,8,0xb2d6e7a3d
50004.22,1.0,18,2,2,2,6,0xb2da130a
75.03,1.0,44,1,2,2,5,0xb2d27c3f
57.86,1.0,7,1,2,3,6,0xb2d6e16dd
19.15,1.0,9,1,2,3,6,0xb2d6c03e
8.64,1.0,47,1,2,2,5,0xb2d5ea18
20722.13,1.0,10,2,2,3,7,0xb2d644ced
161437.26,2.0,0,3,3,4,10,0xb2d5b16ed
200375.22,3.0,6,3,4,3,10,0xb2d4339b
68873.0,4.0,1,3,4,4,11,0xb2da5d2a
507107.69,2.0,11,4,3,3,10,0xb2d6fb36d
702554.04,2.0,23,4,3,2,9,0xb2d78d9a
201618.13,9.0,3,3,4,4,11,0xb2d36eae
500000.0,2.0,3,4,3,4,11,0xb2d9773d
455.47,1.0,0,1,2,4,7,0xb2d6bb1cd
1564474.09,12.0,0,4,4,4,12,0xb2d53c57
190106.97,3.0,11,3,4,3,10,0xb2d5e13ed
113152.95,3.0,0,3,4,4,11,0xb2d5b70bd
300000.0,2.0,20,3,3,2,8,0xb2d78160
51198.35,1.0,18,2,2,2,6,0xb2d298b6
382991.97,2.0,101,4,3,1,8,0xb2d57616d
199.33,1.0,64,1,2,2,5,0xb2d390e0
80000.0,3.0,3,3,4,4,11,0xb2d09eaed
60007.71,2.0,41,3,3,2,8,0xb2d5275fd
21796.4,1.0,0,2,2,4,8,0xb2d31593d
1086682.88,5.0,12,4,4,3,11,0xb2d10d6e
855.42,1.0,0,1,2,4,7,0xb2d8f6f2
210084.17,6.0,11,3,4,3,10,0xb2d3eda2d
92.17,2.0,0,1,3,4,8,0xb2d1d45ed
257278.46,2.0,0,3,3,4,10,0xb2d0daacd
14261.01,1.0,131,2,2,1,5,0xb2d69027
57664.55,2.0,101,3,3,1,7,0xb2d4c847d
350174.26,13.0,6,4,4,3,11,0xb2d57541d
702171.01,2.0,0,4,3,4,11,0xb2d39fdb
3487.13,1.0,184,2,2,1,5,0xb2d3c422
52759.5,1.0,24,3,2,2,7,0xb2d3a9db
216.58,1.0,21,1,2,2,5,0x3b9b46a4
80271.73,2.0,140,3,3,1,7,0xb2d4735b
227426.91,2.0,3,3,3,4,10,0xb2d4a640
590.61,1.0,9,1,2,3,6,0xb2d408b9
153215.34,5.0,73,3,4,1,8,0xb2d59f4ad
2305.76,1.0,13,1,2,3,6,0xb2d48c91
202898.03,2.0,57,3,3,2,8,0xb2d68cfa
4000194.7,3.0,179,4,4,1,9,0xb2d09489
142113.46,3.0,0,3,4,4,11,0xb2d2728e
5003929.15,3.0,0,4,4,4,12,0xb2d38d9a
53444.81,1.0,0,3,2,4,9,0xb2d8ce6b
115001.22,3.0,49,3,4,2,9,0xb2d9ceff
7844.37,1.0,6,2,2,3,7,0xb2d3e97d
904695.28,4.0,0,4,4,4,12,0xb2d48ead
505443.34,1.0,0,4,2,4,10,0xb2d8f43e
102497.77,2.0,80,3,3,1,7,0xb2d305ad
229872.77,6.0,14,3,4,3,10,0xb2d2b287
203594.26,2.0,92,3,3,1,7,0xb2d54e0bd
487990.27,6.0,0,4,4,4,12,0xb2d55cbed
10013.23,1.0,9,2,2,3,7,0xb2d10faa
1100000.0,3.0,5,4,4,3,11,0xb2d9e8f3
200080.17,2.0,6,3,3,3,9,0xb2d5c314
300062.19,2.0,27,3,3,2,8,0xb2d21c23
30038.11,3.0,49,2,4,2,8,0xb2d5e789
342878.04,2.0,125,4,3,1,8,0xb2d0f83b
1500010.02,4.0,0,4,4,4,12,0xb2d4305dd
18265.97,1.0,21,2,2,2,6,0xb2d60a71
160006.46,3.0,94,3,4,1,8,0xb2d1cb82d
524.9,1.0,16,1,2,2,5,0xb2d8c626
70012.45,3.0,6,3,4,3,10,0xb2d9b91f
2732.09,2.0,118,1,3,1,5,0xb2d0a2b2
200000.0,2.0,25,3,3,2,8,0xb2d94b77
2729.44,1.0,21,1,2,2,5,0xb2d6d381
402842.52,3.0,53,4,4,2,10,0xb2d95fd9
40009.42,2.0,11,2,3,3,8,0xb2d9c0b1
345.66,1.0,0,1,2,4,7,0xb2d2de0d
923.57,1.0,41,1,2,2,5,0xb2d6bbec
9607.09,1.0,9,2,2,3,7,0xb2d316cad
220019.94,2.0,129,3,3,1,7,0xb2d13e89d
95.65,1.0,68,1,2,1,4,0xb2d48ea2d
4291.67,1.0,184,2,2,1,5,0xb2d3732ad
90651.22,3.0,3,3,4,4,11,0x3b9b45ced
574710.44,11.0,1,4,4,4,12,0xb2d24ffdd
500973.84,2.0,46,4,3,2,9,0xb2d9da21
150004.75,3.0,90,3,4,1,8,0xb2d6e407d
5889.6,1.0,2,2,2,4,8,0xb2d62874
2999.47,12.0,14,2,4,3,9,0xb2d20156
548321.66,2.0,4,4,3,4,11,0xb2d6d41cd
10000.42,2.0,92,2,3,1,6,0xb2d6485a
362003.31,6.0,31,4,4,2,10,0xb2d29601
362.26,1.0,67,1,2,1,4,0xb2d606bed
179.51,1.0,1,1,2,4,7,0xb2d95f0b
224404.39,2.0,75,3,3,1,7,0xb2d6423bd
137749.88,2.0,123,3,3,1,7,0xb2d1000d
2750110.69,5.0,63,4,4,2,10,0xb2d41e9b
0.0,1.0,6,1,2,3,6,0xb2d60729
201658.08,1.0,184,3,2,1,6,0xb2d380bdd
106532.52,4.0,0,3,4,4,11,0xb2d39dd6d
74.78,1.0,4,1,2,4,7,0xb2d616c1
300052.89,2.0,0,3,3,4,10,0xb2d68fd0
573.06,1.0,20,1,2,2,5,0xb2d1f1abd
221573.46,3.0,94,3,4,1,8,0xb2d5d9f6d
150003.17,2.0,53,3,3,2,8,0xb2d9cc4a
40002.11,2.0,105,2,3,1,6,0xb2d959ebd
60849.89,5.0,6,3,4,3,10,0xb2d230cf
314389.34,2.0,12,4,3,3,10,0xb2d5d5aed
1724.34,1.0,11,1,2,3,6,0xb2d2d2af
5441.98,1.0,0,2,2,4,8,0xb2d15245
213.52,3.0,0,1,4,4,9,0xb2d0e2bd
201421.12,2.0,75,3,3,1,7,0xb2d99d3e
105.78,1.0,2,1,2,4,7,0xb2d1d9d3
20000.21,2.0,38,2,3,2,7,0xb2d92b24
275324.36,3.0,28,3,4,2,9,0xb2d5bcb1
204049.07,6.0,0,3,4,4,11,0xb2d1a8ac
20002.89,3.0,2,2,4,4,10,0xb2d9fefc
1.79,13.0,16,1,4,2,7,0xb2d139aa
0.0,1.0,8,1,2,3,6,0xb2d5705c
250005.84,3.0,59,3,4,2,9,0xb2d5eeced
60003.17,2.0,188,3,3,1,7,0xb2d6a5dbd
4422.01,1.0,3,2,2,4,8,0xb2d6923fd
957316.39,11.0,27,4,4,2,10,0xb2d07c29
39.67,1.0,33,1,2,2,5,0xb2d3cd1ad
382099.55,3.0,111,4,4,1,9,0xb2d27172
320068.83,4.0,118,4,4,1,9,0xb2d171e9d
10066.43,2.0,39,2,3,2,7,0xb2d63f79d
201576.43,2.0,187,3,3,1,7,0xb2d56e5d
34757.05,2.0,213,2,3,1,6,0xb2d10191
10473005.18,9.0,179,4,4,1,9,0x3b9add8cd
558806.21,12.0,0,4,4,4,12,0xb2d240ccd
400014.82,3.0,16,4,4,2,10,0xb2d6e38a
503180.88,3.0,3,4,4,4,12,0xb2d5755a
16967.78,6.0,0,2,4,4,10,0xb2d186c3
200000.0,2.0,8,3,3,3,9,0xb2da4f2f
183.7,1.0,3,1,2,4,7,0xb2d936e5
360011.45,2.0,19,4,3,2,9,0xb2d8d828d
10596.49,2.0,92,2,3,1,6,0xb2d1ff6d
1112.96,1.0,184,1,2,1,4,0xb2d29852
257554.64,2.0,39,3,3,2,8,0xb2d68eb3d
18094.74,1.0,2,2,2,4,8,0xb2d6f049
70562.28,3.0,10,3,4,3,10,0xb2d6e67ad
31817.68,2.0,14,2,3,3,8,0xb2d5346f
296154.76,2.0,53,3,3,2,8,0xb2d117b4
72.35,1.0,16,1,2,2,5,0xb2d200f2
2408.24,2.0,184,1,3,1,5,0xb2d08eb7d
650852.67,3.0,26,4,4,2,10,0xb2d5d512d
426041.25,23.0,1,4,4,4,12,0xb2d6af45d
100020.48,1.0,0,3,2,4,9,0xb2da5bcb
43502.78,1.0,0,2,2,4,8,0xb2d1bd81
310022.24,5.0,18,4,4,2,10,0xb2d3833d
30643.36,3.0,46,2,4,2,8,0xb2d29b85
5614.99,1.0,184,2,2,1,5,0xb2d2c894d
2013.03,1.0,184,1,2,1,4,0x3b9aeff1d
2349.52,1.0,265,1,2,1,4,0xb2d314e3
10.12,6.0,13,1,4,3,8,0xb2d2036ed
16907.4,1.0,21,2,2,2,6,0xb2d648f0
253960.96,3.0,133,3,4,1,8,0x3b9adf59d
120077.21,2.0,67,3,3,1,7,0xb2d55bf7d
25071.74,1.0,10,2,2,3,7,0xb2d39804
300000.97,2.0,17,3,3,2,8,0xb2d7c0d5
638.96,1.0,0,1,2,4,7,0xb2d31ff4d
201050.31,2.0,25,3,3,2,8,0xb2d554ffd
29.29,1.0,46,1,2,2,5,0xb2d56e48
369725.91,4.0,13,4,4,3,11,0xb2d56d0cd
17144.57,1.0,43,2,2,2,6,0xb2d6a826d
5001.85,1.0,26,2,2,2,6,0xb2d9218bd
6792293.09,1.0,1,4,2,4,10,0xb2d52659
100005.19,2.0,10,3,3,3,9,0xb2d6056b
420000.0,6.0,10,4,4,3,11,0xb2d9efc4
207118.86,3.0,80,3,4,1,8,0xb2d4e969d
90104.3,1.0,0,3,2,4,9,0xb2d68508
5001.16,1.0,21,2,2,2,6,0xb2d91b87d
39.17,1.0,53,1,2,2,5,0xb2d256e0d
1106400.03,6.0,9,4,4,3,11,0xb2d0d8d6d
4.01,1.0,67,1,2,1,4,0xb2d9ad0f
35248.42,1.0,3,2,2,4,8,0xb2d5304d
1111414.61,8.0,1,4,4,4,12,0xb2d06f02d
36.7,1.0,184,1,2,1,4,0xb2d253d0
1.91,1.0,18,1,2,2,5,0xb2d45372
42103.85,2.0,184,2,3,1,6,0xb2d3942ad
489362.33,5.0,14,4,4,3,11,0xb2d1ace7d
10001.94,2.0,15,2,3,3,8,0xb2d9148a
0.53,1.0,12,1,2,3,6,0xb2d957e2d
100462.75,1.0,4,3,2,4,9,0xb2d62d29
51283.5,1.0,92,2,2,1,5,0xb2d38062
2.12,1.0,15,1,2,3,6,0xb2d92cd1
190.2,1.0,0,1,2,4,7,0xb2da3c93
310064.3,3.0,83,4,4,1,9,0xb2d17450
486.02,1.0,17,1,2,2,5,0xb2d1c398
40.88,1.0,57,1,2,2,5,0xb2d1c7df
100765.17,2.0,0,3,3,4,10,0xb2d3ed46
120191.7,3.0,80,3,4,1,8,0xb2d24e3f
4166.49,1.0,3,2,2,4,8,0xb2d1da7f
11.72,1.0,12,1,2,3,6,0xb2d6267d
280977.52,3.0,38,3,4,2,9,0xb2d629fb
79.14,1.0,5,1,2,3,6,0xb2d904f6d
120070.15,2.0,53,3,3,2,8,0xb2d5642d
674.96,1.0,5,1,2,3,6,0xb2d92859d
3665.2,1.0,184,2,2,1,5,0xb2d1024ed
300003.17,2.0,206,3,3,1,7,0xb2d69065
14804.66,1.0,5,2,2,3,7,0xb2d2a8b1d
340159.91,7.0,48,4,4,2,10,0xb2d5f4e2
13011.64,1.0,8,2,2,3,7,0xb2d96b58
135548.97,1.0,22,3,2,2,7,0xb2d3c15a
365733.72,3.0,22,4,4,2,10,0xb2d197ae
123.21,2.0,7,1,3,3,7,0xb2d088e2
538.62,1.0,10,1,2,3,6,0xb2d902ce
711024.88,7.0,24,4,4,2,10,0xb2d594f1
500000.0,5.0,2,4,4,4,12,0xb2d9be7f
0.0,1.0,5,1,2,3,6,0xb2d6b827
377.82,4.0,92,1,4,1,6,0x3b9ade0d
282292.29,5.0,0,3,4,4,11,0xb2d212c4d
12728.16,1.0,92,2,2,1,5,0xb2d1a7c9
50007.49,2.0,39,2,3,2,7,0xb2d93f71
135.62,1.0,21,1,2,2,5,0xb2d0de86
1871.49,1.0,92,1,2,1,4,0xb2d23031d
95430.41,5.0,18,3,4,2,9,0xb2d136a4d
58.59,1.0,9,1,2,3,6,0xb2d5b273
632740.57,12.0,6,4,4,3,11,0xb2d60b85
197280.45,4.0,75,3,4,1,8,0xb2d3e950
120281.31,2.0,164,3,3,1,7,0xb2d24368
350045.74,2.0,0,4,3,4,11,0xb2d2920c
14000.15,2.0,14,2,3,3,8,0xb2d63cb4d
291.93,1.0,0,1,2,4,7,0xb2d9ebac
3002.22,1.0,45,2,2,2,6,0xb2d276db
125843.55,1.0,21,3,2,2,7,0x3b9ad0b0d
103837.08,2.0,104,3,3,1,7,0xb2d24a70
203775.13,3.0,0,3,4,4,11,0xb2d5ad8b
400021.35,3.0,10,4,4,3,11,0xb2d6b4ea
1746.03,1.0,92,1,2,1,4,0xb2d25153d
1199.2,1.0,0,1,2,4,7,0xb2d212f8
20007.51,2.0,2,2,3,4,9,0xb2d68e83
71308.55,3.0,112,3,4,1,8,0xb2d5e752d
116160335.55,12.0,1,4,4,4,12,0xb2d5b6d8d
40085.41,4.0,24,2,4,2,8,0xb2d55be0
102.03,1.0,20,1,2,2,5,0xb2d30da6
6255.87,1.0,11,2,2,3,7,0xb2d34324
72485.42,3.0,95,3,4,1,8,0xb2d58e24
366001.96,6.0,52,4,4,2,10,0x3b9b4200
55375.9,3.0,80,3,4,1,8,0xb2d294ffd
4482.28,2.0,92,2,3,1,6,0x3b9b2d46
11.02,1.0,56,1,2,2,5,0xb2d2322e
6.3,1.0,0,1,2,4,7,0xb2d2f751
837358.48,6.0,5,4,4,3,11,0xb2d268c7d
4645.22,1.0,56,2,2,2,6,0xb2d2b935
1053617.6,5.0,0,4,4,4,12,0xb2d0bb50
386169.14,9.0,64,4,4,2,10,0xb2d0e744d
1210.35,1.0,92,1,2,1,4,0xb2d19b7a
215.79,1.0,18,1,2,2,5,0xb2d1bf66
370.21,2.0,195,1,3,1,5,0xb2d5dd90d
4024.63,16.0,0,2,4,4,10,0x3b9b2de9
133.43,1.0,0,1,2,4,7,0xb2d8e68f
242244.12,8.0,6,3,4,3,10,0xb2d175af
1495152.9,10.0,0,4,4,4,12,0xb2d0641dd
11789.69,1.0,92,2,2,1,5,0xb2d1ec1ad
821186.73,3.0,21,4,4,2,10,0xb2d42b2cd
33.66,1.0,30,1,2,2,5,0xb2d7911bd
202131.79,2.0,91,3,3,1,7,0xb2d6a7d2
2069941.67,6.0,0,4,4,4,12,0xb2d2bcc8
7.17,1.0,2,1,2,4,7,0xb2d8023b
4670085.25,3.0,80,4,4,1,9,0xb2d41461d
3018.89,1.0,0,2,2,4,8,0xb2d69b74d
22.9,1.0,61,1,2,2,5,0xb2d8ed70
2.0,1.0,35,1,2,2,5,0xb2d96802
1001071.35,5.0,4,4,4,4,12,0xb2d6207e
315411.86,3.0,8,4,4,3,11,0xb2d68223d
3175.18,1.0,184,2,2,1,5,0xb2d34647
500000.0,2.0,5,4,3,3,10,0xb2d9773c
1038644.43,4.0,0,4,4,4,12,0xb2d5dd10
500015.89,2.0,179,4,3,1,8,0xb2d2684d
9157.1,1.0,21,2,2,2,6,0xb2d61efc
308893.23,4.0,168,4,4,1,9,0xb2d24134
535.43,1.0,0,1,2,4,7,0xb2d4887d
51845.87,1.0,260,2,2,1,5,0xb2d2d6acd
307.33,1.0,33,1,2,2,5,0xb2d0e686
340003.51,9.0,1,4,4,4,12,0xb2d14e71d
766653.36,2.0,0,4,3,4,11,0xb2d1ea2a
510800.22,6.0,21,4,4,2,10,0xb2d09c2b
2583.53,1.0,49,1,2,2,5,0xb2d4525d
10000.74,2.0,11,2,3,3,8,0xb2d69d83d
100397.48,1.0,184,3,2,1,6,0xb2d3055b
315212.14,2.0,1,4,3,4,11,0xb2d5ea13
10332027.11,19.0,12,4,4,3,11,0xb2d2e72ad
110003.27,3.0,10,3,4,3,10,0xb2d95fddd
9726.71,1.0,10,2,2,3,7,0xb2d38645d
201467.23,2.0,75,3,3,1,7,0xb2d4170e
2698.99,1.0,9,1,2,3,6,0xb2d32c1a
218678.33,3.0,62,3,4,2,9,0xb2d25b7dd
501683.04,19.0,5,4,4,3,11,0xb2d22a79d
8035.78,1.0,184,2,2,1,5,0xb2d5c200
32.91,1.0,14,1,2,3,6,0xb2d6ece3
871882.22,6.0,13,4,4,3,11,0xb2d5ab37
135000.86,9.0,3,3,4,4,11,0xb2d681fbd
301113.7,2.0,43,4,3,2,9,0xb2d258f8d
66.4,1.0,8,1,2,3,6,0xb2d94c25d
1638.51,1.0,14,1,2,3,6,0xb2d3c94c
1553061.0,25.0,0,4,4,4,12,0xb2d228add
127026.32,3.0,60,3,4,2,9,0xb2d06f5bd
1369903.09,2.0,25,4,3,2,9,0xb2d4c947
80009.46,3.0,7,3,4,3,10,0xb2d615a8
140017.1,6.0,41,3,4,2,9,0xb2d1a9f5
0.97,1.0,42,1,2,2,5,0xb2d41a46
10011137.49,1.0,34,4,2,2,8,0xb2d6009ad
380006.09,2.0,80,4,3,1,8,0xb2d98b98
103856.11,1.0,0,3,2,4,9,0xb2d17a2d
100615.72,3.0,147,3,4,1,8,0xb2d6ce32
4.06,1.0,74,1,2,1,4,0xb2d60096
2522305.88,6.0,21,4,4,2,10,0xb2d1b590
1463641.52,5.0,3,4,4,4,12,0xb2d35f58
7019.87,1.0,7,2,2,3,7,0xb2d2fac2
36.76,2.0,28,1,3,2,6,0x3b9af216
241.89,1.0,50,1,2,2,5,0xb2d54180
72029.69,4.0,34,3,4,2,9,0xb2d7ec3b
204990.05,2.0,79,3,3,1,7,0xb2d636bbd
53869.87,2.0,1,3,3,4,10,0xb2d563ef
1008.0,1.0,184,1,2,1,4,0xb2d4ec3cd
73625.95,1.0,0,3,2,4,9,0xb2d37189
275048.28,8.0,0,3,4,4,11,0xb2d60593
12.09,1.0,75,1,2,1,4,0xb2d279eed
40343.74,3.0,181,2,4,1,7,0xb2d5e98ad
1210.85,1.0,0,1,2,4,7,0xb2d695f5d
2955.61,1.0,3,2,2,4,8,0xb2d76947
298084.27,3.0,2,3,4,4,11,0xb2d5d1e3
50964.79,1.0,184,2,2,1,5,0xb2d405a9d
0.0,1.0,1,1,2,4,7,0xb2d22ae0
7973.33,1.0,91,2,2,1,5,0xb2d4384ad
168223.88,5.0,48,3,4,2,9,0xb2d1ad94d
93671.11,1.0,15,3,2,3,8,0xb2d23843d
132203.53,2.0,0,3,3,4,10,0xb2d62cf8
50005.45,2.0,55,2,3,2,7,0xb2d4c85ed
111185.91,2.0,66,3,3,2,8,0xb2d6c679d
135.72,1.0,10,1,2,3,6,0xb2d39e21
100030.84,2.0,196,3,3,1,7,0xb2d12003
0.0,1.0,4,1,2,4,7,0xb2d2f637
903036.82,8.0,10,4,4,3,11,0xb2d6b329
51005.7,2.0,3,2,3,4,9,0xb2d909dd
614.59,1.0,0,1,2,4,7,0xb2d168c9
100002.85,3.0,0,3,4,4,11,0xb2d9bf24
6052.88,1.0,16,2,2,2,6,0xb2d28a49d
32487.54,1.0,0,2,2,4,8,0xb2d8f6eed
147.73,1.0,20,1,2,2,5,0xb2d96fca
25.34,1.0,7,1,2,3,6,0xb2d64c0f
101164.66,2.0,14,3,3,3,9,0xb2d93bc8d
1177.75,1.0,184,1,2,1,4,0xb2d29fdb
535706.21,3.0,11,4,4,3,11,0xb2d1caa8
5.03,1.0,2,1,2,4,7,0xb2d459d0
200002.55,6.0,8,3,4,3,10,0xb2da3b70
1151491.63,5.0,48,4,4,2,10,0xb2d08310d
16425.85,1.0,15,2,2,3,7,0xb2d8d541
1409.71,2.0,75,1,3,1,5,0xb2d089e3d
2301.53,1.0,14,1,2,3,6,0xb2d449ce
26118.95,1.0,64,2,2,2,6,0xb2d63e18
123157.61,4.0,55,3,4,2,9,0xb2d4da4b
175022.15,4.0,4,3,4,4,11,0xb2d58064
20008.06,1.0,1,2,2,4,8,0xb2d4851c
1000000.0,4.0,3,4,4,4,12,0xb2d62bbcd
710021.86,8.0,1,4,4,4,12,0xb2d11a02d
2613.57,44.0,0,1,4,4,9,0x3b9b2634d
0.0,1.0,3,1,2,4,7,0xb2d3b1ac
1097.99,1.0,10,1,2,3,6,0xb2d3557f
1247887.31,10.0,18,4,4,2,10,0xb2d23ac2
200014.67,2.0,136,3,3,1,7,0xb2d09272
280522.59,2.0,97,3,3,1,7,0xb2d38aa5
60046.47,3.0,5,3,4,3,10,0xb2d7ec3bd
0.43,1.0,39,1,2,2,5,0xb2d5406d
515000.93,1.0,0,4,2,4,10,0xb2d61b8a
55001.2,2.0,1,3,3,4,10,0xb2d52ea0d
22.17,1.0,35,1,2,2,5,0xb2d925a7
381344.31,7.0,4,4,4,4,12,0xb2d43584d
50000.53,3.0,48,2,4,2,8,0xb2d91467
50585.27,4.0,67,2,4,1,7,0xb2d25ea6d
11918.44,1.0,2,2,2,4,8,0xb2d200bc
200010.42,2.0,9,3,3,3,9,0xb2d9f5cf
500080.05,2.0,5,4,3,3,10,0xb2d2d9d7
40339.52,2.0,4,2,3,4,9,0xb2d592c3
11819.93,1.0,19,2,2,2,6,0xb2d6a7ab
715101.53,3.0,31,4,4,2,10,0xb2d18284
100000.0,2.0,6,3,3,3,9,0xb2d97091
11.96,1.0,75,1,2,1,4,0xb2d5f376
7000122.2,2.0,53,4,3,2,9,0xb2d8f72fd
200105.06,2.0,10,3,3,3,9,0xb2d21319d
4382.22,1.0,10,2,2,3,7,0xb2d6c153
108502.35,2.0,231,3,3,1,7,0xb2d3304cd
11.37,1.0,6,1,2,3,6,0xb2d2dbfd
1281.51,1.0,70,1,2,1,4,0xb2d6362ed
160006.14,2.0,49,3,3,2,8,0xb2d21797
73001.51,3.0,4,3,4,4,11,0xb2d538fd
111883.4,3.0,0,3,4,4,11,0xb2d0685d
40001.37,4.0,24,2,4,2,8,0xb2d93f81
100005.29,2.0,132,3,3,1,7,0xb2d91eb7
2821.08,1.0,26,1,2,2,5,0xb2d25fc3
1912.54,1.0,5,1,2,3,6,0xb2d2399a
67269.43,4.0,41,3,4,2,9,0xb2d0ec08d
4040.73,83.0,1,2,4,4,10,0xb2d36fb0
175073.43,3.0,123,3,4,1,8,0xb2d29626d
500060.26,2.0,27,4,3,2,9,0xb2d251b3
200434.09,2.0,63,3,3,2,8,0xb2d6d8ee
500000.0,2.0,7,4,3,3,10,0xb2d96f1ad
566670.96,7.0,1,4,4,4,12,0xb2d18612
250083.61,3.0,91,3,4,1,8,0xb2d7f389
740000.0,1.0,2,4,2,4,10,0xb2d9703ed
2341.14,1.0,92,1,2,1,4,0xb2d398a8d
138675.74,1.0,184,3,2,1,6,0x3b9b38c5
100030.47,2.0,11,3,3,3,9,0xb2d310e8
300008.64,7.0,15,3,4,3,10,0xb2d926fad
500000.96,2.0,8,4,3,3,10,0xb2d9f295
300524.03,3.0,6,4,4,3,11,0xb2d28bc3d
50239.53,1.0,92,2,2,1,5,0xb2d352a6
203456.73,2.0,1,3,3,4,10,0xb2d6d542
30482.3,2.0,3,2,3,4,9,0xb2d43c55
9848.82,1.0,60,2,2,2,6,0xb2d8d410d
656749.98,4.0,0,4,4,4,12,0xb2da33c2
619.17,1.0,0,1,2,4,7,0xb2d51ee7
1940.29,1.0,95,1,2,1,4,0xb2d6bbbd
105.28,2.0,4,1,3,4,8,0xb2d39e24
988000.33,17.0,0,4,4,4,12,0xb2d472a6
2550892.73,5.0,6,4,4,3,11,0xb2d5754b
435187.77,9.0,2,4,4,4,12,0xb2d0e9a6
106005.74,2.0,77,3,3,1,7,0xb2d65c64d
959849.63,2.0,20,4,3,2,9,0xb2d067bd
100004.52,2.0,70,3,3,1,7,0x3b9b418c
150001.58,2.0,27,3,3,2,8,0xb2d94102d
379056.96,11.0,18,4,4,2,10,0xb2d40ff7
61.99,1.0,14,1,2,3,6,0xb2d62f5e
26063.57,1.0,174,2,2,1,5,0xb2d63320
300874.89,4.0,34,4,4,2,10,0xb2d6b15fd
348853.2,3.0,18,4,4,2,10,0xb2d2f191d
120044.97,3.0,122,3,4,1,8,0xb2d25a2cd
140026.66,4.0,0,3,4,4,11,0xb2d1c752
10184.28,1.0,184,2,2,1,5,0xb2d2535bd
843933.17,7.0,11,4,4,3,11,0xb2d24812d
21261.96,1.0,0,2,2,4,8,0xb2d34c1f
1011.86,1.0,184,1,2,1,4,0xb2d3d52b
218.58,1.0,9,1,2,3,6,0xb2d6de67d
1000096.79,3.0,13,4,4,3,11,0xb2d1be5d
311828.56,4.0,167,4,4,1,9,0xb2d45f57d
0.09,1.0,7,1,2,3,6,0xb2d56230
70034.66,3.0,179,3,4,1,8,0xb2d0754b
0.0,1.0,7,1,2,3,6,0xb2d9461cd
200002.11,2.0,83,3,3,1,7,0xb2d8d010d
1581114.75,11.0,18,4,4,2,10,0xb2d0a1b9d
300000.18,2.0,21,3,3,2,8,0xb2d6f1e2
0.35,1.0,5,1,2,3,6,0xb2d3776b
244002.29,2.0,6,3,3,3,9,0xb2d6a351
2749.7,4.0,0,1,4,4,9,0x3b9af0e4
4908406.63,9.0,10,4,4,3,11,0xb2d245ded
3065.73,1.0,29,2,2,2,6,0xb2d9d03f
6246.01,1.0,10,2,2,3,7,0xb2d94026
598.89,1.0,2,1,2,4,7,0xb2d290b4
2397569.03,13.0,0,4,4,4,12,0xb2d17c8ad
350003.17,3.0,1,4,4,4,12,0xb2d783e7
979378.08,1.0,184,4,2,1,7,0xb2d1c6e4
108959.48,2.0,62,3,3,2,8,0xb2d2ad8b
30.83,1.0,14,1,2,3,6,0xb2d78dc5
3803.8,1.0,0,2,2,4,8,0xb2d26da6d
105917.72,2.0,27,3,3,2,8,0xb2d4ff64
14913.01,1.0,0,2,2,4,8,0xb2d6ab8bd
80362.32,6.0,149,3,4,1,8,0xb2d16ba8
25299.3,1.0,0,2,2,4,8,0xb2d8cee3d
5176.64,1.0,66,2,2,2,6,0xb2d64630
7093.63,1.0,14,2,2,3,7,0xb2d70581d
200077.31,3.0,119,3,4,1,8,0xb2d90cd8d
409071.94,3.0,116,4,4,1,9,0xb2d5177ad
320004.82,4.0,12,4,4,3,11,0xb2d8c788
400000.0,4.0,0,4,4,4,12,0xb2d10f85d
553082.35,11.0,1,4,4,4,12,0xb2d220d3
90003.12,11.0,11,3,4,3,10,0xb2d157f1d
52969.65,2.0,104,3,3,1,7,0xb2d4eb47
114302.07,4.0,27,3,4,2,9,0xb2d1030fd
110652.21,4.0,19,3,4,2,9,0xb2d1db83
3000007.19,4.0,2,4,4,4,12,0xb2d6bd20
3.2,1.0,38,1,2,2,5,0xb2d527c6
123.18,1.0,40,1,2,2,5,0xb2d695eed
24000.0,3.0,5,2,4,3,9,0xb2d46ffa
600055.42,6.0,0,4,4,4,12,0xb2d93c88d
200000.0,7.0,4,3,4,4,11,0xb2d65104
103175.3,7.0,49,3,4,2,9,0xb2d2d7df
62.95,1.0,1,1,2,4,7,0xb2d6b103
543680.04,8.0,6,4,4,3,11,0xb2d424c4d
650048.44,4.0,11,4,4,3,11,0xb2d24675d
139.15,1.0,10,1,2,3,6,0xb2d4f52e
164586.31,2.0,0,3,3,4,10,0xb2d29820d
125578.14,3.0,3,3,4,4,11,0xb2d39e0e
311585.04,6.0,0,4,4,4,12,0xb2d3bcb4d
553737.59,8.0,3,4,4,4,12,0xb2d15fcdd
2329.96,1.0,8,1,2,3,6,0xb2d6c259
1156.27,1.0,92,1,2,1,4,0xb2d580ded
24.13,2.0,1,1,3,4,8,0xb2d4ac7c
860061.05,2.0,19,4,3,2,9,0xb2d92b8d
49486.16,1.0,7,2,2,3,7,0xb2d8d8fc
510079.73,4.0,80,4,4,1,9,0xb2d594aad
21042.91,1.0,0,2,2,4,8,0xb2d571b7
500011.55,3.0,0,4,4,4,12,0xb2da0381
124131.69,6.0,5,3,4,3,10,0xb2d5e046
150006.33,2.0,42,3,3,2,8,0xb2d9e5f6
98618.78,4.0,0,3,4,4,11,0xb2d54e36
3262.1,1.0,92,2,2,1,5,0xb2d2c100
5.25,1.0,10,1,2,3,6,0xb2d6f4f2d
7285.17,1.0,93,2,2,1,5,0xb2d5962b
2.97,1.0,35,1,2,2,5,0xb2d43fe4d
549.21,1.0,1,1,2,4,7,0xb2d78d24d
3894.24,1.0,10,2,2,3,7,0xb2d8e316
7.03,1.0,16,1,2,2,5,0xb2d46ec4
424274.77,4.0,79,4,4,1,9,0xb2d18dc5
559724.67,10.0,0,4,4,4,12,0xb2d192ac
871.11,1.0,73,1,2,1,4,0xb2d70170
100004.22,2.0,14,3,3,3,9,0xb2da35ea
454067.88,4.0,0,4,4,4,12,0xb2d69430
389911.58,3.0,122,4,4,1,9,0xb2d1801cd
300009.55,1.0,0,3,2,4,9,0xb2d65af6d
30.72,1.0,90,1,2,1,4,0xb2d85b22
210680.63,2.0,75,3,3,1,7,0xb2d5890c
870000.0,2.0,18,4,3,2,9,0xb2da2e66
220000.0,2.0,12,3,3,3,9,0xb2d964df
132726.44,2.0,92,3,3,1,7,0xb2d0f92a
202948.3,2.0,70,3,3,1,7,0xb2d59917d
20086.66,2.0,66,2,3,2,7,0xb2d630e5
583187.0,8.0,55,4,4,2,10,0xb2d4eb65d
150.64,2.0,31,1,3,2,6,0xb2d68458
0.53,1.0,13,1,2,3,6,0xb2d95d3bd
54499.65,2.0,4,3,3,4,10,0xb2d67dbdd
3221.77,1.0,7,2,2,3,7,0xb2d3904f
3.38,1.0,6,1,2,3,6,0xb2d9671dd
640064.5,9.0,34,4,4,2,10,0xb2d5cc8dd
475959.01,4.0,3,4,4,4,12,0xb2d2bb9d
70101.05,4.0,7,3,4,3,10,0xb2d95ea3d
100008.65,2.0,22,3,3,2,8,0xb2d9c347
1721.51,3.0,55,1,4,2,7,0x3b9b2d3b
245046.44,1.0,7,3,2,3,8,0xb2d91412
200000.0,2.0,21,3,3,2,8,0xb2d9519c
12878.51,2.0,8,2,3,3,8,0xb2d58919
655493.22,6.0,1,4,4,4,12,0xb2d5d5c6d
3412.76,1.0,31,2,2,2,6,0xb2d65357d
399.92,1.0,18,1,2,2,5,0xb2d25bb5
53762.37,1.0,0,3,2,4,9,0xb2d29151d
501054.23,3.0,7,4,4,3,11,0xb2d92a44d
99.57,1.0,47,1,2,2,5,0xb2d8e09f
200120.97,5.0,4,3,4,4,11,0xb2d5bf21
45090.39,1.0,10,2,2,3,7,0xb2d41577
200658.21,2.0,0,3,3,4,10,0xb2d9d780
212371.68,2.0,6,3,3,3,9,0xb2d489d6d
78408.42,1.0,3,3,2,4,9,0xb2d0f161
600.71,3.0,0,1,4,4,9,0x3b9b30cb
406158.86,1.0,5,4,2,3,9,0xb2d6d9dfd
83097.21,2.0,0,3,3,4,10,0xb2d99904
31334.43,1.0,4,2,2,4,8,0xb2d78274
1100011.02,10.0,11,4,4,3,11,0xb2d1a193d
92412.45,1.0,0,3,2,4,9,0xb2d59e4c
1403.58,1.0,12,1,2,3,6,0xb2d68e9f
456.67,1.0,15,1,2,3,6,0xb2d6c00dd
835009.3,6.0,3,4,4,4,12,0xb2d69cc5
362023.94,4.0,5,4,4,3,11,0xb2d3a816d
4501121.12,1.0,4,4,2,4,10,0xb2d42515
1187183.61,5.0,12,4,4,3,11,0xb2d3317d
89135.54,7.0,0,3,4,4,11,0x3b9af6ab
167013.36,5.0,14,3,4,3,10,0xb2d5ac62
917.6,1.0,28,1,2,2,5,0xb2d4f7fd
58554.72,1.0,2,3,2,4,9,0xb2d31309d
929750.95,1.0,1,4,2,4,10,0xb2d8fc50
1000054.09,3.0,167,4,4,1,9,0xb2d3f77dd
78162.81,2.0,10,3,3,3,9,0xb2d28af3
323.92,1.0,18,1,2,2,5,0xb2d68aef
85086.12,3.0,14,3,4,3,10,0xb2d5cb78
288408.78,5.0,3,3,4,4,11,0xb2d08f55d
55203.06,4.0,39,3,4,2,9,0xb2d60343d
359.98,1.0,77,1,2,1,4,0xb2d63754
410345.79,2.0,12,4,3,3,10,0xb2d2a4ae
1394.44,1.0,3,1,2,4,7,0xb2d2fd8e
1800.89,1.0,0,1,2,4,7,0xb2d6fe07
1081884.19,3.0,3,4,4,4,12,0xb2d46743d
242289.85,3.0,21,3,4,2,9,0xb2d640b1d
50001.06,2.0,10,2,3,3,8,0xb2d962f9
12506.1,1.0,0,2,2,4,8,0xb2d3abc1
221753.84,2.0,118,3,3,1,7,0xb2d6a66f
500033.67,2.0,23,4,3,2,9,0xb2d6e6d3
705790.76,6.0,0,4,4,4,12,0x3b9af2aa
2.23,1.0,77,1,2,1,4,0xb2d82238
1693760.26,7.0,25,4,4,2,10,0xb2d3bca7
38593.52,1.0,0,2,2,4,8,0xb2d3001ad
714.87,1.0,0,1,2,4,7,0xb2d654cd
948.09,1.0,0,1,2,4,7,0xb2d2b419d
31.7,2.0,60,1,3,2,6,0xb2d51771d
256078.45,4.0,147,3,4,1,8,0xb2d18d1c
340067.32,4.0,24,4,4,2,10,0xb2d063ccd
52007.0,2.0,94,2,3,1,6,0xb2d18463
6340.19,1.0,13,2,2,3,7,0xb2d93a2a
410000.72,3.0,10,4,4,3,11,0xb2d920ab
72.17,1.0,9,1,2,3,6,0xb2d3b49dd
69238.03,1.0,0,3,2,4,9,0xb2d2bcd3
152342.67,2.0,25,3,3,2,8,0xb2d1dafdd
3.95,1.0,47,1,2,2,5,0xb2d38c85d
10378.89,2.0,97,2,3,1,6,0xb2d58d04d
400000.0,2.0,0,4,3,4,11,0xb2da667f
401907.45,4.0,1,4,4,4,12,0xb2d6aeed
290012.77,3.0,151,3,4,1,8,0xb2d59e43
47.25,1.0,5,1,2,3,6,0xb2d956a1
957384.01,3.0,3,4,4,4,12,0xb2d187e4
510003.22,3.0,2,4,4,4,12,0xb2d91061d
29242.23,5.0,0,2,4,4,10,0x3b9b406c
104169.61,2.0,62,3,3,2,8,0xb2d2b9eb
400000.0,3.0,0,4,4,4,12,0xb2d9373d
2716.42,1.0,0,1,2,4,7,0xb2d6b8c6
2002.11,4.0,76,1,4,1,6,0xb2d97620
539858.39,3.0,1,4,4,4,12,0xb2d44242
277029.77,4.0,10,3,4,3,10,0xb2d07098
5.15,1.0,12,1,2,3,6,0xb2d2362b
91148.42,2.0,67,3,3,1,7,0xb2d3a567
135.49,1.0,7,1,2,3,6,0xb2d5cc0f
200027.43,2.0,45,3,3,2,8,0xb2d88bd5
18501.79,1.0,184,2,2,1,5,0xb2d0a05dd
33786.46,2.0,0,2,3,4,9,0xb2d3acbb
40001.05,3.0,186,2,4,1,7,0xb2d78e74d
384823.94,35.0,0,4,4,4,12,0x3b9b0e21
505897.63,2.0,12,4,3,3,10,0xb2d1b9ea
608154.8,5.0,5,4,4,3,11,0xb2d316c5
2275.94,1.0,210,1,2,1,4,0xb2d50538
162568.24,3.0,125,3,4,1,8,0xb2d394d4d
1632.43,1.0,92,1,2,1,4,0xb2d0786dd
10000.64,2.0,20,2,3,2,7,0xb2d9a7e3
10000.21,2.0,8,2,3,3,8,0xb2da4684
15597.61,1.0,5,2,2,3,7,0xb2d18d3e
200000.84,2.0,6,3,3,3,9,0xb2d9b2c0
50068.3,2.0,12,2,3,3,8,0xb2d44934
150043.59,2.0,97,3,3,1,7,0xb2d410c7
102721.8,3.0,4,3,4,4,11,0xb2d2c1afd
20464.71,1.0,2,2,2,4,8,0xb2d650b9d
150950.39,5.0,130,3,4,1,8,0xb2d56ded
1423051.86,10.0,25,4,4,2,10,0xb2d10512d
982081.09,6.0,0,4,4,4,12,0xb2d4cc20
262117.91,5.0,4,3,4,4,11,0xb2d093fd
4.13,4.0,60,1,4,2,7,0xb2d11bc2
392.25,1.0,3,1,2,4,7,0xb2d5da0a
1419017.48,9.0,5,4,4,3,11,0xb2d13bd9
1.58,1.0,51,1,2,2,5,0xb2d8df74
58930.44,1.0,8,3,2,3,8,0xb2d8e941
5360.52,1.0,4,2,2,4,8,0xb2d5bc39
90235.53,4.0,25,3,4,2,9,0xb2d7a8a3d
655010.8,5.0,10,4,4,3,11,0xb2d57112
625093.77,3.0,0,4,4,4,12,0xb2d076bdd
30011.07,2.0,8,2,3,3,8,0xb2d5e15dd
6942.85,1.0,11,2,2,3,7,0xb2d9268f
989.37,1.0,0,1,2,4,7,0xb2d2bd5ad
110069.4,1.0,4,3,2,4,9,0xb2d39c14
100021.34,2.0,20,3,3,2,8,0xb2d48f89d
440319.66,4.0,11,4,4,3,11,0xb2d18b9c
5006.09,1.0,10,2,2,3,7,0xb2d8da63d
100001.06,4.0,24,3,4,2,9,0xb2d105c9d
860006.26,9.0,11,4,4,3,11,0xb2d94b13
243846.49,14.0,2,3,4,4,11,0xb2d0690fd
1026.34,1.0,5,1,2,3,6,0xb2d18d45d
197069.27,2.0,87,3,3,1,7,0xb2d59a07d
6059.08,3.0,184,2,4,1,7,0xb2d094a4
113.65,1.0,9,1,2,3,6,0xb2d6b425
6002.0,1.0,1,2,2,4,8,0xb2d85049d
1029118.58,3.0,33,4,4,2,10,0xb2d58d0d
1143103.54,10.0,216,4,4,1,9,0xb2d0f29d
2253.19,1.0,9,1,2,3,6,0xb2d7c004d
200110.11,2.0,12,3,3,3,9,0xb2da0aad
11678.66,1.0,184,2,2,1,5,0xb2d35f7ed
212086.65,4.0,39,3,4,2,9,0xb2d3c58bd
4736.43,3.0,0,2,4,4,10,0xb2d0b053
362696.85,2.0,12,4,3,3,10,0xb2d17fad
500000.0,2.0,26,4,3,2,9,0xb2d94772d
1050000.14,2.0,172,4,3,1,8,0xb2d415a1
20000.42,2.0,3,2,3,4,9,0xb2d9316fd
5129904.95,4.0,5,4,4,3,11,0xb2d6d9bc
10291.87,1.0,68,2,2,1,5,0xb2d5ea6bd
200041.63,2.0,0,3,3,4,10,0xb2d67d57d
189713.83,8.0,0,3,4,4,11,0xb2d2b55f
1668825.79,4.0,92,4,4,1,9,0xb2d22984
30033.67,2.0,92,2,3,1,6,0xb2d62cf3d
350407.19,14.0,33,4,4,2,10,0xb2d51e20
378.79,1.0,7,1,2,3,6,0xb2d9384d
18012.38,1.0,11,2,2,3,7,0xb2d299b9
48002.39,3.0,41,2,4,2,8,0xb2d5d25f
620.85,1.0,0,1,2,4,7,0xb2d2c31e
1257168.7,8.0,18,4,4,2,10,0xb2d2c27b
770826.67,8.0,21,4,4,2,10,0x3b9b4439
255.14,1.0,10,1,2,3,6,0xb2da23a9
3135498.83,7.0,12,4,4,3,11,0xb2d40c57d
11120.25,2.0,10,2,3,3,8,0xb2d195dbd
11337.15,1.0,21,2,2,2,6,0xb2d965e9
447310.47,4.0,60,4,4,2,10,0xb2d5e53c
20284.21,1.0,49,2,2,2,6,0xb2d65a85
307452.32,4.0,21,4,4,2,10,0xb2d51a40
720002.22,2.0,151,4,3,1,8,0xb2d3d34fd
69.44,1.0,81,1,2,1,4,0xb2d645ecd
305004.41,4.0,11,4,4,3,11,0xb2d5b397
550926.37,3.0,3,4,4,4,12,0xb2d24303
200710.48,2.0,48,3,3,2,8,0xb2d9decb
83973.73,1.0,19,3,2,2,7,0xb2d69695d
9001.63,3.0,15,2,4,3,9,0x3b9b35d0
230.32,1.0,55,1,2,2,5,0xb2d12a83d
1044806.82,3.0,73,4,4,1,9,0xb2d195aa
363355.68,1.0,8,4,2,3,9,0xb2d5a720
1710000.0,15.0,0,4,4,4,12,0xb2d54fc3d
2013.36,2.0,92,1,3,1,5,0xb2d3dfc1d
701427.91,12.0,0,4,4,4,12,0xb2d06b75
630087.71,3.0,1,4,4,4,12,0xb2d2278c
44512.72,1.0,8,2,2,3,7,0xb2d62dd3d
302.99,1.0,92,1,2,1,4,0xb2d27cb1d
1660000.0,14.0,0,4,4,4,12,0xb2d11112
632592.93,8.0,4,4,4,4,12,0xb2d5e930d
1784.15,2.0,0,1,3,4,8,0xb2d09c89
87.97,1.0,24,1,2,2,5,0xb2d162fed
3084.0,2.0,92,2,3,1,6,0xb2d34c14
110002.32,2.0,144,3,3,1,7,0xb2d9082c
51685.37,2.0,4,2,3,4,9,0xb2d5e650
50008.18,2.0,11,2,3,3,8,0xb2d30661
198140.1,3.0,4,3,4,4,11,0xb2d940d2d
906604.96,6.0,0,4,4,4,12,0xb2d41097d
153555.18,1.0,63,3,2,2,7,0xb2d5582d
83176.73,3.0,0,3,4,4,11,0xb2d31599
135551.29,4.0,63,3,4,2,9,0xb2d645fbd
407393.34,8.0,83,4,4,1,9,0xb2d11038
230316.2,1.0,10,3,2,3,8,0xb2d36f31
4209.66,1.0,7,2,2,3,7,0xb2d6ea13
100080.89,3.0,38,3,4,2,9,0xb2d5ece1d
502306.78,3.0,55,4,4,2,10,0x3b9b2f90d
84004.3,4.0,98,3,4,1,8,0xb2d3caa3
57.55,1.0,0,1,2,4,7,0xb2d8ec13
11.95,1.0,53,1,2,2,5,0xb2d5db88
6873.51,1.0,0,2,2,4,8,0xb2d99707
61158.12,3.0,3,3,4,4,11,0xb2d64f21
150007.92,2.0,13,3,3,3,9,0xb2d95a7c
12187.97,1.0,15,2,2,3,7,0xb2d93d7b
1186728.57,5.0,0,4,4,4,12,0x3b9af3e2
3913.25,1.0,184,2,2,1,5,0xb2d2c822d
55846.63,6.0,0,3,4,4,11,0xb2d44a99
652.92,1.0,11,1,2,3,6,0xb2d2529e
620021.03,6.0,6,4,4,3,11,0xb2d473ae
34444.53,1.0,21,2,2,2,6,0xb2d6a05cd
1007420.67,2.0,0,4,3,4,11,0xb2d98e9e
510000.13,3.0,16,4,4,2,10,0xb2d6ef54d
37.38,1.0,12,1,2,3,6,0xb2d06950
282172.98,5.0,1,3,4,4,11,0xb2d0977f
251678.15,3.0,0,3,4,4,11,0xb2d1522cd
27021.04,2.0,21,2,3,2,7,0xb2d6afbdd
5242.74,1.0,0,2,2,4,8,0xb2d7c7c7
20912.76,1.0,12,2,2,3,7,0xb2d6ca13d
80000.84,2.0,60,3,3,2,8,0xb2d9bf2a
2568.21,1.0,1,1,2,4,7,0xb2d18857
70000.7,3.0,67,3,4,1,8,0xb2d5f403
51685.85,3.0,0,2,4,4,10,0x3b9b3cc7
480192.87,2.0,147,4,3,1,8,0xb2d3b307d
2620101.0,103.0,1,4,4,4,12,0xb2d170a6d
600099.52,4.0,13,4,4,3,11,0xb2d6076d
1070.21,1.0,92,1,2,1,4,0xb2d29353d
40000.45,1.0,1,2,2,4,8,0xb2d9cc23
51335.99,2.0,143,2,3,1,6,0xb2d2a38f
126.26,3.0,28,1,4,2,7,0xb2d51b8c
1.28,1.0,61,1,2,2,5,0xb2d8eeadd
1603.98,1.0,184,1,2,1,4,0xb2d1e7b8
7632.37,1.0,4,2,2,4,8,0xb2d9b2b7
200711.64,2.0,27,3,3,2,8,0xb2d219e5
9622.04,1.0,0,2,2,4,8,0xb2d24f96
90000.95,6.0,62,3,4,2,9,0xb2d4760b
428166.68,7.0,10,4,4,3,11,0xb2d3fa58d
35872.75,1.0,3,2,2,4,8,0xb2d95090
400052.26,3.0,20,4,4,2,10,0xb2d6e7fa
200711.06,2.0,22,3,3,2,8,0xb2d40a11
552486.77,3.0,2,4,4,4,12,0xb2d9b5be
1005247.11,2.0,0,4,3,4,11,0xb2d8ffc0
80117.74,4.0,18,3,4,2,9,0xb2d3823c
1818104.54,7.0,14,4,4,3,11,0xb2d16e81
580043.97,3.0,19,4,4,2,10,0xb2d6e87f
200004.22,2.0,18,3,3,2,8,0xb2d9557bd
1041.34,1.0,92,1,2,1,4,0xb2d5a975d
100149.09,3.0,153,3,4,1,8,0xb2d0ab22d
70000.0,4.0,0,3,4,4,11,0xb2d6139dd
18300.85,2.0,27,2,3,2,7,0xb2d6587b
613163.23,5.0,4,4,4,4,12,0xb2d1dcc9d
0.0,1.0,9,1,2,3,6,0xb2d3a817
1084.87,1.0,92,1,2,1,4,0xb2d29e34d
10948.14,1.0,92,2,2,1,5,0xb2d22f81d
575932.02,3.0,75,4,4,1,9,0xb2d6c9bcd
6.26,2.0,88,1,3,1,5,0xb2d88a29
440004.35,4.0,24,4,4,2,10,0xb2d92188
165000.0,8.0,3,3,4,4,11,0xb2d592c2d
12142.98,1.0,3,2,2,4,8,0xb2d2d0a7
3000.99,1.0,92,2,2,1,5,0x3b9adc0b
10000.81,2.0,119,2,3,1,6,0xb2d5eff5
12001.04,1.0,14,2,2,3,7,0xb2d92171d
270763.59,10.0,10,3,4,3,10,0xb2d69c66
10809.7,1.0,10,2,2,3,7,0xb2d13f3dd
350002.91,7.0,42,4,4,2,10,0xb2d0a5f8
338.82,1.0,10,1,2,3,6,0xb2d94162
20125.65,1.0,1,2,2,4,8,0xb2d2f150d
354.74,1.0,3,1,2,4,7,0xb2d596e5
190440.36,2.0,239,3,3,1,7,0xb2d24e00d
52003.29,2.0,184,2,3,1,6,0xb2d2767f
70000.0,2.0,0,3,3,4,10,0xb2d61cacd
267265.22,7.0,0,3,4,4,11,0xb2d33400
60081.06,2.0,62,3,3,2,8,0xb2d68958d
35020.78,2.0,21,2,3,2,7,0xb2d168a2
50159.48,2.0,83,2,3,1,6,0xb2d25ee8
1125.48,1.0,92,1,2,1,4,0xb2d2017cd
2395.07,1.0,0,1,2,4,7,0xb2d786ac
502223.82,2.0,13,4,3,3,10,0xb2d6ce89
14408.15,1.0,184,2,2,1,5,0xb2d16686
8099.13,1.0,10,2,2,3,7,0xb2d2c5ce
2.74,1.0,24,1,2,2,5,0xb2d34357d
0.0,1.0,3,1,2,4,7,0xb2d94c06
17155.85,1.0,1,2,2,4,8,0xb2d2f5ba
103.58,1.0,74,1,2,1,4,0xb2d58968d
40330.82,3.0,41,2,4,2,8,0xb2d6d0f6
350060.27,4.0,0,4,4,4,12,0xb2d9f9a2
572.33,1.0,9,1,2,3,6,0xb2d24d9cd
2.73,1.0,25,1,2,2,5,0xb2d31df9
473.51,1.0,1,1,2,4,7,0xb2d2ffb9d
84.37,1.0,18,1,2,2,5,0xb2d31ac2d
27684.87,1.0,0,2,2,4,8,0xb2d88d9b
398088.37,5.0,0,4,4,4,12,0xb2d55bce
11078.21,1.0,202,2,2,1,5,0xb2d36b74d
51344.73,2.0,1,2,3,4,9,0xb2d53fc7
600004.52,5.0,59,4,4,2,10,0xb2d47d6cd
2016.04,1.0,92,1,2,1,4,0xb2d5a802
200221.06,2.0,7,3,3,3,9,0xb2d8d3b0d
403550.29,3.0,4,4,4,4,12,0xb2d69ae9d
688554.03,6.0,32,4,4,2,10,0xb2d65443
2325000.0,17.0,3,4,4,4,12,0xb2d26f66
25667.0,1.0,26,2,2,2,6,0xb2d13476d
20.46,1.0,32,1,2,2,5,0xb2d9f2dc
30001.27,2.0,92,2,3,1,6,0xb2d66a3dd
80142.55,3.0,4,3,4,4,11,0xb2d5dc12d
200147.82,2.0,15,3,3,3,9,0xb2d12444d
4423.1,1.0,13,2,2,3,7,0xb2d912cd
351243.97,2.0,30,4,3,2,9,0xb2d93f19
551.03,1.0,18,1,2,2,5,0xb2d12cca
596195.65,2.0,11,4,3,3,10,0xb2d534b2d
290007.92,7.0,14,3,4,3,10,0xb2d9d4bd
920006.73,5.0,2,4,4,4,12,0xb2d8a43dd
11632.38,1.0,80,2,2,1,5,0xb2d60c58d
20.58,1.0,12,1,2,3,6,0xb2d9f9b9
1761.9,1.0,92,1,2,1,4,0xb2d22d0cd
9850.54,1.0,163,2,2,1,5,0xb2d3dc32
500000.68,3.0,25,4,4,2,10,0xb2d7833c
31.35,2.0,15,1,3,3,7,0x3b9b3d41d
1142.54,2.0,92,1,3,1,5,0xb2d08efad
1523.79,1.0,146,1,2,1,4,0xb2d2e3b3
1334030.23,6.0,14,4,4,3,11,0xb2d3bc59
503552.57,2.0,36,4,3,2,9,0xb2d8f5b3d
1768.12,1.0,68,1,2,1,4,0xb2d8ee22
2805.13,1.0,0,1,2,4,7,0xb2d65034d
88498.6,3.0,92,3,4,1,8,0xb2d0b524
498775.59,3.0,12,4,4,3,11,0xb2d9e74e
500013.75,9.0,34,4,4,2,10,0xb2d5f9a8
600000.0,4.0,86,4,4,1,9,0xb2d77425
5200.68,4.0,5,2,4,3,9,0xb2d39651d
2007277.53,3.0,32,4,4,2,10,0xb2d2050d
602814.29,2.0,0,4,3,4,11,0xb2d339a6d
500403.92,2.0,26,4,3,2,9,0xb2d2016d
20671.13,1.0,0,2,2,4,8,0xb2d6e304
280002.11,6.0,97,3,4,1,8,0xb2d5abe1
595119.28,3.0,200,4,4,1,9,0xb2d65b43
3634.71,1.0,69,2,2,1,5,0xb2d568b9d
2816.28,1.0,81,1,2,1,4,0xb2d09c9c
1050737.51,6.0,36,4,4,2,10,0xb2d96adf
4280.24,1.0,305,2,2,1,5,0xb2d24dbcd
200063.81,2.0,130,3,3,1,7,0xb2d1ac43d
1320091.21,8.0,3,4,4,4,12,0xb2d681e4
414303.67,3.0,0,4,4,4,12,0xb2d290e1d
42581.19,3.0,1,2,4,4,10,0x3b9b4686
87.91,1.0,133,1,2,1,4,0xb2d91e41d
340911.08,5.0,22,4,4,2,10,0xb2d2d28a
630115.8,3.0,62,4,4,2,10,0xb2d3e54b
1285.39,1.0,278,1,2,1,4,0xb2d0efbed
2920.17,1.0,0,2,2,4,8,0xb2d17528
66.77,1.0,73,1,2,1,4,0xb2d32a0d
1150003.7,7.0,6,4,4,3,11,0xb2d633ef
8495.87,1.0,8,2,2,3,7,0xb2d3f2bcd
800000.0,5.0,4,4,4,4,12,0xb2d92125d
471000.45,8.0,1,4,4,4,12,0xb2d0d095
9200.25,2.0,92,2,3,1,6,0xb2d65877d
340095.75,4.0,11,4,4,3,11,0xb2d1ac3ad
348.34,1.0,23,1,2,2,5,0xb2d320f5d
246614.17,2.0,87,3,3,1,7,0xb2d14e6c
1000065.34,2.0,21,4,3,2,9,0xb2d6e7b4
1875.83,1.0,256,1,2,1,4,0xb2d2f08b
90.75,3.0,54,1,4,2,7,0xb2d3d247d
360504.53,3.0,215,4,4,1,9,0xb2d38df7
1192.41,1.0,92,1,2,1,4,0xb2d1d712
4.89,1.0,0,1,2,4,7,0xb2d9138d
11856.09,1.0,24,2,2,2,6,0xb2d92011d
117620.52,6.0,6,3,4,3,10,0xb2d4382d
2125.95,1.0,92,1,2,1,4,0xb2d2fac7
250000.0,2.0,13,3,3,3,9,0xb2da406b
20183.68,1.0,15,2,2,3,7,0xb2d95eb6d
628.06,1.0,15,1,2,3,6,0xb2d2c945
2121.54,1.0,184,1,2,1,4,0xb2d12603d
270000.0,2.0,18,3,3,2,8,0xb2d959d0d
50205.67,3.0,111,2,4,1,7,0xb2d68940
49.22,5.0,6,1,4,3,8,0xb2d52279
500496.7,2.0,224,4,3,1,8,0xb2d15420
200025.9,2.0,12,3,3,3,9,0xb2d95d55
1283.62,1.0,0,1,2,4,7,0xb2d2e2b8d
442325.03,5.0,30,4,4,2,10,0xb2d3cf59
2433.23,1.0,0,1,2,4,7,0xb2d3e856
21307.84,1.0,0,2,2,4,8,0xb2d34084
52476.97,2.0,119,3,3,1,7,0xb2d1f58b
60128.85,3.0,39,3,4,2,9,0x3b9b2b44
300027.96,3.0,25,3,4,2,9,0xb2d88bd5d
681377.74,7.0,25,4,4,2,10,0xb2d3a566d
161.06,1.0,0,1,2,4,7,0xb2d68fe9d
26962.51,1.0,41,2,2,2,6,0xb2d26bf5
450062.57,3.0,80,4,4,1,9,0xb2d16387
150057.63,2.0,80,3,3,1,7,0xb2d61263d
8995.91,1.0,0,2,2,4,8,0xb2d41039
200014.78,2.0,97,3,3,1,7,0xb2d7fcf2d
84879.06,3.0,3,3,4,4,11,0xb2d10726
200000.0,2.0,11,3,3,3,9,0xb2da4ab9
970037.84,3.0,32,4,4,2,10,0xb2d6ce58d
668013.51,11.0,0,4,4,4,12,0xb2d5c48d
50914.78,2.0,48,2,3,2,7,0xb2d58c42d
3538037.1,1.0,0,4,2,4,10,0xb2d22422d
600004.22,2.0,7,4,3,3,10,0xb2d96a71d
151215.5,2.0,5,3,3,3,9,0xb2d56768
33001.74,2.0,47,2,3,2,7,0xb2d91050d
201608.98,2.0,9,3,3,3,9,0xb2d672e5d
1001.72,1.0,35,1,2,2,5,0xb2d383d7
1184.44,1.0,0,1,2,4,7,0xb2d36155
1434.44,1.0,184,1,2,1,4,0xb2d34483
979011.62,8.0,3,4,4,4,12,0xb2d4ff85
50117.53,2.0,92,2,3,1,6,0xb2d341d9
987.94,1.0,10,1,2,3,6,0xb2d547f6d
383.32,1.0,0,1,2,4,7,0xb2d3219bd
9901.22,1.0,5,2,2,3,7,0xb2d96956
202682.24,6.0,18,3,4,2,9,0xb2d655ed
470.84,1.0,1,1,2,4,7,0xb2d78b32
54270.64,4.0,13,3,4,3,10,0xb2d2e81b
1250016.36,3.0,56,4,4,2,10,0xb2d98c70
300082.1,4.0,18,3,4,2,9,0xb2d240b3
41217.06,2.0,0,2,3,4,9,0xb2d5b00cd
60622.87,3.0,0,3,4,4,11,0x3b9af19d
128534.24,7.0,0,3,4,4,11,0xb2d124d8
126.66,1.0,17,1,2,2,5,0xb2d24263d
1128.16,1.0,92,1,2,1,4,0xb2d2b231
542239.34,1.0,184,4,2,1,7,0xb2d17754
4907.49,1.0,18,2,2,2,6,0xb2d92698
30000.63,2.0,228,2,3,1,6,0xb2d6f452
128001.35,2.0,70,3,3,1,7,0xb2d9a717
7149.37,1.0,184,2,2,1,5,0xb2d20d5cd
24511.95,1.0,5,2,2,3,7,0xb2d1fe30
78.53,1.0,3,1,2,4,7,0xb2d6b7cc
534856.85,4.0,6,4,4,3,11,0xb2d1049a
76.73,1.0,2,1,2,4,7,0xb2d31777
10000.73,2.0,19,2,3,2,7,0xb2d5dcf4d
10355.22,2.0,0,2,3,4,9,0xb2d62ca5
301192.88,2.0,132,4,3,1,8,0xb2d3935dd
343014.34,3.0,164,4,4,1,9,0xb2d23da1d
782198.0,6.0,0,4,4,4,12,0x3b9af28ed
600006.33,2.0,14,4,3,3,10,0xb2d957d9d
200031.11,2.0,260,3,3,1,7,0xb2d6822ed
10597.31,1.0,246,2,2,1,5,0xb2d6536f
90016.35,3.0,39,3,4,2,9,0xb2d26191d
955.28,1.0,53,1,2,2,5,0xb2d18664d
5242.06,1.0,2,2,2,4,8,0xb2d6a653d
30969.5,3.0,11,2,4,3,9,0xb2d069d1
11364.4,1.0,0,2,2,4,8,0xb2d309f7
115012.89,2.0,39,3,3,2,8,0xb2d5ccbad
1952.82,1.0,2,1,2,4,7,0xb2d0f270
5512.35,1.0,16,2,2,2,6,0xb2d9465b
41731.0,1.0,3,2,2,4,8,0xb2da643b
90007.77,2.0,0,3,3,4,10,0xb2d1a597
90003.75,4.0,53,3,4,2,9,0xb2d65003d
9498.79,1.0,8,2,2,3,7,0xb2d2088fd
694201.85,6.0,14,4,4,3,11,0xb2d1f384
7632.21,1.0,1,2,2,4,8,0xb2d65014
4324.74,1.0,13,2,2,3,7,0xb2d2a78f
18655.23,1.0,137,2,2,1,5,0xb2d4d48c
621496.92,3.0,40,4,4,2,10,0xb2d6dbba
150011.29,3.0,59,3,4,2,9,0xb2d65422
8560.84,4.0,0,2,4,4,10,0x3b9af2cd
250772.44,4.0,9,3,4,3,10,0xb2d57caad
5262.97,1.0,184,2,2,1,5,0xb2d3f58ad
207253.87,2.0,35,3,3,2,8,0xb2d9c5a5
254482.43,3.0,18,3,4,2,9,0xb2d25d50
570251.9,4.0,11,4,4,3,11,0xb2d5e7c7
703601.44,9.0,0,4,4,4,12,0xb2d5bb1d
183653.39,1.0,24,3,2,2,7,0xb2d48812
103678.39,2.0,221,3,3,1,7,0xb2d550cd
650102.92,1.0,25,4,2,2,8,0xb2d984d6
3234.6,1.0,0,2,2,4,8,0xb2d68ff4
52109.07,1.0,3,2,2,4,8,0xb2d58627
433737.45,11.0,5,4,4,3,11,0xb2d5d764d
175289.36,1.0,5,3,2,3,8,0xb2da165a
25169.8,1.0,184,2,2,1,5,0xb2d356a8
268152.13,3.0,31,3,4,2,9,0xb2d52b52
84107.96,2.0,129,3,3,1,7,0xb2d69ac4
440021.87,7.0,33,4,4,2,10,0xb2d17807
10457.17,3.0,119,2,4,1,7,0xb2d075e5
1778.57,1.0,231,1,2,1,4,0xb2d26bbcd
14.9,1.0,117,1,2,1,4,0xb2d22870
7000182.09,2.0,62,4,3,2,9,0xb2d334fbd
11.2,1.0,59,1,2,2,5,0xb2d35b6fd
220012.38,4.0,31,3,4,2,9,0xb2d1819b
500017.84,3.0,4,4,4,4,12,0xb2d97947
90609.38,5.0,19,3,4,2,9,0xb2d55e1f
170312.98,9.0,0,3,4,4,11,0x3b9b180ed
0.0,2.0,52,1,3,2,6,0xb2d0fc92d
60652.97,2.0,129,3,3,1,7,0xb2d2a4be
60016.37,4.0,116,3,4,1,8,0xb2d5f806
562.39,1.0,17,1,2,2,5,0xb2d564aed
35.47,1.0,68,1,2,1,4,0xb2d9638f
40001.69,2.0,34,2,3,2,7,0xb2d92f86
36705.14,1.0,92,2,2,1,5,0xb2d3d819d
9382.29,1.0,0,2,2,4,8,0xb2d3fe42
360013.57,3.0,139,4,4,1,9,0xb2d62a48
12198.39,2.0,0,2,3,4,9,0xb2d5f6e2
126.0,1.0,13,1,2,3,6,0xb2d25db1
759568.54,3.0,148,4,4,1,9,0xb2d54e7ad
620019.81,4.0,132,4,4,1,9,0xb2d09633
230796.52,3.0,56,3,4,2,9,0xb2d8ea29
638008.93,8.0,0,4,4,4,12,0xb2d5e374
0.0,1.0,5,1,2,3,6,0xb2d645dcd
97.47,1.0,39,1,2,2,5,0xb2d59f97
4635.82,1.0,17,2,2,2,6,0xb2d78ecb
50078.16,2.0,173,2,3,1,6,0xb2d6ac21
20001.5,2.0,132,2,3,1,6,0xb2d6dfced
80007.6,2.0,83,3,3,1,7,0xb2d982f1
303587.26,3.0,143,4,4,1,9,0xb2d6c57f
330194.62,5.0,2,4,4,4,12,0xb2d0fdbad
15006.64,1.0,2,2,2,4,8,0xb2d815d0
252.0,1.0,0,1,2,4,7,0xb2d78739
53.01,2.0,23,1,3,2,6,0xb2d211abd
311719.69,2.0,77,4,3,1,8,0xb2d2a9d3
2412.81,1.0,0,1,2,4,7,0xb2d6b7c4
14194.0,1.0,23,2,2,2,6,0xb2d35894d
279509.18,2.0,18,3,3,2,8,0xb2d62c14d
1104028.46,7.0,6,4,4,3,11,0xb2d18a7a
1500310.13,3.0,3,4,4,4,12,0xb2d068fe
6186.22,1.0,92,2,2,1,5,0xb2d22c07d
1865.85,2.0,21,1,3,2,6,0xb2d2e5afd
60100.0,2.0,0,3,3,4,10,0xb2d97cec
139567.4,3.0,13,3,4,3,10,0xb2d42aca
4233.79,1.0,197,2,2,1,5,0xb2d2ad5b
7.25,1.0,26,1,2,2,5,0xb2d37cea
232032.01,7.0,18,3,4,2,9,0xb2d2598d
110002.75,3.0,92,3,4,1,8,0xb2d63775d
20001.06,2.0,34,2,3,2,7,0xb2d9f66d
840.72,1.0,3,1,2,4,7,0xb2d5d747
535069.1,3.0,97,4,4,1,9,0xb2d58ab5
997.9,1.0,8,1,2,3,6,0xb2d37075
255606.29,4.0,1,3,4,4,11,0xb2d2a9c0d
896.33,1.0,23,1,2,2,5,0xb2d54f7b
3024.85,1.0,184,2,2,1,5,0xb2d34ecc
267163.62,3.0,0,3,4,4,11,0xb2d09195
35.5,1.0,46,1,2,2,5,0xb2d5a5c1d
3.0,1.0,0,1,2,4,7,0xb2d976f3
97.69,1.0,26,1,2,2,5,0xb2d32a2f
20363.56,2.0,206,2,3,1,6,0xb2d5b84bd
99.04,1.0,75,1,2,1,4,0xb2d58cbc
248217.41,3.0,18,3,4,2,9,0xb2d17fc9
1214570.51,14.0,0,4,4,4,12,0xb2d6b6f6d
130513.76,2.0,0,3,3,4,10,0xb2d58391
5753.25,2.0,184,2,3,1,6,0xb2d42b9c
9306.24,1.0,184,2,2,1,5,0xb2d21e50
3015.6,4.0,197,2,4,1,7,0xb2d0fbc7d
201421.11,2.0,74,3,3,1,7,0xb2d8e3f2
73.7,3.0,2,1,4,4,9,0x3b9b43f3d
201731.7,2.0,30,3,3,2,8,0xb2d8c42ed
150075.72,4.0,87,3,4,1,8,0x3b9b42abd
10351.94,1.0,2,2,2,4,8,0xb2d2e818
405064.44,12.0,2,4,4,4,12,0xb2d5aab1d
1007.91,1.0,92,1,2,1,4,0xb2d3465b
41229.33,3.0,0,2,4,4,10,0xb2d94567d
869540.62,6.0,66,4,4,2,10,0xb2d3b456d
223417.76,1.0,90,3,2,1,6,0xb2d0805e
182329.71,4.0,3,3,4,4,11,0xb2d41320d
33.71,1.0,3,1,2,4,7,0xb2d31418d
3253.43,1.0,19,2,2,2,6,0xb2d1e50f
50278.6,1.0,11,2,2,3,7,0xb2d25334d
3108.83,1.0,46,2,2,2,6,0xb2d0e36ad
250002.64,3.0,95,3,4,1,8,0xb2d97a45
17508.75,1.0,0,2,2,4,8,0xb2d0cc8e
150007.2,2.0,133,3,3,1,7,0xb2d19127
8467.39,2.0,13,2,3,3,8,0xb2d06c3e
25.86,1.0,67,1,2,1,4,0xb2d4faf1
911772.04,17.0,15,4,4,3,11,0xb2d1f874
4638.19,1.0,1,2,2,4,8,0xb2d2eef2d
2104622.06,4.0,9,4,4,3,11,0xb2d6471c
1029.53,1.0,184,1,2,1,4,0xb2d246a4
302090.22,2.0,8,4,3,3,10,0xb2d4b63ed
350651.02,4.0,4,4,4,4,12,0xb2d81f20
500002.12,2.0,13,4,3,3,10,0xb2d8d9e6d
412272.28,3.0,15,4,4,3,11,0xb2d1d46ad
1874980.0,2.0,0,4,3,4,11,0xb2d296aa
22521.6,1.0,0,2,2,4,8,0xb2d53b43
215.82,1.0,0,1,2,4,7,0xb2d17bf7d
18892.68,2.0,24,2,3,2,7,0xb2d552c3d
4501.19,1.0,8,2,2,3,7,0xb2d9ca5b
50081.62,2.0,54,2,3,2,7,0xb2d6f199
2329.13,1.0,195,1,2,1,4,0xb2d41a66d
0.0,1.0,4,1,2,4,7,0xb2d96e31d
7.11,1.0,12,1,2,3,6,0xb2d26e74d
11.8,1.0,37,1,2,2,5,0xb2d3fc78
130472.43,4.0,3,3,4,4,11,0xb2d412d9
195000.0,2.0,4,3,3,4,10,0xb2d17cf2
420485.24,7.0,0,4,4,4,12,0xb2d1be62
10000.11,2.0,25,2,3,2,7,0xb2da17cc
360003.82,6.0,95,4,4,1,9,0xb2d18cfc
88098.95,2.0,23,3,3,2,8,0xb2d9341f
15195710.18,2.0,73,4,3,1,8,0xb2d32c7fd
518212.23,2.0,105,4,3,1,8,0xb2d6053dd
90002.85,6.0,6,3,4,3,10,0xb2d95893d
0.63,1.0,12,1,2,3,6,0xb2d638a3
432013.29,2.0,157,4,3,1,8,0xb2d2e9cb
116539.4,3.0,0,3,4,4,11,0xb2d0dd80d
65.64,1.0,40,1,2,2,5,0xb2d16395
2534.62,1.0,1,1,2,4,7,0xb2d24d82
144.48,1.0,9,1,2,3,6,0xb2d2602f
230000.0,2.0,4,3,3,4,10,0xb2da6131
200064.66,2.0,8,3,3,3,9,0xb2d58b83d
14744.22,1.0,10,2,2,3,7,0xb2d8ea6a
37052.49,1.0,0,2,2,4,8,0xb2d315bad
114052.99,4.0,5,3,4,3,10,0xb2da2d31
204141.93,4.0,87,3,4,1,8,0xb2d96e5a
412514.55,4.0,2,4,4,4,12,0xb2d21abb
48975.87,1.0,15,2,2,3,7,0xb2d16d30d
719.19,1.0,4,1,2,4,7,0xb2d1cb5e
50292.84,2.0,12,2,3,3,8,0xb2d180a0
1100033.92,5.0,1,4,4,4,12,0xb2d57475
320043.58,2.0,3,4,3,4,11,0xb2d9f95d
6.7,1.0,39,1,2,2,5,0xb2d2c451d
812800.96,4.0,21,4,4,2,10,0xb2d6abdcd
4420.26,1.0,15,2,2,3,7,0xb2d6c8ba
1019370.38,2.0,11,4,3,3,10,0xb2d6a227d
190155.08,3.0,22,3,4,2,9,0xb2d8db5e
794388.41,6.0,95,4,4,1,9,0x3b9b2c40
87529.71,3.0,129,3,4,1,8,0xb2d2271b
101708.8,2.0,164,3,3,1,7,0xb2d60936d
8101.78,1.0,0,2,2,4,8,0xb2d6a802
1256.81,1.0,29,1,2,2,5,0xb2d44744
2518.47,1.0,14,1,2,3,6,0xb2d5ea4d
85277.49,1.0,0,3,2,4,9,0xb2d50401
58009.44,2.0,56,3,3,2,8,0xb2d625f7
102804.96,2.0,92,3,3,1,7,0xb2d58911
238045.23,3.0,12,3,4,3,10,0xb2d24584d
19852.89,1.0,0,2,2,4,8,0xb2d6c0c5
2408525.6,3.0,32,4,4,2,10,0xb2d0a0c8d
202196.62,2.0,110,3,3,1,7,0xb2d8690b
2570.4,3.0,0,1,4,4,9,0xb2d8913e
3926.67,1.0,2,2,2,4,8,0xb2d92a5b
0.0,1.0,1,1,2,4,7,0xb2d43b5ed
1600000.0,5.0,0,4,4,4,12,0xb2d979a2
64302.97,4.0,2,3,4,4,11,0xb2d56f41d
95.36,1.0,49,1,2,2,5,0xb2d1f5a7
500752.12,3.0,21,4,4,2,10,0xb2d98013
712010.62,13.0,25,4,4,2,10,0xb2d44903d
2048.15,1.0,92,1,2,1,4,0xb2d2403f
110003.48,2.0,206,3,3,1,7,0xb2d5bfa4d
847031.3,8.0,8,4,4,3,11,0xb2d0735c
193008.08,1.0,11,3,2,3,8,0xb2d9149a
54.01,1.0,157,1,2,1,4,0xb2d62603
1238644.95,4.0,3,4,4,4,12,0xb2d54ea2
150017.8,4.0,39,3,4,2,9,0xb2d1b8b4d
600006.02,2.0,29,4,3,2,9,0xb2da0632
6279.79,1.0,39,2,2,2,6,0xb2d5fe3dd
400041.79,3.0,20,4,4,2,10,0xb2d579be
2545733.53,4.0,6,4,4,3,11,0xb2d228cd
300034.84,1.0,21,3,2,2,7,0xb2d0b8de
69114.41,1.0,1,3,2,4,9,0xb2d24016
51.8,1.0,13,1,2,3,6,0xb2d635a1d
7618.87,1.0,0,2,2,4,8,0xb2d3c286
40001.05,3.0,32,2,4,2,8,0xb2d96328d
2106.85,1.0,110,1,2,1,4,0xb2d5eb6a
40387.27,3.0,0,2,4,4,10,0xb2d4c136
120585.5,1.0,92,3,2,1,6,0xb2d2df2ad
570403.99,6.0,21,4,4,2,10,0xb2d2cad5d
3795.34,1.0,23,2,2,2,6,0xb2d4f7da
205023.1,3.0,6,3,4,3,10,0xb2d40ca1
263585.34,1.0,108,3,2,1,6,0x3b9b347ad
354254.93,1.0,22,4,2,2,8,0xb2d105f6d
13917.78,1.0,0,2,2,4,8,0xb2d91300
518485.18,2.0,3,4,3,4,11,0xb2d91b2a
103.32,1.0,20,1,2,2,5,0xb2d2062c
70006.64,3.0,20,3,4,2,9,0xb2d5f331
17008.97,1.0,0,2,2,4,8,0xb2d68c70
1226.18,1.0,184,1,2,1,4,0xb2d06820d
428184.01,5.0,6,4,4,3,11,0xb2d60e9cd
7830.71,5.0,0,2,4,4,10,0x3b9ae934
200004.59,7.0,31,3,4,2,9,0xb2d17242
273094.78,9.0,18,3,4,2,9,0xb2d3e2bfd
360.26,1.0,9,1,2,3,6,0xb2d4cb7b
262711.03,3.0,20,3,4,2,9,0xb2d558e7
15006911.5,1.0,1,4,2,4,10,0xb2d4c9ead
370016.66,5.0,67,4,4,1,9,0xb2d5f68c
130085.63,3.0,34,3,4,2,9,0xb2d5785b
2614.98,1.0,184,1,2,1,4,0xb2d26813
470010.12,2.0,25,4,3,2,9,0xb2d93851
394002.97,4.0,88,4,4,1,9,0xb2d59619d
1132.26,1.0,1,1,2,4,7,0xb2d18f24
201546.33,2.0,4,3,3,4,10,0xb2d99973
570006.55,3.0,13,4,4,3,11,0xb2d637b0d
7067.45,1.0,92,2,2,1,5,0xb2d2b326
1256513.34,21.0,6,4,4,3,11,0xb2d175a6
96.75,1.0,17,1,2,2,5,0xb2d2802f
20055.58,2.0,32,2,3,2,7,0xb2d589de
20710.78,1.0,11,2,2,3,7,0xb2d6511b
40000.0,2.0,1,2,3,4,9,0xb2da61c1
200000.0,2.0,0,3,3,4,10,0xb2d4d1b8
640108.76,6.0,18,4,4,2,10,0xb2d561a1
25111.48,1.0,103,2,2,1,5,0xb2d34f12
40000000.0,2.0,7,4,3,3,10,0xb2da4cb6
43740.13,1.0,11,2,2,3,7,0xb2d96bbd
788545.48,7.0,0,4,4,4,12,0xb2d4e8f4d
30010.33,2.0,71,2,3,1,6,0xb2d9806c
50598.78,1.0,0,2,2,4,8,0xb2d6a7e4d
1270046.95,5.0,87,4,4,1,9,0xb2d14b15
4500017.46,7.0,0,4,4,4,12,0xb2d4ec38
300464.61,1.0,7,4,2,3,9,0xb2d6d128
2437.77,1.0,184,1,2,1,4,0xb2d2dd32d
152898.47,2.0,95,3,3,1,7,0xb2d57b64d
50001.4,2.0,92,2,3,1,6,0xb2d6557d
260000.0,2.0,3,3,3,4,10,0xb2da657e
30000.0,2.0,4,2,3,4,9,0xb2da51cd
2012817.29,8.0,7,4,4,3,11,0xb2d3cbc5d
163237.26,4.0,0,3,4,4,11,0xb2d0d94fd
9297.31,1.0,92,2,2,1,5,0xb2d21e50d
568385.47,5.0,3,4,4,4,12,0x3b9b343bd
560001.62,3.0,35,4,4,2,10,0xb2d2bc41d
3570.13,1.0,237,2,2,1,5,0xb2d61a7cd
50759.58,2.0,77,2,3,1,6,0xb2d60ca5d
235015.7,4.0,27,3,4,2,9,0xb2d5a34a
9035.02,1.0,184,2,2,1,5,0xb2d3e95d
200032.1,3.0,111,3,4,1,8,0xb2d21e01
170000.0,3.0,1,3,4,4,11,0xb2d64f38d
88.31,1.0,5,1,2,3,6,0xb2d4a9c6
50688.92,1.0,54,2,2,2,6,0xb2d0aa42d
72.23,1.0,32,1,2,2,5,0xb2d98452d
21012.15,1.0,21,2,2,2,6,0xb2d5c0f0
136.83,1.0,0,1,2,4,7,0xb2d5017f
34.92,1.0,213,1,2,1,4,0xb2d3bf5b
1010.56,1.0,184,1,2,1,4,0xb2d2b86c
2815926.01,14.0,6,4,4,3,11,0xb2d40699
2.43,1.0,13,1,2,3,6,0xb2d5e617
90102.55,2.0,70,3,3,1,7,0xb2d10d94
152.8,1.0,28,1,2,2,5,0xb2d9052f
5754.88,1.0,0,2,2,4,8,0xb2d34398
20343.25,2.0,34,2,3,2,7,0xb2d2af79
24.78,1.0,10,1,2,3,6,0xb2d99c05
424478.9,3.0,29,4,4,2,10,0xb2d0756f
100606.0,2.0,119,3,3,1,7,0xb2d634ecd
852926.29,3.0,19,4,4,2,10,0xb2d8c362d
94.03,1.0,10,1,2,3,6,0xb2d94e74
629652.63,11.0,0,4,4,4,12,0xb2d30745
151905.54,3.0,122,3,4,1,8,0xb2d5df98
522685.6,2.0,9,4,3,3,10,0xb2d4ad2cd
276835.05,5.0,0,3,4,4,11,0xb2d0694ed
107.07,1.0,7,1,2,3,6,0xb2d4d3bf
30128.6,3.0,0,2,4,4,10,0xb2d293f0
760000.0,3.0,13,4,4,3,11,0xb2d94e3ad
65.9,1.0,3,1,2,4,7,0xb2d781d8d
820008.68,2.0,196,4,3,1,8,0xb2d7f245d
420000.0,2.0,22,4,3,2,9,0xb2da2132
68.06,1.0,9,1,2,3,6,0xb2d6bddb
50528.51,1.0,184,2,2,1,5,0xb2d2a6b3
400000.64,2.0,20,4,3,2,9,0xb2d68b0a
103058.88,2.0,214,3,3,1,7,0xb2d56432
1200000.0,2.0,29,4,3,2,9,0xb2da0a6a
90066.28,6.0,11,3,4,3,10,0xb2d8da7d
416831.53,5.0,1,4,4,4,12,0xb2d1c496d
474.87,1.0,3,1,2,4,7,0xb2d2d84e
3002.14,1.0,11,2,2,3,7,0xb2d64c49
0.0,2.0,10,1,3,3,7,0xb2d9c6bc
1552.03,1.0,8,1,2,3,6,0xb2d0ffd7
1189.73,1.0,184,1,2,1,4,0xb2d2818e
2488.11,1.0,9,1,2,3,6,0xb2d35333
50328.67,1.0,92,2,2,1,5,0xb2d3a837
4524.83,1.0,92,2,2,1,5,0xb2d50150
260000.88,8.0,1,3,4,4,11,0xb2d36b24
2001.11,1.0,9,1,2,3,6,0xb2d63fb9
1104.47,2.0,165,1,3,1,5,0xb2d51290d
0.0,1.0,0,1,2,4,7,0xb2d77f18
975.18,2.0,0,1,3,4,8,0x3b9b45b0
20000.0,2.0,4,2,3,4,9,0xb2da34df
1613.22,1.0,9,1,2,3,6,0xb2d2f132
149.68,1.0,8,1,2,3,6,0xb2d2761b
207574.47,2.0,193,3,3,1,7,0xb2d58dd5d
2144.15,1.0,24,1,2,2,5,0xb2d23929
2615.45,1.0,10,1,2,3,6,0xb2d6e5cd
44005.8,2.0,6,2,3,3,8,0xb2d54c48
911.78,1.0,0,1,2,4,7,0xb2d4d09e
1363218.15,5.0,14,4,4,3,11,0xb2d38e7a
29000.12,5.0,8,2,4,3,9,0xb2da1250
1800002.53,9.0,1,4,4,4,12,0xb2d6e0d8
20008.22,2.0,73,2,3,1,6,0xb2d8e381d
44924.71,2.0,0,2,3,4,9,0xb2d31588
7832.16,3.0,0,2,4,4,10,0x3b9af220
617.88,9.0,0,1,4,4,9,0xb2d09fd7d
310000.0,3.0,9,4,4,3,11,0xb2d0dd10
1949.17,1.0,0,1,2,4,7,0xb2d92256
320301.07,12.0,0,4,4,4,12,0xb2d60593d
86.43,1.0,6,1,2,3,6,0xb2d42c3f
700238.35,7.0,39,4,4,2,10,0xb2d07eb2
2409.55,1.0,9,1,2,3,6,0xb2d6c8bd
50427.03,2.0,59,2,3,2,7,0xb2d1a26c
12256.39,8.0,0,2,4,4,10,0x3b9af1c4
846776.34,6.0,4,4,4,4,12,0xb2d1e0fdd
128777.46,3.0,129,3,4,1,8,0xb2d16b5ad
170005.91,4.0,14,3,4,3,10,0xb2d9974a
360123.59,3.0,59,4,4,2,10,0xb2d28990d
35294.94,4.0,132,2,4,1,7,0x3b9adc98d
30823.0,1.0,13,2,2,3,7,0xb2d36a66
50997.11,1.0,5,2,2,3,7,0xb2d488a8
599.74,1.0,6,1,2,3,6,0xb2d9497a
1006758.42,2.0,0,4,3,4,11,0xb2d38e9b
10003.88,1.0,15,2,2,3,7,0xb2d6b17cd
170078.07,3.0,63,3,4,2,9,0xb2d57582
130032.7,2.0,216,3,3,1,7,0xb2d596bd
89031.93,2.0,0,3,3,4,10,0xb2d3b24ed
6091.95,1.0,14,2,2,3,7,0xb2d948b2
549048.72,9.0,60,4,4,2,10,0xb2d24a9dd
12191.01,1.0,0,2,2,4,8,0xb2d5d3a4
10800.61,1.0,4,2,2,4,8,0xb2d2c21b
791782.47,5.0,30,4,4,2,10,0xb2d8fef3
150023.93,3.0,6,3,4,3,10,0xb2d91a23
10.98,1.0,10,1,2,3,6,0xb2d2ab3d
17200.28,1.0,14,2,2,3,7,0xb2d6be42
57983.35,3.0,0,3,4,4,11,0xb2d61357d
15000.48,2.0,206,2,3,1,6,0xb2d68ca9
2137.39,1.0,0,1,2,4,7,0xb2d5355a
70016.8,4.0,66,3,4,2,9,0xb2d5f710d
152785.81,2.0,14,3,3,3,9,0xb2d55e77d
1060289.87,8.0,11,4,4,3,11,0xb2d071a3d
1005.04,1.0,34,1,2,2,5,0xb2d106da
441.73,1.0,9,1,2,3,6,0xb2d3c261
50030.53,2.0,1,2,3,4,9,0xb2d9c7b8
26233.54,2.0,28,2,3,2,7,0xb2d4fe34d
130004.75,3.0,45,3,4,2,9,0xb2d6fd3a
1035280.06,8.0,11,4,4,3,11,0xb2d2eb41
1562.35,1.0,140,1,2,1,4,0xb2d4128ad
376444.06,3.0,97,4,4,1,9,0xb2d2ba99d
10598.9,2.0,21,2,3,2,7,0xb2d28424
50072.8,2.0,185,2,3,1,6,0xb2d5e650d
328055.59,4.0,33,4,4,2,10,0xb2d0cf17
3827.76,1.0,184,2,2,1,5,0xb2d392c7d
6528.55,2.0,0,2,3,4,9,0x3b9b46cdd
1867.55,1.0,10,1,2,3,6,0xb2d9ec9b
203527.91,2.0,95,3,3,1,7,0xb2d09ef4
3517.85,1.0,56,2,2,2,6,0xb2d6dfb6
6693.53,2.0,92,2,3,1,6,0xb2d1a47bd
508885.74,6.0,6,4,4,3,11,0xb2d699ffd
4.75,1.0,12,1,2,3,6,0xb2d99556
150014.2,3.0,31,3,4,2,9,0xb2d26105d
712732.42,4.0,0,4,4,4,12,0xb2d6210a
9089.15,2.0,0,2,3,4,9,0xb2d20ac7
807.9,1.0,13,1,2,3,6,0xb2d12375
2158.47,1.0,97,1,2,1,4,0xb2d54ff1
85009.54,2.0,67,3,3,1,7,0xb2d63a39
150004.95,3.0,83,3,4,1,8,0xb2d3f253
32.3,1.0,13,1,2,3,6,0xb2d8febd
60266.46,3.0,27,3,4,2,9,0xb2d6a42b
6013.87,5.0,0,2,4,4,10,0xb2d0a637
5000329.84,2.0,184,4,3,1,8,0xb2d2ddc8
340000.46,2.0,21,4,3,2,9,0xb2d98e28
0.33,1.0,184,1,2,1,4,0xb2d44bf8
600000.0,4.0,1,4,4,4,12,0xb2d785a1
10.56,1.0,81,1,2,1,4,0xb2d8d667
196050.94,2.0,3,3,3,4,10,0xb2d10d49
1893.46,1.0,184,1,2,1,4,0xb2d3984c
701.99,1.0,51,1,2,2,5,0xb2d34fa1
258.01,8.0,42,1,4,2,7,0xb2d5986fd
10116.11,1.0,92,2,2,1,5,0xb2d3452ad
60006.13,2.0,76,3,3,1,7,0xb2d22259
10086.57,1.0,92,2,2,1,5,0xb2d2f225d
164589.92,2.0,101,3,3,1,7,0xb2d12489
358621.55,2.0,1,4,3,4,11,0xb2d339d0d
1800.8,1.0,2,1,2,4,7,0xb2d90e70
14872.56,1.0,18,2,2,2,6,0xb2d987ef
101400.61,3.0,5,3,4,3,10,0xb2d5cc2fd
5355.72,1.0,14,2,2,3,7,0xb2d5d766
77612.2,1.0,10,3,2,3,8,0xb2d3cc86
106085.15,3.0,73,3,4,1,8,0xb2d48e8c
304.47,1.0,3,1,2,4,7,0xb2d27a9f
20000.42,2.0,6,2,3,3,8,0xb2d966b7
421107.38,15.0,32,4,4,2,10,0xb2d5f285
34493.32,1.0,167,2,2,1,5,0xb2d4c096
31120.71,15.0,0,2,4,4,10,0x3b9af1eb
4109.07,1.0,187,2,2,1,5,0xb2d51d00
500048.13,7.0,102,4,4,1,9,0xb2d1a54e
1025038.43,7.0,2,4,4,4,12,0xb2d3ab9f
250888.15,2.0,54,3,3,2,8,0xb2d9c92c
400018.63,2.0,13,4,3,3,10,0xb2d9a1a8
200008.44,2.0,76,3,3,1,7,0xb2d8db4dd
24702.51,1.0,12,2,2,3,7,0xb2d6f082
692.66,1.0,3,1,2,4,7,0xb2d3152a
175763.72,1.0,9,3,2,3,8,0xb2d2ae3fd
181023.43,3.0,0,3,4,4,11,0xb2d6967cd
28.16,1.0,75,1,2,1,4,0xb2d5bfa0
200032.6,2.0,25,3,3,2,8,0xb2d0eda4d
8330.29,1.0,1,2,2,4,8,0xb2d2b5bd
54904.29,2.0,60,3,3,2,8,0xb2d2b920
507827.07,3.0,18,4,4,2,10,0xb2d645a2
4003206.58,1.0,5,4,2,3,9,0xb2d2f6b3d
116999.2,2.0,2,3,3,4,10,0xb2d31de6
283005.97,2.0,18,3,3,2,8,0xb2d955a8
2225.75,1.0,120,1,2,1,4,0xb2d9062ad
180073.0,2.0,84,3,3,1,7,0xb2d698d5
21.91,1.0,68,1,2,1,4,0xb2d69a85
10.07,1.0,13,1,2,3,6,0xb2d96b4a
1510658.62,2.0,77,4,3,1,8,0xb2d99a7c
1005554.73,2.0,0,4,3,4,11,0xb2d62a31
862594.11,7.0,3,4,4,4,12,0xb2d354f9
551088.26,4.0,7,4,4,3,11,0xb2d6113f
271246.92,4.0,20,3,4,2,9,0xb2d29a98
146694.28,2.0,0,3,3,4,10,0xb2d2ef3f
279642.49,3.0,1,3,4,4,11,0xb2d9077bd
218930.5,3.0,28,3,4,2,9,0xb2d54f51
693148.16,6.0,0,4,4,4,12,0x3b9b1014
100005.09,2.0,0,3,3,4,10,0xb2d64341d
210000.82,3.0,2,3,4,4,11,0xb2d48149
13596.55,1.0,0,2,2,4,8,0xb2d0b92b
611848.0,8.0,69,4,4,1,9,0xb2d2cabc
307000.02,25.0,0,4,4,4,12,0xb2d1bb10
216000.0,1.0,0,3,2,4,9,0xb2da69b1
50584.73,2.0,118,2,3,1,6,0xb2d680b4
3020757.87,3.0,53,4,4,2,10,0xb2d3b786
1.58,1.0,35,1,2,2,5,0xb2d5d981
100007.14,3.0,187,3,4,1,8,0xb2d6a2f8
135697.27,7.0,8,3,4,3,10,0xb2d5f058
200000.35,2.0,25,3,3,2,8,0xb2d9ca08
489591.08,4.0,48,4,4,2,10,0xb2d1049ad
199.83,1.0,32,1,2,2,5,0xb2d93f3c
10000000.0,2.0,0,4,3,4,11,0xb2d97e7fd
516003.97,2.0,109,4,3,1,8,0xb2d6a52f
32294.26,4.0,17,2,4,2,8,0xb2d380d7
100970.45,2.0,5,3,3,3,9,0xb2d2e5c5d
13965.02,1.0,7,2,2,3,7,0xb2d499f2d
6888.82,1.0,184,2,2,1,5,0xb2d36bbf
88.06,1.0,9,1,2,3,6,0xb2d5daae
109110.44,2.0,19,3,3,2,8,0xb2d39a89
140006.38,3.0,42,3,4,2,9,0xb2d12add
108501.27,3.0,0,3,4,4,11,0xb2d661f1
337247.13,6.0,0,4,4,4,12,0x3b9b102ad
21.22,1.0,32,1,2,2,5,0xb2d6fe99d
10810.64,1.0,9,2,2,3,7,0xb2d97c57
303263.71,2.0,63,4,3,2,9,0xb2d93ef8d
73.67,1.0,5,1,2,3,6,0xb2d53541
255331.91,2.0,122,3,3,1,7,0xb2d8c397
2821.15,1.0,3,1,2,4,7,0xb2d8fa78
22905.5,3.0,1,2,4,4,10,0xb2d09cacd
400007.63,3.0,26,4,4,2,10,0xb2d2db5b
23093.08,1.0,11,2,2,3,7,0xb2d247f3d
50000000.0,1.0,0,4,2,4,10,0xb2da4002
480004.38,3.0,1,4,4,4,12,0xb2d980cad
2103.66,1.0,0,1,2,4,7,0xb2d37945d
100001.06,2.0,13,3,3,3,9,0xb2d95d9a
13.62,1.0,21,1,2,2,5,0xb2d2e433
307762.75,4.0,49,4,4,2,10,0xb2d5906dd
5631.32,1.0,10,2,2,3,7,0xb2d2ac15
17584.68,1.0,0,2,2,4,8,0xb2d50bebd
12046.22,1.0,0,2,2,4,8,0xb2d83c65
802196.09,3.0,18,4,4,2,10,0xb2d78f2dd
12684.98,1.0,0,2,2,4,8,0xb2d3701bd
50159.7,1.0,184,2,2,1,5,0xb2d54ff9d
13457.35,2.0,8,2,3,3,8,0xb2d0e6fed
62.9,1.0,60,1,2,2,5,0xb2d4ae1a
488431.19,9.0,18,4,4,2,10,0xb2d16c51d
562269.24,5.0,22,4,4,2,10,0xb2d38d60d
1494.59,1.0,1,1,2,4,7,0xb2d38299
590052.55,4.0,0,4,4,4,12,0xb2d1f402
205788.69,1.0,259,3,2,1,6,0xb2d1dd4f
226.51,1.0,17,1,2,2,5,0xb2d52bc2
10140.43,9.0,3,2,4,4,10,0xb2d36fb1
3183.54,1.0,92,2,2,1,5,0xb2d63bba
5643.51,1.0,18,2,2,2,6,0xb2d36b8f
460018.25,2.0,193,4,3,1,8,0xb2d6c09ed
6365.44,4.0,0,2,4,4,10,0x3b9b25e5d
200105.35,3.0,10,3,4,3,10,0xb2d8d146
40214.53,2.0,6,2,3,3,8,0xb2d6e454d
50027.81,2.0,95,2,3,1,6,0xb2d61b37
26038.56,1.0,82,2,2,1,5,0xb2d63320d
603.24,1.0,0,1,2,4,7,0xb2d437ecd
658.07,1.0,9,1,2,3,6,0xb2d4da23
36786.45,1.0,5,2,2,3,7,0xb2d6c4bb
2052.94,1.0,33,1,2,2,5,0xb2d696c9
210009.3,3.0,13,3,4,3,10,0xb2d18062
112.3,1.0,10,1,2,3,6,0xb2d32f75d
161922.49,3.0,20,3,4,2,9,0xb2d0e0ea
40000.0,2.0,6,2,3,3,8,0xb2d96ffa
1032.47,1.0,92,1,2,1,4,0xb2d29177
219446.52,3.0,39,3,4,2,9,0xb2d0d940
7019.56,1.0,17,2,2,2,6,0xb2d68e76
1163.35,1.0,184,1,2,1,4,0xb2d488dad
180000.6,1.0,0,3,2,4,9,0xb2d424e1
1291.61,1.0,0,1,2,4,7,0xb2d6bf49
520495.33,2.0,123,4,3,1,8,0xb2d693a2
210425.17,2.0,186,3,3,1,7,0xb2d0a7fad
560679.47,5.0,126,4,4,1,9,0xb2d6ce2f
90441.28,2.0,104,3,3,1,7,0xb2d5be18
1020063.36,6.0,4,4,4,4,12,0xb2d16387d
200052.99,2.0,179,3,3,1,7,0xb2d14da0
230004.86,2.0,52,3,3,2,8,0xb2d90aabd
2054.1,1.0,145,1,2,1,4,0xb2d58f6ed
20090.34,1.0,22,2,2,2,6,0xb2d4703c
10000.11,2.0,13,2,3,3,8,0xb2d95e77
403.67,2.0,0,1,3,4,8,0x3b9b1bff
800096.17,7.0,10,4,4,3,11,0xb2d5d991
278151.06,11.0,0,3,4,4,11,0xb2d2471ed
10087.78,1.0,0,2,2,4,8,0xb2d5f801d
3.72,1.0,4,1,2,4,7,0xb2d95cabd
163.57,1.0,3,1,2,4,7,0xb2d37cb8
178135.89,3.0,39,3,4,2,9,0xb2d5dbd8d
3411.42,1.0,16,2,2,2,6,0xb2d2f5f4
107843.81,1.0,184,3,2,1,6,0xb2d1e303d
55434.95,1.0,184,3,2,1,6,0xb2d366c5
1006035.91,5.0,7,4,4,3,11,0xb2d2cebd
265482.39,2.0,4,3,3,4,10,0xb2d301fd
6078.67,1.0,92,2,2,1,5,0xb2d1bbb0
4846.8,1.0,28,2,2,2,6,0xb2d6b7b7
101235.13,2.0,125,3,3,1,7,0xb2d6d276d
65.9,1.0,1,1,2,4,7,0xb2d9dea8
300002.64,2.0,18,3,3,2,8,0xb2d956eb
600003.48,4.0,7,4,4,3,11,0xb2d6ef05d
690059.33,2.0,10,4,3,3,10,0xb2d9546cd
487422.81,4.0,116,4,4,1,9,0xb2d3819ad
30543.5,1.0,277,2,2,1,5,0xb2d33928
60498.52,1.0,12,3,2,3,8,0xb2d38519d
206014.22,2.0,73,3,3,1,7,0xb2d5a568
18714.89,1.0,265,2,2,1,5,0xb2d3766cd
1147686.05,3.0,80,4,4,1,9,0xb2d0fd6a
400021.92,2.0,22,4,3,2,9,0xb2d21c2e
42053.78,1.0,28,2,2,2,6,0xb2d32fee
15023.14,1.0,29,2,2,2,6,0xb2d8f367
637559.19,4.0,4,4,4,4,12,0xb2d6aa2ed
602131.54,2.0,24,4,3,2,9,0xb2d68f29
750022.19,3.0,0,4,4,4,12,0xb2d78d70
103617.27,3.0,94,3,4,1,8,0xb2d39e8ed
340014.53,3.0,19,4,4,2,10,0xb2d5f68cd
203291.46,3.0,116,3,4,1,8,0xb2d34f93d
1016.66,2.0,92,1,3,1,5,0xb2d081e5
94036.06,3.0,154,3,4,1,8,0xb2d48f72
8845.53,2.0,184,2,3,1,6,0x3b9b1388
5159.09,1.0,184,2,2,1,5,0xb2d1dbcfd
1123.42,1.0,21,1,2,2,5,0xb2d320bc
320363.74,6.0,18,4,4,2,10,0xb2d6408b
100006.62,2.0,235,3,3,1,7,0xb2d39546
100002.11,2.0,38,3,3,2,8,0xb2d9292c
2647.63,1.0,184,1,2,1,4,0xb2d612acd
500009.0,2.0,3,4,3,4,11,0xb2d95ef3
59.73,1.0,11,1,2,3,6,0xb2d8a286
27.05,1.0,16,1,2,2,5,0xb2d9653e
256.67,1.0,41,1,2,2,5,0xb2d21b3e
60035.29,1.0,0,3,2,4,9,0xb2d42ac8
200104.22,1.0,11,3,2,3,8,0xb2d96346
611369.2,2.0,10,4,3,3,10,0xb2d2da36d
10686.38,1.0,35,2,2,2,6,0xb2d5e568
233.47,1.0,0,1,2,4,7,0xb2d8fddf
5408.26,1.0,4,2,2,4,8,0xb2d3f5ca
181444.41,3.0,144,3,4,1,8,0xb2d381c2d
3702.34,1.0,10,2,2,3,7,0xb2d2fbd8
112.02,1.0,34,1,2,2,5,0xb2d0995f
75003.96,2.0,216,3,3,1,7,0xb2d67e7b
566.05,1.0,35,1,2,2,5,0xb2d6a39d
295116.94,3.0,13,3,4,3,10,0xb2d45bd8
59.15,1.0,9,1,2,3,6,0xb2d18215
450004.75,2.0,83,4,3,1,8,0xb2d985ab
280009.28,1.0,4,3,2,4,9,0xb2d86c37
36003.58,4.0,2,2,4,4,10,0xb2d1c58ed
502262.79,2.0,11,4,3,3,10,0xb2d57eef
221.64,1.0,15,1,2,3,6,0xb2d5894f
580006.91,3.0,22,4,4,2,10,0xb2d6e87fd
6279.17,1.0,1,2,2,4,8,0xb2d8f062d
0.82,1.0,20,1,2,2,5,0xb2d69951
100256.23,2.0,3,3,3,4,10,0xb2d261bad
505007.61,4.0,22,4,4,2,10,0xb2d8fe1d
404263.79,2.0,99,4,3,1,8,0xb2d96fd2
20902.76,2.0,8,2,3,3,8,0xb2d58430
172044.97,2.0,20,3,3,2,8,0xb2d1037dd
2.53,2.0,184,1,3,1,5,0xb2d374d6
2280464.45,9.0,61,4,4,2,10,0xb2d4c819d
16847.15,1.0,0,2,2,4,8,0xb2d3cb0d
450071.85,3.0,11,4,4,3,11,0xb2d96307d
1186837.34,3.0,13,4,4,3,11,0xb2d39634d
1050006.86,4.0,7,4,4,3,11,0xb2d6f2bed
5.46,1.0,77,1,2,1,4,0xb2d59875
2.1,2.0,0,1,3,4,8,0xb2d204e3
30511.58,2.0,52,2,3,2,7,0xb2d622a3
1473183.57,4.0,8,4,4,3,11,0x3b9ae86fd
1139.63,1.0,301,1,2,1,4,0xb2d6486bd
310236.2,2.0,231,4,3,1,8,0xb2d55109
10000.12,2.0,5,2,3,3,8,0xb2d951c2
10160.65,1.0,92,2,2,1,5,0xb2d0ce47d
159949.04,2.0,27,3,3,2,8,0xb2d2b686
2089.24,1.0,184,1,2,1,4,0xb2d1a56f
200710.43,2.0,30,3,3,2,8,0xb2d9bd1d
1801.4,1.0,0,1,2,4,7,0xb2d61c15
1016.25,1.0,92,1,2,1,4,0xb2d08d5c
1693.47,1.0,184,1,2,1,4,0xb2d20dd4d
5155.3,1.0,184,2,2,1,5,0xb2d0c8c1d
2305529.75,4.0,21,4,4,2,10,0xb2d550fed
545059.74,4.0,18,4,4,2,10,0xb2d5adffd
70013.9,2.0,11,3,3,3,9,0xb2d4e860d
4767.35,2.0,92,2,3,1,6,0xb2d0cc6c
7009.42,1.0,36,2,2,2,6,0xb2d2aee1d
2931097.43,5.0,0,4,4,4,12,0xb2d0a961
4829.63,1.0,10,2,2,3,7,0xb2d3f7d5d
3283384.39,12.0,0,4,4,4,12,0xb2d61ccad
859137.28,5.0,21,4,4,2,10,0xb2d4a5f0d
8791.51,1.0,0,2,2,4,8,0xb2d59a15
6.86,1.0,82,1,2,1,4,0xb2d95b51
15195.47,1.0,0,2,2,4,8,0xb2d4c1ec
435503.22,1.0,0,4,2,4,10,0xb2d26e73
3918.33,1.0,2,2,2,4,8,0xb2d0e99dd
175996.59,3.0,71,3,4,1,8,0xb2d318fb
3602.33,1.0,92,2,2,1,5,0x3b9b3717d
646433.16,5.0,10,4,4,3,11,0xb2d25b9cd
0.18,1.0,3,1,2,4,7,0xb2d29e74
300635.25,2.0,63,4,3,2,9,0xb2d126abd
450004.32,5.0,29,4,4,2,10,0xb2d8c5a6
552102.19,3.0,1,4,4,4,12,0xb2d87fcd
270059.08,3.0,8,3,4,3,10,0xb2d9b4be
137483.7,1.0,10,3,2,3,8,0xb2d304db
4964.86,3.0,20,2,4,2,8,0x3b9af28a
2.83,1.0,32,1,2,2,5,0xb2d6dd7e
8137.31,2.0,1,2,3,4,9,0xb2d97e26d
112001.76,4.0,27,3,4,2,9,0xb2d6f737
711451.58,11.0,0,4,4,4,12,0xb2d18b51d
282032.46,2.0,50,3,3,2,8,0xb2d5f200d
52023.69,2.0,40,2,3,2,7,0xb2d1202f
184254.81,3.0,3,3,4,4,11,0xb2d5ff25
31092.28,1.0,20,2,2,2,6,0xb2d6bb8e
646136.78,1.0,0,4,2,4,10,0xb2d13eeb
217.59,1.0,29,1,2,2,5,0xb2d5fd92d
533002.35,8.0,25,4,4,2,10,0xb2d0a98e
19906.09,1.0,39,2,2,2,6,0xb2d99150
2130807.96,1.0,0,4,2,4,10,0xb2d6e7c9
99837.67,2.0,14,3,3,3,9,0xb2d31de6d
8223.13,1.0,143,2,2,1,5,0xb2d166f8
137.8,1.0,4,1,2,4,7,0xb2d235a4
400065.15,3.0,3,4,4,4,12,0xb2d824dd
541756.43,6.0,6,4,4,3,11,0xb2d14560
280002.96,2.0,224,3,3,1,7,0xb2d6fb47
0.01,1.0,70,1,2,1,4,0xb2d6c13c
104041.76,3.0,21,3,4,2,9,0xb2d63a8b
1018687.06,2.0,21,4,3,2,9,0xb2d53d0cd
200710.42,2.0,39,3,3,2,8,0xb2d9f533
15861.73,1.0,0,2,2,4,8,0xb2d92d6d
590013.04,14.0,7,4,4,3,11,0xb2d074c1d
4.4,1.0,41,1,2,2,5,0xb2d62568
10153.55,2.0,27,2,3,2,7,0xb2d53f64
58684.22,1.0,0,3,2,4,9,0xb2d2775d
1239.3,1.0,92,1,2,1,4,0xb2d53596
1001883.45,4.0,12,4,4,3,11,0xb2da01a1
10056.47,1.0,19,2,2,2,6,0xb2d781a3d
7217.88,1.0,184,2,2,1,5,0xb2d24684d
1.86,1.0,64,1,2,2,5,0xb2d4cde7d
22198.15,1.0,184,2,2,1,5,0xb2d36652
2862.14,1.0,10,1,2,3,6,0xb2d9b47d
472019.63,5.0,0,4,4,4,12,0xb2d0dd5dd
208756.47,2.0,131,3,3,1,7,0xb2d0e9fad
842.35,1.0,87,1,2,1,4,0xb2d221aa
31155.84,1.0,126,2,2,1,5,0xb2d48fff
77203.08,1.0,35,3,2,2,7,0xb2d36f8a
1511017.76,7.0,88,4,4,1,9,0x3b9b2905d
569508.08,1.0,0,4,2,4,10,0xb2d94800
30773.05,1.0,1,2,2,4,8,0xb2d21d76
1.72,1.0,14,1,2,3,6,0xb2d63b42
169550.78,5.0,0,3,4,4,11,0xb2d3aa70
700014.78,2.0,47,4,3,2,9,0xb2d91390d
200000.0,2.0,1,3,3,4,10,0xb2d8e786d
31.85,1.0,2,1,2,4,7,0xb2d0c527
100481.93,2.0,1,3,3,4,10,0xb2d246d4
86000.91,2.0,24,3,3,2,8,0xb2d9434c
100820.19,5.0,3,3,4,4,11,0x3b9b33a2
219.64,2.0,5,1,3,3,7,0xb2da2396
10005.06,2.0,35,2,3,2,7,0xb2d9f8a6
2801.17,1.0,0,1,2,4,7,0xb2d701bf
150000.53,3.0,4,3,4,4,11,0xb2da4732
160527.16,1.0,4,3,2,4,9,0xb2d29273
21014.31,2.0,38,2,3,2,7,0xb2d5d5b0d
9.59,1.0,11,1,2,3,6,0xb2d29ba2
167035.18,4.0,41,3,4,2,9,0xb2d5f033
1840003.78,3.0,13,4,4,3,11,0xb2d80061d
432.81,1.0,75,1,2,1,4,0xb2d2895a
316024.64,4.0,1,4,4,4,12,0xb2d24dd5
16.17,1.0,10,1,2,3,6,0xb2d920cc
352162.22,10.0,0,4,4,4,12,0xb2d5ee63
63139.54,2.0,1,3,3,4,10,0xb2d54ec7
1966.58,1.0,10,1,2,3,6,0xb2d68e65
120915.13,5.0,6,3,4,3,10,0xb2d6c9bdd
4327.92,7.0,0,2,4,4,10,0xb2d6a40ad
200340.85,2.0,139,3,3,1,7,0xb2d56379
30002.35,2.0,25,2,3,2,7,0xb2d99a70
47597.34,1.0,7,2,2,3,7,0xb2d343d5
9066.66,1.0,4,2,2,4,8,0xb2d9dac9
1007.38,1.0,92,1,2,1,4,0xb2d23ff1
6.6,3.0,60,1,4,2,7,0xb2d28caad
2531.03,1.0,184,1,2,1,4,0xb2d42b44
1414.89,1.0,92,1,2,1,4,0xb2d1d734
198910.04,1.0,158,3,2,1,6,0xb2d432e4
250002.64,2.0,53,3,3,2,8,0xb2d9cf0a
41811.5,3.0,0,2,4,4,10,0xb2d503b1d
1297.65,1.0,6,1,2,3,6,0xb2d31ed7
500062.11,3.0,6,4,4,3,11,0xb2d24429
41.44,1.0,18,1,2,2,5,0xb2d355e5
25.86,1.0,26,1,2,2,5,0xb2d95c8d
10208.02,2.0,80,2,3,1,6,0xb2d560b2
1835874.37,9.0,1,4,4,4,12,0xb2d36b02
0.0,1.0,0,1,2,4,7,0xb2d5822f
210218.5,2.0,16,3,3,2,8,0xb2d59318
0.57,2.0,184,1,3,1,5,0xb2d141bfd
327016.9,2.0,135,4,3,1,8,0xb2d441c7
817736.17,7.0,45,4,4,2,10,0xb2d08300d
102477.93,1.0,6,3,2,3,8,0xb2d305add
32943.92,2.0,6,2,3,3,8,0xb2d2128dd
10000.21,2.0,206,2,3,1,6,0xb2d68de7d
1542459.67,2.0,30,4,3,2,9,0xb2d9b942
37.16,1.0,13,1,2,3,6,0xb2d445a4
630089.35,4.0,0,4,4,4,12,0xb2d1d194
55235.79,1.0,8,3,2,3,8,0xb2d8e2d3
2801.17,1.0,0,1,2,4,7,0xb2d701b2
935491.08,6.0,13,4,4,3,11,0xb2d23f63d
100008.54,2.0,56,3,3,2,8,0xb2d6851fd
213120.7,3.0,151,3,4,1,8,0xb2d170fbd
450346.13,4.0,11,4,4,3,11,0xb2d26703
1015.55,1.0,184,1,2,1,4,0xb2d1457dd
82919.92,1.0,10,3,2,3,8,0xb2d414b9d
5220.13,1.0,184,2,2,1,5,0xb2d12199
351243.23,2.0,34,4,3,2,9,0xb2d9ffe4
50507.49,1.0,288,2,2,1,5,0xb2d323b5d
7.36,1.0,36,1,2,2,5,0xb2d5e5ddd
337550.1,10.0,0,4,4,4,12,0xb2d0f6e4
100578.89,2.0,76,3,3,1,7,0xb2d29345
981.04,1.0,8,1,2,3,6,0xb2d6dc3f
501859.57,2.0,19,4,3,2,9,0xb2d6b1c5d
3509.91,1.0,92,2,2,1,5,0xb2d3a97b
80000.86,3.0,11,3,4,3,10,0xb2d98730
456894.3,5.0,14,4,4,3,11,0xb2d1693ad
501776.18,2.0,30,4,3,2,9,0xb2d98409
7186.45,1.0,92,2,2,1,5,0xb2d27057
455.33,1.0,2,1,2,4,7,0xb2d7adbe
1017.3,1.0,184,1,2,1,4,0xb2d0ddd6d
3253.15,1.0,0,2,2,4,8,0xb2d6edfc
328816.15,3.0,60,4,4,2,10,0xb2d4153f
10290.31,5.0,92,2,4,1,7,0x3b9ae5a2
60.23,1.0,184,1,2,1,4,0xb2d2b3bd
200058.52,2.0,118,3,3,1,7,0xb2d77f07
2700.01,1.0,198,1,2,1,4,0xb2d156ead
44.13,1.0,17,1,2,2,5,0xb2d2886f
10009.72,1.0,102,2,2,1,5,0xb2d96c91
91240.47,2.0,73,3,3,1,7,0xb2d5fd29d
461.01,1.0,0,1,2,4,7,0xb2d6bb66
103798.81,2.0,0,3,3,4,10,0xb2d0d8f2
53536.12,2.0,1,3,3,4,10,0xb2d6e061d
619000.19,4.0,6,4,4,3,11,0xb2d38748d
426494.46,13.0,6,4,4,3,11,0xb2d5e85a
10313.85,1.0,97,2,2,1,5,0xb2d78918
4.86,1.0,26,1,2,2,5,0xb2d9402d
17235.68,1.0,92,2,2,1,5,0xb2d5d790d
587.22,1.0,14,1,2,3,6,0xb2d37c51
300477.23,2.0,0,4,3,4,11,0xb2d571a9
5.66,1.0,60,1,2,2,5,0xb2d74743
805158.6,14.0,32,4,4,2,10,0xb2d5f86f
1833429.91,28.0,0,4,4,4,12,0x3b9af119
2098.12,1.0,0,1,2,4,7,0xb2d34664
150007.38,2.0,20,3,3,2,8,0xb2d7ee27
3820.61,1.0,6,2,2,3,7,0xb2d3c3eb
3503.08,1.0,1,2,2,4,8,0xb2d6fe1cd
1558.87,1.0,18,1,2,2,5,0xb2d1f6c2d
600012.69,2.0,92,4,3,1,8,0xb2d60d58d
6201.71,1.0,6,2,2,3,7,0xb2d68544
904.1,1.0,20,1,2,2,5,0xb2d64ace
2087.59,1.0,25,1,2,2,5,0xb2d0ec05
11660.02,1.0,16,2,2,2,6,0xb2d24524d
90245.07,3.0,3,3,4,4,11,0xb2d90ba3d
260.5,1.0,0,1,2,4,7,0xb2d6c295
200016.28,2.0,104,3,3,1,7,0xb2d60f7a
1000086.43,8.0,11,4,4,3,11,0xb2d13648d
70802.78,2.0,4,3,3,4,10,0xb2d131bb
202211.8,2.0,86,3,3,1,7,0xb2d5b6e6
19274.23,1.0,22,2,2,2,6,0xb2d6b775
2194.26,1.0,6,1,2,3,6,0xb2d26b9b
11692.46,1.0,23,2,2,2,6,0xb2d352af
5.28,1.0,17,1,2,2,5,0xb2d1c972
70000.22,3.0,1,3,4,4,11,0xb2d5e75ed
20000.21,2.0,11,2,3,3,8,0xb2d7891e
10037.84,1.0,184,2,2,1,5,0xb2d6136fd
150031.15,3.0,168,3,4,1,8,0xb2d41623
183488.29,3.0,25,3,4,2,9,0xb2d62f46
9382.01,1.0,0,2,2,4,8,0xb2d43bfdd
820094.69,10.0,10,4,4,3,11,0xb2d10992d
957241.47,4.0,5,4,4,3,11,0xb2d64b91d
40.44,1.0,21,1,2,2,5,0xb2d6a9eb
5.76,1.0,0,1,2,4,7,0xb2d6b7bc
40033.72,2.0,5,2,3,3,8,0xb2d61bf0
42.77,1.0,9,1,2,3,6,0xb2d48310
190006.03,2.0,158,3,3,1,7,0xb2d8e6f0
288.59,2.0,10,1,3,3,7,0xb2d20d11
1015.89,1.0,92,1,2,1,4,0xb2d0dd40d
300418.98,5.0,184,4,4,1,9,0xb2d0b367d
4127.99,1.0,1,2,2,4,8,0xb2d478ebd
2068.64,1.0,0,1,2,4,7,0xb2d76766
454494.93,4.0,53,4,4,2,10,0xb2d5f1cc
4355.85,1.0,16,2,2,2,6,0xb2d47a34
611576.66,3.0,1,4,4,4,12,0xb2d2f7d7
4215.6,1.0,7,2,2,3,7,0xb2d4cbb5d
10040.97,2.0,1,2,3,4,9,0xb2da0528
50205.1,2.0,34,2,3,2,7,0xb2d9a5f6
98679.45,2.0,171,3,3,1,7,0xb2d2b37cd
100004.22,2.0,139,3,3,1,7,0xb2d911be
2670.91,1.0,14,1,2,3,6,0xb2d96436
52.84,1.0,98,1,2,1,4,0xb2d60f64
5515.59,1.0,2,2,2,4,8,0xb2d977ef
4061.1,1.0,2,2,2,4,8,0xb2d6f013
260736.41,4.0,18,3,4,2,9,0xb2d193c6
527.44,1.0,17,1,2,2,5,0xb2d60a4c
500000.44,4.0,0,4,4,4,12,0xb2d541b3d
210064.78,5.0,82,3,4,1,8,0xb2d5f9a5d
12440.47,1.0,0,2,2,4,8,0xb2d903d0
200710.42,2.0,32,3,3,2,8,0xb2d93d47d
17952.39,1.0,10,2,2,3,7,0xb2d39911d
500276.15,2.0,19,4,3,2,9,0xb2d9ca9a
101477.0,4.0,21,3,4,2,9,0x3b9b37b2
100736.45,3.0,62,3,4,2,9,0xb2d67edb
67578.84,5.0,1,3,4,4,11,0xb2d0f2b1
171022.34,3.0,28,3,4,2,9,0xb2d1818d
9355.85,1.0,0,2,2,4,8,0xb2d6b4df
51824.49,2.0,60,2,3,2,7,0xb2d2c754
4045.95,1.0,1,2,2,4,8,0xb2d30ae4d
250002.54,3.0,3,3,4,4,11,0xb2d9fad0
49.62,1.0,9,1,2,3,6,0xb2d3da3dd
15012.75,1.0,13,2,2,3,7,0xb2d1b5a3
20073.85,2.0,139,2,3,1,6,0xb2d2056c
22931.22,13.0,0,2,4,4,10,0xb2d062a0
105153.03,2.0,1,3,3,4,10,0xb2d36ee4d
2082.73,1.0,47,1,2,2,5,0xb2d3904b
26026.22,2.0,56,2,3,2,7,0xb2d6a01a
878.52,1.0,9,1,2,3,6,0xb2d3c641
2088.49,1.0,0,1,2,4,7,0xb2d69d02d
25457.93,1.0,9,2,2,3,7,0xb2d6219cd
20976.52,2.0,6,2,3,3,8,0xb2d6b4e3
1280013.51,2.0,95,4,3,1,8,0xb2d97930
300954.54,5.0,0,4,4,4,12,0xb2d20af3
209376.55,2.0,175,3,3,1,7,0xb2d406fa
1360031.66,2.0,8,4,3,3,10,0xb2d8dd09d
4965.05,1.0,0,2,2,4,8,0xb2d1a855
61.37,1.0,0,1,2,4,7,0xb2d159ccd
104076.17,5.0,2,3,4,4,11,0xb2d43b5f
4603.9,3.0,117,2,4,1,7,0xb2d610bcd
176805.27,4.0,66,3,4,2,9,0xb2d53494
65000.85,3.0,228,3,4,1,8,0xb2d6e9ad
78.0,2.0,0,1,3,4,8,0xb2d59bf0
571834.75,5.0,0,4,4,4,12,0xb2d183d7
44887.22,1.0,9,2,2,3,7,0xb2d2b82b
207292.74,1.0,0,3,2,4,9,0xb2d2b338d
53895.04,1.0,0,3,2,4,9,0xb2d2b4a3
613447.77,4.0,10,4,4,3,11,0xb2d68bb0
120072.64,3.0,12,3,4,3,10,0xb2d60256
0.0,1.0,5,1,2,3,6,0xb2d3993c
127671.78,4.0,59,3,4,2,9,0x3b9b28dd
300064.2,2.0,18,3,3,2,8,0xb2d104ff
9943.09,2.0,184,2,3,1,6,0xb2d09323
153012.43,2.0,67,3,3,1,7,0xb2d40f3b
1485.24,1.0,96,1,2,1,4,0xb2d26612
47.5,1.0,57,1,2,2,5,0xb2d95fe2
566342.5,9.0,0,4,4,4,12,0x3b9b46ba
30000.0,2.0,0,2,3,4,9,0xb2d56f66d
6174.58,1.0,4,2,2,4,8,0xb2d728f2d
450003.06,3.0,13,4,4,3,11,0xb2d9e948
18.16,1.0,19,1,2,2,5,0xb2d9ae7d
436055.43,3.0,2,4,4,4,12,0xb2d574b5
344.53,2.0,14,1,3,3,7,0xb2d6579ed
600028.52,4.0,53,4,4,2,10,0xb2d5ab66
36010.61,2.0,14,2,3,3,8,0xb2da356e
19891.87,1.0,0,2,2,4,8,0xb2d34591
100498.72,4.0,4,3,4,4,11,0xb2d62e00
500000.12,2.0,29,4,3,2,9,0xb2d94131d
392423.6,12.0,73,4,4,1,9,0xb2d63817
3000949.24,3.0,39,4,4,2,10,0xb2d65c75d
50000.53,2.0,202,2,3,1,6,0xb2d69507d
350005.38,6.0,20,4,4,2,10,0xb2d255d1d
240000.0,2.0,20,3,3,2,8,0xb2da2a76
143020.48,3.0,171,3,4,1,8,0xb2d253d9d
5800.55,1.0,19,2,2,2,6,0xb2d9a174
807123.86,6.0,1,4,4,4,12,0xb2d3ffcb
23306.47,1.0,82,2,2,1,5,0xb2d28d32
105000.0,7.0,4,3,4,4,11,0xb2d5ea2a
3000.03,2.0,32,2,3,2,7,0xb2d90bfc
67018.31,2.0,8,3,3,3,9,0xb2d537f5
435.97,1.0,0,1,2,4,7,0xb2d138c6d
1771.56,1.0,184,1,2,1,4,0xb2d1c5c2d
2800.44,1.0,184,1,2,1,4,0x3b9b1b9cd
29089.65,1.0,1,2,2,4,8,0xb2d6cc7c
8991.17,1.0,28,2,2,2,6,0xb2d26fcb
54261.98,1.0,5,3,2,3,8,0xb2d5ee6e
10002.89,2.0,75,2,3,1,6,0xb2d597ba
0.0,1.0,184,1,2,1,4,0xb2d5b838d
38.88,1.0,10,1,2,3,6,0xb2d1a860
662310.32,5.0,32,4,4,2,10,0xb2d69603
12559.9,1.0,10,2,2,3,7,0xb2d3f219d
388502.58,1.0,36,4,2,2,8,0xb2d31aab
22865.46,1.0,11,2,2,3,7,0xb2d1f90f
667746.31,7.0,80,4,4,1,9,0xb2d11edc
695002.83,8.0,6,4,4,3,11,0xb2d19b92
48.03,1.0,75,1,2,1,4,0xb2d880be
1051.31,1.0,2,1,2,4,7,0xb2d68e6b
259813.88,4.0,1,3,4,4,11,0xb2d4d147d
22526.53,1.0,0,2,2,4,8,0xb2d2fa58
300121.41,3.0,98,4,4,1,9,0xb2d1ba3c
818.77,1.0,74,1,2,1,4,0xb2d2cad0
2000021.11,2.0,38,4,3,2,9,0xb2d92cbd
0.93,1.0,80,1,2,1,4,0xb2d588f9d
56.98,1.0,22,1,2,2,5,0xb2d62276
102.12,3.0,1,1,4,4,9,0xb2d4dc75d
15168.24,1.0,235,2,2,1,5,0xb2d3d626d
1203500.06,6.0,0,4,4,4,12,0xb2d4385c
1862.43,5.0,0,1,4,4,9,0xb2d4b8d9
7.85,1.0,78,1,2,1,4,0xb2d5070cd
2035394.58,3.0,8,4,4,3,11,0xb2d4348a
16023.22,1.0,0,2,2,4,8,0xb2d6bb22d
500000.0,1.0,0,4,2,4,10,0xb2d8902f
36001.63,4.0,0,2,4,4,10,0xb2d09ee7d
3.01,1.0,9,1,2,3,6,0xb2d4f3fad
58022.89,2.0,239,3,3,1,7,0xb2d17624
7103.96,1.0,184,2,2,1,5,0xb2d2888a
44797.45,1.0,184,2,2,1,5,0xb2d338c5d
93622.35,2.0,25,3,3,2,8,0xb2d424ab
485688.9,27.0,1,4,4,4,12,0x3b9af169
353000.0,2.0,19,4,3,2,9,0xb2d9dc3f
11911.73,2.0,0,2,3,4,9,0xb2d06ca6
53008.82,3.0,224,3,4,1,8,0xb2d6f8af
435310.67,6.0,0,4,4,4,12,0x3b9ad1c8
1429.24,1.0,1,1,2,4,7,0xb2d4a92a
200008.07,4.0,31,3,4,2,9,0xb2d067e1
363132.13,3.0,0,4,4,4,12,0xb2d40ff8
360000.0,7.0,5,4,4,3,11,0xb2d0d744
20044.54,1.0,22,2,2,2,6,0xb2d36ffa
1512968.63,4.0,8,4,4,3,11,0xb2d67f8d
1027.65,1.0,184,1,2,1,4,0xb2d17647
67280.77,1.0,92,3,2,1,6,0xb2d0840dd
150548.53,2.0,0,3,3,4,10,0xb2d219e6
1140028.19,6.0,52,4,4,2,10,0xb2d8cd9ed
121433.48,1.0,0,3,2,4,9,0xb2da1317
200045.21,2.0,6,3,3,3,9,0xb2d12e0dd
5202.19,2.0,11,2,3,3,8,0xb2d14c3f
1053980.6,2.0,99,4,3,1,8,0xb2d0cb5ed
3180.45,1.0,10,2,2,3,7,0xb2d21ef8
36019.48,1.0,10,2,2,3,7,0xb2d5cf8c
50110.93,2.0,45,2,3,2,7,0xb2d2a07f
17382.43,1.0,92,2,2,1,5,0xb2d2df7a
3093.32,1.0,4,2,2,4,8,0xb2d6f2f9
1306.15,1.0,5,1,2,3,6,0xb2d40de3d
18290.74,1.0,0,2,2,4,8,0xb2d553cdd
17.43,1.0,73,1,2,1,4,0xb2d94a44
850000.0,5.0,41,4,4,2,10,0xb2d9ef80
140000.46,2.0,4,3,3,4,10,0xb2d55715d
367000.75,4.0,0,4,4,4,12,0xb2d61558d
1440.96,1.0,92,1,2,1,4,0xb2d5ba92
1893.26,1.0,19,1,2,2,5,0xb2d43e07
10004.83,1.0,17,2,2,2,6,0xb2d92921
327340.68,3.0,0,4,4,4,12,0xb2d52947d
50000.53,2.0,98,2,3,1,6,0xb2d96f23
4640.88,1.0,0,2,2,4,8,0xb2d52956
24273.24,2.0,67,2,3,1,6,0xb2d67c69
50026.03,2.0,108,2,3,1,6,0xb2d6b0edd
165956.28,1.0,2,3,2,4,9,0xb2d0ea70
1009676.09,9.0,19,4,4,2,10,0xb2d28da1
20762.1,1.0,213,2,2,1,5,0xb2d50ac9d
8.45,1.0,146,1,2,1,4,0xb2d90386d
3026.71,1.0,11,2,2,3,7,0xb2d37d11
1609.86,1.0,184,1,2,1,4,0xb2d33245
160186.34,4.0,3,3,4,4,11,0xb2d60595d
482315.14,4.0,21,4,4,2,10,0xb2d63cf7
3647.97,1.0,10,2,2,3,7,0xb2d24659
844.18,1.0,0,1,2,4,7,0xb2d511c7d
127942.3,6.0,0,3,4,4,11,0xb2d064d0
150000.0,3.0,4,3,4,4,11,0xb2d49042
380096.39,4.0,67,4,4,1,9,0xb2d67ff5d
51024.48,2.0,6,2,3,3,8,0xb2d9879f
3261.58,1.0,184,2,2,1,5,0xb2d311cd
100009.07,2.0,80,3,3,1,7,0xb2d8d787
457063.41,11.0,11,4,4,3,11,0xb2d22bced
2994.69,1.0,92,2,2,1,5,0xb2d0bce7d
50000.74,4.0,39,2,4,2,8,0xb2d954b5
500329.52,2.0,2,4,3,4,11,0xb2d9818ad
15023.92,1.0,160,2,2,1,5,0xb2d57546d
1130789.49,13.0,1,4,4,4,12,0xb2d58f45
447134.45,4.0,36,4,4,2,10,0xb2d4d356d
3803.11,1.0,0,2,2,4,8,0xb2d1d66d
100115.08,1.0,35,3,2,2,7,0xb2d58133d
50000.53,2.0,28,2,3,2,7,0xb2da0a49
350062.83,5.0,4,4,4,4,12,0xb2d54ec2d
2200015.49,2.0,10,4,3,3,10,0xb2d9108b
1184.06,1.0,19,1,2,2,5,0xb2d643d6
91.83,1.0,18,1,2,2,5,0xb2d93774
1105.7,1.0,2,1,2,4,7,0xb2d5d2c5
301728.19,3.0,17,4,4,2,10,0xb2d6a68b
47.25,3.0,40,1,4,2,7,0xb2d8e148
1.06,1.0,75,1,2,1,4,0xb2d20b56
380013.33,3.0,35,4,4,2,10,0xb2d3c10ad
250000.0,2.0,4,3,3,4,10,0xb2da62d1
757103.91,5.0,18,4,4,2,10,0xb2d42c58
700034.4,2.0,60,4,3,2,9,0xb2d5abf3
470022.19,2.0,109,4,3,1,8,0xb2d0f1f4d
8900.59,1.0,9,2,2,3,7,0xb2d79178
636.51,1.0,11,1,2,3,6,0xb2d314d1
91367.35,2.0,171,3,3,1,7,0xb2d5feafd
120001.27,2.0,35,3,3,2,8,0xb2d9f905
350004.32,4.0,27,4,4,2,10,0xb2d90282
201896.93,2.0,92,3,3,1,7,0xb2d328ed
3584.76,1.0,0,2,2,4,8,0xb2d682a6
3326.55,1.0,24,2,2,2,6,0xb2d5feb4
451598.44,2.0,35,4,3,2,9,0xb2d9fce0
250251.14,3.0,5,3,4,3,10,0xb2d5a55d
72623.4,3.0,0,3,4,4,11,0xb2d5ebd4d
505076.05,4.0,20,4,4,2,10,0xb2d9a400
3495.42,1.0,184,2,2,1,5,0xb2d2800c
450757.02,3.0,15,4,4,3,11,0xb2d8f51a
732550.97,6.0,3,4,4,4,12,0xb2d6a2ded
1403.77,1.0,219,1,2,1,4,0xb2d3bb91d
0.17,8.0,4,1,4,4,9,0xb2d6b51ed
2168.24,1.0,0,1,2,4,7,0xb2d43cb0
303230.93,3.0,4,4,4,4,12,0xb2d596d9d
104972.77,1.0,267,3,2,1,6,0xb2d3e2af
502917.2,3.0,58,4,4,2,10,0xb2d74ac3d
517288.76,2.0,175,4,3,1,8,0xb2d1b3a4d
75019.67,2.0,54,3,3,2,8,0xb2d64d6bd
1041.62,1.0,92,1,2,1,4,0xb2d26983
200020.89,2.0,7,3,3,3,9,0xb2d8e798
0.13,1.0,9,1,2,3,6,0xb2d67988
18.83,1.0,49,1,2,2,5,0xb2d1e76c
1198.43,1.0,92,1,2,1,4,0x3b9af08e
300006.33,2.0,6,3,3,3,9,0xb2d966d7
10.16,1.0,35,1,2,2,5,0xb2d8cbbf
300012.67,2.0,55,3,3,2,8,0xb2d900cdd
1003.23,1.0,92,1,2,1,4,0xb2d5d70f
100003.41,1.0,0,3,2,4,9,0xb2d41b55
5013.39,1.0,2,2,2,4,8,0xb2d15ea6
10000.32,2.0,92,2,3,1,6,0xb2d6497dd
472090.64,13.0,0,4,4,4,12,0xb2d47669
50727.62,2.0,4,2,3,4,9,0xb2d5f112d
901.74,1.0,2,1,2,4,7,0xb2d6b4c7
200255.82,3.0,18,3,4,2,9,0xb2d38ea3
500021.13,2.0,182,4,3,1,8,0xb2d8a820
101.39,1.0,0,1,2,4,7,0xb2d22e0d
111.0,1.0,4,1,2,4,7,0xb2d23a3d
420016.28,4.0,11,4,4,3,11,0xb2d92e42d
340022.97,5.0,4,4,4,4,12,0xb2d8a5b9
51413.23,1.0,92,2,2,1,5,0xb2d35f52d
300000.0,2.0,28,3,3,2,8,0xb2da0dee
73046.32,3.0,39,3,4,2,9,0xb2d4ebcad
20000.21,2.0,67,2,3,1,6,0xb2d9b101
138008.54,4.0,41,3,4,2,9,0xb2d61e6ed
201006.53,2.0,29,3,3,2,8,0xb2d9fc69
800777.72,3.0,18,4,4,2,10,0xb2d945acd
250888.13,2.0,22,3,3,2,8,0xb2d90f75
627.4,1.0,9,1,2,3,6,0xb2d653eb
121062.81,3.0,1,3,4,4,11,0xb2d2923f
0.0,1.0,1,1,2,4,7,0xb2d6931fd
882.34,1.0,26,1,2,2,5,0xb2d6235fd
1055.68,1.0,3,1,2,4,7,0xb2d3fef7
37.69,1.0,68,1,2,1,4,0xb2d2e9e8
178101.37,4.0,2,3,4,4,11,0xb2d3b58bd
2492274.24,2.0,82,4,3,1,8,0xb2d11363d
2932.13,1.0,99,2,2,1,5,0xb2d35552
230080.29,2.0,173,3,3,1,7,0xb2d15bef
275110.2,4.0,2,3,4,4,11,0xb2d63357
2434.86,1.0,0,1,2,4,7,0xb2d5ca45
100054.44,2.0,80,3,3,1,7,0xb2d52c6cd
768.58,1.0,10,1,2,3,6,0xb2d41edf
20000.21,2.0,32,2,3,2,7,0xb2da0309
4827.67,1.0,1,2,2,4,8,0xb2d31af8
0.0,1.0,0,1,2,4,7,0xb2d9820f
424494.06,13.0,18,4,4,2,10,0xb2d3af5b
84986.91,2.0,18,3,3,2,8,0xb2d161cad
340051.66,8.0,18,4,4,2,10,0xb2d27493
161411.62,3.0,39,3,4,2,9,0xb2d64721
114591.4,1.0,10,3,2,3,8,0xb2d2fa81
3543.16,1.0,2,2,2,4,8,0xb2d166b2d
68561.23,1.0,0,3,2,4,9,0xb2d3a82dd
350036.4,2.0,199,4,3,1,8,0xb2d5cec8
24.93,2.0,18,1,3,2,6,0x3b9b2394
61091.59,2.0,24,3,3,2,8,0xb2d5e676
6896.15,1.0,9,2,2,3,7,0xb2d3bd14
50005.16,2.0,114,2,3,1,6,0xb2d29748
168383.71,3.0,6,3,4,3,10,0xb2d4439b
25415.25,1.0,10,2,2,3,7,0xb2d5c8a9d
1260004.86,3.0,13,4,4,3,11,0xb2d95cfa
260713.0,3.0,14,3,4,3,10,0xb2d9d103
850.89,1.0,29,1,2,2,5,0xb2d37c47
4.87,1.0,39,1,2,2,5,0xb2d3a85f
1000039.85,3.0,20,4,4,2,10,0xb2d433ba
90003.01,2.0,47,3,3,2,8,0xb2d90bbe
53.87,7.0,25,1,4,2,7,0xb2d07790
832.46,4.0,0,1,4,4,9,0xb2d315a8d
239115.77,2.0,0,3,3,4,10,0xb2d58b64d
23173.85,1.0,9,2,2,3,7,0xb2d23112
25089.97,1.0,0,2,2,4,8,0xb2d3144e
50010.59,2.0,182,2,3,1,6,0xb2d40f77
786744.13,1.0,92,4,2,1,7,0x3b9b1226
217031.66,2.0,19,3,3,2,8,0xb2d13dfbd
1.06,1.0,47,1,2,2,5,0xb2d9dc30
0.0,1.0,10,1,2,3,6,0xb2d65d95
16172.0,1.0,0,2,2,4,8,0xb2d68915d
304371.94,5.0,34,4,4,2,10,0xb2d10b60
200264.97,4.0,45,3,4,2,9,0xb2d2d5b6
100005.45,4.0,10,3,4,3,10,0xb2d067e4
430068.49,4.0,63,4,4,2,10,0xb2d3b3e3
117335.63,3.0,14,3,4,3,10,0xb2d132ccd
248.6,1.0,3,1,2,4,7,0xb2d20b40
10021.49,1.0,20,2,2,2,6,0xb2d4092cd
10015.49,1.0,28,2,2,2,6,0xb2d0d7a1
10457.7,1.0,182,2,2,1,5,0xb2d2acfad
62224.98,1.0,12,3,2,3,8,0xb2d40ad3
948182.29,14.0,4,4,4,4,12,0xb2d171b9
80047.74,2.0,179,3,3,1,7,0xb2d528f5d
100812.87,4.0,47,3,4,2,9,0xb2d294d3
1070.54,1.0,184,1,2,1,4,0xb2d3be2b
220979.83,3.0,27,3,4,2,9,0xb2d2abc3d
19785.12,1.0,5,2,2,3,7,0xb2d6f5a9d
206394.24,2.0,200,3,3,1,7,0xb2d53c4dd
3808.75,1.0,11,2,2,3,7,0xb2d3a9bcd
81886.95,2.0,0,3,3,4,10,0x3b9b1804
2.91,1.0,14,1,2,3,6,0xb2d21963
703876.87,4.0,6,4,4,3,11,0x3b9adce4
142011.16,6.0,32,3,4,2,9,0xb2d8e0d6d
255674.38,11.0,3,3,4,4,11,0xb2d50501
604054.8,5.0,5,4,4,3,11,0xb2d867cd
90022.25,2.0,235,3,3,1,7,0xb2d2158b
700.67,2.0,6,1,3,3,7,0x3b9b28ab
96307.85,3.0,0,3,4,4,11,0xb2d525a4
20074.01,1.0,2,2,2,4,8,0xb2d6c178d
27313.19,1.0,9,2,2,3,7,0xb2d3ab02
1222739.81,2.0,31,4,3,2,9,0xb2d6960bd
500009.5,5.0,83,4,4,1,9,0xb2d2f166
1220190.98,4.0,31,4,4,2,10,0xb2d103e7
4063.52,1.0,18,2,2,2,6,0xb2d51746
412811.56,2.0,133,4,3,1,8,0xb2d5fdb0d
780094.92,3.0,60,4,4,2,10,0xb2d1ae9ad
8276.5,1.0,1,2,2,4,8,0xb2d52b4e
906.4,1.0,126,1,2,1,4,0xb2d5fabfd
459.73,1.0,15,1,2,3,6,0xb2d745ab
200000.0,2.0,11,3,3,3,9,0xb2d966e0
702749.27,3.0,27,4,4,2,10,0xb2d55984d
519299.67,4.0,92,4,4,1,9,0xb2d12a3c
127.49,1.0,13,1,2,3,6,0xb2d5a7c7
1001040.52,1.0,6,4,2,3,9,0xb2d56161
717147.93,2.0,168,4,3,1,8,0xb2d61c94
578916.68,3.0,95,4,4,1,9,0xb2d558cdd
357.04,2.0,9,1,3,3,7,0xb2d6baf6
5052.86,1.0,184,2,2,1,5,0xb2d2a978
100000.2,2.0,38,3,3,2,8,0xb2d61a16
500098.58,2.0,0,4,3,4,11,0xb2d9d023
10486.77,1.0,11,2,2,3,7,0xb2d9dd51
200000.0,2.0,15,3,3,3,9,0xb2d6f481d
1048.73,1.0,0,1,2,4,7,0xb2d42a14d
3209.21,1.0,12,2,2,3,7,0xb2d1f2f5
1372037.94,12.0,0,4,4,4,12,0x3b9af359
402175.23,2.0,0,4,3,4,11,0xb2d631f2d
4020799.62,7.0,6,4,4,3,11,0xb2d0ec82
50003.29,2.0,6,2,3,3,8,0xb2d5fcedd
2001.71,1.0,15,1,2,3,6,0xb2d93ee6
200897.83,2.0,10,3,3,3,9,0xb2d5649f
10.3,1.0,24,1,2,2,5,0xb2d9d9a0
1603.99,1.0,19,1,2,2,5,0xb2d3aae7d
10634.87,1.0,20,2,2,2,6,0xb2d77f5a
260083.15,5.0,8,3,4,3,10,0xb2d4537b
358014.87,2.0,124,4,3,1,8,0xb2d6e5aa
57621.7,2.0,18,3,3,2,8,0x3b9b4704
2.32,1.0,55,1,2,2,5,0xb2d3ad82
677102.48,8.0,104,4,4,1,9,0xb2d575a3
24498.6,1.0,0,2,2,4,8,0xb2d8d547
100000.0,2.0,0,3,3,4,10,0xb2d97d59d
475329.1,6.0,20,4,4,2,10,0xb2d5a93b
1017.7,1.0,184,1,2,1,4,0xb2d18911d
1091436.26,13.0,11,4,4,3,11,0xb2d38e1c
400999.28,3.0,258,4,4,1,9,0xb2d49265
3.46,1.0,5,1,2,3,6,0xb2d7ace0
150052.55,3.0,4,3,4,4,11,0x3b9b1762d
305091.14,4.0,122,4,4,1,9,0xb2d24f83
9804.17,1.0,0,2,2,4,8,0xb2d9160a
280000.0,8.0,2,3,4,4,11,0xb2d60545d
3740.79,1.0,14,2,2,3,7,0xb2d9701b
300040.87,3.0,2,3,4,4,11,0xb2d6e075
70040.89,8.0,0,3,4,4,11,0xb2d48766d
270869.4,3.0,6,3,4,3,10,0xb2d0c86cd
6849.47,1.0,10,2,2,3,7,0xb2d25129
23836.59,1.0,6,2,2,3,7,0xb2d6095d
20000.03,2.0,1,2,3,4,9,0xb2d97423
348929.04,2.0,92,4,3,1,8,0xb2d108f1d
28908.01,1.0,0,2,2,4,8,0xb2d6a514d
20104.5,1.0,13,2,2,3,7,0xb2d430ea
27900.42,1.0,0,2,2,4,8,0xb2d5c2e1
132675.63,1.0,19,3,2,2,7,0xb2d4e987
4451.61,16.0,11,2,4,3,9,0x3b9b2e34
4.67,1.0,67,1,2,1,4,0xb2d4fe82d
357483.39,2.0,3,4,3,4,11,0xb2d262ced
501142.17,1.0,7,4,2,3,9,0xb2d1d2b8d
357025.71,5.0,83,4,4,1,9,0xb2d1408a
182.76,1.0,7,1,2,3,6,0xb2d6b1f7
146595.79,2.0,11,3,3,3,9,0xb2d25c63d
380104.8,4.0,6,4,4,3,11,0x3b9b30f4d
1128.73,1.0,10,1,2,3,6,0xb2d61c14d
1002.53,1.0,245,1,2,1,4,0xb2d30940
962.47,1.0,82,1,2,1,4,0xb2d64b0e
410008.68,2.0,92,4,3,1,8,0xb2d5b2c2
671361.9,4.0,5,4,4,3,11,0xb2d46350d
1000007.08,13.0,0,4,4,4,12,0xb2d53da5d
8945.32,1.0,66,2,2,2,6,0xb2d507e1
500000.0,2.0,5,4,3,3,10,0xb2d96f3d
62151.51,2.0,48,3,3,2,8,0xb2d62b04
1318.6,1.0,184,1,2,1,4,0xb2d30e5f
1001097.41,2.0,0,4,3,4,11,0xb2d4ff5dd
4338.88,1.0,184,2,2,1,5,0xb2d251e8
3874.85,1.0,251,2,2,1,5,0xb2d5fd1e
61988404.85,3.0,1,4,4,4,12,0xb2d32933d
270003.43,3.0,22,3,4,2,9,0xb2d6e879
118044.47,3.0,76,3,4,1,8,0xb2d148c8d
1271.9,1.0,0,1,2,4,7,0xb2d6cf3e
418061.19,2.0,8,4,3,3,10,0xb2d31f8ad
150190.63,2.0,188,3,3,1,7,0xb2d3fb6cd
1013.72,1.0,92,1,2,1,4,0xb2d13da5d
482780.41,2.0,24,4,3,2,9,0xb2d9438cd
751469.92,13.0,80,4,4,1,9,0xb2d1928ad
10000.32,2.0,92,2,3,1,6,0xb2d97d65
33243.05,1.0,74,2,2,1,5,0xb2d3e978d
10042.7,1.0,184,2,2,1,5,0xb2d2d795d
20.73,1.0,67,1,2,1,4,0xb2d4830b
1200207.17,5.0,19,4,4,2,10,0xb2d17943
458859.01,4.0,1,4,4,4,12,0xb2d1272b
679.23,1.0,46,1,2,2,5,0xb2d34547
3461.45,1.0,0,2,2,4,8,0xb2d970ba
90003.8,2.0,77,3,3,1,7,0xb2d8d86f
0.0,1.0,10,1,2,3,6,0xb2d96c52
102.28,1.0,5,1,2,3,6,0xb2d70854
81205.79,2.0,60,3,3,2,8,0xb2d34ba6
95004.58,2.0,185,3,3,1,7,0xb2d4ccb7d
12181.77,1.0,13,2,2,3,7,0xb2d95cdd
1.0,1.0,19,1,2,2,5,0xb2d50669
1025.59,1.0,1,1,2,4,7,0xb2d62d4e
190008.45,2.0,158,3,3,1,7,0xb2d56bb3
5.86,1.0,1,1,2,4,7,0xb2d78280d
6.35,1.0,19,1,2,2,5,0xb2d8e22e
0.53,1.0,66,1,2,2,5,0xb2d36755
10694.8,2.0,92,2,3,1,6,0x3b9b3284d
4006.22,2.0,184,2,3,1,6,0xb2d0724d
260047.1,2.0,19,3,3,2,8,0xb2d98e41
8000.63,1.0,15,2,2,3,7,0xb2d9ada3
80058.77,2.0,92,3,3,1,7,0xb2d5effb
98.45,1.0,16,1,2,2,5,0xb2d32c69
9.72,1.0,56,1,2,2,5,0xb2d2d2e2d
52213.7,1.0,92,3,2,1,6,0xb2d3b46fd
7021.85,3.0,184,2,4,1,7,0xb2d0a682d
100000.16,2.0,1,3,3,4,10,0xb2d930a3
1946.47,1.0,5,1,2,3,6,0xb2d961ba
16328.51,1.0,28,2,2,2,6,0xb2d69b58d
500005.28,2.0,55,4,3,2,9,0xb2d904aad
702330.1,4.0,1,4,4,4,12,0xb2d6bbd9
14835.23,1.0,6,2,2,3,7,0xb2d754d4d
2487.0,1.0,81,1,2,1,4,0xb2d327ac
9158.34,1.0,0,2,2,4,8,0xb2d588bc
566016.41,3.0,31,4,4,2,10,0xb2d6c816
2225.95,1.0,7,1,2,3,6,0xb2d343cb
2450000.95,6.0,0,4,4,4,12,0xb2d2efbdd
500000.0,1.0,4,4,2,4,10,0xb2d92ee2d
8.54,2.0,81,1,3,1,5,0xb2d2a835
274043.82,10.0,1,3,4,4,11,0xb2d24dc8
1272.75,1.0,3,1,2,4,7,0xb2d4d0ba
3.48,1.0,9,1,2,3,6,0xb2d78caf
2431.68,1.0,0,1,2,4,7,0xb2d23083
1539.7,2.0,92,1,3,1,5,0x3b9b32c3d
6100.91,1.0,10,2,2,3,7,0xb2d9e0ee
2030.12,1.0,9,1,2,3,6,0xb2d32fe3
500441.62,5.0,12,4,4,3,11,0xb2d3497f
167976.7,7.0,21,3,4,2,9,0xb2d602c7
20000.63,2.0,18,2,3,2,7,0xb2da24b4
230000.27,2.0,3,3,3,4,10,0xb2d5edccd
12.0,1.0,19,1,2,2,5,0xb2d418b5
711939.29,4.0,0,4,4,4,12,0xb2d67fae
3137886.6,21.0,0,4,4,4,12,0xb2d3690a
0.68,1.0,4,1,2,4,7,0xb2d4e851
265003.58,2.0,7,3,3,3,9,0xb2d418cf
127808.02,3.0,160,3,4,1,8,0xb2d1067f
450000.0,3.0,0,4,4,4,12,0xb2d83cd9
1014.46,1.0,92,1,2,1,4,0xb2d131f0d
37563.19,1.0,89,2,2,1,5,0xb2d1abcc
523801.75,9.0,8,4,4,3,11,0xb2d08872
6.6,1.0,12,1,2,3,6,0xb2d288bad
10984.0,1.0,0,2,2,4,8,0xb2d9d2a7
20001.06,2.0,26,2,3,2,7,0xb2d93ef7d
10235.55,1.0,17,2,2,2,6,0xb2d37c32d
504429.89,2.0,8,4,3,3,10,0xb2d9495e
20000.21,2.0,73,2,3,1,6,0xb2d8e411d
1133.13,1.0,0,1,2,4,7,0xb2d5b578d
61425.24,1.0,14,3,2,3,8,0xb2d94823
10.8,1.0,89,1,2,1,4,0xb2d28972d
141.99,1.0,0,1,2,4,7,0xb2d3a5f4d
1285.24,1.0,147,1,2,1,4,0xb2d0a201
125610.35,5.0,76,3,4,1,8,0xb2d07b8e
17509.0,1.0,9,2,2,3,7,0xb2d42982
65011.44,1.0,6,3,2,3,8,0xb2d0f8af
0.53,1.0,146,1,2,1,4,0xb2d68cb8d
15996.56,1.0,1,2,2,4,8,0xb2d8cf09
50.89,1.0,39,1,2,2,5,0xb2d6444d
134.18,1.0,194,1,2,1,4,0xb2d1df23
604.19,1.0,0,1,2,4,7,0xb2d31e9ad
300000.0,2.0,17,3,3,2,8,0xb2d94d9f
200008.21,2.0,3,3,3,4,10,0xb2da150e
2.63,1.0,4,1,2,4,7,0xb2d1f435
503011.5,5.0,28,4,4,2,10,0xb2d0e46a
1012.43,1.0,10,1,2,3,6,0xb2d9d7b5
90714.67,5.0,21,3,4,2,9,0xb2d5e162d
177000.08,10.0,4,3,4,4,11,0xb2d62145
854.37,1.0,10,1,2,3,6,0xb2d97499
25225.66,1.0,0,2,2,4,8,0xb2d786e1d
105000.0,2.0,3,3,3,4,10,0xb2d97ae5d
506041.32,4.0,0,4,4,4,12,0xb2d316c5d
145754.51,7.0,4,3,4,4,11,0xb2d57f4a
2539.08,1.0,0,1,2,4,7,0xb2d21b2dd
109.49,1.0,32,1,2,2,5,0xb2d9de63
160030.67,2.0,70,3,3,1,7,0xb2d4fd59
236706.52,8.0,0,3,4,4,11,0xb2d06d12
8488.14,1.0,92,2,2,1,5,0xb2d3db4bd
50403.61,1.0,184,2,2,1,5,0xb2d39f89d
3.17,1.0,88,1,2,1,4,0xb2d88b8cd
670034.43,8.0,11,4,4,3,11,0xb2d65c3e
590000.0,24.0,0,4,4,4,12,0xb2d23d7a
607293.66,2.0,62,4,3,2,9,0xb2d11c24
6.74,1.0,31,1,2,2,5,0xb2d8dce8
31459.13,2.0,67,2,3,1,6,0xb2d67db6
18.58,1.0,20,1,2,2,5,0xb2d94d44
1536053.67,2.0,11,4,3,3,10,0xb2d3b953
3.42,1.0,1,1,2,4,7,0xb2d3f2c5
985552.69,2.0,3,4,3,4,11,0xb2d403d3
302251.19,4.0,235,4,4,1,9,0xb2d12065d
3.15,1.0,34,1,2,2,5,0xb2d92156d
1257.56,1.0,184,1,2,1,4,0xb2d24804
234159.34,2.0,123,3,3,1,7,0xb2d1792d
7336.61,1.0,92,2,2,1,5,0xb2d0d197d
41015.31,4.0,26,2,4,2,8,0xb2d6cbdb
2683.48,1.0,3,1,2,4,7,0xb2d6c378
0.03,1.0,185,1,2,1,4,0xb2d5dd4f
105044.38,1.0,236,3,2,1,6,0xb2d46433d
500012.07,2.0,96,4,3,1,8,0xb2d85b75d
33.08,1.0,75,1,2,1,4,0xb2d2df8a
70004.57,3.0,8,3,4,3,10,0xb2d56364
1.97,1.0,77,1,2,1,4,0xb2d91f75
132166.23,1.0,20,3,2,2,7,0xb2d27da2d
38.0,1.0,72,1,2,1,4,0xb2d46ec3
382632.42,9.0,8,4,4,3,11,0xb2d6f4fa
149297.92,1.0,0,3,2,4,9,0xb2d609dfd
8549.69,1.0,12,2,2,3,7,0xb2d37455d
1339.59,1.0,4,1,2,4,7,0xb2d96db5
4936.09,1.0,0,2,2,4,8,0xb2d1ca5fd
600007.86,3.0,6,4,4,3,11,0xb2d99d47
260000.0,2.0,0,3,3,4,10,0xb2d97ca0
3.17,1.0,19,1,2,2,5,0xb2d62d46
4642.87,1.0,9,2,2,3,7,0xb2d9c44f
1281.61,1.0,184,1,2,1,4,0xb2d35e4d
6144.36,5.0,92,2,4,1,7,0x3b9b12bfd
114.6,1.0,76,1,2,1,4,0xb2d7add4
10623.12,2.0,1,2,3,4,9,0xb2d8fb87d
3471.81,1.0,17,2,2,2,6,0xb2d609f7d
23.35,2.0,10,1,3,3,7,0xb2d50f81
4724.09,1.0,181,2,2,1,5,0xb2d67ce1
0.0,4.0,0,1,4,4,9,0xb2d18827
60089.16,4.0,5,3,4,3,10,0xb2d6d7aa
313.52,1.0,27,1,2,2,5,0xb2d598d6
43569.45,2.0,0,2,3,4,9,0xb2d1bcb6
250505.35,7.0,0,3,4,4,11,0xb2d57f21
44362.72,1.0,4,2,2,4,8,0xb2d26bc0
1714.88,1.0,10,1,2,3,6,0xb2d40864
9166.68,1.0,184,2,2,1,5,0xb2d3ee2f
10387.41,1.0,16,2,2,2,6,0xb2d181b6
13890.22,1.0,21,2,2,2,6,0xb2d60a7a
86.17,1.0,15,1,2,3,6,0xb2d6c6cc
27630.14,2.0,49,2,3,2,7,0xb2d581d5d
554019.28,4.0,24,4,4,2,10,0xb2d4f7cfd
32.09,1.0,12,1,2,3,6,0xb2d943a9
2761.6,1.0,184,1,2,1,4,0xb2d10328d
30000.95,2.0,60,2,3,2,7,0xb2d9ba05
305606.48,2.0,225,4,3,1,8,0xb2d63e0ad
143486.95,5.0,0,3,4,4,11,0xb2d12f57
377572.17,6.0,6,4,4,3,11,0xb2d1605e
122.52,1.0,15,1,2,3,6,0xb2d77fee
1562067.95,68.0,0,4,4,4,12,0xb2d4a6d9d
2935.32,1.0,3,2,2,4,8,0xb2d3b003
1374978.14,9.0,2,4,4,4,12,0xb2d0e824
102840.24,2.0,34,3,3,2,8,0xb2d62176
321000.0,24.0,0,4,4,4,12,0xb2d33084
4435.39,1.0,254,2,2,1,5,0xb2d28d89d
381.71,2.0,0,1,3,4,8,0xb2d17d86d
52.78,1.0,83,1,2,1,4,0xb2d8011b
1443469.55,3.0,60,4,4,2,10,0xb2d39764
100002.11,3.0,32,3,4,2,9,0xb2d9ec1f
919.17,1.0,93,1,2,1,4,0xb2d57eddd
559726.92,6.0,3,4,4,4,12,0xb2d06895
752023.34,12.0,35,4,4,2,10,0xb2d086fed
20352.88,2.0,92,2,3,1,6,0xb2d55bc7
1059023.97,3.0,5,4,4,3,11,0xb2d08558
1552.04,1.0,0,1,2,4,7,0xb2d51f2d
990.44,1.0,14,1,2,3,6,0xb2d5e741
25000.64,2.0,208,2,3,1,6,0xb2d58f51
59469.77,1.0,0,3,2,4,9,0xb2d15230d
589081.71,7.0,0,4,4,4,12,0xb2d5a19e
3842.64,1.0,0,2,2,4,8,0xb2d698fbd
600000.08,3.0,22,4,4,2,10,0xb2d94a60
23046.02,2.0,0,2,3,4,9,0xb2d43cb0d
100041.52,2.0,199,3,3,1,7,0xb2d567a8
204.24,1.0,10,1,2,3,6,0xb2d56f02
1.76,1.0,3,1,2,4,7,0xb2d90316
400108.2,4.0,102,4,4,1,9,0xb2d8cffad
17409.8,1.0,16,2,2,2,6,0xb2d95bcc
529.97,1.0,10,1,2,3,6,0xb2d9216e
685.14,1.0,0,1,2,4,7,0xb2d70996
216.93,1.0,23,1,2,2,5,0xb2d826eed
2014.2,1.0,68,1,2,1,4,0xb2d39040d
110006.51,3.0,52,3,4,2,9,0xb2d513d4d
600762.52,1.0,65,4,2,2,8,0xb2d5aab8d
610060.98,9.0,0,4,4,4,12,0xb2d5e87dd
10070.94,1.0,184,2,2,1,5,0xb2d1ce78d
760.46,1.0,16,1,2,2,5,0xb2d91bf4d
1178.54,1.0,0,1,2,4,7,0xb2d8f6ea
108363.5,5.0,0,3,4,4,11,0xb2d210af
3875.16,1.0,10,2,2,3,7,0xb2d25926
50881.57,1.0,0,2,2,4,8,0xb2d30f5b
20980.26,2.0,41,2,3,2,7,0xb2d6706bd
533938.54,2.0,0,4,3,4,11,0xb2d56eea
1684.05,1.0,1,1,2,4,7,0xb2d700c5
21276.94,1.0,5,2,2,3,7,0xb2d54f51d
375289.79,2.0,4,4,3,4,11,0xb2d9addb
1741.52,1.0,9,1,2,3,6,0xb2d3e679
4541.85,1.0,29,2,2,2,6,0xb2d91f6d
501095.94,3.0,0,4,4,4,12,0xb2d83c15
940053.76,10.0,2,4,4,4,12,0xb2d623fc
19223.05,1.0,4,2,2,4,8,0xb2d262f9
3457.43,1.0,0,2,2,4,8,0xb2d3c81cd
12497.87,1.0,6,2,2,3,7,0xb2d52468
100001.06,2.0,76,3,3,1,7,0xb2d8de86
312012.41,3.0,69,4,4,1,9,0xb2d64876
1968280.46,14.0,11,4,4,3,11,0xb2d1552d
1100338.65,2.0,76,4,3,1,8,0xb2d5749ad
1369662.82,3.0,63,4,4,2,10,0xb2d9b604
505316.29,1.0,2,4,2,4,10,0xb2d7ed7dd
500000.07,3.0,14,4,4,3,11,0xb2d9da01
211444.07,6.0,46,3,4,2,9,0xb2d62af0
324106.97,5.0,25,4,4,2,10,0xb2d2239fd
425.46,1.0,110,1,2,1,4,0xb2d07815d
226849.99,1.0,62,3,2,2,7,0xb2d5386b
2009.69,1.0,184,1,2,1,4,0xb2d3f6edd
252041.77,3.0,16,3,4,2,9,0xb2d2b676
100044.33,2.0,157,3,3,1,7,0xb2d6134b
280086.35,2.0,151,3,3,1,7,0xb2d5d154
85545.31,2.0,0,3,3,4,10,0xb2d2f918d
145782.83,3.0,0,3,4,4,11,0xb2d24bebd
7125.1,1.0,3,2,2,4,8,0xb2d6f913
4469.53,1.0,9,2,2,3,7,0xb2d2465d
158.43,1.0,8,1,2,3,6,0xb2d278fad
23223.0,2.0,10,2,3,3,8,0xb2d538cc
345037.14,2.0,77,4,3,1,8,0xb2d1661cd
100003.61,2.0,52,3,3,2,8,0xb2d55c46
3827.91,1.0,0,2,2,4,8,0xb2d943a7
10001.61,2.0,38,2,3,2,7,0xb2d92b44
700143.82,2.0,108,4,3,1,8,0xb2d1cc54
2.34,1.0,15,1,2,3,6,0xb2d3e86cd
696.05,1.0,0,1,2,4,7,0xb2d85be2
30844.42,1.0,0,2,2,4,8,0xb2d69629
430011.0,8.0,0,4,4,4,12,0xb2d10484
348717.19,3.0,74,4,4,1,9,0xb2d64f84d
121134.75,1.0,10,3,2,3,8,0xb2d8dbd7
4.29,1.0,53,1,2,2,5,0xb2d6be26
300000.0,2.0,28,3,3,2,8,0xb2da0e88
10261.85,2.0,80,2,3,1,6,0xb2d5e765
515065.47,13.0,6,4,4,3,11,0xb2d5a57b
152761.61,2.0,8,3,3,3,9,0xb2d30ed9
148191.89,4.0,62,3,4,2,9,0xb2d5c361
716596.42,6.0,1,4,4,4,12,0xb2d12bf8d
12800.22,1.0,1,2,2,4,8,0xb2d65408
30842.54,1.0,6,2,2,3,7,0xb2d60b7cd
10110.76,1.0,184,2,2,1,5,0xb2d286f0d
109249.03,2.0,104,3,3,1,7,0xb2d173cd
2971.29,1.0,184,2,2,1,5,0xb2d10291
130008.97,2.0,49,3,3,2,8,0xb2d63ebfd
1961.32,1.0,184,1,2,1,4,0xb2d09ac5
77.95,1.0,9,1,2,3,6,0xb2d44d5c
59027.12,2.0,13,3,3,3,9,0xb2d29073
300012.67,2.0,60,3,3,2,8,0xb2d9b63d
2077.81,1.0,115,1,2,1,4,0xb2d3b458
603.77,1.0,0,1,2,4,7,0xb2d51e81
503536.89,1.0,11,4,2,3,9,0xb2d9df74
1000006.04,3.0,3,4,4,4,12,0xb2d928f8
1000122.89,4.0,5,4,4,3,11,0xb2d224a5
230332.72,3.0,77,3,4,1,8,0xb2d59033
10.56,1.0,69,1,2,1,4,0xb2d6a777
50004.22,2.0,48,2,3,2,7,0xb2d901f3
316.72,1.0,55,1,2,2,5,0xb2d2f43d
12490.19,1.0,11,2,2,3,7,0xb2d921f9
482001.31,11.0,4,4,4,4,12,0xb2d78e4bd
21925.04,1.0,14,2,2,3,7,0xb2d6d273
530000.0,2.0,3,4,3,4,11,0xb2d97693d
112025.83,4.0,14,3,4,3,10,0xb2d3db8cd
247505.34,2.0,10,3,3,3,9,0xb2d50155
656376.26,7.0,0,4,4,4,12,0xb2d20fa7
425000.85,2.0,3,4,3,4,11,0xb2d5e1ba
15.1,1.0,5,1,2,3,6,0xb2d2e7d4
331945.54,3.0,0,4,4,4,12,0xb2d26383
110050.01,2.0,40,3,3,2,8,0xb2d38ad4
330576.55,7.0,3,4,4,4,12,0xb2d3a108
1.75,1.0,63,1,2,2,5,0xb2d31365
1.48,1.0,32,1,2,2,5,0xb2d959bf
484170.81,4.0,55,4,4,2,10,0xb2d3bee4
2573.89,1.0,0,1,2,4,7,0xb2d6e7f5
416.63,1.0,1,1,2,4,7,0xb2d34756
123075.86,2.0,22,3,3,2,8,0xb2d103e1
156826.18,3.0,56,3,4,2,9,0xb2d439ef
60070.07,3.0,137,3,4,1,8,0xb2d8e094d
5.49,1.0,41,1,2,2,5,0xb2d25b16
36.91,2.0,0,1,3,4,8,0xb2d30f8d
322105.91,17.0,1,4,4,4,12,0xb2d29342
123176.46,2.0,87,3,3,1,7,0xb2d62116d
200001.26,2.0,16,3,3,2,8,0xb2d6f592d
10111.14,1.0,92,2,2,1,5,0xb2d28c66
500188.0,2.0,6,4,3,3,10,0xb2da1d6b
4835.4,1.0,15,2,2,3,7,0xb2d69cd5
230004.57,2.0,31,3,3,2,8,0xb2d5aa44d
300002.64,1.0,9,3,2,3,8,0xb2d96208d
320003.99,3.0,12,4,4,3,11,0xb2d8e699d
200092.07,2.0,7,3,3,3,9,0xb2d94561
2954.78,1.0,7,2,2,3,7,0xb2d2c29b
633.8,1.0,9,1,2,3,6,0xb2d380c4
412775.66,3.0,57,4,4,2,10,0xb2d68c0cd
452237.75,3.0,34,4,4,2,10,0xb2d573b8d
11183.17,1.0,92,2,2,1,5,0xb2d53d0e
1.26,1.0,35,1,2,2,5,0xb2d6d3ea
8592.7,1.0,9,2,2,3,7,0xb2d37baa
1529.53,1.0,3,1,2,4,7,0xb2d29ae2
37087.36,1.0,10,2,2,3,7,0xb2d9a6e7
52512.72,5.0,10,3,4,3,10,0xb2d7fee3d
100042.01,3.0,67,3,4,1,8,0xb2d0e3f8
3607.12,1.0,5,2,2,3,7,0xb2d8fb80d
9908.7,1.0,14,2,2,3,7,0xb2da2145
1241.56,1.0,281,1,2,1,4,0xb2d6189b
31004.11,2.0,213,2,3,1,6,0xb2d59e03d
135053.78,3.0,108,3,4,1,8,0xb2d5d99b
250020.56,3.0,102,3,4,1,8,0xb2d25582d
106069.49,3.0,70,3,4,1,8,0xb2d5e4a6
0.53,1.0,18,1,2,2,5,0xb2d9584e
1816896.2,3.0,2,4,4,4,12,0xb2d3fb2d
103510.02,2.0,164,3,3,1,7,0xb2d18319
50863.07,2.0,48,2,3,2,7,0xb2d5a3c6
26730.81,1.0,6,2,2,3,7,0xb2d35812d
100037.58,2.0,192,3,3,1,7,0xb2d1526e
100503.83,4.0,181,3,4,1,8,0xb2d0bc78
2386.87,1.0,1,1,2,4,7,0xb2d61ece
4.75,1.0,73,1,2,1,4,0xb2d8d8a7
500011.61,3.0,52,4,4,2,10,0xb2d1009ed
50006.67,2.0,92,2,3,1,6,0xb2d5a51ad
107254.99,4.0,19,3,4,2,9,0xb2d68997
3407.28,1.0,0,2,2,4,8,0xb2d54f47
802.7,1.0,47,1,2,2,5,0xb2d53a07d
500062.2,2.0,8,4,3,3,10,0xb2d67dc4
24688.15,1.0,0,2,2,4,8,0xb2d6ab43
50000.53,2.0,92,2,3,1,6,0xb2d5cb6c
160015.37,3.0,97,3,4,1,8,0xb2d57398d
264048.19,7.0,39,3,4,2,9,0xb2d5067d
2442.07,1.0,5,1,2,3,6,0xb2d57c01
1966.59,1.0,92,1,2,1,4,0xb2d28755
2606.06,1.0,4,1,2,4,7,0xb2d8ce2ad
462508.78,5.0,2,4,4,4,12,0xb2d414c7
1000000.56,15.0,0,4,4,4,12,0xb2d11bc6
8275.04,1.0,0,2,2,4,8,0xb2d7552bd
51711.28,1.0,33,2,2,2,6,0xb2d5d6cbd
2683.23,1.0,9,1,2,3,6,0xb2d3eb41
298141.02,5.0,3,3,4,4,11,0xb2d1d9eb
247.95,1.0,0,1,2,4,7,0xb2d6c858d
94036.03,3.0,62,3,4,2,9,0xb2d48f72d
2052.03,1.0,207,1,2,1,4,0xb2d41323
3091724.01,6.0,18,4,4,2,10,0xb2d6e6cf
220063.37,2.0,11,3,3,3,9,0xb2d985d4
330000.0,1.0,0,4,2,4,10,0xb2d41260
110071.41,2.0,179,3,3,1,7,0xb2d1c67a
50639.85,2.0,80,2,3,1,6,0xb2d37b79
281038.41,6.0,11,3,4,3,10,0xb2d273f0d
400000.0,2.0,2,4,3,4,11,0xb2da040b
193069.74,3.0,18,3,4,2,9,0xb2d34d3f
15971.4,1.0,15,2,2,3,7,0xb2d9adc1
738502.68,7.0,20,4,4,2,10,0xb2d615afd
121069.45,2.0,84,3,3,1,7,0xb2d0b9cc
110430.27,2.0,108,3,3,1,7,0xb2d24bcad
10000.11,2.0,231,2,3,1,6,0xb2d6eef8
697514.28,9.0,10,4,4,3,11,0x3b9b443b
58.59,1.0,14,1,2,3,6,0xb2d1a66e
10168.87,1.0,35,2,2,2,6,0xb2d69411d
63050.7,4.0,0,3,4,4,11,0xb2d4e14a
1304492.72,5.0,0,4,4,4,12,0xb2d425bb
499.68,1.0,12,1,2,3,6,0xb2d51746d
100061.97,2.0,48,3,3,2,8,0xb2d6a2d4
375816.63,3.0,0,4,4,4,12,0xb2d61ef3
126082.64,2.0,185,3,3,1,7,0xb2d2af64
470.96,1.0,9,1,2,3,6,0xb2d42d5a
3693.25,1.0,9,2,2,3,7,0xb2d1d500d
0.0,1.0,5,1,2,3,6,0xb2d5926b
2551.16,1.0,0,1,2,4,7,0xb2d99650
346569.05,4.0,5,4,4,3,11,0xb2d29945
15000.32,2.0,45,2,3,2,7,0xb2d9184c
460000.0,3.0,1,4,4,4,12,0xb2d5e7b5
3.64,1.0,36,1,2,2,5,0xb2d0aeab
850000.0,10.0,9,4,4,3,11,0xb2d5d41c
301065.63,2.0,40,4,3,2,9,0xb2d92813d
200150.09,2.0,46,3,3,2,8,0xb2d48b55
201452.64,2.0,36,3,3,2,8,0xb2d2d956d
9985.18,1.0,13,2,2,3,7,0xb2d1a2a6d
1912.99,1.0,0,1,2,4,7,0xb2d1879f
500396.6,2.0,41,4,3,2,9,0xb2d9be6f
103.12,1.0,59,1,2,2,5,0xb2d56f34
650837.72,2.0,49,4,3,2,9,0xb2d586a9
32.98,1.0,4,1,2,4,7,0xb2d3f7fe
3103.6,1.0,260,2,2,1,5,0xb2d238a2
19071.0,1.0,8,2,2,3,7,0xb2d62b61d
1078.89,1.0,184,1,2,1,4,0x3b9b3a0cd
600000.0,4.0,0,4,4,4,12,0xb2d6e3a5
300005.28,3.0,73,3,4,1,8,0xb2d8dcf5d
33323.26,1.0,0,2,2,4,8,0xb2d58c6fd
25000.8,2.0,27,2,3,2,7,0xb2d2310d
10724.63,1.0,184,2,2,1,5,0xb2d59a26
2255.09,1.0,92,1,2,1,4,0xb2d63e65
230150.13,2.0,4,3,3,4,10,0xb2d36c3a
69105.65,3.0,7,3,4,3,10,0xb2d0790ad
7106.51,1.0,0,2,2,4,8,0xb2d55409d
245692.37,2.0,0,3,3,4,10,0xb2d226acd
94000.37,3.0,1,3,4,4,11,0xb2d0bd59
122129.14,5.0,0,3,4,4,11,0xb2d0a76b
50086.21,2.0,216,2,3,1,6,0xb2d226c4d
202905.84,2.0,4,3,3,4,10,0xb2d27a37d
769760.43,1.0,32,4,2,2,8,0xb2d2f9f1
2737.45,1.0,39,1,2,2,5,0xb2d31299
665848.52,3.0,0,4,4,4,12,0xb2d6b0e3
2350.8,1.0,133,1,2,1,4,0xb2d9051f
34068.65,1.0,160,2,2,1,5,0xb2d45a0dd
50034.54,2.0,228,2,3,1,6,0xb2d4d961d
117109.71,2.0,2,3,3,4,10,0xb2d21293d
1027.03,1.0,0,1,2,4,7,0xb2d0e6f8d
330412.33,2.0,12,4,3,3,10,0xb2d5dc1bd
66.77,1.0,11,1,2,3,6,0xb2d2fcd7
3058.45,1.0,184,2,2,1,5,0xb2d1c963
4019.43,1.0,184,2,2,1,5,0xb2d5ce1dd
450016.79,3.0,165,4,4,1,9,0xb2d504e9d
370089.47,2.0,18,4,3,2,9,0xb2d65e65
191.72,1.0,0,1,2,4,7,0xb2d56ebc
128.98,1.0,1,1,2,4,7,0xb2d4b6d5
40203.17,4.0,17,2,4,2,8,0xb2d4526e
600032.25,2.0,8,4,3,3,10,0xb2d32513
333.3,1.0,0,1,2,4,7,0xb2d306b2d
46471.92,5.0,76,2,4,1,7,0xb2d09652
1883.69,1.0,4,1,2,4,7,0xb2d8cf33
111.61,1.0,0,1,2,4,7,0xb2d53151d
19697.43,1.0,14,2,2,3,7,0xb2d37ee4
58.25,1.0,0,1,2,4,7,0xb2d25246
500000.0,2.0,1,4,3,4,11,0xb2d4fd30
2233.54,1.0,0,1,2,4,7,0xb2d21360d
664607.09,5.0,0,4,4,4,12,0xb2d089c6
400122.27,2.0,38,4,3,2,9,0xb2d35d49d
60030.38,3.0,259,3,4,1,8,0xb2d06f7b
110202.77,4.0,18,3,4,2,9,0xb2d6dcb2
500020.0,1.0,0,4,2,4,10,0xb2da6af5
6153.39,1.0,0,2,2,4,8,0xb2d278b4d
225.17,1.0,7,1,2,3,6,0xb2d1b543d
646005.28,8.0,80,4,4,1,9,0xb2d2f17a
50001.58,2.0,74,2,3,1,6,0xb2d999a2
206403.03,2.0,112,3,3,1,7,0xb2d5dc5d
200000.12,2.0,25,3,3,2,8,0xb2d7876c
2155636.1,6.0,6,4,4,3,11,0xb2d24eebd
1510.79,1.0,92,1,2,1,4,0xb2d395aa
64.89,1.0,4,1,2,4,7,0xb2d27030
4.89,1.0,14,1,2,3,6,0xb2d68ea2
101123.63,2.0,102,3,3,1,7,0xb2d3add7d
22.81,2.0,0,1,3,4,8,0xb2d06764d
184787.81,4.0,4,3,4,4,11,0xb2d69a6ad
1856023.1,5.0,17,4,4,2,10,0xb2d075f9
165764.99,3.0,3,3,4,4,11,0xb2d1d8bbd
0.0,2.0,56,1,3,2,6,0xb2d9a554
421658.98,3.0,41,4,4,2,10,0xb2d69a09d
800279.78,4.0,3,4,4,4,12,0xb2d62823
109142.62,1.0,112,3,2,1,6,0xb2d0d3cad
1416.25,1.0,184,1,2,1,4,0xb2d1d734d
112422.6,2.0,97,3,3,1,7,0xb2d5295ad
9.47,1.0,15,1,2,3,6,0xb2d97680
2106470.75,3.0,0,4,4,4,12,0xb2d22550d
271451.55,5.0,14,3,4,3,10,0xb2d19807
1510.55,1.0,98,1,2,1,4,0xb2d20e6cd
207008.18,3.0,11,3,4,3,10,0xb2d632d6
200000.0,1.0,0,3,2,4,9,0xb2da68f6
232495.24,3.0,108,3,4,1,8,0xb2d3e610d
100062.1,3.0,216,3,4,1,8,0xb2d22d3ed
131631.07,1.0,184,3,2,1,6,0xb2d2554ed
450004.75,2.0,25,4,3,2,9,0xb2da0f9a
4530160.76,3.0,92,4,4,1,9,0xb2d40181
464234.89,3.0,85,4,4,1,9,0xb2d67a1f
3501.54,1.0,184,2,2,1,5,0x3b9b2981d
500033.82,3.0,8,4,4,3,11,0xb2da22af
50008.97,1.0,26,2,2,2,6,0xb2d94769d
6035.87,1.0,184,2,2,1,5,0xb2d47653
12.68,1.0,139,1,2,1,4,0xb2d6e9bed
4702.05,1.0,193,2,2,1,5,0xb2d6129bd
500031.67,2.0,11,4,3,3,10,0xb2da364d
71277.1,6.0,12,3,4,3,10,0xb2d410ed
100007.81,2.0,41,3,3,2,8,0xb2d8fdaf
2562.89,1.0,183,1,2,1,4,0xb2d26915d
2141.84,1.0,184,1,2,1,4,0xb2d2b017d
20974.56,1.0,19,2,2,2,6,0xb2d18727
15.41,1.0,32,1,2,2,5,0xb2d692ec
288.99,1.0,22,1,2,2,5,0xb2d9257f
300000.0,2.0,3,3,3,4,10,0xb2d9741f
5516.43,1.0,145,2,2,1,5,0xb2d2437c
434099.34,4.0,74,4,4,1,9,0xb2d16cfb
351030.17,8.0,27,4,4,2,10,0xb2d5c825
200006.33,2.0,8,3,3,3,9,0xb2d96d3d
450004.75,2.0,8,4,3,3,10,0xb2da4a92
621877.27,6.0,15,4,4,3,11,0xb2d60b6e
2260000.0,5.0,0,4,4,4,12,0xb2d3671ad
41879.37,1.0,10,2,2,3,7,0xb2d6bbc9d
200125.42,2.0,25,3,3,2,8,0xb2d3b3c0d
4378.94,1.0,0,2,2,4,8,0xb2d6da3c
383.73,1.0,89,1,2,1,4,0xb2d1fc31d
335033.32,3.0,76,4,4,1,9,0xb2d230ac
622788.28,4.0,1,4,4,4,12,0xb2d53831
868403.06,9.0,5,4,4,3,11,0xb2d0ecb8d
450093.87,3.0,10,4,4,3,11,0xb2d69bb9
202922.15,2.0,95,3,3,1,7,0xb2d65403
693415.5,6.0,0,4,4,4,12,0x3b9af133d
10005.55,1.0,45,2,2,2,6,0xb2d2dc76d
403361.73,5.0,53,4,4,2,10,0xb2d50995
500077.85,3.0,5,4,4,3,11,0xb2d68294
21150.63,3.0,1,2,4,4,10,0xb2d6b6b9
5.6,1.0,81,1,2,1,4,0xb2d97d9b
111053.5,2.0,3,3,3,4,10,0xb2d68a10
1110032.92,13.0,18,4,4,2,10,0xb2d560df
21.93,1.0,9,1,2,3,6,0xb2d6baf2
45438.84,1.0,0,2,2,4,8,0xb2d429b4d
1325.02,1.0,184,1,2,1,4,0xb2d1c9fed
23.37,1.0,68,1,2,1,4,0xb2d8c45a
499000.0,3.0,1,4,4,4,12,0xb2d93077d
4016.88,1.0,184,2,2,1,5,0x3b9af654
483423.89,3.0,9,4,4,3,11,0xb2d40cc6
1508.62,1.0,185,1,2,1,4,0xb2d2d7f8
265.9,1.0,6,1,2,3,6,0xb2d321b9
10000.95,1.0,18,2,2,2,6,0xb2d957c7d
200011.65,2.0,3,3,3,4,10,0xb2d6db89d
543731.53,6.0,3,4,4,4,12,0xb2d3a855
1000011.41,2.0,1,4,3,4,11,0xb2d2763f
155.82,1.0,14,1,2,3,6,0xb2d763d7d
280001.58,4.0,1,3,4,4,11,0xb2da1e5f
1500.02,1.0,39,1,2,2,5,0xb2d43cc1
403187.07,5.0,1,4,4,4,12,0xb2d128e8d
219527.33,8.0,0,3,4,4,11,0xb2d31e13
50009.5,1.0,28,2,2,2,6,0xb2da0e36
202146.0,2.0,93,3,3,1,7,0xb2d65552d
123499.35,2.0,3,3,3,4,10,0xb2d078ba
31072.51,1.0,28,2,2,2,6,0xb2d602d5
1439.63,1.0,0,1,2,4,7,0xb2d278c6d
474.87,2.0,19,1,3,2,6,0x3b9b24fb
55.74,1.0,1,1,2,4,7,0xb2d4ee88
475000.0,5.0,0,4,4,4,12,0xb2d243ec
500000.0,3.0,2,4,4,4,12,0xb2d98248
71418.28,3.0,55,3,4,2,9,0xb2d0a06dd
422000.3,5.0,13,4,4,3,11,0xb2d63a3a
6.61,1.0,60,1,2,2,5,0xb2d64b9d
51.65,1.0,0,1,2,4,7,0xb2d782d1
1093.11,1.0,0,1,2,4,7,0xb2d45bb9
94000.0,4.0,0,3,4,4,11,0xb2d69587
140009.96,3.0,0,3,4,4,11,0xb2d2297b
9.19,1.0,9,1,2,3,6,0xb2d55ae0
326722.92,2.0,0,4,3,4,11,0xb2d1e5c8
0.15,1.0,0,1,2,4,7,0xb2d9588d
1053.24,1.0,92,1,2,1,4,0xb2d34224d
100002.11,2.0,101,3,3,1,7,0xb2d81337
502845.89,1.0,0,4,2,4,10,0xb2d6a3ced
70079.56,2.0,0,3,3,4,10,0xb2d92d22
104.05,1.0,6,1,2,3,6,0xb2d3b9f6
1149203.63,8.0,69,4,4,1,9,0xb2d5f692d
250000.0,3.0,1,3,4,4,11,0xb2d120fe
10100.35,2.0,92,2,3,1,6,0xb2d5ccb6
197206.91,3.0,31,3,4,2,9,0xb2d163bcd
206972.97,4.0,122,3,4,1,8,0xb2d15493
75.92,1.0,21,1,2,2,5,0xb2d7565a
600000.0,2.0,3,4,3,4,11,0xb2d97a2fd
38101.89,1.0,0,2,2,4,8,0xb2d50b3f
526140.12,3.0,5,4,4,3,11,0xb2d34cff
0.19,1.0,2,1,2,4,7,0xb2d91467d
6405.28,1.0,92,2,2,1,5,0xb2d21ad2d
95000.04,7.0,0,3,4,4,11,0xb2d2e844d
208947.34,1.0,133,3,2,1,6,0xb2d31687d
1008.59,1.0,92,1,2,1,4,0xb2d358dbd
13920000.0,1.0,4,4,2,4,10,0xb2da5cf2
1004016.36,6.0,6,4,4,3,11,0xb2d18a7ad
2010657.7,3.0,59,4,4,2,10,0xb2d9c269
28094.32,1.0,24,2,2,2,6,0xb2d30d16
0.79,1.0,92,1,2,1,4,0xb2d393ed
153707.63,4.0,49,3,4,2,9,0xb2d19912
2280092.96,4.0,8,4,4,3,11,0xb2d0fd6ad
110100.48,2.0,4,3,3,4,10,0xb2d5a592
454464.86,6.0,52,4,4,2,10,0xb2d68658d
6774.73,1.0,11,2,2,3,7,0xb2d68082
20.14,1.0,1,1,2,4,7,0xb2d8c768
163.92,1.0,88,1,2,1,4,0xb2d5ada2
501869.74,3.0,22,4,4,2,10,0xb2d95882d
93084.72,2.0,3,3,3,4,10,0xb2d8df5c
1730130.34,2.0,24,4,3,2,9,0xb2d13ac7
161608.02,4.0,8,3,4,3,10,0xb2d4ff03d
1.47,1.0,1,1,2,4,7,0xb2d55a0d
225086.41,3.0,75,3,4,1,8,0xb2d3e6bcd
482002.92,4.0,26,4,4,2,10,0xb2d0d6a9
48445.4,2.0,22,2,3,2,7,0xb2d14878
13.3,1.0,8,1,2,3,6,0xb2d52e16
505000.0,5.0,0,4,4,4,12,0xb2d5be7f
810017.6,6.0,27,4,4,2,10,0xb2d69cde
231585.59,4.0,0,3,4,4,11,0xb2d363c0
113235.09,5.0,0,3,4,4,11,0xb2d1faba
211010.1,3.0,20,3,4,2,9,0xb2da1cc9
10115.03,2.0,46,2,3,2,7,0xb2d90c7dd
830023.36,6.0,3,4,4,4,12,0xb2d12dac
230003.17,3.0,0,3,4,4,11,0xb2d21ad9
8074.78,1.0,143,2,2,1,5,0xb2d30fc7d
9124.17,1.0,10,2,2,3,7,0xb2d6bd98d
450287.78,7.0,11,4,4,3,11,0xb2d61997
101018.14,2.0,118,3,3,1,7,0xb2d628b5d
55304.14,2.0,3,3,3,4,10,0xb2d08eaad
9666.27,1.0,6,2,2,3,7,0xb2d2ac60d
36.14,1.0,20,1,2,2,5,0xb2d6171f
82456.57,2.0,4,3,3,4,10,0xb2d2b55ed
1042914.72,8.0,28,4,4,2,10,0xb2d16ed4d
801474.55,4.0,62,4,4,2,10,0xb2d61b2f
1004.06,1.0,110,1,2,1,4,0xb2d94f28
74841.25,1.0,10,3,2,3,8,0xb2d5ec05
11005.36,1.0,0,2,2,4,8,0xb2d551acd
116619.03,2.0,11,3,3,3,9,0xb2d0cc8ed
220000.0,2.0,12,3,3,3,9,0xb2d96457
435009.19,3.0,175,4,4,1,9,0xb2d324b6
344700.13,4.0,55,4,4,2,10,0xb2d5b752
30185.99,1.0,271,2,2,1,5,0xb2d4debd
70002.96,2.0,98,3,3,1,7,0xb2d96b47
380057.65,4.0,1,4,4,4,12,0xb2d579a7
1008102.3,8.0,1,4,4,4,12,0x3b9b0e6d
160010.7,3.0,47,3,4,2,9,0xb2d186f7
1500015.93,2.0,25,4,3,2,9,0xb2d14c7d
387002.07,10.0,83,4,4,1,9,0xb2d0c102d
670110.13,7.0,63,4,4,2,10,0xb2d561a1d
38311.62,2.0,3,2,3,4,9,0xb2d1f838d
100001.06,4.0,41,3,4,2,9,0xb2d8dd37
102179.69,2.0,158,3,3,1,7,0xb2d44dc3
2200094.36,5.0,0,4,4,4,12,0xb2d6bd9d
275407.72,2.0,92,3,3,1,7,0xb2d12be3d
64658.89,2.0,105,3,3,1,7,0xb2d60555
310740.48,6.0,25,4,4,2,10,0xb2d1554e
610020.52,4.0,70,4,4,1,9,0xb2d1f402d
16327.49,1.0,1,2,2,4,8,0xb2d6c6f6d
402331.65,1.0,26,4,2,2,8,0xb2d1ef8f
604052.19,4.0,0,4,4,4,12,0xb2d288fdd
3.43,1.0,29,1,2,2,5,0xb2d8d00d
360196.69,3.0,0,4,4,4,12,0xb2d128c0
919.79,1.0,80,1,2,1,4,0xb2d6b7ab
45647.68,1.0,0,2,2,4,8,0xb2d638bc
500000.0,2.0,23,4,3,2,9,0xb2d6e6c2d
9623.06,1.0,0,2,2,4,8,0xb2d99e40
572.34,1.0,10,1,2,3,6,0xb2d2ddaa
96848.49,5.0,4,3,4,4,11,0xb2d5e4a5
50493.29,2.0,129,2,3,1,6,0xb2d63dc8d
210004.22,3.0,48,3,4,2,9,0xb2d93c14
402285.47,3.0,18,4,4,2,10,0xb2d64c42d
17643.33,1.0,10,2,2,3,7,0xb2d3ea3cd
131313.46,2.0,4,3,3,4,10,0xb2d3a561d
150009.77,3.0,34,3,4,2,9,0xb2d2fd2fd
57.95,1.0,70,1,2,1,4,0xb2d9539b
9000.0,1.0,3,2,2,4,8,0xb2d76761
3110173.64,14.0,0,4,4,4,12,0x3b9ae49b
7207.74,1.0,31,2,2,2,6,0xb2d42937
1136.5,1.0,130,1,2,1,4,0xb2d53875
671034.18,5.0,8,4,4,3,11,0xb2d0a3c2
5353.34,1.0,14,2,2,3,7,0xb2d5dd3ed
403257.16,6.0,0,4,4,4,12,0xb2d2e04f
249106.46,5.0,6,3,4,3,10,0xb2d41b5a
6.58,1.0,41,1,2,2,5,0xb2d7011a
16.79,1.0,36,1,2,2,5,0xb2d2ae8cd
15793.46,1.0,1,2,2,4,8,0xb2d3163a
82787.18,34.0,21,3,4,2,9,0xb2d13227d
46.91,2.0,3,1,3,4,8,0xb2d4f3d1d
91010.29,5.0,5,3,4,3,10,0xb2d069ded
61059.14,2.0,1,3,3,4,10,0xb2d18b65d
324.0,1.0,0,1,2,4,7,0xb2da26c3
90002.13,4.0,73,3,4,1,8,0xb2d63723d
690558.06,17.0,0,4,4,4,12,0xb2d60594
380744.02,5.0,3,4,4,4,12,0x3b9b0fa6
216963.48,2.0,8,3,3,3,9,0xb2d5f570d
5820.22,1.0,184,2,2,1,5,0xb2d23cbed
80006.57,2.0,108,3,3,1,7,0xb2d3e9d8d
12875.98,1.0,10,2,2,3,7,0xb2d39916
975025.02,5.0,18,4,4,2,10,0xb2d3a565d
164707.99,5.0,13,3,4,3,10,0xb2d5c361d
3.31,1.0,34,1,2,2,5,0xb2d2465dd
9347.93,1.0,1,2,2,4,8,0xb2d73b4b
1039.47,1.0,9,1,2,3,6,0xb2d3448c
1103.19,1.0,149,1,2,1,4,0xb2d0deb9
1978.15,1.0,17,1,2,2,5,0xb2d6d9dcd
8367.59,1.0,0,2,2,4,8,0xb2d0d9b6
185025.2,1.0,0,3,2,4,9,0xb2d4ec85
10061.73,1.0,203,2,2,1,5,0xb2d6d611
197.65,3.0,10,1,4,3,8,0xb2d39ca1
1.15,1.0,27,1,2,2,5,0xb2d568b1
238.92,1.0,33,1,2,2,5,0xb2d5f96a
251778.57,2.0,5,3,3,3,9,0xb2d7f391
7390.37,1.0,0,2,2,4,8,0xb2d905b0
1452.7,1.0,147,1,2,1,4,0xb2d30e54d
138219.82,2.0,94,3,3,1,7,0xb2d433e3d
100006.01,2.0,70,3,3,1,7,0xb2d57728
5785.88,2.0,9,2,3,3,8,0xb2d37adad
24.55,1.0,8,1,2,3,6,0xb2d8d53a
13174.0,1.0,0,2,2,4,8,0xb2d6d370
250225.44,1.0,30,3,2,2,7,0xb2d411c4
112.66,1.0,25,1,2,2,5,0xb2d1d5ced
273012.29,7.0,16,3,4,2,9,0xb2d3a494d
1424.51,1.0,5,1,2,3,6,0xb2d227aad
102318.42,2.0,0,3,3,4,10,0xb2d10d5e
500009.1,3.0,1,4,4,4,12,0xb2d6fd67d
220840.52,1.0,0,3,2,4,9,0xb2d0d807
301423.36,3.0,24,4,4,2,10,0xb2d985bb
36.67,1.0,6,1,2,3,6,0xb2d5bb41
1019792.05,3.0,0,4,4,4,12,0xb2d60f9b
170007.18,2.0,63,3,3,2,8,0xb2d9b4e1
787113.96,4.0,35,4,4,2,10,0xb2d30e66
160011.1,2.0,122,3,3,1,7,0xb2d578c8d
1003554.08,3.0,35,4,4,2,10,0xb2d9fd62
400047.62,3.0,2,4,4,4,12,0xb2d6f8e8d
460118.74,2.0,4,4,3,4,11,0xb2d688a8
115155.41,1.0,8,3,2,3,8,0xb2da01ff
80006.89,2.0,22,3,3,2,8,0xb2d0eaee
30004.48,2.0,28,2,3,2,7,0xb2d91b60
2222.33,1.0,111,1,2,1,4,0xb2d62b43
1273.95,1.0,0,1,2,4,7,0xb2d52498
2321326.35,3.0,102,4,4,1,9,0xb2d963a3d
233311.13,2.0,14,3,3,3,9,0xb2d67e8b
120233.09,3.0,47,3,4,2,9,0xb2d37c85
205690.32,2.0,111,3,3,1,7,0xb2d6c419
12.83,1.0,53,1,2,2,5,0xb2d3c9a3
100937.09,4.0,51,3,4,2,9,0xb2d0848e
130082.52,2.0,200,3,3,1,7,0xb2d4ee0bd
10012.67,1.0,129,2,2,1,5,0xb2d716afd
2382412.24,22.0,0,4,4,4,12,0xb2d3690ad
2.06,1.0,67,1,2,1,4,0xb2d83952d
471983.98,3.0,8,4,4,3,11,0xb2d12b9a
68016.79,4.0,4,3,4,4,11,0xb2d5d1a1d
12267.08,1.0,15,2,2,3,7,0xb2d997b1
25.09,1.0,61,1,2,2,5,0xb2d57b36
100093.72,2.0,175,3,3,1,7,0xb2d8d009d
83246.61,5.0,41,3,4,2,9,0xb2d5ee8b
261612.48,5.0,0,3,4,4,11,0x3b9b2fe4d
174332.85,2.0,1,3,3,4,10,0xb2d11fc8d
101218.74,3.0,0,3,4,4,11,0xb2d5c452
20006.33,3.0,59,2,4,2,8,0xb2d25064d
300055.6,2.0,14,3,3,3,9,0xb2d509f2d
46.69,1.0,80,1,2,1,4,0xb2d346f1
26004.52,1.0,21,2,2,2,6,0xb2d60a8ad
4545.37,1.0,15,2,2,3,7,0xb2d698bed
320154.82,2.0,45,4,3,2,9,0xb2d1c85fd
270037.33,5.0,4,3,4,4,11,0xb2d5b9d2
51766.61,2.0,111,2,3,1,6,0xb2d53b4f
37.16,1.0,29,1,2,2,5,0xb2d443c7
203.92,1.0,9,1,2,3,6,0xb2d4a933
492001.66,5.0,0,4,4,4,12,0xb2d22785
14013.65,1.0,1,2,2,4,8,0xb2d6acca
301099.95,2.0,35,4,3,2,9,0xb2d5d45b
330150.76,2.0,53,4,3,2,9,0xb2d20fff
6788.3,1.0,56,2,2,2,6,0xb2d65ba1
454799.01,2.0,1,4,3,4,11,0xb2d625c9
630086.04,11.0,0,4,4,4,12,0xb2d956e0
10160.39,2.0,221,2,3,1,6,0xb2d64309
8580.54,1.0,1,2,2,4,8,0xb2d989da
4510.95,1.0,2,2,2,4,8,0xb2d2b89c
52091.84,1.0,97,2,2,1,5,0xb2d29743
102006.65,3.0,34,3,4,2,9,0xb2d93030d
20307.98,2.0,263,2,3,1,6,0xb2d5ee6bd
100000000.0,2.0,97,4,3,1,8,0xb2d970e3
30.95,1.0,7,1,2,3,6,0xb2d37c02
501782.37,2.0,21,4,3,2,9,0xb2da0695
1000618.65,6.0,0,4,4,4,12,0xb2d1459ed
30091.85,1.0,11,2,2,3,7,0xb2d3440e
362575.67,1.0,0,4,2,4,10,0xb2d9f373
410325.85,4.0,34,4,4,2,10,0xb2d92d82
227.57,1.0,1,1,2,4,7,0xb2d54be6
300013.04,2.0,66,3,3,2,8,0xb2d6a1d1
779025.78,5.0,12,4,4,3,11,0xb2d41c27d
118.95,1.0,24,1,2,2,5,0xb2d71714
2283.88,1.0,0,1,2,4,7,0xb2d6b574
1447.48,1.0,9,1,2,3,6,0xb2d516dad
40047.04,2.0,0,2,3,4,9,0xb2d32a1d
53.65,2.0,13,1,3,3,7,0xb2d1f2dd
20720.66,2.0,69,2,3,1,6,0xb2d63a83
410397.02,2.0,2,4,3,4,11,0xb2d8d811
470.05,1.0,78,1,2,1,4,0xb2d2106e
155.98,1.0,13,1,2,3,6,0xb2d6dd9d
11.05,1.0,9,1,2,3,6,0xb2d4dd30
185319.46,5.0,0,3,4,4,11,0xb2d4a69fd
1891.3,1.0,207,1,2,1,4,0xb2d5964d
72961.21,3.0,3,3,4,4,11,0xb2d17e72
304237.9,4.0,0,4,4,4,12,0xb2d23268d
101858.55,1.0,35,3,2,2,7,0xb2d584d7
527212.04,3.0,108,4,4,1,9,0xb2d3eff6
2648.39,1.0,20,1,2,2,5,0xb2d62b72d
0.0,1.0,0,1,2,4,7,0xb2d98172
503552.47,2.0,62,4,3,2,9,0xb2d9bc16
437107.19,4.0,46,4,4,2,10,0xb2d11b21
410009.73,4.0,97,4,4,1,9,0xb2d65baa
212840.51,2.0,56,3,3,2,8,0xb2d6b3f1
2.24,1.0,6,1,2,3,6,0xb2d6f5f5
40081.95,1.0,204,2,2,1,5,0xb2d78c52d
985201.93,3.0,1,4,4,4,12,0xb2d5d525
20044.97,1.0,4,2,2,4,8,0xb2d2b663
250005.3,2.0,92,3,3,1,7,0xb2d67e0fd
130003.7,4.0,25,3,4,2,9,0xb2d939f8
2243.19,1.0,0,1,2,4,7,0xb2d68401d
0.21,1.0,92,1,2,1,4,0xb2d14a9f
80001.69,2.0,87,3,3,1,7,0xb2d55102
81577.35,1.0,33,3,2,2,7,0xb2d230ba
500000.0,4.0,19,4,4,2,10,0xb2d0e35d
4425.48,1.0,0,2,2,4,8,0xb2d6c173
1315.23,1.0,0,1,2,4,7,0xb2d5bdd0
1165095.3,7.0,9,4,4,3,11,0xb2d0cd9f
5488.64,1.0,9,2,2,3,7,0xb2d5f5e2d
49264.61,1.0,7,2,2,3,7,0xb2d7055b
24301.61,1.0,1,2,2,4,8,0xb2d45ac5d
79.19,1.0,14,1,2,3,6,0xb2d64d4f
250007.7,4.0,11,3,4,3,10,0xb2d92870
60001.82,2.0,45,3,3,2,8,0xb2d596f9
46.01,3.0,78,1,4,1,6,0xb2d2acb6d
110001.29,1.0,13,3,2,3,8,0xb2d31fdbd
13.32,1.0,15,1,2,3,6,0xb2d4024f
2000.78,1.0,17,1,2,2,5,0xb2d639bfd
200099.3,3.0,47,3,4,2,9,0xb2d0f939
10376.98,1.0,116,2,2,1,5,0xb2d15b36d
510883.33,4.0,59,4,4,2,10,0xb2d5ab1bd
1638244.46,15.0,0,4,4,4,12,0x3b9af1c6d
3550003.6,16.0,0,4,4,4,12,0xb2d7fce3d
1163812.17,3.0,22,4,4,2,10,0xb2d5e0f2d
3.63,1.0,8,1,2,3,6,0xb2d56ea7
707449.86,4.0,0,4,4,4,12,0xb2d6e215
222874.09,3.0,3,3,4,4,11,0xb2d5da5ad
283720.31,4.0,24,3,4,2,9,0xb2d5ee06
377034.98,7.0,10,4,4,3,11,0xb2d3a54c
372.87,1.0,54,1,2,2,5,0xb2d6f3c2d
51082.98,2.0,42,2,3,2,7,0xb2d9e25a
106288.73,2.0,1,3,3,4,10,0xb2d8c9d0d
4612.3,1.0,0,2,2,4,8,0xb2d63ecd
242694.93,3.0,60,3,4,2,9,0xb2d97854
5276.48,1.0,9,2,2,3,7,0xb2d60c64
683641.51,4.0,9,4,4,3,11,0xb2d64828d
520108.24,6.0,5,4,4,3,11,0xb2d670ded
98.67,1.0,10,1,2,3,6,0xb2d34735
9652.28,1.0,9,2,2,3,7,0xb2d2fc03d
18872.19,1.0,0,2,2,4,8,0xb2d85bea
100006.97,4.0,32,3,4,2,9,0xb2d20fc6
229940.44,1.0,25,3,2,2,7,0xb2d6e29e
801000.52,6.0,0,4,4,4,12,0xb2d62050
28099.56,1.0,2,2,2,4,8,0xb2d2225f
3.03,1.0,8,1,2,3,6,0xb2d68fe6
34007.93,1.0,13,2,2,3,7,0xb2d6d716
20318.01,2.0,49,2,3,2,7,0xb2d7f224
752730.0,6.0,14,4,4,3,11,0xb2d3827d
18663.1,1.0,3,2,2,4,8,0xb2d0c527d
992154.11,6.0,4,4,4,4,12,0xb2d51baa
623049.03,4.0,0,4,4,4,12,0xb2d19a58d
28.52,1.0,24,1,2,2,5,0xb2d5bf78
690007.08,3.0,1,4,4,4,12,0xb2d9711ad
487003.14,3.0,184,4,4,1,9,0xb2d06924d
304014.07,5.0,33,4,4,2,10,0xb2d41e68
54106.79,2.0,87,3,3,1,7,0xb2d39a64d
602171.48,5.0,27,4,4,2,10,0xb2d3663f
385.24,1.0,58,1,2,2,5,0xb2d5ac91
2928.38,1.0,6,2,2,3,7,0xb2d78df3
1037962.35,2.0,32,4,3,2,9,0xb2d4da96
1023540.72,1.0,5,4,2,3,9,0xb2d2f94a
506342.78,3.0,27,4,4,2,10,0xb2d0b644d
15162.14,2.0,0,2,3,4,9,0xb2d2da70d
232460.7,1.0,10,3,2,3,8,0xb2d3aff1
21626.26,1.0,20,2,2,2,6,0xb2d6533bd
10000.42,2.0,92,2,3,1,6,0xb2d635a0d
25.56,1.0,12,1,2,3,6,0xb2d65c3a
44.81,1.0,0,1,2,4,7,0xb2d30ecd
3321.73,1.0,8,2,2,3,7,0xb2d6ed5cd
1031.16,1.0,184,1,2,1,4,0xb2d16437
70006.29,2.0,0,3,3,4,10,0x3b9b3dba
332205.35,5.0,24,4,4,2,10,0xb2d60087
175149.65,4.0,1,3,4,4,11,0xb2d58509
3793.25,1.0,120,2,2,1,5,0xb2d2effb
60011.18,2.0,74,3,3,1,7,0xb2d95f41
1089.78,1.0,0,1,2,4,7,0xb2d3ef96
300189.71,4.0,30,4,4,2,10,0xb2d95a46
690024.51,4.0,80,4,4,1,9,0xb2d2a261d
10505.23,1.0,21,2,2,2,6,0xb2d5d407
200586.65,2.0,151,3,3,1,7,0xb2d3c757
136006.22,1.0,116,3,2,1,6,0xb2d24465
27897.13,2.0,0,2,3,4,9,0xb2d689e2
340025.09,3.0,80,4,4,1,9,0xb2d576c7
8.13,1.0,10,1,2,3,6,0xb2da0d56
17.61,1.0,12,1,2,3,6,0xb2d569bd
598.01,1.0,4,1,2,4,7,0xb2d5222f
503553.07,2.0,82,4,3,1,8,0xb2d8d56bd
3740.78,2.0,0,2,3,4,9,0xb2d65986
1818.32,1.0,12,1,2,3,6,0xb2d261dc
517347.59,1.0,0,4,2,4,10,0xb2d143de
1371.27,1.0,91,1,2,1,4,0xb2d6a5d7
610000.0,2.0,1,4,3,4,11,0xb2da6349
56.72,1.0,10,1,2,3,6,0xb2d27c9a
0.74,1.0,1,1,2,4,7,0xb2d1ac64
455000.0,12.0,7,4,4,3,11,0xb2d3e600
218011.49,3.0,4,3,4,4,11,0xb2d09052d
280402.14,3.0,4,3,4,4,11,0xb2d6a164
8995.61,1.0,9,2,2,3,7,0xb2d3794bd
5626.24,1.0,0,2,2,4,8,0xb2d6062b
290012.76,3.0,59,3,4,2,9,0xb2d59e43d
20589.58,1.0,3,2,2,4,8,0xb2d652d9d
94022.36,3.0,0,3,4,4,11,0xb2d56973
4007.35,3.0,0,2,4,4,10,0x3b9b1947
1018.61,2.0,184,1,3,1,5,0x3b9b4261
100826.1,1.0,0,3,2,4,9,0xb2d64aced
880047.84,4.0,92,4,4,1,9,0xb2d3e614
8284.32,1.0,1,2,2,4,8,0xb2d8eba0
6.8,1.0,10,1,2,3,6,0xb2d8ffa3
9043.66,1.0,4,2,2,4,8,0xb2d4187bd
4451.35,1.0,130,2,2,1,5,0xb2d6a1ff
220812.49,2.0,15,3,3,3,9,0xb2d6c0be
400052.2,3.0,14,4,4,3,11,0xb2d6e38ad
50628.4,1.0,184,2,2,1,5,0xb2d19b02
100003.17,2.0,92,3,3,1,7,0xb2d643c5
5554500.77,52.0,0,4,4,4,12,0xb2d1ae82
2260365.16,4.0,90,4,4,1,9,0xb2d25181d
926024.82,3.0,4,4,4,4,12,0xb2d26748d
4206.53,1.0,0,2,2,4,8,0xb2d6b5bbd
525395.79,9.0,13,4,4,3,11,0xb2d49540
601.89,2.0,0,1,3,4,8,0xb2d0646e
5357.66,1.0,49,2,2,2,6,0xb2d8cb3dd
65.58,1.0,162,1,2,1,4,0xb2d138ba
62752.37,1.0,3,3,2,4,9,0xb2d43593d
153.14,1.0,52,1,2,2,5,0xb2d6b989
90020.62,35.0,8,3,4,3,10,0xb2d1c9d3d
944.92,1.0,18,1,2,2,5,0xb2d486a7
500005.28,2.0,10,4,3,3,10,0xb2d931fbd
5626.09,1.0,10,2,2,3,7,0xb2d6b5e4
238711.12,6.0,1,3,4,4,11,0xb2d37f78
1680019.31,5.0,73,4,4,1,9,0xb2d59709d
80971.5,2.0,52,3,3,2,8,0xb2d6d27d
2.78,1.0,184,1,2,1,4,0xb2d28fd3
1101.66,8.0,92,1,4,1,6,0xb2d30a35d
1214132.96,4.0,69,4,4,1,9,0x3b9b3ebe
217000.11,3.0,25,3,4,2,9,0xb2d07958d
489006.32,4.0,4,4,4,4,12,0xb2d96e90
727097.66,3.0,57,4,4,2,10,0xb2d6d3b5
800006.67,7.0,1,4,4,4,12,0xb2d19119d
81.78,1.0,53,1,2,2,5,0xb2d77feed
1064.97,1.0,4,1,2,4,7,0xb2d405da
328025.87,3.0,122,4,4,1,9,0xb2d28899d
200031.69,2.0,63,3,3,2,8,0xb2d53c8fd
8039.37,1.0,29,2,2,2,6,0xb2d938f9
73362.23,2.0,256,3,3,1,7,0xb2d45242
228.15,1.0,0,1,2,4,7,0xb2d9956d
68392.32,2.0,0,3,3,4,10,0xb2d3118d
234094.57,5.0,39,3,4,2,9,0xb2d6d7a4d
489013.74,11.0,19,4,4,2,10,0xb2d3b503d
1000056.9,2.0,28,4,3,2,9,0xb2d90f62
438689.17,4.0,21,4,4,2,10,0xb2d3818cd
171442.4,2.0,70,3,3,1,7,0xb2d1ed6e
17.71,1.0,4,1,2,4,7,0xb2d2ee56
4253.48,1.0,9,2,2,3,7,0xb2d78bb4
245630.78,1.0,0,3,2,4,9,0xb2d91412d
932.22,1.0,3,1,2,4,7,0xb2d2d1c4
8000000.0,2.0,22,4,3,2,9,0xb2d97595
2489.99,1.0,10,1,2,3,6,0xb2d78083
235682.04,2.0,1,3,3,4,10,0xb2d5f39e
30243.17,1.0,92,2,2,1,5,0xb2d3589a
27216.08,1.0,18,2,2,2,6,0xb2d32abfd
5000000.0,3.0,5,4,4,3,11,0xb2d91884
784.24,1.0,41,1,2,2,5,0xb2d39729
745.27,1.0,0,1,2,4,7,0xb2d6ce49
7928.46,1.0,10,2,2,3,7,0xb2d6f613d
900000.0,3.0,3,4,4,4,12,0xb2d42489
1070.19,1.0,10,1,2,3,6,0xb2d6d8db
100074.68,2.0,214,3,3,1,7,0xb2d2e11dd
122786.57,3.0,83,3,4,1,8,0xb2d5f624
334005.61,3.0,95,4,4,1,9,0xb2d64d16
95.97,2.0,92,1,3,1,5,0x3b9b2df7d
36119.27,1.0,0,2,2,4,8,0xb2d95d5ed
81825.22,2.0,4,3,3,4,10,0xb2d17981
32689.25,2.0,60,2,3,2,7,0xb2d535d7d
113.92,1.0,78,1,2,1,4,0xb2d45c02d
4.31,1.0,69,1,2,1,4,0xb2d28677
58906.89,1.0,203,3,2,1,6,0xb2d29ecfd
26279.8,2.0,21,2,3,2,7,0xb2d27ac0
709484.18,2.0,0,4,3,4,11,0xb2d15325
354475.06,2.0,0,4,3,4,11,0xb2d2b46a
1181017.65,8.0,1,4,4,4,12,0xb2d16058
747.36,1.0,8,1,2,3,6,0xb2d1f05b
3080.22,1.0,184,2,2,1,5,0xb2d5d1f9
1436000.0,15.0,0,4,4,4,12,0xb2d3be1bd
386514.99,3.0,12,4,4,3,11,0xb2d11d8ad
5507.95,2.0,184,2,3,1,6,0xb2d0cb4e
65598.17,1.0,25,3,2,2,7,0xb2d286af
21799.08,1.0,0,2,2,4,8,0xb2d0d22dd
1.35,1.0,110,1,2,1,4,0xb2d9577bd
19.98,1.0,11,1,2,3,6,0xb2d2ffd9
1895.23,1.0,5,1,2,3,6,0xb2d96263d
1350053.66,6.0,63,4,4,2,10,0xb2d368e8
1664.02,1.0,184,1,2,1,4,0xb2d0771a
624711.55,2.0,143,4,3,1,8,0xb2d5ab68d
1195.25,1.0,0,1,2,4,7,0xb2d638fed
11038.85,1.0,184,2,2,1,5,0xb2d3b80b
550928.56,5.0,26,4,4,2,10,0xb2d37821
500003.02,2.0,14,4,3,3,10,0xb2d91a9c
400472.91,3.0,1,4,4,4,12,0xb2d9b62b
200074.14,2.0,0,3,3,4,10,0xb2d6edf1d
607293.94,2.0,154,4,3,1,8,0xb2d11c24d
11000.0,1.0,0,2,2,4,8,0xb2d22c23
57505.85,2.0,1,3,3,4,10,0xb2d8e1ab
445.76,1.0,77,1,2,1,4,0xb2d1f0e8
76485.03,2.0,20,3,3,2,8,0xb2d58de5d
300000.0,2.0,18,3,3,2,8,0xb2da3444
50645.33,1.0,16,2,2,2,6,0xb2d3132ed
10801.78,1.0,3,2,2,4,8,0xb2d8d8c7
1.38,1.0,38,1,2,2,5,0xb2d6c64d
1079.5,1.0,10,1,2,3,6,0xb2d282fc
210000.11,3.0,24,3,4,2,9,0xb2d94b91
3176.0,1.0,92,2,2,1,5,0xb2d35db1
18309.54,1.0,8,2,2,3,7,0xb2d312f1
213055.09,2.0,134,3,3,1,7,0xb2d1a8d8
53.26,1.0,47,1,2,2,5,0xb2d384acd
100003.17,2.0,12,3,3,3,9,0xb2d95dc6
62350.87,2.0,151,3,3,1,7,0xb2d1ebdb
420111.25,4.0,2,4,4,4,12,0xb2d465c9
200008.71,3.0,18,3,4,2,9,0xb2d5677bd
1132622.0,5.0,13,4,4,3,11,0xb2d31cbf
471043.11,5.0,0,4,4,4,12,0xb2d0df19
15.64,1.0,31,1,2,2,5,0xb2d3f376d
48171.35,1.0,9,2,2,3,7,0xb2d8c7ee
1089.09,1.0,184,1,2,1,4,0x3b9adedf
200058.92,2.0,97,3,3,1,7,0xb2d30a3e
510083.34,4.0,20,4,4,2,10,0xb2d6b31b
800117.94,2.0,193,4,3,1,8,0xb2d18b01d
9639.87,1.0,25,2,2,2,6,0xb2d6bd66
210011.68,3.0,62,3,4,2,9,0xb2d1104c
2686.32,1.0,45,1,2,2,5,0xb2d8e7e5d
1910418.93,9.0,1,4,4,4,12,0xb2d1a447
2051062.45,5.0,6,4,4,3,11,0xb2d8f445
4903.28,1.0,23,2,2,2,6,0xb2d9bde0
51641.55,1.0,92,2,2,1,5,0xb2d10563d
220417.83,4.0,75,3,4,1,8,0xb2d1d45fd
5051.23,1.0,184,2,2,1,5,0xb2d29131
604.1,1.0,7,1,2,3,6,0xb2d119bf
8187.26,1.0,0,2,2,4,8,0xb2d4eb77
131099.59,4.0,28,3,4,2,9,0xb2d17126d
75042.76,5.0,11,3,4,3,10,0xb2d0b5bcd
20262.08,1.0,155,2,2,1,5,0xb2d60633
60234.29,1.0,0,3,2,4,9,0xb2d485c8
8017.03,1.0,0,2,2,4,8,0xb2d144f8d
500000.0,2.0,21,4,3,2,9,0xb2d65ae8
365372.02,4.0,8,4,4,3,11,0xb2d44a54
8003.17,1.0,0,2,2,4,8,0xb2d31ea8
100001.06,2.0,49,3,3,2,8,0xb2d9d5aa
339585.44,3.0,33,4,4,2,10,0xb2d27ed1
2.41,1.0,72,1,2,1,4,0xb2d13565
25011.87,2.0,18,2,3,2,7,0x3b9b2b8b
241527.57,2.0,31,3,3,2,8,0xb2d1c6ddd
34001.66,2.0,10,2,3,3,8,0xb2d61bb5
120501.22,5.0,26,3,4,2,9,0xb2d56072d
140004.43,2.0,25,3,3,2,8,0xb2da0b27
40532.99,2.0,0,2,3,4,9,0xb2d69a7a
2292.62,3.0,0,1,4,4,9,0x3b9b0e4f
500015.83,2.0,67,4,3,1,8,0xb2d5a9d2
138000.0,3.0,1,3,4,4,11,0xb2d265fc
118000.57,6.0,0,3,4,4,11,0xb2d20add
203081.13,2.0,208,3,3,1,7,0xb2d63e93
201438.21,2.0,68,3,3,1,7,0xb2d6321c
19.83,1.0,3,1,2,4,7,0xb2d9228e
307658.17,4.0,13,4,4,3,11,0xb2da1692
1500089.44,2.0,98,4,3,1,8,0xb2d5417c
20262.42,3.0,77,2,4,1,7,0xb2d5e765d
14088.06,1.0,25,2,2,2,6,0xb2d3b64d
169000.0,7.0,6,3,4,3,10,0xb2d3aa70d
30310.23,4.0,4,2,4,4,10,0xb2d13d19
692.79,1.0,21,1,2,2,5,0xb2d1dc9a
2925.27,1.0,184,2,2,1,5,0xb2d3f6fbd
302131.5,2.0,61,4,3,2,9,0xb2d9bfdc
175.03,1.0,69,1,2,1,4,0xb2d1b1a4
181922.29,2.0,235,3,3,1,7,0xb2d0e428
48.15,1.0,1,1,2,4,7,0xb2d6c2a7
179810.17,4.0,97,3,4,1,8,0xb2d08511
101853.21,3.0,70,3,4,1,8,0xb2d5c51c
30580.44,4.0,9,2,4,3,9,0xb2d537a1d
3178.12,1.0,8,2,2,3,7,0xb2d0bb38d
420054.54,6.0,111,4,4,1,9,0xb2d07ad3d
1.15,1.0,23,1,2,2,5,0xb2d6222f
384726.65,1.0,8,4,2,3,9,0xb2d21164d
100005.28,2.0,27,3,3,2,8,0xb2d93ccbd
6657077.55,3.0,5,4,4,3,11,0xb2d21263
103.96,1.0,0,1,2,4,7,0xb2d2e4f6
30001.27,2.0,94,2,3,1,6,0xb2d858b0
8498.87,1.0,9,2,2,3,7,0xb2d2d2c7d
1211.21,1.0,184,1,2,1,4,0xb2d17808
230076.73,2.0,69,3,3,1,7,0xb2d48ba3
1867.46,1.0,1,1,2,4,7,0x3b9b4111
2381.84,1.0,0,1,2,4,7,0xb2d3958e
542.11,1.0,10,1,2,3,6,0xb2d48196
86.77,1.0,14,1,2,3,6,0xb2d22537
1253.68,3.0,71,1,4,1,6,0x3b9b11bb
50001.06,2.0,18,2,3,2,7,0xb2d94bd5
225.38,1.0,75,1,2,1,4,0xb2d3b398d
13209.65,1.0,7,2,2,3,7,0xb2d99c9c
1212557.15,7.0,11,4,4,3,11,0xb2d41274d
422929.34,5.0,29,4,4,2,10,0xb2d6c821d
450002.74,3.0,11,4,4,3,11,0xb2d9d65e
57.42,1.0,92,1,2,1,4,0xb2d23042d
51.15,1.0,0,1,2,4,7,0xb2d0b786
1136.09,1.0,184,1,2,1,4,0xb2d29b16
7284.0,1.0,14,2,2,3,7,0xb2d2a37e
77185.54,4.0,109,3,4,1,8,0xb2d5c5d2
30000.32,2.0,76,2,3,1,6,0xb2d8a795d
100002.11,2.0,80,3,3,1,7,0xb2d98e19
18739.35,1.0,4,2,2,4,8,0xb2d69417d
210231.34,4.0,0,3,4,4,11,0x3b9b3f45d
1586.92,1.0,4,1,2,4,7,0xb2d7803c
742.81,1.0,25,1,2,2,5,0xb2d21b1a
31344.9,4.0,6,2,4,3,9,0xb2d2b13b
10067.71,1.0,19,2,2,2,6,0xb2d5a88cd
112.5,1.0,10,1,2,3,6,0xb2d54c49d
0.0,1.0,5,1,2,3,6,0xb2d1c969
18475.03,1.0,0,2,2,4,8,0xb2d6bf01
66816.38,1.0,20,3,2,2,7,0xb2d35520d
595377.56,2.0,120,4,3,1,8,0xb2d41180
36432.84,1.0,0,2,2,4,8,0xb2d3b824
326048.38,5.0,39,4,4,2,10,0x3b9b1329d
40190.31,1.0,156,2,2,1,5,0xb2d3296fd
3.46,1.0,110,1,2,1,4,0xb2d953a4d
300000.0,2.0,6,3,3,3,9,0xb2d97229d
2553.44,1.0,0,1,2,4,7,0xb2d8ff3c
352867.23,3.0,9,4,4,3,11,0xb2d2e5b3
900000.0,2.0,6,4,3,3,10,0xb2d57eefd
1608.32,1.0,92,1,2,1,4,0xb2d33245d
251224.73,5.0,9,3,4,3,10,0xb2d49d53
655000.1,4.0,1,4,4,4,12,0xb2d174a9
20991.39,1.0,16,2,2,2,6,0xb2d5b9fe
470078.26,3.0,95,4,4,1,9,0xb2d2567e
4017.39,1.0,6,2,2,3,7,0xb2d90511d
101790.22,2.0,116,3,3,1,7,0xb2d5dd41
94.06,1.0,116,1,2,1,4,0xb2d4a93dd
1.65,1.0,74,1,2,1,4,0xb2d2381fd
2671445.56,10.0,0,4,4,4,12,0xb2d156f4d
2187.92,1.0,8,1,2,3,6,0xb2d40872d
121927.69,2.0,73,3,3,1,7,0xb2d5d103
40301.59,2.0,210,2,3,1,6,0xb2d7814c
13608.44,1.0,98,2,2,1,5,0xb2d3a269d
10147.35,1.0,184,2,2,1,5,0xb2d5e55f
109119.32,1.0,99,3,2,1,6,0xb2d2cde3d
35.6,1.0,11,1,2,3,6,0xb2d22fbf
2799.5,1.0,92,1,2,1,4,0xb2d44d17d
275579.14,1.0,3,3,2,4,9,0xb2d2a3e5d
45000.95,3.0,60,2,4,2,8,0xb2d98d8e
0.14,1.0,14,1,2,3,6,0xb2d67e97d
19.27,1.0,23,1,2,2,5,0xb2d0d9b4d
10000.11,2.0,90,2,3,1,6,0xb2d8c382
200008.44,2.0,32,3,3,2,8,0xb2d9f6ba
9181.2,1.0,27,2,2,2,6,0xb2d359ed
51628.51,1.0,92,2,2,1,5,0xb2d2e4e2
73852.72,2.0,9,3,3,3,9,0xb2d6a813
1953.37,1.0,184,1,2,1,4,0xb2d282a5d
350000.61,7.0,0,4,4,4,12,0xb2d65af3
201321.76,5.0,82,3,4,1,8,0xb2d69fec
6500.14,1.0,0,2,2,4,8,0xb2d5a610
76.12,1.0,78,1,2,1,4,0xb2d56fbcd
262775.64,5.0,5,3,4,3,10,0xb2d27e62
665352.78,5.0,11,4,4,3,11,0xb2d0c12d
8.85,1.0,75,1,2,1,4,0xb2d5a768
198.48,1.0,19,1,2,2,5,0xb2d2fa46
1020608.09,2.0,0,4,3,4,11,0xb2d50a04
12826.98,1.0,9,2,2,3,7,0xb2d5d82fd
641415.59,4.0,4,4,4,4,12,0xb2d17724d
13440.94,5.0,42,2,4,2,8,0xb2d2868cd
2207.0,1.0,0,1,2,4,7,0xb2d5a7c7d
3901.67,1.0,92,2,2,1,5,0xb2d433c5
946.36,1.0,8,1,2,3,6,0xb2d40005
38.27,1.0,64,1,2,2,5,0xb2d1279e
50041.72,2.0,48,2,3,2,7,0xb2d32f82d
2769.36,1.0,10,1,2,3,6,0xb2d65eae
251000.12,2.0,20,3,3,2,8,0xb2d950bf
9760.1,1.0,0,2,2,4,8,0xb2d107cdd
81.54,1.0,12,1,2,3,6,0xb2d30e8b
1270049.76,4.0,6,4,4,3,11,0xb2d60969d
280221.35,3.0,6,3,4,3,10,0xb2d637cb
132081.86,8.0,28,3,4,2,9,0xb2d5ae00
24.06,1.0,15,1,2,3,6,0xb2d8ff43
1200017.71,5.0,102,4,4,1,9,0xb2d609c5
4731.15,1.0,0,2,2,4,8,0xb2d6b7d3
2508987.06,5.0,7,4,4,3,11,0xb2d62279
817106.91,8.0,62,4,4,2,10,0xb2d504e1
230003.86,8.0,0,3,4,4,11,0xb2d69eb4d
200013.3,6.0,55,3,4,2,9,0xb2d41392
1704.09,1.0,6,1,2,3,6,0xb2d2c2dc
4174.15,1.0,35,2,2,2,6,0xb2d2a79d
608.19,1.0,0,1,2,4,7,0xb2d223e7
30427.0,1.0,2,2,2,4,8,0xb2d488c0
4920342.42,3.0,0,4,4,4,12,0xb2d183c2d
2.11,1.0,126,1,2,1,4,0xb2d92f08d
1850247.54,6.0,1,4,4,4,12,0xb2d11030
136.59,1.0,9,1,2,3,6,0xb2d8f839
10000.11,2.0,105,2,3,1,6,0xb2d95d42
1081859.9,7.0,11,4,4,3,11,0xb2d5af0d
1383209.79,8.0,8,4,4,3,11,0xb2d67ed7
2942.58,1.0,0,2,2,4,8,0xb2d21918d
52999.43,2.0,118,3,3,1,7,0xb2d42078
7496.03,1.0,92,2,2,1,5,0xb2d3a4e3
10001.61,2.0,43,2,3,2,7,0xb2d307f7
24166.04,3.0,34,2,4,2,8,0x3b9b2e86d
7646.51,1.0,29,2,2,2,6,0xb2d91b81
72007.74,3.0,4,3,4,4,11,0xb2d58eeb
168073.42,3.0,1,3,4,4,11,0xb2d2ea32
22790.9,3.0,1,2,4,4,10,0xb2d0da98
163477.31,5.0,0,3,4,4,11,0xb2d667db
190055.94,2.0,11,3,3,3,9,0xb2d41252
844035.53,4.0,1,4,4,4,12,0xb2d94dba
2030.61,1.0,184,1,2,1,4,0xb2d0b6b4
3095.0,1.0,9,2,2,3,7,0xb2d48885d
41000.0,2.0,3,2,3,4,9,0xb2d60332
5494.74,1.0,9,2,2,3,7,0xb2d53dd9
260060.68,3.0,1,3,4,4,11,0xb2d6860bd
1406060.26,1.0,14,4,2,3,9,0xb2d28545d
66.55,1.0,9,1,2,3,6,0xb2d5b41c
1141582.94,7.0,67,4,4,1,9,0xb2d27a4b
705875.68,10.0,0,4,4,4,12,0xb2d0648b
48001.26,5.0,27,2,4,2,8,0xb2d5be4e
913025.36,6.0,108,4,4,1,9,0xb2d56fa8
3.31,1.0,20,1,2,2,5,0xb2d6fc35d
25989.9,1.0,20,2,2,2,6,0xb2d08e0ed
67003.52,3.0,10,3,4,3,10,0xb2d87e63
108013.73,3.0,28,3,4,2,9,0xb2d8fb3bd
1473.62,1.0,0,1,2,4,7,0xb2d6acfe
1815.22,1.0,9,1,2,3,6,0xb2d78b7d
88.28,1.0,0,1,2,4,7,0xb2d30441
21.49,1.0,20,1,2,2,5,0xb2d387a9
475263.38,3.0,62,4,4,2,10,0xb2d06c62d
80282.25,3.0,9,3,4,3,10,0xb2d210f2d
12520.28,1.0,90,2,2,1,5,0xb2d8e0b3d
197286.68,3.0,2,3,4,4,11,0xb2d58391d
295.72,1.0,184,1,2,1,4,0xb2d29bf5d
7074.24,1.0,184,2,2,1,5,0xb2d2b326d
47.68,1.0,14,1,2,3,6,0xb2d9976c
751804.59,3.0,41,4,4,2,10,0xb2d162f8
200002.11,2.0,49,3,3,2,8,0xb2d9d4db
5037.27,2.0,222,2,3,1,6,0xb2d45aa5
519502.88,2.0,6,4,3,3,10,0xb2d581b0
556176.37,3.0,6,4,4,3,11,0xb2d1ca4e
42179.35,1.0,302,2,2,1,5,0xb2d303e9
866000.0,3.0,2,4,4,4,12,0xb2d5db5bd
501628.84,5.0,25,4,4,2,10,0xb2d4fdd9d
4187.3,1.0,3,2,2,4,8,0xb2d6dbae
222334.49,3.0,6,3,4,3,10,0xb2d1811fd
220942.98,4.0,8,3,4,3,10,0xb2d13040d
113756.81,1.0,75,3,2,1,6,0xb2d5a95d
6235.56,1.0,26,2,2,2,6,0xb2d5e53bd
2977.09,1.0,0,2,2,4,8,0xb2d28c5a
43175.92,1.0,0,2,2,4,8,0xb2d64fee
390023.06,5.0,1,4,4,4,12,0xb2d91aba
100002.11,2.0,31,3,3,2,8,0xb2d9383f
500152.16,2.0,20,4,3,2,9,0xb2d8d6ae
108.34,1.0,44,1,2,2,5,0xb2d3ba5d
110050.63,8.0,55,3,4,2,9,0xb2d0d706d
1083.46,1.0,10,1,2,3,6,0xb2d412c3
2736.49,1.0,11,1,2,3,6,0xb2d7f155d
25107.56,1.0,13,2,2,3,7,0xb2d3321e
135.57,1.0,35,1,2,2,5,0xb2d6b844
591309.53,53.0,0,4,4,4,12,0xb2d0f345
721888.35,4.0,0,4,4,4,12,0xb2d59cadd
320474.42,7.0,4,4,4,4,12,0xb2d3e517
5404.78,1.0,1,2,2,4,8,0xb2d7554fd
52030.55,2.0,217,2,3,1,6,0xb2d55cf0
261343.88,2.0,189,3,3,1,7,0xb2d0e20b
481225.34,2.0,71,4,3,1,8,0xb2d0a4dbd
66896.98,1.0,92,3,2,1,6,0xb2d250fdd
1915.22,1.0,197,1,2,1,4,0xb2d6b8a8
170627.77,3.0,6,3,4,3,10,0xb2d39c1e
420291.41,3.0,20,4,4,2,10,0xb2d149d0
301119.45,1.0,2,4,2,4,10,0xb2d280bcd
270010.51,3.0,66,3,4,2,9,0xb2d33c32d
300001.7,2.0,13,3,3,3,9,0xb2d615ce
147000.01,7.0,1,3,4,4,11,0xb2d08e25
4726.36,1.0,12,2,2,3,7,0xb2d8df35
2383.77,1.0,12,1,2,3,6,0xb2d91eea
1308.94,1.0,0,1,2,4,7,0xb2d323dfd
7250.86,1.0,20,2,2,2,6,0xb2d1f23cd
120095.82,2.0,143,3,3,1,7,0xb2d62616
40002.11,2.0,20,2,3,2,7,0xb2da1b3f
222734.8,3.0,41,3,4,2,9,0xb2d13e86
2109.37,1.0,40,1,2,2,5,0xb2d5109ed
23820.36,1.0,232,2,2,1,5,0xb2d48f97d
912474.22,4.0,21,4,4,2,10,0xb2d16c52
152042.18,2.0,4,3,3,4,10,0xb2d6275c
1560001.35,11.0,12,4,4,3,11,0xb2d5cb4cd
6.7,1.0,49,1,2,2,5,0xb2d9a965
53903.12,1.0,16,3,2,2,7,0xb2d4358cd
1227.63,1.0,9,1,2,3,6,0xb2d57a73d
490401.68,5.0,17,4,4,2,10,0xb2d0e3d4d
51462.06,2.0,175,2,3,1,6,0xb2d54848d
101977.64,2.0,0,3,3,4,10,0xb2d1d3ee
37753.34,3.0,20,2,4,2,8,0xb2d5c807
60090.59,2.0,66,3,3,2,8,0xb2d6cac3d
44.5,1.0,67,1,2,1,4,0xb2d45275d
3846.94,1.0,150,2,2,1,5,0xb2d2ae63d
50287.79,1.0,184,2,2,1,5,0xb2d352a6d
581927.97,2.0,95,4,3,1,8,0xb2d1c6e3d
5462.32,1.0,49,2,2,2,6,0xb2d3146fd
1.59,1.0,20,1,2,2,5,0xb2d0e2f2
3337.64,1.0,14,2,2,3,7,0xb2d5d216
100856.94,4.0,0,3,4,4,11,0xb2d14c30
1167107.52,6.0,11,4,4,3,11,0xb2d5c932
263057.49,3.0,0,3,4,4,11,0xb2d34d84
608745.57,3.0,4,4,4,4,12,0xb2d3f89ed
12.76,1.0,13,1,2,3,6,0xb2d410ea
252865.72,2.0,82,3,3,1,7,0xb2d950bfd
500000.0,2.0,0,4,3,4,11,0xb2d9846c
10300.44,1.0,95,2,2,1,5,0xb2d65365
5539.78,1.0,92,2,2,1,5,0xb2d345ced
15073.93,1.0,7,2,2,3,7,0xb2d62da6d
304304.35,6.0,3,4,4,4,12,0x3b9b1b78d
630.65,1.0,1,1,2,4,7,0xb2d49041
615053.11,4.0,29,4,4,2,10,0xb2d0842fd
1023191.89,7.0,2,4,4,4,12,0xb2d3c973d
568.58,1.0,15,1,2,3,6,0xb2d503c9
240012.31,5.0,6,3,4,3,10,0xb2d9e1f2
130000.0,5.0,7,3,4,3,10,0xb2d4e5ed
1131872.87,8.0,25,4,4,2,10,0xb2d0a6e2
300000.0,2.0,3,3,3,4,10,0xb2d970ebd
570188.57,2.0,147,4,3,1,8,0xb2d47f5bd
430004.64,9.0,15,4,4,3,11,0xb2d1b79b
471210.74,5.0,18,4,4,2,10,0xb2d69527
582453.68,4.0,186,4,4,1,9,0xb2d0f9f8
655981.86,4.0,52,4,4,2,10,0xb2d10fced
669711.2,2.0,0,4,3,4,11,0xb2d2b9cc
600046.41,3.0,20,4,4,2,10,0xb2d1a9aed
980051.33,7.0,1,4,4,4,12,0xb2d54b22
20227.0,1.0,10,2,2,3,7,0xb2d5ce24
712.45,1.0,14,1,2,3,6,0xb2d2375e
1193465.03,15.0,0,4,4,4,12,0xb2d1c22a
1220.93,1.0,184,1,2,1,4,0xb2d42dfb
742789.66,4.0,24,4,4,2,10,0xb2d390c4d
900028.5,1.0,12,4,2,3,9,0xb2d95e8fd
1400.0,1.0,0,1,2,4,7,0xb2d9537fd
312.98,2.0,30,1,3,2,6,0xb2d349d2
31171.87,1.0,29,2,2,2,6,0xb2d6c4f8d
306400.08,2.0,58,4,3,2,9,0xb2d783e6d
10028.14,2.0,28,2,3,2,7,0xb2d3a2aa
41466806.98,5.0,11,4,4,3,11,0xb2d29c29
601422.65,4.0,11,4,4,3,11,0xb2d6696dd
7068.97,1.0,0,2,2,4,8,0xb2d4a6c2d
1.03,1.0,22,1,2,2,5,0xb2d5e18e
301068.32,2.0,20,4,3,2,9,0xb2d90884d
120024.27,4.0,1,3,4,4,11,0xb2d2fb61
190007.08,4.0,80,3,4,1,8,0xb2d63e96
1768.3,2.0,175,1,3,1,5,0xb2d224bcd
11061.21,1.0,160,2,2,1,5,0xb2d587b8
0.22,1.0,9,1,2,3,6,0xb2d9fb8a
203607.32,3.0,68,3,4,1,8,0xb2d6c2afd
512294.54,4.0,16,4,4,2,10,0xb2d18239
20693.95,1.0,39,2,2,2,6,0xb2d6359fd
60317.42,2.0,4,3,3,4,10,0xb2d467fcd
224206.8,2.0,1,3,3,4,10,0xb2d15465
503919.06,2.0,11,4,3,3,10,0xb2d56237d
1744.73,1.0,0,1,2,4,7,0xb2d39528
0.0,1.0,5,1,2,3,6,0xb2d756d0
20.93,2.0,27,1,3,2,6,0xb2d222f6
4694.55,1.0,10,2,2,3,7,0xb2d5ffa2d
134.63,1.0,3,1,2,4,7,0xb2d261f8
23385.19,2.0,123,2,3,1,6,0xb2d569b9
7048.74,1.0,2,2,2,4,8,0xb2d5cf58
1686.32,1.0,184,1,2,1,4,0xb2d27f8c
291303.82,2.0,214,3,3,1,7,0xb2d16140
7317.16,1.0,11,2,2,3,7,0xb2d9bd0c
86.5,1.0,41,1,2,2,5,0xb2d26f92
36333.66,1.0,1,2,2,4,8,0xb2d2d4c6
1.0,2.0,20,1,3,2,6,0xb2d9528c
130496.73,3.0,96,3,4,1,8,0xb2d68109d
1110691.01,4.0,17,4,4,2,10,0xb2d5ea8fd
245303.4,3.0,171,3,4,1,8,0x3b9b10a2d
503553.13,3.0,22,4,4,2,10,0xb2d8d318
50899.98,2.0,104,2,3,1,6,0xb2d46634
10080.4,1.0,0,2,2,4,8,0xb2d1be4d
70001.33,4.0,10,3,4,3,10,0xb2d96437d
49256.98,2.0,97,2,3,1,6,0xb2d60143
673493.42,2.0,77,4,3,1,8,0xb2d41caa
4777.21,1.0,19,2,2,2,6,0xb2d2010d
100004.22,2.0,209,3,3,1,7,0xb2d68966
7233.54,1.0,0,2,2,4,8,0xb2d6e871d
2.78,1.0,10,1,2,3,6,0xb2d96327
14520.59,1.0,14,2,2,3,7,0xb2d32c0b
1500046.98,2.0,1,4,3,4,11,0xb2d6b27cd
68.9,1.0,60,1,2,2,5,0xb2d50945
282214.16,4.0,123,3,4,1,8,0xb2d6229f
309604.05,2.0,295,4,3,1,8,0xb2d693b8d
1909.7,1.0,152,1,2,1,4,0xb2d5dd0cd
670.83,1.0,8,1,2,3,6,0xb2d7b057
7259.39,1.0,15,2,2,3,7,0xb2d945f7
155051.08,4.0,90,3,4,1,8,0xb2d39f37d
3050.81,1.0,16,2,2,2,6,0xb2d23f22
220000.0,2.0,0,3,3,4,10,0xb2d983fa
101305.44,2.0,210,3,3,1,7,0xb2d29de4
80873.53,1.0,0,3,2,4,9,0xb2d63b2cd
500000.0,2.0,92,4,3,1,8,0xb2d53fbcd
250631.4,3.0,19,3,4,2,9,0xb2d0d4d1
300096.94,2.0,92,3,3,1,7,0xb2d5bfc3
1135482.09,5.0,14,4,4,3,11,0xb2d31cbfd
304860.2,7.0,6,4,4,3,11,0x3b9b31c4d
700000.0,1.0,1,4,2,4,10,0xb2da6679
442224.23,6.0,0,4,4,4,12,0x3b9af1fed
14.44,4.0,94,1,4,1,6,0xb2d43e2d
5054.58,1.0,92,2,2,1,5,0xb2d2843d
199.77,1.0,4,1,2,4,7,0xb2d58512
236005.84,5.0,97,3,4,1,8,0xb2d0cd56
26.98,1.0,63,1,2,2,5,0xb2d5e08ed
1255047.83,6.0,10,4,4,3,11,0xb2d3d519
1806.97,1.0,4,1,2,4,7,0xb2d54fc4
289519.07,4.0,77,3,4,1,8,0xb2d2ba15
580.17,1.0,1,1,2,4,7,0xb2d64e6a
465.95,1.0,10,1,2,3,6,0xb2d6bbfc
50837.28,1.0,1,2,2,4,8,0xb2d382b1
283573.0,5.0,0,3,4,4,11,0x3b9b45dad
1086.45,1.0,7,1,2,3,6,0xb2d91b41
43575.17,1.0,4,2,2,4,8,0xb2d28e21
41701.14,1.0,14,2,2,3,7,0xb2d5b747
1319.58,2.0,184,1,3,1,5,0xb2d0e6a8d
1568818.36,17.0,15,4,4,3,11,0xb2d067af
110478.02,2.0,46,3,3,2,8,0xb2d1cea4
50182.27,1.0,12,2,2,3,7,0xb2d31050
13190.59,1.0,30,2,2,2,6,0xb2d69b75
4604.18,1.0,18,2,2,2,6,0xb2d2abb4
0.0,2.0,1,1,3,4,8,0xb2d1cc3e
1015.1,1.0,92,1,2,1,4,0xb2d1169cd
509065.67,3.0,8,4,4,3,11,0xb2d5ac6b
746141.54,5.0,34,4,4,2,10,0x3b9b2d84
3451409.29,6.0,0,4,4,4,12,0xb2d33fd0d
1202.36,1.0,39,1,2,2,5,0xb2d55e3ed
66188.27,1.0,92,3,2,1,6,0xb2d62aa2d
1848.91,1.0,10,1,2,3,6,0xb2d8d38f
65605.86,1.0,39,3,2,2,7,0xb2d38d68
289417.18,5.0,0,3,4,4,11,0x3b9b2972d
21431.07,1.0,7,2,2,3,7,0xb2d8c4cf
6805.34,1.0,184,2,2,1,5,0xb2d29380d
2303423.29,5.0,1,4,4,4,12,0xb2d63027d
46220.11,1.0,41,2,2,2,6,0xb2d63594
300070.13,2.0,5,3,3,3,9,0xb2d9b3ae
2610.19,1.0,50,1,2,2,5,0xb2d6d053
1348.66,1.0,9,1,2,3,6,0xb2d69f35d
55139.39,3.0,1,3,4,4,11,0xb2d0f46f
268059.13,9.0,4,3,4,4,11,0xb2d1b261
200704.77,4.0,29,3,4,2,9,0xb2d91fe2d
7566.14,1.0,69,2,2,1,5,0xb2d68656d
104060.56,2.0,92,3,3,1,7,0xb2d43a75d
990666.84,7.0,0,4,4,4,12,0xb2d0eeb2
228102.32,5.0,4,3,4,4,11,0x3b9af179
2000094.46,4.0,10,4,4,3,11,0xb2d24d51
560000.0,2.0,67,4,3,1,8,0xb2d9a746
7378.62,1.0,1,2,2,4,8,0x3b9b481ed
644160.69,7.0,4,4,4,4,12,0xb2d0e629
839.36,1.0,40,1,2,2,5,0xb2d8d59cd
60506.8,3.0,80,3,4,1,8,0xb2d641a5
1488.87,1.0,10,1,2,3,6,0xb2d40391
4.75,1.0,56,1,2,2,5,0xb2d9b4a6
2735.62,1.0,2,1,2,4,7,0xb2d6b699
473317.76,5.0,1,4,4,4,12,0xb2d0c825d
210027.47,3.0,18,3,4,2,9,0xb2d985cd
430045.87,3.0,4,4,4,4,12,0xb2d8ff24d
9.86,1.0,6,1,2,3,6,0xb2d59028d
4364.51,7.0,224,2,4,1,7,0x3b9ae857d
4639.52,3.0,35,2,4,2,8,0xb2d64592
311516.91,5.0,74,4,4,1,9,0xb2d0771dd
13807.5,1.0,184,2,2,1,5,0xb2d10137d
11623.97,1.0,139,2,2,1,5,0xb2d353bb
301000.0,2.0,5,4,3,3,10,0xb2da2a12
100012.32,2.0,172,3,3,1,7,0xb2d51179d
795.1,1.0,0,1,2,4,7,0xb2d13330d
9958.12,1.0,3,2,2,4,8,0xb2d1998d
26005.11,3.0,13,2,4,3,9,0xb2d70028d
6935.76,1.0,36,2,2,2,6,0xb2d1bf90d
58.55,1.0,35,1,2,2,5,0xb2d67ea4
1157.81,1.0,206,1,2,1,4,0xb2d617ef
50000.0,2.0,3,2,3,4,9,0xb2d977e3
1651.76,1.0,184,1,2,1,4,0xb2d0e57cd
123000.22,2.0,0,3,3,4,10,0xb2d23f57
1000053.84,3.0,13,4,4,3,11,0xb2d9b58c
19685.74,1.0,184,2,2,1,5,0xb2d09786
11814.93,5.0,308,2,4,1,7,0xb2d559fed
1731.4,1.0,0,1,2,4,7,0xb2d2e892d
128.21,1.0,27,1,2,2,5,0xb2d1efb7
584354.11,9.0,0,4,4,4,12,0x3b9af0f9
1010854.63,6.0,5,4,4,3,11,0xb2d57de1d
65001.52,2.0,18,3,3,2,8,0xb2d909a1
303198.51,2.0,27,4,3,2,9,0xb2d784fad
619972.47,4.0,14,4,4,3,11,0xb2d1a445
305.0,1.0,9,1,2,3,6,0xb2d43c70
41763.56,1.0,22,2,2,2,6,0xb2d0cdcc
5.58,1.0,3,1,2,4,7,0xb2d5e993
1064000.18,5.0,15,4,4,3,11,0xb2d458bbd
62159.72,1.0,0,3,2,4,9,0xb2d54ec7d
657532.88,2.0,136,4,3,1,8,0xb2d57f2b
734.58,1.0,10,1,2,3,6,0xb2d5f9ded
50002.95,4.0,13,2,4,3,9,0xb2d68979
1503952.72,7.0,0,4,4,4,12,0xb2d7e090
1409.46,1.0,184,1,2,1,4,0xb2d25501
2063.27,1.0,9,1,2,3,6,0xb2d517c4d
150663.2,2.0,38,3,3,2,8,0xb2d61108d
475.95,1.0,41,1,2,2,5,0xb2d5faea
105054.1,5.0,69,3,4,1,8,0xb2d14e0bd
200031.56,2.0,11,3,3,3,9,0xb2d6daadd
3798.67,1.0,14,2,2,3,7,0xb2d1d286
1.37,1.0,49,1,2,2,5,0xb2d9c3a0
50017.23,2.0,101,2,3,1,6,0xb2d6b2a1
754078.41,10.0,0,4,4,4,12,0x3b9b2711
16.89,1.0,14,1,2,3,6,0xb2d69a64
370296.05,2.0,95,4,3,1,8,0xb2d15565
134002.57,3.0,18,3,4,2,9,0xb2d6cb3c
800099.56,7.0,87,4,4,1,9,0xb2d0afda
31012.0,9.0,52,2,4,2,8,0xb2d227bfd
10000.0,1.0,2,2,2,4,8,0xb2d2886a
1191.93,1.0,5,1,2,3,6,0xb2d6db03
30041.93,4.0,2,2,4,4,10,0xb2d36078
428008.98,22.0,32,4,4,2,10,0xb2d15bd2
174095.52,3.0,6,3,4,3,10,0xb2d5915f
3536.09,1.0,112,2,2,1,5,0xb2d1e15f
887000.0,6.0,7,4,4,3,11,0xb2d15614
1390.61,1.0,2,1,2,4,7,0xb2d1e875
236697.74,1.0,3,3,2,4,9,0xb2d653c8d
20197.27,3.0,67,2,4,1,7,0xb2d64a80
158092.78,8.0,14,3,4,3,10,0xb2d1957f
1046.43,1.0,184,1,2,1,4,0xb2d213d4d
300138.75,3.0,25,4,4,2,10,0xb2d6ea4a
470129.28,2.0,39,4,3,2,9,0xb2d3b4fd
1342.84,1.0,0,1,2,4,7,0xb2d91349
20000.0,2.0,4,2,3,4,9,0xb2da54b4
6145.31,1.0,184,2,2,1,5,0xb2d0ce83d
13569.04,1.0,31,2,2,2,6,0xb2d408f2
100003.17,2.0,24,3,3,2,8,0xb2d94634
3144.52,7.0,0,2,4,4,10,0xb2d0787c
180000.0,2.0,4,3,3,4,10,0xb2da5983
23.59,1.0,8,1,2,3,6,0xb2d9801cd
360000.0,2.0,21,4,3,2,9,0xb2da27e7
109620.38,1.0,4,3,2,4,9,0xb2d64210d
506.07,1.0,3,1,2,4,7,0xb2d1cf37
69.08,1.0,7,1,2,3,6,0xb2d49535
22061.8,1.0,0,2,2,4,8,0xb2d6476a
46.13,1.0,67,1,2,1,4,0xb2d99104
224185.31,4.0,3,3,4,4,11,0xb2d5b022
92605.97,4.0,6,3,4,3,10,0xb2d9910a
372.61,1.0,60,1,2,2,5,0xb2d2280a
3105.31,1.0,0,2,2,4,8,0xb2d601c7d
15135.16,1.0,184,2,2,1,5,0xb2d5c2f4
43935.73,1.0,1,2,2,4,8,0xb2d693dfd
2996.54,2.0,5,2,3,3,8,0xb2d2d47fd
181822.6,3.0,10,3,4,3,10,0xb2d41680d
50029.66,1.0,24,2,2,2,6,0xb2d93b51d
16039.0,1.0,138,2,2,1,5,0xb2d869c1
4392.92,2.0,1,2,3,4,9,0xb2d0bcd9
1680759.24,7.0,4,4,4,4,12,0xb2d5f456
39.48,1.0,6,1,2,3,6,0xb2d685b0
5103.76,1.0,0,2,2,4,8,0xb2d4c080d
509473.45,13.0,0,4,4,4,12,0xb2d6d536
203474.83,3.0,101,3,4,1,8,0xb2d5316ed
300007.35,2.0,4,3,3,4,10,0xb2d92230
122863.88,1.0,184,3,2,1,6,0xb2d4477bd
5000000.0,2.0,8,4,3,3,10,0xb2da50b8
2797.05,1.0,2,1,2,4,7,0xb2d34385
520000.76,4.0,12,4,4,3,11,0xb2d7869b
709090.93,15.0,0,4,4,4,12,0xb2d109b5d
940831.92,8.0,0,4,4,4,12,0xb2d9155cd
200000.0,2.0,0,3,3,4,10,0xb2da6c9d
10291.31,1.0,3,2,2,4,8,0xb2d651ebd
5594.25,1.0,3,2,2,4,8,0xb2d23f7e
102817.4,2.0,18,3,3,2,8,0xb2d52e70
301072.23,2.0,30,4,3,2,9,0xb2d14b1d
50001.06,2.0,18,2,3,2,7,0xb2da2c94
3797.21,1.0,10,2,2,3,7,0xb2d6d571
100207.39,3.0,25,3,4,2,9,0xb2d4f405
400790.89,3.0,8,4,4,3,11,0xb2d6c1ed
1.17,1.0,67,1,2,1,4,0xb2d690acd
860000.0,7.0,9,4,4,3,11,0xb2d24aa1
7712.04,1.0,9,2,2,3,7,0xb2d964dc
53987.69,2.0,6,3,3,3,9,0xb2d155b7
1289.61,1.0,14,1,2,3,6,0xb2d24615
66345.13,1.0,9,3,2,3,8,0xb2d5ea22
1434391.45,6.0,17,4,4,2,10,0xb2d7f4c0
399672.85,3.0,147,4,4,1,9,0xb2d2b13dd
310067.64,3.0,7,4,4,3,11,0xb2d64849
13683.35,1.0,11,2,2,3,7,0xb2d2678d
584587.71,8.0,0,4,4,4,12,0xb2d5ae18d
111042.06,1.0,8,3,2,3,8,0xb2d34828
220934.59,4.0,0,3,4,4,11,0xb2d7f3ba
284.82,1.0,12,1,2,3,6,0xb2d2ba01d
0.0,1.0,3,1,2,4,7,0xb2d8cfbf
250833.82,2.0,70,3,3,1,7,0xb2d673fd
10125.13,1.0,2,2,2,4,8,0xb2d23288d
311002.73,7.0,80,4,4,1,9,0xb2d1721a
34.71,1.0,7,1,2,3,6,0xb2d57cce
70.3,1.0,8,1,2,3,6,0xb2d6be89d
200000.0,2.0,8,3,3,3,9,0xb2d9ad94
67.67,1.0,33,1,2,2,5,0xb2d68f2d
50000.97,1.0,4,2,2,4,8,0xb2d6fe58
20000.42,2.0,59,2,3,2,7,0xb2d58c90d
274149.9,6.0,70,3,4,1,8,0xb2d69269d
70599.11,4.0,0,3,4,4,11,0xb2d067ff
503021.02,5.0,27,4,4,2,10,0xb2d36058
113330.08,4.0,25,3,4,2,9,0xb2d228ba
149979.12,1.0,0,3,2,4,9,0xb2d6215e
1301017.52,14.0,14,4,4,3,11,0xb2d4c5f5d
223318.95,2.0,124,3,3,1,7,0xb2d65c99d
513268.52,7.0,0,4,4,4,12,0xb2d44187
302661.93,2.0,125,4,3,1,8,0xb2d230e8
37751.24,2.0,15,2,3,3,8,0xb2d5e95c
960029.7,8.0,4,4,4,4,12,0xb2d4f48a
361126.87,8.0,4,4,4,4,12,0xb2d5599b
196516.48,1.0,247,3,2,1,6,0xb2d388ccd
300153.75,2.0,16,4,3,2,9,0xb2d6c231
6475.86,1.0,151,2,2,1,5,0xb2d315e5
607251.12,4.0,62,4,4,2,10,0xb2d60be2
345190.21,3.0,144,4,4,1,9,0xb2d3786fd
53652.58,2.0,266,3,3,1,7,0xb2d18613
1455.63,1.0,27,1,2,2,5,0xb2d2e96b
14170.76,1.0,6,2,2,3,7,0xb2d6c222d
130102.9,6.0,24,3,4,2,9,0xb2d4ec90d
150002.65,3.0,144,3,4,1,8,0xb2d4c875d
241930.6,2.0,27,3,3,2,8,0xb2d10311
120233.31,3.0,139,3,4,1,8,0xb2d37c85d
348100.52,4.0,154,4,4,1,9,0xb2d22dd1d
204952.12,6.0,3,3,4,4,11,0xb2d45f2b
1048.36,1.0,0,1,2,4,7,0xb2d8db55d
142425.85,3.0,42,3,4,2,9,0xb2d52af3
500000.0,2.0,8,4,3,3,10,0xb2da4f72
77.45,2.0,81,1,3,1,5,0xb2d11325d
600382.56,3.0,9,4,4,3,11,0xb2d579b1
300000.67,2.0,19,3,3,2,8,0xb2d3a836d
40017.37,3.0,11,2,4,3,9,0xb2d91b83
215094.71,2.0,8,3,3,3,9,0xb2d90b1cd
236019.24,3.0,5,3,4,3,10,0xb2d29420
200012.23,4.0,1,3,4,4,11,0xb2d1fe5c
10062.02,1.0,184,2,2,1,5,0xb2d47dae
1211.79,1.0,184,1,2,1,4,0xb2d28a32
7294.86,1.0,10,2,2,3,7,0xb2d28480d
717.35,1.0,90,1,2,1,4,0xb2d5ac80
2895.12,1.0,15,2,2,3,7,0xb2d7096e
99.86,1.0,10,1,2,3,6,0xb2d41fc5
562401.17,3.0,11,4,4,3,11,0xb2d132c5
343997.03,4.0,39,4,4,2,10,0xb2d919ffd
72.62,1.0,20,1,2,2,5,0xb2d2af79d
1288285.35,10.0,13,4,4,3,11,0xb2d23fe4
0.0,1.0,9,1,2,3,6,0xb2d6ec82
11667.2,1.0,9,2,2,3,7,0xb2d22a38
101277.02,1.0,112,3,2,1,6,0xb2d4cec8
1508.22,1.0,0,1,2,4,7,0xb2d34652
480047.58,5.0,31,4,4,2,10,0xb2d59a8e
501010.81,2.0,31,4,3,2,9,0xb2d6439dd
150075.99,1.0,12,3,2,3,8,0xb2d4356fd
10848.63,1.0,20,2,2,2,6,0xb2d6d555d
722264.23,3.0,29,4,4,2,10,0xb2d8e277
70688.25,2.0,160,3,3,1,7,0xb2d4b8b7
6078.03,1.0,10,2,2,3,7,0xb2d371de
306299.2,5.0,10,4,4,3,11,0xb2d20134
52395.93,1.0,0,3,2,4,9,0xb2d55fc6d
238074.13,5.0,108,3,4,1,8,0x3b9b29cb
50003.47,2.0,8,2,3,3,8,0xb2d0cd49
23.57,3.0,87,1,4,1,6,0xb2d5ed7dd
2533.64,1.0,116,1,2,1,4,0xb2d645c8
11721.81,1.0,5,2,2,3,7,0xb2d8dab3
102734.69,1.0,4,3,2,4,9,0xb2d1647dd
1705.27,1.0,20,1,2,2,5,0xb2d2b913d
108626.07,7.0,22,3,4,2,9,0x3b9add69
1097113.11,6.0,0,4,4,4,12,0x3b9af277
40006.33,2.0,124,2,3,1,6,0xb2d3d22e
655925.56,3.0,0,4,4,4,12,0xb2d13f1b
373010.03,5.0,60,4,4,2,10,0xb2d4ee03d
1022.11,2.0,1,1,3,4,8,0xb2d316fa
200000.0,1.0,0,3,2,4,9,0xb2d982f3
163667.2,2.0,6,3,3,3,9,0xb2d3ac5ad
60000.0,2.0,3,3,3,4,10,0xb2d97ab9
9181.29,1.0,13,2,2,3,7,0xb2d37ff2
20242.64,1.0,63,2,2,2,6,0xb2d60633d
4.79,1.0,31,1,2,2,5,0xb2d69b75d
6.23,1.0,43,1,2,2,5,0xb2d4ff21
54850.81,2.0,4,3,3,4,10,0xb2d9a11e
123.48,1.0,1,1,2,4,7,0xb2d4d4f8
22873.48,2.0,278,2,3,1,6,0xb2d2712bd
700065.07,2.0,11,4,3,3,10,0xb2d1c1dcd
511334.43,2.0,11,4,3,3,10,0xb2d330bfd
16348.55,1.0,15,2,2,3,7,0xb2d8d049d
296000.14,2.0,9,3,3,3,9,0xb2d5b5c9d
161895.72,4.0,94,3,4,1,8,0xb2d58f34
280369.78,2.0,104,3,3,1,7,0xb2d4bcf1
1630.94,1.0,0,1,2,4,7,0xb2d8d4db
162914.03,3.0,55,3,4,2,9,0xb2d60088
215311.82,3.0,6,3,4,3,10,0xb2d24da5d
292075.81,5.0,3,3,4,4,11,0xb2d6123bd
10064.06,2.0,1,2,3,4,9,0xb2d52042
1119.36,1.0,28,1,2,2,5,0xb2d21bf9d
363423.14,4.0,6,4,4,3,11,0xb2d30f9f
2899.74,1.0,0,2,2,4,8,0xb2d4cc46
722.25,1.0,25,1,2,2,5,0xb2d275ba
1252.29,1.0,0,1,2,4,7,0xb2d97c92
590020.22,7.0,34,4,4,2,10,0xb2d3c33d
8363.78,11.0,0,2,4,4,10,0x3b9b25a1
105066.51,2.0,143,3,3,1,7,0xb2d0e9f5d
6218.65,1.0,165,2,2,1,5,0xb2d12379d
20457.93,2.0,175,2,3,1,6,0xb2d5f103d
150011.09,2.0,3,3,3,4,10,0xb2d1b7dbd
410117.01,6.0,11,4,4,3,11,0xb2d439a6
2303353.87,4.0,0,4,4,4,12,0xb2d068fed
3.08,1.0,20,1,2,2,5,0xb2d3106a
10200.34,1.0,92,2,2,1,5,0xb2d564bf
3114.72,1.0,32,2,2,2,6,0xb2d9d334
56653.56,2.0,214,3,3,1,7,0xb2d39661d
53.16,1.0,22,1,2,2,5,0xb2d5482b
100082.96,2.0,1,3,3,4,10,0xb2d2adc2
2423.78,1.0,273,1,2,1,4,0xb2d4eab1d
61841.46,3.0,182,3,4,1,8,0xb2d57b7d
200710.54,2.0,56,3,3,2,8,0xb2d9c7cd
512906.9,1.0,0,4,2,4,10,0xb2d2df0b
3066.39,1.0,92,2,2,1,5,0xb2d2d8b5d
100043.95,2.0,186,3,3,1,7,0xb2d1ea6cd
440111.61,10.0,0,4,4,4,12,0xb2d1b51fd
13043.95,2.0,18,2,3,2,7,0xb2d1a0b2
200008.44,2.0,62,3,3,2,8,0xb2d8f62e
1000000.0,2.0,27,4,3,2,9,0xb2d93f5bd
5052.53,1.0,166,2,2,1,5,0xb2d292fe
20100.5,2.0,4,2,3,4,9,0xb2d9fdd8
7759.21,1.0,10,2,2,3,7,0xb2d6c4c3
507107.45,2.0,129,4,3,1,8,0xb2d71845
1360.31,2.0,9,1,3,3,7,0xb2d80304
4348.27,1.0,92,2,2,1,5,0xb2d3af50
141161.35,4.0,0,3,4,4,11,0xb2d60dc8
1874.09,1.0,9,1,2,3,6,0xb2d6c153d
320000.0,1.0,0,4,2,4,10,0xb2da6aad
59.24,1.0,15,1,2,3,6,0xb2d307f7d
300001.37,2.0,18,3,3,2,8,0xb2d68b34
5.32,1.0,10,1,2,3,6,0xb2d479cf
19.46,1.0,9,1,2,3,6,0xb2d2c0de
103267.99,2.0,136,3,3,1,7,0xb2d41ced
7564.63,2.0,0,2,3,4,9,0xb2d31855
40188.0,1.0,0,2,2,4,8,0xb2d11ac2d
214223.68,3.0,80,3,4,1,8,0xb2d1a8dcd
181712.39,1.0,180,3,2,1,6,0xb2d267b8
77219.66,1.0,92,3,2,1,6,0xb2d6294ed
926039.41,6.0,10,4,4,3,11,0xb2d145cf
522928.65,6.0,0,4,4,4,12,0xb2d90fdfd
201423.24,2.0,17,3,3,2,8,0xb2d62443
1719068.0,4.0,6,4,4,3,11,0xb2d5041bd
291004.74,6.0,11,3,4,3,10,0xb2d3868e
160005.07,2.0,92,3,3,1,7,0xb2d97c78d
4836.38,3.0,0,2,4,4,10,0xb2d09c8ad
60004.25,3.0,26,3,4,2,9,0xb2d126cd
310047.13,4.0,5,4,4,3,11,0xb2d170b6
2033.19,1.0,184,1,2,1,4,0xb2d193a9
577924.75,2.0,97,4,3,1,8,0xb2d6aacb
200710.49,2.0,19,3,3,2,8,0xb2d9126b
200710.52,2.0,24,3,3,2,8,0xb2d98fa3
50002.64,2.0,55,2,3,2,7,0xb2d9c272
1401.58,1.0,24,1,2,2,5,0xb2d96c8d
350.37,1.0,15,1,2,3,6,0xb2d248b2
535338.71,3.0,0,4,4,4,12,0xb2d14acbd
250000.02,3.0,4,3,4,4,11,0xb2d93459
200029.05,3.0,11,3,4,3,10,0xb2d4e967
5542.55,2.0,10,2,3,3,8,0x3b9b2be9d
2418.18,1.0,184,1,2,1,4,0xb2d3231dd
1653.73,1.0,10,1,2,3,6,0xb2d42841
142036.08,6.0,11,3,4,3,10,0xb2d12a10
5798.81,1.0,1,2,2,4,8,0xb2d3b4ee
186000.0,9.0,4,3,4,4,11,0xb2d4cc95d
103864.53,3.0,63,3,4,2,9,0xb2d15345d
50077.48,2.0,98,2,3,1,6,0xb2d5774d
17178.98,1.0,110,2,2,1,5,0xb2d4804e
80809.66,3.0,112,3,4,1,8,0xb2d0a7ffd
540617.41,3.0,235,4,4,1,9,0xb2d12167d
2.38,5.0,144,1,4,1,6,0xb2d22f3c
50001.58,2.0,10,2,3,3,8,0xb2d95ff9
81700.81,3.0,129,3,4,1,8,0xb2d57087
115.76,1.0,0,1,2,4,7,0xb2d5d52fd
673.8,1.0,0,1,2,4,7,0xb2d3207d
116.93,1.0,167,1,2,1,4,0xb2d2460b
29160.33,3.0,104,2,4,1,7,0xb2d600a1d
940194.29,3.0,0,4,4,4,12,0xb2d44ade
600165.85,5.0,38,4,4,2,10,0xb2d6cc8f
31.51,1.0,66,1,2,2,5,0xb2d6bce4
0.0,1.0,61,1,2,2,5,0xb2d2a532
32451.81,4.0,184,2,4,1,7,0x3b9acca4
202885.94,2.0,100,3,3,1,7,0xb2d92d9ad
593118.4,36.0,3,4,4,4,12,0xb2d0dc0d
520369.27,8.0,3,4,4,4,12,0xb2d3fa0ad
630067.51,4.0,12,4,4,3,11,0xb2d2f0a9d
106.17,1.0,1,1,2,4,7,0xb2d327fa
50001.58,2.0,92,2,3,1,6,0xb2d28a95
4809.6,1.0,0,2,2,4,8,0xb2d6b8c3d
4.83,1.0,89,1,2,1,4,0xb2d5ada8
296112.73,4.0,14,3,4,3,10,0xb2d3cde7
15.83,1.0,34,1,2,2,5,0xb2d0c895
389.61,1.0,16,1,2,2,5,0xb2d2e6d8d
2500000.0,3.0,5,4,4,3,11,0xb2d9fadb
13152.86,1.0,1,2,2,4,8,0xb2d34051d
19166.97,1.0,16,2,2,2,6,0xb2d277fbd
410436.38,6.0,20,4,4,2,10,0xb2d81647
60000.63,2.0,70,3,3,1,7,0xb2d62f66
14627.65,1.0,7,2,2,3,7,0xb2d6b5ae
651017.51,9.0,10,4,4,3,11,0xb2d06340
106169.78,4.0,79,3,4,1,8,0xb2d2be04d
450100.45,1.0,0,4,2,4,10,0xb2d8ceec
511.43,1.0,9,1,2,3,6,0xb2d541dc
20508.38,1.0,92,2,2,1,5,0xb2d37c43
301075.2,2.0,20,4,3,2,9,0xb2d0edc7
63170.44,1.0,26,3,2,2,7,0xb2d0e8f6
838.17,2.0,3,1,3,4,8,0xb2d07fe3d
1085.31,5.0,92,1,4,1,6,0xb2d15244
30822.01,1.0,117,2,2,1,5,0xb2d51ad0d
429964.81,3.0,33,4,4,2,10,0xb2d3b07dd
6084.08,1.0,2,2,2,4,8,0xb2d68c86d
700763.84,3.0,12,4,4,3,11,0xb2d79020d
3524.96,1.0,10,2,2,3,7,0xb2d68e16
100004.43,2.0,92,3,3,1,7,0xb2d62d28
510027.66,3.0,27,4,4,2,10,0xb2d931b2
22058.6,2.0,80,2,3,1,6,0xb2d5eda2
80714.79,1.0,8,3,2,3,8,0xb2d8c3b7
100069.64,2.0,102,3,3,1,7,0xb2d438e6
2014.56,1.0,0,1,2,4,7,0xb2d5328e
96332.28,5.0,11,3,4,3,10,0xb2d5b37dd
2680207.8,10.0,41,4,4,2,10,0xb2d10a3c
45661.36,3.0,3,2,4,4,10,0xb2d247ae
41633.23,1.0,0,2,2,4,8,0xb2d43c50
9386.12,1.0,2,2,2,4,8,0xb2d0b59b
1123.0,1.0,4,1,2,4,7,0xb2d6c643d
9.49,1.0,1,1,2,4,7,0xb2da1c06
106566.57,1.0,92,3,2,1,6,0xb2d133c3d
4245.17,1.0,92,2,2,1,5,0xb2d298e8d
376062.55,3.0,39,4,4,2,10,0xb2d5e1c1d
718017.49,1.0,0,4,2,4,10,0xb2d4635f
30972.02,1.0,92,2,2,1,5,0xb2d23e5d
63847.58,2.0,11,3,3,3,9,0xb2d352c3
508081.35,6.0,94,4,4,1,9,0xb2d37821d
10002.05,2.0,5,2,3,3,8,0xb2d07c56d
51459.81,2.0,235,2,3,1,6,0xb2d444a6
1906298.66,3.0,41,4,4,2,10,0xb2d24f4ed
1100031.54,5.0,4,4,4,4,12,0xb2d4f965d
200000.0,2.0,18,3,3,2,8,0xb2d95990
277.29,2.0,92,1,3,1,5,0x3b9ade41
798.82,1.0,15,1,2,3,6,0xb2d34c8c
250004.97,2.0,0,3,3,4,10,0xb2d8f5f1
10000.32,2.0,102,2,3,1,6,0xb2d961e1
2427.91,1.0,1,1,2,4,7,0xb2d6bc06
50001.11,2.0,189,2,3,1,6,0xb2d69ed4
82877.19,2.0,41,3,3,2,8,0xb2d57af8d
301065.78,2.0,23,4,3,2,9,0xb2d90e3dd
1374.56,1.0,235,1,2,1,4,0xb2d6901ad
90002.21,4.0,73,3,4,1,8,0xb2d5c539d
800039.66,3.0,18,4,4,2,10,0xb2d40136
35.76,1.0,154,1,2,1,4,0xb2d23269
482554.28,3.0,25,4,4,2,10,0xb2d4f1b5d
54343.25,1.0,10,3,2,3,8,0xb2d96348
10096.05,1.0,92,2,2,1,5,0xb2d219c0d
551715.43,4.0,13,4,4,3,11,0xb2d208cc
400088.11,4.0,0,4,4,4,12,0xb2d21644
7990.02,1.0,2,2,2,4,8,0xb2d6c264d
520001.23,4.0,12,4,4,3,11,0xb2d7869bd
530057.19,2.0,143,4,3,1,8,0xb2d3b9ba
40301.3,2.0,118,2,3,1,6,0xb2d7814cd
3.71,1.0,70,1,2,1,4,0xb2d2979dd
101.39,1.0,89,1,2,1,4,0xb2d6076ad
261930.44,3.0,72,3,4,1,8,0xb2d9a2ba
200000.0,2.0,7,3,3,3,9,0xb2da5441
31125.94,1.0,34,2,2,2,6,0xb2d48fffd
0.0,1.0,1,1,2,4,7,0xb2d97620d
5139.48,1.0,12,2,2,3,7,0xb2d17b94d
1056.88,1.0,11,1,2,3,6,0xb2d57c46
5537392.03,10.0,0,4,4,4,12,0xb2d576a6
152155.4,2.0,52,3,3,2,8,0xb2d696c6
1638.47,1.0,184,1,2,1,4,0xb2d35d40d
563125.29,6.0,4,4,4,4,12,0xb2d5a660
4.9,2.0,34,1,3,2,6,0xb2d42272d
1.42,1.0,17,1,2,2,5,0xb2d322f2
329044.69,7.0,18,4,4,2,10,0xb2d54e25
894929.97,6.0,5,4,4,3,11,0xb2d61fbf
102976.86,2.0,25,3,3,2,8,0xb2d24915
6425.27,1.0,9,2,2,3,7,0xb2d1c33e
1015.55,1.0,184,1,2,1,4,0xb2d0ea7d
101179.74,3.0,31,3,4,2,9,0xb2d63a8bd
35093.34,2.0,74,2,3,1,6,0xb2d65918
2354022.52,3.0,0,4,4,4,12,0xb2d0d679
50690.07,4.0,18,2,4,2,8,0xb2d507e8
10009.15,1.0,19,2,2,2,6,0xb2d68e2d
780000.02,7.0,4,4,4,4,12,0xb2d5728fd
10426.53,1.0,18,2,2,2,6,0xb2d54c3c
3242.68,1.0,6,2,2,3,7,0xb2d2a34d
20000.21,2.0,55,2,3,2,7,0xb2d9043d
150005.29,4.0,102,3,4,1,8,0xb2d8fe2f
123390.14,4.0,11,3,4,3,10,0xb2d3fd89d
10000.11,2.0,5,2,3,3,8,0xb2d96a70
550826.93,3.0,80,4,4,1,9,0xb2d620e1
53265.85,1.0,5,3,2,3,8,0xb2d15527
47154.01,1.0,184,2,2,1,5,0xb2d33525d
260010.36,7.0,108,3,4,1,8,0xb2d5796d
5342.49,1.0,1,2,2,4,8,0xb2d3870d
1.97,1.0,15,1,2,3,6,0xb2d8db1ed
450000.47,2.0,8,4,3,3,10,0xb2d9d099
50337.35,5.0,24,2,4,2,8,0xb2d59cc6d
370092.05,5.0,6,4,4,3,11,0xb2d15c4fd
21991.77,1.0,5,2,2,3,7,0xb2d29d62
50077.4,2.0,30,2,3,2,7,0xb2d58952
1250005.28,4.0,13,4,4,3,11,0xb2d915f3
4208.56,1.0,0,2,2,4,8,0xb2d59201
10.0,1.0,4,1,2,4,7,0xb2d965d8
240003.2,7.0,21,3,4,2,9,0xb2d39f01
601451.33,4.0,47,4,4,2,10,0xb2d4c60c
167190.09,5.0,0,3,4,4,11,0x3b9b4600
156.6,1.0,44,1,2,2,5,0xb2d94795
2055.63,1.0,2,1,2,4,7,0xb2d59999
290000.0,2.0,1,3,3,4,10,0xb2da66a6
620017.92,5.0,32,4,4,2,10,0xb2d21e22d
816.24,1.0,16,1,2,2,5,0xb2d45ca5
696.08,1.0,1,1,2,4,7,0xb2d8db14
3372.22,1.0,9,2,2,3,7,0xb2d3f3f3
3.17,1.0,75,1,2,1,4,0xb2d98fc6
70.71,1.0,1,1,2,4,7,0xb2d6eeca
2060.82,1.0,9,1,2,3,6,0xb2d5e437
42729.4,2.0,7,2,3,3,8,0x3b9af230
2137.33,2.0,184,1,3,1,5,0xb2d33fafd
750042.38,7.0,2,4,4,4,12,0xb2d16b3f
20493.53,2.0,92,2,3,1,6,0x3b9ae20e
160347.44,3.0,34,3,4,2,9,0xb2d8d00cd
599500.39,5.0,0,4,4,4,12,0xb2d17574
17487.69,1.0,0,2,2,4,8,0xb2d6b4a7
3470.21,1.0,7,2,2,3,7,0xb2d2a34dd
120015.49,3.0,70,3,4,1,8,0xb2d4c402
200003.53,3.0,13,3,4,3,10,0x3b9b3db6d
8944.72,1.0,0,2,2,4,8,0xb2d0d75e
7100.6,1.0,18,2,2,2,6,0xb2da2060
20000.84,2.0,73,2,3,1,6,0xb2d8de5f
11.73,1.0,35,1,2,2,5,0xb2d5cb95
440.35,1.0,0,1,2,4,7,0xb2d2262e
100003.17,2.0,66,3,3,2,8,0xb2d8eada
500000.0,2.0,19,4,3,2,9,0xb2d93a8a
400251.49,5.0,7,4,4,3,11,0xb2d6aeedd
336876.36,4.0,34,4,4,2,10,0xb2d2d1e4
682.43,1.0,0,1,2,4,7,0xb2d966e3
1139554.14,12.0,0,4,4,4,12,0xb2d1710fd
29791.42,1.0,1,2,2,4,8,0xb2d43b19
270062.71,2.0,0,3,3,4,10,0xb2d96497d
250097.94,2.0,5,3,3,3,9,0xb2d5b98a
60845.3,1.0,9,3,2,3,8,0xb2d6b6d1
2806496.15,15.0,0,4,4,4,12,0xb2d31198
83927.44,3.0,0,3,4,4,11,0xb2d4dcb0
51.36,1.0,13,1,2,3,6,0xb2d8d4e1
20000.21,2.0,46,2,3,2,7,0xb2d9e131
1622.71,1.0,1,1,2,4,7,0xb2d2d6a4
222257.44,2.0,70,3,3,1,7,0xb2d22340d
40605.93,1.0,0,2,2,4,8,0xb2d27a42
52360.0,2.0,252,3,3,1,7,0xb2d3f776d
628044.8,9.0,0,4,4,4,12,0xb2d6f5d9
450000.0,2.0,52,4,3,2,9,0xb2d91078
70003.22,2.0,92,3,3,1,7,0xb2d6446b
377.59,3.0,11,1,4,3,8,0x3b9ae61d
40165.31,2.0,25,2,3,2,7,0xb2d37bff
3015000.0,3.0,1,4,4,4,12,0xb2d56dab
12456.33,1.0,10,2,2,3,7,0xb2d334c6
270000.0,2.0,0,3,3,4,10,0xb2d9308dd
50141.28,2.0,10,2,3,3,8,0xb2d990b1
947.76,1.0,6,1,2,3,6,0xb2d4fd40d
112146.41,4.0,11,3,4,3,10,0xb2d5d0b4d
530.65,1.0,46,1,2,2,5,0xb2d593bdd
61692.69,3.0,211,3,4,1,8,0x3b9ad6ac
1010663.81,20.0,1,4,4,4,12,0xb2d2c302
100001.95,2.0,52,3,3,2,8,0xb2d7ec9bd
7180.38,1.0,15,2,2,3,7,0xb2da083b
304.92,1.0,2,1,2,4,7,0xb2d9288f
181008.22,4.0,63,3,4,2,9,0xb2d16fd1d
13218335.76,3.0,42,4,4,2,10,0xb2d6857f
1151260.52,37.0,0,4,4,4,12,0xb2d146f4
74130.46,9.0,0,3,4,4,11,0x3b9af27dd
258501.12,5.0,1,3,4,4,11,0xb2d0b40fd
360039.82,2.0,0,4,3,4,11,0xb2d62c9ad
100000.16,4.0,0,3,4,4,11,0xb2d20fc6d
7007.05,1.0,0,2,2,4,8,0xb2d6992f
501858.61,2.0,35,4,3,2,9,0xb2d60185
382244.84,5.0,12,4,4,3,11,0xb2d07fe4
470.76,1.0,21,1,2,2,5,0xb2d37c6a
0.0,1.0,1,1,2,4,7,0xb2d9323e
1348698.14,5.0,35,4,4,2,10,0xb2d3e443d
311838.99,3.0,46,4,4,2,10,0xb2d41e9d
10887.57,1.0,0,2,2,4,8,0xb2d6a9c1
400000.0,3.0,8,4,4,3,11,0xb2da25c1
130.15,1.0,47,1,2,2,5,0xb2d8f6eb
2000054.36,2.0,3,4,3,4,11,0xb2d915d6
200008.62,2.0,19,3,3,2,8,0xb2d5cb53d
214794.03,3.0,13,3,4,3,10,0x3b9b45ead
50000.8,5.0,69,2,4,1,7,0x3b9b45a7
2016.57,1.0,0,1,2,4,7,0xb2d9252e
0.53,1.0,89,1,2,1,4,0xb2d8c5c4d
1125267.63,9.0,4,4,4,4,12,0xb2d5e7a8d
405328.26,4.0,27,4,4,2,10,0xb2d1e327
770.77,1.0,16,1,2,2,5,0xb2d33dec
1177059.37,6.0,3,4,4,4,12,0xb2d60649d
61.09,1.0,11,1,2,3,6,0xb2d3198cd
250048.31,2.0,12,3,3,3,9,0xb2d354a6
10939.4,1.0,7,2,2,3,7,0xb2d48c91d
120004.12,4.0,28,3,4,2,9,0xb2d9f8ad
6.66,1.0,54,1,2,2,5,0xb2d8eb63
61059.12,3.0,83,3,4,1,8,0xb2d5f466d
500622.24,4.0,3,4,4,4,12,0xb2d3c551d
82114.75,2.0,4,3,3,4,10,0xb2d43a8ad
60190.52,1.0,92,3,2,1,6,0xb2d37a40d
401441.34,3.0,32,4,4,2,10,0xb2d9613dd
235913.25,3.0,7,3,4,3,10,0xb2d09a84d
208000.0,1.0,4,3,2,4,9,0xb2d928d3
51109.18,1.0,41,2,2,2,6,0xb2d62167
5.51,1.0,1,1,2,4,7,0xb2d9c11f
219.19,1.0,25,1,2,2,5,0xb2d3639f
1394846.5,17.0,0,4,4,4,12,0xb2d1106bd
184039.45,1.0,0,3,2,4,9,0xb2d2f146
10000.95,2.0,83,2,3,1,6,0xb2d98336
5.56,5.0,18,1,4,2,7,0xb2d0672f
1764.38,1.0,184,1,2,1,4,0xb2d29ab0d
2747.26,1.0,6,1,2,3,6,0xb2d92994
250050.01,2.0,25,3,3,2,8,0xb2da0d4c
3322.79,2.0,11,2,3,3,8,0xb2d1dd23d
121022.74,4.0,21,3,4,2,9,0xb2d1b9fcd
1044.02,1.0,31,1,2,2,5,0xb2d81625
93517.03,6.0,3,3,4,4,11,0xb2d2284ed
5878.34,1.0,0,2,2,4,8,0xb2d973f5
1153.97,1.0,2,1,2,4,7,0xb2d47ccb
45.91,1.0,25,1,2,2,5,0xb2d8ede8
102001.0,2.0,13,3,3,3,9,0xb2d15a2d
42088.15,5.0,0,2,4,4,10,0xb2d2123e
939053.78,5.0,10,4,4,3,11,0xb2d3b76bd
8135.87,1.0,108,2,2,1,5,0xb2d40e6dd
8141.06,1.0,7,2,2,3,7,0xb2d5958b
1111138.53,20.0,6,4,4,3,11,0xb2d27fccd
350061.36,5.0,11,4,4,3,11,0xb2d0c2c9d
682920.34,6.0,111,4,4,1,9,0xb2d23d73
510097.21,3.0,12,4,4,3,11,0xb2d9fc02
501.03,1.0,0,1,2,4,7,0xb2d0ff01
34.59,1.0,80,1,2,1,4,0xb2d23af9d
770204.28,2.0,12,4,3,3,10,0xb2da0301
4978.38,3.0,0,2,4,4,10,0x3b9b3673
50008.98,2.0,139,2,3,1,6,0xb2d4108dd
1536.98,1.0,147,1,2,1,4,0xb2d548c5d
10637.96,1.0,0,2,2,4,8,0xb2d2b5de
1175.14,1.0,16,1,2,2,5,0xb2d2f551
1890.12,1.0,205,1,2,1,4,0xb2d43e07d
480064.87,4.0,110,4,4,1,9,0xb2d59749
200720.85,2.0,8,3,3,3,9,0xb2d8ed77d
52001.67,2.0,53,2,3,2,7,0xb2d9c602
1001.63,1.0,92,1,2,1,4,0xb2d57b04
1.58,1.0,81,1,2,1,4,0xb2d8d4e7
590092.84,5.0,34,4,4,2,10,0xb2d440eb
1044000.29,6.0,7,4,4,3,11,0xb2d23a3c
11793.7,1.0,14,2,2,3,7,0xb2d61b5ad
2640.83,1.0,122,1,2,1,4,0xb2d258e7
58013.69,2.0,10,3,3,3,9,0xb2d112b9d
503552.47,2.0,62,4,3,2,9,0xb2d9bd36
30.77,2.0,53,1,3,2,6,0xb2d9078dd
130117.57,2.0,76,3,3,1,7,0xb2d1b8b0d
102.55,1.0,10,1,2,3,6,0xb2d6e82fd
1725.14,1.0,5,1,2,3,6,0xb2d2d71a
50085.82,2.0,206,2,3,1,6,0xb2d5c594d
7748.19,1.0,4,2,2,4,8,0xb2d4548f
450000.0,2.0,0,4,3,4,11,0xb2d9833c
200611.2,2.0,0,3,3,4,10,0xb2d7d2dd
302612.17,2.0,3,4,3,4,11,0xb2d0ea86d
93533.42,5.0,5,3,4,3,10,0xb2d07d41d
670564.46,5.0,8,4,4,3,11,0xb2d089c6d
2701.86,3.0,0,1,4,4,9,0xb2d09b8f
110.94,1.0,7,1,2,3,6,0xb2d3989f
334526.42,3.0,60,4,4,2,10,0xb2d57a1fd
1488.64,1.0,71,1,2,1,4,0xb2d93a44
472437.17,8.0,8,4,4,3,11,0xb2d6a974
302178.09,3.0,11,4,4,3,11,0xb2d6bbe3
70078.2,1.0,16,3,2,2,7,0xb2d409ebd
826000.0,7.0,0,4,4,4,12,0xb2d550bcd
441743.36,8.0,4,4,4,4,12,0xb2d52b20
18617.64,1.0,92,2,2,1,5,0xb2d35e07
3.17,2.0,61,1,3,2,6,0xb2d50106
4650.52,5.0,0,2,4,4,10,0xb2d2657d
3894.32,1.0,6,2,2,3,7,0xb2d21247
282521.31,7.0,2,3,4,4,11,0xb2d60e61d
30449.75,2.0,118,2,3,1,6,0xb2d5aac4
100010.82,2.0,136,3,3,1,7,0xb2d1775d
101008.02,1.0,200,3,2,1,6,0xb2d38229d
102392.88,2.0,132,3,3,1,7,0xb2d5633e
1648247.71,5.0,20,4,4,2,10,0xb2d14b5ed
8.0,1.0,9,1,2,3,6,0xb2d6f432
240000.95,5.0,11,3,4,3,10,0xb2da393f
16485.62,1.0,15,2,2,3,7,0xb2d264d2
10801.03,1.0,179,2,2,1,5,0xb2d57971
3402.37,1.0,3,2,2,4,8,0xb2d9439a
7659.92,1.0,1,2,2,4,8,0xb2d31e90
1525.16,1.0,92,1,2,1,4,0xb2d10304d
10189.26,1.0,92,2,2,1,5,0xb2d08512d
1.89,1.0,6,1,2,3,6,0xb2d48c55d
700024.7,5.0,0,4,4,4,12,0xb2d966e7
0.46,2.0,5,1,3,3,7,0xb2d49e2a
2079546.49,46.0,0,4,4,4,12,0xb2d082b7d
1095034.85,2.0,15,4,3,3,10,0xb2d23e5bd
50131.09,2.0,74,2,3,1,6,0xb2d63610
2519.3,1.0,24,1,2,2,5,0xb2d30863
1572933.38,1.0,165,4,2,1,7,0xb2d0c845
503254.05,3.0,6,4,4,3,11,0xb2d17a8ad
193133.0,4.0,83,3,4,1,8,0xb2d3c330
4017476.32,3.0,94,4,4,1,9,0xb2d29238d
50004.73,2.0,18,2,3,2,7,0xb2d5607dd
840119.35,2.0,21,4,3,2,9,0xb2d0de49
10000.11,2.0,90,2,3,1,6,0xb2d8c381
152093.69,3.0,104,3,4,1,8,0xb2d3884a
1006382.04,1.0,0,4,2,4,10,0xb2d6a65fd
224965.11,2.0,0,3,3,4,10,0xb2d8ccd0
10033.46,1.0,59,2,2,2,6,0xb2d5b2c1
10445.07,1.0,11,2,2,3,7,0xb2d835bf
100000.0,2.0,0,3,3,4,10,0xb2d97f5a
65054.68,2.0,35,3,3,2,8,0xb2d0f8afd
100094.42,2.0,136,3,3,1,7,0xb2d6180c
465533.83,4.0,23,4,4,2,10,0xb2d6bc88d
6215.94,1.0,37,2,2,2,6,0xb2d67ee8d
1.87,1.0,20,1,2,2,5,0xb2d60926
1844.43,1.0,18,1,2,2,5,0xb2d37c11
62818.6,2.0,0,3,3,4,10,0xb2d94054
12147.05,1.0,0,2,2,4,8,0xb2d6b59cd
805204.17,19.0,0,4,4,4,12,0xb2d2111cd
2744.42,2.0,4,1,3,4,8,0xb2d982ed
151665.61,29.0,1,3,4,4,11,0xb2d3a8e9
61135.03,2.0,235,3,3,1,7,0xb2d60f77
102863.82,2.0,38,3,3,2,8,0xb2d61f01d
30611.06,1.0,1,2,2,4,8,0xb2d3334d
1929.57,1.0,0,1,2,4,7,0xb2d34d7a
0.12,1.0,0,1,2,4,7,0xb2d58bfad
636247.46,7.0,0,4,4,4,12,0xb2d5dd45
275648.02,4.0,3,3,4,4,11,0xb2d17975
106178.81,4.0,186,3,4,1,8,0xb2d57c98d
700461.69,3.0,18,4,4,2,10,0xb2d5960a
16473.26,1.0,1,2,2,4,8,0xb2d304cb
335.81,1.0,10,1,2,3,6,0xb2d8a1b7
109010.53,2.0,130,3,3,1,7,0xb2d5d14ad
2007.62,1.0,19,1,2,2,5,0xb2d213d1
160000.0,5.0,6,3,4,3,10,0xb2d0d628
17574.91,1.0,0,2,2,4,8,0xb2d90e59
4014.58,1.0,26,2,2,2,6,0xb2d1aec4
9083.85,1.0,5,2,2,3,7,0xb2d2ad2ad
2787.84,1.0,142,1,2,1,4,0xb2d2823a
140059.0,2.0,239,3,3,1,7,0xb2d68820
212850.34,6.0,3,3,4,4,11,0xb2d38831d
322234.98,2.0,259,4,3,1,8,0xb2d4112b
400016.75,4.0,38,4,4,2,10,0xb2d2607e
153266.15,2.0,19,3,3,2,8,0x3b9b32f8d
1114663.9,2.0,14,4,3,3,10,0xb2d49038
3765.57,1.0,2,2,2,4,8,0xb2d21f63d
570.59,1.0,0,1,2,4,7,0xb2d34830d
171124.83,5.0,3,3,4,4,11,0xb2d0ca35
1889.41,1.0,9,1,2,3,6,0xb2d8fa09
300033.33,6.0,3,3,4,4,11,0xb2d4cacbd
282189.9,2.0,22,3,3,2,8,0xb2d8d0ec
3560029.68,1.0,184,4,2,1,7,0xb2d0dbc3
6.64,1.0,7,1,2,3,6,0xb2d2caf9d
230.65,1.0,63,1,2,2,5,0xb2d2260cd
1796.14,2.0,10,1,3,3,7,0xb2d8a9d3
70007.29,2.0,11,3,3,3,9,0xb2d0f068d
45.78,1.0,1,1,2,4,7,0xb2d43aa5
90003.06,5.0,25,3,4,2,9,0xb2d87047d
50005.19,2.0,20,2,3,2,7,0xb2d57597
6750.95,1.0,16,2,2,2,6,0xb2d128f7
1003552.3,2.0,46,4,3,2,9,0xb2d9e628
1513.04,1.0,164,1,2,1,4,0xb2d4d10c
6114.67,1.0,0,2,2,4,8,0xb2d6bff2
3799503.57,12.0,1,4,4,4,12,0x3b9b44a3
461000.0,3.0,1,4,4,4,12,0xb2d62149d
60003.17,1.0,15,3,2,3,8,0xb2d9f413
2004.75,1.0,92,1,2,1,4,0xb2d59ef3d
16618.73,1.0,3,2,2,4,8,0xb2d39890
876.45,1.0,10,1,2,3,6,0xb2d6d02a
23740.43,1.0,0,2,2,4,8,0xb2d0c59b
814.85,1.0,3,1,2,4,7,0xb2d2a811
4.49,1.0,81,1,2,1,4,0xb2d50dc3d
10021.5,1.0,184,2,2,1,5,0xb2d3511dd
100050.29,2.0,46,3,3,2,8,0xb2d107a9
21112.29,1.0,21,2,2,2,6,0xb2d6948b
110002.74,3.0,25,3,4,2,9,0xb2d8363e
200477.02,2.0,0,3,3,4,10,0xb2d927ecd
320502.7,3.0,20,4,4,2,10,0xb2d14de6d
12038.5,1.0,6,2,2,3,7,0xb2d769ea
60559.8,2.0,80,3,3,1,7,0xb2d120b2d
93015.1,5.0,12,3,4,3,10,0xb2d5e705d
501819.06,2.0,4,4,3,4,11,0xb2d62b70
64136.05,1.0,46,3,2,2,7,0xb2d36f8ad
127582.21,1.0,14,3,2,3,8,0xb2d0de15d
14584.5,1.0,26,2,2,2,6,0xb2d69bb6
47.31,1.0,20,1,2,2,5,0xb2d6e1a2
1500069.09,2.0,21,4,3,2,9,0xb2d65873
51342.1,2.0,7,2,3,3,8,0xb2d586e8d
524746.1,3.0,0,4,4,4,12,0xb2d298e6
5692.66,1.0,39,2,2,2,6,0xb2d2f128
81008.21,5.0,3,3,4,4,11,0xb2d53c51
3.18,1.0,49,1,2,2,5,0xb2d79085
1127.73,1.0,1,1,2,4,7,0xb2d4cb60
1395.87,1.0,92,1,2,1,4,0xb2d1234bd
10000.11,2.0,62,2,3,2,7,0xb2d8f721
2.95,7.0,82,1,4,1,6,0xb2d6cf12d
2018234.64,7.0,6,4,4,3,11,0xb2d6d090
32184.8,1.0,7,2,2,3,7,0xb2d5a651
10000.42,2.0,92,2,3,1,6,0xb2d6391b
30049.33,2.0,36,2,3,2,7,0xb2d92247
92050.62,2.0,0,3,3,4,10,0xb2d5df1e
80004.0,6.0,47,3,4,2,9,0xb2d23d2ad
310719.11,4.0,18,4,4,2,10,0x3b9b3c72
0.0,19.0,5,1,4,3,8,0xb2d1860f
482959.0,6.0,1,4,4,4,12,0xb2d43ba9
602191.42,2.0,12,4,3,3,10,0xb2d68b6bd
20000.0,2.0,1,2,3,4,9,0xb2da60fc
280076.06,2.0,4,3,3,4,10,0xb2d5bf3c
180081.63,3.0,83,3,4,1,8,0xb2d1f7acd
2025.31,1.0,184,1,2,1,4,0xb2d57f5c
100003.17,2.0,60,3,3,2,8,0xb2d9b98a
2100205.2,5.0,18,4,4,2,10,0xb2d4ea94d
170001.79,2.0,13,3,3,3,9,0xb2d95d72
3100.62,1.0,168,2,2,1,5,0xb2d238a2d
100368.85,2.0,107,3,3,1,7,0xb2d2d30d
720006.64,5.0,9,4,4,3,11,0xb2d2b339d
635684.01,8.0,13,4,4,3,11,0xb2d5d7b0d
768625.19,2.0,3,4,3,4,11,0xb2d1161c
1570014.42,4.0,27,4,4,2,10,0xb2d94799d
104333.79,3.0,69,3,4,1,8,0xb2d56c78d
110200.52,6.0,0,3,4,4,11,0xb2d08ad9
64400.77,5.0,0,3,4,4,11,0xb2d0f4a1
800008.44,2.0,49,4,3,2,9,0xb2d9d5e2
290009.21,3.0,25,3,4,2,9,0xb2d78dded
82424.7,2.0,18,3,3,2,8,0xb2d5ad6f
704776.97,6.0,24,4,4,2,10,0xb2d0aa65d
1000019.63,6.0,11,4,4,3,11,0xb2d42f61
50010.07,2.0,10,2,3,3,8,0xb2d78e48
645394.6,7.0,97,4,4,1,9,0xb2d3ab7e
50199.87,1.0,0,2,2,4,8,0xb2d64616d
253741.04,3.0,209,3,4,1,8,0xb2d3a5fdd
31111.85,1.0,4,2,2,4,8,0xb2d2e087
139168.5,3.0,11,3,4,3,10,0xb2d590db
3678.71,1.0,5,2,2,3,7,0xb2d21705d
50022.56,2.0,55,2,3,2,7,0xb2d7a72b
111975.43,2.0,53,3,3,2,8,0xb2d3d355
670000.0,3.0,10,4,4,3,11,0xb2d9a7ca
1551.82,1.0,109,1,2,1,4,0xb2d6f099
104401.0,2.0,92,3,3,1,7,0xb2d2b095
2215.92,1.0,0,1,2,4,7,0xb2d52c44
20493.58,2.0,4,2,3,4,9,0xb2d5ea89
1014.44,1.0,184,1,2,1,4,0xb2d1a30cd
1801109.13,6.0,24,4,4,2,10,0xb2d2b9de
155570.28,1.0,4,3,2,4,9,0xb2d430eb
1053.86,1.0,1,1,2,4,7,0xb2d22b26
59.0,1.0,26,1,2,2,5,0xb2d5edd4
364024.83,3.0,111,4,4,1,9,0xb2d27e88
1272.71,1.0,0,1,2,4,7,0xb2d983e9
71.2,6.0,15,1,4,3,8,0xb2d0acbf
2488.01,1.0,24,1,2,2,5,0xb2d33cc9
200029.69,4.0,12,3,4,3,10,0xb2d127e1d
172116.58,7.0,3,3,4,4,11,0xb2d5551f
60025.38,2.0,249,3,3,1,7,0xb2d5a0ea
48309.77,2.0,0,2,3,4,9,0xb2d119a0d
7481.28,1.0,184,2,2,1,5,0xb2d1d3f9
350338.28,7.0,3,4,4,4,12,0x3b9b1a2ed
20620.5,1.0,0,2,2,4,8,0xb2d43a49
444.23,1.0,72,1,2,1,4,0xb2d32e2bd
605034.26,3.0,41,4,4,2,10,0xb2d91c56
3.93,1.0,0,1,2,4,7,0xb2d6c00a
1.67,1.0,138,1,2,1,4,0xb2d58073d
18807.76,1.0,0,2,2,4,8,0xb2d3ecd1
9395.94,1.0,0,2,2,4,8,0xb2d4cc1f
201421.04,2.0,68,3,3,1,7,0xb2d9afb4
10291.21,1.0,3,2,2,4,8,0xb2d65365d
685.82,1.0,3,1,2,4,7,0xb2d3e50fd
280006.56,2.0,17,3,3,2,8,0xb2d5a362d
3940.47,1.0,184,2,2,1,5,0xb2d07440
2822.04,1.0,9,1,2,3,6,0xb2d56ecdd
172019.42,2.0,174,3,3,1,7,0xb2d1c72a
0.0,1.0,63,1,2,2,5,0xb2d8f793
29763.96,1.0,108,2,2,1,5,0xb2d623e2d
1.25,1.0,1,1,2,4,7,0xb2d7fe90
11054.77,1.0,92,2,2,1,5,0xb2d68136d
67.34,1.0,19,1,2,2,5,0xb2d20169
491364.53,2.0,43,4,3,2,9,0xb2d3567cd
200000.38,2.0,1,3,3,4,10,0xb2d5a0a8
150391.93,5.0,0,3,4,4,11,0xb2d6e4a1
402064.37,1.0,77,4,2,1,7,0xb2d3641f
1249.24,1.0,0,1,2,4,7,0xb2d4361fd
119420.86,3.0,125,3,4,1,8,0xb2d416c8d
400000.0,3.0,0,4,4,4,12,0xb2d8f342d
503552.98,2.0,80,4,3,1,8,0xb2d99460
255184.17,1.0,25,3,2,2,7,0xb2d42082d
174551.46,1.0,0,3,2,4,9,0xb2d623a6
100003.17,2.0,92,3,3,1,7,0xb2d97dc7d
207637.79,3.0,202,3,4,1,8,0xb2d175be
600729.6,3.0,1,4,4,4,12,0xb2d6b2abd
8563.89,2.0,92,2,3,1,6,0xb2d39f1fd
0.0,1.0,6,1,2,3,6,0xb2d95ee6
120000.72,3.0,1,3,4,4,11,0xb2d0e169
1740.34,1.0,2,1,2,4,7,0xb2d5d282
40.53,1.0,21,1,2,2,5,0xb2d94807
1476710.84,2.0,60,4,3,2,9,0xb2d1c1e9
432001.01,3.0,25,4,4,2,10,0xb2d0d6a9d
500000.04,2.0,19,4,3,2,9,0xb2d95a40
20002.21,2.0,77,2,3,1,6,0xb2d9952f
675.27,1.0,0,1,2,4,7,0xb2d6f0e5
30001.05,3.0,80,2,4,1,7,0xb2d95aa4
1.63,1.0,57,1,2,2,5,0xb2d95d9f
20000.21,2.0,32,2,3,2,7,0xb2da0368
340215.98,2.0,13,4,3,3,10,0xb2d8d79f
2931000.18,4.0,1,4,4,4,12,0xb2d5ec4cd
14.4,1.0,18,1,2,2,5,0xb2da1e3e
19.01,1.0,35,1,2,2,5,0xb2d90bea
126144.67,6.0,25,3,4,2,9,0xb2d647d3d
530068.53,2.0,221,4,3,1,8,0xb2d36b18d
102540.42,2.0,4,3,3,4,10,0xb2d78747
3753.94,1.0,0,2,2,4,8,0xb2d964a8
2586.02,1.0,54,1,2,2,5,0xb2d4525dd
1774.8,1.0,10,1,2,3,6,0xb2d2e743
70196.22,2.0,122,3,3,1,7,0xb2d58fa5
182011.82,3.0,74,3,4,1,8,0xb2d146afd
1746939.7,2.0,0,4,3,4,11,0xb2d6250b
2120.32,1.0,92,1,2,1,4,0xb2d34d73d
3839.68,1.0,21,2,2,2,6,0xb2d99fa0
6995.72,1.0,29,2,2,2,6,0xb2d9256c
787499.84,1.0,184,4,2,1,7,0x3b9b1226d
50097.0,2.0,53,2,3,2,7,0xb2d59607d
1526.37,2.0,24,1,3,2,6,0x3b9b2cfd
30000.65,2.0,25,2,3,2,7,0xb2d9283fd
666.42,1.0,1,1,2,4,7,0xb2d21095
1558009.32,16.0,13,4,4,3,11,0xb2d40ec0
192.77,1.0,18,1,2,2,5,0xb2d9773a
85.21,1.0,47,1,2,2,5,0xb2d2e096d
60001.9,3.0,66,3,4,2,9,0xb2d8e10ad
4064.28,1.0,0,2,2,4,8,0xb2d8d535d
7.98,1.0,9,1,2,3,6,0xb2d29b0e
50002.14,2.0,95,2,3,1,6,0xb2d5e645
103520.28,8.0,0,3,4,4,11,0xb2d0eb62d
114691.61,2.0,228,3,3,1,7,0xb2d1d25a
63057.78,1.0,184,3,2,1,6,0xb2d32df2d
135.99,2.0,0,1,3,4,8,0x3b9af1d4
57309.89,1.0,8,3,2,3,8,0xb2d37b70d
504102.5,3.0,90,4,4,1,9,0xb2d126f1d
264362.54,2.0,15,3,3,3,9,0xb2d0b8a8
2756.62,1.0,27,1,2,2,5,0xb2d68944
1548.26,1.0,108,1,2,1,4,0xb2d3a25e
200311.5,1.0,123,3,2,1,6,0xb2d4ecbb
501135.0,3.0,18,4,4,2,10,0xb2d6f0d3d
60001.79,5.0,7,3,4,3,10,0xb2d65744
90566.71,2.0,114,3,3,1,7,0xb2d63c38
500019.34,4.0,1,4,4,4,12,0xb2d6454d
360025.28,4.0,55,4,4,2,10,0xb2d5f392
7380.34,1.0,0,2,2,4,8,0xb2d5fb29d
11326.27,1.0,1,2,2,4,8,0xb2d55240
1363.68,1.0,1,1,2,4,7,0xb2d7910b
420010.01,3.0,76,4,4,1,9,0xb2d9831d
310129.2,6.0,0,4,4,4,12,0xb2d06724
500076.08,2.0,0,4,3,4,11,0xb2d9bf5c
25.58,1.0,12,1,2,3,6,0xb2d3a8bf
1175.61,1.0,158,1,2,1,4,0xb2d1d68cd
398.51,1.0,110,1,2,1,4,0xb2d3a90d
50727.28,3.0,0,2,4,4,10,0xb2d6109ed
525285.54,11.0,14,4,4,3,11,0x3b9b0fd6
506015.62,4.0,4,4,4,4,12,0xb2d65a6b
40001.64,4.0,94,2,4,1,7,0xb2d68d37
4549.39,1.0,92,2,2,1,5,0xb2d4c29fd
310793.51,2.0,92,4,3,1,8,0xb2d25217d
400000.0,2.0,25,4,3,2,9,0xb2d94a54
600270.18,6.0,0,4,4,4,12,0xb2d11b26
203006.46,2.0,199,3,3,1,7,0xb2d5d4eb
502991.14,3.0,76,4,4,1,9,0xb2d56871d
150000.0,2.0,1,3,3,4,10,0xb2da618f
30000.32,2.0,6,2,3,3,8,0xb2d96d05
30007.48,2.0,31,2,3,2,7,0xb2d6c253d
600.11,1.0,0,1,2,4,7,0xb2d1a299
12111.34,1.0,7,2,2,3,7,0xb2d2d741
84316.11,3.0,14,3,4,3,10,0xb2d4f545
978.24,1.0,0,1,2,4,7,0xb2d1ed93d
14056.31,1.0,3,2,2,4,8,0xb2d74a77
209348.17,2.0,0,3,3,4,10,0xb2d622ecd
402812.9,3.0,6,4,4,3,11,0xb2d48339
16463.93,1.0,0,2,2,4,8,0xb2d36b9bd
62995.72,1.0,2,3,2,4,9,0xb2d32efd
264.1,1.0,26,1,2,2,5,0xb2d6826fd
0.0,1.0,0,1,2,4,7,0xb2d2e41e
24.69,1.0,39,1,2,2,5,0xb2d22ea1
4856859.04,95.0,0,4,4,4,12,0xb2d0bb89d
5590.08,1.0,0,2,2,4,8,0xb2d32985
501776.3,2.0,54,4,3,2,9,0xb2d9cfff
162709.36,5.0,3,3,4,4,11,0xb2d62431
7389.25,1.0,110,2,2,1,5,0xb2d52782d
5.06,1.0,68,1,2,1,4,0xb2d7f201d
301.94,1.0,9,1,2,3,6,0xb2d4a387
83393.93,1.0,6,3,2,3,8,0xb2d0a9b1
31066.7,3.0,23,2,4,2,8,0xb2d08d4fd
1.09,1.0,19,1,2,2,5,0xb2d6bad7
21.65,1.0,139,1,2,1,4,0xb2d5ad41
135.74,1.0,10,1,2,3,6,0xb2d7861d
206684.3,2.0,119,3,3,1,7,0xb2d4170ad
20582.2,1.0,3,2,2,4,8,0xb2d65446
10461.88,2.0,6,2,3,3,8,0xb2d2e113
23.79,1.0,16,1,2,2,5,0xb2d3b15e
370216.64,3.0,3,4,4,4,12,0xb2d59ed5
214451.83,4.0,10,3,4,3,10,0xb2d6c2a5d
17493.36,1.0,0,2,2,4,8,0xb2d62d13
37877.22,2.0,0,2,3,4,9,0xb2d0f6dfd
50000.53,2.0,83,2,3,1,6,0xb2d8d176
2541.15,2.0,184,1,3,1,5,0xb2d09ac4
13.06,1.0,41,1,2,2,5,0xb2d6236a
8022.97,3.0,184,2,4,1,7,0xb2d11e8ad
61.6,1.0,4,1,2,4,7,0xb2d1fa59
4111.09,2.0,1,2,3,4,9,0xb2d0a27fd
305662.26,1.0,0,4,2,4,10,0xb2d65d53d
602.6,1.0,5,1,2,3,6,0xb2d40c2bd
60059.26,2.0,137,3,3,1,7,0xb2d263c5
10000000.0,1.0,0,4,2,4,10,0xb2da683e
394.19,1.0,25,1,2,2,5,0xb2d6a69d
10052.78,1.0,184,2,2,1,5,0xb2d53d35d
280068.35,2.0,134,3,3,1,7,0xb2d14850
380.61,1.0,8,1,2,3,6,0xb2d6aa7a
28002.01,3.0,0,2,4,4,10,0xb2d891f9
3434.3,6.0,96,2,4,1,7,0xb2d4057b
2089.79,1.0,184,1,2,1,4,0xb2d0d28f
5808.63,1.0,5,2,2,3,7,0xb2d23b6bd
3.3,1.0,32,1,2,2,5,0xb2d92254
17052.92,1.0,147,2,2,1,5,0xb2d279b8d
670333.32,12.0,1,4,4,4,12,0x3b9b1828
38513.08,4.0,184,2,4,1,7,0x3b9b14f2d
1365565.19,3.0,12,4,4,3,11,0xb2d38127
105370.7,2.0,80,3,3,1,7,0xb2d56bb0d
150005.28,2.0,0,3,3,4,10,0xb2d9d161
10000.64,2.0,81,2,3,1,6,0xb2d56942
2504.29,1.0,33,1,2,2,5,0xb2d21633
203554.17,2.0,33,3,3,2,8,0xb2d6de9a
6174.74,1.0,0,2,2,4,8,0xb2d4cc14d
48375.97,1.0,0,2,2,4,8,0xb2d6330f
2692.66,1.0,11,1,2,3,6,0xb2d23ace
298.39,1.0,9,1,2,3,6,0xb2d8f599
107125.44,3.0,3,3,4,4,11,0xb2d2560cd
6266.9,1.0,184,2,2,1,5,0xb2d0d8fbd
260014.16,3.0,19,3,4,2,9,0xb2d99b20
100003.07,2.0,38,3,3,2,8,0xb2d92565
33447.18,1.0,229,2,2,1,5,0xb2d222b5d
100404.52,2.0,112,3,3,1,7,0xb2d3cb98
1039.22,1.0,92,1,2,1,4,0xb2d405f0d
29.22,1.0,28,1,2,2,5,0xb2d1711fd
5245.22,2.0,99,2,3,1,6,0xb2d6d020
546822.8,2.0,48,4,3,2,9,0xb2d3a58d
4560.79,1.0,0,2,2,4,8,0xb2d0f59c
408069.16,7.0,11,4,4,3,11,0xb2d3bc8a
3.17,1.0,60,1,2,2,5,0xb2d9c168
10610.0,2.0,21,2,3,2,7,0xb2da264f
50003.17,2.0,41,2,3,2,7,0xb2d9e2cc
18133.25,1.0,4,2,2,4,8,0xb2d6a1d0
50004.45,3.0,17,2,4,2,8,0xb2d61051d
70001.27,3.0,8,3,4,3,10,0xb2d98f86
2925.76,1.0,92,2,2,1,5,0x3b9aec3f
1846.79,1.0,10,1,2,3,6,0xb2d5f8db
161909.31,3.0,3,3,4,4,11,0xb2d35f51
313897.04,4.0,157,4,4,1,9,0xb2d5ccaf
20126.93,2.0,4,2,3,4,9,0xb2d940fe
2882.27,2.0,184,1,3,1,5,0xb2d104a9
40791.67,2.0,110,2,3,1,6,0xb2d28364
94028.52,3.0,10,3,4,3,10,0xb2d4b2e2d
9.35,1.0,44,1,2,2,5,0xb2d5af37
5.28,1.0,21,1,2,2,5,0xb2da221b
1134.26,1.0,5,1,2,3,6,0xb2d932b0
538.7,1.0,10,1,2,3,6,0xb2d25631
5700.23,1.0,114,2,2,1,5,0xb2d3fefe
1658.55,1.0,184,1,2,1,4,0xb2d22fb1
0.0,1.0,6,1,2,3,6,0xb2d27fe4
10172.51,2.0,1,2,3,4,9,0xb2d5c90d
570384.73,1.0,0,4,2,4,10,0xb2d92535
70009.5,3.0,27,3,4,2,9,0xb2d8fc5f
4000011.45,6.0,4,4,4,4,12,0xb2d1527d
500645.09,4.0,39,4,4,2,10,0xb2d52a06
301065.63,2.0,8,4,3,3,10,0xb2d92f72
0.52,1.0,0,1,2,4,7,0xb2d60917
156086.98,2.0,122,3,3,1,7,0xb2d5dc0dd
55625.54,1.0,21,3,2,2,7,0xb2d1f79a
466890.96,1.0,74,4,2,1,7,0xb2d29932
30000.0,2.0,2,2,3,4,9,0xb2d53f58
4101.53,2.0,92,2,3,1,6,0x3b9b332a
7.43,1.0,3,1,2,4,7,0xb2d9556e
1.85,1.0,10,1,2,3,6,0xb2d8f2f5
8528.13,2.0,184,2,3,1,6,0x3b9b19e0d
55.78,1.0,10,1,2,3,6,0xb2d937a8
202132.01,2.0,75,3,3,1,7,0xb2d956e4
501798.78,2.0,32,4,3,2,9,0xb2d9605bd
24090.43,1.0,16,2,2,2,6,0xb2d3d63e
170459.46,1.0,17,3,2,2,7,0xb2d8fb81
40000.84,2.0,179,2,3,1,6,0xb2d6b488d
262771.65,2.0,106,3,3,1,7,0xb2d95ea8
227204.23,2.0,91,3,3,1,7,0xb2d10904
80000.84,2.0,126,3,3,1,7,0xb2d9340bd
251014.97,4.0,22,3,4,2,9,0xb2d12989
50001.06,2.0,95,2,3,1,6,0xb2d97804d
1648.09,1.0,0,1,2,4,7,0xb2d8c3c3d
10676.58,1.0,126,2,2,1,5,0xb2d08524d
1446.87,1.0,92,1,2,1,4,0xb2d29844d
0.55,1.0,8,1,2,3,6,0xb2d9338a
3.62,1.0,45,1,2,2,5,0xb2d69b85
80003.18,2.0,90,3,3,1,7,0xb2d1b162
436597.59,5.0,0,4,4,4,12,0xb2d2d13e
10958.13,1.0,12,2,2,3,7,0xb2d8e315
510664.16,2.0,126,4,3,1,8,0xb2d8a5e6
640044.52,5.0,0,4,4,4,12,0xb2d32e64d
1838.43,1.0,10,1,2,3,6,0xb2d3298f
430467.98,12.0,1,4,4,4,12,0x3b9b4383
1319.79,1.0,6,1,2,3,6,0xb2d0f524
16.68,1.0,184,1,2,1,4,0xb2d25bc2d
50151.51,4.0,174,2,4,1,7,0xb2d652e7
31247456.15,3.0,83,4,4,1,9,0xb2d13a09d
4569.28,1.0,0,2,2,4,8,0xb2d210ed
100012.52,2.0,48,3,3,2,8,0xb2d68f79
202853.03,2.0,9,3,3,3,9,0xb2d3c989d
260000.24,2.0,15,3,3,3,9,0xb2d6ef87d
16271.41,1.0,92,2,2,1,5,0xb2d309a8
10914.28,1.0,0,2,2,4,8,0xb2d8eb4e
2442.66,1.0,45,1,2,2,5,0xb2d8caa3
924770.45,6.0,1,4,4,4,12,0xb2d298e6d
331139.34,3.0,19,4,4,2,10,0xb2d210ec
19.89,1.0,32,1,2,2,5,0xb2d5c537
9.42,1.0,9,1,2,3,6,0xb2d1fa0bd
510098.51,7.0,5,4,4,3,11,0xb2d6846dd
7669.32,1.0,0,2,2,4,8,0xb2d6b610
370034.2,7.0,0,4,4,4,12,0xb2d137aed
201734.31,3.0,10,3,4,3,10,0xb2d1c22f
124779.12,1.0,194,3,2,1,6,0xb2d5896b
200033.33,2.0,0,3,3,4,10,0xb2d56479
3116.27,1.0,10,2,2,3,7,0xb2d2e78b
102350.19,2.0,137,3,3,1,7,0xb2d3825ad
1200017.69,5.0,10,4,4,3,11,0xb2d609c5d
400000.0,2.0,7,4,3,3,10,0xb2d96fd2d
501507.59,3.0,61,4,4,2,10,0xb2d1678b
3075.83,1.0,0,2,2,4,8,0xb2d06f8c
61424.86,3.0,53,3,4,2,9,0xb2d14eafd
50131.05,3.0,0,2,4,4,10,0xb2d06977
2939.82,1.0,92,2,2,1,5,0xb2d3ac5b
10484.34,2.0,25,2,3,2,7,0xb2da0ef8
90002.85,2.0,80,3,3,1,7,0xb2d98b4c
51486.7,2.0,137,2,3,1,6,0xb2d5aca3d
12605.54,1.0,1,2,2,4,8,0xb2d20678
50078.8,1.0,1,2,2,4,8,0xb2da3254
651056.82,8.0,27,4,4,2,10,0xb2d45c4dd
10000000.0,3.0,8,4,4,3,11,0xb2da0684
351005.98,3.0,18,4,4,2,10,0xb2d0dbf3
185696.14,2.0,20,3,3,2,8,0xb2d1a942d
15044.66,1.0,0,2,2,4,8,0xb2d6ecb1
118917.44,2.0,7,3,3,3,9,0xb2d11080d
190000.0,4.0,1,3,4,4,11,0xb2d16ae9
40129.44,3.0,34,2,4,2,8,0xb2d5cb45d
50063.83,8.0,2,2,4,4,10,0xb2d093fdd
768721.14,6.0,13,4,4,3,11,0xb2d5c2d4
152070.94,3.0,70,3,4,1,8,0xb2d463b2d
20471.1,3.0,67,2,4,1,7,0xb2d5a9be
10241.87,2.0,10,2,3,3,8,0xb2d5b74c
2502293.02,3.0,48,4,4,2,10,0xb2d11b83
1768600.22,3.0,27,4,4,2,10,0xb2d57e6c
20039.22,1.0,54,2,2,2,6,0xb2d34c82d
10241.7,2.0,0,2,3,4,9,0xb2d6992fd
3253.76,2.0,1,2,3,4,9,0xb2d0763ed
230011.25,7.0,8,3,4,3,10,0xb2d0e639d
100014.28,2.0,0,3,3,4,10,0xb2d3f43c
200075.27,2.0,22,3,3,2,8,0xb2d5ac19
79616.76,4.0,0,3,4,4,11,0xb2d0d52c
36.81,1.0,20,1,2,2,5,0xb2d8f117
330036.54,4.0,6,4,4,3,11,0xb2d6fa9c
67763.26,1.0,3,3,2,4,9,0xb2d55db1
500000.02,3.0,20,4,4,2,10,0xb2d953d2
512717.14,3.0,38,4,4,2,10,0xb2d11731
1388.94,1.0,167,1,2,1,4,0xb2d10b16d
3814.39,1.0,30,2,2,2,6,0xb2d5b1ca
5.55,1.0,21,1,2,2,5,0xb2d823ed
590183.71,5.0,48,4,4,2,10,0xb2d1cdf2
134.83,1.0,4,1,2,4,7,0xb2d9ada9
246.78,1.0,53,1,2,2,5,0xb2d5e9b2d
459129.72,4.0,3,4,4,4,12,0xb2d45f66
1731.63,1.0,92,1,2,1,4,0xb2d1e640d
1.69,1.0,38,1,2,2,5,0xb2d5355b
0.0,1.0,75,1,2,1,4,0xb2d6ba66d
8830.57,1.0,158,2,2,1,5,0xb2d680ab
50006.27,2.0,123,2,3,1,6,0xb2d21438d
786729.88,8.0,36,4,4,2,10,0xb2d0b028d
2019.85,1.0,184,1,2,1,4,0xb2d34ba7
606.13,2.0,0,1,3,4,8,0xb2d0898d
2351627.56,3.0,63,4,4,2,10,0xb2d441a8d
47407.52,1.0,92,2,2,1,5,0x3b9b2b00d
653.69,1.0,20,1,2,2,5,0xb2d40278
201500.0,2.0,1,3,3,4,10,0xb2da654b
3503.0,1.0,88,2,2,1,5,0xb2d93984
900017.76,3.0,5,4,4,3,11,0xb2d8f1c2d
161504.04,1.0,2,3,2,4,9,0xb2d58cd9d
34.0,1.0,52,1,2,2,5,0xb2d8d75e
1316726.07,14.0,10,4,4,3,11,0x3b9b0fd6d
440190.69,6.0,4,4,4,4,12,0xb2d57965
1114.51,1.0,92,1,2,1,4,0xb2d1dd64d
189.99,1.0,31,1,2,2,5,0xb2d6e8e4
30020.54,3.0,45,2,4,2,8,0xb2d90ea2d
193733.8,5.0,0,3,4,4,11,0xb2d15ff5d
530.09,1.0,98,1,2,1,4,0xb2d2cf43
165776.69,3.0,0,3,4,4,11,0xb2d3ec04d
1426.78,1.0,0,1,2,4,7,0xb2d21216
500000.21,2.0,1,4,3,4,11,0xb2d589c6
10333.1,1.0,159,2,2,1,5,0xb2d5da27d
5.69,1.0,109,1,2,1,4,0xb2d156fa
4710.16,1.0,59,2,2,2,6,0xb2d3a6f4
100008.48,3.0,76,3,4,1,8,0xb2d29c91
363088.66,4.0,42,4,4,2,10,0xb2d17753d
431667.31,1.0,0,4,2,4,10,0xb2d1258d
300524.23,4.0,38,4,4,2,10,0xb2d1a25d
15281.84,2.0,199,2,3,1,6,0xb2d5d471
1944.01,1.0,16,1,2,2,5,0xb2d3515fd
402106.85,7.0,0,4,4,4,12,0xb2d12939d
411649.28,7.0,28,4,4,2,10,0xb2d3c54fd
3783.87,1.0,0,2,2,4,8,0xb2d6bb6ad
0.77,1.0,5,1,2,3,6,0xb2d68c4f
136554.54,1.0,52,3,2,2,7,0xb2d4b15d
53813.72,1.0,10,3,2,3,8,0xb2d6a41dd
206.87,1.0,4,1,2,4,7,0xb2d3d5b0
200000.0,2.0,11,3,3,3,9,0xb2da4d62
539358.91,2.0,168,4,3,1,8,0xb2d39110
0.0,1.0,8,1,2,3,6,0xb2d42318
2031.98,1.0,92,1,2,1,4,0xb2d0d655d
1016749.26,8.0,21,4,4,2,10,0xb2d633efd
87.19,1.0,56,1,2,2,5,0xb2d91252
164.98,1.0,9,1,2,3,6,0xb2d90b85
400658.45,3.0,0,4,4,4,12,0xb2d982dad
136715.1,4.0,14,3,4,3,10,0x3b9af4f2
1002.92,1.0,287,1,2,1,4,0xb2d69e4e
30259.7,1.0,92,2,2,1,5,0xb2d2bf2bd
200710.52,2.0,54,3,3,2,8,0xb2d9cfcc
500000.0,1.0,0,4,2,4,10,0xb2d97813
357.7,1.0,9,1,2,3,6,0xb2d8c86c
50113.72,2.0,122,2,3,1,6,0xb2d417f6d
83575.39,1.0,184,3,2,1,6,0xb2d070cb
20155.69,1.0,78,2,2,1,5,0xb2d0bf3a
165170.49,2.0,8,3,3,3,9,0xb2d3a66dd
2092188.74,20.0,0,4,4,4,12,0xb2d11744
870.89,1.0,24,1,2,2,5,0xb2d254fd
2117.92,1.0,92,1,2,1,4,0x3b9b2d1fd
501776.04,2.0,32,4,3,2,9,0xb2d8f740
92011.68,1.0,190,3,2,1,6,0xb2d1b768d
22092.34,1.0,0,2,2,4,8,0xb2d95b04
54.96,2.0,3,1,3,4,8,0xb2d236be
100071.81,2.0,95,3,3,1,7,0xb2d57aa1
60075.09,2.0,42,3,3,2,8,0xb2d273eb
258111.74,3.0,0,3,4,4,11,0xb2d50160
473000.65,4.0,5,4,4,3,11,0xb2d6c3c3
500000.0,2.0,11,4,3,3,10,0xb2d966a2
157612.05,1.0,92,3,2,1,6,0xb2d4527a
2000029.46,3.0,15,4,4,3,11,0xb2d6f45b
1720096.63,16.0,4,4,4,4,12,0xb2d0b392
202424.08,3.0,18,3,4,2,9,0xb2d62e31d
460000.42,3.0,4,4,4,4,12,0xb2d8e65e
5466.37,1.0,0,2,2,4,8,0xb2d3ca63
123.05,1.0,35,1,2,2,5,0xb2d92030
159.57,1.0,7,1,2,3,6,0xb2d8dafd
1138857.27,13.0,70,4,4,1,9,0xb2d30c2c
13.62,1.0,45,1,2,2,5,0xb2d91137
190381.52,3.0,0,3,4,4,11,0xb2d06950d
1924.32,1.0,1,1,2,4,7,0xb2d5dd03d
242129.0,7.0,0,3,4,4,11,0xb2d41a9c
312655.08,2.0,17,4,3,2,9,0xb2d407a3d
201574.92,2.0,95,3,3,1,7,0xb2d56e5dd
100000.0,5.0,0,3,4,4,11,0xb2d2b29e
22454.12,3.0,0,2,4,4,10,0xb2d6c218d
58195.69,3.0,31,3,4,2,9,0xb2d1c4a3
48.39,1.0,0,1,2,4,7,0xb2d3b3b4d
480001.75,3.0,16,4,4,2,10,0xb2d9184ed
25288.4,1.0,21,2,2,2,6,0xb2d5350b
31326.49,1.0,13,2,2,3,7,0xb2d98b35
4.65,1.0,48,1,2,2,5,0xb2d8c608
18930.51,2.0,92,2,3,1,6,0xb2d08ecf
1276801.32,5.0,0,4,4,4,12,0xb2d0db7d
5511.87,2.0,92,2,3,1,6,0x3b9ace5d
5658.06,1.0,1,2,2,4,8,0xb2d23ccc
1728.77,1.0,92,1,2,1,4,0xb2d3e5b5
600731.56,7.0,18,4,4,2,10,0xb2d43385d
748.26,1.0,19,1,2,2,5,0xb2d204f5d
1006.27,1.0,7,1,2,3,6,0xb2d2c66f
167.84,9.0,40,1,4,2,7,0x3b9b43ca
3.73,1.0,17,1,2,2,5,0xb2d69094
10.61,1.0,63,1,2,2,5,0xb2d25d1e
500105.28,2.0,8,4,3,3,10,0xb2da47ec
53.37,1.0,25,1,2,2,5,0xb2d6ff8dd
23.6,1.0,9,1,2,3,6,0xb2d37e34
552318.23,6.0,4,4,4,4,12,0xb2d2f7d9d
350046.68,3.0,1,4,4,4,12,0xb2d90773d
1000353.79,9.0,0,4,4,4,12,0xb2d0c54c
72718.43,3.0,16,3,4,2,9,0xb2d0f44ad
750000.41,4.0,20,4,4,2,10,0xb2d6ee24
110.01,1.0,89,1,2,1,4,0xb2d14f9e
100005.77,2.0,111,3,3,1,7,0xb2d626add
260009.99,4.0,10,3,4,3,10,0xb2d58fa7
184.96,1.0,7,1,2,3,6,0xb2d21015
220384.42,13.0,0,3,4,4,11,0x3b9b4622
42705.06,3.0,11,2,4,3,9,0xb2d53829
179429.32,1.0,3,3,2,4,9,0xb2d2ecd8
613746.25,3.0,78,4,4,1,9,0xb2d69698
28022.58,1.0,0,2,2,4,8,0xb2d309f6
60001.53,2.0,117,3,3,1,7,0xb2d691ddd
11151.46,1.0,92,2,2,1,5,0x3b9b171c
936.28,1.0,10,1,2,3,6,0xb2d58ee7
1961.16,1.0,67,1,2,1,4,0xb2d8ee4a
3159.35,1.0,0,2,2,4,8,0xb2d57a89d
40104.41,3.0,0,2,4,4,10,0xb2d64a8fd
35652.87,1.0,67,2,2,1,5,0xb2d10191d
104026.97,3.0,20,3,4,2,9,0xb2d2a29a
500034.79,3.0,92,4,4,1,9,0xb2d0ac2fd
30.88,1.0,3,1,2,4,7,0xb2d8c627
86.0,1.0,89,1,2,1,4,0xb2d59c6b
108506.29,2.0,31,3,3,2,8,0xb2d68336d
53290.77,5.0,0,3,4,4,11,0xb2d3969ad
142880.03,1.0,173,3,2,1,6,0xb2d636bd
404.69,1.0,13,1,2,3,6,0xb2d9cc12
400000.03,2.0,11,4,3,3,10,0xb2d22ef4
57897.8,2.0,18,3,3,2,8,0xb2d2952ad
10001.18,2.0,221,2,3,1,6,0xb2d5538c
370008.92,10.0,10,4,4,3,11,0xb2d0af70
775081.85,8.0,53,4,4,2,10,0xb2d6bc0bd
14000.26,1.0,0,2,2,4,8,0xb2d3455e
188022.61,1.0,250,3,2,1,6,0xb2d3c4c7
14368.18,1.0,92,2,2,1,5,0xb2d2eb71
52548.57,2.0,0,3,3,4,10,0xb2d28e2ed
286014.71,4.0,1,3,4,4,11,0xb2da33e3
400025.54,5.0,97,4,4,1,9,0xb2d1fbeed
684022.36,5.0,14,4,4,3,11,0xb2d6476ad
270000.0,3.0,8,3,4,3,10,0xb2d21fe3
6917.18,3.0,112,2,4,1,7,0x3b9b3e66d
200652.74,2.0,3,3,3,4,10,0xb2d8ef1cd
647.32,1.0,2,1,2,4,7,0xb2d2f880d
4015.83,1.0,107,2,2,1,5,0xb2d4d1c0
1015.06,1.0,184,1,2,1,4,0xb2d1327fd
9092.39,1.0,92,2,2,1,5,0xb2d30617d
3.72,1.0,40,1,2,2,5,0xb2d29c53d
130001.91,6.0,49,3,4,2,9,0xb2d86837d
10006.97,1.0,75,2,2,1,5,0xb2d8c3e3
24.28,1.0,50,1,2,2,5,0xb2d883e9
85000.9,2.0,1,3,3,4,10,0xb2d95144d
11193.38,1.0,92,2,2,1,5,0xb2d2daef
6664.58,1.0,92,2,2,1,5,0xb2d2df48
842249.11,4.0,11,4,4,3,11,0xb2d0fc29d
120001.27,2.0,27,3,3,2,8,0xb2d261d9
54187.96,1.0,24,3,2,2,7,0xb2d5db83
120052.23,4.0,3,3,4,4,11,0xb2d252b9d
20000.84,2.0,92,2,3,1,6,0xb2d648f6d
4783.18,1.0,2,2,2,4,8,0xb2d6a9c1d
200232.22,4.0,21,3,4,2,9,0xb2d7840b
6701.46,1.0,184,2,2,1,5,0xb2d1537dd
50684.31,2.0,62,2,3,2,7,0xb2d5cb46
3417.23,1.0,266,2,2,1,5,0xb2d5f329d
1717.89,1.0,0,1,2,4,7,0xb2d6e5b1
420035.27,2.0,80,4,3,1,8,0xb2d5a614
128879.39,3.0,32,3,4,2,9,0xb2d3047d
8380.14,2.0,184,2,3,1,6,0xb2d0e820d
82256.06,2.0,206,3,3,1,7,0xb2d54064
1741.51,1.0,120,1,2,1,4,0xb2d25f66
171767.9,2.0,0,3,3,4,10,0xb2d5ff67
765078.35,14.0,0,4,4,4,12,0xb2d170dd
2633.83,1.0,10,1,2,3,6,0xb2d3a7f7
530012.81,4.0,1,4,4,4,12,0xb2d62304
56002.49,2.0,101,3,3,1,7,0xb2d5d1f1d
600093.55,4.0,12,4,4,3,11,0xb2d6076dd
309083.17,5.0,1,4,4,4,12,0xb2d4518d
80340.02,1.0,184,3,2,1,6,0xb2d0916ad
483584.89,3.0,32,4,4,2,10,0xb2d5947bd
21.83,1.0,10,1,2,3,6,0xb2d8eba8
1900.26,1.0,26,1,2,2,5,0xb2d17e93
30000.95,2.0,92,2,3,1,6,0xb2d97d1e
2002055.44,1.0,1,4,2,4,10,0xb2d6abbbd
240303.44,5.0,69,3,4,1,8,0xb2d196e6d
94.17,1.0,9,1,2,3,6,0xb2d749ff
124294.96,1.0,7,3,2,3,8,0xb2d62795
4350.39,1.0,13,2,2,3,7,0xb2d27500
2902384.99,6.0,8,4,4,3,11,0x3b9b32b3
155595.02,4.0,13,3,4,3,10,0xb2d5d88ad
226263.61,3.0,0,3,4,4,11,0xb2d09c64
400511.84,3.0,0,4,4,4,12,0xb2d683ff
271053.51,9.0,25,3,4,2,9,0xb2d6c535d
1509.67,1.0,92,1,2,1,4,0xb2d34652d
421590.8,5.0,41,4,4,2,10,0xb2d083e2
125009.85,2.0,92,3,3,1,7,0xb2d3e2ca
520051.09,2.0,49,4,3,2,9,0xb2d62147
6871.82,1.0,0,2,2,4,8,0xb2d386b9d
12.62,1.0,0,1,2,4,7,0xb2d211bf
55493.23,1.0,82,3,2,1,6,0xb2d14069
442063.64,3.0,5,4,4,3,11,0xb2d6d094d
818067.13,3.0,94,4,4,1,9,0xb2d65c9b
1380.27,1.0,9,1,2,3,6,0xb2d68412d
460130.14,5.0,3,4,4,4,12,0xb2d6ed1bd
1926.61,1.0,11,1,2,3,6,0xb2d3ecdb
1170076.68,12.0,4,4,4,4,12,0xb2d5b05cd
33007.01,3.0,38,2,4,2,8,0xb2d3c785d
7912.41,1.0,4,2,2,4,8,0xb2da3b5a
1226896.34,9.0,3,4,4,4,12,0xb2d249bb
500000.0,2.0,1,4,3,4,11,0xb2d8f793d
300000.0,2.0,22,3,3,2,8,0xb2da2360
789.75,1.0,5,1,2,3,6,0xb2d408d6d
201446.65,2.0,59,3,3,2,8,0xb2d716f8
251422.06,4.0,64,3,4,2,9,0xb2d8df8f
50070.22,1.0,142,2,2,1,5,0xb2d6cd81d
350076.26,5.0,110,4,4,1,9,0xb2d18a37d
1954.09,1.0,260,1,2,1,4,0xb2d344a6d
25.31,1.0,9,1,2,3,6,0xb2d52657
8003.65,1.0,0,2,2,4,8,0xb2d22cd4
4542.67,1.0,8,2,2,3,7,0xb2d438ce
20011.71,1.0,0,2,2,4,8,0xb2d5d7d5
850000.05,2.0,6,4,3,3,10,0xb2d944b5d
661008.06,12.0,0,4,4,4,12,0xb2d4a6ae
30311.17,1.0,12,2,2,3,7,0xb2d2b360d
250001.18,2.0,16,3,3,2,8,0xb2d6cf79d
450048.61,3.0,2,4,4,4,12,0xb2d8b0b2d
73298.07,1.0,26,3,2,2,7,0xb2d31aabd
41441.57,2.0,76,2,3,1,6,0xb2d5ec79d
5799.0,1.0,9,2,2,3,7,0xb2d77fce
2907.21,1.0,6,2,2,3,7,0xb2d4e562
120198.57,2.0,0,3,3,4,10,0xb2d3c13a
711076.55,5.0,0,4,4,4,12,0xb2d63764
293091.62,2.0,111,3,3,1,7,0xb2d9586dd
568701.57,10.0,10,4,4,3,11,0xb2d6b612
9.36,1.0,0,1,2,4,7,0xb2d4c247
580000.84,8.0,4,4,4,4,12,0xb2d0b9c8d
32004.57,4.0,41,2,4,2,8,0xb2d5e780
903841.13,3.0,56,4,4,2,10,0xb2d21461
70005.83,2.0,132,3,3,1,7,0xb2d1acf6
230928.73,2.0,18,3,3,2,8,0xb2d60e35
4.01,1.0,78,1,2,1,4,0xb2d6895c
0.0,2.0,1,1,3,4,8,0xb2da2ec5
554929.62,4.0,25,4,4,2,10,0xb2d78ddbd
150006.33,2.0,45,3,3,2,8,0xb2d914a8
7232.45,1.0,28,2,2,2,6,0xb2d69770
6168.7,1.0,5,2,2,3,7,0xb2d6c707
25279.65,1.0,2,2,2,4,8,0xb2d6b13a
176472.87,1.0,0,3,2,4,9,0xb2d6b0bc
203554.49,2.0,75,3,3,1,7,0xb2d8e3f2d
25.01,2.0,0,1,3,4,8,0xb2d2bf0ed
19629.91,1.0,0,2,2,4,8,0xb2d1d9d9d
170003.91,3.0,3,3,4,4,11,0xb2d33575
43267.64,2.0,41,2,3,2,7,0xb2d09207d
930563.4,3.0,3,4,4,4,12,0xb2d4a263
39214.07,1.0,9,2,2,3,7,0xb2d58662d
117073.56,6.0,0,3,4,4,11,0xb2d33140d
224464.31,51.0,0,3,4,4,11,0xb2d09f01
5312593.81,11.0,11,4,4,3,11,0xb2d14fd7
9053.81,1.0,28,2,2,2,6,0xb2d82271
123016.7,4.0,151,3,4,1,8,0xb2d59146
30000.0,3.0,8,2,4,3,9,0xb2d54f14
230011.75,2.0,20,3,3,2,8,0xb2d26667
4.83,1.0,48,1,2,2,5,0xb2d0a788
330501.45,4.0,92,4,4,1,9,0xb2d44601d
307235.56,3.0,25,4,4,2,10,0xb2d10d54
100002.11,2.0,92,3,3,1,7,0xb2d67d7fd
6108.36,2.0,0,2,3,4,9,0xb2d08efd
1104523.66,5.0,0,4,4,4,12,0xb2d11f67
2.96,1.0,26,1,2,2,5,0xb2d464e0
513713.76,2.0,31,4,3,2,9,0xb2d59c12
200000.0,2.0,29,3,3,2,8,0xb2da0ab1
50001.8,3.0,18,2,4,2,8,0xb2d691f1
127844.78,2.0,21,3,3,2,8,0x3b9af19bd
200108.5,2.0,56,3,3,2,8,0xb2d56edd
150001.58,2.0,47,3,3,2,8,0xb2d91562
600021.85,5.0,73,4,4,1,9,0xb2d4dd38
400088.98,3.0,75,4,4,1,9,0xb2d174d8d
690006.92,8.0,4,4,4,4,12,0xb2d1d0bf
300747.97,2.0,10,4,3,3,10,0xb2d9d79d
39113.68,1.0,184,2,2,1,5,0xb2d1b51bd
500090.58,4.0,4,4,4,4,12,0xb2d6454dd
6890.09,1.0,6,2,2,3,7,0xb2d23e3f
70005.97,3.0,123,3,4,1,8,0x3b9adbfa
213319.27,3.0,11,3,4,3,10,0xb2d15ed4
293.69,1.0,1,1,2,4,7,0xb2d62385
4996.63,2.0,92,2,3,1,6,0xb2d2974d
270038.89,3.0,20,3,4,2,9,0xb2d36332
25461.92,1.0,3,2,2,4,8,0xb2d2b5dc
182061.91,2.0,158,3,3,1,7,0xb2d6bf11
350022.79,6.0,31,4,4,2,10,0xb2d084b5
12436.23,1.0,3,2,2,4,8,0xb2d0c2f2
1363.07,1.0,157,1,2,1,4,0xb2d4f1aa
2015.55,2.0,117,1,3,1,5,0xb2d28641
732647.12,4.0,4,4,4,4,12,0xb2d2d34cd
300018.07,2.0,8,3,3,3,9,0xb2d6d481
204330.41,2.0,58,3,3,2,8,0xb2d22a8e
2134.79,2.0,92,1,3,1,5,0xb2d0915c
57900.0,1.0,2,3,2,4,9,0xb2d228d9
891.42,1.0,21,1,2,2,5,0xb2d2a273
4742.34,1.0,11,2,2,3,7,0xb2d35243d
20000.21,2.0,18,2,3,2,7,0xb2da2f97
1913.38,1.0,105,1,2,1,4,0xb2d6b8a8d
315.35,1.0,13,1,2,3,6,0xb2d1db0bd
4302.03,1.0,92,2,2,1,5,0xb2d1b876
10500.0,1.0,5,2,2,3,7,0xb2d309cd
360005.21,3.0,23,4,4,2,10,0xb2d17a4fd
94.79,1.0,9,1,2,3,6,0xb2d3abc3
30001.27,2.0,25,2,3,2,7,0xb2da0cc9
155820.72,4.0,20,3,4,2,9,0xb2d45552d
433488.68,4.0,221,4,4,1,9,0xb2d3c962
500009.52,2.0,140,4,3,1,8,0xb2d9133d
280035.86,4.0,1,3,4,4,11,0xb2d0d1d9d
40087.03,2.0,92,2,3,1,6,0x3b9ae614
6102.1,1.0,0,2,2,4,8,0xb2d98911
313980.05,15.0,0,4,4,4,12,0xb2d28374d
714913.37,5.0,25,4,4,2,10,0xb2d0855e
182200.11,1.0,12,3,2,3,8,0xb2d31e88
2749.46,1.0,92,1,2,1,4,0xb2d073f2d
25073.01,2.0,89,2,3,1,6,0xb2d0bb98
0.99,1.0,3,1,2,4,7,0xb2d1fab9
90530.77,1.0,0,3,2,4,9,0xb2d18d4b
5035841.6,2.0,77,4,3,1,8,0xb2d99784
10939.59,1.0,0,2,2,4,8,0xb2d3cbb5d
150001.66,2.0,44,3,3,2,8,0xb2d41170
100050.72,2.0,3,3,3,4,10,0xb2d4e407
39.72,2.0,6,1,3,3,7,0xb2d12cf1
150000.0,1.0,0,3,2,4,9,0xb2d965f3
311108.17,2.0,28,4,3,2,9,0xb2d6b0bf
545081.68,22.0,1,4,4,4,12,0xb2d0b646
370292.15,2.0,3,4,3,4,11,0xb2d15565d
5740.72,1.0,6,2,2,3,7,0xb2d62d78
101006.18,2.0,229,3,3,1,7,0xb2d61235
201221.89,5.0,48,3,4,2,9,0xb2d3fa98
984326.21,5.0,39,4,4,2,10,0xb2d939e9d
0.0,1.0,0,1,2,4,7,0xb2d35bf0
500000.0,2.0,5,4,3,3,10,0xb2d97b3d
65087.64,3.0,48,3,4,2,9,0xb2d43ea9d
303200.5,2.0,82,4,3,1,8,0xb2d7bebe
449537.22,5.0,14,4,4,3,11,0xb2d64acf
140.86,1.0,0,1,2,4,7,0xb2d4cbb7
334319.27,5.0,4,4,4,4,12,0xb2d06c19
1612.19,1.0,92,1,2,1,4,0xb2d42c9a
2185.76,1.0,9,1,2,3,6,0xb2d78a99d
281830.32,6.0,4,3,4,4,11,0xb2d1db95
4006.21,2.0,92,2,3,1,6,0xb2d0724dd
2473078.1,5.0,14,4,4,3,11,0xb2d29466
1257.68,1.0,10,1,2,3,6,0xb2d5e147
1.57,1.0,26,1,2,2,5,0xb2d54c9e
1753.79,1.0,32,1,2,2,5,0xb2d3e69d
130012.76,2.0,80,3,3,1,7,0xb2d59e06
449.67,1.0,9,1,2,3,6,0xb2d96317
60444.71,5.0,14,3,4,3,10,0xb2d9e74a
1370100.0,7.0,7,4,4,3,11,0xb2d5d5ba
100724.44,1.0,57,3,2,2,7,0xb2d8da1a
65005.56,4.0,5,3,4,3,10,0xb2d6c7e4
300038.53,2.0,11,3,3,3,9,0xb2d966d7d
6059.55,1.0,92,2,2,1,5,0xb2d29802
80000.0,5.0,4,3,4,4,11,0xb2d244b7d
2049.75,1.0,0,1,2,4,7,0xb2d210aed
948137.54,11.0,11,4,4,3,11,0xb2d11558d
867015.5,3.0,52,4,4,2,10,0xb2d690cdd
104466.41,2.0,9,3,3,3,9,0xb2d638ee
16.78,1.0,35,1,2,2,5,0xb2d9f184
210.1,1.0,12,1,2,3,6,0xb2d33764
101605.77,6.0,10,3,4,3,10,0xb2d6f4fad
10072.67,2.0,2,2,3,4,9,0xb2d9b005
50744.33,1.0,3,2,2,4,8,0xb2d37d33
259.97,1.0,26,1,2,2,5,0xb2d2bce2
1037745.74,8.0,6,4,4,3,11,0xb2d23ac2d
251776.24,2.0,61,3,3,2,8,0xb2d8fdbcd
53863.26,2.0,158,3,3,1,7,0xb2d38856d
85006.13,4.0,11,3,4,3,10,0xb2d2fdba
3807.48,1.0,9,2,2,3,7,0xb2d3f583d
450096.41,2.0,6,4,3,3,10,0xb2d598a4d
509.85,1.0,4,1,2,4,7,0xb2d203ea
929584.13,6.0,4,4,4,4,12,0xb2d64d72
134922.51,1.0,11,3,2,3,8,0xb2d3c726
1250.05,2.0,92,1,3,1,5,0x3b9b1637
300038.59,3.0,11,3,4,3,10,0xb2d2206bd
784.42,1.0,14,1,2,3,6,0xb2d3c4ba
1488.22,1.0,9,1,2,3,6,0xb2d2e4fe
4271.86,1.0,20,2,2,2,6,0xb2d38c8a
445025.88,3.0,0,4,4,4,12,0xb2d6ee34
602615.08,6.0,104,4,4,1,9,0xb2d4e826
27.69,1.0,1,1,2,4,7,0xb2d1d036
5032.44,2.0,130,2,3,1,6,0xb2d45aa5d
120012.72,3.0,60,3,4,2,9,0xb2d41a20
300013.55,4.0,59,3,4,2,9,0xb2d59587d
20.05,3.0,15,1,4,3,8,0x3b9b2678
0.0,1.0,57,1,2,2,5,0xb2d2baee
33.38,1.0,0,1,2,4,7,0xb2d62d11
5421600.74,6.0,39,4,4,2,10,0xb2d11956d
175346.99,4.0,154,3,4,1,8,0xb2d41008d
19969.21,1.0,54,2,2,2,6,0xb2d6c6ff
1059.86,1.0,184,1,2,1,4,0xb2d3356a
116008.58,3.0,1,3,4,4,11,0xb2d4eb29d
9355.66,1.0,4,2,2,4,8,0xb2d8215ed
360000.43,2.0,20,4,3,2,9,0xb2d68ae2
500000.0,4.0,4,4,4,4,12,0xb2d5b6dbd
430043.2,5.0,3,4,4,4,12,0xb2d15286d
1007.62,1.0,92,1,2,1,4,0xb2d10104d
344.13,1.0,1,1,2,4,7,0xb2d1d615
323225.81,2.0,0,4,3,4,11,0xb2d6c9c4d
207099.0,1.0,184,3,2,1,6,0xb2d0b844
73155.22,3.0,0,3,4,4,11,0xb2d67d9c
45.73,1.0,34,1,2,2,5,0xb2d3c75c
110181.86,2.0,52,3,3,2,8,0xb2d6c134d
7178.99,1.0,92,2,2,1,5,0xb2d1374d
4503.58,1.0,273,2,2,1,5,0xb2d2b1afd
736.85,1.0,12,1,2,3,6,0xb2d18164d
525029.13,3.0,82,4,4,1,9,0xb2d231bd
325000.2,8.0,20,4,4,2,10,0xb2d46822
420072.32,3.0,22,4,4,2,10,0xb2d6e4ad
411394.97,2.0,258,4,3,1,8,0xb2d6c99d
120868.8,5.0,66,3,4,2,9,0xb2d5e588
550870.92,3.0,7,4,4,3,11,0xb2d62f78
203241.65,2.0,33,3,3,2,8,0xb2d759a1d
190005.52,3.0,23,3,4,2,9,0xb2d65df2
1171.87,1.0,159,1,2,1,4,0xb2d8edcc
52044.19,1.0,2,2,2,4,8,0xb2d23a96d
376045.43,5.0,1,4,4,4,12,0xb2d659add
616.13,1.0,10,1,2,3,6,0xb2d3beb3
457210.68,4.0,14,4,4,3,11,0xb2d7aae4d
350005.37,6.0,52,4,4,2,10,0xb2d1184c
3916.27,1.0,0,2,2,4,8,0xb2d2cfe0d
50000.74,3.0,53,2,4,2,8,0xb2d9cc7a
10219.84,1.0,13,2,2,3,7,0xb2d68d3c
213261.72,2.0,75,3,3,1,7,0xb2d3ba9f
3852.07,1.0,9,2,2,3,7,0xb2d28d6c
60736.01,2.0,192,3,3,1,7,0xb2d5b841d
304615.85,2.0,129,4,3,1,8,0xb2d42617
7440.99,1.0,24,2,2,2,6,0xb2d19cb2
6387.83,1.0,11,2,2,3,7,0xb2d6f2e5
8397.67,1.0,9,2,2,3,7,0xb2d32f57d
344.53,1.0,9,1,2,3,6,0xb2d22062
48000.63,1.0,3,2,2,4,8,0xb2d93ef6
654777.33,4.0,103,4,4,1,9,0xb2d50b14d
371336.84,11.0,67,4,4,1,9,0xb2d2139a
1162.62,1.0,17,1,2,2,5,0xb2d26adbd
232009.89,3.0,35,3,4,2,9,0xb2d26ba9
3822.42,1.0,0,2,2,4,8,0xb2d780de
0.6,1.0,20,1,2,2,5,0xb2d5d410
31221.97,3.0,53,2,4,2,8,0xb2d285dc
29105.21,3.0,58,2,4,2,8,0xb2d0e263
487024.66,2.0,3,4,3,4,11,0xb2d30c97d
20364.4,2.0,199,2,3,1,6,0xb2d5c0f0d
327010.79,5.0,76,4,4,1,9,0xb2d58cd3
197599.83,8.0,0,3,4,4,11,0x3b9b1276d
130088.35,1.0,7,3,2,3,8,0xb2d42002
145200.0,4.0,2,3,4,4,11,0xb2d53367
319921.92,2.0,143,4,3,1,8,0xb2d1b3ed
0.92,1.0,0,1,2,4,7,0xb2d3c46e
462352.16,14.0,14,4,4,3,11,0xb2d4e146
38.35,1.0,1,1,2,4,7,0xb2d4cc83
2111.67,1.0,12,1,2,3,6,0xb2d61559d
268.23,1.0,1,1,2,4,7,0xb2d8ff05d
10107.99,1.0,184,2,2,1,5,0xb2d29a99
427002.99,3.0,10,4,4,3,11,0xb2d8dc3ad
40000.17,2.0,0,2,3,4,9,0xb2d9ac47
330003.03,3.0,31,4,4,2,10,0xb2d4b337
376075.62,5.0,10,4,4,3,11,0xb2d16b37d
10055.87,1.0,92,2,2,1,5,0xb2d43a4a
50002.11,3.0,98,2,4,1,7,0xb2d96cd4d
701354.28,2.0,6,4,3,3,10,0xb2d0c518
7533.95,1.0,119,2,2,1,5,0xb2d6b789d
30703.77,1.0,0,2,2,4,8,0xb2d27197d
520068.74,7.0,95,4,4,1,9,0xb2d10ac2
51372.32,2.0,184,2,3,1,6,0x3b9b2e12
50039.24,2.0,76,2,3,1,6,0xb2d12ca1
31908.64,2.0,6,2,3,3,8,0xb2da1a70
1500124.94,2.0,77,4,3,1,8,0xb2d3c75cd
1016.54,1.0,93,1,2,1,4,0xb2d2e00dd
15772.11,2.0,0,2,3,4,9,0xb2d06b71d
2100049.36,1.0,0,4,2,4,10,0xb2d5874a
5213.43,1.0,17,2,2,2,6,0xb2d122e6
2125.81,1.0,8,1,2,3,6,0xb2d604e2
7127.93,1.0,92,2,2,1,5,0xb2d14600
213.72,1.0,0,1,2,4,7,0xb2d67ebc
4117770.14,9.0,1,4,4,4,12,0xb2d0da56d
73466.82,1.0,1,3,2,4,9,0xb2d58efbd
206141.28,3.0,0,3,4,4,11,0xb2d5cb93
49.15,1.0,2,1,2,4,7,0xb2d2a079
570006.02,2.0,27,4,3,2,9,0xb2d9420ad
100069.58,7.0,20,3,4,2,9,0xb2d0785a
301001.15,4.0,7,4,4,3,11,0xb2d4fbe2
4904.32,1.0,1,2,2,4,8,0xb2d6fe6a
112007.66,3.0,27,3,4,2,9,0xb2d1daf9
122341.03,2.0,139,3,3,1,7,0xb2d5b795d
260106.55,4.0,189,3,4,1,8,0xb2d5875d
90207.28,5.0,4,3,4,4,11,0xb2d564f5d
403000.0,4.0,4,4,4,4,12,0xb2d63c03d
830972.45,5.0,1,4,4,4,12,0xb2d4f7b0d
2812.19,1.0,8,1,2,3,6,0xb2d6f26a
0.0,6.0,10,1,4,3,8,0xb2d1f323
3112065.73,2.0,80,4,3,1,8,0xb2d5c472
87513.78,2.0,228,3,3,1,7,0xb2d297add
501776.19,2.0,18,4,3,2,9,0xb2d916ff
100002.11,2.0,24,3,3,2,8,0xb2d94787d
170058.49,3.0,60,3,4,2,9,0xb2d24fc3
206698.89,1.0,0,3,2,4,9,0xb2d0d7d1
37.2,1.0,105,1,2,1,4,0xb2d445a4d
500004.3,2.0,34,4,3,2,9,0xb2d25564
281.31,1.0,0,1,2,4,7,0xb2d6c5d8d
7879.58,1.0,167,2,2,1,5,0xb2d3f8fed
1503.5,1.0,0,1,2,4,7,0xb2d6063bd
43.06,1.0,8,1,2,3,6,0xb2d5ff31
5002.21,1.0,20,2,2,2,6,0xb2d6dd77
610074.59,5.0,4,4,4,4,12,0xb2d94578d
235411.8,4.0,21,3,4,2,9,0x3b9b2c08d
0.11,1.0,184,1,2,1,4,0xb2d60fbbd
2809.79,1.0,8,1,2,3,6,0xb2d2c446
402131.82,2.0,0,4,3,4,11,0xb2d981d5
2000236.76,3.0,32,4,4,2,10,0xb2d1ff4ad
504969.36,5.0,15,4,4,3,11,0xb2d328f2
5049.54,1.0,184,2,2,1,5,0xb2d230dad
793.93,2.0,57,1,3,2,6,0xb2d3dbad
131348.84,4.0,3,3,4,4,11,0xb2d07436d
251776.27,2.0,65,3,3,2,8,0xb2d9aeec
184640.73,3.0,14,3,4,3,10,0xb2d5f288d
1700.64,1.0,1,1,2,4,7,0xb2d6a1e8
71.47,1.0,68,1,2,1,4,0xb2d665a6
160512.99,3.0,172,3,4,1,8,0xb2d0eb9d
2933.86,1.0,9,2,2,3,7,0xb2d6fa65d
2285.21,1.0,112,1,2,1,4,0xb2d1da1fd
445000.0,6.0,1,4,4,4,12,0xb2d1f2ad
505761.54,3.0,80,4,4,1,9,0xb2d1960bd
8644.12,1.0,10,2,2,3,7,0xb2d50da8d
882404.24,5.0,29,4,4,2,10,0xb2d6278c
500000.0,2.0,5,4,3,3,10,0xb2d8f4d6d
80078.15,3.0,92,3,4,1,8,0xb2d5b339
50001.06,2.0,66,2,3,2,7,0xb2d8f014
599.15,2.0,79,1,3,1,5,0xb2d332b8
150525.21,4.0,40,3,4,2,9,0xb2d5e70a
80340.0,2.0,3,3,3,4,10,0xb2d6bc26d
920000.74,6.0,1,4,4,4,12,0xb2d3bd89d
50000.0,1.0,1,2,2,4,8,0xb2da67d9
465.34,1.0,4,1,2,4,7,0xb2d2f9af
71513.26,2.0,97,3,3,1,7,0xb2d52ffad
132449.94,1.0,9,3,2,3,8,0xb2d8d6c3
500735.52,2.0,15,4,3,3,10,0xb2d6f68a
1174.52,1.0,184,1,2,1,4,0xb2d288e5d
250150.9,4.0,53,3,4,2,9,0xb2d38ba3
1405000.0,7.0,0,4,4,4,12,0xb2d11877
102385.27,2.0,31,3,3,2,8,0x3b9b350f
481000.0,1.0,2,4,2,4,10,0xb2d9b843
2037.07,1.0,9,1,2,3,6,0xb2d2ce8cd
15578.84,1.0,76,2,2,1,5,0xb2d6803bd
18.49,1.0,1,1,2,4,7,0xb2d2767c
3506.4,1.0,3,2,2,4,8,0xb2d505cb
7067.37,1.0,1,2,2,4,8,0xb2d912c6d
10156.63,1.0,92,2,2,1,5,0xb2d23f2b
440082.93,7.0,12,4,4,3,11,0xb2d18d0b
222777.76,2.0,25,3,3,2,8,0xb2d412cfd
2707.06,1.0,92,1,2,1,4,0xb2d2164f
880092.74,6.0,11,4,4,3,11,0xb2d4d1cc
710013.25,4.0,11,4,4,3,11,0xb2d98e2c
133874.43,10.0,0,3,4,4,11,0xb2d2ba23
1243.1,1.0,92,1,2,1,4,0xb2d2facf
313784.22,5.0,0,4,4,4,12,0xb2d09c64d
549754.14,2.0,0,4,3,4,11,0xb2d455da
101127.83,2.0,31,3,3,2,8,0xb2d68b1b
533092.1,3.0,9,4,4,3,11,0xb2d5574b
1015674.74,8.0,0,4,4,4,12,0xb2d42105
4810139.67,3.0,113,4,4,1,9,0x3b9aeddf
13974.32,5.0,18,2,4,2,8,0xb2d58e4e
12.04,1.0,6,1,2,3,6,0xb2d6a424
371328.54,2.0,30,4,3,2,9,0xb2d9c2ff
622976.43,7.0,4,4,4,4,12,0xb2d153cc
130031.28,3.0,92,3,4,1,8,0xb2d4a301
373578.23,30.0,1,4,4,4,12,0x3b9af1bb
510.13,1.0,14,1,2,3,6,0xb2d6c005
273028.71,3.0,0,3,4,4,11,0xb2d16fcf
114100.95,3.0,49,3,4,2,9,0xb2d22262
240468.29,2.0,23,3,3,2,8,0xb2d7ae33
206174.6,2.0,41,3,3,2,8,0xb2d83baf
242963.36,4.0,95,3,4,1,8,0xb2d622bad
16.04,1.0,56,1,2,2,5,0xb2d4e8f6
6404.33,1.0,184,2,2,1,5,0xb2d104fcd
18.21,1.0,6,1,2,3,6,0xb2d635a5
28108.61,3.0,5,2,4,3,9,0xb2d6cd16d
501803.7,2.0,26,4,3,2,9,0xb2d8fc7e
40554.79,1.0,184,2,2,1,5,0xb2d36cce
667035.21,3.0,17,4,4,2,10,0xb2d65913d
394459.05,1.0,5,4,2,3,9,0xb2d5c255
50015.36,2.0,102,2,3,1,6,0xb2d5cb33d
2244.26,1.0,272,1,2,1,4,0xb2d29231
95.85,1.0,27,1,2,2,5,0xb2d2667c
120002.76,2.0,87,3,3,1,7,0xb2d28a5a
48206.56,1.0,0,2,2,4,8,0xb2d5a13c
22333.05,1.0,21,2,2,2,6,0xb2d16d87d
8709.56,2.0,5,2,3,3,8,0xb2d0a11ed
11222.25,2.0,9,2,3,3,8,0xb2d23303
20000.43,3.0,74,2,4,1,7,0xb2d98771
1517765.24,2.0,1,4,3,4,11,0xb2d23fd6d
474938.39,4.0,62,4,4,2,10,0xb2d0e981
2127.04,1.0,10,1,2,3,6,0xb2d1d61e
30559.26,2.0,171,2,3,1,6,0xb2d59921
508239.73,5.0,18,4,4,2,10,0xb2d1082ad
76.8,1.0,9,1,2,3,6,0xb2d57246d
1173.04,1.0,10,1,2,3,6,0xb2d1ccbad
4032.33,1.0,3,2,2,4,8,0xb2d5d748
3177.59,1.0,0,2,2,4,8,0xb2d5d23b
100156.29,3.0,63,3,4,2,9,0xb2d68335
4306.16,1.0,184,2,2,1,5,0xb2d1b876d
1311.77,2.0,184,1,3,1,5,0x3b9b22fc
108822.62,2.0,4,3,3,4,10,0xb2d552b8d
10018.19,2.0,48,2,3,2,7,0xb2d98c46
429768.81,2.0,94,4,3,1,8,0xb2d1b678
850009.93,6.0,4,4,4,4,12,0xb2d812a7d
650.71,1.0,0,1,2,4,7,0xb2d2639c
1483.48,1.0,92,1,2,1,4,0xb2d1b98f
12843.39,1.0,0,2,2,4,8,0xb2d29c33d
200087.64,2.0,82,3,3,1,7,0xb2d4d1b8d
200006.34,2.0,122,3,3,1,7,0xb2d75b4c
400000.15,3.0,12,4,4,3,11,0xb2d608cd
280000.0,1.0,0,3,2,4,9,0xb2d2085c
500000.0,2.0,29,4,3,2,9,0xb2d935bb
1037.08,1.0,92,1,2,1,4,0xb2d3283f
1382.62,1.0,9,1,2,3,6,0xb2d717d5
3027.48,1.0,10,2,2,3,7,0xb2d8e6ed
48678.04,4.0,4,2,4,4,10,0xb2d60f7c
9363.4,1.0,8,2,2,3,7,0xb2d36bafd
154513.23,1.0,138,3,2,1,6,0xb2d11b1a
266481.71,5.0,1,3,4,4,11,0xb2d668bf
195002.06,3.0,35,3,4,2,9,0xb2d981a3
2576227.94,8.0,10,4,4,3,11,0x3b9b1b8a
50002.24,2.0,123,2,3,1,6,0xb2d5f594d
3362.91,1.0,108,2,2,1,5,0xb2d93b7c
3838.59,1.0,0,2,2,4,8,0xb2d53d80d
198814.01,1.0,0,3,2,4,9,0xb2d2a203
16.17,1.0,8,1,2,3,6,0xb2d32260d
1019.66,1.0,71,1,2,1,4,0xb2d50a1f
0.45,1.0,4,1,2,4,7,0xb2d9c92b
1151.66,1.0,159,1,2,1,4,0xb2d6c8f4d
878331.28,4.0,26,4,4,2,10,0xb2d531a8d
130027.76,3.0,0,3,4,4,11,0xb2d4a301d
20.32,1.0,7,1,2,3,6,0xb2d9465bd
4470.93,1.0,0,2,2,4,8,0xb2d6a78f
1502179.28,12.0,0,4,4,4,12,0xb2d103ebd
3461.9,1.0,0,2,2,4,8,0xb2d906cb
500739.34,3.0,175,4,4,1,9,0xb2d16ca2
2076.86,1.0,0,1,2,4,7,0xb2d68809d
68.66,1.0,57,1,2,2,5,0xb2d51d09
317492.26,3.0,33,4,4,2,10,0xb2d16b3b
252895.67,4.0,11,3,4,3,10,0xb2d2d19a
6693.99,1.0,92,2,2,1,5,0xb2d2b458
21402.47,1.0,0,2,2,4,8,0xb2d41396d
20005.26,2.0,214,2,3,1,6,0xb2d1a219
62505.56,1.0,10,3,2,3,8,0xb2d90342
10164.41,2.0,221,2,3,1,6,0xb2d2ad0dd
38.42,1.0,7,1,2,3,6,0xb2d7abb5
1019.8,1.0,0,1,2,4,7,0xb2d2124dd
200221.22,2.0,11,3,3,3,9,0xb2d988b1
2428.21,1.0,0,1,2,4,7,0xb2d976b2
7231.65,1.0,0,2,2,4,8,0xb2d69103d
267368.86,6.0,35,3,4,2,9,0xb2d5635fd
500098.2,4.0,5,4,4,3,11,0xb2d9794e
12.97,1.0,26,1,2,2,5,0xb2d5dd84
409670.48,3.0,48,4,4,2,10,0xb2d168f4
853067.03,5.0,11,4,4,3,11,0xb2d1724f
110112.63,3.0,11,3,4,3,10,0xb2d95bc8d
902799.9,5.0,27,4,4,2,10,0xb2d5ff09d
350061.21,2.0,7,4,3,3,10,0xb2d8818fd
2012.97,1.0,165,1,2,1,4,0xb2d656af
603.1,1.0,0,1,2,4,7,0xb2d324e8
8590.36,1.0,0,2,2,4,8,0xb2d91cf1d
10000.42,2.0,49,2,3,2,7,0xb2d9d24c
322151.45,1.0,0,4,2,4,10,0xb2d5b175
106.78,1.0,68,1,2,1,4,0xb2d0901bd
52404.91,1.0,59,3,2,2,7,0xb2d1b53e
6558.13,1.0,4,2,2,4,8,0xb2d94232
50000.53,2.0,80,2,3,1,6,0xb2d98fc2
480073.67,3.0,110,4,4,1,9,0xb2d18051d
1091.14,1.0,3,1,2,4,7,0xb2d3e97e
12324.36,1.0,169,2,2,1,5,0xb2d1e62f
9172.71,1.0,1,2,2,4,8,0xb2d49718
600003.17,4.0,12,4,4,3,11,0xb2d44917d
400024.07,2.0,5,4,3,3,10,0xb2d8f245
73.01,1.0,3,1,2,4,7,0xb2d5f0be
23892.28,1.0,25,2,2,2,6,0xb2d2aa46d
300460.82,8.0,0,4,4,4,12,0xb2d63291
60714.84,4.0,0,3,4,4,11,0xb2d60f57
1894.75,1.0,92,1,2,1,4,0xb2d1dd19d
528.91,1.0,34,1,2,2,5,0xb2d6e0bc
700152.62,2.0,27,4,3,2,9,0xb2d4b2e9
5707.43,2.0,0,2,3,4,9,0xb2d06868
34.11,1.0,78,1,2,1,4,0xb2d3cde5
70000.74,2.0,56,3,3,2,8,0xb2d9c66f
50874.65,2.0,12,2,3,3,8,0xb2d184f5
1173.42,1.0,184,1,2,1,4,0xb2d27237d
200004.67,5.0,59,3,4,2,9,0xb2d59444
371423.7,2.0,101,4,3,1,8,0xb2d623c9
11199.46,2.0,263,2,3,1,6,0xb2d3fa9a
123.61,1.0,75,1,2,1,4,0xb2d2441cd
716075.63,12.0,15,4,4,3,11,0xb2d14d5a
50001.48,2.0,200,2,3,1,6,0xb2d6014d
3750131.03,10.0,13,4,4,3,11,0xb2d6bd9dd
8005.7,1.0,0,2,2,4,8,0xb2d965b4
13.52,1.0,70,1,2,1,4,0xb2d83504
416744.29,4.0,1,4,4,4,12,0xb2d21117
500015.85,2.0,172,4,3,1,8,0xb2d8d28ed
18442.9,1.0,92,2,2,1,5,0x3b9ad3a7d
52957.79,2.0,3,3,3,4,10,0xb2d9fd1b
1170000.0,4.0,4,4,4,4,12,0xb2d8ea8bd
8262.09,1.0,7,2,2,3,7,0xb2d29ae8
453961.09,8.0,11,4,4,3,11,0xb2d124a6
250061.97,3.0,0,3,4,4,11,0xb2d527d7d
1311.19,1.0,22,1,2,2,5,0xb2d28db4
3853.95,1.0,0,2,2,4,8,0xb2d599d5
101821.35,4.0,13,3,4,3,10,0xb2d60954d
500003.5,3.0,7,4,4,3,11,0xb2d5d298
404691.6,3.0,200,4,4,1,9,0xb2d5681bd
411249.29,3.0,78,4,4,1,9,0xb2d39cd3d
9895.27,4.0,0,2,4,4,10,0x3b9b38ac
10007.82,2.0,5,2,3,3,8,0xb2d9a564
60306.62,2.0,56,3,3,2,8,0xb2d64eea
2250704.83,6.0,0,4,4,4,12,0xb2d6ba7f
377.7,1.0,19,1,2,2,5,0xb2d1cce9
100001.06,2.0,14,3,3,3,9,0xb2da2ad1
8450.3,1.0,0,2,2,4,8,0xb2d390e7
2204188.72,7.0,48,4,4,2,10,0xb2d1b7fb
825629.62,3.0,76,4,4,1,9,0xb2d429cc
1473.7,1.0,0,1,2,4,7,0xb2d4ce2ed
10268.52,1.0,1,2,2,4,8,0xb2d3a0bb
301973.16,6.0,3,4,4,4,12,0xb2d207c9
1.47,1.0,3,1,2,4,7,0xb2d118c3
1070.24,1.0,144,1,2,1,4,0xb2d595a3d
124092.04,3.0,30,3,4,2,9,0xb2d9e413
379.84,1.0,16,1,2,2,5,0xb2d25db3
4068.94,1.0,32,2,2,2,6,0xb2d9d416
1136.42,1.0,92,1,2,1,4,0xb2d4ba8f
8619.37,3.0,92,2,4,1,7,0xb2d40194
92.5,1.0,7,1,2,3,6,0xb2d79091
100005.4,2.0,139,3,3,1,7,0xb2d55bcfd
435014.67,5.0,13,4,4,3,11,0xb2d42561
20026.4,2.0,151,2,3,1,6,0xb2d2b569d
32535.01,1.0,92,2,2,1,5,0xb2d2d2d6
50011.57,2.0,221,2,3,1,6,0xb2d55cf2
333525.38,4.0,36,4,4,2,10,0xb2d144c5d
205472.97,3.0,59,3,4,2,9,0xb2d29559d
2524.83,1.0,173,1,2,1,4,0xb2d4ad7d
242685.46,2.0,73,3,3,1,7,0xb2d58bdf
252590.65,2.0,0,3,3,4,10,0xb2d5867bd
40081.24,3.0,10,2,4,3,9,0xb2d95a46d
9103.54,1.0,14,2,2,3,7,0xb2d6fc60
183.92,1.0,46,1,2,2,5,0xb2d95fdb
160157.24,2.0,6,3,3,3,9,0xb2d0a806
200001.26,3.0,5,3,4,3,10,0xb2d97984
550000.12,2.0,23,4,3,2,9,0xb2d6e247
1677.7,1.0,184,1,2,1,4,0xb2d3614b
16137.98,1.0,96,2,2,1,5,0xb2d132ab
301000.0,7.0,0,4,4,4,12,0xb2d30a64
4257.71,1.0,3,2,2,4,8,0xb2d1d88e
20006.27,2.0,147,2,3,1,6,0xb2d6d015
31330.31,1.0,184,2,2,1,5,0xb2d22c3ed
1.28,1.0,13,1,2,3,6,0xb2d54b7d
360053.62,4.0,4,4,4,4,12,0xb2d9b402
4139.25,1.0,9,2,2,3,7,0xb2d609abd
1284546.67,2.0,35,4,3,2,9,0xb2d9fc0c
122027.27,2.0,74,3,3,1,7,0xb2d9600ed
8985.74,1.0,4,2,2,4,8,0xb2d90c50
434645.44,5.0,27,4,4,2,10,0xb2d6242f
20000.95,2.0,6,2,3,3,8,0xb2d96ed3
1151.21,2.0,92,1,3,1,5,0xb2d0732a
493967.26,3.0,6,4,4,3,11,0xb2d49554d
200446.66,2.0,12,3,3,3,9,0xb2d68f21
152002.55,3.0,49,3,4,2,9,0xb2d0c1e9d
44.07,1.0,60,1,2,2,5,0xb2d4e483d
274.91,3.0,0,1,4,4,9,0x3b9b4458d
500725.32,4.0,63,4,4,2,10,0xb2d363f2d
50107.74,1.0,214,2,2,1,5,0xb2d6b39f
1154.91,1.0,184,1,2,1,4,0xb2d23a7a
3015.82,6.0,6,2,4,3,9,0x3b9ad060
728339.5,4.0,4,4,4,4,12,0xb2d22029d
150000.0,2.0,4,3,3,4,10,0xb2da56a5
96924.51,1.0,0,3,2,4,9,0xb2d12ca1d
275415.73,2.0,112,3,3,1,7,0xb2d3a31c
111531.48,2.0,42,3,3,2,8,0xb2d0fa0d
358768.4,3.0,0,4,4,4,12,0xb2d311a3
132.11,1.0,64,1,2,2,5,0x3b9b470d
613372.49,5.0,3,4,4,4,12,0xb2d65638d
7331.79,1.0,18,2,2,2,6,0xb2d1a96ed
0.0,1.0,237,1,2,1,4,0xb2d6e77b
165122.78,1.0,21,3,2,2,7,0xb2d2fcc8d
1172.29,1.0,9,1,2,3,6,0xb2d57c0b
618.39,1.0,1,1,2,4,7,0xb2d29519
373919.48,5.0,0,4,4,4,12,0xb2d1779b
28.71,1.0,19,1,2,2,5,0xb2d8e1f7
62.16,4.0,40,1,4,2,7,0xb2d30d86
4302.7,1.0,19,2,2,2,6,0xb2d1f3be
12160.23,1.0,157,2,2,1,5,0xb2d3197b
417468.38,4.0,41,4,4,2,10,0xb2d19787d
50143.27,5.0,3,2,4,4,10,0xb2d68022d
3680.62,1.0,21,2,2,2,6,0xb2d2dd16
600061.51,2.0,19,4,3,2,9,0xb2d42122
18272.28,1.0,8,2,2,3,7,0xb2d867afd
154364.95,1.0,46,3,2,2,7,0xb2d11b1ad
8897.37,1.0,0,2,2,4,8,0xb2d32727
4691.39,1.0,9,2,2,3,7,0xb2d40604d
62.92,1.0,0,1,2,4,7,0xb2d90becd
0.37,1.0,175,1,2,1,4,0xb2d393a3
155959.09,4.0,0,3,4,4,11,0xb2d1a3bdd
537839.22,3.0,33,4,4,2,10,0xb2d58c51d
250064.92,2.0,25,3,3,2,8,0xb2d94d4a
5957.43,1.0,17,2,2,2,6,0xb2d6c438
283236.47,3.0,77,3,4,1,8,0xb2d0fa67d
2221.26,1.0,3,1,2,4,7,0xb2d34044
101001.07,5.0,52,3,4,2,9,0xb2d716cad
80268.31,2.0,55,3,3,2,8,0xb2d623e5d
6.95,1.0,25,1,2,2,5,0xb2d93899d
2562.34,1.0,121,1,2,1,4,0xb2d64b90d
530313.02,8.0,4,4,4,4,12,0xb2d2377f
500043.43,2.0,12,4,3,3,10,0xb2d4caff
2150.0,1.0,0,1,2,4,7,0xb2d51c65
14746.6,1.0,184,2,2,1,5,0xb2d42e0ad
15999.58,2.0,23,2,3,2,7,0xb2d9ff9d
52232.2,2.0,62,3,3,2,8,0xb2d57a40d
80049.45,3.0,179,3,4,1,8,0xb2d60e33
72.11,1.0,0,1,2,4,7,0xb2d623ce
10083.71,1.0,0,2,2,4,8,0xb2d6c65d
368686.49,4.0,2,4,4,4,12,0xb2d44daf
318932.63,1.0,8,4,2,3,9,0xb2d1b2b6
540551.28,7.0,0,4,4,4,12,0x3b9b2f45d
50001.06,2.0,200,2,3,1,6,0xb2d7911d
50024.6,2.0,110,2,3,1,6,0xb2d281c9
432003.81,3.0,13,4,4,3,11,0xb2d180bd
7028.73,1.0,1,2,2,4,8,0xb2d933a0d
54996.39,1.0,94,3,2,1,6,0xb2d26d58
600009.04,4.0,5,4,4,3,11,0xb2d6b773
10796.77,1.0,13,2,2,3,7,0xb2d34818
15576.79,1.0,4,2,2,4,8,0xb2d78a86
7.91,1.0,10,1,2,3,6,0xb2d3600ed
1035.28,1.0,92,1,2,1,4,0xb2d30e22
2002.4,2.0,184,1,3,1,5,0xb2d349ca
1017.05,1.0,184,1,2,1,4,0xb2d3e5dc
102136.11,1.0,197,3,2,1,6,0xb2d61cfc
10048.61,2.0,6,2,3,3,8,0xb2d63931
2342.24,1.0,4,1,2,4,7,0xb2d2215f
5755.47,1.0,5,2,2,3,7,0xb2d4dfe9
5279.62,1.0,5,2,2,3,7,0xb2d4f50ed
200000.0,2.0,18,3,3,2,8,0xb2da333b
250000.0,2.0,14,3,3,3,9,0xb2da31fa
70005.37,6.0,27,3,4,2,9,0xb2d2a2dd
365891.01,6.0,73,4,4,1,9,0xb2d16ef2d
3780.98,1.0,2,2,2,4,8,0xb2d6f213
9526.99,1.0,19,2,2,2,6,0xb2d2829d
117.19,1.0,48,1,2,2,5,0xb2d15effd
101629.84,3.0,18,3,4,2,9,0xb2d6953d
875045.63,7.0,2,4,4,4,12,0xb2d11b8a
8368.25,1.0,184,2,2,1,5,0xb2d305cbd
2451.22,1.0,5,1,2,3,6,0xb2d3f104d
12491.22,1.0,225,2,2,1,5,0xb2d553bed
551895.37,47.0,3,4,4,4,12,0xb2d0f345d
1692.87,1.0,53,1,2,2,5,0xb2d60bdd
51564.04,1.0,308,2,2,1,5,0xb2d3f5f0d
869.64,1.0,17,1,2,2,5,0xb2d7176ed
500039.01,2.0,209,4,3,1,8,0xb2d28425d
540710.42,13.0,2,4,4,4,12,0xb2d17965
1671.72,1.0,0,1,2,4,7,0xb2d59a09
74305.29,3.0,49,3,4,2,9,0xb2d37ca6
980028.46,12.0,25,4,4,2,10,0xb2d1f7b5
20277.53,2.0,60,2,3,2,7,0xb2d61070
3186.6,1.0,184,2,2,1,5,0xb2d63bbad
412448.6,9.0,0,4,4,4,12,0xb2d0e10a
5628.58,3.0,14,2,4,3,9,0x3b9af185
12001.45,2.0,56,2,3,2,7,0xb2d4dc25
21099.19,1.0,0,2,2,4,8,0xb2d6b5b5d
50377.01,1.0,184,2,2,1,5,0xb2d3a837d
500015.85,2.0,161,4,3,1,8,0xb2d8e90f
1958643.04,23.0,0,4,4,4,12,0xb2d138cdd
20000.63,2.0,25,2,3,2,7,0xb2da0f38
1180024.35,6.0,8,4,4,3,11,0xb2d64c3ed
500000.0,2.0,28,4,3,2,9,0xb2d6e6f8d
250004.53,5.0,83,3,4,1,8,0xb2d175a7
1295.1,1.0,92,1,2,1,4,0xb2d0a132
61000.86,2.0,0,3,3,4,10,0xb2d5296d
10956.27,1.0,5,2,2,3,7,0xb2d6c3ced
170056.82,2.0,78,3,3,1,7,0xb2d653cc
220021.92,2.0,24,3,3,2,8,0xb2d28b8bd
119.25,1.0,4,1,2,4,7,0xb2d2da27
1575.25,1.0,0,1,2,4,7,0xb2d6945c
900063.38,6.0,4,4,4,4,12,0xb2d950a6
2042.79,1.0,2,1,2,4,7,0xb2d0e9d2d
3152.06,1.0,12,2,2,3,7,0xb2d2d749
71000.97,5.0,49,3,4,2,9,0xb2d4fded
1016.25,1.0,184,1,2,1,4,0xb2d107e2
8667.41,1.0,0,2,2,4,8,0xb2d41d36d
14.92,1.0,116,1,2,1,4,0xb2d18da0
200051.01,2.0,92,3,3,1,7,0xb2d43a2cd
3362173.74,4.0,11,4,4,3,11,0xb2d6861cd
382300.53,3.0,37,4,4,2,10,0xb2d64386d
6.07,1.0,15,1,2,3,6,0xb2d24817
121840.11,5.0,12,3,4,3,10,0x3b9b3cf6d
35000.37,2.0,92,2,3,1,6,0xb2d63750
500000.0,2.0,18,4,3,2,9,0xb2da2d73
145007.65,5.0,8,3,4,3,10,0xb2d57ca0d
155135.61,2.0,14,3,3,3,9,0xb2d12ee6
9150.33,1.0,184,2,2,1,5,0xb2d39b9c
4897.68,1.0,20,2,2,2,6,0xb2d8db34d
500010.0,1.0,0,4,2,4,10,0xb2da5808
7.66,1.0,39,1,2,2,5,0xb2d8e212
8101.09,1.0,3,2,2,4,8,0xb2d93d48
5312.54,1.0,204,2,2,1,5,0xb2d19dded
600007.34,5.0,6,4,4,3,11,0xb2d635ef
28137.3,1.0,2,2,2,4,8,0xb2d6bfa8
501127.26,3.0,0,4,4,4,12,0xb2d1838b
14791.66,1.0,0,2,2,4,8,0xb2d1802e
949.93,1.0,0,1,2,4,7,0xb2d784ae
500010.56,2.0,38,4,3,2,9,0xb2d92a3bd
1.2,1.0,184,1,2,1,4,0xb2d282cb
1631.31,1.0,21,1,2,2,5,0xb2d6de5ed
1383.35,1.0,245,1,2,1,4,0xb2d32a45d
104506.85,5.0,0,3,4,4,11,0xb2d4d837
9114.33,1.0,195,2,2,1,5,0xb2d46814d
489181.54,6.0,0,4,4,4,12,0xb2d616e6d
6144.71,1.0,18,2,2,2,6,0xb2d156f0
600003.17,3.0,18,4,4,2,10,0xb2d9cc78
850031.82,3.0,0,4,4,4,12,0xb2d683d5
370007.81,2.0,80,4,3,1,8,0xb2d95b8a
40225.31,2.0,214,2,3,1,6,0xb2d5bdc5
39.04,1.0,35,1,2,2,5,0xb2d39290
274065.74,4.0,31,3,4,2,9,0xb2d610c7d
28.72,1.0,10,1,2,3,6,0xb2d3bc11
1800.14,1.0,0,1,2,4,7,0xb2d9aca6
190028.45,4.0,74,3,4,1,8,0xb2d60c9d
142850.43,2.0,34,3,3,2,8,0xb2d21962d
420816.13,1.0,194,4,2,1,7,0xb2d81062
404054.41,5.0,14,4,4,3,11,0xb2d126be
40223.79,2.0,69,2,3,1,6,0xb2d61114d
450402.27,4.0,0,4,4,4,12,0xb2d5fdea
386867.09,4.0,17,4,4,2,10,0xb2d24c33
32607.78,4.0,2,2,4,4,10,0xb2d08038
1009786.03,2.0,17,4,3,2,9,0xb2d62d53d
882093.85,4.0,92,4,4,1,9,0xb2d23dbad
405386.34,2.0,0,4,3,4,11,0xb2d3adc8d
3634.14,2.0,0,2,3,4,9,0xb2d38eb8d
4622.48,1.0,13,2,2,3,7,0xb2d59e15d
200031.26,2.0,2,3,3,4,10,0xb2d97fc6d
16519.22,1.0,14,2,2,3,7,0xb2d6c9cbd
33663.42,1.0,3,2,2,4,8,0xb2d40ad0
8220.11,1.0,15,2,2,3,7,0xb2d14bc7
130995.57,2.0,64,3,3,2,8,0xb2d5aa0f
2022.01,1.0,68,1,2,1,4,0xb2d21421
500003.34,2.0,13,4,3,3,10,0xb2d1417ed
120770.36,3.0,1,3,4,4,11,0xb2d58a29
9814.37,1.0,74,2,2,1,5,0xb2d3ea04d
100014.88,2.0,112,3,3,1,7,0xb2d4f873
6011.76,1.0,24,2,2,2,6,0xb2d365cb
2.01,1.0,45,1,2,2,5,0xb2d51bae
89536.75,1.0,15,3,2,3,8,0xb2d319a7d
25.12,1.0,53,1,2,2,5,0xb2d8db83
361011.47,6.0,23,4,4,2,10,0xb2d12989d
953.09,1.0,28,1,2,2,5,0xb2d5cce6
100607.25,2.0,27,3,3,2,8,0xb2d1364b
131.24,1.0,48,1,2,2,5,0xb2d2a0ae
1808920.77,14.0,0,4,4,4,12,0xb2d0d9a6d
4220.47,1.0,0,2,2,4,8,0xb2d17da0d
1180.93,1.0,24,1,2,2,5,0xb2d2e31b
37044.54,1.0,14,2,2,3,7,0xb2d698cd
152534.19,2.0,217,3,3,1,7,0xb2d55e64d
9.61,1.0,53,1,2,2,5,0xb2d9c150
1010.8,1.0,184,1,2,1,4,0xb2d29c57d
29.69,1.0,59,1,2,2,5,0xb2d0ee71d
3.52,2.0,66,1,3,2,6,0xb2d07240d
1893.15,1.0,9,1,2,3,6,0xb2d177c2
5.79,1.0,0,1,2,4,7,0xb2da0163
5308.94,1.0,184,2,2,1,5,0xb2d1fcf7d
58000.61,2.0,27,3,3,2,8,0xb2d8e339d
532891.62,3.0,84,4,4,1,9,0xb2d684a4
286.4,1.0,18,1,2,2,5,0xb2d25b5e
194.92,1.0,47,1,2,2,5,0xb2d8d1e5
1369.09,1.0,27,1,2,2,5,0xb2d1bf8f
130244.43,2.0,161,3,3,1,7,0xb2d5b2bfd
4.37,1.0,26,1,2,2,5,0xb2d5d0cb
360341.51,9.0,14,4,4,3,11,0xb2d2425bd
37859.7,1.0,0,2,2,4,8,0xb2d6b8c8
409.18,1.0,65,1,2,2,5,0xb2d56a9f
1000042.3,2.0,92,4,3,1,8,0xb2d63ec1
200055.58,7.0,25,3,4,2,9,0xb2d41cb1
5364.09,1.0,0,2,2,4,8,0xb2d69f64d
33567.9,1.0,9,2,2,3,7,0xb2d6bdbfd
1000079.58,3.0,41,4,4,2,10,0xb2d10390
36130.97,1.0,0,2,2,4,8,0xb2d309f6d
5627.12,1.0,13,2,2,3,7,0xb2d3efc4d
377497.92,5.0,19,4,4,2,10,0xb2d087bed
386593.16,4.0,52,4,4,2,10,0xb2d454ac
100046.34,2.0,206,3,3,1,7,0xb2d318fa
670002.11,4.0,3,4,4,4,12,0xb2d95428d
261595.14,4.0,8,3,4,3,10,0xb2d3b863
835.9,3.0,10,1,4,3,8,0xb2d95983
200006.33,2.0,25,3,3,2,8,0xb2da0f91
6028.81,1.0,24,2,2,2,6,0xb2d37e9f
450126.23,2.0,224,4,3,1,8,0xb2d6c298
200711.33,2.0,48,3,3,2,8,0xb2d59f35d
1611.3,1.0,184,1,2,1,4,0x3b9b3427d
5.15,1.0,47,1,2,2,5,0xb2d9835a
812.28,1.0,2,1,2,4,7,0xb2d6ce2c
3032.51,1.0,94,2,2,1,5,0xb2d69f4bd
12000.13,2.0,92,2,3,1,6,0xb2d9819e
83067.58,1.0,3,3,2,4,9,0xb2d53eed
3808.24,1.0,24,2,2,2,6,0xb2d5fbb2d
120.23,1.0,21,1,2,2,5,0xb2d65179
170464.24,6.0,0,3,4,4,11,0xb2d0a942
87191.52,1.0,2,3,2,4,9,0xb2d3c3f0d
367013.26,9.0,18,4,4,2,10,0xb2d11fb8d
505540.25,5.0,1,4,4,4,12,0xb2d64422
30843.24,1.0,0,2,2,4,8,0xb2d905b0d
500109.6,2.0,14,4,3,3,10,0xb2d91dce
66552.95,1.0,50,3,2,2,7,0xb2d51250d
136006.42,3.0,0,3,4,4,11,0xb2d22fc0
13.9,1.0,39,1,2,2,5,0xb2d922fa
6675.3,1.0,23,2,2,2,6,0xb2d2f557
0.0,1.0,0,1,2,4,7,0xb2d59602
60001.27,2.0,46,3,3,2,8,0xb2d9df3f
222107.73,34.0,44,3,4,2,9,0x3b9b0e16
2280.9,2.0,184,1,3,1,5,0xb2d1d874
83.56,1.0,80,1,2,1,4,0xb2d4442e
100005.31,3.0,0,3,4,4,11,0xb2d61e34d
691.52,1.0,0,1,2,4,7,0xb2d52da9
985021.81,4.0,70,4,4,1,9,0xb2d36740
102011.73,3.0,18,3,4,2,9,0xb2d6e0efd
530000.0,1.0,0,4,2,4,10,0xb2d93a72
506456.02,3.0,17,4,4,2,10,0xb2d263ffd
5666.5,1.0,92,2,2,1,5,0xb2d2744f
110883.06,3.0,14,3,4,3,10,0xb2d5e673d
834938.42,1.0,1,4,2,4,10,0xb2d25347
6055.51,1.0,92,2,2,1,5,0xb2d2b282d
2035.99,3.0,92,1,4,1,6,0x3b9b297d
1000053.12,1.0,1,4,2,4,10,0xb2d588c7
4365.83,1.0,9,2,2,3,7,0xb2d291a4
481870.05,4.0,6,4,4,3,11,0xb2d62698
40150.0,2.0,4,2,3,4,9,0xb2d9dc7a
60089.02,2.0,216,3,3,1,7,0xb2d5aa64d
5288.49,1.0,14,2,2,3,7,0xb2d69b6e
843226.96,4.0,13,4,4,3,11,0xb2d155bd
178.59,1.0,28,1,2,2,5,0xb2d65bda
3670.84,1.0,41,2,2,2,6,0xb2d0ee55
10094.25,1.0,45,2,2,2,6,0xb2d0cea1
175712.32,3.0,67,3,4,1,8,0xb2d5a83cd
16765.02,1.0,0,2,2,4,8,0xb2d6b5d6
182679.07,3.0,83,3,4,1,8,0xb2d43815
376107.16,1.0,162,4,2,1,7,0xb2d18a3cd
7094.0,1.0,2,2,2,4,8,0xb2d96365
71011.53,5.0,4,3,4,4,11,0x3b9b37a0
40.03,1.0,8,1,2,3,6,0xb2d264f4
1007105.95,2.0,80,4,3,1,8,0xb2d992a2
803559.06,5.0,34,4,4,2,10,0xb2d99abe
10000.11,2.0,77,2,3,1,6,0xb2d99712
38000.37,2.0,10,2,3,3,8,0xb2d99518
0.0,1.0,3,1,2,4,7,0xb2d912a3
100011.37,2.0,11,3,3,3,9,0xb2d6391e
65826.12,2.0,13,3,3,3,9,0xb2d68942
1115297.77,1.0,0,4,2,4,10,0xb2d55adc
256539.87,5.0,31,3,4,2,9,0xb2d28cb1d
410472.39,19.0,6,4,4,3,11,0xb2d21249d
142009.09,1.0,0,3,2,4,9,0xb2d31066
9190.73,1.0,139,2,2,1,5,0xb2d14196d
3801.45,1.0,47,2,2,2,6,0xb2d398ad
115001.9,6.0,27,3,4,2,9,0xb2d63f77
707.71,1.0,80,1,2,1,4,0xb2d24ce1d
316292.78,3.0,10,4,4,3,11,0xb2d26812
1100003.1,2.0,0,4,3,4,11,0xb2d98308d
1101781.62,5.0,40,4,4,2,10,0xb2d2193ad
507000.0,10.0,9,4,4,3,11,0xb2d20f31d
2097.18,1.0,92,1,2,1,4,0xb2d21a2f
90015.39,2.0,14,3,3,3,9,0xb2d230c9
0.0,2.0,1,1,3,4,8,0xb2d5e569
406092.37,3.0,66,4,4,2,10,0xb2d225c0
30918.52,1.0,83,2,2,1,5,0xb2d24715
3907.72,1.0,10,2,2,3,7,0xb2d4be47
81419.93,1.0,42,3,2,2,7,0xb2d14fbb
105165.16,1.0,1,3,2,4,9,0xb2d11448
5495.68,1.0,3,2,2,4,8,0xb2d2e72d
326471.64,5.0,0,4,4,4,12,0xb2d40fa4
9610.39,1.0,4,2,2,4,8,0xb2d82262d
799.23,1.0,157,1,2,1,4,0xb2d20b60d
490428.15,4.0,1,4,4,4,12,0xb2d3ba65d
542469.59,15.0,1,4,4,4,12,0xb2d65bf3d
240356.16,4.0,20,3,4,2,9,0xb2d09a0c
11568.12,1.0,1,2,2,4,8,0xb2d9125a
22898.32,1.0,6,2,2,3,7,0xb2d78fed
8064.25,1.0,92,2,2,1,5,0xb2d369c2d
52127.85,2.0,32,2,3,2,7,0xb2d3bdb1
1110.5,1.0,10,1,2,3,6,0xb2d6f468
12000106.76,2.0,92,4,3,1,8,0xb2d60808
310000.0,3.0,0,4,4,4,12,0xb2d8e0bc
2424.32,1.0,44,1,2,2,5,0xb2d5aa1f
256010.2,2.0,184,3,3,1,7,0x3b9b353f
300000.0,2.0,9,3,3,3,9,0xb2d96da1d
300816.48,3.0,172,4,4,1,9,0xb2d55c43
6199.59,1.0,1,2,2,4,8,0xb2d69a7bd
18432.2,1.0,9,2,2,3,7,0xb2d42dedd
175.13,1.0,0,1,2,4,7,0xb2d4f1ced
20817.5,2.0,14,2,3,3,8,0xb2d62131
438000.0,2.0,0,4,3,4,11,0xb2d97c9ad
2227.54,1.0,92,1,2,1,4,0xb2d22693d
653000.0,2.0,14,4,3,3,10,0xb2d95d9ed
0.0,1.0,1,1,2,4,7,0xb2d6d76f
980016.4,7.0,8,4,4,3,11,0xb2d46e3f
181385.2,6.0,18,3,4,2,9,0xb2d5b172d
542022.2,10.0,10,4,4,3,11,0xb2d5e07bd
452000.08,2.0,15,4,3,3,10,0xb2d8de62
13870.82,1.0,184,2,2,1,5,0xb2d3b79d
2000000.0,2.0,27,4,3,2,9,0xb2d9453c
9990.5,2.0,0,2,3,4,9,0xb2d4aa1ad
230613.72,5.0,6,3,4,3,10,0xb2d5abd4
8680.24,1.0,7,2,2,3,7,0xb2d62d35
320004.22,3.0,49,4,4,2,10,0xb2d9cc88
17596.45,1.0,14,2,2,3,7,0xb2d6be3e
200002.01,2.0,21,3,3,2,8,0xb2da22dc
172836.45,3.0,3,3,4,4,11,0xb2d284a7
220048.46,3.0,111,3,4,1,8,0xb2d36e88d
500123.76,2.0,151,4,3,1,8,0xb2d1d9cd
266006.98,3.0,179,3,4,1,8,0xb2d0fd89d
4488.82,2.0,3,2,3,4,9,0xb2d3f629
3.92,1.0,35,1,2,2,5,0xb2d25cd7d
50011.66,2.0,17,2,3,2,7,0xb2d168a2d
50012.39,2.0,122,2,3,1,6,0xb2d103cc
200020.65,3.0,10,3,4,3,10,0xb2d39552d
100813.65,4.0,139,3,4,1,8,0xb2d294d3d
1022.51,1.0,184,1,2,1,4,0xb2d2b666d
25471.22,2.0,206,2,3,1,6,0xb2d27ac0d
6.33,1.0,1,1,2,4,7,0xb2d958a7
740054.2,7.0,0,4,4,4,12,0xb2d153f2
8235.84,1.0,1,2,2,4,8,0xb2d2b5c0
450020.23,4.0,6,4,4,3,11,0xb2d5f1ccd
7856.74,1.0,1,2,2,4,8,0xb2d9160ad
200006.36,3.0,9,3,4,3,10,0xb2da11cd
7781.22,1.0,29,2,2,2,6,0xb2d92676
665154.48,6.0,10,4,4,3,11,0xb2d5c4c2
16218.36,1.0,5,2,2,3,7,0xb2d2b5ffd
293.64,1.0,9,1,2,3,6,0xb2d6b2eb
6059.74,1.0,92,2,2,1,5,0x3b9b37ddd
311382.53,1.0,3,4,2,4,10,0xb2d3aa6d
10320.67,1.0,167,2,2,1,5,0xb2d5ae94
156675.34,1.0,184,3,2,1,6,0x3b9ae9cad
197025.68,1.0,0,3,2,4,9,0xb2d2df0bd
30025.12,2.0,21,2,3,2,7,0xb2d627b9
62002.13,5.0,5,3,4,3,10,0xb2d4ac79
2713.44,1.0,287,1,2,1,4,0xb2d5dc4dd
1012.5,1.0,184,1,2,1,4,0xb2d122c6
70003.54,4.0,202,3,4,1,8,0xb2d1d4b9
2030.49,1.0,0,1,2,4,7,0xb2d4715f
2646.35,1.0,6,1,2,3,6,0xb2d258af
520012.23,3.0,0,4,4,4,12,0xb2d24888
5058.14,1.0,184,2,2,1,5,0xb2d0dc17
92.01,1.0,17,1,2,2,5,0xb2d428d5
82953.76,1.0,141,3,2,1,6,0xb2d37c48d
151043.65,2.0,82,3,3,1,7,0xb2d5a590
60968.35,1.0,12,3,2,3,8,0xb2d5bdec
1708.43,1.0,10,1,2,3,6,0xb2d3c106
10.65,1.0,28,1,2,2,5,0xb2d349e8
6600097.13,1.0,0,4,2,4,10,0xb2d5e6f2
70629.57,6.0,75,3,4,1,8,0xb2d61145d
40005.87,1.0,2,2,2,4,8,0xb2d1a744d
67828.26,1.0,8,3,2,3,8,0xb2d93313
480720.67,3.0,22,4,4,2,10,0xb2d86a4e
1100002.33,3.0,5,4,4,3,11,0xb2d9736dd
201012.58,2.0,13,3,3,3,9,0xb2d7c1add
915.58,1.0,0,1,2,4,7,0xb2d8ffc8
241705.25,2.0,68,3,3,1,7,0xb2d8ef0e
20697.38,1.0,3,2,2,4,8,0xb2d6329cd
60.07,1.0,157,1,2,1,4,0xb2d25391d
2401.01,1.0,0,1,2,4,7,0xb2d70218
609.64,3.0,0,1,4,4,9,0x3b9b340b
1719540.96,1.0,0,4,2,4,10,0xb2d2abcc
1887.05,2.0,96,1,3,1,5,0x3b9b119b
30000.21,4.0,119,2,4,1,7,0xb2d75ae8d
13827.51,1.0,21,2,2,2,6,0xb2d2cc01d
100007.28,2.0,21,3,3,2,8,0xb2d50960d
100102.31,2.0,137,3,3,1,7,0xb2d91544
494061.06,4.0,189,4,4,1,9,0x3b9b2a61d
90004.57,2.0,0,3,3,4,10,0xb2d51f06d
17432.31,1.0,17,2,2,2,6,0xb2d54be5d
1509.91,1.0,92,1,2,1,4,0x3b9b2351
5258.26,1.0,184,2,2,1,5,0xb2d11a16
352068.63,6.0,87,4,4,1,9,0xb2d33d6a
802351.18,5.0,15,4,4,3,11,0xb2d91fe7
13136.15,1.0,184,2,2,1,5,0xb2d28198d
347643.79,3.0,3,4,4,4,12,0xb2d3b9f0d
93.96,1.0,15,1,2,3,6,0xb2da1553
250.65,1.0,10,1,2,3,6,0xb2d4a55c
463465.03,3.0,56,4,4,2,10,0xb2d5cb5b
5010.05,1.0,60,2,2,2,6,0xb2d0f84d
51275.96,2.0,1,2,3,4,9,0xb2d6061ed
2466.42,1.0,2,1,2,4,7,0xb2d2e440
5059.44,1.0,184,2,2,1,5,0xb2d285fd
10220.43,1.0,184,2,2,1,5,0xb2d563c4
169008.91,4.0,10,3,4,3,10,0xb2d33e23d
200710.42,3.0,33,3,4,2,9,0xb2d69a7d
3001.39,1.0,14,2,2,3,7,0xb2d60a4a
2559.2,1.0,0,1,2,4,7,0xb2d8f58c
12.54,1.0,8,1,2,3,6,0xb2d8e0e1
117654.52,1.0,0,3,2,4,9,0xb2d947ed
97.33,1.0,9,1,2,3,6,0xb2d42dd2
11235.46,1.0,2,2,2,4,8,0xb2d1af0f
100029.83,2.0,23,3,3,2,8,0xb2d69a23
440098.91,4.0,16,4,4,2,10,0xb2d658a2
300718.61,2.0,11,4,3,3,10,0xb2d5edc9d
356519.98,2.0,32,4,3,2,9,0xb2d36cf9
1000000.0,5.0,2,4,4,4,12,0xb2d0c55cd
121348.53,3.0,158,3,4,1,8,0xb2d596df
11116.35,1.0,9,2,2,3,7,0xb2d5ada7
301065.78,2.0,23,4,3,2,9,0xb2d90cb3
606763.24,10.0,0,4,4,4,12,0xb2d1b797
3542.56,1.0,11,2,2,3,7,0xb2d54f4c
2080.26,1.0,0,1,2,4,7,0xb2d48839
100012.98,2.0,42,3,3,2,8,0xb2d49d6ed
5.5,1.0,50,1,2,2,5,0xb2d6215c
4740.37,1.0,3,2,2,4,8,0xb2d91f56
2011.0,1.0,17,1,2,2,5,0xb2d6f1c8d
20.58,4.0,1,1,4,4,9,0x3b9b29b1
73.91,1.0,10,1,2,3,6,0xb2d3f5fb
108128.84,1.0,3,3,2,4,9,0xb2d2094bd
15489.91,1.0,2,2,2,4,8,0xb2d769ba
1057208.28,10.0,0,4,4,4,12,0xb2d16848d
254605.05,1.0,0,3,2,4,9,0xb2d4261dd
90006.94,4.0,55,3,4,2,9,0xb2d58ef3d
2128425.73,11.0,4,4,4,4,12,0xb2d0ac79
10629.05,1.0,0,2,2,4,8,0xb2d9069fd
100023.36,2.0,178,3,3,1,7,0xb2d70039
564916.21,7.0,0,4,4,4,12,0x3b9b3365
1000014.63,4.0,25,4,4,2,10,0xb2d1f2ddd
43.61,1.0,21,1,2,2,5,0xb2d3f950d
216996.93,6.0,53,3,4,2,9,0xb2d2ae18d
1500050.39,4.0,0,4,4,4,12,0xb2d83c7c
829.57,1.0,23,1,2,2,5,0xb2d23ca8
835.03,1.0,0,1,2,4,7,0xb2d97dc2
1613.74,1.0,184,1,2,1,4,0xb2d42c9ad
134161.41,2.0,87,3,3,1,7,0xb2d21c9cd
77.02,1.0,70,1,2,1,4,0xb2d627f7
1080.05,1.0,19,1,2,2,5,0xb2d51dd0
10044.9,1.0,42,2,2,2,6,0xb2d9c958
514224.77,2.0,105,4,3,1,8,0xb2d6cc90
550000.0,2.0,4,4,3,4,11,0xb2da58a5
10169.16,2.0,12,2,3,3,8,0x3b9b44bb
1007106.03,2.0,81,4,3,1,8,0xb2d990af
2161.2,1.0,69,1,2,1,4,0xb2d59cda
14.4,1.0,14,1,2,3,6,0xb2d25201
530566.25,2.0,27,4,3,2,9,0xb2d12a4dd
446361.11,3.0,3,4,4,4,12,0xb2d0f828d
350867.21,2.0,0,4,3,4,11,0xb2d5c865
4437.31,1.0,0,2,2,4,8,0xb2d6e818
52867.15,2.0,185,3,3,1,7,0xb2d5e556
3091.1,1.0,203,2,2,1,5,0xb2d150e8
130059.6,2.0,125,3,3,1,7,0xb2d138d6
905576.69,5.0,21,4,4,2,10,0xb2d9ce7a
50210.31,2.0,15,2,3,3,8,0xb2d95bbad
707230.91,6.0,34,4,4,2,10,0xb2d170b2d
200000.0,2.0,10,3,3,3,9,0xb2d96c78d
100072.32,3.0,31,3,4,2,9,0xb2d5a462
100610.45,2.0,62,3,3,2,8,0xb2d6c237
51193.3,2.0,31,2,3,2,7,0xb2d1e12cd
210015.31,3.0,87,3,4,1,8,0xb2d0b75b
10000.21,2.0,18,2,3,2,7,0xb2da1a58
501877.82,2.0,59,4,3,2,9,0xb2d8d51e
139946.49,2.0,76,3,3,1,7,0xb2d56e8d
115083.49,2.0,259,3,3,1,7,0xb2d53c50
54411.99,2.0,29,3,3,2,8,0xb2d2d734
52075.16,3.0,12,2,4,3,9,0xb2d130db
340000.0,2.0,19,4,3,2,9,0xb2da30d0
558006.57,3.0,129,4,4,1,9,0xb2d644f3d
30452.52,2.0,80,2,3,1,6,0xb2d61b9b
141171.37,1.0,10,3,2,3,8,0xb2d22a38d
1061.95,1.0,92,1,2,1,4,0xb2d298dd
5455.72,1.0,184,2,2,1,5,0xb2d3f3a6
100001.06,2.0,60,3,3,2,8,0xb2d93f76
82317.59,1.0,13,3,2,3,8,0xb2d2c3f4d
220063.05,2.0,6,3,3,3,9,0xb2d5de02
134007.9,8.0,24,3,4,2,9,0xb2d1b261d
464463.13,2.0,0,4,3,4,11,0xb2d0857ed
80421.84,2.0,0,3,3,4,10,0xb2d0f9b6
5015.08,1.0,2,2,2,4,8,0xb2d6d3af
2136.84,2.0,184,1,3,1,5,0xb2d0915cd
100006.78,2.0,161,3,3,1,7,0xb2d5755c
7026.98,1.0,81,2,2,1,5,0xb2d3c7ccd
459176.05,2.0,0,4,3,4,11,0xb2d2909fd
608.96,3.0,0,1,4,4,9,0x3b9b2846
14922.16,1.0,18,2,2,2,6,0xb2d99635
1007669.73,3.0,94,4,4,1,9,0xb2d1bf14
341637.35,5.0,0,4,4,4,12,0xb2d22225
120004.83,2.0,42,3,3,2,8,0xb2d8ef05d
2001.22,1.0,20,1,2,2,5,0xb2d6de94d
2204.93,2.0,1,1,3,4,8,0xb2d0ae91
200000.0,2.0,29,3,3,2,8,0xb2da0c4a
60.96,1.0,36,1,2,2,5,0xb2d6972d
5408.39,1.0,24,2,2,2,6,0xb2d23111d
470086.1,3.0,6,4,4,3,11,0xb2d68bdcd
603.23,1.0,7,1,2,3,6,0xb2d8ce73
120091.09,2.0,189,3,3,1,7,0xb2d1c8bd
50005.93,2.0,167,2,3,1,6,0xb2d65a55d
190002.01,2.0,6,3,3,3,9,0xb2d96bcf
210787.18,2.0,36,3,3,2,8,0xb2d29ec4
261.77,1.0,0,1,2,4,7,0xb2d2aeb8d
14.99,1.0,81,1,2,1,4,0xb2d3ec00
28137.15,4.0,185,2,4,1,7,0xb2d64dfdd
765044.19,9.0,18,4,4,2,10,0xb2d7a916
54989.18,1.0,7,3,2,3,8,0xb2d50aa8
1545.03,1.0,21,1,2,2,5,0xb2d330b2
513559.39,3.0,94,4,4,1,9,0xb2d0caeb
470016.23,10.0,0,4,4,4,12,0xb2d3a697
2017.43,1.0,22,1,2,2,5,0xb2d58f17
88.72,1.0,1,1,2,4,7,0xb2d91e62
322.09,1.0,55,1,2,2,5,0xb2d6d2a4
1683.51,1.0,44,1,2,2,5,0xb2d95204
243526.39,3.0,3,3,4,4,11,0xb2d25094
85.41,2.0,0,1,3,4,8,0xb2d2ad04
423826.65,6.0,0,4,4,4,12,0xb2d5c794
6.46,1.0,44,1,2,2,5,0xb2d592e7
806495.28,9.0,6,4,4,3,11,0xb2d0e629d
3749.16,1.0,92,2,2,1,5,0xb2d08851d
100222.78,3.0,39,3,4,2,9,0xb2d60398
3685.92,1.0,0,2,2,4,8,0xb2d6b53a
104208.01,4.0,15,3,4,3,10,0x3b9b44f9
1000011.09,4.0,10,4,4,3,11,0xb2d8d1ec
107307.48,2.0,174,3,3,1,7,0xb2d1e2b1
520068.05,7.0,3,4,4,4,12,0xb2d10ac2d
480015.22,2.0,92,4,3,1,8,0xb2d643fd
80093.1,5.0,101,3,4,1,8,0xb2d5271b
691637.88,8.0,2,4,4,4,12,0xb2d079b8d
508186.88,2.0,1,4,3,4,11,0xb2d53645
1116785.57,8.0,12,4,4,3,11,0xb2d9bcc4
1023.88,2.0,92,1,3,1,5,0xb2d06873
10004.92,2.0,70,2,3,1,6,0xb2d78035
50002.01,2.0,172,2,3,1,6,0xb2d63316
574007.2,7.0,111,4,4,1,9,0xb2d1a4e5d
31001.51,2.0,76,2,3,1,6,0xb2d64ade
85479.15,1.0,209,3,2,1,6,0xb2d4aa55
12852.0,1.0,92,2,2,1,5,0xb2d1e545
103.04,4.0,11,1,4,3,8,0xb2d95724
250520.57,4.0,13,3,4,3,10,0xb2d58322d
17122.26,1.0,34,2,2,2,6,0xb2d22b25d
61981.23,4.0,0,3,4,4,11,0x3b9ad0dd
11072.23,1.0,59,2,2,2,6,0xb2d9c16b
8038.86,1.0,4,2,2,4,8,0xb2d98e04
100007.42,1.0,0,3,2,4,9,0xb2d419db
461.8,1.0,33,1,2,2,5,0xb2d85837
86335.76,1.0,141,3,2,1,6,0xb2d37ca9
6942.37,4.0,92,2,4,1,7,0xb2d41dead
406434.69,3.0,28,4,4,2,10,0xb2d60436
79317.68,4.0,1,3,4,4,11,0xb2d5ed8ed
10001.61,2.0,31,2,3,2,7,0xb2d92c69
1014.64,1.0,223,1,2,1,4,0xb2d23737d
8047.81,1.0,92,2,2,1,5,0xb2d537c2
30.71,1.0,13,1,2,3,6,0xb2d4779e
51780.51,2.0,102,2,3,1,6,0xb2d49332
351655.6,3.0,35,4,4,2,10,0xb2d9a9f2
1813.38,1.0,119,1,2,1,4,0xb2d3700d
80010.23,2.0,92,3,3,1,7,0xb2d14b0a
348671.23,5.0,7,4,4,3,11,0xb2d54887
50190.93,2.0,92,2,3,1,6,0xb2d1bdbc
756094.6,2.0,0,4,3,4,11,0xb2d62cf6
3201.94,1.0,20,2,2,2,6,0xb2d6dd65
306.72,1.0,11,1,2,3,6,0xb2d60a89
71986.55,2.0,116,3,3,1,7,0xb2d18ac3d
20179.11,3.0,153,2,4,1,7,0xb2d5a9bed
414384.61,3.0,88,4,4,1,9,0xb2d1bc9dd
504278.43,5.0,10,4,4,3,11,0xb2d36832d
513460.38,5.0,13,4,4,3,11,0xb2d61870d
489486.79,6.0,52,4,4,2,10,0xb2d4d757d
5739.58,1.0,6,2,2,3,7,0xb2d92f1e
8.27,1.0,14,1,2,3,6,0xb2d38c82
9824.91,1.0,4,2,2,4,8,0xb2d5ae76
111002.37,4.0,1,3,4,4,11,0xb2d6008e
185161.36,3.0,9,3,4,3,10,0xb2d54e3a
250009.98,7.0,63,3,4,2,9,0xb2d0943d
22000.85,3.0,124,2,4,1,7,0xb2d55a51
430084.38,4.0,35,4,4,2,10,0xb2d0ebb0d
164840.26,3.0,4,3,4,4,11,0xb2d33875
0.0,3.0,0,1,4,4,9,0xb2da03db
787542.86,3.0,18,4,4,2,10,0xb2d57f2bd
7729.5,1.0,3,2,2,4,8,0xb2d670e0
300009.5,2.0,31,3,3,2,8,0xb2d9373cd
9847.21,1.0,3,2,2,4,8,0xb2d6a567
1069.24,1.0,92,1,2,1,4,0xb2d519ded
18000.19,2.0,80,2,3,1,6,0xb2d51421
1500406.53,3.0,3,4,4,4,12,0xb2d4497dd
3096.43,1.0,13,2,2,3,7,0xb2d41a76
300000.0,2.0,20,3,3,2,8,0xb2da2815
15001.52,1.0,10,2,2,3,7,0xb2d0f98e
3161.78,1.0,18,2,2,2,6,0xb2d3fcd7
653931.49,2.0,52,4,3,2,9,0xb2d63b3f
10069.15,1.0,105,2,2,1,5,0xb2d61f76d
253534.31,3.0,4,3,4,4,11,0xb2d42430
289031.02,8.0,6,3,4,3,10,0xb2d0a9d9
6007.64,2.0,0,2,3,4,9,0xb2d4f398d
1423.78,1.0,11,1,2,3,6,0xb2d1b0b8d
1003.33,1.0,4,1,2,4,7,0xb2d2f0ba
211018.72,5.0,32,3,4,2,9,0xb2d38398
50760.81,3.0,0,2,4,4,10,0x3b9b2ae0d
33207.1,1.0,10,2,2,3,7,0xb2d6b7e5
1621019.41,10.0,5,4,4,3,11,0xb2d4f1f8
60580.14,1.0,11,3,2,3,8,0xb2d2b5f7d
8806.63,1.0,0,2,2,4,8,0xb2d483f4
159.12,1.0,4,1,2,4,7,0x3b9b2895d
22.52,1.0,0,1,2,4,7,0xb2d8d2e5
0.33,1.0,77,1,2,1,4,0xb2d8d447d
8140.68,1.0,184,2,2,1,5,0x3b9b2eb5
130221.15,3.0,3,3,4,4,11,0xb2d2c029
677719.7,4.0,25,4,4,2,10,0xb2d19523d
825769.56,6.0,8,4,4,3,11,0xb2d21daa
210815.73,2.0,42,3,3,2,8,0xb2d1a8d8d
800100.0,2.0,4,4,3,4,11,0xb2d9cee7
50783.78,2.0,20,2,3,2,7,0xb2d53fc7d
2771.46,1.0,6,1,2,3,6,0xb2d3e19c
177014.8,6.0,94,3,4,1,8,0xb2d116bfd
417276.68,3.0,18,4,4,2,10,0xb2d509af
3150058.73,7.0,42,4,4,2,10,0xb2d3af6b
172.38,1.0,0,1,2,4,7,0xb2d1ff55
9.19,1.0,80,1,2,1,4,0xb2d0b91f
10228.37,1.0,92,2,2,1,5,0xb2d0aa7ad
852055.34,5.0,18,4,4,2,10,0xb2d5b112d
160005.49,3.0,67,3,4,1,8,0xb2d6ec32
12749.14,1.0,49,2,2,2,6,0xb2d8cc7bd
1.26,1.0,11,1,2,3,6,0xb2d20c93
1517.47,2.0,67,1,3,1,5,0xb2d4906f
5234.53,1.0,184,2,2,1,5,0xb2d0794cd
30035.38,2.0,193,2,3,1,6,0xb2d688ef
206010.77,2.0,3,3,3,4,10,0xb2d61e74d
20000.0,2.0,6,2,3,3,8,0xb2d96f6ed
892.46,1.0,21,1,2,2,5,0xb2d27d34
9056.73,2.0,16,2,3,2,7,0xb2d98a5a
144121.27,3.0,0,3,4,4,11,0xb2d27399
3986.36,1.0,17,2,2,2,6,0xb2d5498b
15699.55,2.0,5,2,3,3,8,0xb2d60de6d
3467.83,2.0,184,2,3,1,6,0xb2d064c8d
621833.14,2.0,0,4,3,4,11,0xb2d57276d
70136.6,1.0,186,3,2,1,6,0xb2d41474d
13096.49,1.0,184,2,2,1,5,0xb2d3f909d
307624.87,2.0,36,4,3,2,9,0xb2d64323
1062.64,1.0,184,1,2,1,4,0xb2d24d12
13821.23,1.0,9,2,2,3,7,0xb2d9056c
1168814.53,15.0,1,4,4,4,12,0x3b9b0fc9d
1396.94,1.0,184,1,2,1,4,0x3b9b0fdd
300065.64,2.0,18,3,3,2,8,0xb2d912a0
9130099.75,2.0,39,4,3,2,9,0xb2d8ffe3d
83421.19,2.0,139,3,3,1,7,0xb2d28be3
10094.32,2.0,0,2,3,4,9,0xb2d22734
2.15,1.0,65,1,2,2,5,0xb2d6c2fe
3000000.0,3.0,1,4,4,4,12,0xb2da5f8b
200210.22,3.0,10,3,4,3,10,0xb2d6f323
2406092.36,10.0,19,4,4,2,10,0xb2d3c23cd
7.62,1.0,112,1,2,1,4,0xb2d0e48e
1381.9,1.0,131,1,2,1,4,0xb2d4107d
59003.68,2.0,245,3,3,1,7,0xb2d29667
10433.7,1.0,26,2,2,2,6,0xb2d97b6b
90004.75,2.0,76,3,3,1,7,0xb2d98fb5
10000.24,2.0,17,2,3,2,7,0xb2da2b29
9.5,1.0,53,1,2,2,5,0xb2d97034
4131.28,2.0,184,2,3,1,6,0x3b9b4587d
600285.43,4.0,0,4,4,4,12,0xb2d30c2fd
190013.34,4.0,31,3,4,2,9,0xb2d6d972d
600190.0,2.0,39,4,3,2,9,0xb2d22872
2802.58,1.0,40,1,2,2,5,0xb2d78c37d
71827.9,5.0,0,3,4,4,11,0x3b9b3272d
1503.81,1.0,113,1,2,1,4,0xb2d65adf
62231.18,1.0,7,3,2,3,8,0xb2d2e3ced
338288.21,2.0,7,4,3,3,10,0xb2d5ece3
812060.8,7.0,0,4,4,4,12,0xb2d1bd88d
22215.62,5.0,0,2,4,4,10,0xb2d0908a
1050086.97,5.0,0,4,4,4,12,0xb2d65854d
246.06,1.0,18,1,2,2,5,0xb2d69a23d
732320.2,7.0,0,4,4,4,12,0xb2d2cbb2
171282.78,5.0,1,3,4,4,11,0xb2d45285d
3659.35,1.0,4,2,2,4,8,0xb2d9d298
31157.08,1.0,21,2,2,2,6,0xb2d6bf5b
1293.72,1.0,40,1,2,2,5,0xb2d37198
122990.83,5.0,4,3,4,4,11,0xb2d27996d
805.93,1.0,4,1,2,4,7,0xb2d215e0d
648.12,1.0,72,1,2,1,4,0xb2d3afff
790.64,1.0,9,1,2,3,6,0xb2d8cbfe
6094.99,1.0,0,2,2,4,8,0xb2d20062d
67015.71,3.0,98,3,4,1,8,0xb2d1a863
3641495.58,9.0,12,4,4,3,11,0xb2d244a6d
500000.0,2.0,8,4,3,3,10,0xb2da522a
321460.77,3.0,19,4,4,2,10,0xb2d24033d
3935.08,1.0,125,2,2,1,5,0xb2d55e22
55075.04,1.0,1,3,2,4,9,0xb2d3989b
190018.66,4.0,104,3,4,1,8,0xb2d4dd0fd
13368.03,1.0,25,2,2,2,6,0xb2d2ee56d
501776.1,2.0,29,4,3,2,9,0xb2d8fdb3
1004179.36,3.0,29,4,4,2,10,0xb2d614d5d
12516.38,1.0,17,2,2,2,6,0xb2d6b4c8
203948.18,13.0,1,3,4,4,11,0xb2d5f607d
25000.48,3.0,74,2,4,1,7,0xb2d91d20d
580000.0,5.0,4,4,4,4,12,0xb2d93717
400744.61,3.0,10,4,4,3,11,0xb2d65c94
10.06,1.0,16,1,2,2,5,0xb2d920a9
481099.31,3.0,57,4,4,2,10,0x3b9b41a7d
348.17,1.0,4,1,2,4,7,0xb2d9f08a
1755.29,1.0,9,1,2,3,6,0xb2d83ede
1000000.0,1.0,0,4,2,4,10,0xb2d9f4e2
3.17,1.0,7,1,2,3,6,0xb2d902fa
380016.24,4.0,60,4,4,2,10,0xb2d40b83
380000.0,1.0,1,4,2,4,10,0xb2da657c
109.68,1.0,0,1,2,4,7,0xb2d9686a
302131.7,2.0,75,4,3,1,8,0xb2d8e29ed
18250.17,1.0,9,2,2,3,7,0xb2d322fcd
1315.24,1.0,184,1,2,1,4,0xb2d13d26
48.33,1.0,60,1,2,2,5,0xb2d5b114d
16139.18,1.0,19,2,2,2,6,0xb2d1fe25
3930477.31,8.0,5,4,4,3,11,0xb2d6f508d
110601.62,5.0,37,3,4,2,9,0xb2d8cca5d
150077.46,3.0,111,3,4,1,8,0xb2d3ea33d
1091.65,1.0,2,1,2,4,7,0xb2d2093e
25303.3,2.0,41,2,3,2,7,0xb2d6e19cd
190037.95,1.0,0,3,2,4,9,0xb2d93010
500092.54,2.0,11,4,3,3,10,0xb2d9c574
1206.93,1.0,184,1,2,1,4,0xb2d12c4a
50015.65,1.0,3,2,2,4,8,0xb2da655a
402108.35,2.0,3,4,3,4,11,0xb2d6dc59d
170002.41,3.0,69,3,4,1,8,0xb2d5cb3fd
90.32,1.0,47,1,2,2,5,0xb2d4887e
18309.8,1.0,39,2,2,2,6,0xb2d3c3b5d
30201.02,2.0,14,2,3,3,8,0xb2d354fe
50085.73,2.0,101,2,3,1,6,0xb2d649d8d
9940.63,1.0,0,2,2,4,8,0xb2d967c8
90057.41,2.0,32,3,3,2,8,0xb2d2a975
70710.23,2.0,66,3,3,2,8,0xb2d28189
165.53,1.0,90,1,2,1,4,0xb2d2515e
11000.12,2.0,14,2,3,3,8,0xb2d63f5c
42.42,1.0,28,1,2,2,5,0xb2d59b54
65533.5,2.0,2,3,3,4,10,0xb2d53a58d
3346.08,1.0,2,2,2,4,8,0xb2d31376
301103.36,2.0,11,4,3,3,10,0xb2d982ef
321545.28,2.0,1,4,3,4,11,0xb2d8fb69
5186.55,1.0,1,2,2,4,8,0xb2d6501c
1121710.66,3.0,9,4,4,3,11,0xb2d445b1
131002.37,3.0,168,3,4,1,8,0xb2d5c2efd
80004.06,2.0,97,3,3,1,7,0xb2d431f4
144.26,1.0,20,1,2,2,5,0xb2d2b685
12746.77,1.0,1,2,2,4,8,0xb2d6d0bd
5594.09,1.0,5,2,2,3,7,0xb2d579cd
200008.44,2.0,48,3,3,2,8,0xb2d9106fd
1653236.06,5.0,0,4,4,4,12,0xb2d0e386d
736.38,1.0,62,1,2,2,5,0xb2d1fc0ed
544.28,1.0,10,1,2,3,6,0xb2d6f055d
200080.3,4.0,1,3,4,4,11,0xb2d939d0d
435.46,1.0,1,1,2,4,7,0xb2d69fcb
36516.26,1.0,18,2,2,2,6,0xb2d5e428
626533.65,3.0,23,4,4,2,10,0xb2d14fbe
187151.32,3.0,1,3,4,4,11,0xb2d64edf
10178.91,2.0,39,2,3,2,7,0xb2d20cc1
6076.07,4.0,184,2,4,1,7,0xb2d0796fd
219151.95,3.0,11,3,4,3,10,0xb2d249bc
363344.1,3.0,0,4,4,4,12,0xb2d50995d
3163.19,1.0,19,2,2,2,6,0xb2d6c05b
20004.78,1.0,0,2,2,4,8,0xb2d5ef66
180193.33,2.0,77,3,3,1,7,0xb2d65ba6d
31963.74,1.0,26,2,2,2,6,0xb2d42708
1024.85,1.0,184,1,2,1,4,0xb2d1b608
470161.85,3.0,3,4,4,4,12,0xb2d20ca7
6600000.0,4.0,10,4,4,3,11,0xb2d1d310
808.76,1.0,9,1,2,3,6,0xb2d87d31
1210.59,1.0,92,1,2,1,4,0xb2d2e313
4.54,1.0,10,1,2,3,6,0xb2d6273d
19172.33,1.0,0,2,2,4,8,0xb2d63e1dd
154770.5,7.0,10,3,4,3,10,0xb2d1936cd
1884.72,4.0,0,1,4,4,9,0xb2d06b7a
183592.73,4.0,0,3,4,4,11,0xb2d29229d
2604.38,1.0,14,1,2,3,6,0xb2d960ea
413468.65,5.0,8,4,4,3,11,0xb2d5fc13d
151016.41,3.0,3,3,4,4,11,0xb2d5ae49d
235015.48,4.0,6,3,4,3,10,0xb2d11db4
577881.3,4.0,33,4,4,2,10,0xb2d6b150
2158.21,1.0,0,1,2,4,7,0xb2d92120
40029.71,5.0,1,2,4,4,10,0xb2d9ec98
800021.11,3.0,4,4,4,4,12,0xb2d9b1c9
900050.0,4.0,3,4,4,4,12,0xb2d97108d
175.36,1.0,1,1,2,4,7,0xb2d6e94b
13145.88,1.0,1,2,2,4,8,0xb2d0f209
340025.9,4.0,34,4,4,2,10,0xb2d6b904d
164673.43,4.0,8,3,4,3,10,0xb2d6b3f7
7399.98,1.0,1,2,2,4,8,0xb2d3fa63
17075.71,1.0,1,2,2,4,8,0xb2d28318
60140.12,4.0,11,3,4,3,10,0x3b9af0cb
89863.45,5.0,24,3,4,2,9,0xb2d0c9a0d
170133.68,4.0,31,3,4,2,9,0xb2d358f1
464.93,1.0,104,1,2,1,4,0xb2d3b35a
935051.75,4.0,19,4,4,2,10,0xb2d27f8bd
164.28,1.0,104,1,2,1,4,0xb2d245a1
300396.21,2.0,12,4,3,3,10,0xb2d802b5d
580000.0,5.0,3,4,4,4,12,0xb2d0d997
200000.0,2.0,5,3,3,3,9,0xb2da5dd8
300003.59,2.0,14,3,3,3,9,0xb2d615ced
460000.0,2.0,20,4,3,2,9,0xb2d954d1d
340020.37,2.0,256,4,3,1,8,0xb2d168c4d
17221.32,2.0,46,2,3,2,7,0xb2d1a756d
50036.42,1.0,78,2,2,1,5,0xb2d8cdbd
23611.09,1.0,12,2,2,3,7,0xb2d28969d
50107.72,3.0,11,2,4,3,9,0xb2d314ed
54740.31,1.0,162,3,2,1,6,0xb2d6bbadd
44.89,1.0,29,1,2,2,5,0xb2d22895
200062.07,2.0,98,3,3,1,7,0xb2d38b62d
100011.37,2.0,175,3,3,1,7,0xb2d2462dd
108166.1,2.0,4,3,3,4,10,0xb2d6fae5d
192917.97,3.0,80,3,4,1,8,0xb2d288edd
176370.79,2.0,10,3,3,3,9,0xb2d25c2cd
14.94,2.0,12,1,3,3,7,0xb2d7c32b
2.34,1.0,67,1,2,1,4,0xb2d5ce2d
260926.5,2.0,32,3,3,2,8,0xb2d9ec78
1124255.99,4.0,5,4,4,3,11,0xb2d41444
402510.97,4.0,0,4,4,4,12,0xb2d1a945
271918.74,2.0,84,3,3,1,7,0xb2d8d15d
930009.82,2.0,18,4,3,2,9,0xb2da2f90
200060.83,2.0,10,3,3,3,9,0xb2d145ffd
285452.45,5.0,11,3,4,3,10,0xb2d5d1cf
130095.79,2.0,0,3,3,4,10,0xb2d69ebb
50575.51,2.0,73,2,3,1,6,0xb2d0ffa3d
352.42,1.0,2,1,2,4,7,0xb2d6c6e4
1018.48,1.0,184,1,2,1,4,0xb2d192e5
70034.14,6.0,34,3,4,2,9,0xb2d5def8d
58464.69,1.0,12,3,2,3,8,0xb2d32df3
222621.64,2.0,83,3,3,1,7,0xb2d6347b
6372.25,1.0,2,2,2,4,8,0xb2d6b82d
8077.7,1.0,9,2,2,3,7,0xb2d35d77
602624.91,2.0,10,4,3,3,10,0xb2d39768
12.67,1.0,19,1,2,2,5,0xb2d6472c
13113.2,1.0,184,2,2,1,5,0xb2d58c5e
200079.73,4.0,90,3,4,1,8,0xb2d50f54
7477.46,1.0,173,2,2,1,5,0xb2d2c4fe
1016.25,1.0,184,1,2,1,4,0xb2d1dad4d
12802.98,1.0,76,2,2,1,5,0xb2d5090dd
420013.13,4.0,119,4,4,1,9,0xb2d6845fd
6235996.64,1.0,0,4,2,4,10,0xb2d45700
178.02,1.0,1,1,2,4,7,0xb2d34186d
140000.68,5.0,0,3,4,4,11,0xb2d9157e
11974.49,2.0,9,2,3,3,8,0xb2d60abb
569635.71,3.0,55,4,4,2,10,0xb2d132c5d
50100.74,2.0,104,2,3,1,6,0xb2d24eaed
5022.74,1.0,42,2,2,2,6,0xb2d78670
3739.65,1.0,7,2,2,3,7,0xb2d78626
214023.0,4.0,19,3,4,2,9,0xb2d0a8f7
16.0,1.0,2,1,2,4,7,0xb2d0b806
1293.1,1.0,92,1,2,1,4,0xb2d263ca
29291.34,5.0,0,2,4,4,10,0xb2d0f2c4
16509.45,1.0,14,2,2,3,7,0xb2d69fcd
50001.16,3.0,157,2,4,1,7,0xb2d691f1d
110369.84,3.0,0,3,4,4,11,0xb2d475cd
3063.36,1.0,12,2,2,3,7,0xb2d4350d
30.43,1.0,2,1,2,4,7,0xb2d22602
4168.08,1.0,0,2,2,4,8,0xb2d607bb
100001.06,2.0,13,3,3,3,9,0xb2d95cee
703001.01,11.0,4,4,4,4,12,0xb2d59063
277.05,1.0,2,1,2,4,7,0xb2d32b75
300002.11,3.0,14,3,4,3,10,0xb2da1249
286072.74,4.0,4,3,4,4,11,0xb2d28185
9.42,1.0,0,1,2,4,7,0xb2d92a59
220009.16,4.0,7,3,4,3,10,0xb2d5ad8bd
12208.0,2.0,0,2,3,4,9,0xb2d30f53
6001.85,1.0,1,2,2,4,8,0xb2d61eb1
1563.77,1.0,72,1,2,1,4,0xb2d2f85c
8009.43,1.0,105,2,2,1,5,0xb2d8fc78
513.21,1.0,111,1,2,1,4,0xb2d17362
35.82,4.0,1,1,4,4,9,0x3b9b345cd
700235.67,3.0,69,4,4,1,9,0xb2d1b4d4d
60432.9,2.0,125,3,3,1,7,0xb2d42068
6.1,1.0,14,1,2,3,6,0xb2d8eedb
450002.94,3.0,11,4,4,3,11,0xb2d10adf
283.96,1.0,10,1,2,3,6,0xb2d6f3c8
8.58,1.0,2,1,2,4,7,0xb2d3a7c7
1073.65,1.0,4,1,2,4,7,0xb2d22a88
1355.72,1.0,184,1,2,1,4,0xb2d33790
105025.52,3.0,0,3,4,4,11,0xb2d637c7d
50024.73,3.0,0,2,4,4,10,0xb2d192d4
1815000.0,30.0,1,4,4,4,12,0xb2d3b239
8087.97,1.0,13,2,2,3,7,0xb2da061b
67.44,1.0,0,1,2,4,7,0xb2d6b7d6
41.67,1.0,11,1,2,3,6,0xb2d22170
11752.55,1.0,0,2,2,4,8,0xb2d54891d
458000.0,3.0,2,4,4,4,12,0xb2d6e950
500027.58,3.0,13,4,4,3,11,0xb2d5e073d
30848.14,2.0,184,2,3,1,6,0xb2d08fbc
7.07,1.0,17,1,2,2,5,0xb2d4dd54d
8608.66,1.0,236,2,2,1,5,0xb2d19d14
25305.34,1.0,0,2,2,4,8,0xb2d21105
875.26,1.0,9,1,2,3,6,0xb2d8ef72
4489.09,1.0,10,2,2,3,7,0xb2d28f0ed
500000.0,2.0,24,4,3,2,9,0xb2d949d2d
200000.0,2.0,1,3,3,4,10,0xb2d6d3a4
20170.4,1.0,184,2,2,1,5,0xb2d604d8d
610.46,1.0,6,1,2,3,6,0xb2d2ccfe
100140.62,2.0,8,3,3,3,9,0xb2d5bd2bd
1824.46,1.0,0,1,2,4,7,0xb2d312d7
60008.89,1.0,66,3,2,2,7,0xb2d61c71
40001.13,3.0,52,2,4,2,8,0xb2d8d61c
608.26,1.0,0,1,2,4,7,0xb2d685f9
164105.04,11.0,0,3,4,4,11,0xb2d6503d
8160.31,1.0,0,2,2,4,8,0xb2d33b78
464.32,1.0,17,1,2,2,5,0xb2d270fb
381057.67,4.0,24,4,4,2,10,0xb2d23b28
3004360.93,2.0,10,4,3,3,10,0xb2d5b477d
108482.95,3.0,39,3,4,2,9,0xb2d3699b
7193.35,1.0,184,2,2,1,5,0xb2d27057d
1703342.21,3.0,22,4,4,2,10,0xb2d6e719d
1.07,1.0,11,1,2,3,6,0xb2d93a2c
6346.65,1.0,12,2,2,3,7,0xb2d267e4d
100003.17,2.0,158,3,3,1,7,0xb2d8ecda
4018.45,1.0,2,2,2,4,8,0xb2d6dac8
10484.9,2.0,28,2,3,2,7,0xb2d9d4cd
1606557.9,12.0,11,4,4,3,11,0xb2d4ff97
50946.66,1.0,6,2,2,3,7,0xb2d6a3a4
451309.69,6.0,3,4,4,4,12,0xb2d209c5d
408852.41,2.0,77,4,3,1,8,0xb2d44d77d
140001.48,2.0,59,3,3,2,8,0xb2d8fe5e
100013.84,2.0,16,3,3,2,8,0xb2d60dc5d
22.85,1.0,11,1,2,3,6,0xb2d27c49d
0.0,1.0,6,1,2,3,6,0xb2d90d2b
5293.83,1.0,188,2,2,1,5,0xb2d35620
5727.71,1.0,5,2,2,3,7,0xb2d558d2
320014.81,5.0,1,4,4,4,12,0xb2d68972d
13717.46,1.0,14,2,2,3,7,0xb2d46923d
5370.31,1.0,47,2,2,2,6,0xb2d366cf
50002.64,2.0,48,2,3,2,7,0xb2d9d2f7
10025.22,2.0,92,2,3,1,6,0xb2d63f26d
50987.33,2.0,53,2,3,2,7,0xb2d5aac4d
5.28,1.0,60,1,2,2,5,0xb2d0b642
5393.13,1.0,0,2,2,4,8,0xb2d6b842
554244.37,7.0,0,4,4,4,12,0xb2d08306d
340128.02,3.0,55,4,4,2,10,0xb2d10b9f
1954.55,1.0,92,1,2,1,4,0xb2d2eee2d
30914.09,2.0,5,2,3,3,8,0xb2d968fbd
50531.03,2.0,0,2,3,4,9,0xb2d5b526d
200000.0,2.0,1,3,3,4,10,0xb2d980f6d
380018.44,4.0,4,4,4,4,12,0xb2d6ed8a
160002.93,6.0,0,3,4,4,11,0xb2d48bbfd
700100.0,2.0,6,4,3,3,10,0xb2da29f0
6462.61,1.0,254,2,2,1,5,0xb2d553e9
1059.7,1.0,22,1,2,2,5,0xb2d3cacb
150101.94,2.0,47,3,3,2,8,0xb2d176cd
3103.55,1.0,109,2,2,1,5,0xb2d5982c
253.97,1.0,7,1,2,3,6,0xb2d31e9b
2500.14,1.0,9,1,2,3,6,0xb2d6d308
158355.97,2.0,216,3,3,1,7,0xb2d36533
103872.97,2.0,231,3,3,1,7,0xb2d5a874
15932.26,1.0,0,2,2,4,8,0xb2d5c8ad
6576.44,1.0,118,2,2,1,5,0xb2d57b03d
639.35,1.0,1,1,2,4,7,0xb2d7bdad
107197.9,2.0,4,3,3,4,10,0xb2d53f41d
1742256.61,4.0,34,4,4,2,10,0xb2d57a7b
4.76,1.0,0,1,2,4,7,0xb2d3b54a
162771.99,3.0,28,3,4,2,9,0xb2d0e0ead
200064.17,2.0,11,3,3,3,9,0xb2d5d04bd
501782.08,2.0,9,4,3,3,10,0xb2d8eabd
13713.46,1.0,20,2,2,2,6,0xb2d6a072
1.56,1.0,83,1,2,1,4,0xb2d54e8f
230966.37,5.0,95,3,4,1,8,0xb2d13eef
0.0,1.0,78,1,2,1,4,0xb2d8da3d
55604.89,2.0,21,3,3,2,8,0xb2d5609f
25415.34,1.0,12,2,2,3,7,0xb2d5dd5a
100274.47,2.0,60,3,3,2,8,0xb2d3b5b7d
50521.91,2.0,221,2,3,1,6,0xb2d63df6
95026.33,4.0,25,3,4,2,9,0xb2d2681bd
500076.05,2.0,18,4,3,2,9,0xb2d8da7cd
37.23,1.0,22,1,2,2,5,0xb2d3e86dd
3.19,2.0,72,1,3,1,5,0xb2d8de62d
100290.8,2.0,196,3,3,1,7,0xb2d50259
9003.91,1.0,10,2,2,3,7,0xb2d8e40f
170.18,1.0,65,1,2,2,5,0xb2d55c2a
60003.17,2.0,76,3,3,1,7,0xb2d991ee
463.41,1.0,0,1,2,4,7,0xb2d43426d
32.17,1.0,2,1,2,4,7,0xb2d6dba4d
847045.7,8.0,0,4,4,4,12,0xb2d4f45cd
64510.29,1.0,92,3,2,1,6,0xb2d181abd
50145.81,1.0,92,2,2,1,5,0xb2d621d3d
3654.8,1.0,4,2,2,4,8,0xb2d92242
0.0,1.0,3,1,2,4,7,0xb2d4327c
1870514.84,3.0,0,4,4,4,12,0xb2d6d4ded
300000.0,2.0,13,3,3,3,9,0xb2d8e4d4
120.05,1.0,32,1,2,2,5,0xb2d5e908
17399.13,1.0,184,2,2,1,5,0xb2d2df7ad
646752.58,4.0,122,4,4,1,9,0xb2d279d4d
19270.51,1.0,119,2,2,1,5,0xb2d9037ad
25945.72,1.0,0,2,2,4,8,0xb2d36a43d
2154213.47,16.0,0,4,4,4,12,0x3b9af30b
1371.76,1.0,184,1,2,1,4,0x3b9b29f4d
80060.65,2.0,154,3,3,1,7,0xb2d6c5ec
248093.58,3.0,2,3,4,4,11,0xb2d2f2a3d
676.38,1.0,6,1,2,3,6,0xb2d5f1cfd
2407.79,1.0,4,1,2,4,7,0xb2d6b1de
1250.47,1.0,1,1,2,4,7,0xb2d39d57
1242687.71,2.0,135,4,3,1,8,0xb2d67cb7d
160000.0,4.0,0,3,4,4,11,0xb2d65a21
150125.96,2.0,68,3,3,1,7,0xb2d51e26d
10020.08,2.0,154,2,3,1,6,0xb2d63c65
131550.9,2.0,158,3,3,1,7,0xb2d6c4f6
600002.02,4.0,4,4,4,4,12,0xb2da1e7c
18390.6,1.0,0,2,2,4,8,0xb2d6c41bd
5367.4,1.0,92,2,2,1,5,0xb2d25f56
70.3,1.0,8,1,2,3,6,0xb2d1dc7f
50000.0,3.0,5,2,4,3,9,0xb2d91492
51450.2,2.0,104,2,3,1,6,0xb2d42a0ad
374379.76,3.0,0,4,4,4,12,0xb2d4a98a
2207.13,1.0,184,1,2,1,4,0x3b9b3993
102798.61,3.0,25,3,4,2,9,0xb2d2b08bd
2941.85,1.0,60,2,2,2,6,0xb2d9b492
460438.85,5.0,9,4,4,3,11,0xb2d2c532d
7189.81,1.0,6,2,2,3,7,0xb2d3d58c
9635.29,1.0,15,2,2,3,7,0xb2d9add5
300070.11,3.0,20,3,4,2,9,0xb2d68ea3d
1381008.61,7.0,4,4,4,4,12,0xb2d31813
1403.24,1.0,181,1,2,1,4,0xb2d60bb8
2778.12,1.0,20,1,2,2,5,0xb2d5b9ec
60.55,1.0,9,1,2,3,6,0xb2d77fced
202469.79,2.0,24,3,3,2,8,0xb2d2ee7ed
23284.85,1.0,0,2,2,4,8,0xb2d69249
1126.96,1.0,0,1,2,4,7,0xb2d5725d
12509.92,1.0,84,2,2,1,5,0xb2d93164
555.9,1.0,0,1,2,4,7,0xb2d69ef3
1953411.99,13.0,5,4,4,3,11,0xb2d69290d
805278.63,16.0,1,4,4,4,12,0xb2d3b919
100077.76,2.0,154,3,3,1,7,0xb2d0ef18
366630.57,6.0,59,4,4,2,10,0xb2d26c09d
300065.75,2.0,14,3,3,3,9,0xb2d9cdcf
5601.73,1.0,12,2,2,3,7,0xb2d16cb5
13055623.93,5.0,0,4,4,4,12,0xb2d485cfd
1303.59,1.0,92,1,2,1,4,0xb2d192ec
1598.62,2.0,5,1,3,3,7,0xb2d2c0c7
21045.17,2.0,59,2,3,2,7,0xb2d5e074
51429.9,2.0,182,2,3,1,6,0xb2d5e150
50000.53,2.0,18,2,3,2,7,0xb2da2e8a
9.99,1.0,3,1,2,4,7,0xb2d2b176d
1508.56,1.0,29,1,2,2,5,0xb2d91ca7
3055.52,1.0,92,2,2,1,5,0xb2d1c963d
1027.58,1.0,60,1,2,2,5,0xb2d59d32
130033.7,3.0,11,3,4,3,10,0xb2d424bad
8199.55,1.0,92,2,2,1,5,0xb2d15f65
880184.93,3.0,97,4,4,1,9,0xb2d13f27
1.19,1.0,18,1,2,2,5,0xb2d5b32f
488058.85,1.0,13,4,2,3,9,0xb2d5e3afd
1998.52,1.0,96,1,2,1,4,0xb2d8d55bd
234310.31,2.0,0,3,3,4,10,0xb2d5af86d
94208.84,1.0,49,3,2,2,7,0xb2d37bf0
309.55,1.0,54,1,2,2,5,0xb2d2c005d
4162.41,1.0,0,2,2,4,8,0xb2d6ab27
247.57,1.0,21,1,2,2,5,0xb2d3f2e5
6734.25,1.0,224,2,2,1,5,0xb2d57934
1015.92,2.0,215,1,3,1,5,0xb2d11ea0d
0.0,1.0,36,1,2,2,5,0xb2d41b31
3762.43,1.0,77,2,2,1,5,0xb2d23746d
1000099.75,2.0,147,4,3,1,8,0xb2d81f82
47.85,1.0,3,1,2,4,7,0xb2d1af51
80121.68,2.0,108,3,3,1,7,0xb2d105cd
1738.2,1.0,9,1,2,3,6,0xb2d6f78f
1511.72,1.0,184,1,2,1,4,0xb2d108dc
40078.48,2.0,41,2,3,2,7,0xb2d6a7e7d
499061.77,9.0,6,4,4,3,11,0xb2d3d86bd
2625.14,1.0,26,1,2,2,5,0xb2d8c3ae
71566.39,2.0,11,3,3,3,9,0xb2d10812d
30000.63,2.0,59,2,3,2,7,0xb2d8fcd8d
1802.74,1.0,123,1,2,1,4,0xb2d70142
500018.05,3.0,2,4,4,4,12,0xb2d9da6f
204924.21,4.0,18,3,4,2,9,0xb2d36caf
3747.46,1.0,115,2,2,1,5,0xb2d4321fd
250000.12,2.0,15,3,3,3,9,0xb2d7e013d
20595.21,1.0,10,2,2,3,7,0xb2d35764
2502.49,1.0,93,1,2,1,4,0xb2d94e52
407889.35,3.0,9,4,4,3,11,0xb2d213dc
264.42,1.0,16,1,2,2,5,0xb2d23918
509511.09,3.0,19,4,4,2,10,0xb2d3f455d
105004.9,4.0,129,3,4,1,8,0xb2d4c901
2805.45,1.0,191,1,2,1,4,0xb2d58617
181455.84,3.0,102,3,4,1,8,0xb2d1a482d
5400.09,1.0,13,2,2,3,7,0xb2d16ea9
42.35,1.0,11,1,2,3,6,0xb2d7905b
10377.35,1.0,184,2,2,1,5,0xb2d30869
2011.74,1.0,92,1,2,1,4,0xb2d0d205
40002.42,3.0,14,2,4,3,9,0xb2d64028
1151491.79,9.0,0,4,4,4,12,0xb2d1676bd
101029.59,3.0,62,3,4,2,9,0xb2d6295ad
90574.65,4.0,7,3,4,3,10,0xb2d59cdfd
379959.05,4.0,74,4,4,1,9,0xb2d3eaac
1.11,1.0,13,1,2,3,6,0xb2d95853d
5245.3,1.0,0,2,2,4,8,0xb2d5c587d
180000.0,2.0,2,3,3,4,10,0xb2d21d77
180009.25,3.0,214,3,4,1,8,0xb2d389e9
11827.18,1.0,4,2,2,4,8,0xb2d2e947
10.05,1.0,54,1,2,2,5,0xb2d8da24
210249.15,3.0,40,3,4,2,9,0xb2d60930
158451.89,3.0,0,3,4,4,11,0xb2d0a5e2d
4124.96,1.0,92,2,2,1,5,0xb2d406cad
1862310.12,7.0,0,4,4,4,12,0xb2d5ddf3
264.27,2.0,2,1,3,4,8,0x3b9b46a5
2804.79,3.0,10,1,4,3,8,0xb2d2579c
140091.04,4.0,74,3,4,1,8,0xb2d55844d
220003.93,5.0,3,3,4,4,11,0x3b9b355a
200000.0,2.0,7,3,3,3,9,0xb2da55f6
955458.42,7.0,4,4,4,4,12,0xb2d1e8a6
6321.76,1.0,2,2,2,4,8,0xb2d2b58ad
250334.23,5.0,0,3,4,4,11,0xb2d0def6d
13381.59,1.0,9,2,2,3,7,0xb2d9fc06
382656.76,4.0,3,4,4,4,12,0x3b9b0e6b
354843.22,2.0,1,4,3,4,11,0xb2d0729cd
50034.16,4.0,73,2,4,1,7,0x3b9ade07d
50043.23,1.0,10,2,2,3,7,0xb2d27fe4d
6025.27,1.0,184,2,2,1,5,0xb2d1c13f
72.41,1.0,184,1,2,1,4,0xb2d2f6a4d
152053.94,1.0,7,3,2,3,8,0xb2d33c0c
158682.85,2.0,0,3,3,4,10,0xb2d2b6a0
1901.82,1.0,18,1,2,2,5,0xb2d5d772
381543.96,1.0,184,4,2,1,7,0xb2d393de
200.95,1.0,0,1,2,4,7,0xb2d70120
261109.64,2.0,18,3,3,2,8,0xb2d52728
100002.11,2.0,39,3,3,2,8,0xb2d9eeae
476782.67,3.0,61,4,4,2,10,0xb2d7876fd
8.87,1.0,35,1,2,2,5,0xb2d9b906
60000.63,2.0,18,3,3,2,8,0xb2da29fb
70616.86,2.0,4,3,3,4,10,0xb2d2d1b8
200010.42,2.0,5,3,3,3,9,0xb2d9fdb4
155365.59,2.0,0,3,3,4,10,0xb2d09fc8d
51097.52,2.0,97,2,3,1,6,0xb2d5f44d
2453.55,1.0,1,1,2,4,7,0xb2d6bcfe
16236.82,1.0,103,2,2,1,5,0xb2d39569
195620.85,6.0,6,3,4,3,10,0xb2d11875d
238423.37,2.0,217,3,3,1,7,0x3b9b3666d
50141.02,2.0,0,2,3,4,9,0xb2d28d4f
891393.48,2.0,0,4,3,4,11,0xb2d9e267
677102.38,8.0,12,4,4,3,11,0xb2d575a3d
1217367.76,2.0,58,4,3,2,9,0xb2d56f98
6723.74,1.0,15,2,2,3,7,0xb2d1c7bed
764.1,1.0,10,1,2,3,6,0xb2d6dbe9
55000.58,2.0,202,3,3,1,7,0xb2d6940c
504968.31,3.0,15,4,4,3,11,0xb2d0c82fd
47.51,1.0,23,1,2,2,5,0xb2d64d82
6174.42,1.0,184,2,2,1,5,0xb2d1c62b
100004.22,2.0,83,3,3,1,7,0xb2d8cf21d
76.44,1.0,1,1,2,4,7,0xb2d5dd49
2528.6,1.0,92,1,2,1,4,0xb2d42b44d
430461.09,2.0,0,4,3,4,11,0xb2d9ffcb
1489.88,1.0,157,1,2,1,4,0xb2d5eb7e
190021.53,2.0,1,3,3,4,10,0xb2d58b8c
6.96,1.0,10,1,2,3,6,0xb2d6e991
11039.34,1.0,18,2,2,2,6,0xb2d92766
20477.4,2.0,62,2,3,2,7,0xb2d5d3d1d
47013.43,3.0,20,2,4,2,8,0xb2d681a5
0.0,1.0,1,1,2,4,7,0xb2d683fe
43.06,1.0,34,1,2,2,5,0xb2d5b360
24392.75,1.0,12,2,2,3,7,0xb2d355d3d
65458.36,3.0,118,3,4,1,8,0xb2d693fd
142541.3,5.0,77,3,4,1,8,0xb2d588e7
307924.84,8.0,1,4,4,4,12,0x3b9b3d09
1010.29,1.0,92,1,2,1,4,0xb2d249dfd
7257.67,1.0,184,2,2,1,5,0xb2d2aeff
330693.06,5.0,18,4,4,2,10,0xb2d60087d
646007.28,7.0,74,4,4,1,9,0xb2d2f17ad
28.31,1.0,8,1,2,3,6,0xb2d40fc0d
1.19,1.0,32,1,2,2,5,0xb2d2dc9cd
412576.26,7.0,33,4,4,2,10,0xb2d5e896
600000.0,1.0,3,4,2,4,10,0xb2d9709d
642271.26,8.0,0,4,4,4,12,0xb2d5ba1e
24643.75,1.0,3,2,2,4,8,0xb2d3ba32
1050078.43,6.0,39,4,4,2,10,0x3b9b3ffbd
3868.49,1.0,0,2,2,4,8,0xb2d6e067
242273.48,3.0,14,3,4,3,10,0xb2d3a2cc
1904704.56,1.0,0,4,2,4,10,0xb2d35495d
990123.17,7.0,70,4,4,1,9,0xb2d446e4d
53.48,1.0,3,1,2,4,7,0xb2d33978
155011.45,2.0,56,3,3,2,8,0xb2d3a653
0.0,1.0,7,1,2,3,6,0xb2d5b7e0
174457.62,5.0,0,3,4,4,11,0x3b9af26fd
583044.85,2.0,92,4,3,1,8,0xb2d1a85fd
12921.66,1.0,89,2,2,1,5,0xb2d6a741d
1943.01,1.0,92,1,2,1,4,0xb2d3a59d
3001.29,1.0,20,2,2,2,6,0xb2d69a27
8671.49,1.0,0,2,2,4,8,0xb2d6e7fc
1721.85,1.0,1,1,2,4,7,0xb2d8d9aed
511255.96,3.0,40,4,4,2,10,0xb2d59f5bd
25.71,1.0,4,1,2,4,7,0xb2d1c89c
7808.53,2.0,2,2,3,4,9,0x3b9af1aad
200004.22,2.0,56,3,3,2,8,0xb2d9a54d
4.04,1.0,63,1,2,2,5,0xb2d6a6a3
465.56,1.0,0,1,2,4,7,0xb2d7917c
918.14,1.0,2,1,2,4,7,0xb2d6b310
12851.06,2.0,80,2,3,1,6,0xb2d38c39
171557.27,4.0,1,3,4,4,11,0xb2d91081d
1.08,1.0,19,1,2,2,5,0xb2d6a031
4143.52,1.0,9,2,2,3,7,0xb2d6d840
122127.31,2.0,76,3,3,1,7,0xb2d16fcfd
140015.52,3.0,20,3,4,2,9,0xb2d9fa48
5698.14,1.0,237,2,2,1,5,0xb2d55f08
9332.82,1.0,10,2,2,3,7,0xb2d9f579
201.28,1.0,3,1,2,4,7,0xb2d45367
1262000.0,10.0,5,4,4,3,11,0xb2d0c57f
10503.63,2.0,82,2,3,1,6,0xb2d94907
10000168.89,2.0,1,4,3,4,11,0xb2da402e
204066.79,2.0,184,3,3,1,7,0xb2d2850e
19389.0,1.0,20,2,2,2,6,0xb2d6aa81
10.56,1.0,18,1,2,2,5,0xb2d8a21e
161295.09,3.0,28,3,4,2,9,0xb2d64326
1909050.54,9.0,9,4,4,3,11,0xb2d6a222d
371408.18,2.0,29,4,3,2,9,0xb2d78534d
4517.57,1.0,22,2,2,2,6,0xb2da115e
2823.35,1.0,4,1,2,4,7,0xb2d3119c
1050043.55,2.0,224,4,3,1,8,0xb2d4fc74
570506.87,5.0,11,4,4,3,11,0xb2d957cc
80076.7,2.0,5,3,3,3,9,0xb2d8808d
6311.85,1.0,6,2,2,3,7,0xb2d207d7
570036.43,4.0,14,4,4,3,11,0xb2d6ea1fd
40021.8,2.0,92,2,3,1,6,0xb2d56f6e
223127.22,4.0,126,3,4,1,8,0xb2d74aa8
70942.62,2.0,66,3,3,2,8,0xb2d54aa2
62140.04,1.0,1,3,2,4,9,0xb2d320e7
115025.16,6.0,3,3,4,4,11,0xb2d0d258
50101.14,1.0,189,2,2,1,5,0xb2d43a80d
2202.42,3.0,8,1,4,3,8,0x3b9b4207
14.5,2.0,75,1,3,1,5,0x3b9b4a04
340033.15,2.0,1,4,3,4,11,0xb2d45bd8d
200020.86,2.0,25,3,3,2,8,0xb2d8cd6f
81381.69,2.0,73,3,3,1,7,0xb2d4d0ee
290109.35,3.0,10,3,4,3,10,0xb2d13c14
0.0,1.0,5,1,2,3,6,0xb2d5aec3
9125.9,1.0,0,2,2,4,8,0xb2d9429c
46.31,1.0,49,1,2,2,5,0xb2d369f5
64548.6,3.0,0,3,4,4,11,0xb2d3651ad
70000.0,4.0,3,3,4,4,11,0xb2d2b29ed
276.9,1.0,47,1,2,2,5,0xb2d321a9
4253.52,1.0,28,2,2,2,6,0xb2d5a64e
10143.64,1.0,33,2,2,2,6,0xb2d53816d
38.4,1.0,88,1,2,1,4,0xb2d1a895d
6469.46,1.0,102,2,2,1,5,0xb2d5dcb6
11739.99,6.0,1,2,4,4,10,0x3b9b3dabd
457.23,1.0,10,1,2,3,6,0xb2d81517
4.43,1.0,167,1,2,1,4,0xb2d5c47fd
211.52,1.0,4,1,2,4,7,0xb2d4f7a9
0.38,1.0,4,1,2,4,7,0xb2d63491
531885.6,2.0,27,4,3,2,9,0xb2d93d1e
51261.33,2.0,6,2,3,3,8,0xb2d64827d
10719.71,1.0,9,2,2,3,7,0xb2d31080
500000.0,2.0,26,4,3,2,9,0xb2d94982
3151.13,1.0,19,2,2,2,6,0xb2d6ffa6
37.36,1.0,9,1,2,3,6,0xb2d324c3
5072.41,1.0,0,2,2,4,8,0xb2d555a5
6269.85,1.0,1,2,2,4,8,0xb2d5c574
1903558.74,9.0,0,4,4,4,12,0x3b9b2d2c
360967.21,52.0,0,4,4,4,12,0xb2d0bc4a
2281.13,1.0,1,1,2,4,7,0xb2d90975
89836.65,2.0,1,3,3,4,10,0xb2d764cc
2719.61,1.0,0,1,2,4,7,0xb2d69b76
71230.04,1.0,29,3,2,2,7,0xb2d6c6fbd
0.0,1.0,3,1,2,4,7,0xb2d30335
187799.37,1.0,0,3,2,4,9,0xb2d4137dd
50000.53,2.0,20,2,3,2,7,0xb2d60091
121000.0,8.0,6,3,4,3,10,0xb2d97bcad
11617.22,1.0,96,2,2,1,5,0xb2d2e62f
68149.28,4.0,0,3,4,4,11,0xb2d186d8
1903526.8,3.0,24,4,4,2,10,0xb2d406c7d
52117.07,1.0,184,2,2,1,5,0xb2d411e3
591085.53,12.0,14,4,4,3,11,0xb2d5a959
30356.55,3.0,76,2,4,1,7,0xb2d63811d
511348.8,2.0,8,4,3,3,10,0xb2d1a70f
1355.21,1.0,6,1,2,3,6,0xb2d60f88d
309670.61,4.0,125,4,4,1,9,0xb2d1dc65d
73.0,1.0,0,1,2,4,7,0xb2d6cf4b
374.04,1.0,5,1,2,3,6,0xb2d7ac63
12.78,1.0,39,1,2,2,5,0xb2d61f86
4296.9,1.0,4,2,2,4,8,0xb2d2c4a7
1244.3,1.0,46,1,2,2,5,0xb2d1a0c6
0.33,1.0,10,1,2,3,6,0xb2d60fef
180006.99,3.0,13,3,4,3,10,0xb2d3c45d
2162692.45,17.0,10,4,4,3,11,0xb2d1507c
107233.79,2.0,6,3,3,3,9,0xb2d42490
170017.49,2.0,67,3,3,1,7,0xb2d63aca
56001.77,1.0,8,3,2,3,8,0xb2d9b93a
203.76,1.0,10,1,2,3,6,0xb2d64eadd
254577.75,4.0,6,3,4,3,10,0xb2d2d19ad
500073.73,7.0,0,4,4,4,12,0xb2d09de9
1923.78,1.0,4,1,2,4,7,0xb2d5dc58
11.92,1.0,54,1,2,2,5,0xb2d69db3
74.07,1.0,18,1,2,2,5,0xb2d22d9a
0.57,1.0,73,1,2,1,4,0xb2d63c75
9042.05,1.0,11,2,2,3,7,0xb2d782ef
520000.86,5.0,0,4,4,4,12,0xb2d3a00b
400020.3,3.0,11,4,4,3,11,0xb2d5d3cc
31060.31,1.0,10,2,2,3,7,0xb2d6f626d
115096.11,5.0,60,3,4,2,9,0xb2d55a3e
316767.15,3.0,56,4,4,2,10,0xb2d5def0
2.69,1.0,18,1,2,2,5,0xb2d51882
275.13,1.0,10,1,2,3,6,0xb2d8e4ec
801339.88,2.0,7,4,3,3,10,0xb2d3ccd1
383375.19,3.0,22,4,4,2,10,0xb2d41806
2320096.39,3.0,60,4,4,2,10,0xb2d61b51d
111482.13,4.0,0,3,4,4,11,0xb2d1a246
1571423.94,1.0,73,4,2,1,7,0xb2d0c845d
116.26,1.0,19,1,2,2,5,0xb2d1d2b5
340022.42,4.0,6,4,4,3,11,0xb2d3e78d
50057.17,2.0,92,2,3,1,6,0xb2d65490
799.88,1.0,82,1,2,1,4,0xb2d2d49d
550006.98,3.0,17,4,4,2,10,0xb2d9dc50
111627.02,3.0,77,3,4,1,8,0xb2d59dffd
1053457.97,19.0,0,4,4,4,12,0x3b9b1850d
174.68,2.0,90,1,3,1,5,0xb2d88f58
102742.26,2.0,10,3,3,3,9,0xb2d60fe3
179.05,3.0,5,1,4,3,8,0xb2d4da2a
70014.06,3.0,10,3,4,3,10,0xb2d2cd4bd
2412775.85,25.0,1,4,4,4,12,0xb2d1507cd
2018.6,1.0,92,1,2,1,4,0xb2d2c94b
50086.84,2.0,116,2,3,1,6,0xb2d19c9a
46766.11,1.0,92,2,2,1,5,0xb2d2b3c2
109160.66,2.0,19,3,3,2,8,0xb2d33c5f
12.76,1.0,124,1,2,1,4,0xb2d56048
175069.98,4.0,3,3,4,4,11,0x3b9b28f6d
210020.95,5.0,0,3,4,4,11,0xb2d81647d
18390.15,1.0,4,2,2,4,8,0xb2d21124d
361331.55,1.0,0,4,2,4,10,0xb2d86e2b
30412.63,3.0,19,2,4,2,8,0xb2d5e0ed
5.94,1.0,2,1,2,4,7,0xb2d8f246d
654059.52,2.0,12,4,3,3,10,0xb2d1bcb4d
56500.13,3.0,184,3,4,1,8,0xb2d1b711d
140034.45,2.0,189,3,3,1,7,0xb2d4238ed
405.96,1.0,34,1,2,2,5,0xb2d904ac
420069.94,8.0,4,4,4,4,12,0xb2d5b2c6d
5197577.52,3.0,4,4,4,4,12,0xb2d31cfe
5372.28,1.0,28,2,2,2,6,0xb2d2907c
8893.67,1.0,11,2,2,3,7,0xb2da320f
502936.64,4.0,56,4,4,2,10,0xb2d60cc3
385152.47,15.0,1,4,4,4,12,0xb2d62dead
3.17,1.0,39,1,2,2,5,0xb2d98d18
32658.49,1.0,10,2,2,3,7,0xb2d8d7cf
15.41,1.0,48,1,2,2,5,0xb2d2dc8e
3021.01,1.0,15,2,2,3,7,0xb2d55f9cd
500000.0,2.0,7,4,3,3,10,0xb2d94f31d
236053.24,2.0,21,3,3,2,8,0xb2d6e792d
1479.54,1.0,0,1,2,4,7,0xb2d621c6
50002.11,2.0,90,2,3,1,6,0xb2d5f58e
572291.93,5.0,11,4,4,3,11,0xb2d50f19
40001.96,2.0,53,2,3,2,7,0xb2d0f563
154164.77,3.0,6,3,4,3,10,0xb2d39347d
4304.76,2.0,92,2,3,1,6,0x3b9b198a
402157.49,3.0,49,4,4,2,10,0xb2d91e59
3227106.31,17.0,3,4,4,4,12,0xb2d1adb0d
1300004.32,5.0,6,4,4,3,11,0xb2d78bfd
473.39,1.0,0,1,2,4,7,0xb2d5ba44d
816940.43,7.0,3,4,4,4,12,0xb2d16a41d
3828.39,1.0,9,2,2,3,7,0xb2d5a1a2
326620.14,2.0,26,4,3,2,9,0xb2d3965b
200073.4,2.0,0,3,3,4,10,0xb2d128b9
3361.35,1.0,92,2,2,1,5,0xb2d4013fd
1045941.69,28.0,0,4,4,4,12,0x3b9af0ea
50000.08,2.0,1,2,3,4,9,0xb2da6109
65003.87,5.0,42,3,4,2,9,0xb2d64042
523403.01,5.0,1,4,4,4,12,0xb2d3c584d
201882.24,2.0,4,3,3,4,10,0xb2d0e04a
95434.05,2.0,10,3,3,3,9,0xb2d12c8b
100180.42,2.0,0,3,3,4,10,0xb2d40388d
921.02,1.0,12,1,2,3,6,0xb2d34c1c
21.26,1.0,15,1,2,3,6,0xb2d948fa
738423.79,8.0,0,4,4,4,12,0xb2d3a460d
52000.55,2.0,8,2,3,3,8,0xb2da4a8e
25.37,1.0,45,1,2,2,5,0xb2d31721
29630.57,1.0,4,2,2,4,8,0xb2d23913
520088.28,3.0,6,4,4,3,11,0xb2d4de92
201776.91,2.0,16,3,3,2,8,0xb2d65e0b
353.51,1.0,10,1,2,3,6,0xb2d680d4
22652.43,1.0,92,2,2,1,5,0xb2d2d703d
2611.17,1.0,0,1,2,4,7,0xb2d5b580
200560.13,2.0,92,3,3,1,7,0xb2d0b8d7d
2877.67,1.0,0,1,2,4,7,0xb2d83483d
3526590.43,6.0,10,4,4,3,11,0x3b9adc92
10015.21,2.0,18,2,3,2,7,0xb2da2c0b
398.41,1.0,7,1,2,3,6,0xb2d57143
171191.83,5.0,21,3,4,2,9,0xb2d9119c
782022.65,6.0,1,4,4,4,12,0xb2d10bcb
351065.99,1.0,9,4,2,3,9,0xb2d2ed35
350088.69,6.0,19,4,4,2,10,0xb2d6c4fb
643.58,1.0,17,1,2,2,5,0xb2d23de2
200503.93,2.0,90,3,3,1,7,0xb2d24796
281005.01,3.0,14,3,4,3,10,0xb2d26742
3730000.11,44.0,1,4,4,4,12,0xb2d3c208
1776.09,1.0,3,1,2,4,7,0xb2d62cffd
50001.58,2.0,53,2,3,2,7,0xb2d9ca27
86892.62,2.0,0,3,3,4,10,0xb2da150c
647133.56,6.0,77,4,4,1,9,0xb2d0c712
150855.0,3.0,90,3,4,1,8,0xb2d38383
5302.56,1.0,9,2,2,3,7,0xb2d3479cd
2436.51,1.0,184,1,2,1,4,0xb2d0af0b
25005.48,2.0,8,2,3,3,8,0xb2d68eabd
400798.61,3.0,0,4,4,4,12,0xb2d1b49fd
7650000.0,1.0,0,4,2,4,10,0xb2d96bb4
326259.08,3.0,15,4,4,3,11,0xb2d1792e
750024.89,2.0,200,4,3,1,8,0xb2d68d1fd
7883.74,1.0,245,2,2,1,5,0xb2d25e34d
23008.58,2.0,4,2,3,4,9,0xb2d0fdfe
145.33,1.0,4,1,2,4,7,0xb2d39e88
388666.81,2.0,96,4,3,1,8,0xb2d23d16
5.89,1.0,0,1,2,4,7,0xb2d5ef79
200710.47,2.0,17,3,3,2,8,0xb2d283c3
500058.58,2.0,14,4,3,3,10,0xb2d7a8d7
180332.87,3.0,92,3,4,1,8,0xb2d40521d
475785.31,2.0,1,4,3,4,11,0xb2d6c520
122332.64,2.0,0,3,3,4,10,0xb2d4919a
40136.44,2.0,76,2,3,1,6,0xb2d60fa8
200006.33,2.0,11,3,3,3,9,0xb2da3c05
2539.73,1.0,0,1,2,4,7,0xb2d5d229
200067.99,3.0,20,3,4,2,9,0xb2d97e8bd
4032.72,1.0,39,2,2,2,6,0xb2d432acd
500067.01,3.0,14,4,4,3,11,0xb2d6f8b3
30612.65,1.0,92,2,2,1,5,0xb2d29346d
798925.39,9.0,1,4,4,4,12,0xb2d2ade5d
350009.4,3.0,1,4,4,4,12,0xb2d5e54c
130000.0,8.0,1,3,4,4,11,0xb2d43117
0.19,1.0,75,1,2,1,4,0xb2d51421d
413723.28,4.0,10,4,4,3,11,0xb2d630a7
685.34,1.0,0,1,2,4,7,0xb2d438d8
1065.82,1.0,101,1,2,1,4,0xb2d23e4c
2564.21,1.0,7,1,2,3,6,0xb2d8e438
2276.73,1.0,18,1,2,2,5,0xb2d988f7
0.16,1.0,9,1,2,3,6,0xb2d65ae2
5494247.95,4.0,0,4,4,4,12,0xb2d6eb86
376045.56,10.0,0,4,4,4,12,0xb2d64816
587000.66,10.0,4,4,4,4,12,0xb2d560c2
50276.96,1.0,213,2,2,1,5,0xb2d64fc0
1602.44,1.0,92,1,2,1,4,0xb2d1e7b8d
60500.21,2.0,0,3,3,4,10,0xb2d949a0
650048.71,4.0,25,4,4,2,10,0x3b9b375ad
475975.36,4.0,95,4,4,1,9,0xb2d2bb9dd
250006.65,8.0,0,3,4,4,11,0xb2d92ec6d
506437.86,6.0,0,4,4,4,12,0xb2d20ab1d
500000.0,2.0,20,4,3,2,9,0xb2d95476
337.69,1.0,0,1,2,4,7,0xb2d8e693
2288.51,1.0,1,1,2,4,7,0xb2d6c4a6d
11330.12,1.0,26,2,2,2,6,0xb2d6db68
205992.58,2.0,108,3,3,1,7,0xb2d19204d
5752.31,1.0,0,2,2,4,8,0xb2da064e
403004.65,4.0,0,4,4,4,12,0xb2d5f97ed
50277.37,1.0,130,2,2,1,5,0xb2d25ff6d
792267.13,53.0,0,4,4,4,12,0x3b9b1823
350863.29,3.0,20,4,4,2,10,0xb2d604a8
341.7,1.0,68,1,2,1,4,0xb2d6adbed
20000.63,2.0,206,2,3,1,6,0xb2d68d68
652308.97,2.0,15,4,3,3,10,0xb2d91ec1
30000.0,1.0,2,2,2,4,8,0xb2da639f
6277.22,1.0,0,2,2,4,8,0xb2d6d742
200031.27,2.0,176,3,3,1,7,0xb2d2f94c
122710.28,3.0,4,3,4,4,11,0xb2d68531
152816.12,2.0,235,3,3,1,7,0xb2d5fc18d
9174.78,1.0,0,2,2,4,8,0xb2d1ef73
20736.39,2.0,4,2,3,4,9,0xb2d1d441
450186.2,3.0,70,4,4,1,9,0xb2d1cadc
50003.17,2.0,92,2,3,1,6,0xb2d63339d
632642.41,17.0,5,4,4,3,11,0xb2d0ed02d
604817.75,8.0,13,4,4,3,11,0xb2d39ea3d
200923.87,3.0,13,3,4,3,10,0xb2d16b3bd
72000.54,2.0,4,3,3,4,10,0xb2d5e98cd
50002.11,2.0,41,2,3,2,7,0xb2d91e6bd
15838.18,1.0,10,2,2,3,7,0xb2d8dad3d
748.84,2.0,0,1,3,4,8,0x3b9b45c0d
55000.87,3.0,56,3,4,2,9,0xb2d5957a
185890.43,10.0,1,3,4,4,11,0xb2d49550
21262.49,1.0,0,2,2,4,8,0xb2d973bf
694768.38,4.0,1,4,4,4,12,0xb2d287cf
107572.56,3.0,136,3,4,1,8,0xb2d07400
7.37,1.0,7,1,2,3,6,0xb2d7bd5d
1251247.32,2.0,119,4,3,1,8,0xb2d5b8b4d
320018.48,3.0,0,4,4,4,12,0xb2d59701d
18402.94,1.0,14,2,2,3,7,0xb2d55144
4.48,1.0,9,1,2,3,6,0xb2d8d8fe
1186826.38,2.0,92,4,3,1,8,0xb2d1f28fd
1378.38,1.0,9,1,2,3,6,0xb2d5ae75
11696.63,1.0,0,2,2,4,8,0xb2d6c227
546027.28,4.0,95,4,4,1,9,0xb2d37486d
3004.14,1.0,84,2,2,1,5,0xb2d8d007d
605395.54,3.0,8,4,4,3,11,0xb2d6fcd0
13.67,1.0,4,1,2,4,7,0xb2d95bda
200000.0,2.0,0,3,3,4,10,0xb2da6ba6
48127.78,1.0,19,2,2,2,6,0xb2d62605d
84007.25,4.0,11,3,4,3,10,0xb2d4eca0
203583.59,3.0,107,3,4,1,8,0xb2d1ae20d
91622.06,1.0,0,3,2,4,9,0xb2d291c9d
1000063.05,3.0,0,4,4,4,12,0xb2d58e3fd
198627.59,2.0,7,3,3,3,9,0xb2d63f13d
593.1,1.0,82,1,2,1,4,0xb2d5cc38d
559518.39,7.0,6,4,4,3,11,0xb2d20c07
10000.32,2.0,53,2,3,2,7,0xb2d174de
614517.94,2.0,10,4,3,3,10,0xb2d21daf
2468.35,1.0,20,1,2,2,5,0xb2d1f745d
210240.38,3.0,0,3,4,4,11,0xb2d29fe9
500001.98,2.0,5,4,3,3,10,0xb2d92c9f
1109.38,1.0,92,1,2,1,4,0xb2d34d4f
1015.44,1.0,184,1,2,1,4,0xb2d14eef
400000.0,2.0,27,4,3,2,9,0xb2d16c54
109020.5,2.0,10,3,3,3,9,0xb2d99517
18957.18,1.0,0,2,2,4,8,0xb2d973ec
1176.94,1.0,0,1,2,4,7,0xb2d62b88
222000.0,5.0,2,3,4,4,11,0xb2d5ee7a
100004.22,2.0,76,3,3,1,7,0xb2d8d9fa
700815.28,9.0,18,4,4,2,10,0xb2d2cabcd
300000.0,3.0,8,3,4,3,10,0xb2d96e5ed
101166.05,2.0,53,3,3,2,8,0xb2d415d0d
560190.74,6.0,3,4,4,4,12,0xb2d17937d
5000329.52,2.0,92,4,3,1,8,0xb2d2ddc8d
0.0,1.0,6,1,2,3,6,0xb2d0e83f
202427.22,2.0,158,3,3,1,7,0xb2d6c2c9
2.11,1.0,93,1,2,1,4,0xb2d97771
101001.06,3.0,87,3,4,1,8,0xb2d5bfe9
2500000.0,1.0,0,4,2,4,10,0xb2d98402d
966581.13,4.0,62,4,4,2,10,0xb2d19b34d
171932.05,1.0,10,3,2,3,8,0xb2d78b0ad
163300.27,1.0,38,3,2,2,7,0xb2d68665
52441.64,1.0,59,3,2,2,7,0xb2d06945d
2.03,1.0,10,1,2,3,6,0xb2d95fae
42.22,1.0,67,1,2,1,4,0xb2d41015
4303.32,1.0,19,2,2,2,6,0xb2d8f758
338386.25,4.0,39,4,4,2,10,0xb2d23911
18238.02,1.0,138,2,2,1,5,0xb2d5ec50d
300006.33,4.0,24,3,4,2,9,0xb2d68e28
6.68,1.0,51,1,2,2,5,0xb2d7edf0
17977.89,1.0,18,2,2,2,6,0xb2d49fd4
4.13,1.0,1,1,2,4,7,0xb2d689b3
220002.32,2.0,48,3,3,2,8,0xb2d9dc4d
9.6,1.0,88,1,2,1,4,0xb2d8c383d
151753.46,2.0,228,3,3,1,7,0xb2d43910
321789.23,2.0,94,4,3,1,8,0xb2d5908a
10099.07,2.0,27,2,3,2,7,0xb2d90a26d
35.78,1.0,4,1,2,4,7,0xb2d0c6b7d
86.05,1.0,20,1,2,2,5,0xb2d5b1d2d
67862.53,3.0,90,3,4,1,8,0xb2d07c86
148007.45,4.0,55,3,4,2,9,0xb2d9bf34
140007.62,3.0,13,3,4,3,10,0xb2d3d20bd
102004.06,2.0,139,3,3,1,7,0xb2d6ee89
188071.78,5.0,5,3,4,3,10,0xb2d1a91d
166003.5,2.0,80,3,3,1,7,0xb2d98d65
1000108.61,4.0,82,4,4,1,9,0xb2d7fe42
294.35,3.0,45,1,4,2,7,0xb2d3beb8
24750.11,1.0,51,2,2,2,6,0xb2d57e60
467732.99,2.0,4,4,3,4,11,0xb2d57e5d
2001300.64,3.0,31,4,4,2,10,0xb2d9028ad
257427.59,4.0,10,3,4,3,10,0xb2d28ceb
1062.67,1.0,92,1,2,1,4,0xb2d3a4ced
450333.3,3.0,4,4,4,4,12,0xb2d79136
300070.53,2.0,8,3,3,3,9,0xb2d99d58
541401.74,30.0,0,4,4,4,12,0x3b9af169d
65828.27,2.0,67,3,3,1,7,0xb2d1c270d
1011910.31,15.0,1,4,4,4,12,0xb2d69050
246001.89,7.0,52,3,4,2,9,0xb2d3d36a
762581.42,3.0,55,4,4,2,10,0xb2d3c528
1130009.05,5.0,1,4,4,4,12,0xb2d938a1d
335044.31,10.0,74,4,4,1,9,0xb2d1ba61
0.24,1.0,0,1,2,4,7,0xb2d2eaefd
288122.15,2.0,5,3,3,3,9,0xb2d2a081d
300004.06,2.0,28,3,3,2,8,0xb2d6e171d
62212.34,1.0,13,3,2,3,8,0xb2d340c6
300022.82,4.0,6,3,4,3,10,0xb2d58930
284626.64,3.0,139,3,4,1,8,0xb2d538b4
29171.16,5.0,0,2,4,4,10,0x3b9b0e73d
1000000.01,2.0,93,4,3,1,8,0xb2d53fa0
38.17,1.0,38,1,2,2,5,0xb2d4f8e3
1222078.54,2.0,0,4,3,4,11,0xb2d4ff2ad
1050115.43,7.0,6,4,4,3,11,0xb2d535c5
8042.57,1.0,0,2,2,4,8,0xb2d2b5c2
1826.36,1.0,9,1,2,3,6,0xb2d5b4df
80.59,1.0,7,1,2,3,6,0xb2d61efcd
158063.85,4.0,6,3,4,3,10,0xb2d15f3ad
509609.96,2.0,0,4,3,4,11,0xb2d573bd
201293.4,2.0,0,3,3,4,10,0xb2d1fc6e
363730.61,3.0,3,4,4,4,12,0xb2d5b993
45.82,2.0,18,1,3,2,6,0xb2d425a8
229337.46,3.0,3,3,4,4,11,0xb2d40c6c
151543.44,3.0,92,3,4,1,8,0xb2d539e5d
716331.53,2.0,0,4,3,4,11,0xb2d51316
30408.53,3.0,27,2,4,2,8,0xb2d5e9a6
478936.88,3.0,3,4,4,4,12,0xb2d22ff7d
404351.47,3.0,94,4,4,1,9,0xb2d64711
677914.9,6.0,80,4,4,1,9,0xb2d6838bd
0.34,1.0,25,1,2,2,5,0xb2d57e67d
8719.08,1.0,2,2,2,4,8,0xb2d2f2f7
358.65,1.0,11,1,2,3,6,0xb2d2785dd
5501256.92,6.0,46,4,4,2,10,0xb2d1fe72d
102.5,1.0,2,1,2,4,7,0xb2d68e9fd
20000.21,2.0,10,2,3,3,8,0xb2d96900
13501.51,1.0,0,2,2,4,8,0xb2d1ed02d
100466.64,4.0,18,3,4,2,9,0xb2d53aaad
100000.0,1.0,2,3,2,4,9,0xb2d9432dd
56188.18,12.0,184,3,4,1,8,0xb2d0bab0d
862.24,1.0,65,1,2,2,5,0xb2d2b409
601176.15,3.0,4,4,4,4,12,0xb2d6875c
1689.65,1.0,92,1,2,1,4,0xb2d2efb8d
60.27,1.0,77,1,2,1,4,0xb2d604c8
1050759.42,9.0,20,4,4,2,10,0xb2d0b84bd
30.03,1.0,69,1,2,1,4,0xb2d254a2d
6806.75,1.0,0,2,2,4,8,0xb2d43a95
490004.66,3.0,20,4,4,2,10,0xb2d5e038
50103.16,2.0,0,2,3,4,9,0xb2da4c6e
300001.1,3.0,18,3,4,2,9,0xb2d9c63c
18.97,2.0,32,1,3,2,6,0xb2d1bc95
1624042.84,4.0,7,4,4,3,11,0xb2d7ecbad
2916.64,1.0,18,2,2,2,6,0xb2d6275f
140156.93,8.0,36,3,4,2,9,0xb2d5b837
1571.32,1.0,150,1,2,1,4,0xb2d4acdf
3.32,1.0,17,1,2,2,5,0xb2d2451e
415811.58,2.0,0,4,3,4,11,0xb2d0c4de
0.0,1.0,92,1,2,1,4,0xb2d2bf5f
11.05,1.0,20,1,2,2,5,0xb2d6c063
12960.74,1.0,8,2,2,3,7,0xb2d3480dd
40000.84,2.0,18,2,3,2,7,0xb2d955fad
417326.9,5.0,0,4,4,4,12,0x3b9af2bdd
267029.72,4.0,41,3,4,2,9,0xb2d11204
4428.67,1.0,184,2,2,1,5,0xb2d0f8ed
426421.01,5.0,27,4,4,2,10,0xb2d230e5d
300009.83,3.0,67,3,4,1,8,0xb2d074dfd
125445.58,1.0,57,3,2,2,7,0xb2d6fec2d
1047.22,1.0,9,1,2,3,6,0xb2d503c4d
475.13,1.0,21,1,2,2,5,0xb2d2062cd
3.06,1.0,75,1,2,1,4,0xb2d8cdff
14000.59,2.0,256,2,3,1,6,0xb2d6c73c
2360114.66,4.0,3,4,4,4,12,0xb2d5521f
62870.79,2.0,8,3,3,3,9,0xb2d1a51dd
44350.88,1.0,1,2,2,4,8,0xb2d6c6ffd
2311.51,1.0,221,1,2,1,4,0xb2d16c45d
5000000.0,1.0,0,4,2,4,10,0xb2d9622a
600830.86,5.0,7,4,4,3,11,0xb2d262fed
440011.19,5.0,21,4,4,2,10,0xb2d081f2d
56798.45,2.0,217,3,3,1,7,0xb2d1760d
55.02,1.0,14,1,2,3,6,0xb2da1d5b
701115.79,4.0,32,4,4,2,10,0xb2d287cfd
26076.46,3.0,0,2,4,4,10,0xb2d42966
1190.0,1.0,184,1,2,1,4,0xb2d17e97
69.47,1.0,16,1,2,2,5,0xb2d38e4f
301072.65,2.0,34,4,3,2,9,0xb2d6be36d
30004.89,2.0,18,2,3,2,7,0xb2d57e71d
72116.97,2.0,2,3,3,4,10,0xb2d06ad4d
106826.34,5.0,3,3,4,4,11,0xb2d0fa99d
763.87,1.0,9,1,2,3,6,0xb2d5e5c4d
38.3,1.0,2,1,2,4,7,0xb2d91043
200046.48,2.0,172,3,3,1,7,0xb2d821ca
12275.53,2.0,0,2,3,4,9,0xb2d550ea
14879.75,1.0,10,2,2,3,7,0xb2d304cbd
18.18,1.0,13,1,2,3,6,0xb2d8e8bc
1.02,1.0,18,1,2,2,5,0xb2d82441d
43172.48,1.0,10,2,2,3,7,0xb2d4a6cd
500004.48,2.0,7,4,3,3,10,0xb2d93027d
321015.3,6.0,6,4,4,3,11,0xb2d31c21d
450000.91,2.0,17,4,3,2,9,0xb2d996e3
188198.81,3.0,136,3,4,1,8,0xb2d155d4
201214.31,2.0,20,3,3,2,8,0xb2d1dd47d
1121950.79,3.0,3,4,4,4,12,0xb2d29110
3100.84,1.0,8,2,2,3,7,0xb2d37cd4
10137.35,1.0,76,2,2,1,5,0x3b9b25be
6661.98,1.0,18,2,2,2,6,0xb2d4b2c4
640279.79,3.0,69,4,4,1,9,0xb2d60938d
10042.6,1.0,184,2,2,1,5,0xb2d4b30f
41.27,1.0,9,1,2,3,6,0xb2d8e2d8
168.0,1.0,10,1,2,3,6,0xb2d38137
84240.71,3.0,9,3,4,3,10,0xb2d9476ad
6295.43,1.0,5,2,2,3,7,0xb2d3b7fa
20087.12,2.0,56,2,3,2,7,0xb2d25252d
10000.53,2.0,21,2,3,2,7,0xb2da1622
580005.7,3.0,6,4,4,3,11,0xb2d6c6f1
220121.93,2.0,151,3,3,1,7,0xb2d0eb57
157127.13,4.0,0,3,4,4,11,0xb2d2e09b
542073.55,6.0,90,4,4,1,9,0xb2d45078
7320.96,1.0,1,2,2,4,8,0xb2d8ce39
180479.07,8.0,0,3,4,4,11,0x3b9af1b4
200348.65,1.0,4,3,2,4,9,0xb2d6a9f1
1068.52,1.0,184,1,2,1,4,0xb2d0cac3
502330.72,2.0,28,4,3,2,9,0xb2d5c0af
1154.79,2.0,9,1,3,3,7,0xb2d4e004
503552.53,3.0,63,4,4,2,10,0xb2d8f7d2
200085.37,2.0,25,3,3,2,8,0xb2d61fb6
30000.68,2.0,21,2,3,2,7,0xb2da1c63
530036.25,7.0,0,4,4,4,12,0xb2d4b424d
150214.93,3.0,3,3,4,4,11,0xb2d2728ed
80079.15,2.0,110,3,3,1,7,0xb2d4f128
60002.53,2.0,34,3,3,2,8,0xb2d9307f
3608.05,1.0,281,2,2,1,5,0xb2d65961d
2021.44,1.0,92,1,2,1,4,0xb2d269b0
13056.71,1.0,7,2,2,3,7,0xb2d2085b
24513.49,2.0,15,2,3,3,8,0xb2d5ca3bd
695.25,1.0,0,1,2,4,7,0xb2d906a2
758274.44,5.0,49,4,4,2,10,0xb2d2278cd
400026.67,2.0,60,4,3,2,9,0xb2d68050d
90014.64,2.0,18,3,3,2,8,0xb2d59eb0
887109.76,8.0,18,4,4,2,10,0xb2d18027
688022.98,20.0,0,4,4,4,12,0xb2d1ec20d
1300789.0,3.0,1,4,4,4,12,0xb2d98199d
4602.67,1.0,0,2,2,4,8,0xb2d8fb46
50007.02,2.0,62,2,3,2,7,0xb2d8f48a
1093.24,1.0,184,1,2,1,4,0xb2d30bb8
147951.97,4.0,18,3,4,2,9,0xb2d1c0e1d
0.0,1.0,0,1,2,4,7,0xb2d294d9
53639.43,5.0,5,3,4,3,10,0xb2d53035
22.24,1.0,7,1,2,3,6,0xb2d18b84
3716.3,1.0,2,2,2,4,8,0xb2d58dc5
71.91,1.0,7,1,2,3,6,0xb2d2761bd
4967.48,1.0,11,2,2,3,7,0xb2d8c395
601096.88,6.0,4,4,4,4,12,0xb2d94d5d
662572.4,7.0,0,4,4,4,12,0xb2d2e6f1d
970052.33,6.0,69,4,4,1,9,0xb2d2ca53
184017.72,2.0,7,3,3,3,9,0xb2d0b2e4
200066.65,4.0,80,3,4,1,8,0xb2d07dbe
189290.52,1.0,0,3,2,4,9,0xb2d2107b
868130.33,1.0,140,4,2,1,7,0xb2d6eeebd
50003.17,2.0,60,2,3,2,7,0xb2d26072
51003.56,2.0,217,2,3,1,6,0xb2d3d292
220781.46,2.0,35,3,3,2,8,0xb2d9fc92
27.84,3.0,3,1,4,4,9,0xb2d4a98ad
103893.38,3.0,31,3,4,2,9,0xb2d4bce9d
8161.81,1.0,10,2,2,3,7,0xb2d4fd0ed
11.54,1.0,25,1,2,2,5,0xb2d7857f
869007.3,7.0,11,4,4,3,11,0xb2d52b59d
686431.48,5.0,4,4,4,4,12,0xb2d9217cd
2442.02,1.0,1,1,2,4,7,0xb2d96af0
500329.64,2.0,0,4,3,4,11,0xb2d97b38d
123882.67,3.0,14,3,4,3,10,0xb2d4d991
280579.33,5.0,11,3,4,3,10,0xb2d91047
733423.16,3.0,139,4,4,1,9,0xb2d52dac
74004.92,4.0,0,3,4,4,11,0xb2d58105
1533.04,1.0,9,1,2,3,6,0xb2d122e6d
1024.06,1.0,201,1,2,1,4,0xb2d1d4c5d
261942.38,2.0,56,3,3,2,8,0xb2d69420
366684.83,3.0,3,4,4,4,12,0xb2d3e81dd
350281.3,3.0,139,4,4,1,9,0xb2d351ea
500000.27,3.0,1,4,4,4,12,0xb2d8e974d
30047.09,2.0,92,2,3,1,6,0xb2d62316d
60380.15,2.0,3,3,3,4,10,0xb2d60ed2
1949.52,4.0,10,1,4,3,8,0xb2d26827d
2569.0,1.0,0,1,2,4,7,0xb2d96f1c
377847.44,5.0,83,4,4,1,9,0xb2d1d839d
2098.62,1.0,92,1,2,1,4,0xb2d347bb
82.31,1.0,4,1,2,4,7,0xb2d2a9a2
300040.92,2.0,101,3,3,1,7,0xb2d1e342
400000.0,3.0,61,4,4,2,10,0xb2d8e011
3406.98,1.0,92,2,2,1,5,0xb2d12cb6d
4555.98,1.0,9,2,2,3,7,0xb2d90807d
547531.41,2.0,16,4,3,2,9,0xb2d535f7
300000.0,2.0,14,3,3,3,9,0xb2da3549
500128.77,1.0,18,4,2,2,8,0xb2d93e89d
5392.38,1.0,18,2,2,2,6,0xb2d1c300d
81451.25,2.0,201,3,3,1,7,0xb2d1be70d
200000.3,2.0,14,3,3,3,9,0xb2d6524a
514588.4,1.0,0,4,2,4,10,0xb2d1b3a7
23.75,1.0,70,1,2,1,4,0xb2d11dee
389026.69,2.0,31,4,3,2,9,0xb2d68447
220485.8,2.0,40,3,3,2,8,0xb2d138d2
316856.32,4.0,0,4,4,4,12,0x3b9b186bd
17528.04,1.0,8,2,2,3,7,0xb2d76b4ed
1124808.94,6.0,0,4,4,4,12,0x3b9af217
530025.16,8.0,4,4,4,4,12,0xb2d17258d
243940.43,3.0,0,3,4,4,11,0xb2d5c328
200000.0,2.0,3,3,3,4,10,0xb2d9af7f
1301121.88,5.0,5,4,4,3,11,0xb2d63c3f
3109.93,2.0,5,2,3,3,8,0xb2d59199d
12050.27,1.0,298,2,2,1,5,0xb2d0d600
5414.42,1.0,0,2,2,4,8,0xb2d3cdffd
500052.12,2.0,13,4,3,3,10,0xb2d8dfad
401041.17,1.0,0,4,2,4,10,0xb2d2b103d
18.5,1.0,10,1,2,3,6,0xb2d3aa3c
5982.72,1.0,0,2,2,4,8,0xb2d6c0d6
200000.0,2.0,4,3,3,4,10,0xb2da5ae4
204865.99,3.0,17,3,4,2,9,0x3b9b4325
591670.42,6.0,0,4,4,4,12,0xb2d42427d
1444.37,1.0,231,1,2,1,4,0xb2d09283
2475.91,1.0,184,1,2,1,4,0xb2d0e1d2d
12800.0,2.0,35,2,3,2,7,0xb2d93296d
2.43,1.0,50,1,2,2,5,0xb2d5cc22d
220104.43,4.0,32,3,4,2,9,0xb2d7892dd
2856.57,1.0,2,1,2,4,7,0xb2d78fc0
27.39,1.0,88,1,2,1,4,0xb2d28bbb
476.59,1.0,13,1,2,3,6,0xb2d624d8d
65008.15,4.0,3,3,4,4,11,0xb2d2ae81
18011.95,1.0,0,2,2,4,8,0xb2d63c7bd
81701.48,3.0,221,3,4,1,8,0xb2d57087d
20000000.5,3.0,4,4,4,4,12,0xb2d6b682d
436386.65,8.0,0,4,4,4,12,0xb2d6a974d
2863.33,1.0,92,1,2,1,4,0xb2d1edfdd
213055.09,6.0,10,3,4,3,10,0xb2d515e7
1233.62,1.0,4,1,2,4,7,0xb2d23196
427757.52,5.0,49,4,4,2,10,0xb2d45d0a
130609.89,7.0,55,3,4,2,9,0xb2d42147
190523.21,1.0,0,3,2,4,9,0xb2d96e16d
70075.3,2.0,72,3,3,1,7,0xb2d6260cd
600236.45,6.0,0,4,4,4,12,0xb2d3eae2
277401.47,3.0,3,3,4,4,11,0xb2d41e7a
350008.5,3.0,42,4,4,2,10,0xb2d6a476
43001.76,3.0,21,2,4,2,8,0xb2d9d799
520000.12,2.0,13,4,3,3,10,0xb2d6f464d
21.24,1.0,39,1,2,2,5,0xb2d922ccd
1022.64,1.0,184,1,2,1,4,0xb2d31617
202205.64,2.0,92,3,3,1,7,0xb2d128b9d
10997.32,8.0,0,2,4,4,10,0xb2d16e48
3604746.06,9.0,14,4,4,3,11,0x3b9b19bdd
131.49,2.0,60,1,3,2,6,0xb2d63602
420033.77,2.0,17,4,3,2,9,0xb2d997d4
84502.11,3.0,5,3,4,3,10,0xb2d92b41d
110001.16,2.0,25,3,3,2,8,0xb2da17f1
50002.63,2.0,132,2,3,1,6,0xb2d2a25dd
7502.11,1.0,10,2,2,3,7,0xb2d2e1c6d
780718.38,9.0,0,4,4,4,12,0xb2d0c4ddd
23.37,33.0,0,1,4,4,9,0xb2d11809
482438.99,4.0,24,4,4,2,10,0xb2d0ebe5
500000.0,2.0,12,4,3,3,10,0xb2d9634a
3986.65,1.0,92,2,2,1,5,0xb2d2435ed
3580000.0,9.0,0,4,4,4,12,0xb2d54e6ad
927.89,1.0,15,1,2,3,6,0xb2d8573c
31639.54,3.0,8,2,4,3,9,0xb2d68363
1905.35,1.0,0,1,2,4,7,0xb2d16d62d
65287.93,2.0,11,3,3,3,9,0x3b9b4a04d
154301.42,2.0,63,3,3,2,8,0xb2d689f6d
1336.78,2.0,184,1,3,1,5,0x3b9b0f62
489172.86,4.0,11,4,4,3,11,0xb2d43b6a
309637.75,2.0,277,4,3,1,8,0xb2d6a8ea
508886.24,2.0,13,4,3,3,10,0xb2d6cc90d
5783.48,1.0,4,2,2,4,8,0xb2d91f4b
44762.23,2.0,5,2,3,3,8,0xb2d8eab4
647033.59,9.0,55,4,4,2,10,0xb2d55c2c
432014.26,2.0,249,4,3,1,8,0xb2d2e9cbd
258689.28,4.0,39,3,4,2,9,0xb2d341d1
436383.78,3.0,173,4,4,1,9,0xb2d43aa4
3278.96,1.0,0,2,2,4,8,0xb2d66058
176258.34,2.0,4,3,3,4,10,0xb2d3ea35
330012.25,9.0,34,4,4,2,10,0xb2d6c596d
58430.87,1.0,0,3,2,4,9,0xb2d2fd5a
1155280.3,7.0,5,4,4,3,11,0xb2d07939
450027.06,3.0,10,4,4,3,11,0xb2d622abd
10882.65,1.0,0,2,2,4,8,0xb2d65049
112.65,1.0,75,1,2,1,4,0xb2d79178d
700005.2,3.0,18,4,4,2,10,0xb2d6e85d
16816.45,6.0,184,2,4,1,7,0xb2d0795bd
407566.64,3.0,1,4,4,4,12,0xb2d22a91d
200052.19,2.0,13,3,3,3,9,0xb2d6ca25
66634.1,1.0,13,3,2,3,8,0xb2d63166
0.0,1.0,3,1,2,4,7,0xb2d4fc93
409.72,1.0,9,1,2,3,6,0xb2d0db12
650418.27,2.0,3,4,3,4,11,0xb2d07c9d
551525.61,6.0,4,4,4,4,12,0xb2d5ab72
410932.66,3.0,1,4,4,4,12,0xb2d53adb
1939010.88,6.0,3,4,4,4,12,0xb2d5fe55
220849.87,16.0,0,3,4,4,11,0x3b9b36c6
80135.25,2.0,92,3,3,1,7,0xb2d62b2f
310000.0,2.0,3,4,3,4,11,0xb2d971f3d
4139110.03,27.0,8,4,4,3,11,0xb2d8e984d
0.09,1.0,1,1,2,4,7,0xb2d31ea6
573662.25,5.0,67,4,4,1,9,0xb2d52b42
320203.75,3.0,158,4,4,1,9,0xb2d5dd20d
500076.1,2.0,18,4,3,2,9,0xb2d8da5e
5000000.0,1.0,4,4,2,4,10,0xb2da602c
0.96,1.0,0,1,2,4,7,0xb2d6363d
50002.2,2.0,214,2,3,1,6,0xb2d63b08
2343.96,1.0,10,1,2,3,6,0xb2d65a4d
10242.86,1.0,24,2,2,2,6,0xb2d42afbd
487.14,1.0,6,1,2,3,6,0xb2d6a79d
200001.84,3.0,19,3,4,2,9,0xb2d88e6b
19426158.14,32.0,8,4,4,3,11,0xb2d179f6d
24242.24,3.0,3,2,4,4,10,0xb2d609c7
1669.19,1.0,257,1,2,1,4,0xb2d30838
461322.6,7.0,1,4,4,4,12,0xb2d0dbf5
7671.99,1.0,180,2,2,1,5,0xb2d655e1
144.87,1.0,1,1,2,4,7,0xb2d31bc7
500032.31,2.0,9,4,3,3,10,0xb2d63bf4
80064.85,1.0,55,3,2,2,7,0xb2d64866
5699.5,1.0,2,2,2,4,8,0xb2d99fbb
1088.56,1.0,17,1,2,2,5,0xb2d21839d
309833.56,3.0,73,4,4,1,9,0xb2d5ced9
2655.84,1.0,40,1,2,2,5,0xb2d8cdf0
161854.25,5.0,28,3,4,2,9,0xb2d62c22d
125593.3,1.0,10,3,2,3,8,0xb2d78d6cd
612851.77,5.0,0,4,4,4,12,0xb2d19fe6d
100912.49,2.0,97,3,3,1,7,0xb2d3606bd
348104.04,2.0,164,4,3,1,8,0xb2d4362b
10111984.16,4.0,0,4,4,4,12,0xb2d88af5
11751.03,2.0,2,2,3,4,9,0x3b9af0da
5508.3,5.0,3,2,4,4,10,0xb2d9b067
5315.74,1.0,5,2,2,3,7,0xb2d5358c
94955.75,2.0,18,3,3,2,8,0xb2d8df5cd
20005.98,2.0,237,2,3,1,6,0xb2d5e898d
8101.02,1.0,0,2,2,4,8,0xb2d34df3
103603.56,2.0,60,3,3,2,8,0xb2d64820
70338.13,2.0,9,3,3,3,9,0xb2d465b9
19129.09,3.0,0,2,4,4,10,0x3b9af135d
4155.12,1.0,6,2,2,3,7,0xb2d19cf6
302406.25,2.0,10,4,3,3,10,0xb2d695a0
124.92,1.0,1,1,2,4,7,0xb2d93f74d
1339919.6,16.0,7,4,4,3,11,0xb2d5e33cd
4032.05,1.0,1,2,2,4,8,0xb2d6505d
377906.98,3.0,0,4,4,4,12,0xb2d5ea7dd
1010051.9,3.0,0,4,4,4,12,0xb2d96c87
587375.56,6.0,8,4,4,3,11,0xb2d4c05c
1202.12,1.0,73,1,2,1,4,0xb2d35bb1
1500197.35,3.0,4,4,4,4,12,0xb2d9cc2d
189.68,2.0,6,1,3,3,7,0x3b9b3e11
200002.11,2.0,28,3,3,2,8,0xb2da0b19
38.01,3.0,2,1,4,4,9,0xb2d96acf
20023.62,2.0,8,2,3,3,8,0xb2da46ff
17.74,1.0,34,1,2,2,5,0xb2d90fe1
801107.42,3.0,11,4,4,3,11,0xb2d83847
150011.14,2.0,122,3,3,1,7,0xb2d52b11d
8260.47,1.0,0,2,2,4,8,0xb2d99fe5
184871.3,1.0,0,3,2,4,9,0xb2d1f36fd
487.95,1.0,13,1,2,3,6,0xb2d2cd7b
10735.6,1.0,92,2,2,1,5,0xb2d65796
105753.87,1.0,4,3,2,4,9,0xb2d6cbef
10000.21,2.0,8,2,3,3,8,0xb2da469a
670.52,1.0,42,1,2,2,5,0xb2d8d841
705596.46,2.0,42,4,3,2,9,0xb2d91265
10422.99,3.0,0,2,4,4,10,0xb2d2fd43d
200003.6,3.0,12,3,4,3,10,0xb2d4cb2a
180065.96,3.0,0,3,4,4,11,0xb2d49d53d
2201.75,3.0,184,1,4,1,6,0x3b9addead
2225.77,1.0,29,1,2,2,5,0xb2d1d6d9d
300000.0,2.0,0,3,3,4,10,0xb2d97eaad
6788.65,1.0,184,2,2,1,5,0xb2d28855d
515460.71,3.0,4,4,4,4,12,0xb2d6ff7e
177446.4,5.0,0,3,4,4,11,0x3b9b3e49
2300180.35,2.0,200,4,3,1,8,0xb2d48082d
391064.87,4.0,0,4,4,4,12,0xb2d22101
100060.55,1.0,20,3,2,2,7,0xb2d94365
1647.4,1.0,4,1,2,4,7,0xb2d6affe
448007.28,3.0,48,4,4,2,10,0xb2d58999
1010.04,2.0,184,1,3,1,5,0xb2d1a739d
200000.0,2.0,7,3,3,3,9,0xb2d96f5c
4.2,1.0,40,1,2,2,5,0xb2d5e7cc
5473.67,1.0,184,2,2,1,5,0xb2d41902d
58727.22,1.0,0,3,2,4,9,0xb2d96b19
101267.31,1.0,1,3,2,4,9,0xb2d92510d
10000.21,2.0,92,2,3,1,6,0xb2d63a48d
7125.42,1.0,7,2,2,3,7,0xb2d30986
1300096.31,18.0,1,4,4,4,12,0xb2d6f057
60038.28,2.0,151,3,3,1,7,0xb2d14e67
89575.46,1.0,92,3,2,1,6,0xb2d3c81fd
157019.22,4.0,181,3,4,1,8,0xb2d451dc
500015.42,3.0,0,4,4,4,12,0xb2d9aa5f
50000.0,3.0,5,2,4,3,9,0xb2d91492d
2790282.67,73.0,0,4,4,4,12,0xb2d4a6ef
500002.68,3.0,12,4,4,3,11,0xb2d80d4ed
80972.7,2.0,80,3,3,1,7,0xb2d171e1
303733.34,2.0,98,4,3,1,8,0xb2d6417f
12237.21,1.0,0,2,2,4,8,0xb2d6b723d
148028.32,1.0,0,3,2,4,9,0xb2d35341
1325.24,1.0,6,1,2,3,6,0xb2d6f271
389889.29,4.0,32,4,4,2,10,0xb2d094b3
710707.57,2.0,28,4,3,2,9,0xb2d104dcd
46.27,1.0,27,1,2,2,5,0xb2d40ad3d
2937.91,1.0,9,2,2,3,7,0xb2d9d295
1040.73,1.0,7,1,2,3,6,0xb2d38adc
277031.75,3.0,143,3,4,1,8,0xb2d41477d
802841.74,2.0,30,4,3,2,9,0xb2d9bb45
80012.22,3.0,101,3,4,1,8,0xb2d09508d
151.18,1.0,11,1,2,3,6,0xb2d692a1
2897.88,1.0,167,2,2,1,5,0xb2d3e6ead
1865199.82,14.0,12,4,4,3,11,0xb2d07b5dd
58.8,1.0,18,1,2,2,5,0xb2d38bc9d
500000.0,2.0,3,4,3,4,11,0xb2d8f98bd
214766.64,10.0,25,3,4,2,9,0xb2d643ad
300730.63,3.0,15,4,4,3,11,0xb2d76963d
698.35,4.0,92,1,4,1,6,0x3b9ada5c
77086.74,2.0,209,3,3,1,7,0xb2d34416d
71001.0,2.0,4,3,3,4,10,0xb2d16a82
839177.04,8.0,10,4,4,3,11,0xb2d2143ad
183.98,1.0,40,1,2,2,5,0xb2d4a92f
971.03,1.0,2,1,2,4,7,0xb2d3ec66
20340.73,3.0,184,2,4,1,7,0xb2d109d2d
140036.18,3.0,6,3,4,3,10,0xb2d5e553
34.5,1.0,76,1,2,1,4,0xb2d2fedc
381618.16,4.0,15,4,4,3,11,0xb2d5e756d
375.89,1.0,23,1,2,2,5,0xb2d27dfb
15.5,1.0,45,1,2,2,5,0xb2d6ced3
350000.84,2.0,28,4,3,2,9,0xb2d9f57b
300018.36,3.0,25,3,4,2,9,0xb2d9192fd
1500000.54,2.0,2,4,3,4,11,0xb2d75646
120689.44,3.0,83,3,4,1,8,0xb2d4b8b7d
7976.32,1.0,24,2,2,2,6,0xb2d1b215d
270036.28,2.0,17,3,3,2,8,0xb2d8f7c0d
102201.74,5.0,92,3,4,1,8,0x3b9b4911
140127.13,10.0,0,3,4,4,11,0xb2d6ac3ed
2092.72,1.0,1,1,2,4,7,0xb2d15281
140079.78,3.0,174,3,4,1,8,0x3b9adcffd
34768.59,2.0,20,2,3,2,7,0xb2d60a49
650008.46,4.0,10,4,4,3,11,0xb2d2d5d7
332002.59,5.0,6,4,4,3,11,0xb2d1f0e3d
821.1,3.0,21,1,4,2,7,0xb2d5dc68
1123.94,1.0,10,1,2,3,6,0xb2d4eb81
7.91,1.0,10,1,2,3,6,0xb2d37a6cd
662433.62,2.0,55,4,3,2,9,0xb2d94e97d
60635.14,2.0,11,3,3,3,9,0xb2d95e8a
5770.92,1.0,21,2,2,2,6,0xb2d6bb43d
3000084.48,2.0,101,4,3,1,8,0xb2d594df
1800000.01,5.0,5,4,4,3,11,0xb2d10b20
1000000.0,4.0,5,4,4,3,11,0xb2d5a131
20044.23,1.0,196,2,2,1,5,0xb2d52ee7
200027.19,2.0,90,3,3,1,7,0xb2d27178d
1196.13,1.0,92,1,2,1,4,0xb2d976d6
3320385.31,7.0,3,4,4,4,12,0xb2d40d4f
200020.9,2.0,12,3,3,3,9,0xb2d9a1b8
5361.57,1.0,70,2,2,1,5,0xb2d16b6d
1213.66,1.0,92,1,2,1,4,0xb2d366b5
551953.77,2.0,46,4,3,2,9,0xb2d91d1fd
3.44,1.0,9,1,2,3,6,0xb2d3c98a
1453.77,1.0,32,1,2,2,5,0xb2d56eb9
712.47,1.0,0,1,2,4,7,0xb2d909c0
9001.98,1.0,2,2,2,4,8,0xb2d6acb7
12564.02,3.0,0,2,4,4,10,0x3b9b3536d
70343.49,4.0,6,3,4,3,10,0xb2d557b5
231830.8,2.0,122,3,3,1,7,0xb2d29203
700103.47,4.0,95,4,4,1,9,0xb2d32ee1
200755.28,5.0,8,3,4,3,10,0xb2d14d25d
306744.58,2.0,64,4,3,2,9,0xb2d36137
68.66,2.0,60,1,3,2,6,0xb2d1742bd
1737.75,1.0,74,1,2,1,4,0xb2d40cce
565039.61,4.0,4,4,4,4,12,0xb2d4f422d
103603.33,2.0,70,3,3,1,7,0xb2d63daf
350012.43,5.0,1,4,4,4,12,0xb2d5ad28
63.99,1.0,16,1,2,2,5,0xb2d59571
490062.76,4.0,2,4,4,4,12,0xb2d0c9a9
1001.57,1.0,147,1,2,1,4,0xb2d8f477
300000.0,2.0,9,3,3,3,9,0xb2d8e80b
2042.75,1.0,9,1,2,3,6,0xb2d6c9bfd
153833.28,1.0,3,3,2,4,9,0xb2d48e7c
20000.8,3.0,1,2,4,4,10,0xb2da47d0
380197.53,4.0,125,4,4,1,9,0xb2d17e8f
900286.77,3.0,49,4,4,2,10,0xb2d0c6f5d
651431.95,5.0,11,4,4,3,11,0xb2d41065
103602.79,1.0,0,3,2,4,9,0xb2d99af7
10305.91,1.0,0,2,2,4,8,0xb2d6b944d
60000.65,8.0,27,3,4,2,9,0xb2d1a090
402012.73,2.0,46,4,3,2,9,0xb2d9dab5
1516.93,1.0,0,1,2,4,7,0xb2d8f6ead
100001.06,2.0,38,3,3,2,8,0xb2d92cd7
5499.29,1.0,9,2,2,3,7,0xb2d82b91
12282.91,1.0,0,2,2,4,8,0xb2d41fd3
311169.1,3.0,108,4,4,1,9,0xb2d11d8d
4973.22,5.0,2,2,4,4,10,0x3b9af12c
5759.5,1.0,137,2,2,1,5,0xb2d306bf
75117.11,2.0,9,3,3,3,9,0xb2d06553d
11050.69,1.0,102,2,2,1,5,0xb2d6efded
144569.22,4.0,1,3,4,4,11,0xb2d26bce
1907.08,1.0,0,1,2,4,7,0xb2d3511e
788.77,1.0,6,1,2,3,6,0xb2d58f97
36704.19,1.0,10,2,2,3,7,0xb2d54f0c
30252.28,1.0,3,2,2,4,8,0xb2d140f5
152232.69,1.0,2,3,2,4,9,0xb2d15625d
20340.46,1.0,92,2,2,1,5,0x3b9ad6cb
3.37,2.0,69,1,3,1,5,0xb2d0c898
150821.02,2.0,5,3,3,3,9,0xb2d91837
7074.31,1.0,184,2,2,1,5,0xb2d2b312
8716.65,2.0,0,2,3,4,9,0x3b9af2d6
680151.57,3.0,27,4,4,2,10,0xb2d53ca2d
250000.0,3.0,3,3,4,4,11,0xb2d97a45d
129.86,1.0,88,1,2,1,4,0xb2d5d1fad
12342.36,1.0,0,2,2,4,8,0xb2d6b8aed
1799.29,1.0,8,1,2,3,6,0xb2d1d0f1d
31.29,1.0,20,1,2,2,5,0xb2d315c0
103346.92,8.0,4,3,4,4,11,0xb2d594b8
2596.86,1.0,0,1,2,4,7,0xb2d8dac6
200078.98,2.0,3,3,3,4,10,0xb2da642a
20090.18,1.0,184,2,2,1,5,0xb2d54c50
310099.94,3.0,0,4,4,4,12,0xb2d24672
22094.32,1.0,9,2,2,3,7,0xb2d75b24
7019.56,1.0,239,2,2,1,5,0xb2d6321b
168011.3,3.0,49,3,4,2,9,0xb2d63a3cd
8075.37,1.0,3,2,2,4,8,0xb2d4351dd
3078.26,1.0,0,2,2,4,8,0xb2d6f80b
1972.41,1.0,121,1,2,1,4,0xb2d1637fd
201889.73,2.0,0,3,3,4,10,0xb2d328edd
61358.06,4.0,34,3,4,2,9,0xb2d4e417
14684.75,1.0,21,2,2,2,6,0xb2d96466
360614.13,14.0,25,4,4,2,10,0xb2d6521dd
57742.42,2.0,143,3,3,1,7,0xb2d36fd3
50011.55,2.0,143,2,3,1,6,0xb2d56d90
88.42,1.0,26,1,2,2,5,0xb2d41a1a
2267.73,1.0,196,1,2,1,4,0xb2d5f39c
232.96,1.0,0,1,2,4,7,0xb2d55ec2
370051.07,2.0,27,4,3,2,9,0xb2d45cdcd
2648.85,1.0,10,1,2,3,6,0xb2d3b0ff
187.98,1.0,49,1,2,2,5,0xb2d352f1d
555600.0,12.0,0,4,4,4,12,0x3b9af192d
318152.26,2.0,143,4,3,1,8,0xb2d30d52d
249036.32,14.0,41,3,4,2,9,0xb2d2db3fd
1014222.71,8.0,3,4,4,4,12,0xb2d4961c
280005.38,4.0,61,3,4,2,9,0xb2d1184cd
1049185.79,1.0,4,4,2,4,10,0xb2d5dfcfd
2131.5,1.0,3,1,2,4,7,0xb2d8ec0d
30088.84,4.0,2,2,4,4,10,0xb2d6fb86
801065.63,4.0,21,4,4,2,10,0xb2d953b3
5361.52,1.0,92,2,2,1,5,0xb2d13ab2d
776731.04,3.0,3,4,4,4,12,0xb2d2bc9e
160899.89,1.0,0,3,2,4,9,0xb2d8f6a3
513000.0,4.0,0,4,4,4,12,0xb2d1e103
10.15,1.0,51,1,2,2,5,0xb2d25c98
63200.37,1.0,10,3,2,3,8,0xb2d5d129d
192034.2,4.0,10,3,4,3,10,0xb2d10bebd
320191.04,4.0,105,4,4,1,9,0xb2d074b5d
1459.2,1.0,184,1,2,1,4,0xb2d0feded
370000.0,10.0,1,4,4,4,12,0xb2d57e5e
731530.57,4.0,4,4,4,4,12,0xb2da000b
0.0,1.0,0,1,2,4,7,0xb2d6a213
301149.99,2.0,11,4,3,3,10,0xb2d6275bd
807.92,2.0,92,1,3,1,5,0xb2d4a278
200000.0,2.0,29,3,3,2,8,0xb2da0a2d
1451862.15,5.0,12,4,4,3,11,0xb2d5c489d
206402.22,2.0,288,3,3,1,7,0xb2d69ec6
453154.18,8.0,3,4,4,4,12,0xb2d1947e
157214.95,4.0,108,3,4,1,8,0xb2d5e54e
160005.5,5.0,41,3,4,2,9,0xb2d4c02b
11092.23,1.0,0,2,2,4,8,0xb2d3ad75
9828.89,1.0,1,2,2,4,8,0xb2d1a297
4364.98,1.0,89,2,2,1,5,0xb2d093fed
15634.6,1.0,15,2,2,3,7,0xb2d1bde7
580169.63,3.0,0,4,4,4,12,0xb2d4955f
0.0,1.0,8,1,2,3,6,0xb2d273f6
3.9,1.0,89,1,2,1,4,0xb2d548bb
3732.93,1.0,9,2,2,3,7,0xb2d8db50
2667.22,1.0,45,1,2,2,5,0xb2d8a945d
7405.84,1.0,127,2,2,1,5,0xb2d4126fd
200007.95,4.0,18,3,4,2,9,0xb2d6d7d4d
204984.49,2.0,214,3,3,1,7,0xb2d1ccea
3682.52,1.0,4,2,2,4,8,0xb2d52df5d
87.8,1.0,9,1,2,3,6,0xb2d2c815
1003552.3,2.0,16,4,3,2,9,0xb2d91d5a
70615.3,2.0,87,3,3,1,7,0xb2d2bf50d
7.34,1.0,6,1,2,3,6,0xb2d25decd
550901.3,7.0,19,4,4,2,10,0xb2d69407
32.59,1.0,84,1,2,1,4,0xb2d50dee
736.55,2.0,23,1,3,2,6,0xb2d2df17
60000.85,3.0,62,3,4,2,9,0xb2d6f303d
330071.34,2.0,27,4,3,2,9,0xb2d1b44fd
1681.79,1.0,7,1,2,3,6,0xb2d91e6e
3998.87,1.0,1,2,2,4,8,0xb2d6eaf0
383742.36,18.0,0,4,4,4,12,0x3b9af13e
507115.34,2.0,121,4,3,1,8,0xb2d92629
29224.15,1.0,15,2,2,3,7,0xb2d3b610
206017.88,2.0,31,3,3,2,8,0xb2d26eb1
18.42,1.0,43,1,2,2,5,0xb2d584ff
2644.37,1.0,7,1,2,3,6,0xb2d234f4
1047.7,1.0,9,1,2,3,6,0xb2d8e69d
520556.71,4.0,8,4,4,3,11,0xb2d273e9
100010.77,2.0,1,3,3,4,10,0xb2d56ca0
120901.79,5.0,0,3,4,4,11,0x3b9ae61dd
13660.34,1.0,7,2,2,3,7,0xb2d632fd
62000.65,2.0,21,3,3,2,8,0xb2da2080
52127.04,2.0,6,2,3,3,8,0xb2d615dd
140003.48,2.0,76,3,3,1,7,0xb2d8dcea
30.16,2.0,6,1,3,3,7,0x3b9b2fac
110.47,1.0,69,1,2,1,4,0xb2d68eb9d
600014.33,2.0,37,4,3,2,9,0xb2d90e13
140920.88,1.0,0,3,2,4,9,0xb2d8fa04
100050.0,1.0,0,3,2,4,9,0xb2d9799fd
0.0,23.0,1,1,4,4,9,0xb2d380db
1295.92,1.0,52,1,2,2,5,0xb2d593fa
113010.52,2.0,92,3,3,1,7,0xb2d645ba
103092.93,3.0,0,3,4,4,11,0xb2d45b12d
79.36,1.0,48,1,2,2,5,0xb2d5ae5b
886106.51,2.0,0,4,3,4,11,0xb2d20614d
328814.64,4.0,1,4,4,4,12,0xb2d51225
204711.3,2.0,35,3,3,2,8,0xb2d8dcf7d
733114.22,7.0,52,4,4,2,10,0xb2d1815e
633.14,1.0,7,1,2,3,6,0xb2d3d9e6
7100.9,1.0,22,2,2,2,6,0xb2d9d3c1
132052.64,3.0,98,3,4,1,8,0xb2d41086d
254243.04,2.0,16,3,3,2,8,0xb2d62b41
800000.0,6.0,19,4,4,2,10,0xb2d8e0e7d
97004.37,2.0,77,3,3,1,7,0xb2d47782d
20015.59,2.0,77,2,3,1,6,0xb2d99367
49557.99,1.0,3,2,2,4,8,0xb2d42ce3
1125134.17,15.0,1,4,4,4,12,0xb2d40ffd
514225.97,2.0,83,4,3,1,8,0xb2d6bd08
2068.44,2.0,0,1,3,4,8,0x3b9b0e33d
1889.83,1.0,237,1,2,1,4,0xb2d3962ad
950010.0,1.0,5,4,2,3,9,0xb2d9036f
2231900.18,7.0,2,4,4,4,12,0x3b9b18e3
10302.16,1.0,1,2,2,4,8,0xb2d69c2cd
301022.65,4.0,7,4,4,3,11,0xb2d30a64d
21754.29,1.0,10,2,2,3,7,0xb2d4c8a4d
20012.22,2.0,122,2,3,1,6,0xb2d62140
15537.09,1.0,35,2,2,2,6,0xb2d5d18fd
20686.81,1.0,209,2,2,1,5,0xb2d5a665d
380000.62,3.0,8,4,4,3,11,0xb2d1a2ae
33469.38,1.0,4,2,2,4,8,0xb2d606eb
52286.4,1.0,1,3,2,4,9,0xb2d908aa
700045.74,4.0,47,4,4,2,10,0xb2d41280
40.02,3.0,0,1,4,4,9,0xb2d8d9b3
2226441.29,10.0,19,4,4,2,10,0xb2d0df37d
591042.65,11.0,10,4,4,3,11,0xb2d4c931
1.27,1.0,19,1,2,2,5,0xb2d94bda
268.21,1.0,13,1,2,3,6,0xb2d2425e
323721.68,4.0,0,4,4,4,12,0xb2d63dce
2413.7,1.0,24,1,2,2,5,0xb2d6ba50d
3564.76,1.0,0,2,2,4,8,0xb2d78353
1050058.3,6.0,3,4,4,4,12,0xb2d5bb97
20275.78,1.0,92,2,2,1,5,0xb2d17225d
1223.4,24.0,184,1,4,1,6,0x3b9b35e3d
209006.62,2.0,157,3,3,1,7,0xb2d454c3d
1805000.0,27.0,0,4,4,4,12,0xb2d4277ad
500005.28,2.0,48,4,3,2,9,0xb2d9db30
1.48,1.0,60,1,2,2,5,0xb2d8f1ed
80.82,1.0,36,1,2,2,5,0xb2d9384b
50000.53,3.0,62,2,4,2,8,0xb2d8eab4d
1.79,12.0,88,1,4,1,6,0xb2d292de
200005.99,3.0,123,3,4,1,8,0xb2d60101
1072011.38,6.0,110,4,4,1,9,0xb2d5ba56d
1510.81,1.0,4,1,2,4,7,0xb2d15b27
1226713.24,8.0,0,4,4,4,12,0xb2d1e97f
690000.35,2.0,154,4,3,1,8,0xb2d574f7
21.09,1.0,19,1,2,2,5,0xb2d5a263
300000.75,5.0,136,3,4,1,8,0xb2d14158
700458.93,4.0,9,4,4,3,11,0xb2d5a9b9
20405.67,7.0,132,2,4,1,7,0xb2d6a4f3d
200019.57,1.0,7,3,2,3,8,0xb2d5ea73
34326.75,2.0,23,2,3,2,7,0xb2d658a6
66182.81,2.0,35,3,3,2,8,0xb2d68372d
468754.63,7.0,12,4,4,3,11,0xb2d07de5
3709.77,1.0,92,2,2,1,5,0xb2d3adf3
4111.58,1.0,184,2,2,1,5,0xb2d35d66
2534.05,1.0,7,1,2,3,6,0xb2d32f5fd
0.48,1.0,2,1,2,4,7,0xb2d8d2e5d
500041.83,2.0,2,4,3,4,11,0xb2d65c91
231104.96,2.0,87,3,3,1,7,0xb2d8c9c9d
45132.68,1.0,193,2,2,1,5,0xb2d44c66
5738.11,1.0,4,2,2,4,8,0xb2d6beac
313.05,1.0,2,1,2,4,7,0xb2d69a24d
880023.47,2.0,117,4,3,1,8,0xb2d61c4ed
1255.79,1.0,6,1,2,3,6,0xb2d213a5
100001.14,9.0,3,3,4,4,11,0xb2d6812cd
540003.07,4.0,3,4,4,4,12,0xb2d964ffd
535716.61,2.0,4,4,3,4,11,0xb2d28e01
16846.78,1.0,0,2,2,4,8,0xb2d22b17d
1298.05,1.0,184,1,2,1,4,0xb2d39ab6
20087900.51,27.0,1,4,4,4,12,0xb2d1538c
8004.0,1.0,10,2,2,3,7,0xb2d3bd5ed
27337.02,1.0,184,2,2,1,5,0x3b9adc87
540000.0,3.0,29,4,4,2,10,0xb2da0a9e
500000.0,2.0,24,4,3,2,9,0xb2d94d1ad
50000.64,2.0,32,2,3,2,7,0xb2d92a15d
176691.36,2.0,95,3,3,1,7,0xb2d45795
311003.58,4.0,0,4,4,4,12,0xb2d9a100
500000.0,2.0,19,4,3,2,9,0xb2da2ff7
160189.68,4.0,9,3,4,3,10,0xb2d4ec04d
280669.86,4.0,5,3,4,3,10,0xb2d707d1d
559.25,1.0,16,1,2,2,5,0xb2d38e21
570051.32,7.0,3,4,4,4,12,0xb2d22157d
9997.25,1.0,9,2,2,3,7,0xb2d2fdaf
252101.5,3.0,3,3,4,4,11,0xb2d6ea06
10000.42,2.0,14,2,3,3,8,0xb2da350a
200290.58,2.0,6,3,3,3,9,0xb2d0e701
94000.99,2.0,21,3,3,2,8,0xb2da203c
1135.07,1.0,16,1,2,2,5,0xb2d4f61c
403316.69,2.0,181,4,3,1,8,0xb2d1e629d
359006.54,8.0,0,4,4,4,12,0xb2d0d643d
0.0,1.0,1,1,2,4,7,0xb2d96cc9
67611.42,2.0,0,3,3,4,10,0xb2d212d8
120005.84,3.0,41,3,4,2,9,0xb2d2aa6cd
1400000.0,5.0,4,4,4,4,12,0xb2d83b79
12344.66,1.0,6,2,2,3,7,0xb2d68ed3d
0.0,1.0,7,1,2,3,6,0xb2d09a36
6137.56,1.0,184,2,2,1,5,0xb2d311b7d
844.81,1.0,0,1,2,4,7,0xb2d24c48
187.94,1.0,6,1,2,3,6,0xb2d24663
110988.84,2.0,0,3,3,4,10,0xb2d2406b
488810.36,4.0,11,4,4,3,11,0xb2d6b064d
1133.28,1.0,184,1,2,1,4,0xb2d21613d
19530.19,1.0,1,2,2,4,8,0xb2d32479d
15000.0,1.0,6,2,2,3,7,0xb2d5d3dd
105017.42,2.0,175,3,3,1,7,0xb2d3887d
437076.47,5.0,41,4,4,2,10,0xb2d1bed0d
12104.33,1.0,92,2,2,1,5,0xb2d1f710d
500000.0,4.0,7,4,4,3,11,0xb2d4657a
107795.49,2.0,92,3,3,1,7,0xb2d0cd26d
111331.67,2.0,0,3,3,4,10,0xb2d52b4ed
4444.22,1.0,21,2,2,2,6,0xb2d39341
500028.88,2.0,10,4,3,3,10,0xb2d78a4d
99632.65,20.0,0,3,4,4,11,0xb2d09f16
10237.52,1.0,22,2,2,2,6,0xb2d24a71
40.33,1.0,10,1,2,3,6,0xb2d5a1a2d
150252.07,3.0,18,3,4,2,9,0xb2d2282dd
382904.79,5.0,0,4,4,4,12,0xb2d59b8e
641.73,1.0,23,1,2,2,5,0xb2d2ca9cd
33.09,1.0,15,1,2,3,6,0xb2d5d5a4d
23906.84,2.0,20,2,3,2,7,0xb2d264d0d
1540178.75,22.0,1,4,4,4,12,0xb2d69050d
1489025.39,12.0,19,4,4,2,10,0x3b9b30bf
57540.33,2.0,2,3,3,4,10,0xb2d1daf3d
2393.06,1.0,92,1,2,1,4,0xb2d26741
878.36,2.0,63,1,3,2,6,0xb2d43e4b
255248.1,2.0,113,3,3,1,7,0xb2d4bc6f
21145.48,1.0,12,2,2,3,7,0xb2d57aba
555298.11,4.0,80,4,4,1,9,0xb2d1dae4d
1049614.09,8.0,0,4,4,4,12,0xb2d09ff5d
237093.24,4.0,97,3,4,1,8,0xb2d283fd
140029.46,3.0,73,3,4,1,8,0xb2d2b332d
657078.7,5.0,26,4,4,2,10,0xb2d3fe63
300065.63,2.0,11,3,3,3,9,0xb2d9efea
90111.84,1.0,0,3,2,4,9,0xb2d27acd
5036057.83,19.0,10,4,4,3,11,0xb2d5ca4a
1.58,1.0,18,1,2,2,5,0xb2d60b5f
56243.4,3.0,0,3,4,4,11,0xb2d3fc4bd
200000.0,2.0,1,3,3,4,10,0xb2d9822c
3.76,1.0,109,1,2,1,4,0xb2d95875
46.81,1.0,15,1,2,3,6,0xb2d6111b
850153.97,3.0,20,4,4,2,10,0xb2d13f69
2630.47,1.0,12,1,2,3,6,0xb2d1ffc4
101841.95,1.0,26,3,2,2,7,0xb2d87ff5
1395.6,1.0,92,1,2,1,4,0x3b9b0fddd
200000.0,2.0,1,3,3,4,10,0xb2d8a160d
500000.0,2.0,20,4,3,2,9,0xb2da2b56
138.14,1.0,29,1,2,2,5,0xb2d86944d
0.0,1.0,0,1,2,4,7,0xb2d294d9d
3061.69,1.0,184,2,2,1,5,0xb2d33094d
745.75,1.0,7,1,2,3,6,0xb2d6c1c8
70196.34,5.0,160,3,4,1,8,0xb2d2ecfad
400020.86,2.0,16,4,3,2,9,0xb2d9de3e
90.81,1.0,53,1,2,2,5,0xb2d7ad86
970.34,5.0,4,1,4,4,9,0x3b9b3dfa
3052.0,1.0,92,2,2,1,5,0xb2d30f18
400179.33,7.0,25,4,4,2,10,0xb2d32d46
766045.17,6.0,20,4,4,2,10,0xb2d5d2abd
1957.33,2.0,0,1,3,4,8,0xb2d51ea4
786125.57,2.0,14,4,3,3,10,0x3b9b335ad
9887.32,1.0,0,2,2,4,8,0xb2d68544d
110002.64,3.0,27,3,4,2,9,0xb2d9ae08
300159.94,2.0,143,4,3,1,8,0xb2d11f34d
3633.98,1.0,8,2,2,3,7,0xb2d292bd
53152.75,2.0,182,3,3,1,7,0xb2d42b1bd
350006.03,8.0,10,4,4,3,11,0xb2d6eb94d
3063.17,1.0,10,2,2,3,7,0xb2d96811
742094.38,6.0,3,4,4,4,12,0xb2d14506
692059.32,5.0,1,4,4,4,12,0xb2d6230ad
325840.29,2.0,9,4,3,3,10,0xb2d4a9f3d
146256.7,3.0,0,3,4,4,11,0xb2d2c8afd
36.94,1.0,18,1,2,2,5,0xb2d94b12d
311005.88,3.0,18,4,4,2,10,0xb2d6b94e
24.12,1.0,20,1,2,2,5,0xb2d561c1
31833.51,3.0,0,2,4,4,10,0xb2d6b03d
35.9,1.0,106,1,2,1,4,0xb2d951c1
7.82,1.0,87,1,2,1,4,0xb2d24b70
669830.76,2.0,30,4,3,2,9,0xb2d3bb41d
9712.22,1.0,1,2,2,4,8,0xb2d28b4d
1000547.54,4.0,15,4,4,3,11,0xb2d0c859
6312.15,1.0,29,2,2,2,6,0xb2d92bfa
66.4,1.0,17,1,2,2,5,0xb2d26da9
1019.55,1.0,184,1,2,1,4,0xb2d0d899d
38.65,1.0,10,1,2,3,6,0xb2d3b847
104.67,1.0,81,1,2,1,4,0xb2d17097
202005.12,7.0,13,3,4,3,10,0xb2d2145e
952.82,1.0,10,1,2,3,6,0xb2d5c284
19315.06,1.0,0,2,2,4,8,0xb2d69165
256020.79,3.0,63,3,4,2,9,0xb2d198d1
1293.55,1.0,92,1,2,1,4,0xb2d1f04a
1324.81,1.0,7,1,2,3,6,0xb2d6c989
154871.41,3.0,13,3,4,3,10,0xb2d5b4d7d
1560757.04,6.0,0,4,4,4,12,0xb2d20cb0
7004.6,1.0,7,2,2,3,7,0xb2d6ada1
60692.52,3.0,77,3,4,1,8,0xb2d8d305d
460935.16,4.0,12,4,4,3,11,0xb2d93d6cd
10004.54,2.0,6,2,3,3,8,0xb2d6049e
539.71,2.0,21,1,3,2,6,0x3b9ade55d
66.02,1.0,18,1,2,2,5,0xb2d20169d
200000.0,2.0,15,3,3,3,9,0xb2da2f23
53.51,2.0,33,1,3,2,6,0xb2d8e612
2012.23,2.0,157,1,3,1,5,0xb2d58408
24006.45,2.0,10,2,3,3,8,0xb2d3fa70d
705.52,1.0,24,1,2,2,5,0xb2d279e3
81129.86,1.0,1,3,2,4,9,0xb2d259a8d
1178.01,1.0,92,1,2,1,4,0x3b9b3983
134586.52,1.0,10,3,2,3,8,0xb2d7f345
7981.4,1.0,38,2,2,2,6,0xb2d24b4dd
320000.0,2.0,12,4,3,3,10,0xb2d96476
20002.33,2.0,108,2,3,1,6,0xb2d55aa4
2000000.0,1.0,0,4,2,4,10,0xb2da6c50
602782.3,2.0,13,4,3,3,10,0xb2d69690d
147.58,1.0,0,1,2,4,7,0xb2d9673e
223.5,1.0,1,1,2,4,7,0xb2d2eed2
2032.0,1.0,146,1,2,1,4,0xb2d610c6d
600019.04,2.0,228,4,3,1,8,0xb2d6f2b3d
23.2,1.0,21,1,2,2,5,0xb2d17e94
101117.8,2.0,48,3,3,2,8,0xb2d904ecd
4800.81,1.0,11,2,2,3,7,0xb2d9a649
1364230.82,10.0,31,4,4,2,10,0xb2d26b87
800892.63,5.0,17,4,4,2,10,0xb2d6bdf9
4.02,1.0,9,1,2,3,6,0xb2d41577d
230002.53,2.0,13,3,3,3,9,0xb2d26742d
17.52,1.0,5,1,2,3,6,0xb2d612ef
952818.97,5.0,8,4,4,3,11,0xb2d1ba43d
200106.49,2.0,14,3,3,3,9,0xb2d25e63
233648.5,2.0,33,3,3,2,8,0xb2d6de1bd
2277.97,1.0,9,1,2,3,6,0xb2d90623d
452.11,1.0,32,1,2,2,5,0xb2d22630
108.41,2.0,18,1,3,2,6,0xb2d0dfdd
1480000.0,10.0,0,4,4,4,12,0xb2d6c8df
105656.44,1.0,46,3,2,2,7,0xb2d2478c
75053.35,2.0,0,3,3,4,10,0xb2d3492bd
50055.01,2.0,49,2,3,2,7,0xb2d4ce7f
6185.47,1.0,14,2,2,3,7,0xb2d8f7cc
208009.6,2.0,92,3,3,1,7,0xb2d28f83
1462.47,1.0,10,1,2,3,6,0xb2d6f7d4
202198.73,9.0,0,3,4,4,11,0xb2d0a446
5003.9,1.0,13,2,2,3,7,0xb2d54c37d
200710.86,2.0,30,3,3,2,8,0xb2d64dac
224.78,1.0,10,1,2,3,6,0xb2d31c22d
6701.25,1.0,184,2,2,1,5,0xb2d1cc36
5802.83,1.0,10,2,2,3,7,0xb2d900a2d
200049.24,2.0,0,3,3,4,10,0xb2d9e508
500023.17,3.0,0,4,4,4,12,0xb2d50c20d
45.4,1.0,46,1,2,2,5,0xb2d68108
74.79,1.0,12,1,2,3,6,0xb2d2e0a7
3384.63,1.0,52,2,2,2,6,0xb2d3a2b0d
503552.64,2.0,71,4,3,1,8,0xb2d9a782
2559.21,1.0,92,1,2,1,4,0xb2d0d17b
70001.48,2.0,38,3,3,2,8,0xb2d9287f
160003.78,7.0,18,3,4,2,9,0xb2d6a7d3d
207006.47,3.0,0,3,4,4,11,0xb2d632d6d
0.0,1.0,7,1,2,3,6,0xb2d475e4
31580.03,6.0,28,2,4,2,8,0xb2d9f6aa
50001.06,2.0,83,2,3,1,6,0xb2d98566
488339.88,5.0,1,4,4,4,12,0xb2d594d4d
250002.64,3.0,123,3,4,1,8,0xb2d6ef32
2353.17,1.0,1,1,2,4,7,0xb2d3fe30d
113798.24,1.0,2,3,2,4,9,0xb2d41737
26146.47,1.0,2,2,2,4,8,0xb2d2b547
743104.15,21.0,0,4,4,4,12,0x3b9b124fd
123003.05,3.0,14,3,4,3,10,0xb2d5e919d
18026.97,1.0,7,2,2,3,7,0xb2d629cdd
2823.85,1.0,0,1,2,4,7,0xb2d42236
6.33,1.0,69,1,2,1,4,0xb2d9a2df
6.0,1.0,13,1,2,3,6,0xb2d6c580
320012.18,5.0,3,4,4,4,12,0xb2d64881d
0.0,1.0,6,1,2,3,6,0xb2d2004e
5753.97,1.0,45,2,2,2,6,0xb2d306bfd
5207.7,4.0,92,2,4,1,7,0x3b9b0e1c
203538.03,3.0,55,3,4,2,9,0xb2d5f85bd
26077.73,1.0,92,2,2,1,5,0xb2d61410
30285.87,2.0,83,2,3,1,6,0xb2d68359
5806.15,1.0,10,2,2,3,7,0xb2d3c171
20005.94,2.0,57,2,3,2,7,0xb2d59453
2638.1,1.0,184,1,2,1,4,0xb2d0c49cd
153003.59,4.0,25,3,4,2,9,0xb2d3e279
30000.32,2.0,20,2,3,2,7,0xb2d62f92
400241.79,3.0,8,4,4,3,11,0xb2d63c2f
110.0,1.0,84,1,2,1,4,0xb2d54c56d
1022.4,1.0,10,1,2,3,6,0xb2d957a1
1010.89,1.0,184,1,2,1,4,0xb2d29369
11075.0,1.0,0,2,2,4,8,0xb2d49700
10822.97,1.0,14,2,2,3,7,0xb2d464b6
625.37,2.0,10,1,3,3,7,0xb2d2e0a3
198407.82,1.0,92,3,2,1,6,0xb2d263a3
372815.46,5.0,0,4,4,4,12,0xb2d0c21ad
3.0,1.0,16,1,2,2,5,0xb2d0d7f9
90079.09,2.0,129,3,3,1,7,0xb2d0eb51
501776.36,2.0,57,4,3,2,9,0xb2d9c7b1
902.46,1.0,48,1,2,2,5,0xb2d48da8d
40000.0,4.0,0,2,4,4,10,0xb2d58d15d
133853.36,1.0,0,3,2,4,9,0xb2d2ed54d
977480.5,5.0,13,4,4,3,11,0xb2d60f1ed
302329.59,2.0,32,4,3,2,9,0xb2d6dfee
4540.94,1.0,99,2,2,1,5,0xb2d647d1
6555443.07,5.0,0,4,4,4,12,0xb2d6eb86d
52020.48,1.0,7,2,2,3,7,0xb2d41899
100061.05,2.0,63,3,3,2,8,0xb2d5274dd
250048.22,3.0,11,3,4,3,10,0xb2d213a8d
11673.44,1.0,8,2,2,3,7,0xb2d31df5d
27.47,2.0,5,1,3,3,7,0xb2d98453
0.95,1.0,2,1,2,4,7,0xb2d55649
44518.76,1.0,14,2,2,3,7,0xb2d22e71
1271.4,1.0,70,1,2,1,4,0xb2d567e0d
20055.5,2.0,94,2,3,1,6,0xb2d66734d
8935.68,2.0,0,2,3,4,9,0x3b9b451b
500228.24,3.0,13,4,4,3,11,0xb2d7ec02
110457.44,3.0,68,3,4,1,8,0xb2d17e4dd
196.7,1.0,19,1,2,2,5,0xb2d6faf8
1015.96,1.0,184,1,2,1,4,0xb2d11fbfd
255000.0,2.0,19,3,3,2,8,0xb2d957c5
865.61,1.0,131,1,2,1,4,0xb2d65b8cd
66917.77,2.0,87,3,3,1,7,0x3b9adbd0
826466.03,3.0,4,4,4,4,12,0xb2d20087
582017.85,5.0,112,4,4,1,9,0xb2d56fc3d
64726.58,1.0,0,3,2,4,9,0xb2d1e7f4
21093.51,7.0,4,2,4,4,10,0xb2d6e1c6d
200885.18,4.0,29,3,4,2,9,0xb2d3e5e0
22281.96,1.0,5,2,2,3,7,0xb2d33d89d
530797.99,2.0,31,4,3,2,9,0xb2d65a33
301065.7,2.0,46,4,3,2,9,0xb2d9e2fb
515.75,1.0,10,1,2,3,6,0xb2d320b6
10000.16,2.0,3,2,3,4,9,0xb2d55f80d
1282.0,1.0,184,1,2,1,4,0xb2d13313
1857523.03,7.0,11,4,4,3,11,0x3b9acec3
1998.23,1.0,9,1,2,3,6,0xb2d8c66c
300188.51,3.0,70,4,4,1,9,0xb2d423d3d
1000024.82,8.0,0,4,4,4,12,0xb2d4562f
101174.6,2.0,17,3,3,2,8,0xb2d8d774
61054.44,2.0,46,3,3,2,8,0xb2d6ab9dd
40040.83,5.0,39,2,4,2,8,0xb2d68014
2.11,1.0,67,1,2,1,4,0xb2d99d79
158000.79,3.0,4,3,4,4,11,0xb2d24dadd
2867396.4,11.0,1,4,4,4,12,0xb2d0b52a
59635.19,1.0,141,3,2,1,6,0xb2d37cced
6668.62,1.0,0,2,2,4,8,0xb2d914a4d
408.14,1.0,10,1,2,3,6,0xb2d95b5f
1320005.8,4.0,0,4,4,4,12,0xb2d10b0cd
112082.94,4.0,67,3,4,1,8,0xb2d59dab
6062.42,1.0,10,2,2,3,7,0xb2d34572d
930008.79,4.0,11,4,4,3,11,0xb2d1e607
93156.79,1.0,0,3,2,4,9,0xb2d2f030
4.16,1.0,3,1,2,4,7,0xb2d5a9d5
101022.05,2.0,165,3,3,1,7,0xb2d1172cd
1693.31,1.0,92,1,2,1,4,0xb2d2d905
250063.95,4.0,33,3,4,2,9,0xb2d267fc
35.16,1.0,15,1,2,3,6,0xb2d7918c
10000.71,2.0,94,2,3,1,6,0xb2d7f512d
50366.97,3.0,92,2,4,1,7,0xb2d082db
761009.27,14.0,21,4,4,2,10,0xb2d2605bd
51.81,1.0,5,1,2,3,6,0xb2d21e6cd
513959.92,19.0,5,4,4,3,11,0xb2d2847bd
238.41,1.0,58,1,2,2,5,0xb2d5f240
169407.04,1.0,7,3,2,3,8,0xb2d64bd2
663944.99,4.0,94,4,4,1,9,0xb2d3ac7ed
115000.0,2.0,7,3,3,3,9,0xb2d99c1e
7522.85,1.0,18,2,2,2,6,0xb2d408c1
5415.45,1.0,167,2,2,1,5,0xb2d4263ed
2961014.3,2.0,3,4,3,4,11,0xb2d57882
1978.02,1.0,43,1,2,2,5,0xb2d394bdd
3405.73,4.0,18,2,4,2,8,0xb2d27c63
160022.99,2.0,13,3,3,3,9,0xb2d6176dd
61.6,2.0,48,1,3,2,6,0xb2d32077
8.71,1.0,51,1,2,2,5,0xb2d968ff
121034.28,2.0,169,3,3,1,7,0xb2d1b8c6
524014.12,8.0,21,4,4,2,10,0xb2d65a11d
1710.83,2.0,92,1,3,1,5,0x3b9b4783
450064.36,11.0,0,4,4,4,12,0xb2d25bdb
501786.16,2.0,13,4,3,3,10,0xb2d6e655
120001.27,2.0,203,3,3,1,7,0xb2d788cf
160014.42,2.0,122,3,3,1,7,0xb2d24e8b
100450.86,3.0,18,3,4,2,9,0xb2d414a0d
310000.0,2.0,6,4,3,3,10,0xb2da5bb1
180165.05,2.0,53,3,3,2,8,0xb2d2cdced
203583.79,2.0,129,3,3,1,7,0xb2d5f9bf
300000.0,2.0,27,3,3,2,8,0xb2d99917
4241039.73,13.0,69,4,4,1,9,0xb2d0fa98
18008.88,2.0,167,2,3,1,6,0xb2d5f852
380004.16,7.0,0,4,4,4,12,0xb2d155e3
3770.44,1.0,0,2,2,4,8,0xb2d2961f
5705.24,1.0,18,2,2,2,6,0xb2d1422f
14232.44,1.0,18,2,2,2,6,0xb2d640f0d
1475427.9,7.0,110,4,4,1,9,0xb2d14355
200006.81,2.0,7,3,3,3,9,0xb2d51bcb
61771.19,2.0,74,3,3,1,7,0xb2d405f8
910139.43,3.0,22,4,4,2,10,0xb2d5a827
22044.66,1.0,92,2,2,1,5,0xb2d2ff27d
410726.44,4.0,23,4,4,2,10,0xb2d51232
2525.82,1.0,1,1,2,4,7,0xb2d18d93
52143.33,2.0,14,2,3,3,8,0xb2d3d564d
260008.25,2.0,200,3,3,1,7,0xb2d78ef4
30011.27,2.0,39,2,3,2,7,0xb2d966a3d
204771.45,2.0,129,3,3,1,7,0xb2d5fafe
4949.56,1.0,0,2,2,4,8,0xb2d88bd7d
202140.58,2.0,26,3,3,2,8,0xb2d57c92
131024.03,5.0,12,3,4,3,10,0xb2d12a10d
314701.67,8.0,0,4,4,4,12,0xb2d41158
4753514.45,7.0,4,4,4,4,12,0xb2d12adf
176.28,1.0,0,1,2,4,7,0xb2d2f5e6
197008.81,1.0,27,3,2,2,7,0xb2d57ac6
3512.46,1.0,184,2,2,1,5,0xb2d40668
10013.03,2.0,29,2,3,2,7,0xb2d97055
92.47,1.0,4,1,2,4,7,0xb2d408c6d
400011.08,2.0,3,4,3,4,11,0xb2d961eb
1362.84,1.0,119,1,2,1,4,0xb2d632b8d
1125508.01,2.0,59,4,3,2,9,0xb2d26123
1014.77,1.0,8,1,2,3,6,0xb2d2dc37
7421.51,1.0,0,2,2,4,8,0xb2d9241a
692028.58,11.0,10,4,4,3,11,0xb2d1d99e
400087.28,4.0,12,4,4,3,11,0xb2d8cf94
105004.17,2.0,28,3,3,2,8,0xb2d8c5ccd
0.0,1.0,0,1,2,4,7,0xb2d46827
205075.31,5.0,45,3,4,2,9,0xb2d23d7ed
607002.95,2.0,4,4,3,4,11,0xb2d9543f
1340143.06,14.0,11,4,4,3,11,0xb2d12af5
100005.27,3.0,34,3,4,2,9,0xb2d21ac0
61001.09,2.0,52,3,3,2,8,0xb2d90e0ad
56034.69,2.0,245,3,3,1,7,0xb2d4d0ac
22.51,1.0,63,1,2,2,5,0x3b9b4511
608.15,2.0,0,1,3,4,8,0x3b9b1c04
1627999.25,12.0,0,4,4,4,12,0xb2d20b11d
434309.16,1.0,1,4,2,4,10,0xb2d4baeed
420096.26,4.0,13,4,4,3,11,0xb2d433e0
1005.46,1.0,92,1,2,1,4,0xb2d65ec6d
644264.03,5.0,10,4,4,3,11,0xb2d249fad
136633.54,1.0,0,3,2,4,9,0xb2d1aea5
229.45,1.0,12,1,2,3,6,0xb2d25db1d
254526.44,2.0,27,3,3,2,8,0xb2d6b8ba
3077.95,1.0,12,2,2,3,7,0xb2d1eba9
1040000.0,6.0,0,4,4,4,12,0xb2d42dd5d
8599.04,1.0,22,2,2,2,6,0xb2d6d78e
10047.08,1.0,2,2,2,4,8,0xb2d781ec
89836.9,1.0,0,3,2,4,9,0xb2d3cbb9d
124797.21,2.0,206,3,3,1,7,0xb2d1ef29d
456.0,1.0,25,1,2,2,5,0xb2d958f4
10837.29,1.0,7,2,2,3,7,0xb2da0847
135164.24,1.0,8,3,2,3,8,0xb2d6b3d1
320000.0,2.0,4,4,3,4,11,0xb2da59ac
741.97,1.0,26,1,2,2,5,0xb2d21c87d
2.33,1.0,0,1,2,4,7,0xb2d69238d
1001.01,1.0,21,1,2,2,5,0xb2d59dd4d
4517.89,1.0,92,2,2,1,5,0xb2d54f43
788363.23,5.0,73,4,4,1,9,0xb2d48b3d
10658.08,1.0,22,2,2,2,6,0xb2d6f3d7
2892782.33,14.0,0,4,4,4,12,0x3b9af15f
200040.9,3.0,14,3,4,3,10,0xb2d9a118
1194.04,1.0,184,1,2,1,4,0xb2d43245
370201.09,3.0,4,4,4,4,12,0xb2d95b12
500038.69,2.0,215,4,3,1,8,0xb2d62c19d
101001.29,4.0,49,3,4,2,9,0xb2d3c766d
216555.74,2.0,74,3,3,1,7,0xb2d643c5d
6180.94,1.0,0,2,2,4,8,0xb2d6a9d0
2230000.81,15.0,0,4,4,4,12,0xb2d23389
2031.24,1.0,92,1,2,1,4,0xb2d193a9d
178000.0,4.0,0,3,4,4,11,0xb2d3ea83
11568.46,1.0,1,2,2,4,8,0xb2d6b6c5
250261.44,4.0,10,3,4,3,10,0xb2d6d09e
50000.53,2.0,94,2,3,1,6,0xb2d88b45
269.26,1.0,0,1,2,4,7,0xb2d7833d
286798.18,10.0,6,3,4,3,10,0xb2d0b3ba
1151.44,1.0,0,1,2,4,7,0xb2da2141
70186.07,2.0,83,3,3,1,7,0xb2d5dba3d
101182.12,1.0,0,3,2,4,9,0xb2d11c27
94230.24,7.0,0,3,4,4,11,0xb2d4319ad
50056.91,2.0,131,2,3,1,6,0xb2d61c56
240319.94,5.0,59,3,4,2,9,0xb2d13e8d
60.93,1.0,76,1,2,1,4,0xb2d576ff
6168.49,1.0,92,2,2,1,5,0xb2d1c62bd
30062.85,2.0,4,2,3,4,9,0xb2d2a87d
1248.54,1.0,184,1,2,1,4,0xb2d2a86fd
130319.86,4.0,0,3,4,4,11,0x3b9b4677
222486.39,3.0,6,3,4,3,10,0xb2d64721d
500.94,2.0,26,1,3,2,6,0xb2d301ed
3.94,1.0,10,1,2,3,6,0xb2d953ab
8964.82,1.0,12,2,2,3,7,0xb2d1ec50d
10229.16,1.0,184,2,2,1,5,0xb2d2c458
2114.52,1.0,184,1,2,1,4,0xb2d2018ad
376.65,1.0,12,1,2,3,6,0xb2d8bda3
10455.1,1.0,103,2,2,1,5,0xb2d835bfd
7895.0,1.0,7,2,2,3,7,0xb2d34fba
1001.51,1.0,17,1,2,2,5,0xb2d273c7d
209034.53,2.0,3,3,3,4,10,0xb2d1baf2
10730.46,1.0,11,2,2,3,7,0xb2d8dfdd
2460000.07,18.0,1,4,4,4,12,0xb2d23389d
260316.61,7.0,1,3,4,4,11,0xb2d17f7e
2000083.8,3.0,132,4,4,1,9,0xb2d20fdbd
314164.8,2.0,129,4,3,1,8,0xb2d15de2d
20060.86,1.0,92,2,2,1,5,0xb2d60babd
1099398.61,2.0,87,4,3,1,8,0xb2d2cbe7d
5728467.11,13.0,0,4,4,4,12,0xb2d25552d
100033.44,2.0,293,3,3,1,7,0xb2d1fc4bd
5.28,1.0,55,1,2,2,5,0xb2d9c9ae
35691.93,1.0,0,2,2,4,8,0xb2d6b8c8d
60013.78,3.0,103,3,4,1,8,0xb2d6ee2dd
40006.76,2.0,83,2,3,1,6,0xb2d14069d
217768.22,3.0,214,3,4,1,8,0xb2d1395ed
90145.24,2.0,189,3,3,1,7,0xb2d15986d
6290.62,1.0,21,2,2,2,6,0xb2d5dfc9d
9447.18,1.0,6,2,2,3,7,0xb2d40675
423092.56,8.0,3,4,4,4,12,0xb2d685e7
1410.97,2.0,184,1,3,1,5,0xb2d06b01
350007.1,2.0,1,4,3,4,11,0xb2d97923
164593.04,2.0,24,3,3,2,8,0xb2d11f8b
212185.55,3.0,27,3,4,2,9,0xb2d0c419d
250411.34,7.0,1,3,4,4,11,0xb2d21280d
1017336.83,2.0,206,4,3,1,8,0x3b9b4935
450000.0,2.0,6,4,3,3,10,0xb2d8b135d
5463.6,1.0,29,2,2,2,6,0xb2d6c851
80002.33,3.0,39,3,4,2,9,0xb2d98775
222219.29,4.0,8,3,4,3,10,0xb2d1f9ac
100011.98,2.0,231,3,3,1,7,0xb2d58159
201420.99,2.0,60,3,3,2,8,0xb2d63bf1
20009.35,2.0,18,2,3,2,7,0xb2d68e7fd
300415.72,3.0,3,4,4,4,12,0xb2d5a568d
88.48,1.0,9,1,2,3,6,0xb2d91164
138.04,1.0,23,1,2,2,5,0xb2d2e62c
15166.45,1.0,184,2,2,1,5,0xb2d2199c
3492.38,1.0,6,2,2,3,7,0xb2d3925e
16045.47,1.0,36,2,2,2,6,0xb2d4882a
133717.17,5.0,1,3,4,4,11,0xb2d29f9ad
0.0,1.0,3,1,2,4,7,0xb2d646aa
16.12,1.0,4,1,2,4,7,0xb2d54028
17305.38,1.0,9,2,2,3,7,0xb2d92366
213609.36,3.0,20,3,4,2,9,0xb2d479c2d
9210.12,1.0,45,2,2,2,6,0xb2d7ee54d
256714.96,3.0,8,3,4,3,10,0xb2d1261f
50002.53,3.0,97,2,4,1,7,0xb2d7c541d
511.76,1.0,1,1,2,4,7,0xb2d52caf
245006.68,5.0,12,3,4,3,10,0xb2d2b35ed
140005.93,5.0,27,3,4,2,9,0xb2d61802
10371604.95,15.0,0,4,4,4,12,0xb2d11472
26989.45,1.0,0,2,2,4,8,0xb2d69ec1
39679.89,1.0,200,2,2,1,5,0xb2d69a19
743.12,1.0,1,1,2,4,7,0xb2d408e1d
61055.29,2.0,92,3,3,1,7,0xb2d55e0fd
0.05,2.0,77,1,3,1,5,0xb2d950b7d
136557.61,1.0,3,3,2,4,9,0xb2d4c9d3
217941.7,4.0,39,3,4,2,9,0xb2d361a4d
452225.53,2.0,25,4,3,2,9,0xb2d93217d
18828.28,1.0,0,2,2,4,8,0xb2d787c3
600024.47,3.0,60,4,4,2,10,0xb2d20500
866063.19,9.0,22,4,4,2,10,0xb2d5f2ce
585039.99,10.0,3,4,4,4,12,0x3b9b2a49d
152974.41,4.0,0,3,4,4,11,0xb2d56aa7d
1022.82,1.0,0,1,2,4,7,0xb2d3f970
650027.44,2.0,76,4,3,1,8,0xb2d8d9d8
6548.22,1.0,11,2,2,3,7,0xb2d27c41d
400000.68,2.0,0,4,3,4,11,0xb2d3c375d
600055.27,5.0,14,4,4,3,11,0xb2d5b267
1906404.15,11.0,0,4,4,4,12,0xb2d3ea51
539.32,1.0,10,1,2,3,6,0xb2d49621
15264.37,1.0,184,2,2,1,5,0xb2d28565d
51649.96,3.0,0,2,4,4,10,0xb2d64e87
121661.32,5.0,13,3,4,3,10,0xb2d6841e
269587.72,9.0,0,3,4,4,11,0xb2d53029
4081.36,1.0,32,2,2,2,6,0xb2d41a90
940780.0,114.0,3,4,4,4,12,0x3b9af110
191921.62,3.0,1,3,4,4,11,0xb2d54a96
10000.43,2.0,54,2,3,2,7,0xb2d6c709d
1340142.56,4.0,0,4,4,4,12,0x3b9b2e33
80915.64,3.0,0,3,4,4,11,0xb2d1d895
200045.95,2.0,12,3,3,3,9,0xb2d58a91d
42000.44,2.0,21,2,3,2,7,0xb2da1fe5
5269.44,1.0,211,2,2,1,5,0xb2d40709d
400038.07,3.0,2,4,4,4,12,0xb2d8f60f
15.31,1.0,9,1,2,3,6,0xb2d8c41c
711447.25,6.0,13,4,4,3,11,0xb2d98b2d
33825.33,5.0,77,2,4,1,7,0x3b9af522d
125046.19,2.0,8,3,3,3,9,0xb2d2c7c4d
152054.16,4.0,27,3,4,2,9,0xb2d149d3
6612.84,1.0,29,2,2,2,6,0xb2d91f34
303555.41,3.0,101,4,4,1,9,0xb2d8eb5f
1003048.13,3.0,53,4,4,2,10,0xb2d57ecad
193122.15,3.0,0,3,4,4,11,0xb2d3c330d
15132468.31,3.0,18,4,4,2,10,0xb2d9572a
20026.01,1.0,0,2,2,4,8,0xb2d1c484d
130099.11,2.0,206,3,3,1,7,0xb2d4b370
124.28,1.0,21,1,2,2,5,0xb2d62c99
264.92,1.0,0,1,2,4,7,0xb2d2b5e7
570404.05,3.0,59,4,4,2,10,0xb2d200d4
150008.63,3.0,195,3,4,1,8,0xb2d28f0d
3500.62,1.0,22,2,2,2,6,0xb2d4ba10d
508028.95,3.0,7,4,4,3,11,0xb2d2620b
480000.01,3.0,20,4,4,2,10,0xb2d9978b
50488.61,4.0,53,2,4,2,8,0xb2d5c772
87767.01,1.0,9,3,2,3,8,0xb2d3cce6
193073.29,8.0,3,3,4,4,11,0xb2d5b289
25019.45,1.0,5,2,2,3,7,0xb2d3c26f
1601731.01,3.0,5,4,4,3,11,0xb2d21df5d
539016.71,3.0,59,4,4,2,10,0xb2d36b02d
50019.54,1.0,35,2,2,2,6,0xb2d5cdeb
9876.1,1.0,0,2,2,4,8,0xb2d3f545
1243438.85,4.0,14,4,4,3,11,0xb2d93174
970654.7,20.0,1,4,4,4,12,0xb2d5d3ae
315917.01,2.0,120,4,3,1,8,0xb2d57f8a
365.82,1.0,0,1,2,4,7,0xb2d93473
983.96,1.0,0,1,2,4,7,0xb2d25c79
140006.02,3.0,189,3,4,1,8,0xb2d85729d
272498.9,7.0,50,3,4,2,9,0xb2d108e4
73086.23,1.0,28,3,2,2,7,0xb2d222d2d
29933.45,1.0,18,2,2,2,6,0xb2d985de
1509714.42,16.0,14,4,4,3,11,0xb2d21fced
373101.87,10.0,4,4,4,4,12,0x3b9b18d6
217187.2,3.0,17,3,4,2,9,0xb2d6ac08d
583.63,3.0,18,1,4,2,7,0x3b9b440bd
206337.28,5.0,19,3,4,2,9,0xb2d53ad2
285345.16,2.0,75,3,3,1,7,0xb2d07a55
1097.08,1.0,184,1,2,1,4,0xb2d1fc03d
54.66,1.0,0,1,2,4,7,0xb2d9be55
151374.03,3.0,27,3,4,2,9,0xb2d563b0
376.47,1.0,17,1,2,2,5,0xb2d28d6bd
10000.32,2.0,60,2,3,2,7,0xb2d9bae5
906750.32,3.0,32,4,4,2,10,0xb2d98433
211336.43,1.0,172,3,2,1,6,0xb2d43059
804124.04,1.0,0,4,2,4,10,0xb2d238cf
200236.05,2.0,82,3,3,1,7,0xb2d5d5a3
1637.45,1.0,4,1,2,4,7,0xb2d94572
14.73,1.0,67,1,2,1,4,0xb2d5b019
15278.76,1.0,12,2,2,3,7,0xb2d783e2
31089.81,2.0,6,2,3,3,8,0xb2d614b5d
181542.87,5.0,11,3,4,3,10,0xb2d4dc08
585866.14,6.0,5,4,4,3,11,0xb2d5eb8cd
80091.1,3.0,73,3,4,1,8,0xb2d5d0f8
5648.93,1.0,110,2,2,1,5,0xb2d36b8fd
470045.15,4.0,6,4,4,3,11,0xb2d1ea24
807936.12,4.0,19,4,4,2,10,0xb2d94d0f
5733.97,1.0,18,2,2,2,6,0xb2d8c711
2022.8,3.0,228,1,4,1,6,0xb2d53193d
2862.1,10.0,0,1,4,4,9,0xb2d18680
22828.4,1.0,0,2,2,4,8,0xb2d564b9
180005.51,3.0,70,3,4,1,8,0xb2d6db52
943706.12,3.0,21,4,4,2,10,0xb2d4ec87
53002.28,2.0,26,3,3,2,8,0xb2d24ffed
40552.98,1.0,177,2,2,1,5,0xb2d86fbdd
313870.95,6.0,3,4,4,4,12,0xb2d1f9b2d
7540.18,1.0,7,2,2,3,7,0xb2d6fdca
272831.85,4.0,0,3,4,4,11,0xb2d410a8d
500000.0,5.0,0,4,4,4,12,0xb2d65560
171.81,1.0,36,1,2,2,5,0xb2d20741d
2265.74,1.0,4,1,2,4,7,0xb2d28dd4
6771.68,1.0,5,2,2,3,7,0xb2d9107ad
100.27,3.0,33,1,4,2,7,0xb2d9204d
122013.98,3.0,0,3,4,4,11,0xb2d33512d
40581.42,1.0,21,2,2,2,6,0xb2d5f8af
512027.5,14.0,4,4,4,4,12,0xb2d62483d
3000.86,1.0,36,2,2,2,6,0xb2d2b929d
99014.99,3.0,0,3,4,4,11,0xb2d33048d
60358.22,3.0,0,3,4,4,11,0xb2d402f9d
510364.08,2.0,19,4,3,2,9,0xb2d23586
2832.61,2.0,92,1,3,1,5,0xb2d1a0a8
60171.19,3.0,0,3,4,4,11,0xb2d6d09f
1480.87,1.0,5,1,2,3,6,0xb2d783c0
7102.97,1.0,2,2,2,4,8,0xb2d92134
588747.5,7.0,25,4,4,2,10,0xb2d3a855d
13446.54,1.0,92,2,2,1,5,0xb2d16f78
2126369.32,19.0,4,4,4,4,12,0xb2d58a75d
201617.57,2.0,182,3,3,1,7,0xb2d60923d
200710.49,2.0,50,3,3,2,8,0xb2d9d689
60002.32,4.0,47,3,4,2,9,0xb2d67095
562483.85,2.0,80,4,3,1,8,0xb2d1a94fd
0.0,1.0,8,1,2,3,6,0xb2d5926bd
257011.27,2.0,68,3,3,1,7,0xb2d225bf
6591.22,1.0,127,2,2,1,5,0xb2d33f45d
90091.54,2.0,87,3,3,1,7,0xb2d55c19d
400000.0,2.0,14,4,3,3,10,0xb2d9d258
30038.81,2.0,221,2,3,1,6,0xb2d695fad
675.51,1.0,0,1,2,4,7,0xb2d21b93
333917.97,2.0,0,4,3,4,11,0xb2d5733e
252.86,1.0,2,1,2,4,7,0xb2d91aa8
100065.34,2.0,104,3,3,1,7,0xb2d577f9
200552.84,5.0,83,3,4,1,8,0xb2d7f421d
366101.17,2.0,18,4,3,2,9,0xb2d57b8bd
422.48,1.0,5,1,2,3,6,0xb2d2d41d
231723.05,2.0,56,3,3,2,8,0xb2d659afd
109633.93,2.0,17,3,3,2,8,0xb2d28d15
11348.08,1.0,18,2,2,2,6,0xb2d5fd1fd
450019.04,2.0,92,4,3,1,8,0xb2d65dbb
56437.21,1.0,15,3,2,3,8,0xb2d319b5
780031.74,3.0,49,4,4,2,10,0xb2d90377
284004.75,3.0,158,3,4,1,8,0xb2d5a765
336115.08,3.0,8,4,4,3,11,0xb2d24054
22938.13,2.0,7,2,3,3,8,0xb2d1a2b8
9797.92,5.0,92,2,4,1,7,0x3b9b1369
50000.53,3.0,11,2,4,3,9,0xb2d19882
14.78,1.0,39,1,2,2,5,0xb2d9dde8
4302.99,1.0,0,2,2,4,8,0xb2d912ae
52513.88,2.0,116,3,3,1,7,0xb2d3cc72
6057.15,1.0,95,2,2,1,5,0xb2d22ab7
82803.63,2.0,143,3,3,1,7,0xb2d40d88d
400000.0,2.0,3,4,3,4,11,0xb2d97643
40465.52,2.0,32,2,3,2,7,0xb2d2d629d
86636.55,1.0,6,3,2,3,8,0xb2d2f8dd
191742.13,4.0,111,3,4,1,8,0xb2d07855d
25.61,3.0,2,1,4,4,9,0xb2d1cd47
3985.01,1.0,92,2,2,1,5,0xb2d1671f
162.4,1.0,21,1,2,2,5,0xb2d27ad6
7651.49,1.0,184,2,2,1,5,0xb2d3d702
2374078.84,48.0,1,4,4,4,12,0xb2d100ef
194535.06,2.0,0,3,3,4,10,0xb2d6b843
397336.18,7.0,0,4,4,4,12,0xb2d0af3b
617.72,1.0,13,1,2,3,6,0xb2d99185
50958.15,1.0,0,2,2,4,8,0xb2d698ee
200041.81,3.0,179,3,4,1,8,0xb2d0d28a
307573.96,2.0,9,4,3,3,10,0xb2d695a0d
90.74,2.0,18,1,3,2,6,0x3b9b49ae
500336.09,4.0,13,4,4,3,11,0xb2d57a06
2945456.99,8.0,4,4,4,4,12,0xb2d5f4d0
2448.33,1.0,10,1,2,3,6,0xb2d2c833
24580.06,1.0,213,2,2,1,5,0xb2d2e96a
117388.85,1.0,123,3,2,1,6,0xb2d618ac
706123.66,4.0,3,4,4,4,12,0xb2d391bcd
50002.11,2.0,195,2,3,1,6,0xb2d69ce4
50050.76,3.0,80,2,4,1,7,0xb2d25eb2
163185.84,4.0,69,3,4,1,8,0xb2d5695cd
523.81,1.0,6,1,2,3,6,0xb2d0eac4d
244.93,1.0,8,1,2,3,6,0xb2d51a6d
352147.26,4.0,76,4,4,1,9,0xb2d31e2f
250230.56,3.0,10,3,4,3,10,0xb2d697b8d
20303.69,1.0,141,2,2,1,5,0xb2d65a85d
70346.09,2.0,83,3,3,1,7,0xb2d11b0c
200000.27,2.0,15,3,3,3,9,0xb2d61b28
180016.83,3.0,102,3,4,1,8,0xb2d100a3d
58585.25,3.0,0,3,4,4,11,0xb2d07a77
223927.78,1.0,0,3,2,4,9,0xb2d67f98
500019.03,3.0,4,4,4,4,12,0xb2d87fe5
1995.45,1.0,3,1,2,4,7,0xb2d6c12b
11.23,1.0,24,1,2,2,5,0xb2d68606
1069.8,1.0,10,1,2,3,6,0xb2d43523
22220.6,1.0,14,2,2,3,7,0xb2d6acbb
1378.51,1.0,5,1,2,3,6,0xb2d23196d
225021.61,2.0,123,3,3,1,7,0xb2d605afd
2627.14,1.0,39,1,2,2,5,0xb2d98ed1
1401.4,1.0,10,1,2,3,6,0xb2d68bfe
71.22,1.0,23,1,2,2,5,0xb2d3af75
406103.51,8.0,53,4,4,2,10,0xb2d249fe
396007.63,18.0,0,4,4,4,12,0xb2d4faa4d
2749.13,1.0,92,1,2,1,4,0xb2d31843d
304544.91,6.0,60,4,4,2,10,0xb2d7f3bad
180030.03,3.0,116,3,4,1,8,0xb2d0873f
257400.26,1.0,6,3,2,3,8,0xb2d40885
1100060.36,4.0,62,4,4,2,10,0xb2d0dbcdd
1008.17,2.0,0,1,3,4,8,0xb2d102e7
1043947.91,1.0,1,4,2,4,10,0xb2d64c5d
1951051.9,6.0,27,4,4,2,10,0xb2d2b3dcd
2926.14,1.0,0,2,2,4,8,0xb2d2d3b9
50355.76,3.0,108,2,4,1,7,0x3b9b3aab
24823.68,1.0,21,2,2,2,6,0xb2d2755ed
1082.59,1.0,168,1,2,1,4,0xb2d5db93
10000.21,2.0,80,2,3,1,6,0xb2d98e3c
26.5,1.0,0,1,2,4,7,0xb2d30cfe
440001.48,5.0,6,4,4,3,11,0xb2d07db5
164765.64,2.0,196,3,3,1,7,0xb2d5b9dcd
120000.0,3.0,3,3,4,4,11,0xb2d61b9c
304826.52,4.0,17,4,4,2,10,0xb2d5ea13d
102052.06,2.0,18,3,3,2,8,0xb2d3ea86
430001.06,2.0,19,4,3,2,9,0xb2da2a13
50385.52,2.0,60,2,3,2,7,0xb2d5fb6ed
728421.74,5.0,0,4,4,4,12,0xb2d4ea01
84.4,1.0,0,1,2,4,7,0xb2d8a2ec
47124.93,2.0,27,2,3,2,7,0xb2d54b25d
14943.42,1.0,0,2,2,4,8,0xb2d24a27
40413.32,1.0,5,2,2,3,7,0xb2d1ae49
249005.79,3.0,13,3,4,3,10,0xb2d59de6
501782.23,2.0,53,4,3,2,9,0xb2d6b3df
5011206.0,7.0,6,4,4,3,11,0xb2d65a19
10058.46,2.0,18,2,3,2,7,0xb2d0c86e
10000.53,1.0,14,2,2,3,7,0xb2d8c7da
64373.08,3.0,4,3,4,4,11,0xb2d6216ad
742.5,1.0,10,1,2,3,6,0xb2d492e9
257196.18,2.0,58,3,3,2,8,0xb2d6b8bad
53.58,1.0,67,1,2,1,4,0xb2d3afd3d
203021.75,3.0,83,3,4,1,8,0xb2d6287bd
2815834.06,9.0,46,4,4,2,10,0xb2d2eebb
220002.4,2.0,34,3,3,2,8,0xb2d52b28
29006.46,3.0,6,2,4,3,9,0xb2d60766d
1.88,1.0,14,1,2,3,6,0xb2d31b87
6.29,1.0,30,1,2,2,5,0xb2d8e7e0d
107.51,1.0,4,1,2,4,7,0xb2d43675d
2501.11,1.0,10,1,2,3,6,0xb2d790f0
6356.6,1.0,20,2,2,2,6,0xb2d247c0d
500000.0,2.0,27,4,3,2,9,0xb2d9059f
17.2,1.0,17,1,2,2,5,0xb2d37c54
655010.08,4.0,31,4,4,2,10,0xb2d7013f
819624.28,7.0,17,4,4,2,10,0xb2d10999
513030.36,2.0,74,4,3,1,8,0xb2d3ab8bd
187293.38,3.0,24,3,4,2,9,0xb2d40f07
9427.04,1.0,151,2,2,1,5,0xb2d30a12
120.85,1.0,9,1,2,3,6,0xb2d344c8d
0.43,6.0,0,1,4,4,9,0xb2d4ec33d
62243.47,2.0,0,3,3,4,10,0xb2d212ff
51.28,1.0,20,1,2,2,5,0xb2d2fd85
1290.7,1.0,92,1,2,1,4,0xb2d13514
354602.78,3.0,111,4,4,1,9,0xb2d4cf2cd
200161.23,2.0,63,3,3,2,8,0xb2d25dd9
150044.76,3.0,3,3,4,4,11,0xb2d12149d
790039.43,5.0,1,4,4,4,12,0x3b9b3924d
591.18,1.0,10,1,2,3,6,0xb2d44532
873457.31,8.0,4,4,4,4,12,0xb2d5067e
50309.88,2.0,10,2,3,3,8,0xb2d1d895d
1355.76,1.0,13,1,2,3,6,0xb2d2f0c1
871532.93,4.0,74,4,4,1,9,0xb2d16d58d
110000.24,2.0,1,3,3,4,10,0xb2d0c2acd
79632.04,8.0,8,3,4,3,10,0xb2d68698d
3139.92,1.0,189,2,2,1,5,0xb2d6d8ccd
4375.12,1.0,9,2,2,3,7,0xb2d1cce9d
67.61,1.0,8,1,2,3,6,0xb2d8cb9c
4203000.0,7.0,8,4,4,3,11,0xb2d1c41ed
63638.08,3.0,0,3,4,4,11,0xb2d9b7f9
2182.43,1.0,92,1,2,1,4,0xb2d1763a
582121.63,5.0,69,4,4,1,9,0xb2d0ebb1
437.0,1.0,1,1,2,4,7,0xb2d94b82
30804.52,3.0,0,2,4,4,10,0xb2d0687b
1985050.95,5.0,7,4,4,3,11,0xb2d1c743
204017.82,6.0,62,3,4,2,9,0xb2d3654a
531.45,1.0,14,1,2,3,6,0xb2d23070
1.32,1.0,57,1,2,2,5,0xb2d14d3bd
958126.56,3.0,4,4,4,4,12,0xb2d34bba
1038005.85,9.0,69,4,4,1,9,0xb2d0bf30
300082.43,4.0,28,3,4,2,9,0xb2d64ae2
5020.12,1.0,184,2,2,1,5,0xb2d598b9d
81281.05,2.0,136,3,3,1,7,0xb2d63bc3
54.13,1.0,26,1,2,2,5,0xb2d6deee
308391.46,4.0,80,4,4,1,9,0xb2d4439bd
220313.7,6.0,73,3,4,1,8,0xb2d3c0d5d
10045.01,1.0,184,2,2,1,5,0xb2d5b610
200000.0,2.0,21,3,3,2,8,0xb2da2594
2413.61,1.0,184,1,2,1,4,0xb2d3223cd
11831.58,1.0,9,2,2,3,7,0xb2d698c4
288958.39,7.0,77,3,4,1,8,0xb2d06a3dd
5486.52,1.0,36,2,2,2,6,0xb2d6a6c1
10298.68,2.0,13,2,3,3,8,0xb2d9f718
1082.2,1.0,0,1,2,4,7,0xb2d5fd4e
1453713.94,5.0,0,4,4,4,12,0xb2d162c6
120018.99,2.0,19,3,3,2,8,0xb2d8d9df
52923.51,3.0,6,3,4,3,10,0xb2d152dcd
644.29,1.0,32,1,2,2,5,0xb2d412a3
1548.61,1.0,92,1,2,1,4,0xb2d1098fd
0.0,1.0,7,1,2,3,6,0xb2d4acb8
0.0,1.0,0,1,2,4,7,0xb2d56156
275404.01,3.0,119,3,4,1,8,0xb2d910be
9291.82,1.0,5,2,2,3,7,0xb2d472b3d
37814.65,1.0,8,2,2,3,7,0xb2d6809e
22.22,1.0,7,1,2,3,6,0xb2d6947a
32138.53,1.0,0,2,2,4,8,0xb2d284ad
5573089.72,7.0,1,4,4,4,12,0xb2d67cd5
211597.52,2.0,106,3,3,1,7,0xb2d29180
33.78,1.0,46,1,2,2,5,0xb2d50f88
1102.45,1.0,138,1,2,1,4,0xb2d29eccd
10000.74,2.0,31,2,3,2,7,0xb2d910c6
160014.43,2.0,214,3,3,1,7,0xb2d24e8bd
100544.98,1.0,184,3,2,1,6,0xb2d0dd26d
396000.0,4.0,3,4,4,4,12,0xb2d11eacd
418.19,1.0,13,1,2,3,6,0xb2d0a4f6d
164850.51,7.0,47,3,4,2,9,0xb2d441da
1377.71,1.0,109,1,2,1,4,0xb2d68f9a
90858.75,1.0,0,3,2,4,9,0xb2d62e40d
31.25,12.0,13,1,4,3,8,0xb2d6c745
20063.48,1.0,288,2,2,1,5,0xb2d52ee7d
201660.8,2.0,240,3,3,1,7,0xb2d1a5dc
10970.33,1.0,8,2,2,3,7,0xb2d6f225
32.67,1.0,80,1,2,1,4,0xb2d65d67d
103000.0,4.0,4,3,4,4,11,0xb2d201fdd
520044.45,3.0,102,4,4,1,9,0xb2d0a03a
15450.56,1.0,9,2,2,3,7,0xb2d2edbed
600.0,1.0,0,1,2,4,7,0xb2d86703
3881.45,1.0,124,2,2,1,5,0xb2d22d4a
16049.43,2.0,92,2,3,1,6,0xb2d0dc2ad
21550.85,1.0,19,2,2,2,6,0xb2d6af76d
103230.39,2.0,11,3,3,3,9,0xb2d6a2fad
445325.42,2.0,53,4,3,2,9,0xb2d5e99c
336.41,1.0,112,1,2,1,4,0xb2d1b1d8d
680012.38,3.0,13,4,4,3,11,0xb2d2895b
69.98,1.0,81,1,2,1,4,0xb2d938c1
2832.45,1.0,92,1,2,1,4,0xb2d2a3f5
517510.18,3.0,129,4,4,1,9,0xb2d6e5cb
500008.79,3.0,9,4,4,3,11,0xb2d6c6b8
1715250.05,8.0,20,4,4,2,10,0xb2d2b34fd
21915.52,1.0,1,2,2,4,8,0xb2d2b614
200710.73,2.0,27,3,3,2,8,0xb2d641a1d
4037.5,1.0,135,2,2,1,5,0xb2d6e3e3d
253678.4,2.0,0,3,3,4,10,0xb2d0f4b4d
31131.32,7.0,1,2,4,4,10,0x3b9af126d
461410.95,11.0,0,4,4,4,12,0xb2d580ee
882415.19,5.0,6,4,4,3,11,0xb2d57cb8d
50078.21,2.0,25,2,3,2,7,0xb2d5b592
154681.37,7.0,3,3,4,4,11,0xb2d597ce
5314.49,1.0,10,2,2,3,7,0xb2d23616
1003215.85,3.0,18,4,4,2,10,0xb2d33529d
51004.78,2.0,92,2,3,1,6,0xb2d62e4a
702516.85,3.0,42,4,4,2,10,0xb2d10a17
710.71,1.0,75,1,2,1,4,0xb2d30e62
150.32,5.0,47,1,4,2,7,0xb2d08680d
10895.37,1.0,0,2,2,4,8,0xb2d86fea
4392.18,1.0,4,2,2,4,8,0xb2d5f37ad
10187.46,2.0,245,2,3,1,6,0xb2d5bcec
600021.77,4.0,1,4,4,4,12,0xb2d6919fd
840000.0,24.0,0,4,4,4,12,0xb2d38386
2016.42,1.0,70,1,2,1,4,0xb2d5ea6f
6901.73,1.0,32,2,2,2,6,0xb2d21f01d
607.25,1.0,22,1,2,2,5,0xb2d6b536
1011.53,1.0,92,1,2,1,4,0xb2d122c6d
58347.79,1.0,4,3,2,4,9,0xb2d2ebd0d
1049.31,1.0,92,1,2,1,4,0xb2d39724
50916.56,1.0,0,2,2,4,8,0xb2da1664
0.08,1.0,3,1,2,4,7,0xb2d5614a
73551.48,1.0,0,3,2,4,9,0xb2d27195d
500000.0,3.0,4,4,4,4,12,0xb2da37b7
24601.04,1.0,1,2,2,4,8,0xb2d2b8d2
740746.57,5.0,27,4,4,2,10,0xb2d41164
2817.51,1.0,92,1,2,1,4,0xb2d4e15fd
290072.53,7.0,6,3,4,3,10,0xb2d3176bd
369096.57,7.0,69,4,4,1,9,0x3b9b405ad
240050.02,5.0,3,3,4,4,11,0xb2d8d6afd
2099.19,1.0,184,1,2,1,4,0xb2d21a2fd
27414.84,1.0,11,2,2,3,7,0xb2d6a580
2086.29,1.0,10,1,2,3,6,0xb2d8d372
1071.31,1.0,9,1,2,3,6,0xb2d4784a
51516.02,1.0,92,2,2,1,5,0xb2d10cae
3616.34,1.0,1,2,2,4,8,0xb2d4c834
16391.9,1.0,14,2,2,3,7,0xb2d6123fd
201.18,1.0,6,1,2,3,6,0xb2d08d2b
893009.43,19.0,0,4,4,4,12,0xb2d10cf0
0.94,1.0,4,1,2,4,7,0xb2d63524
40227.03,5.0,0,2,4,4,10,0xb2d0a315
200503.91,1.0,215,3,2,1,6,0xb2d4ecbbd
560623.94,7.0,0,4,4,4,12,0xb2d5dc60
209743.85,2.0,20,3,3,2,8,0xb2d67e8bd
980032.25,11.0,11,4,4,3,11,0xb2d0b5a1
2130285.84,2.0,101,4,3,1,8,0xb2d2ffa9
5081.85,1.0,0,2,2,4,8,0xb2d55fd0d
14.38,1.0,72,1,2,1,4,0xb2d940c0
352.02,1.0,17,1,2,2,5,0xb2d37c23
4018.93,1.0,16,2,2,2,6,0xb2d2c43b
200010.56,2.0,83,3,3,1,7,0xb2d0dbbc
1474244.51,4.0,0,4,4,4,12,0xb2d355ed
172196.05,1.0,141,3,2,1,6,0xb2d56a36
300001.26,2.0,12,3,3,3,9,0xb2d8e538
80659.37,4.0,0,3,4,4,11,0xb2d0afa5
8.85,1.0,41,1,2,2,5,0xb2d8f64dd
345113.89,4.0,1,4,4,4,12,0xb2d0a876d
300098.61,3.0,6,3,4,3,10,0xb2d5b98ad
515.11,1.0,9,1,2,3,6,0xb2d48196d
2301.0,1.0,16,1,2,2,5,0xb2d92525
25000.53,2.0,228,2,3,1,6,0xb2d6f501
32179.74,1.0,141,2,2,1,5,0xb2d56ffad
1828823.85,11.0,0,4,4,4,12,0xb2d16d03d
226518.65,3.0,0,3,4,4,11,0xb2d2a4f4d
992374.44,3.0,0,4,4,4,12,0xb2d068f8
24190.71,2.0,125,2,3,1,6,0xb2d6a01ad
32138.58,1.0,66,2,2,2,6,0xb2d57dce
1323.07,1.0,10,1,2,3,6,0xb2d69efed
3070.44,1.0,20,2,2,2,6,0xb2d8dbd5d
269.98,1.0,1,1,2,4,7,0xb2d30a70d
161670.13,4.0,10,3,4,3,10,0xb2d0ba18
100665.97,2.0,103,3,3,1,7,0xb2d34fa1d
401420.94,3.0,47,4,4,2,10,0xb2d9e253
20000.19,2.0,4,2,3,4,9,0xb2d5eb28
3881.11,1.0,52,2,2,2,6,0xb2d1d03ad
427.4,1.0,3,1,2,4,7,0xb2d6a6c0
685366.28,6.0,5,4,4,3,11,0xb2d22bc5
1364.68,1.0,1,1,2,4,7,0xb2d39096d
81480.28,2.0,0,3,3,4,10,0xb2d5b989d
1350000.0,19.0,4,4,4,4,12,0xb2d5923cd
1391.15,1.0,1,1,2,4,7,0xb2d5ce48
4008.89,1.0,2,2,2,4,8,0xb2d4d88f
700090.27,5.0,18,4,4,2,10,0xb2d37657d
47.5,1.0,67,1,2,1,4,0xb2d98fbf
159.24,1.0,9,1,2,3,6,0xb2d2ccfc
1290000.0,16.0,2,4,4,4,12,0xb2d2b184
243881.75,8.0,60,3,4,2,9,0xb2d1edae
2018.89,1.0,184,1,2,1,4,0xb2d2fdc7d
304.24,1.0,76,1,2,1,4,0xb2d37caad
140.86,2.0,21,1,3,2,6,0xb2d46354d
7953.45,3.0,0,2,4,4,10,0x3b9b2bae
15771.32,1.0,3,2,2,4,8,0xb2d9892e
1.87,1.0,10,1,2,3,6,0xb2d6ba73
1868.51,1.0,184,1,2,1,4,0x3b9b2303d
1340785.21,9.0,10,4,4,3,11,0xb2d08609
13450.99,1.0,9,2,2,3,7,0xb2d508e4
200076.46,2.0,8,3,3,3,9,0xb2d4907ed
275760.31,3.0,13,3,4,3,10,0xb2d9f217
500000.17,4.0,6,4,4,3,11,0xb2d68dbf
10020.17,1.0,29,2,2,2,6,0xb2d208ef
9134.4,2.0,33,2,3,2,7,0xb2d0a312
10.63,1.0,86,1,2,1,4,0xb2d12e11
620012.85,8.0,116,4,4,1,9,0xb2d0d04a
24001.54,3.0,42,2,4,2,8,0xb2d27080
768.39,1.0,10,1,2,3,6,0xb2d509a5
12604.8,1.0,16,2,2,2,6,0xb2d9186a
300016.11,4.0,18,3,4,2,9,0xb2d5eb37
39992.6,1.0,0,2,2,4,8,0xb2d503c7d
506.97,1.0,16,1,2,2,5,0xb2d242c6d
25.38,1.0,60,1,2,2,5,0xb2d2e4f5
438386.05,2.0,10,4,3,3,10,0xb2d276d2d
1503.92,1.0,1,1,2,4,7,0xb2d704ec
210.9,1.0,35,1,2,2,5,0xb2d8f6b8
109206.32,2.0,3,3,3,4,10,0xb2d3627cd
8395.46,1.0,21,2,2,2,6,0xb2d2c99ed
382087.08,1.0,27,4,2,2,8,0xb2d85c39
4.28,1.0,64,1,2,2,5,0xb2d8d2e9
186013.76,4.0,101,3,4,1,8,0xb2d6f7d9
1010118.07,6.0,20,4,4,2,10,0xb2d41bb8
29381.51,1.0,24,2,2,2,6,0xb2d2377d
1252.68,1.0,10,1,2,3,6,0xb2d6abb1
200000.0,2.0,0,3,3,4,10,0xb2da6b6b
1182.78,1.0,24,1,2,2,5,0xb2d2d6a7
50077.28,2.0,200,2,3,1,6,0xb2d5ba40
211664.96,2.0,111,3,3,1,7,0xb2d16891d
2.97,1.0,14,1,2,3,6,0xb2d6e265
6145.16,1.0,6,2,2,3,7,0xb2d5af35
200286.95,2.0,18,3,3,2,8,0xb2d5a2ca
410891.92,6.0,0,4,4,4,12,0xb2d12be5
4935.21,1.0,92,2,2,1,5,0xb2d1bed6d
24058.54,1.0,11,2,2,3,7,0xb2da3c1c
41007.79,1.0,27,2,2,2,6,0xb2d8f95c
31166.11,1.0,12,2,2,3,7,0xb2d317c1d
1014219.23,7.0,1,4,4,4,12,0xb2d0c54cd
200005.28,4.0,11,3,4,3,10,0xb2d56f81
871.16,1.0,9,1,2,3,6,0xb2d292f6
2283508.06,16.0,1,4,4,4,12,0xb2d2caa4d
2001.22,1.0,20,1,2,2,5,0xb2d6ddefd
282851.62,2.0,2,3,3,4,10,0xb2d0f4c6d
7010.02,1.0,11,2,2,3,7,0xb2d6bd73
230002.43,2.0,13,3,3,3,9,0xb2d95d89d
179518.66,1.0,0,3,2,4,9,0xb2d1b317d
10188.62,2.0,136,2,3,1,6,0xb2d614f4d
300062.35,6.0,53,3,4,2,9,0xb2d0d7b0d
693673.6,5.0,4,4,4,4,12,0xb2d0d8fa
775632.24,3.0,18,4,4,2,10,0xb2d3e614d
340109.05,4.0,28,4,4,2,10,0xb2d3a82ed
20000.21,4.0,92,2,4,1,7,0xb2d27c74
5340.77,1.0,9,2,2,3,7,0xb2d2f24f
403071.22,5.0,1,4,4,4,12,0xb2d98615
25.99,1.0,14,1,2,3,6,0xb2d10b19
5620026.57,4.0,83,4,4,1,9,0xb2d1d310d
3034082.18,11.0,3,4,4,4,12,0xb2d15720d
132861.54,2.0,0,3,3,4,10,0xb2d5ae8c
1.63,1.0,55,1,2,2,5,0xb2d81f3e
32121.93,2.0,14,2,3,3,8,0x3b9b2b77
273.08,1.0,5,1,2,3,6,0xb2d95a66
604.83,1.0,92,1,2,1,4,0xb2d29f92d
745161.28,3.0,11,4,4,3,11,0xb2d345b3
93225.56,5.0,0,3,4,4,11,0xb2d651b2d
19.63,1.0,18,1,2,2,5,0xb2d355e3d
2547.63,1.0,184,1,2,1,4,0xb2d54012
140022.94,2.0,102,3,3,1,7,0xb2d40cf4d
119284.22,2.0,8,3,3,3,9,0xb2d240e6d
40058.71,2.0,153,2,3,1,6,0xb2d61e77
56328.22,2.0,118,3,3,1,7,0xb2d3b5f8d
270020.87,7.0,13,3,4,3,10,0xb2d43069
544000.0,14.0,0,4,4,4,12,0xb2d0c993
100436.19,1.0,178,3,2,1,6,0xb2d4ce1c
358.33,1.0,2,1,2,4,7,0xb2d62b69d
220000.0,2.0,1,3,3,4,10,0xb2d4f1d2d
488454.84,3.0,5,4,4,3,11,0xb2d135a1d
30012.39,2.0,18,2,3,2,7,0xb2d60cc4d
1090.38,1.0,56,1,2,2,5,0xb2d3e94d
3548.24,1.0,3,2,2,4,8,0xb2d35d02
15348.59,1.0,56,2,2,2,6,0xb2d604c0
1989949.32,4.0,2,4,4,4,12,0xb2d6c22cd
380.64,1.0,20,1,2,2,5,0xb2d62dd7d
200027.94,2.0,12,3,3,3,9,0xb2d3e641d
240029.39,6.0,13,3,4,3,10,0xb2d62bf5d
685020.29,5.0,101,4,4,1,9,0xb2d57aa2d
15005.57,1.0,1,2,2,4,8,0xb2d8eb74
35510.64,4.0,7,2,4,3,9,0xb2d3e99c
57000.04,2.0,2,3,3,4,10,0xb2d2679f
933.32,1.0,18,1,2,2,5,0xb2d1cef6
9736.17,1.0,0,2,2,4,8,0xb2d6a7b7d
30861.65,2.0,20,2,3,2,7,0xb2d2a298d
293569.78,11.0,0,3,4,4,11,0xb2d65b58
10433.72,2.0,25,2,3,2,7,0xb2d638d6d
30371.01,1.0,119,2,2,1,5,0xb2d7176dd
10267.12,2.0,0,2,3,4,9,0xb2da2573
190003.07,2.0,80,3,3,1,7,0xb2d98c86
10100.84,1.0,92,2,2,1,5,0xb2d0ebafd
2500000.0,3.0,5,4,4,3,11,0xb2d9faf2
644350.3,3.0,83,4,4,1,9,0xb2d16c32
130146.22,2.0,4,3,3,4,10,0xb2d2af64d
470013.38,3.0,92,4,4,1,9,0xb2d52b45
100166.07,2.0,1,3,3,4,10,0xb2da4adc
210950.09,1.0,64,3,2,2,7,0xb2d5ae08d
900018.0,3.0,17,4,4,2,10,0xb2da14ad
171050.58,2.0,74,3,3,1,7,0xb2d17344d
18152.65,1.0,6,2,2,3,7,0xb2d61ee9
4616.34,6.0,0,2,4,4,10,0x3b9af3a2d
611.46,1.0,0,1,2,4,7,0xb2d48e5dd
1857.97,1.0,33,1,2,2,5,0xb2d1fdb1
6740.61,1.0,9,2,2,3,7,0xb2d6b84f
2611.48,1.0,2,1,2,4,7,0xb2d8ebd5d
100011.87,3.0,83,3,4,1,8,0xb2d44c99d
39.52,1.0,24,1,2,2,5,0xb2d21856d
253.82,1.0,0,1,2,4,7,0xb2da020d
110013.08,4.0,92,3,4,1,8,0xb2d5c62cd
360010.22,2.0,0,4,3,4,11,0xb2d69f9a
75076.95,1.0,3,3,2,4,9,0xb2d6a703
2080840.87,6.0,24,4,4,2,10,0xb2d64211
16304.47,1.0,0,2,2,4,8,0xb2d64338
0.0,1.0,2,1,2,4,7,0xb2d34313
19023.89,4.0,0,2,4,4,10,0x3b9af146
158.33,1.0,13,1,2,3,6,0xb2d93240
11139.63,1.0,0,2,2,4,8,0xb2d68f05d
50002.64,2.0,48,2,3,2,7,0xb2d90e9ad
934314.84,5.0,7,4,4,3,11,0xb2d0880ad
1377.78,1.0,184,1,2,1,4,0xb2d2401ed
1451.92,1.0,4,1,2,4,7,0xb2d2ce69
3013.58,1.0,184,2,2,1,5,0xb2d1e3d4d
1670.38,11.0,92,1,4,1,6,0xb2d085fd
300009.51,2.0,102,3,3,1,7,0xb2d95fde
66795.32,1.0,49,3,2,2,7,0xb2d37cf2
556059.11,2.0,74,4,3,1,8,0xb2d56b26
61318.63,2.0,22,3,3,2,8,0xb2d68b40d
9200.86,1.0,2,2,2,4,8,0xb2d252d0
0.0,1.0,2,1,2,4,7,0xb2d161c5d
82899.61,2.0,124,3,3,1,7,0xb2d5514a
60000.0,2.0,6,3,3,3,9,0xb2da5289
81765.11,2.0,14,3,3,3,9,0xb2d5e676d
201.44,1.0,13,1,2,3,6,0xb2d69d0a
996.55,1.0,22,1,2,2,5,0xb2d2bb13
0.0,1.0,2,1,2,4,7,0xb2d6b400d
102038.1,1.0,105,3,2,1,6,0xb2d61cfcd
20326.05,2.0,98,2,3,1,6,0xb2d5e965d
47342.45,1.0,99,2,2,1,5,0xb2d20493d
64.11,1.0,3,1,2,4,7,0xb2d5d769
2970.75,3.0,0,2,4,4,10,0xb2d06557
8801.78,1.0,29,2,2,2,6,0xb2d46b49
10044.39,1.0,4,2,2,4,8,0xb2d3481bd
2180.98,1.0,184,1,2,1,4,0xb2d23a69d
90047.46,4.0,47,3,4,2,9,0xb2d11f28d
326180.75,4.0,0,4,4,4,12,0xb2d5cb77
932714.95,3.0,36,4,4,2,10,0xb2d5543e
649.83,1.0,9,1,2,3,6,0xb2d34435d
228768.23,3.0,103,3,4,1,8,0xb2d4c934
820020.25,3.0,20,4,4,2,10,0xb2d5b7c5
143000.0,3.0,0,3,4,4,11,0xb2d36322
10016.58,1.0,167,2,2,1,5,0xb2d8c3e3d
366.31,1.0,13,1,2,3,6,0xb2d5cc55
600014.58,4.0,18,4,4,2,10,0xb2d10c36
3370.37,1.0,9,2,2,3,7,0xb2d6bd26d
6288.94,1.0,9,2,2,3,7,0xb2d57dddd
281042.88,4.0,63,3,4,2,9,0xb2d598b6
3056.85,1.0,6,2,2,3,7,0xb2d23376
151817.86,3.0,3,3,4,4,11,0xb2d1e5cbd
258862.25,5.0,5,3,4,3,10,0xb2d07ff8d
8917000.0,3.0,6,4,4,3,11,0xb2d50a92d
630000.0,4.0,3,4,4,4,12,0xb2d93717d
115070.57,3.0,3,3,4,4,11,0xb2d4f344
200002.11,2.0,10,3,3,3,9,0xb2d26df8
2530994.73,4.0,3,4,4,4,12,0xb2d4bce6
400000.0,2.0,21,4,3,2,9,0xb2d951eb
401893.46,4.0,0,4,4,4,12,0xb2d687cdd
575001.74,8.0,18,4,4,2,10,0x3b9af1a7
1501.32,1.0,16,1,2,2,5,0xb2d8c5fdd
800563.48,1.0,3,4,2,4,10,0xb2d5dc4e
900244.37,1.0,2,4,2,4,10,0xb2d904fa
175.17,1.0,9,1,2,3,6,0xb2d3aecb
270004.96,4.0,59,3,4,2,9,0xb2d8d73fd
5.0,2.0,15,1,3,3,7,0xb2d9e3e7
65889.62,1.0,0,3,2,4,9,0xb2d30034
6.33,1.0,16,1,2,2,5,0xb2d353d5
35.61,3.0,53,1,4,2,7,0xb2d20dfb
148.33,1.0,3,1,2,4,7,0xb2d8c696
1.68,1.0,80,1,2,1,4,0xb2d8255c
165.26,1.0,52,1,2,2,5,0xb2d6d33d
190029.47,3.0,21,3,4,2,9,0xb2d36df4
1110007.97,9.0,0,4,4,4,12,0xb2d5c6ea
59.17,1.0,14,1,2,3,6,0xb2d6ad33
166060.39,3.0,6,3,4,3,10,0xb2d2b470d
105022.72,6.0,0,3,4,4,11,0xb2d0ab05
1624.68,1.0,3,1,2,4,7,0xb2d99f4f
433728.92,3.0,17,4,4,2,10,0xb2d23dc8
212131.45,2.0,92,3,3,1,7,0xb2d3c0c8d
200031.07,3.0,7,3,4,3,10,0xb2d4862cd
3.47,1.0,25,1,2,2,5,0xb2d30db8d
598397.33,12.0,0,4,4,4,12,0x3b9b461a
539872.78,3.0,83,4,4,1,9,0xb2d15e2b
2032.3,1.0,1,1,2,4,7,0xb2d2e02a
2101.24,1.0,1,1,2,4,7,0xb2d32727d
7439.11,1.0,10,2,2,3,7,0xb2da3b64
56684.48,311.0,0,3,4,4,11,0x3b9b4643
1035026.5,3.0,27,4,4,2,10,0xb2d221b3
541346.32,4.0,0,4,4,4,12,0xb2d30025d
504945.45,5.0,53,4,4,2,10,0xb2d2d082d
2985.68,1.0,5,2,2,3,7,0xb2d8f954
15877.42,1.0,132,2,2,1,5,0xb2d4264e
9837.25,1.0,0,2,2,4,8,0xb2d6ac05
180006.8,6.0,4,3,4,4,11,0xb2d38343d
75667.79,2.0,10,3,3,3,9,0xb2d9449e
20858.02,2.0,133,2,3,1,6,0xb2d63c47
4802.82,1.0,12,2,2,3,7,0xb2d226be
600184.96,7.0,0,4,4,4,12,0xb2d5b75f
2242.9,1.0,44,1,2,2,5,0xb2d8e687
89062.27,2.0,210,3,3,1,7,0xb2d19e11
10000.11,2.0,70,2,3,1,6,0xb2d9a81e
41735.15,2.0,70,2,3,1,6,0xb2d4db32d
1991.01,1.0,92,1,2,1,4,0xb2d072d3
1599436.08,6.0,5,4,4,3,11,0xb2d3bca7d
152384.52,1.0,26,3,2,2,7,0xb2d8eda8
3774.0,1.0,20,2,2,2,6,0xb2d25187
742442.27,3.0,60,4,4,2,10,0xb2d31ab8
748.69,1.0,17,1,2,2,5,0xb2d9c0a2
200131.92,2.0,14,3,3,3,9,0xb2d95c9cd
10647.14,1.0,0,2,2,4,8,0xb2d65aee
700081.38,3.0,52,4,4,2,10,0xb2d374b3
42523.76,1.0,14,2,2,3,7,0xb2d319b4
30001.58,2.0,231,2,3,1,6,0xb2d6e4be
143006.67,2.0,256,3,3,1,7,0xb2d6053e
9713.69,5.0,10,2,4,3,9,0xb2d2f460
657.71,1.0,18,1,2,2,5,0xb2d1added
16.36,1.0,12,1,2,3,6,0xb2d9c5ed
360488.47,2.0,63,4,3,2,9,0xb2d682e9
12644.46,1.0,0,2,2,4,8,0xb2d6ab00
51751.34,2.0,73,2,3,1,6,0xb2d5d226
10039.83,1.0,1,2,2,4,8,0xb2d48c76
500006.04,2.0,7,4,3,3,10,0xb2d9304ad
949.51,1.0,25,1,2,2,5,0xb2d1c8c4
1477.26,1.0,175,1,2,1,4,0xb2d339d1d
90100.87,2.0,12,3,3,3,9,0xb2d93592d
7178.72,1.0,92,2,2,1,5,0xb2d1761e
1.58,1.0,127,1,2,1,4,0xb2d5d981d
118.56,1.0,30,1,2,2,5,0xb2d1cf2d
11000.0,2.0,6,2,3,3,8,0xb2da4f60
520000.0,2.0,4,4,3,4,11,0xb2d97a9c
10030.04,2.0,48,2,3,2,7,0xb2d9d34e
101657.44,2.0,46,3,3,2,8,0xb2d13d04
100372.85,2.0,206,3,3,1,7,0xb2d26b65
3222.66,1.0,0,2,2,4,8,0xb2d33443
101756.09,2.0,31,3,3,2,8,0xb2d6c237d
30.19,1.0,69,1,2,1,4,0xb2d8c5c6
100004.22,1.0,13,3,2,3,8,0xb2d95fdbd
810098.66,2.0,22,4,3,2,9,0xb2d5efc8
10007.98,2.0,188,2,3,1,6,0xb2d60600
27.44,1.0,39,1,2,2,5,0xb2d91352
130243.52,3.0,92,3,4,1,8,0xb2d0fdffd
90.39,1.0,59,1,2,2,5,0xb2d5c5e5
250002.64,2.0,83,3,3,1,7,0xb2d98702
26159.71,1.0,11,2,2,3,7,0xb2d6809ed
4183.72,1.0,204,2,2,1,5,0xb2d3b50d
91059.72,2.0,125,3,3,1,7,0xb2d2a098
270046.37,4.0,48,3,4,2,9,0xb2d11753d
0.87,1.0,7,1,2,3,6,0xb2da0add
51.47,1.0,36,1,2,2,5,0xb2d3a339
602131.25,2.0,33,4,3,2,9,0xb2d9386a
30005.11,2.0,37,2,3,2,7,0xb2d282fe
154384.08,4.0,3,3,4,4,11,0xb2d3fa98d
10032.75,1.0,92,2,2,1,5,0xb2d547f0d
100001.15,6.0,3,3,4,4,11,0xb2d0da5c
380760.25,4.0,0,4,4,4,12,0xb2d6f999
550008.58,4.0,14,4,4,3,11,0xb2d9cd43
1009.46,1.0,184,1,2,1,4,0xb2d2e843
2000008.08,2.0,0,4,3,4,11,0xb2d8c729d
669.69,1.0,78,1,2,1,4,0xb2d18ad8d
300000.0,2.0,1,3,3,4,10,0xb2da677c
8581.5,1.0,184,2,2,1,5,0xb2d1b42b
200060.38,2.0,0,3,3,4,10,0xb2d68b2d
12531.3,1.0,184,2,2,1,5,0xb2d2592cd
1711.75,1.0,184,1,2,1,4,0xb2d41d2ad
0.5,1.0,15,1,2,3,6,0xb2d5abe5
415702.65,7.0,12,4,4,3,11,0xb2d10362
10001.9,2.0,18,2,3,2,7,0xb2d5ade5
40515.87,1.0,92,2,2,1,5,0xb2d36cced
3.08,1.0,22,1,2,2,5,0xb2d4155f
17000.85,1.0,9,2,2,3,7,0xb2d303c1
1250073.53,4.0,4,4,4,4,12,0xb2d607a0
16517.87,1.0,5,2,2,3,7,0xb2d9312c
70000.74,2.0,6,3,3,3,9,0xb2da4a26
434.93,1.0,61,1,2,2,5,0xb2d5a43fd
16716.62,1.0,20,2,2,2,6,0xb2d901cd
207049.22,2.0,3,3,3,4,10,0xb2d5ed85d
11.61,1.0,90,1,2,1,4,0xb2d8929f
73.0,1.0,9,1,2,3,6,0xb2d375e1
2415.18,3.0,0,1,4,4,9,0x3b9b2640
17033.51,1.0,6,2,2,3,7,0xb2d1c561
690.73,1.0,1,1,2,4,7,0xb2d4b89e
25126.46,1.0,5,2,2,3,7,0xb2d5d148
15359.82,1.0,63,2,2,2,6,0xb2d5adf1d
203264.58,2.0,121,3,3,1,7,0xb2d204d7d
110022.11,3.0,129,3,4,1,8,0xb2d17988d
12244.19,2.0,7,2,3,3,8,0xb2d93685
0.0,1.0,6,1,2,3,6,0xb2d9670d
5.18,1.0,11,1,2,3,6,0xb2d6a1c1
138001.57,5.0,49,3,4,2,9,0xb2d9651cd
1058.95,1.0,84,1,2,1,4,0xb2d97937
1611497.31,15.0,1,4,4,4,12,0xb2d0fc55
374117.22,5.0,0,4,4,4,12,0xb2d91a39d
50.69,1.0,29,1,2,2,5,0xb2d566c1
8854.96,2.0,0,2,3,4,9,0xb2d60b1d
635.17,1.0,9,1,2,3,6,0xb2d2b072d
20758.15,2.0,4,2,3,4,9,0xb2d62c31d
3539.71,1.0,10,2,2,3,7,0xb2d2e315d
0.63,1.0,36,1,2,2,5,0xb2d25e29
275031.26,5.0,4,3,4,4,11,0xb2d2fe70
1001001.62,9.0,1,4,4,4,12,0xb2d16d28d
350000.43,2.0,14,4,3,3,10,0xb2d477d1
73.08,2.0,26,1,3,2,6,0xb2d12493
1199.7,1.0,43,1,2,2,5,0xb2d5e0dc
177751.28,4.0,46,3,4,2,9,0xb2d48e8cd
50027.04,2.0,3,2,3,4,9,0xb2d61b37d
1764.77,5.0,0,1,4,4,9,0xb2d0a6f7d
1521.37,1.0,184,1,2,1,4,0xb2d1aff5
2598.1,1.0,264,1,2,1,4,0xb2d3df57d
200051.8,2.0,13,3,3,3,9,0xb2d65b64
52.83,1.0,0,1,2,4,7,0xb2d8ee29
300066.06,7.0,10,3,4,3,10,0x3b9b4311
34.2,1.0,15,1,2,3,6,0xb2da0454
162402.36,5.0,11,3,4,3,10,0xb2d8de24
370000.0,2.0,1,4,3,4,11,0xb2d95045
3512.28,1.0,18,2,2,2,6,0xb2d54aeed
261478.1,8.0,0,3,4,4,11,0x3b9b34f6
11565.63,1.0,199,2,2,1,5,0xb2d52c0c
127168.49,1.0,4,3,2,4,9,0xb2d3339dd
2417.88,1.0,0,1,2,4,7,0xb2d92a26
200690.74,2.0,27,3,3,2,8,0xb2d4442ed
80131.94,2.0,0,3,3,4,10,0xb2d62b2fd
22199.44,1.0,1,2,2,4,8,0xb2d320e1
202826.01,2.0,25,3,3,2,8,0xb2d2c14c
1111528.47,5.0,6,4,4,3,11,0xb2d1e4ad
7485.24,1.0,184,2,2,1,5,0xb2d40566
314924.44,5.0,1,4,4,4,12,0xb2d5cbd0
18127.04,1.0,13,2,2,3,7,0xb2d68cca
641729.62,7.0,5,4,4,3,11,0xb2d1547c
400000.0,3.0,6,4,4,3,11,0xb2da1c31
50584.14,2.0,25,2,3,2,7,0xb2d92434d
7448.09,1.0,92,2,2,1,5,0xb2d0bdd4
868135.4,8.0,0,4,4,4,12,0xb2d108c0d
261665.09,6.0,35,3,4,2,9,0xb2d65884d
37.35,1.0,32,1,2,2,5,0xb2d0daebd
18888.07,1.0,0,2,2,4,8,0xb2d0fa7e
1100.06,1.0,5,1,2,3,6,0xb2d3e8fd
2.9,1.0,21,1,2,2,5,0xb2d6dc87
2014471.14,2.0,1,4,3,4,11,0xb2d65452d
108050.8,2.0,3,3,3,4,10,0xb2d3c3bb
1197322.29,5.0,55,4,4,2,10,0xb2d0be5c
15006.63,2.0,87,2,3,1,6,0xb2d8c391
400001.46,3.0,3,4,4,4,12,0xb2d4a971
650666.04,5.0,4,4,4,4,12,0xb2d588d1
490600.01,20.0,0,4,4,4,12,0xb2d0a4de
314460.44,2.0,94,4,3,1,8,0xb2d51df6d
2915756.49,10.0,0,4,4,4,12,0xb2d131ff
516.03,1.0,1,1,2,4,7,0xb2d3bbb1d
500000.0,2.0,0,4,3,4,11,0xb2da6a6e
1004.1,1.0,10,1,2,3,6,0xb2d8e50e
184847.9,5.0,0,3,4,4,11,0x3b9af0cf
170754.36,4.0,0,3,4,4,11,0xb2d64326d
308975.55,2.0,84,4,3,1,8,0xb2d5d0af
500000.0,5.0,9,4,4,3,11,0x3b9af17ad
156905.32,6.0,0,3,4,4,11,0xb2d1e95b
70000.0,5.0,0,3,4,4,11,0xb2d06ca9
660242.41,4.0,6,4,4,3,11,0xb2d6b0e3d
1360295.24,3.0,4,4,4,4,12,0xb2d3bee9
738.22,1.0,0,1,2,4,7,0xb2d6aaf8d
242002.0,3.0,0,3,4,4,11,0xb2d44511
1160237.01,3.0,53,4,4,2,10,0xb2d163b1
50002.3,2.0,231,2,3,1,6,0xb2d58ec2
504213.26,3.0,9,4,4,3,11,0xb2d6391fd
490034.14,4.0,31,4,4,2,10,0xb2d4381dd
166.44,3.0,13,1,4,3,8,0x3b9b3d37
40096.13,1.0,190,2,2,1,5,0xb2d537ce
5.86,1.0,41,1,2,2,5,0xb2d42993d
195.04,1.0,9,1,2,3,6,0xb2d3eade
9351.99,1.0,9,2,2,3,7,0xb2d6b22fd
40490.12,3.0,52,2,4,2,8,0xb2d08917
803.06,3.0,28,1,4,2,7,0xb2d219d8
3521.44,1.0,184,2,2,1,5,0xb2d11d4a
150215.01,2.0,0,3,3,4,10,0xb2d51293
260029.37,2.0,48,3,3,2,8,0xb2d6de2b
7135.01,3.0,18,2,4,2,8,0xb2d11fbdd
0.0,5.0,9,1,4,3,8,0xb2d0a736d
0.28,1.0,3,1,2,4,7,0xb2d9119b
73905.4,1.0,0,3,2,4,9,0xb2da5637
1355115.05,8.0,32,4,4,2,10,0xb2d3d519d
71.19,1.0,1,1,2,4,7,0xb2d574e8d
551558.42,8.0,11,4,4,3,11,0xb2d18447
750026.96,3.0,47,4,4,2,10,0xb2d78d70d
85715.37,8.0,0,3,4,4,11,0x3b9af194
408996.2,6.0,30,4,4,2,10,0xb2d3a89dd
50918.41,1.0,0,2,2,4,8,0xb2d6d194d
237278.45,2.0,1,3,3,4,10,0xb2d22415d
501776.38,3.0,57,4,4,2,10,0xb2d9c580
220257.91,2.0,10,3,3,3,9,0xb2d6c0bed
1242.43,1.0,92,1,2,1,4,0xb2d2ed23d
3427.29,1.0,295,2,2,1,5,0xb2d5c57e
208470.72,2.0,60,3,3,2,8,0xb2d9c40e
8096.17,1.0,0,2,2,4,8,0xb2d91cdf
800710.47,5.0,7,4,4,3,11,0xb2d611cdd
875544.23,12.0,19,4,4,2,10,0xb2d2d14dd
2800000.6,13.0,1,4,4,4,12,0xb2d0d3a7
70.08,1.0,96,1,2,1,4,0xb2d2643c
2039273.21,1.0,7,4,2,3,9,0xb2d2561fd
48.17,2.0,68,1,3,1,5,0xb2d417b0
783.45,1.0,1,1,2,4,7,0xb2d20f4a
790103.56,5.0,18,4,4,2,10,0xb2d16ec3
1589814.54,8.0,20,4,4,2,10,0x3b9b4607
120000.0,2.0,1,3,3,4,10,0xb2d5b13ad
743.91,1.0,3,1,2,4,7,0xb2d97859
12022.98,1.0,0,2,2,4,8,0xb2d0bf52
253840.58,3.0,38,3,4,2,9,0xb2d649e0
3015128.65,2.0,69,4,3,1,8,0xb2d45d5a
67.77,2.0,30,1,3,2,6,0x3b9b2a1c
2211.06,2.0,0,1,3,4,8,0x3b9af229
375181.53,3.0,20,4,4,2,10,0xb2d1d12a
54.31,2.0,16,1,3,2,6,0xb2d21b28
138078.07,3.0,0,3,4,4,11,0xb2d0847a
10100.1,2.0,20,2,3,2,7,0xb2d91bcf
301131.27,2.0,29,4,3,2,9,0xb2d8fff6
24665.5,1.0,1,2,2,4,8,0xb2d1288d
8736.47,1.0,304,2,2,1,5,0xb2d2fd61d
840002.58,4.0,97,4,4,1,9,0xb2d22236d
7944.45,1.0,14,2,2,3,7,0xb2d977ab
530011.92,3.0,70,4,4,1,9,0xb2d9814d
1308046.7,13.0,39,4,4,2,10,0xb2d2117a
690.98,1.0,4,1,2,4,7,0xb2d41308
0.0,1.0,0,1,2,4,7,0xb2d28870
11761.42,1.0,92,2,2,1,5,0xb2d2646bd
273994.34,2.0,10,3,3,3,9,0xb2d95fe3
8006511.44,5.0,0,4,4,4,12,0x3b9af646
100100.63,2.0,0,3,3,4,10,0xb2d210d8
112370.68,3.0,6,3,4,3,10,0xb2d90227
10.25,1.0,51,1,2,2,5,0xb2d211d4
70920.84,1.0,38,3,2,2,7,0xb2d4be4d
30995.33,2.0,12,2,3,3,8,0xb2d97642d
561115.48,8.0,55,4,4,2,10,0xb2d25c5ad
850002.77,5.0,3,4,4,4,12,0xb2d2d5d7d
250211.11,5.0,0,3,4,4,11,0xb2d91450
7773.6,1.0,184,2,2,1,5,0xb2d38575
230869.81,7.0,27,3,4,2,9,0xb2d56c89
623607.49,6.0,11,4,4,3,11,0xb2d0c517
642000.0,14.0,1,4,4,4,12,0xb2d242f1
7382.84,1.0,197,2,2,1,5,0xb2d340dad
10003.4,2.0,39,2,3,2,7,0xb2d68b43
14725.18,1.0,0,2,2,4,8,0xb2d315b3
1649.26,1.0,6,1,2,3,6,0xb2d2b7be
1679.96,1.0,184,1,2,1,4,0xb2d3a49f
1253073.94,7.0,3,4,4,4,12,0xb2d08584d
30794.52,1.0,7,2,2,3,7,0xb2d60146d
100101.07,2.0,19,3,3,2,8,0xb2da1616
260656.6,2.0,192,3,3,1,7,0xb2d62324d
10001.42,2.0,53,2,3,2,7,0xb2d9c60e
518078.97,4.0,14,4,4,3,11,0xb2d68295
61840.65,3.0,90,3,4,1,8,0xb2d57b7dd
1085.53,1.0,87,1,2,1,4,0xb2d06967
3825.15,1.0,92,2,2,1,5,0xb2d49035
210057.62,9.0,13,3,4,3,10,0xb2d61ca9
11193.16,1.0,125,2,2,1,5,0xb2d2a5b8
242869.72,4.0,144,3,4,1,8,0xb2d4fc3fd
52960.74,2.0,21,3,3,2,8,0xb2d55593d
200794.1,6.0,0,3,4,4,11,0xb2d6375bd
3004.29,4.0,0,2,4,4,10,0xb2d0bafe
2389.29,1.0,24,1,2,2,5,0xb2d6318fd
480.71,1.0,0,1,2,4,7,0xb2d790b2d
233189.31,2.0,6,3,3,3,9,0xb2d39af3
500000.89,4.0,7,4,4,3,11,0xb2d50b94
260024.47,3.0,0,3,4,4,11,0xb2d09deed
536889.65,12.0,0,4,4,4,12,0xb2d06916
35.29,1.0,18,1,2,2,5,0xb2d42731
38287.46,3.0,67,2,4,1,7,0xb2d58765
152022.17,2.0,80,3,3,1,7,0xb2d33c11
538092.54,5.0,12,4,4,3,11,0xb2d5c0e4
411946.89,4.0,41,4,4,2,10,0xb2d286bdd
1445056.66,9.0,12,4,4,3,11,0xb2d23b80
7105.95,1.0,10,2,2,3,7,0xb2d64020
3039.1,1.0,92,2,2,1,5,0xb2d2a9d9d
200006.33,2.0,80,3,3,1,7,0xb2d8d37ed
200.0,1.0,6,1,2,3,6,0xb2da1fd9
2397.86,1.0,88,1,2,1,4,0xb2d2e175d
5000062.15,3.0,19,4,4,2,10,0xb2d41325
3515324.22,2.0,0,4,3,4,11,0xb2d59f7dd
1450.5,1.0,9,1,2,3,6,0xb2d6a3fa
35685.25,1.0,4,2,2,4,8,0xb2d6a97cd
400000.0,3.0,14,4,4,3,11,0xb2da3e09
223.4,1.0,0,1,2,4,7,0xb2d30da6d
100103.89,2.0,200,3,3,1,7,0xb2d63242
209840.41,2.0,107,3,3,1,7,0xb2d154a1d
137452.32,4.0,0,3,4,4,11,0x3b9b4687
79.78,1.0,20,1,2,2,5,0xb2d1ef3e
157780.42,8.0,4,3,4,4,11,0xb2d30a2c
442.08,1.0,89,1,2,1,4,0xb2d5913d
3.62,1.0,4,1,2,4,7,0xb2d5faed
145000.0,1.0,0,3,2,4,9,0xb2d9e5ab
2449.72,1.0,0,1,2,4,7,0xb2d589a1
29018.01,1.0,52,2,2,2,6,0xb2d570d0d
700000.0,3.0,3,4,4,4,12,0xb2d93902d
330124.35,4.0,6,4,4,3,11,0xb2d2352f
355097.52,3.0,21,4,4,2,10,0xb2d51795d
240020.96,7.0,0,3,4,4,11,0xb2d61802d
5148.22,1.0,0,2,2,4,8,0xb2d210c6
17801.16,1.0,0,2,2,4,8,0xb2d6b55bd
70210.38,6.0,13,3,4,3,10,0xb2d93911d
14866.1,1.0,20,2,2,2,6,0xb2d0f4f2
560668.22,2.0,139,4,3,1,8,0xb2d436bfd
51048.06,1.0,184,2,2,1,5,0xb2d5ab77d
140387.52,3.0,4,3,4,4,11,0xb2d1e1a8d
809.82,1.0,6,1,2,3,6,0xb2d53264
484144.88,4.0,76,4,4,1,9,0xb2d167cbd
50822.06,2.0,221,2,3,1,6,0xb2d63affd
1403.93,1.0,7,1,2,3,6,0xb2d2bee2
203599.93,2.0,17,3,3,2,8,0xb2d5a45e
20000.84,2.0,20,2,3,2,7,0xb2da035a
2.97,1.0,11,1,2,3,6,0xb2d2dd25
1877.52,1.0,1,1,2,4,7,0xb2d6f213d
207172.14,1.0,0,3,2,4,9,0xb2d58c2c
3188000.0,8.0,0,4,4,4,12,0xb2d195a3
4.32,1.0,19,1,2,2,5,0xb2d593b9d
20534.19,2.0,10,2,3,3,8,0xb2d575b5d
41000.43,2.0,90,2,3,1,6,0xb2d88adf
5015.22,1.0,298,2,2,1,5,0xb2d6922fd
0.0,1.0,10,1,2,3,6,0xb2d78cd9d
363877.96,2.0,4,4,3,4,11,0xb2d36ef1d
250046.96,3.0,130,3,4,1,8,0xb2d50a97d
200020.19,2.0,199,3,3,1,7,0xb2d5cb32
514246.36,2.0,84,4,3,1,8,0xb2d3f141
393886.65,2.0,22,4,3,2,9,0xb2d65cbb
385149.46,4.0,1,4,4,4,12,0xb2d1ef86d
172.66,1.0,11,1,2,3,6,0xb2d1dff7
915.5,1.0,0,1,2,4,7,0xb2d51ebe
18000.3,2.0,23,2,3,2,7,0xb2d54645
368.5,1.0,59,1,2,2,5,0xb2d5cb69
500060.76,2.0,13,4,3,3,10,0xb2d78465
6049.87,1.0,0,2,2,4,8,0xb2d97347
230411.29,5.0,1,3,4,4,11,0xb2d211b5
36386.51,1.0,0,2,2,4,8,0xb2d57a51
1868035.45,2.0,5,4,3,3,10,0xb2d14c53
843.84,1.0,5,1,2,3,6,0xb2d6dd16
2492.18,1.0,19,1,2,2,5,0xb2d60ad9d
1966105.16,1.0,92,4,2,1,7,0xb2d4ffec
3303.65,1.0,3,2,2,4,8,0xb2d689fa
1419.83,1.0,92,1,2,1,4,0xb2d375ead
496.61,1.0,10,1,2,3,6,0xb2d53eb9d
937044.98,8.0,73,4,4,1,9,0xb2d3160d
670623.65,10.0,1,4,4,4,12,0xb2d6db63d
1477281.54,29.0,4,4,4,4,12,0xb2d175a6d
0.11,1.0,92,1,2,1,4,0xb2d1447fd
361314.23,1.0,20,4,2,2,8,0xb2d39fa3
24693.28,3.0,173,2,4,1,7,0xb2d5c655
10010.15,1.0,10,2,2,3,7,0xb2d96576
325277.14,3.0,154,4,4,1,9,0xb2d227db
4181.86,2.0,92,2,3,1,6,0x3b9b1938d
1.8,1.0,5,1,2,3,6,0xb2d6c06b
800017.95,4.0,13,4,4,3,11,0xb2da331c
22905.76,1.0,0,2,2,4,8,0xb2d6c9e6d
184183.42,3.0,93,3,4,1,8,0xb2d17e7e
1000078.26,4.0,9,4,4,3,11,0xb2d91b69d
158005.16,7.0,0,3,4,4,11,0xb2d12054d
6.89,1.0,4,1,2,4,7,0xb2d2444c
45724.23,2.0,14,2,3,3,8,0xb2d51883
642079.94,8.0,118,4,4,1,9,0x3b9b3ebdd
660.68,1.0,1,1,2,4,7,0xb2d2b3a0d
471697.42,4.0,20,4,4,2,10,0xb2d06435
1001978.85,5.0,76,4,4,1,9,0xb2d0f9ff
40298.91,2.0,67,2,3,1,6,0xb2d67ce3d
30088.43,1.0,92,2,2,1,5,0xb2d618a8d
133.39,1.0,6,1,2,3,6,0xb2d9205b
81920.71,2.0,63,3,3,2,8,0xb2d27a15
717.12,1.0,10,1,2,3,6,0xb2d78740
500000.0,1.0,0,4,2,4,10,0xb2d41837
434.85,1.0,0,1,2,4,7,0xb2d2fc9f
390356.75,3.0,4,4,4,4,12,0xb2d3e446d
1650976.52,6.0,22,4,4,2,10,0xb2d3af06
2121.16,1.0,92,1,2,1,4,0xb2d11065d
1000097.67,2.0,87,4,3,1,8,0xb2d51e40d
181254.11,5.0,13,3,4,3,10,0xb2d3bf47d
721.14,1.0,0,1,2,4,7,0xb2d4fd11
4.07,2.0,9,1,3,3,7,0xb2d8257c
3822.54,1.0,0,2,2,4,8,0xb2d55148
460077.97,4.0,108,4,4,1,9,0xb2d5f290
131.2,2.0,12,1,3,3,7,0x3b9b255c
283037.44,7.0,60,3,4,2,9,0xb2d5a9f5d
100076.93,2.0,109,3,3,1,7,0xb2d1b36e
301452.27,3.0,25,4,4,2,10,0xb2d15465d
53645.75,2.0,143,3,3,1,7,0xb2d1d8c7d
760467.7,4.0,6,4,4,3,11,0xb2d13c24
15325.82,1.0,1,2,2,4,8,0xb2d0b62e
35663.06,1.0,256,2,2,1,5,0xb2d5c8cad
2303107.5,20.0,41,4,4,2,10,0xb2d40efb
1020864.87,4.0,13,4,4,3,11,0xb2d10d45
451187.71,5.0,1,4,4,4,12,0xb2d5302ed
20000.84,2.0,92,2,3,1,6,0xb2d66618
200002.52,2.0,19,3,3,2,8,0xb2d79044d
93.86,1.0,2,1,2,4,7,0xb2d40947
119756.93,2.0,3,3,3,4,10,0xb2d63a69d
16045.29,1.0,6,2,2,3,7,0xb2d48322
30000.23,2.0,129,2,3,1,6,0xb2d55c7bd
0.0,2.0,60,1,3,2,6,0xb2d6c7f5
111002.87,3.0,20,3,4,2,9,0xb2d622c8
1191475.05,7.0,14,4,4,3,11,0xb2d478e7d
490027.68,3.0,1,4,4,4,12,0xb2d5f069
330000.0,2.0,19,4,3,2,9,0xb2d9579ed
101168.5,2.0,32,3,3,2,8,0xb2d90796d
1070641.05,1.0,21,4,2,2,8,0xb2d156f7d
974.65,1.0,0,1,2,4,7,0xb2d9c389
3295.53,1.0,16,2,2,2,6,0xb2d92571
1284013.24,9.0,6,4,4,3,11,0xb2d282a8
1034.61,1.0,184,1,2,1,4,0xb2d1d729d
1792.24,1.0,92,1,2,1,4,0xb2d3c62b
4841.63,2.0,70,2,3,1,6,0xb2d46af5d
10052.88,1.0,184,2,2,1,5,0xb2d539dd
6216448.65,10.0,12,4,4,3,11,0xb2d65a77
1201.5,1.0,7,1,2,3,6,0xb2d25fab
733.96,1.0,18,1,2,2,5,0xb2d20d45
512475.15,2.0,82,4,3,1,8,0xb2d6362a
398.79,1.0,131,1,2,1,4,0xb2d56f0b
380.04,1.0,18,1,2,2,5,0xb2d52c30
484778.31,4.0,80,4,4,1,9,0xb2d14b08
50002.79,3.0,4,2,4,4,10,0xb2d5e404d
190017.25,4.0,0,3,4,4,11,0xb2d60c9dd
1366266.01,7.0,16,4,4,2,10,0xb2d13d6ed
230002.06,2.0,14,3,3,3,9,0xb2d9cc51
166.97,1.0,10,1,2,3,6,0xb2d93cb5
0.0,1.0,2,1,2,4,7,0xb2d32f6fd
1868.72,1.0,92,1,2,1,4,0xb2d1c3e7d
2087.24,1.0,92,1,2,1,4,0xb2d1a571
1.84,1.0,77,1,2,1,4,0xb2d82233d
200021.59,5.0,95,3,4,1,8,0x3b9b1275
201892.4,1.0,84,3,2,1,6,0xb2d2228bd
312177.34,3.0,77,4,4,1,9,0xb2d6161ad
414526.25,2.0,3,4,3,4,11,0xb2d62108d
166468.24,3.0,0,3,4,4,11,0xb2d9d741
247.88,1.0,4,1,2,4,7,0xb2d6dee6
230206.96,2.0,0,3,3,4,10,0xb2d969fa
655075.77,6.0,3,4,4,4,12,0xb2d19687
9026.35,1.0,92,2,2,1,5,0xb2d3e95dd
10000.42,2.0,42,2,3,2,7,0xb2d9e442
350006.86,3.0,6,4,4,3,11,0xb2da35f6
5044.97,1.0,37,2,2,2,6,0xb2d3b6ded
42320.45,1.0,60,2,2,2,6,0xb2d175f5d
250003.33,3.0,14,3,4,3,10,0xb2d9cc05
1974770.18,9.0,0,4,4,4,12,0xb2d5b7ef
380008.23,6.0,1,4,4,4,12,0xb2d3f253d
220249.7,3.0,41,3,4,2,9,0xb2d60eed
11.61,1.0,0,1,2,4,7,0xb2d90c66
51686.69,2.0,1,2,3,4,9,0xb2d5e54d
25.4,1.0,10,1,2,3,6,0xb2d5050f
66773.89,1.0,39,3,2,2,7,0xb2d58bcd
243565.97,3.0,10,3,4,3,10,0xb2d9969f
2879.44,1.0,24,1,2,2,5,0xb2d2d9e3
1614245.46,4.0,7,4,4,3,11,0xb2d241fb
7459.15,1.0,0,2,2,4,8,0xb2d78fdfd
2402.69,1.0,8,1,2,3,6,0xb2d21bc5
461.98,1.0,77,1,2,1,4,0xb2d6b707d
113589.62,2.0,3,3,3,4,10,0xb2d370a9d
4515.89,1.0,92,2,2,1,5,0xb2d591dbd
573000.0,14.0,1,4,4,4,12,0xb2d08c2cd
28426.4,1.0,8,2,2,3,7,0xb2d8d076d
5803.53,1.0,92,2,2,1,5,0xb2d218add
50002.49,2.0,213,2,3,1,6,0xb2d58f0fd
1281.17,1.0,92,1,2,1,4,0xb2d14762
893578.94,12.0,1,4,4,4,12,0xb2d0f9d6
228213.93,2.0,83,3,3,1,7,0xb2d10145d
60010.48,2.0,60,3,3,2,8,0xb2d60470
142318.24,8.0,0,3,4,4,11,0xb2d1642ad
134249.78,1.0,3,3,2,4,9,0xb2d30330
180012.46,3.0,0,3,4,4,11,0xb2d9e487
360000.02,6.0,3,4,4,4,12,0xb2d18cfcd
6084.51,1.0,184,2,2,1,5,0xb2d1bbb0d
420402.84,8.0,87,4,4,1,9,0xb2d06348d
1.58,1.0,93,1,2,1,4,0xb2d97bb3d
200068.54,2.0,80,3,3,1,7,0xb2d2cc3f
10.94,1.0,45,1,2,2,5,0xb2d7aef0
7640.47,1.0,32,2,2,2,6,0xb2d93844
200731.71,2.0,31,3,3,2,8,0xb2d4909d
17955.73,1.0,1,2,2,4,8,0xb2d1cc73
5992.1,3.0,184,2,4,1,7,0x3b9b1671d
200010.43,2.0,26,3,3,2,8,0xb2d9c624
831000.0,15.0,1,4,4,4,12,0xb2d1494cd
364476.4,6.0,11,4,4,3,11,0xb2d3bd2c
10595.6,1.0,184,2,2,1,5,0x3b9b3f78d
240554.26,3.0,94,3,4,1,8,0xb2d3d2d4d
470928.61,5.0,0,4,4,4,12,0xb2d1be18d
61047.98,2.0,235,3,3,1,7,0xb2d6279cd
100594.33,2.0,63,3,3,2,8,0xb2d50ca5d
200012.3,2.0,92,3,3,1,7,0xb2d1326cd
334216.95,2.0,6,4,3,3,10,0xb2d434fed
126583.3,1.0,92,3,2,1,6,0xb2d3a38a
353612.07,4.0,14,4,4,3,11,0xb2d627aad
52.24,1.0,7,1,2,3,6,0xb2d27e13
520308.94,3.0,214,4,4,1,9,0x3b9b0edad
490504.16,2.0,14,4,3,3,10,0xb2d8e03bd
0.0,1.0,0,1,2,4,7,0xb2d6a7f7
523785.93,3.0,0,4,4,4,12,0xb2d38fb9
163449.27,2.0,76,3,3,1,7,0xb2d57e2dd
4369.91,2.0,7,2,3,3,8,0x3b9b0fb6
11386.9,1.0,22,2,2,2,6,0xb2d97df0
6.34,1.0,47,1,2,2,5,0xb2d95cce
12.58,1.0,30,1,2,2,5,0xb2d1a39ad
50002.64,2.0,92,2,3,1,6,0xb2d63c75d
16721.8,1.0,18,2,2,2,6,0xb2d2531fd
206270.67,2.0,0,3,3,4,10,0xb2d16788d
3226.06,1.0,0,2,2,4,8,0xb2d5827dd
101800.7,1.0,15,3,2,3,8,0xb2d2ed3a
2.11,1.0,20,1,2,2,5,0xb2d4350a
1170987.4,7.0,3,4,4,4,12,0xb2d19468d
251438.43,4.0,26,3,4,2,9,0xb2d179dd
645093.91,14.0,6,4,4,3,11,0xb2d52534d
41164.86,3.0,48,2,4,2,8,0xb2d62d4ad
680211.34,4.0,1,4,4,4,12,0xb2d128c0d
1100194.1,2.0,19,4,3,2,9,0xb2d239ead
15064.81,2.0,158,2,3,1,6,0xb2d46ec1d
1897.41,2.0,217,1,3,1,5,0xb2d37265d
100001.06,2.0,130,3,3,1,7,0xb2d92d4f
409790.29,28.0,1,4,4,4,12,0xb2d0ccdf
20246.16,1.0,6,2,2,3,7,0xb2d78cbc
1156.31,1.0,184,1,2,1,4,0xb2d0f557
2106.05,1.0,184,1,2,1,4,0xb2d14b5c
101054.63,3.0,18,3,4,2,9,0xb2d459c7
203.74,1.0,83,1,2,1,4,0xb2d5cf89
153.91,1.0,60,1,2,2,5,0xb2d745f2d
29741.6,2.0,19,2,3,2,7,0xb2d54add
237959.89,2.0,0,3,3,4,10,0xb2d0f00fd
292080.68,6.0,0,3,4,4,11,0xb2d275d6
2268.07,1.0,4,1,2,4,7,0xb2d6b4e4
570022.88,3.0,31,4,4,2,10,0xb2d3a10dd
10246.38,2.0,118,2,3,1,6,0xb2d4d1b4
33.42,1.0,11,1,2,3,6,0xb2d1aaae
120227.13,2.0,34,3,3,2,8,0xb2d5eb4b
3905.91,1.0,32,2,2,2,6,0xb2d9d278
350019.85,5.0,47,4,4,2,10,0xb2d5ad28d
300022.52,2.0,0,3,3,4,10,0xb2d98f6d
70036.39,3.0,70,3,4,1,8,0xb2d3ec16
768.52,1.0,0,1,2,4,7,0xb2d600dc
1034926.71,2.0,11,4,3,3,10,0xb2d5b020d
990010.0,1.0,5,4,2,3,9,0xb2d92cd2
444474.75,6.0,0,4,4,4,12,0xb2d0e398
1140.92,1.0,26,1,2,2,5,0xb2d261f8d
1001.93,1.0,1,1,2,4,7,0xb2d42b3f
500000.0,2.0,4,4,3,4,11,0xb2d911b9
530.94,1.0,0,1,2,4,7,0xb2d6e8a0
76070.29,2.0,5,3,3,3,9,0xb2d21aa3d
938129.19,1.0,2,4,2,4,10,0xb2d2679fd
226.03,1.0,10,1,2,3,6,0xb2d8e342
130030.21,4.0,3,3,4,4,11,0xb2d5c213
50001.06,2.0,101,2,3,1,6,0xb2d6b459d
742655.54,2.0,4,4,3,4,11,0xb2d94da6d
3379892.99,5.0,10,4,4,3,11,0x3b9b3755
200001.59,2.0,21,3,3,2,8,0xb2d98b2b
1793.96,1.0,184,1,2,1,4,0xb2d3c62bd
1871.62,1.0,158,1,2,1,4,0xb2d54fa9
266663.29,3.0,5,3,4,3,10,0xb2d2ec68
12.6,1.0,9,1,2,3,6,0xb2d2b3af
6.86,1.0,25,1,2,2,5,0xb2d1f2ea
5537.04,1.0,284,2,2,1,5,0xb2d298c2d
20651.03,2.0,263,2,3,1,6,0xb2d5fcfd
767.53,1.0,15,1,2,3,6,0xb2d68e0b
1130.26,2.0,92,1,3,1,5,0xb2d42d27
88.51,1.0,28,1,2,2,5,0xb2d99da2
510666.02,2.0,203,4,3,1,8,0xb2d693e2d
6.86,1.0,67,1,2,1,4,0xb2d8d731
12627.17,2.0,80,2,3,1,6,0x3b9b0f6a
1833.76,1.0,184,1,2,1,4,0xb2d2fe10
7012.82,1.0,147,2,2,1,5,0xb2d6321bd
1309.49,1.0,5,1,2,3,6,0xb2d7c785d
1247550.9,5.0,82,4,4,1,9,0xb2d6950dd
1958.83,1.0,257,1,2,1,4,0xb2d4058c
2000002.22,2.0,3,4,3,4,11,0xb2d9efdc
125970.81,2.0,182,3,3,1,7,0xb2d3f290
300048.49,1.0,6,3,2,3,8,0xb2d1dca7
230009.08,2.0,113,3,3,1,7,0xb2d87eeb
2.83,1.0,9,1,2,3,6,0xb2d6b7c2
406991.1,2.0,58,4,3,2,9,0xb2d16b89d
23654.88,1.0,6,2,2,3,7,0xb2d29d95d
75782.83,1.0,135,3,2,1,6,0xb2d60df3
288.55,1.0,1,1,2,4,7,0xb2d6867ad
20038.65,1.0,192,2,2,1,5,0xb2d6a65b
5292.31,1.0,0,2,2,4,8,0xb2d9031c
21835.78,1.0,7,2,2,3,7,0xb2d8c711d
185.3,1.0,10,1,2,3,6,0xb2d1d6e8
419.16,1.0,9,1,2,3,6,0xb2d55588
888433.9,4.0,10,4,4,3,11,0xb2d540bad
458402.66,1.0,79,4,2,1,7,0xb2d81e1ed
3.03,1.0,9,1,2,3,6,0xb2d402d2d
6072.25,1.0,11,2,2,3,7,0xb2d3e45f
100513.26,3.0,73,3,4,1,8,0xb2d5aa18
4.55,1.0,73,1,2,1,4,0xb2d1ff4d
2.64,1.0,110,1,2,1,4,0xb2d958ca
39066.04,2.0,32,2,3,2,7,0xb2d07504
604741.06,10.0,3,4,4,4,12,0xb2d09fc9
50006.9,2.0,213,2,3,1,6,0xb2d5fd38d
93.02,1.0,87,1,2,1,4,0xb2d4eaed
1574088.31,3.0,206,4,4,1,9,0xb2d2266e
142034.1,4.0,0,3,4,4,11,0xb2d0d62ad
2293.46,1.0,60,1,2,2,5,0xb2d7008a
31234.19,1.0,7,2,2,3,7,0xb2d10910d
29743.88,1.0,0,2,2,4,8,0xb2d331d6d
239.21,2.0,35,1,3,2,6,0xb2d08f6b
2163.81,1.0,92,1,2,1,4,0xb2d35358
503559.23,4.0,16,4,4,2,10,0xb2d6543bd
157692.75,2.0,3,3,3,4,10,0xb2d10bcbd
1004.37,1.0,92,1,2,1,4,0xb2d530b7
123000.0,5.0,3,3,4,4,11,0xb2d6dabb
527.49,1.0,10,1,2,3,6,0xb2d58454
2101.18,1.0,8,1,2,3,6,0xb2d6185e
1000520.26,1.0,0,4,2,4,10,0xb2d40be3
1775.46,3.0,38,1,4,2,7,0x3b9af278
110374.11,2.0,3,3,3,4,10,0xb2d6472d
1081.45,1.0,1,1,2,4,7,0xb2d3e528
0.0,2.0,8,1,3,3,7,0xb2d3bebc
699526.96,1.0,77,4,2,1,7,0xb2d3049fd
104706.97,1.0,36,3,2,2,7,0xb2d3fc45
3210.03,1.0,0,2,2,4,8,0xb2d1425d
2.69,1.0,80,1,2,1,4,0xb2d5b3cc
80845.09,2.0,0,3,3,4,10,0xb2d667aed
8385.0,1.0,0,2,2,4,8,0xb2d780ded
200000.0,2.0,15,3,3,3,9,0xb2da395b
955.65,1.0,6,1,2,3,6,0xb2d2ff63
100986.86,2.0,136,3,3,1,7,0xb2d6361e
39837.57,1.0,14,2,2,3,7,0xb2d0d148
54033.23,2.0,217,3,3,1,7,0xb2d0d416
354022.87,5.0,20,4,4,2,10,0xb2d50f3cd
2238.21,1.0,0,1,2,4,7,0xb2d29bfb
10030.22,2.0,33,2,3,2,7,0xb2d62e96d
60394.93,4.0,11,3,4,3,10,0xb2d62814
917182.24,8.0,3,4,4,4,12,0xb2d4dbd7d
20049.1,1.0,0,2,2,4,8,0xb2d6159dd
13836.97,2.0,159,2,3,1,6,0xb2d09ee2
50000.53,2.0,83,2,3,1,6,0xb2d8d07c
2.22,1.0,6,1,2,3,6,0xb2d959fc
172051.6,7.0,2,3,4,4,11,0xb2d9ccc3
9.8,1.0,0,1,2,4,7,0xb2d22372d
18549.45,1.0,184,2,2,1,5,0x3b9adc68
9.71,2.0,82,1,3,1,5,0xb2d5db70
4177.31,2.0,5,2,3,3,8,0x3b9af596
56573.09,5.0,0,3,4,4,11,0x3b9b18eb
1133078.82,2.0,49,4,3,2,9,0xb2d31bd8
55.99,1.0,4,1,2,4,7,0xb2d2c4cd
61964.36,2.0,199,3,3,1,7,0xb2d3a105d
490000.74,3.0,0,4,4,4,12,0xb2d93691
32002.87,4.0,80,2,4,1,7,0xb2d52015
1583.44,1.0,1,1,2,4,7,0xb2d6be4a
700000.0,5.0,0,4,4,4,12,0xb2d966e7d
0.53,1.0,184,1,2,1,4,0xb2d28b59d
932078.58,3.0,18,4,4,2,10,0xb2d8ea31
245.33,1.0,3,1,2,4,7,0xb2d61b1fd
335.17,1.0,1,1,2,4,7,0xb2d24fbe
107676.36,2.0,186,3,3,1,7,0xb2d3a020d
1500000.0,6.0,11,4,4,3,11,0xb2d6bd0f
2934.86,1.0,0,2,2,4,8,0xb2d63152
8418869.46,9.0,0,4,4,4,12,0x3b9b316ad
377879.29,2.0,7,4,3,3,10,0xb2d43ba9d
5239.74,3.0,0,2,4,4,10,0xb2d06557d
79054.56,4.0,24,3,4,2,9,0xb2d3c686
580670.76,3.0,7,4,4,3,11,0xb2d6e3fb
60175.27,2.0,63,3,3,2,8,0xb2d5a77c
10626.08,1.0,15,2,2,3,7,0xb2d94531
211000.58,3.0,13,3,4,3,10,0xb2d95a27
470106.23,3.0,59,4,4,2,10,0xb2d133acd
200021.41,2.0,18,3,3,2,8,0xb2d5cf8d
4184.72,1.0,9,2,2,3,7,0xb2d07fd6
207.81,1.0,9,1,2,3,6,0xb2d52eb6
648.08,1.0,23,1,2,2,5,0xb2d53d1cd
460107.31,3.0,0,4,4,4,12,0xb2d41fecd
17.4,1.0,2,1,2,4,7,0xb2d25576
12733.23,1.0,11,2,2,3,7,0xb2d2aafc
250991.1,3.0,101,3,4,1,8,0xb2d69416
392547.47,6.0,0,4,4,4,12,0xb2d0e80fd
57.53,1.0,11,1,2,3,6,0xb2d8f2f5d
40125.54,2.0,184,2,3,1,6,0x3b9ae614d
400100.0,3.0,5,4,4,3,11,0xb2d1b429
420656.68,3.0,110,4,4,1,9,0xb2d4219b
381260.2,4.0,9,4,4,3,11,0xb2d29601d
69.33,1.0,25,1,2,2,5,0xb2d101c2
400067.84,5.0,0,4,4,4,12,0xb2d24398
300015.11,2.0,6,3,3,3,9,0xb2d41064d
912883.43,5.0,0,4,4,4,12,0x3b9b331bd
565.31,1.0,21,1,2,2,5,0xb2d6f773
0.0,1.0,184,1,2,1,4,0xb2d2d613
416045.46,4.0,3,4,4,4,12,0xb2d5ad38d
1321.47,1.0,0,1,2,4,7,0xb2d5aa6e
44537.59,1.0,0,2,2,4,8,0xb2d210c1d
77575.47,2.0,0,3,3,4,10,0xb2d5638dd
10030.71,2.0,129,2,3,1,6,0xb2d5c4dbd
119969.79,2.0,92,3,3,1,7,0xb2d3c362d
1108449.15,6.0,41,4,4,2,10,0xb2d17a86
1661059.72,1.0,0,4,2,4,10,0xb2d42d02
204624.23,3.0,78,3,4,1,8,0xb2d65ad6
100013.44,2.0,31,3,3,2,8,0xb2d46ac8d
55.95,1.0,1,1,2,4,7,0xb2d27e13d
3.58,1.0,2,1,2,4,7,0xb2d2ebb1
3171.1,3.0,184,2,4,1,7,0x3b9b4335
772303.9,6.0,77,4,4,1,9,0xb2d8d4d0
327500.32,3.0,31,4,4,2,10,0xb2d4fd0bd
4064.41,1.0,0,2,2,4,8,0xb2d6f357
388.09,1.0,10,1,2,3,6,0xb2d9cda9
52069.76,1.0,4,2,2,4,8,0xb2d6a0f4
600000.0,4.0,1,4,4,4,12,0xb2d59f27
1001.77,1.0,121,1,2,1,4,0xb2d91a54
522825.82,4.0,18,4,4,2,10,0xb2d4257d
230837.7,4.0,47,3,4,2,9,0xb2d17fc3
111.26,1.0,10,1,2,3,6,0xb2d9b844
1202495.52,7.0,11,4,4,3,11,0xb2d1e4aa
690132.14,4.0,4,4,4,4,12,0xb2d95990d
400050.19,4.0,10,4,4,3,11,0xb2d8cf94d
201421.25,2.0,84,3,3,1,7,0xb2d98732
90249.96,4.0,25,3,4,2,9,0xb2d2b2e2
255782.44,3.0,1,3,4,4,11,0xb2d5a45ed
5679.94,1.0,0,2,2,4,8,0xb2d1695b
55001.74,2.0,67,3,3,1,7,0xb2d2f2fed
72605.73,3.0,32,3,4,2,9,0xb2d1202fd
11980.25,1.0,10,2,2,3,7,0xb2d2d741d
14675.99,1.0,29,2,2,2,6,0xb2d6c676
687.26,1.0,6,1,2,3,6,0xb2d5cfaa
677986.99,6.0,27,4,4,2,10,0xb2d5b6e1
0.01,1.0,10,1,2,3,6,0xb2d78626d
910035.25,2.0,17,4,3,2,9,0xb2d63575d
84.74,1.0,11,1,2,3,6,0xb2d6b73ed
4177.22,2.0,223,2,3,1,6,0xb2d425e1
1.6,4.0,3,1,4,4,9,0x3b9af231
1635.79,1.0,92,1,2,1,4,0xb2d1b254d
981000.0,10.0,4,4,4,4,12,0xb2d30f9b
152537.37,4.0,11,3,4,3,10,0xb2d21fbc
49010.47,3.0,0,2,4,4,10,0xb2d0d8e7
31021.09,1.0,92,2,2,1,5,0xb2d23a5e
600223.0,3.0,21,4,4,2,10,0xb2d909b7d
201427.8,2.0,27,3,3,2,8,0xb2d22de9
2.19,1.0,131,1,2,1,4,0xb2d42c4b
472054.67,4.0,24,4,4,2,10,0xb2d4dcc2d
23071.37,1.0,0,2,2,4,8,0xb2d0e0bf
165132.78,2.0,1,3,3,4,10,0xb2d5e71cd
220013.32,5.0,74,3,4,1,8,0xb2d072a9d
85000.95,2.0,97,3,3,1,7,0xb2d5b9bc
1503.05,1.0,201,1,2,1,4,0xb2d696be
217003.07,3.0,175,3,4,1,8,0xb2d682a4d
1692.82,1.0,1,1,2,4,7,0xb2d989a9
1106667.81,4.0,32,4,4,2,10,0xb2d62a73
630058.17,5.0,4,4,4,4,12,0xb2d24ab2d
104330.52,2.0,2,3,3,4,10,0xb2d51411
26681.79,1.0,9,2,2,3,7,0xb2d5f0bed
1.08,1.0,71,1,2,1,4,0xb2d3871b
41.73,1.0,81,1,2,1,4,0xb2d207bdd
760011.41,4.0,23,4,4,2,10,0xb2d40272d
685.74,2.0,6,1,3,3,7,0xb2d19533
344105.02,4.0,52,4,4,2,10,0xb2d29a2f
950017.73,15.0,32,4,4,2,10,0xb2d6e0ecd
552597.83,1.0,42,4,2,2,8,0xb2d0e946
2015.13,3.0,238,1,4,1,6,0x3b9adb52
40699.97,2.0,256,2,3,1,6,0xb2d60546d
2784536.33,18.0,0,4,4,4,12,0xb2d613e3d
5.35,1.0,35,1,2,2,5,0xb2d526ef
500000.0,3.0,1,4,4,4,12,0xb2d99442
120003.35,4.0,4,3,4,4,11,0xb2d61b38d
15.4,1.0,32,1,2,2,5,0xb2d37ca7
200000.0,2.0,3,3,3,4,10,0xb2d5f4f4
50770.06,1.0,4,2,2,4,8,0xb2d792c5d
606724.63,4.0,69,4,4,1,9,0xb2d78046
257617.91,6.0,42,3,4,2,9,0xb2d6038f
17931.64,1.0,179,2,2,1,5,0xb2d37009d
10000.21,2.0,213,2,3,1,6,0xb2d415cbd
292307.36,3.0,87,3,4,1,8,0xb2d1aafe
5056.39,1.0,92,2,2,1,5,0xb2d2a613d
313951.55,3.0,13,4,4,3,11,0xb2d10060
12052.42,1.0,184,2,2,1,5,0xb2d3f3ca
600043.23,3.0,1,4,4,4,12,0xb2d9b436
430019.72,2.0,111,4,3,1,8,0xb2d6a346
221058.83,5.0,10,3,4,3,10,0xb2d57299
751943.11,1.0,25,4,2,2,8,0xb2d0e946d
415045.86,7.0,2,4,4,4,12,0xb2d5c37dd
0.01,11.0,47,1,4,2,7,0xb2d0bd1f
90000.0,6.0,0,3,4,4,11,0xb2d186f8
610027.4,9.0,0,4,4,4,12,0xb2d61400
222675.26,4.0,10,3,4,3,10,0xb2d5bbc1
200031.27,2.0,4,3,3,4,10,0xb2d87a1bd
3006432.05,5.0,49,4,4,2,10,0xb2d39cc8d
530017.39,3.0,18,4,4,2,10,0xb2d9ddd7
1345039.19,5.0,26,4,4,2,10,0xb2d5a723
206798.41,2.0,94,3,3,1,7,0xb2d24efdd
2.11,1.0,56,1,2,2,5,0xb2d25c2bd
300000.0,2.0,13,3,3,3,9,0xb2da4011
100006.61,5.0,0,3,4,4,11,0xb2d0e3df
970087.63,5.0,0,4,4,4,12,0xb2d53053
610088.79,4.0,4,4,4,4,12,0xb2d61a7b
200408.65,2.0,9,3,3,3,9,0xb2d63cd9
907.55,1.0,0,1,2,4,7,0xb2d229dcd
31.76,1.0,74,1,2,1,4,0xb2d93f2c
201434.26,2.0,64,3,3,2,8,0xb2d687c8d
711385.85,2.0,14,4,3,3,10,0xb2d578bf
3008.96,1.0,2,2,2,4,8,0xb2d60aaa
4327.14,1.0,10,2,2,3,7,0xb2d443e6
4364.12,1.0,0,2,2,4,8,0xb2d6d1b9
202843.31,2.0,111,3,3,1,7,0xb2d9126bd
237566.31,1.0,4,3,2,4,9,0xb2d35a4c
10341.16,1.0,184,2,2,1,5,0x3b9b2e42d
50001.17,2.0,31,2,3,2,7,0xb2d11eb5
70023.24,2.0,259,3,3,1,7,0xb2d1e2b9d
11287.09,1.0,33,2,2,2,6,0xb2d2e814
1000000.0,2.0,1,4,3,4,11,0xb2d918cdd
5.82,1.0,25,1,2,2,5,0xb2d24381d
309611.26,3.0,77,4,4,1,9,0xb2d36065d
201624.97,2.0,0,3,3,4,10,0xb2d6b2d4
30245.37,2.0,10,2,3,3,8,0xb2d60abbd
800032.89,2.0,80,4,3,1,8,0xb2d17f2e
3.48,1.0,52,1,2,2,5,0xb2d6b5ea
664032.15,6.0,1,4,4,4,12,0xb2d3c7f5d
1254011.76,10.0,3,4,4,4,12,0xb2d17ba6
370844.44,2.0,0,4,3,4,11,0xb2d6058c
585.47,1.0,0,1,2,4,7,0xb2d6faa3
306079.51,8.0,1,4,4,4,12,0xb2d5b1b8d
2.09,1.0,26,1,2,2,5,0xb2d6d37d
688139.42,5.0,4,4,4,4,12,0xb2d61390d
9634.92,1.0,92,2,2,1,5,0xb2d377b9
2126.7,1.0,134,1,2,1,4,0xb2d4066b
15162.12,1.0,184,2,2,1,5,0xb2d5c9b0d
500000.04,2.0,5,4,3,3,10,0xb2d9fe56
3000000.0,2.0,33,4,3,2,9,0xb2d649abd
716794.51,8.0,0,4,4,4,12,0xb2d28f5a
218929.95,2.0,8,3,3,3,9,0xb2d350d2
508886.74,2.0,111,4,3,1,8,0xb2d8db1f
145005.92,6.0,62,3,4,2,9,0xb2d5378f
517000.64,11.0,3,4,4,4,12,0xb2d52b75
2996.72,1.0,10,2,2,3,7,0xb2d0a816d
97712.69,1.0,70,3,2,1,6,0xb2d5fbbc
326.1,1.0,12,1,2,3,6,0xb2d15855
6742.86,1.0,13,2,2,3,7,0xb2d6fadd
0.0,1.0,2,1,2,4,7,0xb2d8e2a0d
116543.71,2.0,10,3,3,3,9,0xb2d4391c
401033.51,3.0,2,4,4,4,12,0xb2d59882
200000.0,2.0,12,3,3,3,9,0xb2d95fd9d
450.91,1.0,10,1,2,3,6,0xb2d24f6f
19328.13,1.0,0,2,2,4,8,0xb2d53056
100001.06,2.0,118,3,3,1,7,0xb2d782fd
130004.12,2.0,18,3,3,2,8,0xb2da26dc
690080.55,5.0,52,4,4,2,10,0xb2d2ac56d
1318.73,1.0,184,1,2,1,4,0xb2d10ee3d
2674207.24,7.0,18,4,4,2,10,0xb2d37541d
204947.62,6.0,1,3,4,4,11,0xb2d576cd
7079.55,1.0,184,2,2,1,5,0xb2d0cbe0
40040.37,2.0,58,2,3,2,7,0xb2d61627
112.55,1.0,47,1,2,2,5,0xb2d8f8f6
312136.54,2.0,12,4,3,3,10,0xb2d9aff4
3587.02,1.0,184,2,2,1,5,0xb2d2f3d4
2377.9,1.0,3,1,2,4,7,0xb2d12611d
16205.72,1.0,28,2,2,2,6,0xb2d6c621
6135.0,1.0,0,2,2,4,8,0xb2d3f2b4
955307.52,6.0,41,4,4,2,10,0xb2d14809
64.76,1.0,98,1,2,1,4,0xb2d5f9a6
10000.0,2.0,50,2,3,2,7,0xb2d9d806
960581.89,5.0,27,4,4,2,10,0xb2d4a263d
21001.12,2.0,202,2,3,1,6,0xb2d60c65d
284172.68,5.0,22,3,4,2,9,0xb2d551bf
13690.93,1.0,184,2,2,1,5,0xb2d102ec
0.06,1.0,6,1,2,3,6,0xb2d1febfd
1481.66,2.0,139,1,3,1,5,0xb2d08255
0.0,1.0,3,1,2,4,7,0xb2d954dc
500000.08,2.0,10,4,3,3,10,0xb2d9a85b
5890386.22,2.0,46,4,3,2,9,0xb2d4e936d
2585.81,1.0,98,1,2,1,4,0xb2d32c91
300090.8,4.0,3,3,4,4,11,0xb2d30589
28.9,1.0,72,1,2,1,4,0xb2d63ed1d
620118.3,3.0,117,4,4,1,9,0xb2d3ce18
200009.59,5.0,27,3,4,2,9,0xb2d4f875d
10511.5,1.0,3,2,2,4,8,0xb2d34552d
440996.13,2.0,19,4,3,2,9,0xb2d11176
44542.37,2.0,50,2,3,2,7,0xb2d5d0b0d
408000.0,6.0,4,4,4,4,12,0xb2d54ff0d
11319.77,1.0,0,2,2,4,8,0xb2d500a8
49.42,1.0,49,1,2,2,5,0xb2d3f0ce
50004.75,2.0,83,2,3,1,6,0xb2d98490
6598099.81,4.0,4,4,4,4,12,0xb2d163fad
345017.79,4.0,6,4,4,3,11,0xb2d533ab
2877.02,2.0,184,1,3,1,5,0xb2d23f9c
501974.54,3.0,41,4,4,2,10,0xb2d3ae14
400810.75,3.0,11,4,4,3,11,0xb2d16c57
85037.58,2.0,55,3,3,2,8,0xb2d5b1ced
275301.6,9.0,0,3,4,4,11,0xb2d17989
3260.45,1.0,11,2,2,3,7,0xb2d8f868
3000.78,1.0,0,2,2,4,8,0xb2d78330
779008.58,12.0,0,4,4,4,12,0xb2d61052
12662.57,1.0,0,2,2,4,8,0xb2d6111ad
401.85,1.0,6,1,2,3,6,0xb2da1b85
31.49,1.0,5,1,2,3,6,0xb2d38b35
8081.34,1.0,2,2,2,4,8,0xb2d9af66
500154.12,3.0,7,4,4,3,11,0xb2d8e94d
18989.71,1.0,3,2,2,4,8,0xb2d1a84b
40000.42,2.0,67,2,3,1,6,0xb2d9af85
303095.39,4.0,54,4,4,2,10,0xb2d25b48d
11056.78,2.0,0,2,3,4,9,0xb2d5cb2a
160252.46,2.0,0,3,3,4,10,0xb2d22ca0
420512.85,4.0,19,4,4,2,10,0xb2d5d7f8
302229.47,2.0,62,4,3,2,9,0xb2d6b5d0d
102252.2,1.0,7,3,2,3,8,0xb2d29781d
1440.41,1.0,9,1,2,3,6,0xb2d3ef51d
224006.87,8.0,12,3,4,3,10,0xb2d24dc8d
9276.42,1.0,166,2,2,1,5,0xb2d0f67f
9558.48,2.0,9,2,3,3,8,0xb2d3ec92d
136051.61,9.0,20,3,4,2,9,0xb2d2a2ddd
130048.89,8.0,7,3,4,3,10,0xb2d5747e
3.69,1.0,25,1,2,2,5,0xb2d93eca
0.55,1.0,22,1,2,2,5,0xb2d4cda0
42.95,1.0,90,1,2,1,4,0xb2d378ccd
79282.53,1.0,1,3,2,4,9,0xb2d8c4fc
20889.42,1.0,147,2,2,1,5,0xb2d58c4a
250071.93,4.0,48,3,4,2,9,0xb2d600b9d
339031.22,4.0,52,4,4,2,10,0xb2d13892
400002.11,3.0,13,4,4,3,11,0xb2da3d69
271103.19,4.0,22,3,4,2,9,0xb2d637a4
570090.02,4.0,101,4,4,1,9,0xb2d57a35d
419204.66,3.0,4,4,4,4,12,0xb2d5e5f3d
51449.33,4.0,0,2,4,4,10,0xb2d3acbbd
200973.75,2.0,39,3,3,2,8,0xb2d6f989
2500775.03,10.0,26,4,4,2,10,0xb2d160aad
70.87,1.0,0,1,2,4,7,0xb2d908e9
2296.96,3.0,0,1,4,4,9,0xb2d2394cd
204022.37,2.0,61,3,3,2,8,0xb2d6ce16d
48.42,1.0,28,1,2,2,5,0xb2d3f00a
9496.67,1.0,28,2,2,2,6,0xb2d3811fd
500000.0,3.0,8,4,4,3,11,0xb2d6f211
159636.73,1.0,6,3,2,3,8,0xb2da0e49
20000.42,2.0,21,2,3,2,7,0xb2d538c5
212690.05,2.0,1,3,3,4,10,0xb2d11301d
1868.26,2.0,92,1,3,1,5,0xb2d391ced
540102.81,1.0,27,4,2,2,8,0xb2d9e66b
2727.82,1.0,2,1,2,4,7,0xb2d579cbd
36752.61,2.0,1,2,3,4,9,0xb2d61395
15460.64,1.0,32,2,2,2,6,0xb2d9917a
110468.32,3.0,47,3,4,2,9,0xb2d2e867d
6202.67,1.0,6,2,2,3,7,0xb2d833afd
0.0,3.0,10,1,4,3,8,0xb2d0c1d1d
358626.6,6.0,60,4,4,2,10,0xb2d23362d
395.85,1.0,77,1,2,1,4,0xb2d28eb2
1354795.62,3.0,16,4,4,2,10,0xb2d91c0a
300006.33,2.0,74,3,3,1,7,0xb2d98b51
23.96,1.0,88,1,2,1,4,0xb2d64454
496.66,2.0,3,1,3,4,8,0x3b9b2570d
61203.56,2.0,263,3,3,1,7,0xb2d07aabd
1002.31,1.0,92,1,2,1,4,0xb2d5cf71d
210430.78,3.0,0,3,4,4,11,0xb2d69b52d
1019.25,1.0,0,1,2,4,7,0xb2d6c06fd
5850.48,1.0,184,2,2,1,5,0xb2d2e783
235114.75,2.0,17,3,3,2,8,0xb2d91584d
96191.0,2.0,249,3,3,1,7,0xb2d2cdecd
21879.19,1.0,70,2,2,1,5,0xb2d340d6d
312896.16,6.0,6,4,4,3,11,0xb2d58151
2.11,1.0,18,1,2,2,5,0xb2da3123
420376.53,4.0,0,4,4,4,12,0xb2d60f4fd
459.27,2.0,7,1,3,3,7,0xb2d2d84c
153.58,1.0,17,1,2,2,5,0xb2d11387
4601.18,2.0,0,2,3,4,9,0xb2d209e3
17748.03,1.0,20,2,2,2,6,0xb2d45cd4
2786.07,1.0,5,1,2,3,6,0xb2d6a10dd
449603.05,2.0,6,4,3,3,10,0xb2d29298
1880.37,1.0,184,1,2,1,4,0xb2d34a37d
2001.48,1.0,80,1,2,1,4,0xb2d992be
853806.16,5.0,4,4,4,4,12,0xb2d1ddbe
1011.78,1.0,92,1,2,1,4,0xb2d2228f
74379.17,1.0,4,3,2,4,9,0xb2d7b024
65003.43,2.0,63,3,3,2,8,0xb2d9ade7
70854.25,3.0,182,3,4,1,8,0xb2d60405d
3988.84,1.0,184,2,2,1,5,0xb2d1671fd
500000.08,2.0,15,4,3,3,10,0xb2d9871f
8224.32,1.0,21,2,2,2,6,0xb2d963ba
6443.68,1.0,3,2,2,4,8,0xb2d0c9e1
71028.1,3.0,1,3,4,4,11,0xb2d4ba82d
4408.03,1.0,92,2,2,1,5,0xb2d273f1d
1133.99,1.0,92,1,2,1,4,0xb2d1580f
60032.74,2.0,24,3,3,2,8,0xb2d59c28
36307.55,1.0,0,2,2,4,8,0xb2d57614d
16092.54,1.0,5,2,2,3,7,0xb2d9453a
173.17,1.0,7,1,2,3,6,0xb2d6dc4c
3222.31,1.0,10,2,2,3,7,0xb2d2e61dd
50.62,1.0,81,1,2,1,4,0xb2d490ac
440016.28,4.0,16,4,4,2,10,0xb2d07daf
462013.77,5.0,101,4,4,1,9,0xb2d6afe1d
52018.53,2.0,62,2,3,2,7,0xb2d42430d
25.35,1.0,44,1,2,2,5,0xb2d0e9dcd
130006.51,2.0,77,3,3,1,7,0xb2d5e80b
4771.7,1.0,46,2,2,2,6,0xb2d99110
100100.0,1.0,0,3,2,4,9,0xb2da3551
175921.07,3.0,0,3,4,4,11,0xb2d09751
1324.96,2.0,9,1,3,3,7,0xb2d267b5d
500553.18,2.0,15,4,3,3,10,0xb2d8c68f
203090.78,2.0,179,3,3,1,7,0xb2d45f42
6.56,1.0,4,1,2,4,7,0xb2d27184d
265255.5,2.0,60,3,3,2,8,0xb2d4f29ad
28710.74,1.0,22,2,2,2,6,0xb2d577a4
50002.11,2.0,60,2,3,2,7,0xb2d69c51
0.0,2.0,4,1,3,4,8,0xb2d06cc8
67817.48,2.0,14,3,3,3,9,0xb2d55e49d
50356.1,3.0,200,2,4,1,7,0x3b9b3aabd
1076.66,1.0,302,1,2,1,4,0xb2d2301cd
560017.25,7.0,81,4,4,1,9,0xb2d25692
5915.52,1.0,0,2,2,4,8,0xb2d745f7
800048.07,3.0,6,4,4,3,11,0xb2d53d62
10443.86,1.0,0,2,2,4,8,0xb2d8c621
1354.44,1.0,202,1,2,1,4,0xb2d0d271d
580296.51,6.0,0,4,4,4,12,0xb2d7814f
690955.13,3.0,124,4,4,1,9,0xb2d20513
4.05,1.0,46,1,2,2,5,0xb2d0f578
40000.0,4.0,4,2,4,4,10,0xb2d6cf93
34000.4,3.0,0,2,4,4,10,0xb2d5c671
2676014.89,2.0,87,4,3,1,8,0xb2d25685d
69.12,1.0,81,1,2,1,4,0xb2d1f886
531882.6,2.0,32,4,3,2,9,0xb2d93d1ed
5043.45,1.0,92,2,2,1,5,0xb2d2f02c
739.34,1.0,1,1,2,4,7,0xb2d58d14
58.0,1.0,4,1,2,4,7,0xb2d357d2
8034.23,1.0,5,2,2,3,7,0xb2d4adfe
230039.22,4.0,0,3,4,4,11,0xb2d5fd91d
9476.35,1.0,0,2,2,4,8,0xb2d6fd85
1091078.33,12.0,11,4,4,3,11,0xb2d680a3
64498.13,1.0,19,3,2,2,7,0xb2d2ec52
106.35,1.0,40,1,2,2,5,0xb2d782cf
210001.49,3.0,139,3,4,1,8,0xb2d63b63d
169801.73,1.0,1,3,2,4,9,0xb2d9fde9
400000.0,3.0,5,4,4,3,11,0xb2d9fa54
51734.79,2.0,53,2,3,2,7,0xb2d6474ad
8086.49,1.0,246,2,2,1,5,0xb2d4fdecd
441243.66,18.0,0,4,4,4,12,0xb2d0e26b
1299.26,1.0,184,1,2,1,4,0xb2d147cd
100008.44,2.0,20,3,3,2,8,0xb2d8daf2d
1292.11,1.0,2,1,2,4,7,0xb2d22b26d
61.35,1.0,39,1,2,2,5,0xb2d392a1
220008.11,3.0,18,3,4,2,9,0xb2d11952
140031.73,6.0,11,3,4,3,10,0xb2d074c3d
30.67,1.0,36,1,2,2,5,0xb2d9e09f
77.11,1.0,0,1,2,4,7,0xb2d43149
60810.27,2.0,92,3,3,1,7,0x3b9b41c0
10129.95,1.0,184,2,2,1,5,0xb2d24aaad
147.04,1.0,12,1,2,3,6,0xb2d588bb
255575.63,8.0,0,3,4,4,11,0xb2d50501d
10400.72,1.0,0,2,2,4,8,0xb2d706ed
25592.93,1.0,1,2,2,4,8,0xb2d33db4d
306434.68,4.0,60,4,4,2,10,0xb2d64eefd
50875.86,1.0,0,2,2,4,8,0xb2d38e69
6639.61,1.0,5,2,2,3,7,0xb2d6f1ee
320053.58,3.0,1,4,4,4,12,0xb2d8fa79
26013.56,1.0,0,2,2,4,8,0xb2d6b6c8
53.82,1.0,11,1,2,3,6,0xb2d292b0
43202.1,6.0,0,2,4,4,10,0xb2d0bf4ad
240000.0,2.0,8,3,3,3,9,0xb2d68b59
50008.16,2.0,95,2,3,1,6,0xb2d6309b
344.21,1.0,10,1,2,3,6,0xb2d77fcb
4172.93,1.0,184,2,2,1,5,0xb2d0afb1d
10015.24,1.0,22,2,2,2,6,0xb2d53cb5
1250049.16,5.0,0,4,4,4,12,0xb2d55d80d
45436.43,1.0,12,2,2,3,7,0xb2d31fb1
100285.62,2.0,22,3,3,2,8,0xb2d288af
2492.05,1.0,9,1,2,3,6,0xb2d4585d
6011.2,2.0,16,2,3,2,7,0xb2d262fad
1007.05,1.0,92,1,2,1,4,0xb2d530ee
401652.81,2.0,54,4,3,2,9,0xb2d9cf3e
20000.37,3.0,0,2,4,4,10,0xb2d8ce95d
10164.36,1.0,13,2,2,3,7,0xb2d29a5ed
10298.05,1.0,74,2,2,1,5,0xb2d67cbe
726345.35,6.0,8,4,4,3,11,0xb2d3048ad
641.32,1.0,0,1,2,4,7,0xb2d1eac8
1000052.65,2.0,21,4,3,2,9,0xb2d64bd5
300033.08,3.0,101,3,4,1,8,0xb2d08a51d
280000.54,5.0,4,3,4,4,11,0xb2d175a7d
500000.0,2.0,6,4,3,3,10,0xb2d2a37d
412000.0,12.0,4,4,4,4,12,0xb2d5c4d1
591.6,3.0,0,1,4,4,9,0xb2d0bf3f
100000.16,2.0,6,3,3,3,9,0xb2da2536
6827.49,1.0,92,2,2,1,5,0xb2d2e124d
1450101.36,3.0,28,4,4,2,10,0xb2d491a1d
808430.75,15.0,4,4,4,4,12,0xb2d4f036d
30719.96,2.0,10,2,3,3,8,0xb2d14fd0
600139.14,4.0,4,4,4,4,12,0xb2d39ef6d
0.0,1.0,6,1,2,3,6,0xb2d96326
500003.06,3.0,18,4,4,2,10,0xb2d60cfa
250713.06,3.0,32,3,4,2,9,0xb2d9fddd
7082.77,1.0,9,2,2,3,7,0xb2d8b3c1
1.1,1.0,88,1,2,1,4,0xb2d59518
15545.04,2.0,31,2,3,2,7,0xb2d5aad7
551285.84,5.0,6,4,4,3,11,0xb2d07a20d
3000.38,2.0,184,2,3,1,6,0x3b9b16b2d
703033.75,3.0,51,4,4,2,10,0xb2d239a9
60459.35,3.0,6,3,4,3,10,0xb2d4b9e7d
500021.72,11.0,14,4,4,3,11,0xb2d1b8e1d
260967.49,2.0,36,3,3,2,8,0xb2d605f4
401441.66,2.0,30,4,3,2,9,0xb2d9c36f
829297.89,3.0,62,4,4,2,10,0xb2d43631
194570.6,4.0,0,3,4,4,11,0xb2d0dda3
11.73,1.0,20,1,2,2,5,0xb2d2fcd2
355279.16,3.0,7,4,4,3,11,0xb2d6427dd
70001.38,3.0,45,3,4,2,9,0xb2d8c86d
550005.81,2.0,95,4,3,1,8,0xb2d96e81
95.8,1.0,5,1,2,3,6,0xb2d929f6
51056.5,3.0,46,2,4,2,8,0xb2d6c7e4d
4847.2,1.0,0,2,2,4,8,0xb2d6edad
2876.39,1.0,0,1,2,4,7,0xb2d70016
512449.31,2.0,30,4,3,2,9,0xb2d656ea
174.08,1.0,3,1,2,4,7,0xb2d3873e
1296.82,1.0,116,1,2,1,4,0xb2d5edbbd
352.53,1.0,7,1,2,3,6,0xb2d1722e
617326.35,8.0,11,4,4,3,11,0xb2d26cfc
1314015.51,4.0,8,4,4,3,11,0x3b9b2e33d
201660.9,2.0,17,3,3,2,8,0xb2d68d22
320901.85,1.0,7,4,2,3,9,0xb2d40174
1710.19,1.0,0,1,2,4,7,0xb2d2c67cd
282.67,1.0,18,1,2,2,5,0xb2d38eac
6056.57,1.0,184,2,2,1,5,0xb2d4118b
583036.64,4.0,34,4,4,2,10,0xb2d690cad
269019.94,2.0,122,3,3,1,7,0xb2d3ae0b
455815.65,1.0,8,4,2,3,9,0xb2d2127f
847430.41,5.0,6,4,4,3,11,0xb2d24d7c
50462.04,8.0,4,2,4,4,10,0xb2d19f0c
53.19,1.0,4,1,2,4,7,0xb2d9344fd
5035.21,1.0,184,2,2,1,5,0xb2d410ebd
308209.75,2.0,48,4,3,2,9,0xb2d6cee6d
70302.62,2.0,44,3,3,2,8,0xb2d3e734
13334.8,1.0,0,2,2,4,8,0xb2d62367d
50686.76,1.0,184,2,2,1,5,0xb2d1d8a0d
6323.9,1.0,10,2,2,3,7,0xb2d5d2aed
19079.78,1.0,57,2,2,2,6,0xb2d26dc6d
2651.26,1.0,7,1,2,3,6,0xb2d6f17c
207068.22,2.0,80,3,3,1,7,0xb2d6b6a1
319954.2,1.0,77,4,2,1,7,0xb2d433ca
307353.97,3.0,69,4,4,1,9,0xb2d479a1
3002.63,1.0,93,2,2,1,5,0xb2d9824c
452414.29,3.0,54,4,4,2,10,0xb2d13b28d
283037.01,2.0,13,3,3,3,9,0xb2d1af49
348740.65,4.0,1,4,4,4,12,0xb2d5ee06d
20000.63,2.0,80,2,3,1,6,0xb2d8d21a
319421.98,3.0,63,4,4,2,10,0xb2d18b95d
100001.06,2.0,74,3,3,1,7,0xb2d9a014
23513.95,1.0,0,2,2,4,8,0xb2d6ecc0
1200250.12,2.0,9,4,3,3,10,0xb2d92bf2
1406.84,1.0,0,1,2,4,7,0xb2d55acc
8.24,1.0,59,1,2,2,5,0xb2d8e1d9
553988.02,4.0,52,4,4,2,10,0xb2d5d723
18817.67,1.0,21,2,2,2,6,0xb2d9640d
5157.68,1.0,27,2,2,2,6,0xb2d3e93bd
2266.0,1.0,92,1,2,1,4,0xb2d1b42ad
30335.11,1.0,7,2,2,3,7,0xb2d50da0
426816.8,3.0,24,4,4,2,10,0xb2d26eae
16.06,1.0,0,1,2,4,7,0xb2d6bcfcd
231560.08,2.0,0,3,3,4,10,0xb2d1dc51
4202.21,1.0,9,2,2,3,7,0xb2d3e0b9
22.15,1.0,10,1,2,3,6,0xb2d5a5a6
304931.13,2.0,136,4,3,1,8,0xb2d6340fd
1261.52,1.0,184,1,2,1,4,0xb2d15b54
213225.7,8.0,11,3,4,3,10,0xb2d29ca7d
24067.49,1.0,1,2,2,4,8,0xb2d59911d
4959.03,1.0,11,2,2,3,7,0xb2d3151f
202887.95,2.0,11,3,3,3,9,0xb2d58e3a
4.44,5.0,1,1,4,4,9,0xb2da49fb
149261.63,1.0,2,3,2,4,9,0xb2d3155dd
33.12,1.0,6,1,2,3,6,0xb2d931a8
200000.0,2.0,12,3,3,3,9,0xb2d956e4d
152010.93,3.0,0,3,4,4,11,0xb2d1d906d
2471.91,1.0,0,1,2,4,7,0xb2d8db3c
68060.03,2.0,172,3,3,1,7,0xb2d11f90
17479.25,1.0,5,2,2,3,7,0xb2d29d22
3913.61,1.0,1,2,2,4,8,0xb2d5e526
1510.3,2.0,0,1,3,4,8,0xb2d070d1d
459.35,1.0,0,1,2,4,7,0xb2d0ad94d
101760.0,1.0,0,3,2,4,9,0xb2d97e80
640068.96,9.0,5,4,4,3,11,0xb2d231ced
239890.59,4.0,0,3,4,4,11,0xb2d17989d
742203.74,5.0,1,4,4,4,12,0xb2d3177dd
372.9,1.0,14,1,2,3,6,0xb2d64a92
10000.11,2.0,21,2,3,2,7,0xb2da20c2
100311.49,4.0,0,3,4,4,11,0xb2d54c6bd
1500000.0,1.0,0,4,2,4,10,0xb2d97694
10043.18,2.0,18,2,3,2,7,0xb2d3ce33
6.46,1.0,77,1,2,1,4,0xb2d5fa99
40006.21,2.0,108,2,3,1,6,0xb2d15776
40002.73,2.0,144,2,3,1,6,0xb2d5ce2e
70099.94,2.0,136,3,3,1,7,0xb2d63b10
7019.29,1.0,211,2,2,1,5,0xb2d2763ad
15437.91,1.0,3,2,2,4,8,0xb2d64b9dd
524.97,1.0,28,1,2,2,5,0xb2d26667d
4366.9,1.0,10,2,2,3,7,0xb2d5d4bc
159.52,2.0,60,1,3,2,6,0xb2d9a68f
50600.77,3.0,0,2,4,4,10,0x3b9b1862
5.11,1.0,9,1,2,3,6,0xb2d99cc2
345321.56,3.0,0,4,4,4,12,0xb2d2b423d
2037.34,1.0,7,1,2,3,6,0xb2d8e465d
3924443.26,17.0,0,4,4,4,12,0xb2d19ad9
350100.72,1.0,24,4,2,2,8,0xb2da1301
40082.85,2.0,182,2,3,1,6,0xb2d5e197
42675.75,4.0,0,2,4,4,10,0xb2d2e109
96.3,1.0,25,1,2,2,5,0xb2d3aaaa
501990.78,7.0,0,4,4,4,12,0xb2d2756b
383101.84,2.0,125,4,3,1,8,0xb2d1e193d
0.33,1.0,92,1,2,1,4,0xb2d44bf8d
485111.68,1.0,0,4,2,4,10,0xb2d5293b
600223.82,4.0,22,4,4,2,10,0xb2d6e857d
1366.24,1.0,15,1,2,3,6,0xb2d509a1
1200000.0,4.0,14,4,4,3,11,0xb2da2652
2764.35,1.0,8,1,2,3,6,0xb2d2a052
200042.04,2.0,13,3,3,3,9,0xb2d6f989d
777840.72,7.0,0,4,4,4,12,0x3b9af10b
151751.78,2.0,136,3,3,1,7,0xb2d43910d
3617.66,1.0,0,2,2,4,8,0xb2d5bd5d
116509.98,5.0,0,3,4,4,11,0xb2d0ab05d
204978.31,2.0,22,3,3,2,8,0xb2d6edfad
250008.7,2.0,9,3,3,3,9,0xb2d610b0d
200000.0,2.0,1,3,3,4,10,0xb2d9780c
200001.36,2.0,181,3,3,1,7,0xb2d3346dd
129.24,1.0,21,1,2,2,5,0xb2d65970d
1631502.55,6.0,182,4,4,1,9,0xb2d48cd3d
351.0,1.0,1,1,2,4,7,0xb2d34771
73869.04,5.0,0,3,4,4,11,0xb2d17c32d
519620.79,3.0,14,4,4,3,11,0xb2d11731d
950201.69,2.0,13,4,3,3,10,0xb2d1f3d2d
200046.55,1.0,30,3,2,2,7,0xb2d93d5c
671011.32,2.0,0,4,3,4,11,0xb2d187eb
194877.11,3.0,66,3,4,2,9,0xb2d6a8da
164223.56,3.0,73,3,4,1,8,0xb2d53018
59.84,2.0,0,1,3,4,8,0x3b9b3dea
399140.27,2.0,66,4,3,2,9,0xb2d5b0ccd
2.32,1.0,12,1,2,3,6,0xb2d958dbd
1031.7,1.0,194,1,2,1,4,0xb2d36559d
114000.65,2.0,1,3,3,4,10,0xb2d51fd4
710124.3,3.0,74,4,4,1,9,0xb2d1e5a4
50001.69,2.0,11,2,3,3,8,0xb2d9d4b4
246.92,2.0,6,1,3,3,7,0xb2d3f9c3d
51402.35,2.0,94,2,3,1,6,0xb2d879a9
1000000.0,2.0,6,4,3,3,10,0xb2da5414
1000005.42,1.0,0,4,2,4,10,0xb2d58dc4
504502.61,8.0,3,4,4,4,12,0xb2d6a0b3d
67039.69,1.0,1,3,2,4,9,0xb2d651bf
500000.0,8.0,1,4,4,4,12,0xb2d14f9a
13380.54,2.0,39,2,3,2,7,0xb2d5eddd
30956.88,1.0,1,2,2,4,8,0xb2d6b557d
1733.54,1.0,184,1,2,1,4,0xb2d0c9c3d
28.57,2.0,27,1,3,2,6,0xb2d17813
1066.35,1.0,92,1,2,1,4,0xb2d378b9d
2047361.24,9.0,0,4,4,4,12,0xb2d5ac54d
702983.5,4.0,0,4,4,4,12,0xb2d55a31
2908.04,2.0,92,2,3,1,6,0x3b9b2396d
15656.34,1.0,9,2,2,3,7,0xb2d8eb43
311738.82,4.0,26,4,4,2,10,0xb2d5cef9
200000.0,2.0,18,3,3,2,8,0xb2da358e
4021.07,1.0,119,2,2,1,5,0xb2d112c7d
1064.02,4.0,92,1,4,1,6,0x3b9af1f1
463022.42,6.0,19,4,4,2,10,0xb2d3d2ae
2096.15,1.0,27,1,2,2,5,0xb2d53a44
20800.13,1.0,26,2,2,2,6,0xb2d9066e
61691.08,1.0,104,3,2,1,6,0xb2d4baa8
568639.79,4.0,0,4,4,4,12,0xb2d421cd
474000.38,6.0,2,4,4,4,12,0xb2d5e3d1
257807.17,2.0,21,3,3,2,8,0xb2d35df4
325076.41,4.0,6,4,4,3,11,0xb2d40f3dd
116581.0,6.0,0,3,4,4,11,0xb2d33917
872042.66,7.0,10,4,4,3,11,0xb2d656d0d
64171.61,39.0,0,3,4,4,11,0x3b9af28c
3639.86,1.0,40,2,2,2,6,0xb2d9dedf
7317.54,2.0,6,2,3,3,8,0xb2d0fd98
9992.03,1.0,177,2,2,1,5,0xb2d8cebc
5707.14,1.0,23,2,2,2,6,0xb2d70095d
521478.11,3.0,26,4,4,2,10,0xb2d24782d
160004.01,3.0,74,3,4,1,8,0xb2d96134d
91.82,1.0,19,1,2,2,5,0xb2d236f6
1178.18,1.0,92,1,2,1,4,0xb2d20af7d
160145.77,1.0,0,3,2,4,9,0xb2d5387ed
8803.89,1.0,1,2,2,4,8,0xb2d434d9
759.63,1.0,10,1,2,3,6,0xb2d939c0
6808.44,1.0,11,2,2,3,7,0xb2d6866f
2213.71,1.0,58,1,2,2,5,0xb2d5ef37
502.7,1.0,4,1,2,4,7,0xb2d294ba
0.68,1.0,0,1,2,4,7,0xb2d1bfa2
150076.43,2.0,97,3,3,1,7,0xb2d282a0d
1918.72,1.0,92,1,2,1,4,0xb2d1d323d
1360158.79,5.0,1,4,4,4,12,0xb2d63712d
400044.27,2.0,0,4,3,4,11,0xb2d5ab6e
1990006.67,11.0,0,4,4,4,12,0xb2d22064
523.41,1.0,72,1,2,1,4,0xb2d8a9ea
736.54,1.0,10,1,2,3,6,0xb2d93fa1
21565.32,1.0,9,2,2,3,7,0xb2d7842dd
100001.05,4.0,0,3,4,4,11,0xb2d78e89
11199.27,2.0,171,2,3,1,6,0xb2d3fa9ad
2381.17,1.0,92,1,2,1,4,0xb2d3004a
6.29,1.0,0,1,2,4,7,0xb2d557ebd
15284.26,1.0,188,2,2,1,5,0xb2d5eab9d
126.67,1.0,19,1,2,2,5,0xb2da04cb
2651.45,1.0,19,1,2,2,5,0xb2d1fb7a
120012.56,3.0,95,3,4,1,8,0xb2d62b14
564499.25,8.0,1,4,4,4,12,0xb2d37b56
959311.87,4.0,32,4,4,2,10,0xb2d19903d
244193.84,2.0,1,3,3,4,10,0xb2d62d01
57007.63,6.0,31,3,4,2,9,0xb2d1ab2bd
3268.24,1.0,10,2,2,3,7,0xb2d95611
23339.4,1.0,228,2,2,1,5,0xb2d61e85
2189.67,1.0,116,1,2,1,4,0xb2d45b1fd
729.37,1.0,9,1,2,3,6,0xb2d60c3a
10043.13,1.0,92,2,2,1,5,0xb2d53ca0d
120001.29,7.0,7,3,4,3,10,0xb2d88007
201005.38,2.0,16,3,3,2,8,0xb2d69b28
71195.75,2.0,182,3,3,1,7,0xb2d62383d
706.31,1.0,19,1,2,2,5,0xb2d19dc5
235732.84,5.0,0,3,4,4,11,0xb2d96fc1
10000.11,2.0,8,2,3,3,8,0xb2da4b2d
333944.07,17.0,0,4,4,4,12,0xb2d1ceb5
6.71,1.0,12,1,2,3,6,0xb2d95e9dd
370726.13,4.0,29,4,4,2,10,0xb2d8fc87
18527.54,1.0,25,2,2,2,6,0xb2d6c262
14012.06,2.0,139,2,3,1,6,0xb2d2466a
170603.89,1.0,184,3,2,1,6,0xb2d3a183
83.96,1.0,92,1,2,1,4,0xb2d22b38d
270026.2,3.0,32,3,4,2,9,0x3b9b454cd
503316.4,1.0,0,4,2,4,10,0xb2d8827b
80017.23,1.0,1,3,2,4,9,0xb2d93f2cd
100000.0,1.0,0,3,2,4,9,0xb2da69bf
60000.63,2.0,10,3,3,3,9,0xb2d9698a
1580.09,1.0,9,1,2,3,6,0xb2d5cfaad
520000.71,4.0,0,4,4,4,12,0xb2d614d9
104466.88,1.0,0,3,2,4,9,0xb2d5358e
12312.53,1.0,77,2,2,1,5,0xb2d1e62fd
2150.36,1.0,3,1,2,4,7,0xb2d5a5ca
60123.36,2.0,103,3,3,1,7,0xb2d5957b
15877.71,1.0,0,2,2,4,8,0xb2d6e922
556409.54,5.0,34,4,4,2,10,0xb2d6ce2fd
37035.18,1.0,6,2,2,3,7,0xb2d56b94
4864.65,1.0,7,2,2,3,7,0xb2d258afd
66001655.9,6.0,6,4,4,3,11,0xb2d511e1d
33.28,1.0,8,1,2,3,6,0xb2d7e2e2
620906.73,7.0,33,4,4,2,10,0xb2d574d0d
40043.87,2.0,14,2,3,3,8,0xb2d65a0c
408.73,1.0,20,1,2,2,5,0xb2d205f2d
2254.83,2.0,0,1,3,4,8,0xb2d3281a
1400014.78,3.0,66,4,4,2,10,0xb2d89034d
209360.23,2.0,143,3,3,1,7,0xb2d108f7d
120203.82,2.0,92,3,3,1,7,0xb2d3c13ad
273017.64,5.0,0,3,4,4,11,0xb2d24115
72466.16,2.0,182,3,3,1,7,0xb2d4971bd
397092.28,11.0,1,4,4,4,12,0xb2d64816d
1882254.48,5.0,1,4,4,4,12,0xb2d0a23cd
112580.07,2.0,0,3,3,4,10,0xb2d51e3fd
1722083.42,12.0,0,4,4,4,12,0xb2d09ff7
418.89,1.0,17,1,2,2,5,0xb2d236af
175.26,2.0,18,1,3,2,6,0xb2d262bcd
360169.46,2.0,19,4,3,2,9,0xb2d49056
76.43,1.0,28,1,2,2,5,0xb2d683b4
680053.24,5.0,90,4,4,1,9,0xb2d28c70
717247.73,5.0,9,4,4,3,11,0xb2d3e857d
62476.31,1.0,174,3,2,1,6,0xb2d2b06fd
24.85,1.0,42,1,2,2,5,0xb2d698bd
59095.54,3.0,45,3,4,2,9,0xb2d14036d
474329.27,2.0,0,4,3,4,11,0xb2d38aaf
2010374.19,1.0,5,4,2,3,9,0xb2d3285b
1782.96,1.0,4,1,2,4,7,0xb2d6f4a1
1863.5,1.0,92,1,2,1,4,0xb2d34606d
570000.0,5.0,6,4,4,3,11,0xb2d2bc40d
1064.8,1.0,9,1,2,3,6,0xb2d23e4cd
350823.43,3.0,35,4,4,2,10,0xb2d6f8ae
186428.18,7.0,4,3,4,4,11,0xb2d52ed2
350944.57,2.0,0,4,3,4,11,0xb2d3eaed
201421.22,2.0,82,3,3,1,7,0xb2d98ce6
18.02,1.0,63,1,2,2,5,0xb2d9450a
60758.41,2.0,6,3,3,3,9,0xb2d6cf1bd
375000.0,2.0,22,4,3,2,9,0xb2da2004
830199.86,2.0,80,4,3,1,8,0xb2d29632
2339.1,1.0,184,1,2,1,4,0xb2d13019
4272.97,1.0,62,2,2,2,6,0xb2d33b68d
36128.78,1.0,11,2,2,3,7,0xb2d264b0
0.0,1.0,5,1,2,3,6,0xb2d59766
2000046.32,3.0,95,4,4,1,9,0xb2d2741b
510044.27,2.0,9,4,3,3,10,0xb2d909eb
5059.64,1.0,3,2,2,4,8,0xb2d940df
2844.87,1.0,0,1,2,4,7,0xb2d599d4
16.94,1.0,19,1,2,2,5,0xb2d9977c
380022.94,5.0,70,4,4,1,9,0xb2d1fc77d
105500.52,3.0,157,3,4,1,8,0xb2d39a3e
704875.44,6.0,3,4,4,4,12,0xb2d43565
86197.53,3.0,7,3,4,3,10,0xb2d07df9d
182.88,1.0,9,1,2,3,6,0xb2d8eb6f
13409.95,1.0,4,2,2,4,8,0xb2d420eed
900092.23,3.0,182,4,4,1,9,0xb2d55c18d
183039.66,6.0,27,3,4,2,9,0xb2d29fbd
7214.24,2.0,92,2,3,1,6,0xb2d145fcd
500000.0,2.0,4,4,3,4,11,0xb2d36cddd
140043.71,4.0,3,3,4,4,11,0x3b9b355ad
338862.82,5.0,0,4,4,4,12,0xb2d17686
0.0,1.0,3,1,2,4,7,0xb2d95b0b
60.2,1.0,1,1,2,4,7,0xb2d3f646
317309.99,3.0,104,4,4,1,9,0xb2d106ff
1029128.58,5.0,4,4,4,4,12,0xb2d675a4
88483.3,5.0,0,3,4,4,11,0xb2d5edde
410110.02,6.0,4,4,4,4,12,0xb2d3a0f1d
10115.8,2.0,59,2,3,2,7,0xb2d6cca2
1603.95,1.0,92,1,2,1,4,0xb2d31230
190006.01,4.0,31,3,4,2,9,0xb2d53d9ad
1033.46,1.0,184,1,2,1,4,0xb2d29177d
200052.15,2.0,4,3,3,4,10,0xb2d6d936
130077.66,12.0,14,3,4,3,10,0xb2d8d83dd
608463.49,10.0,18,4,4,2,10,0xb2d1492cd
1500031.63,5.0,7,4,4,3,11,0xb2d96c87d
2521.59,1.0,0,1,2,4,7,0xb2d8df37
18479.35,1.0,92,2,2,1,5,0xb2d42b62d
781000.67,8.0,6,4,4,3,11,0xb2d6d271
100655.69,2.0,0,3,3,4,10,0xb2d69e89
1837743.41,5.0,14,4,4,3,11,0xb2d639bad
720000.92,8.0,6,4,4,3,11,0xb2d0f9b7d
385098.39,5.0,13,4,4,3,11,0xb2d4ed5d
700000.83,3.0,21,4,4,2,10,0xb2d90507d
17016.24,2.0,109,2,3,1,6,0xb2d27fc4d
5048.46,1.0,11,2,2,3,7,0xb2d68031d
73.98,1.0,29,1,2,2,5,0xb2d35cf7d
4.67,1.0,89,1,2,1,4,0xb2d5ac99
60092.53,2.0,25,3,3,2,8,0xb2d588e9
162855.67,3.0,53,3,4,2,9,0xb2d78ffb
3001061.75,4.0,2,4,4,4,12,0xb2d67987d
2200060.42,2.0,22,4,3,2,9,0xb2d9108bd
47974.37,1.0,83,2,2,1,5,0xb2d3ca2e
349779.83,2.0,0,4,3,4,11,0xb2d4013b
534876.69,3.0,0,4,4,4,12,0xb2d2baa8d
815198.65,2.0,0,4,3,4,11,0xb2d5e966d
107737.85,2.0,5,3,3,3,9,0xb2d0a12dd
24.73,1.0,10,1,2,3,6,0xb2d8c7e4
110003.48,2.0,39,3,3,2,8,0xb2d9e9ee
107678.16,4.0,102,3,4,1,8,0xb2d0acc1d
865.44,1.0,92,1,2,1,4,0xb2d268d4d
97168.67,1.0,0,3,2,4,9,0xb2d2e286d
5590.11,2.0,184,2,3,1,6,0xb2d09347
301011.26,3.0,26,4,4,2,10,0xb2d40bf2d
0.37,2.0,52,1,3,2,6,0xb2d1c386
370000.53,3.0,1,4,4,4,12,0xb2d8d78fd
30096.52,1.0,14,2,2,3,7,0xb2d6ad22
5283.65,1.0,2,2,2,4,8,0xb2d23cfd
986096.89,11.0,21,4,4,2,10,0xb2d5ca03d
653008.83,7.0,20,4,4,2,10,0xb2d1d68ad
15301.56,1.0,23,2,2,2,6,0xb2d8c48dd
121002.13,5.0,40,3,4,2,9,0xb2d3b8f6
264528.33,3.0,5,3,4,3,10,0xb2d37b43d
269025.96,3.0,18,3,4,2,9,0xb2d20aae
500000.0,2.0,11,4,3,3,10,0xb2da0b18
60763.71,1.0,0,3,2,4,9,0xb2d31f86
401446.49,2.0,10,4,3,3,10,0xb2d59660d
90747.76,1.0,12,3,2,3,8,0xb2d41171
1000111.23,4.0,11,4,4,3,11,0xb2d9c61e
3326.92,1.0,15,2,2,3,7,0xb2d2f8c7d
241865.69,3.0,97,3,4,1,8,0xb2d3be25d
1248.48,1.0,184,1,2,1,4,0xb2d2036d
3430.74,1.0,4,2,2,4,8,0xb2d697ec
1600270.92,7.0,3,4,4,4,12,0xb2d7444dd
20027.06,2.0,29,2,3,2,7,0xb2d90fb1d
173.86,1.0,0,1,2,4,7,0xb2d6ac05d
100045.9,6.0,3,3,4,4,11,0xb2d62fa8
100.0,1.0,1,1,2,4,7,0xb2d6ba6c
4.28,1.0,212,1,2,1,4,0xb2d28108d
845.7,1.0,10,1,2,3,6,0xb2d587f2
223613.87,4.0,55,3,4,2,9,0xb2d63ffd
1000041.83,3.0,25,4,4,2,10,0xb2d60742
212674.66,2.0,91,3,3,1,7,0xb2d5f105
542320.52,6.0,3,4,4,4,12,0xb2d5095dd
171.21,1.0,40,1,2,2,5,0xb2d204aa
44.7,1.0,17,1,2,2,5,0xb2d68e66d
600031.7,2.0,188,4,3,1,8,0xb2d6a59a
25014.88,2.0,116,2,3,1,6,0xb2d5ce5d
20503.92,3.0,80,2,4,1,7,0xb2d64cecd
60331.49,4.0,147,3,4,1,8,0xb2d64844
1.53,1.0,0,1,2,4,7,0xb2d16beb
13405.66,1.0,1,2,2,4,8,0xb2d27952
100002.14,2.0,11,3,3,3,9,0xb2d51674
3988.78,1.0,4,2,2,4,8,0xb2d9212d
3524.53,1.0,9,2,2,3,7,0xb2d6e3a2
156.01,1.0,32,1,2,2,5,0xb2d4104d
610.31,1.0,14,1,2,3,6,0xb2d6f7c2
294739.32,4.0,4,3,4,4,11,0xb2d14d52
1724.24,1.0,5,1,2,3,6,0xb2d62847
17.94,1.0,20,1,2,2,5,0xb2d93648
1428.74,1.0,9,1,2,3,6,0xb2d3eede
66.79,1.0,82,1,2,1,4,0xb2d459e2
1170.92,1.0,26,1,2,2,5,0xb2d6ec4fd
1.0,2.0,184,1,3,1,5,0xb2d1a89e
8949.69,2.0,183,2,3,1,6,0xb2d4bb13
310671.13,2.0,96,4,3,1,8,0xb2d68646
384002.2,7.0,0,4,4,4,12,0xb2d1e5f4d
290065.21,4.0,45,3,4,2,9,0xb2d1ae87
880058.08,7.0,0,4,4,4,12,0xb2d423b1d
150062.17,5.0,11,3,4,3,10,0x3b9b47eb
670012.25,5.0,9,4,4,3,11,0xb2d2e254d
220032.23,2.0,101,3,3,1,7,0xb2d57eb7
15409.16,1.0,3,2,2,4,8,0xb2d5e913
50000.0,1.0,1,2,2,4,8,0xb2da5f8d
370282.72,4.0,0,4,4,4,12,0xb2d568ab
176816.49,4.0,27,3,4,2,9,0xb2d53494d
80299.71,2.0,1,3,3,4,10,0xb2d416b9
195507.97,4.0,14,3,4,3,10,0xb2d41632d
127948.84,2.0,67,3,3,1,7,0xb2d45607d
421380.25,2.0,3,4,3,4,11,0xb2d628d1
500082.68,2.0,29,4,3,2,9,0xb2d8c68fd
280019.86,2.0,0,3,3,4,10,0xb2d3653a
136.5,1.0,2,1,2,4,7,0xb2d37cbe
211996.43,3.0,35,3,4,2,9,0xb2d38f98d
443292.13,2.0,14,4,3,3,10,0xb2d23dc8d
50002.96,2.0,27,2,3,2,7,0xb2da04ca
32297.69,1.0,4,2,2,4,8,0xb2d52cc3d
26623.86,2.0,12,2,3,3,8,0xb2d39ca1d
301296.22,7.0,0,4,4,4,12,0xb2d20fb4
60627.24,1.0,181,3,2,1,6,0xb2d600d7
1017.67,1.0,11,1,2,3,6,0xb2d286e6
6793.81,1.0,0,2,2,4,8,0xb2d85bdf
0.51,1.0,172,1,2,1,4,0xb2d41024
100147.5,2.0,98,3,3,1,7,0xb2d1f97c
16.78,1.0,0,1,2,4,7,0xb2d20ee0
3069.66,1.0,6,2,2,3,7,0xb2d69b14
0.03,16.0,184,1,4,1,6,0xb2d2299fd
20000.0,2.0,1,2,3,4,9,0xb2da6155
276831.53,3.0,0,3,4,4,11,0xb2d25f53d
1532.38,1.0,6,1,2,3,6,0xb2d21a02
600000.45,4.0,1,4,4,4,12,0xb2d6cf44d
348150.7,7.0,3,4,4,4,12,0xb2d0d1fa
0.06,2.0,110,1,3,1,5,0xb2d260ecd
3257.53,1.0,10,2,2,3,7,0xb2d98891
36.02,1.0,60,1,2,2,5,0xb2d0da4bd
4.45,1.0,6,1,2,3,6,0xb2d6f864d
300000.0,2.0,0,3,3,4,10,0xb2d975eed
603379.34,3.0,4,4,4,4,12,0xb2d94645
1758.42,3.0,40,1,4,2,7,0xb2d064c7
122.49,1.0,30,1,2,2,5,0xb2d6d169d
1216.79,1.0,184,1,2,1,4,0xb2d3178e
62.88,1.0,4,1,2,4,7,0xb2d6a8a4
3031.32,1.0,10,2,2,3,7,0xb2d9a497
114007.51,1.0,1,3,2,4,9,0xb2d26e81
440083.21,5.0,8,4,4,3,11,0xb2d186c5
533784.94,4.0,8,4,4,3,11,0xb2d13adbd
5396.79,1.0,3,2,2,4,8,0xb2d402ee
1666.0,1.0,0,1,2,4,7,0xb2d6d022
2383.46,1.0,184,1,2,1,4,0xb2d3004ad
60000.2,2.0,6,3,3,3,9,0xb2d93841d
141057.04,3.0,11,3,4,3,10,0xb2d36c84d
476015.19,5.0,108,4,4,1,9,0xb2d21c28d
114352.5,2.0,2,3,3,4,10,0xb2d0dc29d
8444.68,1.0,92,2,2,1,5,0xb2d13eb8
4498.27,1.0,40,2,2,2,6,0xb2d24688
3.21,1.0,59,1,2,2,5,0xb2d6c1ac
5178017.91,4.0,67,4,4,1,9,0x3b9b37e1
2160.5,2.0,184,1,3,1,5,0x3b9b2b3d
4594.3,1.0,20,2,2,2,6,0xb2d30022
179007.59,3.0,63,3,4,2,9,0xb2d6a312d
331173.02,2.0,56,4,3,2,9,0xb2d90217d
73560.95,3.0,11,3,4,3,10,0xb2d4f75c
10004.22,1.0,50,2,2,2,6,0xb2d95a75
32335.63,1.0,10,2,2,3,7,0xb2d6cc03d
1163.98,1.0,168,1,2,1,4,0xb2d33087
27713.82,6.0,0,2,4,4,10,0xb2d170c4
628499.76,4.0,1,4,4,4,12,0x3b9af1b0
20001.85,2.0,104,2,3,1,6,0xb2d68d00
25998.97,1.0,6,2,2,3,7,0xb2d60966
65841.11,2.0,210,3,3,1,7,0xb2d288d4d
100004.22,2.0,39,3,3,2,8,0xb2d9e8a1
400016.77,4.0,130,4,4,1,9,0xb2d2607ed
222.12,1.0,45,1,2,2,5,0xb2d922a8
4716.29,2.0,16,2,3,2,7,0xb2d0d129d
744.36,1.0,7,1,2,3,6,0xb2d54c32
60028.73,2.0,168,3,3,1,7,0xb2d378bc
3151.88,1.0,0,2,2,4,8,0xb2d6a79dd
113397.43,2.0,92,3,3,1,7,0xb2d1f86cd
2252.12,1.0,92,1,2,1,4,0xb2d320a1d
918211.85,8.0,33,4,4,2,10,0xb2d69609
30128.09,2.0,159,2,3,1,6,0x3b9b2b44d
51070.12,2.0,0,2,3,4,9,0xb2d68428d
0.91,1.0,7,1,2,3,6,0xb2d5879f
102007.64,2.0,172,3,3,1,7,0xb2d2ec88d
115002.91,3.0,11,3,4,3,10,0xb2d4a225d
408021.96,4.0,6,4,4,3,11,0xb2d6097bd
13052.27,1.0,1,2,2,4,8,0xb2d51b55
370558.04,7.0,12,4,4,3,11,0xb2d77790d
58.12,1.0,8,1,2,3,6,0xb2d2d3b5
85.02,1.0,19,1,2,2,5,0xb2d6a9a9
334016.24,4.0,2,4,4,4,12,0xb2d280a7
200010.84,2.0,13,3,3,3,9,0xb2d9a104
61750.34,1.0,196,3,2,1,6,0xb2d4baa8d
463871.73,6.0,0,4,4,4,12,0x3b9b322d
2002.82,1.0,0,1,2,4,7,0xb2d6bd49d
110003.94,2.0,18,3,3,2,8,0xb2da27d4
37599.41,1.0,1,2,2,4,8,0xb2d2f1db
229.42,1.0,19,1,2,2,5,0xb2d20b3b
18442.07,1.0,10,2,2,3,7,0xb2d93865
5527.35,2.0,184,2,3,1,6,0xb2d205e6
58033.99,2.0,69,3,3,1,7,0xb2d130ead
1513.58,1.0,17,1,2,2,5,0xb2d2f8bdd
70001.16,2.0,0,3,3,4,10,0xb2d60e46
100002.11,2.0,80,3,3,1,7,0xb2d8d579
637012.44,6.0,74,4,4,1,9,0xb2d8df92
20007.3,2.0,11,2,3,3,8,0xb2d60e46d
21428.6,1.0,10,2,2,3,7,0xb2d373f5
290000.0,2.0,11,3,3,3,9,0xb2da4c7c
63.62,1.0,36,1,2,2,5,0xb2d7857a
5526.64,1.0,6,2,2,3,7,0xb2d212ae
0.0,1.0,3,1,2,4,7,0xb2d9281e
24.66,1.0,92,1,2,1,4,0xb2d3527e
215000.0,2.0,4,3,3,4,10,0xb2d97a96
1552000.82,2.0,4,4,3,4,11,0xb2d13bb8d
50034.57,3.0,13,2,4,3,9,0xb2d0a103
22.53,1.0,26,1,2,2,5,0xb2d91809
1015034.53,5.0,101,4,4,1,9,0xb2d10f1f
401510.02,3.0,25,4,4,2,10,0xb2d683e4d
330000.52,2.0,2,4,3,4,11,0xb2d6230d
446796.97,4.0,10,4,4,3,11,0xb2d076fd
89.3,1.0,5,1,2,3,6,0xb2d9c916
60364.2,2.0,221,3,3,1,7,0xb2d28758d
257189.68,8.0,69,3,4,1,8,0xb2d5687e
12786.73,1.0,184,2,2,1,5,0xb2d2e6cfd
203795.22,4.0,118,3,4,1,8,0xb2d239e5d
21612.81,1.0,0,2,2,4,8,0xb2d99c62
602490.42,4.0,55,4,4,2,10,0xb2d1039bd
713315.16,4.0,83,4,4,1,9,0xb2d78e67d
312055.65,8.0,60,4,4,2,10,0xb2d2dabe
102213.67,3.0,119,3,4,1,8,0xb2d087cad
7057.28,1.0,13,2,2,3,7,0xb2da0214
633108.32,4.0,10,4,4,3,11,0xb2d520c6
7888.18,1.0,1,2,2,4,8,0xb2d1d841
500000.0,2.0,18,4,3,2,9,0xb2d9126cd
4369.17,1.0,4,2,2,4,8,0xb2d4d3dad
300098.73,2.0,189,3,3,1,7,0xb2d699e6
100104.45,2.0,210,3,3,1,7,0xb2d78063d
652.87,2.0,35,1,3,2,6,0xb2d5e654d
164637.37,4.0,5,3,4,3,10,0xb2d085ced
500578.12,2.0,6,4,3,3,10,0xb2d26bd5d
600087.32,2.0,158,4,3,1,8,0xb2d5d8a5
7953.11,1.0,10,2,2,3,7,0xb2d8e32b
1351.28,1.0,92,1,2,1,4,0xb2d29fc4
202425.99,2.0,28,3,3,2,8,0xb2d6f617d
120461.63,3.0,0,3,4,4,11,0xb2d69ad4d
2558.82,1.0,20,1,2,2,5,0xb2d1f257d
703040.2,7.0,0,4,4,4,12,0x3b9b298f
350102.06,3.0,90,4,4,1,9,0xb2d1b758
409.18,1.0,65,1,2,2,5,0xb2d56ac0
28038.85,1.0,8,2,2,3,7,0xb2d56fa9
693.69,1.0,55,1,2,2,5,0xb2d6d773
18627.15,1.0,95,2,2,1,5,0xb2d822f8
3091.27,1.0,1,2,2,4,8,0xb2d5ea2d
358250.21,4.0,3,4,4,4,12,0xb2d08cd3d
10031.83,2.0,2,2,3,4,9,0xb2d3ceb0
10979.22,1.0,5,2,2,3,7,0xb2d67ee0d
1340000.0,4.0,0,4,4,4,12,0xb2d3bee9d
110668.44,1.0,1,3,2,4,9,0xb2d1d72ed
385137.69,3.0,49,4,4,2,10,0xb2d2ee4cd
10087.74,2.0,46,2,3,2,7,0xb2d60c8e
201218.56,3.0,47,3,4,2,9,0xb2d6d4dcd
54507.33,1.0,9,3,2,3,8,0xb2d5ec05d
49.86,1.0,37,1,2,2,5,0xb2d1fee0
2032086.11,4.0,13,4,4,3,11,0xb2d27689
4.65,1.0,57,1,2,2,5,0xb2d626aa
431.06,1.0,1,1,2,4,7,0xb2d8db3a
95250.9,3.0,4,3,4,4,11,0xb2d3a435d
2507287.31,26.0,4,4,4,4,12,0xb2d0b3ce
202637.06,2.0,37,3,3,2,8,0xb2d5fafed
4169.85,1.0,6,2,2,3,7,0xb2d2da14
451394.61,11.0,0,4,4,4,12,0x3b9b0e3d
17.24,1.0,6,1,2,3,6,0xb2d5f9a6d
7818.12,5.0,0,2,4,4,10,0xb2d0d832d
2729.32,1.0,3,1,2,4,7,0xb2d82267
255007.24,8.0,13,3,4,3,10,0xb2d20d14d
130004.34,2.0,92,3,3,1,7,0xb2d33c13
115083.41,2.0,167,3,3,1,7,0xb2d53c50d
13508.35,1.0,204,2,2,1,5,0xb2d1c77e
313312.5,2.0,89,4,3,1,8,0xb2d6b0bfd
7038.23,1.0,61,2,2,2,6,0xb2d35545
203589.12,3.0,25,3,4,2,9,0xb2d6b732
723400.04,5.0,52,4,4,2,10,0xb2d23631
161733.98,2.0,168,3,3,1,7,0xb2d50dadd
18402.15,1.0,4,2,2,4,8,0xb2d6bf96
3890.96,1.0,2,2,2,4,8,0xb2d5363e
300002.3,2.0,1,3,3,4,10,0xb2d16e9b
1883.97,2.0,0,1,3,4,8,0xb2d20be4
20000.22,3.0,5,2,4,3,9,0xb2d96904d
8128.17,1.0,43,2,2,2,6,0xb2d933fe
8729.87,1.0,2,2,2,4,8,0xb2d52bf5
25440.92,1.0,12,2,2,3,7,0xb2d2a7b9
602367.3,1.0,0,4,2,4,10,0xb2d5b388
223218.43,6.0,0,3,4,4,11,0xb2d62cc6
150004.25,2.0,31,3,3,2,8,0xb2d55e10
4611.5,1.0,2,2,2,4,8,0xb2d32dd4d
1560.77,2.0,3,1,3,4,8,0xb2d07b7f
180000.0,4.0,7,3,4,3,10,0xb2d5da4cd
1127030.69,3.0,0,4,4,4,12,0xb2d5bf7d
939004.09,4.0,15,4,4,3,11,0xb2d63c5b
200000.1,4.0,0,3,4,4,11,0xb2d20578
1000000.03,5.0,11,4,4,3,11,0xb2d6c0cbd
68613.56,1.0,1,3,2,4,9,0xb2d496e0
170610.11,3.0,147,3,4,1,8,0xb2d6c618d
987.43,1.0,35,1,2,2,5,0xb2d682bc
17.91,1.0,12,1,2,3,6,0xb2d60a9fd
429220.11,11.0,16,4,4,2,10,0xb2d118da
997.87,1.0,0,1,2,4,7,0xb2d6c40c
4651.06,1.0,6,2,2,3,7,0xb2d30cba
10094.52,2.0,45,2,3,2,7,0xb2d8d11b
284399.11,4.0,3,3,4,4,11,0xb2d2d1e4d
4.22,1.0,39,1,2,2,5,0xb2d69e80d
10.77,1.0,43,1,2,2,5,0xb2d93f9ed
822331.84,3.0,25,4,4,2,10,0xb2d0e656d
50000.0,2.0,0,2,3,4,9,0xb2d9804a
10187.28,2.0,153,2,3,1,6,0xb2d5bcecd
11216.17,1.0,11,2,2,3,7,0xb2d24cd5
140065.0,3.0,80,3,4,1,8,0xb2d55bc4
120002.19,5.0,60,3,4,2,9,0xb2d45bb3d
104.24,2.0,4,1,3,4,8,0xb2d16084
20100.89,2.0,91,2,3,1,6,0xb2d28aec
11046.64,2.0,39,2,3,2,7,0xb2d2bb62d
31.73,1.0,11,1,2,3,6,0xb2d94be4
5265.21,1.0,9,2,2,3,7,0xb2d202b8
1124.49,1.0,35,1,2,2,5,0xb2d692a4
120422.24,1.0,10,3,2,3,8,0xb2d9a1d4
51887.45,1.0,10,2,2,3,7,0xb2d40917
11816.82,1.0,92,2,2,1,5,0xb2d38762
2000031.84,2.0,2,4,3,4,11,0xb2d939f5d
635001.93,7.0,15,4,4,3,11,0xb2d6393b
3943.06,1.0,92,2,2,1,5,0xb2d3ffcc
665.91,2.0,70,1,3,1,5,0xb2d40f0a
1101946.24,4.0,67,4,4,1,9,0xb2d074eb
50001.06,2.0,24,2,3,2,7,0xb2d94864
136920.32,1.0,92,3,2,1,6,0xb2d1adb2
100810.53,2.0,208,3,3,1,7,0xb2d6a6bbd
507107.69,2.0,11,4,3,3,10,0xb2d6f5cd
338065.85,4.0,6,4,4,3,11,0xb2d1aea2d
140063.35,3.0,20,3,4,2,9,0xb2d92860
818014.48,7.0,123,4,4,1,9,0xb2d242c9
700051.29,6.0,24,4,4,2,10,0xb2d5d991d
232991.36,3.0,129,3,4,1,8,0xb2d66558d
18588.11,1.0,309,2,2,1,5,0xb2d61ba0
98.83,1.0,4,1,2,4,7,0xb2d34aeb
7165.13,28.0,31,2,4,2,8,0xb2d0ed51
150013.61,2.0,45,3,3,2,8,0xb2d33129
195580.6,3.0,0,3,4,4,11,0xb2d1a8f2
1712.47,2.0,184,1,3,1,5,0x3b9b4783d
260674.37,2.0,126,3,3,1,7,0xb2d62f0e
20001.9,2.0,83,2,3,1,6,0xb2d6ba1e
203093.12,2.0,32,3,3,2,8,0xb2d648ee
983.41,1.0,9,1,2,3,6,0xb2d35dbfd
50102.38,3.0,19,2,4,2,8,0xb2da1d78
39.09,1.0,60,1,2,2,5,0xb2d5e247
1177.31,1.0,22,1,2,2,5,0xb2d9bb22
2.39,1.0,60,1,2,2,5,0xb2d68b42d
250649.55,2.0,24,3,3,2,8,0xb2d54ff7
189.8,2.0,69,1,3,1,5,0xb2d36016
103559.75,1.0,14,3,2,3,8,0xb2d619c0d
500015.65,3.0,8,4,4,3,11,0xb2d99d32
123207.11,6.0,4,3,4,4,11,0xb2d96eab
202000.0,2.0,4,3,3,4,10,0xb2d96f38d
160086.42,5.0,31,3,4,2,9,0xb2d6e20c
33399.01,2.0,7,2,3,3,8,0xb2d7017a
456650.9,3.0,2,4,4,4,12,0xb2d0c42c
3090558.06,43.0,0,4,4,4,12,0xb2d23dd2d
2969.74,1.0,13,2,2,3,7,0xb2d2ab5e
27712.11,1.0,92,2,2,1,5,0xb2d30f22
52828.8,1.0,172,3,2,1,6,0xb2d438f4
5385.17,1.0,184,2,2,1,5,0xb2d2ba18d
128.47,1.0,0,1,2,4,7,0xb2d66a87
4145.2,1.0,12,2,2,3,7,0xb2d631e5
330008.44,7.0,27,4,4,2,10,0xb2d1b63b
7400.01,2.0,46,2,3,2,7,0xb2d9183a
350154.28,3.0,0,4,4,4,12,0xb2d233f0
285039.84,7.0,0,3,4,4,11,0x3b9af1ce
1003552.38,2.0,48,4,3,2,9,0xb2d9de7f
80000.85,3.0,56,3,4,2,9,0xb2d9b7f6
202854.74,2.0,129,3,3,1,7,0xb2d56e56d
194097.8,2.0,0,3,3,4,10,0xb2d2224c
100104.4,3.0,167,3,4,1,8,0xb2d68ac1
822.0,1.0,1,1,2,4,7,0xb2d3119b
23.2,1.0,56,1,2,2,5,0xb2d8df89d
10000.11,2.0,13,2,3,3,8,0xb2d95d9c
1002.68,1.0,127,1,2,1,4,0xb2d383d7d
130003.4,3.0,186,3,4,1,8,0xb2d8577c
50001.58,2.0,67,2,3,1,6,0xb2d9a903
117615.63,1.0,3,3,2,4,9,0xb2d1b0b1
2971.03,1.0,4,2,2,4,8,0xb2d2bad1d
2618.15,2.0,1,1,3,4,8,0x3b9add38
360307.13,4.0,0,4,4,4,12,0xb2d60089d
4275.05,1.0,14,2,2,3,7,0xb2d8f93d
670087.2,4.0,7,4,4,3,11,0xb2d63e81
0.27,3.0,0,1,4,4,9,0xb2d06788
100527.91,2.0,209,3,3,1,7,0xb2d416e5d
100010.92,2.0,18,3,3,2,8,0xb2d5db48
84117.87,3.0,7,3,4,3,10,0xb2d239a0
40002.33,2.0,67,2,3,1,6,0xb2d0d479d
7955.99,2.0,209,2,3,1,6,0xb2d29f36d
0.32,1.0,49,1,2,2,5,0xb2d56a1a
3391.76,1.0,8,2,2,3,7,0xb2d97638
155468.82,1.0,4,3,2,4,9,0xb2d5820fd
8516.63,1.0,0,2,2,4,8,0xb2d16589
103810.43,2.0,0,3,3,4,10,0xb2d22258d
400027.03,4.0,13,4,4,3,11,0xb2d5d1fed
207753.49,2.0,22,3,3,2,8,0xb2d90d29
100002.64,3.0,11,3,4,3,10,0xb2d91047d
320111.9,2.0,1,4,3,4,11,0xb2d3f6d2
6526.46,1.0,15,2,2,3,7,0xb2d9b38e
736919.96,1.0,184,4,2,1,7,0xb2d2dea7
1417.57,3.0,1,1,4,4,9,0xb2d0a6aad
41013.88,1.0,5,2,2,3,7,0xb2d2c452
20129.82,3.0,6,2,4,3,9,0xb2d5cb6d
81433.87,2.0,1,3,3,4,10,0xb2da618e
1001.16,1.0,120,1,2,1,4,0xb2d91a7c
153694.27,3.0,10,3,4,3,10,0xb2d19912d
20001.16,2.0,98,2,3,1,6,0xb2d96ed3d
409306.32,17.0,4,4,4,4,12,0xb2d24535d
227.05,1.0,2,1,2,4,7,0xb2d39dba
555855.01,3.0,91,4,4,1,9,0xb2d3fcf1d
2059.59,1.0,0,1,2,4,7,0xb2d31054
1009.51,1.0,92,1,2,1,4,0xb2d0c846d
400624.82,4.0,14,4,4,3,11,0xb2d90ad0d
2279.38,1.0,66,1,2,2,5,0xb2d985ff
202965.88,3.0,6,3,4,3,10,0xb2d60d92d
41.44,1.0,12,1,2,3,6,0xb2d8049e
503634.64,2.0,82,4,3,1,8,0xb2d6e2be
200080.51,2.0,0,3,3,4,10,0xb2d4c22dd
600027.16,8.0,6,4,4,3,11,0xb2d10997d
2.62,1.0,2,1,2,4,7,0xb2d3d52a
3226.51,1.0,189,2,2,1,5,0xb2d39034
453429.3,1.0,208,4,2,1,7,0xb2d201a8
1159109.62,9.0,63,4,4,2,10,0xb2d08674
400001.0,1.0,0,4,2,4,10,0xb2d9e30c
16440.61,1.0,104,2,2,1,5,0xb2d4c0f4
220162.84,3.0,18,3,4,2,9,0xb2d6591bd
200710.52,2.0,26,3,3,2,8,0xb2d93552
3279.13,1.0,11,2,2,3,7,0xb2d517bb
237908.44,2.0,0,3,3,4,10,0xb2d4fe14
801525.63,4.0,63,4,4,2,10,0xb2d0f1e8d
4617655.19,3.0,0,4,4,4,12,0xb2d5bd70
351193.55,5.0,1,4,4,4,12,0xb2d0be43
140.21,1.0,11,1,2,3,6,0xb2d42f51
150007.03,3.0,20,3,4,2,9,0xb2d9eac9
101.33,1.0,29,1,2,2,5,0xb2d9bbda
802867.61,8.0,48,4,4,2,10,0xb2d56afcd
7303.81,1.0,0,2,2,4,8,0xb2d7c11ed
21813.94,1.0,184,2,2,1,5,0xb2d539f2
40925.73,4.0,0,2,4,4,10,0xb2d2fc92
92245.48,3.0,0,3,4,4,11,0xb2d52bcdd
1144.33,1.0,92,1,2,1,4,0xb2d2660d
1034.78,1.0,13,1,2,3,6,0xb2d287ab
962.93,1.0,0,1,2,4,7,0xb2d6c3f1d
90002.58,3.0,83,3,4,1,8,0xb2d630b1
2139002.23,11.0,0,4,4,4,12,0xb2d0d587
65267.7,2.0,20,3,3,2,8,0xb2d60333d
200986.66,2.0,2,3,3,4,10,0xb2d96eaed
210000.0,2.0,5,3,3,3,9,0xb2d97725d
824.66,1.0,0,1,2,4,7,0xb2d6922a
70019.42,3.0,67,3,4,1,8,0xb2d5c03ad
103588.38,2.0,13,3,3,3,9,0xb2d5101d
3160.83,1.0,0,2,2,4,8,0xb2d91743
501.08,3.0,43,1,4,2,7,0xb2d1451e
553.74,1.0,52,1,2,2,5,0xb2d0f1de
575008.76,5.0,15,4,4,3,11,0xb2d8d5c3
1001.59,1.0,161,1,2,1,4,0xb2d8edd1
590000.0,10.0,10,4,4,3,11,0xb2d6907fd
540000.83,5.0,14,4,4,3,11,0xb2d6c624
174.61,1.0,29,1,2,2,5,0xb2d185e8
306012.52,2.0,92,4,3,1,8,0xb2d65ea6d
29089.47,1.0,15,2,2,3,7,0xb2d6993b
1.89,1.0,19,1,2,2,5,0xb2d2cfd5d
12576.01,1.0,18,2,2,2,6,0xb2d9179dd
5030.54,1.0,184,2,2,1,5,0xb2d42d3dd
3.47,1.0,13,1,2,3,6,0xb2d645a7
1708.96,1.0,92,1,2,1,4,0xb2d34673d
22692.37,1.0,13,2,2,3,7,0xb2d6bfa1d
11.32,1.0,2,1,2,4,7,0xb2d592ca
320013.98,3.0,158,4,4,1,9,0xb2d6bc9c
50055.29,2.0,108,2,3,1,6,0xb2d35123
2630.72,1.0,184,1,2,1,4,0xb2d1ee8ad
305036.26,6.0,0,4,4,4,12,0xb2d46ddb
689.26,1.0,9,1,2,3,6,0xb2d2a794d
453173.36,3.0,10,4,4,3,11,0xb2d0cbd8d
147.05,1.0,9,1,2,3,6,0xb2d42488
50605.21,2.0,55,2,3,2,7,0xb2d5ceee
350971.68,3.0,0,4,4,4,12,0xb2d6aac1
191699.09,4.0,1,3,4,4,11,0xb2d35006
4310.3,2.0,268,2,3,1,6,0xb2d27187d
23466.39,1.0,4,2,2,4,8,0xb2d77f65
165.51,1.0,2,1,2,4,7,0xb2d609be
23978.66,1.0,0,2,2,4,8,0xb2d21bde
23.77,1.0,11,1,2,3,6,0xb2d9f436
660262.44,8.0,27,4,4,2,10,0xb2d1bd12d
21.14,3.0,75,1,4,1,6,0xb2d97c62d
30223.47,1.0,184,2,2,1,5,0xb2d38309d
250000.0,2.0,16,3,3,2,8,0xb2d6f23b
30000.32,2.0,83,2,3,1,6,0xb2d8d0f0
100012.48,3.0,111,3,4,1,8,0xb2d6af85
32.61,1.0,0,1,2,4,7,0xb2d69647
5015.96,1.0,17,2,2,2,6,0xb2d47680
1197130.36,6.0,4,4,4,4,12,0xb2d488cf
307465.95,2.0,30,4,3,2,9,0xb2d3fe99
13500.0,1.0,1,2,2,4,8,0xb2d4b62ad
200016.35,2.0,92,3,3,1,7,0xb2d63541
320227.98,2.0,0,4,3,4,11,0xb2d3f94dd
160160.65,1.0,0,3,2,4,9,0xb2d41974
56238.78,1.0,3,3,2,4,9,0xb2d56088
401566.61,3.0,4,4,4,4,12,0xb2d683ffd
100001.93,5.0,59,3,4,2,9,0xb2d56434d
16925.85,1.0,3,2,2,4,8,0xb2d1ff2ed
230002.43,2.0,25,3,3,2,8,0xb2da144b
501776.04,2.0,40,4,3,2,9,0xb2d929ec
31065.15,4.0,203,2,4,1,7,0xb2d5a78fd
20713.21,2.0,92,2,3,1,6,0xb2d62527d
8172.11,1.0,7,2,2,3,7,0xb2d34818d
7599.76,1.0,6,2,2,3,7,0xb2d6a926
16907.15,1.0,11,2,2,3,7,0xb2d27c2c
735.88,1.0,0,1,2,4,7,0xb2d81625d
43.39,1.0,14,1,2,3,6,0xb2d908d4
4921.88,1.0,92,2,2,1,5,0xb2d2ddc5d
522196.5,3.0,59,4,4,2,10,0xb2d60581
51838.85,1.0,0,2,2,4,8,0xb2d610d6d
220077.95,4.0,11,3,4,3,10,0xb2d20ebc
5000001.0,2.0,7,4,3,3,10,0xb2da4b26
20000.63,2.0,11,2,3,3,8,0xb2da3bc4
66254.69,2.0,15,3,3,3,9,0xb2d5da0ad
259325.18,2.0,1,3,3,4,10,0xb2d55154
1002042.31,2.0,90,4,3,1,8,0xb2d2803ed
830915.74,4.0,11,4,4,3,11,0xb2d0d64ad
957.88,1.0,0,1,2,4,7,0xb2d33d1b
50161.37,2.0,83,2,3,1,6,0xb2d55f43
1350.78,1.0,26,1,2,2,5,0xb2d2ae15
6000000.0,3.0,0,4,4,4,12,0xb2d0bfd7
590036.07,6.0,80,4,4,1,9,0xb2d27475
77427.38,3.0,129,3,4,1,8,0xb2d16b39d
66.09,1.0,88,1,2,1,4,0xb2d59966
65971.96,1.0,172,3,2,1,6,0xb2d650b3
205006.61,3.0,69,3,4,1,8,0xb2d40ca1d
260043.07,4.0,4,3,4,4,11,0xb2d108fcd
806875.24,6.0,2,4,4,4,12,0xb2d354f9d
1788.67,1.0,10,1,2,3,6,0xb2d85958
180283.83,2.0,0,3,3,4,10,0xb2d52cbdd
82540.5,2.0,63,3,3,2,8,0xb2d5dcbc
110003.48,2.0,46,3,3,2,8,0xb2d9d248
391928.67,8.0,0,4,4,4,12,0xb2d06a07
180008.24,3.0,0,3,4,4,11,0xb2d3ac67
810057.32,3.0,2,4,4,4,12,0xb2d23ae4d
20788.51,1.0,8,2,2,3,7,0xb2d3f2b3d
32.75,1.0,13,1,2,3,6,0xb2d5b7cc
2.11,1.0,157,1,2,1,4,0xb2d6d156d
151514.31,1.0,9,3,2,3,8,0xb2d691ef
80001.69,2.0,95,3,3,1,7,0xb2d9749dd
408.74,1.0,22,1,2,2,5,0xb2d6d0fcd
72.33,1.0,21,1,2,2,5,0xb2d218e3
427.53,2.0,32,1,3,2,6,0xb2d33a85d
114679.92,4.0,6,3,4,3,10,0xb2d08bd9
39689.04,4.0,184,2,4,1,7,0xb2d08d06
278856.24,3.0,10,3,4,3,10,0xb2d21058
500001.51,5.0,11,4,4,3,11,0xb2d5d25d
110023.24,3.0,0,3,4,4,11,0xb2d18a84
21873.01,1.0,4,2,2,4,8,0xb2d68c8c
7101.8,1.0,20,2,2,2,6,0xb2d9b918
434047.05,11.0,0,4,4,4,12,0xb2d0cf5ad
2178110.51,9.0,0,4,4,4,12,0xb2d40699d
1007.32,1.0,184,1,2,1,4,0xb2d3e601d
100014.24,2.0,59,3,3,2,8,0xb2d8d0e8
632.05,1.0,0,1,2,4,7,0xb2d913e4
1751.32,1.0,10,1,2,3,6,0xb2d92998
888.01,1.0,0,1,2,4,7,0xb2d34baed
90.5,1.0,9,1,2,3,6,0xb2d30afa
1.06,1.0,101,1,2,1,4,0xb2d633f3
6.25,1.0,8,1,2,3,6,0xb2d919b3d
80333.24,4.0,56,3,4,2,9,0xb2d6fb3bd
50514.7,3.0,123,2,4,1,7,0xb2d2696ed
500015.08,2.0,8,4,3,3,10,0xb2d6cec4
1688.7,1.0,92,1,2,1,4,0xb2d14712
72.83,1.0,59,1,2,2,5,0xb2d73976
2891.25,1.0,0,2,2,4,8,0xb2d181c6
7000.37,1.0,14,2,2,3,7,0xb2d9421bd
370376.14,2.0,35,4,3,2,9,0xb2d416c6
71561.96,2.0,0,3,3,4,10,0xb2d17b90
553287.57,3.0,70,4,4,1,9,0xb2d21466d
1391.45,1.0,10,1,2,3,6,0xb2d1b190
3.74,1.0,49,1,2,2,5,0xb2d6d7ac
50013.3,2.0,92,2,3,1,6,0xb2d3c5a0d
38463.01,3.0,31,2,4,2,8,0xb2d229a4d
3200.75,1.0,30,2,2,2,6,0xb2d3727a
314268.49,6.0,10,4,4,3,11,0xb2d1554ed
2968.98,1.0,0,2,2,4,8,0xb2d42501
3290759.55,3.0,21,4,4,2,10,0xb2d3535d
1315.07,4.0,0,1,4,4,9,0x3b9ae812
1514.33,1.0,0,1,2,4,7,0xb2d2f30a
12165.16,1.0,15,2,2,3,7,0xb2d943c5
100275.51,2.0,62,3,3,2,8,0xb2d5db8ed
9550.62,3.0,14,2,4,3,9,0xb2d09fead
500052.57,2.0,4,4,3,4,11,0xb2d9b49f
1797.57,1.0,145,1,2,1,4,0xb2d6e8a2d
7042.04,1.0,237,2,2,1,5,0xb2d5f451d
1327573.85,5.0,1,4,4,4,12,0xb2d5611bd
200001.26,2.0,6,3,3,3,9,0xb2d9584d
2701.43,1.0,1,1,2,4,7,0xb2d91bbf
2036.86,1.0,0,1,2,4,7,0xb2d36b27
894.53,1.0,9,1,2,3,6,0xb2d2a563
409009.35,4.0,47,4,4,2,10,0xb2d5d14e
332252.57,4.0,184,4,4,1,9,0xb2d14142d
10.95,1.0,16,1,2,2,5,0xb2d25df7
330089.98,2.0,35,4,3,2,9,0xb2d179c7
220011.74,3.0,97,3,4,1,8,0xb2d170d1d
801868.16,3.0,35,4,4,2,10,0xb2d900e6
90466.28,2.0,21,3,3,2,8,0xb2d0df96
601005.28,3.0,1,4,4,4,12,0xb2da08a8
1.33,1.0,34,1,2,2,5,0xb2d1ac42d
32.15,1.0,50,1,2,2,5,0xb2d41f02
2740.82,1.0,6,1,2,3,6,0xb2d67e96
380009.28,6.0,63,4,4,2,10,0xb2d1357a
50.06,1.0,15,1,2,3,6,0xb2d62f3c
50007.39,2.0,13,2,3,3,8,0xb2d5b5db
40002.11,2.0,92,2,3,1,6,0xb2d65c20d
128125.16,1.0,13,3,2,3,8,0xb2d568c3
10275.63,2.0,55,2,3,2,7,0xb2d6cf88
500020.2,3.0,6,4,4,3,11,0xb2da57ce
61663.78,1.0,0,3,2,4,9,0xb2d236d9
314348.79,2.0,69,4,3,1,8,0xb2d57de8d
196585.11,2.0,1,3,3,4,10,0xb2d4fe14d
500012.18,2.0,4,4,3,4,11,0xb2d4ceead
28.29,1.0,11,1,2,3,6,0xb2d5d774
430000.0,1.0,0,4,2,4,10,0xb2da6b9c
500029.31,3.0,6,4,4,3,11,0xb2d65c69
4601.06,1.0,12,2,2,3,7,0xb2d914af
5224.03,2.0,158,2,3,1,6,0xb2d334de
500276.04,2.0,1,4,3,4,11,0xb2d9fff3
1366621.26,10.0,76,4,4,1,9,0xb2d625b6d
12469.6,2.0,2,2,3,4,9,0x3b9b1851
12549.18,1.0,14,2,2,3,7,0xb2d6ecbf
1067.0,1.0,237,1,2,1,4,0xb2d2cb73d
10150.88,2.0,38,2,3,2,7,0xb2d5fe03
8472.1,1.0,3,2,2,4,8,0xb2d8d110
100002.11,3.0,80,3,4,1,8,0xb2d814c7d
146388.1,2.0,0,3,3,4,10,0xb2d21116
3000.82,1.0,11,2,2,3,7,0xb2d6f7b5
523.58,1.0,1,1,2,4,7,0xb2d3268a
222065.67,1.0,0,3,2,4,9,0xb2d0a916
50001.58,2.0,92,2,3,1,6,0xb2d2c96ed
20464.56,3.0,6,2,4,3,9,0xb2d88104
1603.11,1.0,10,1,2,3,6,0xb2d2c499
477433.0,4.0,53,4,4,2,10,0xb2d1cd17
579184.18,5.0,4,4,4,4,12,0xb2d29ca6
1251.7,1.0,184,1,2,1,4,0xb2d132e6
600044.94,2.0,101,4,3,1,8,0xb2d3bba7
604.48,1.0,45,1,2,2,5,0xb2d6e217
8786.07,1.0,39,2,2,2,6,0xb2d905e2
550000.0,4.0,3,4,4,4,12,0xb2d8a568
1077.9,1.0,3,1,2,4,7,0xb2d2c369
101488.3,3.0,20,3,4,2,9,0xb2d3ea86d
7593.58,1.0,8,2,2,3,7,0xb2d305a1d
187.17,1.0,6,1,2,3,6,0xb2d3bf66d
10190.06,1.0,11,2,2,3,7,0xb2d68530
1148.42,1.0,0,1,2,4,7,0xb2d6bb0f
50006.33,1.0,21,2,2,2,6,0xb2d94014d
508009.13,5.0,27,4,4,2,10,0x3b9b4865
50079.62,1.0,19,2,2,2,6,0xb2d4254ad
271026.31,3.0,80,3,4,1,8,0xb2d5ee04d
2724.82,1.0,265,1,2,1,4,0xb2d52004d
1390.14,1.0,166,1,2,1,4,0xb2d0ea1dd
1297.27,1.0,108,1,2,1,4,0xb2d6e26cd
260063.85,3.0,13,3,4,3,10,0xb2d42e70d
114206.34,2.0,87,3,3,1,7,0xb2d4cc8f
1015.25,1.0,92,1,2,1,4,0xb2d3cc33d
601193.83,4.0,4,4,4,4,12,0xb2d0bf95
200765.28,2.0,28,3,3,2,8,0xb2d838e9
83364.42,1.0,184,3,2,1,6,0xb2d1ffa7d
2000021.21,2.0,20,4,3,2,9,0xb2d92b4cd
5073.16,1.0,184,2,2,1,5,0xb2d20713d
66100.86,3.0,94,3,4,1,8,0xb2d55c0cd
2669.82,1.0,0,1,2,4,7,0xb2d76665
1251.24,2.0,184,1,3,1,5,0x3b9b1637d
250052.73,9.0,14,3,4,3,10,0xb2d36d11
11056.04,2.0,14,2,3,3,8,0xb2d644df
400004.92,2.0,11,4,3,3,10,0xb2d6f106
6297.03,1.0,0,2,2,4,8,0xb2d34837
380091.87,4.0,4,4,4,4,12,0xb2d6082dd
112729.82,5.0,1,3,4,4,11,0xb2d6294cd
100098.38,4.0,0,3,4,4,11,0xb2d921b1
200000.0,2.0,32,3,3,2,8,0xb2d931b0
501776.04,2.0,35,4,3,2,9,0xb2d9fc3c
200262.49,2.0,1,3,3,4,10,0xb2d6284c
50023.99,2.0,9,2,3,3,8,0xb2d602c6
297427.95,6.0,1,3,4,4,11,0x3b9b46b1
131167.64,2.0,104,3,3,1,7,0xb2d5bc9f
10121.18,1.0,69,2,2,1,5,0xb2d8e1ded
32000.34,2.0,32,2,3,2,7,0xb2da02fe
13457.72,1.0,7,2,2,3,7,0xb2d5f828
140004.43,2.0,39,3,3,2,8,0xb2d9ebf3
470562.9,3.0,16,4,4,2,10,0xb2d49139
13041.36,1.0,184,2,2,1,5,0xb2d31ce0
61063.39,2.0,27,3,3,2,8,0xb2d66abed
188.18,1.0,26,1,2,2,5,0xb2d8e18f
5482.63,1.0,3,2,2,4,8,0xb2d2fcc4
260000.0,2.0,7,3,3,3,9,0xb2da530e
21.0,2.0,10,1,3,3,7,0xb2d7a73e
1004876.32,2.0,105,4,3,1,8,0xb2d418a7
291228.4,2.0,34,3,3,2,8,0xb2d6adb8
131322.04,6.0,4,3,4,4,11,0xb2d62cc9
12.56,1.0,10,1,2,3,6,0xb2d8636b
40139.96,1.0,13,2,2,3,7,0xb2d5eb75
301468.5,3.0,1,4,4,4,12,0xb2d9b177
680002.23,7.0,0,4,4,4,12,0xb2d594f1d
22.7,1.0,18,1,2,2,5,0xb2d21d8b
679581.8,15.0,52,4,4,2,10,0xb2d0dbeed
29.68,1.0,35,1,2,2,5,0xb2d2ade0
167817.14,2.0,49,3,3,2,8,0xb2d3c0db
26540.67,1.0,21,2,2,2,6,0xb2d8e9ae
483890.0,3.0,25,4,4,2,10,0xb2d3d6b8d
100123.04,2.0,11,3,3,3,9,0xb2d29221d
720086.45,3.0,21,4,4,2,10,0xb2d5bdaa
260001.44,5.0,59,3,4,2,9,0xb2d4329ed
1014.97,1.0,92,1,2,1,4,0xb2d1223bd
876.71,1.0,8,1,2,3,6,0xb2d8e18e
100085.75,3.0,189,3,4,1,8,0xb2d0681d
472.04,1.0,24,1,2,2,5,0xb2d62359
312667.78,3.0,77,4,4,1,9,0xb2d951c0d
389.36,1.0,1,1,2,4,7,0xb2d6de4d
3269.45,3.0,87,2,4,1,7,0xb2d266b3d
1363.97,2.0,10,1,3,3,7,0xb2d0af7a
1119000.0,5.0,3,4,4,4,12,0xb2d235f5d
53.77,1.0,8,1,2,3,6,0xb2d08d3e
143005.28,2.0,18,3,3,2,8,0xb2d636bdd
400008.44,2.0,24,4,3,2,9,0xb2d93248
76.57,1.0,8,1,2,3,6,0xb2d6a6b8
500177.04,2.0,14,4,3,3,10,0xb2d1249fd
464.4,1.0,8,1,2,3,6,0xb2d8f33d
80001.69,2.0,203,3,3,1,7,0xb2d7897f
280001.0,2.0,6,3,3,3,9,0xb2da3846
0.64,1.0,71,1,2,1,4,0xb2d5cbb0
5320.61,1.0,9,2,2,3,7,0xb2d59563
140002.43,3.0,47,3,4,2,9,0xb2d632dc
5915.74,1.0,92,2,2,1,5,0xb2d2ca46d
240027.87,1.0,20,3,2,2,7,0xb2d92757d
848.52,8.0,0,1,4,4,9,0xb2d1c8abd
500121.39,1.0,14,4,2,3,9,0xb2d92382
104149.82,3.0,14,3,4,3,10,0xb2d3ccb7
428.14,1.0,9,1,2,3,6,0xb2d205e8
20389.87,1.0,27,2,2,2,6,0xb2d681add
320003.38,3.0,18,4,4,2,10,0xb2da1f75
3938.86,1.0,217,2,2,1,5,0xb2d55e22d
329.71,1.0,57,1,2,2,5,0xb2d685f1d
1741.81,1.0,184,1,2,1,4,0xb2d27768
0.0,1.0,7,1,2,3,6,0xb2d3f80f
40000.0,2.0,6,2,3,3,8,0xb2d9709ed
4469.14,2.0,7,2,3,3,8,0xb2d22d13
2127.82,1.0,92,1,2,1,4,0xb2d0c97a
2341622.3,57.0,0,4,4,4,12,0xb2d0b943d
90018.63,3.0,6,3,4,3,10,0xb2d248e1
55883.28,1.0,308,3,2,1,6,0xb2d0ebe3d
35.47,1.0,0,1,2,4,7,0xb2d69215
14.8,2.0,12,1,3,3,7,0x3b9b10a1
161015.17,6.0,98,3,4,1,8,0xb2d530f6
270011.08,4.0,10,3,4,3,10,0xb2d956b9d
2826.29,1.0,10,1,2,3,6,0xb2d4b35bd
200710.55,2.0,57,3,3,2,8,0xb2d9c5d9
330018.12,4.0,7,4,4,3,11,0xb2d697de
274001.18,5.0,20,3,4,2,9,0xb2d6656cd
50221.45,2.0,193,2,3,1,6,0xb2d61fc1d
54784.35,2.0,14,3,3,3,9,0xb2d2ba00
20532.75,1.0,1,2,2,4,8,0xb2d3aa6e
223824.42,4.0,46,3,4,2,9,0xb2d5bbc1d
131565.55,2.0,5,3,3,3,9,0xb2d5b042d
39834.08,3.0,0,2,4,4,10,0xb2d26125
3833.16,1.0,153,2,2,1,5,0xb2d59e98
70051.09,3.0,0,3,4,4,11,0x3b9b3d22
2.21,1.0,18,1,2,2,5,0xb2da0a29
40.64,1.0,110,1,2,1,4,0xb2d13807
1116364.3,2.0,122,4,3,1,8,0xb2d43ee8
1175.23,1.0,184,1,2,1,4,0xb2d1eed7
106.62,1.0,4,1,2,4,7,0xb2d631c7
1021.46,1.0,54,1,2,2,5,0xb2d40fbb
785.87,1.0,9,1,2,3,6,0xb2d4149cd
2085.18,1.0,22,1,2,2,5,0xb2d8dffe
163.41,1.0,6,1,2,3,6,0xb2d6837f
600144.07,2.0,188,4,3,1,8,0xb2d23901
12.25,1.0,75,1,2,1,4,0xb2d636fd
75000.79,2.0,62,3,3,2,8,0xb2d8f73b
54311.65,2.0,59,3,3,2,8,0xb2d35a61
1263089.99,1.0,125,4,2,1,7,0xb2d2cc7a
8316.75,1.0,0,2,2,4,8,0xb2d8eb12
83216.34,2.0,92,3,3,1,7,0xb2d12ef2d
4951.0,1.0,24,2,2,2,6,0xb2d2cad4
325063.1,8.0,8,4,4,3,11,0xb2d64996
554389.27,11.0,0,4,4,4,12,0xb2d0d7aed
1545300.21,1.0,0,4,2,4,10,0xb2d5b388d
58.98,2.0,64,1,3,2,6,0x3b9b3164
15.95,1.0,18,1,2,2,5,0xb2d38c95
317.11,1.0,225,1,2,1,4,0xb2d6e60c
110800.02,2.0,153,3,3,1,7,0xb2d3440d
27687.46,1.0,1,2,2,4,8,0xb2d43671
177037.97,5.0,6,3,4,3,10,0xb2d28284
1842.01,1.0,5,1,2,3,6,0xb2d2cfb0
257662.0,2.0,209,3,3,1,7,0xb2d0e1f9d
25330.43,2.0,76,2,3,1,6,0xb2d1712d
375569.83,3.0,66,4,4,2,10,0xb2d589e0
63451.28,5.0,0,3,4,4,11,0xb2d1dabad
209.71,1.0,26,1,2,2,5,0xb2d184f2
20113.39,2.0,3,2,3,4,9,0xb2d580b1
50003.18,2.0,18,2,3,2,7,0xb2d3d17d
1354.16,1.0,92,1,2,1,4,0xb2d2e371
5444.03,1.0,0,2,2,4,8,0xb2d57ca3
2620.11,1.0,111,1,2,1,4,0xb2d38a0c
8746.07,1.0,0,2,2,4,8,0xb2d32775d
203554.49,2.0,105,3,3,1,7,0xb2d8e44cd
200003.31,2.0,14,3,3,3,9,0xb2d3315b
223933.98,2.0,32,3,3,2,8,0xb2d41ef1
200710.53,2.0,55,3,3,2,8,0xb2d9cca0
120769.32,4.0,11,3,4,3,10,0xb2d6d59bd
0.0,1.0,1,1,2,4,7,0xb2d8e9f2
12.9,1.0,77,1,2,1,4,0xb2d5a1ccd
290000.0,2.0,8,3,3,3,9,0xb2da4f37
416818.84,3.0,0,4,4,4,12,0xb2d6939c
72979.65,1.0,18,3,2,2,7,0xb2d3c44a
138.38,1.0,56,1,2,2,5,0xb2d177add
422.52,1.0,10,1,2,3,6,0xb2d6fe9c
1189.21,1.0,92,1,2,1,4,0xb2d1d9ab
9000000.0,4.0,3,4,4,4,12,0xb2d189bd
521427.5,4.0,28,4,4,2,10,0xb2d6aee4d
200213.32,2.0,5,3,3,3,9,0xb2d642a8
26042.02,3.0,1,2,4,4,10,0xb2d0e7a7d
5396.42,1.0,3,2,2,4,8,0xb2d41674
45.97,1.0,2,1,2,4,7,0xb2d34e8b
201402.52,7.0,0,3,4,4,11,0xb2d1ba50d
630095.1,3.0,12,4,4,3,11,0xb2d644b3d
308.3,1.0,1,1,2,4,7,0xb2d42f4fd
73.4,1.0,36,1,2,2,5,0xb2d3b7dad
20236.52,1.0,34,2,2,2,6,0xb2d5a9ed
10000.71,2.0,5,2,3,3,8,0xb2d1527fd
720359.33,3.0,14,4,4,3,11,0xb2d8e277d
1994.31,1.0,10,1,2,3,6,0xb2d2d892d
940.77,1.0,10,1,2,3,6,0xb2d56423
710.25,1.0,9,1,2,3,6,0xb2d27c4cd
2045.89,1.0,9,1,2,3,6,0xb2d39bf6
1130000.35,37.0,3,4,4,4,12,0xb2d0d04bd
5959.04,2.0,87,2,3,1,6,0xb2d44fbb
10141541.15,3.0,112,4,4,1,9,0xb2d91979
491795.12,4.0,72,4,4,1,9,0xb2d36e1a
110004.64,2.0,189,3,3,1,7,0xb2d63edd
126001.96,3.0,11,3,4,3,10,0xb2d4dd46
26288.41,1.0,0,2,2,4,8,0xb2d37355
1028.54,1.0,92,1,2,1,4,0xb2d246a4d
202898.3,2.0,48,3,3,2,8,0xb2d615e8d
10081.88,1.0,92,2,2,1,5,0xb2d32fdd
455.67,1.0,16,1,2,2,5,0xb2d26757
66.5,1.0,60,1,2,2,5,0xb2d9baad
103004.05,2.0,32,3,3,2,8,0xb2d64a62
367.09,1.0,33,1,2,2,5,0xb2d9ae0e
50144.75,1.0,92,2,2,1,5,0xb2d5ecd8d
3174964.66,3.0,13,4,4,3,11,0xb2d626b3
4016.11,1.0,97,2,2,1,5,0xb2d6d755
410725.94,7.0,26,4,4,2,10,0xb2d961a1d
14174.42,1.0,0,2,2,4,8,0xb2d2a1e3
40007.75,2.0,31,2,3,2,7,0xb2d55f57d
6422.49,1.0,92,2,2,1,5,0xb2d14df8d
181515.08,10.0,1,3,4,4,11,0xb2d2a3f6
180060.3,2.0,34,3,3,2,8,0xb2d21d77d
239.69,1.0,5,1,2,3,6,0xb2d64fb4d
1503.52,1.0,15,1,2,3,6,0xb2d8cd1cd
171610.09,4.0,0,3,4,4,11,0x3b9af1f9
42.22,1.0,28,1,2,2,5,0xb2d97813d
3079.39,1.0,0,2,2,4,8,0xb2d92c80
1616025.39,6.0,0,4,4,4,12,0xb2d6abfb
48.09,1.0,26,1,2,2,5,0xb2d82478
28975.15,1.0,63,2,2,2,6,0xb2d8c775
10245.42,1.0,0,2,2,4,8,0xb2d6ab43d
410610.31,6.0,2,4,4,4,12,0xb2d97815
50001.16,6.0,7,2,4,3,9,0xb2da1e52
4514.23,1.0,92,2,2,1,5,0xb2d5f899
500754.44,3.0,7,4,4,3,11,0xb2d6d161
13822.76,1.0,12,2,2,3,7,0xb2d75b24d
200000.0,2.0,7,3,3,3,9,0xb2d96fe5
450088.07,3.0,20,4,4,2,10,0xb2d9d025
4222.93,1.0,9,2,2,3,7,0xb2d938b2
101489.15,4.0,0,3,4,4,11,0xb2d624ecd
398000.24,4.0,6,4,4,3,11,0xb2d2b78ed
10013.1,1.0,21,2,2,2,6,0xb2d5a713
2650.75,1.0,184,1,2,1,4,0xb2d25d77d
1033.18,1.0,92,1,2,1,4,0xb2d36d28
5392.18,1.0,92,2,2,1,5,0xb2d1d592d
1730.83,1.0,92,1,2,1,4,0xb2d3f83c
729.63,1.0,0,1,2,4,7,0xb2d5ef86
414221.56,7.0,1,4,4,4,12,0xb2d5e896d
2210968.48,1.0,184,4,2,1,7,0x3b9b2c52d
10489.48,1.0,0,2,2,4,8,0xb2d5fe15
450745.43,4.0,19,4,4,2,10,0xb2d3adf6
400111.16,2.0,118,4,3,1,8,0xb2d0cbbed
47.39,1.0,48,1,2,2,5,0xb2d8dc93
293118.73,2.0,20,3,3,2,8,0xb2d410d2
52258.45,2.0,77,3,3,1,7,0xb2d41047
324043.95,10.0,13,4,4,3,11,0x3b9b3249
4673450.14,1.0,0,4,2,4,10,0xb2d24147d
8531.31,1.0,1,2,2,4,8,0xb2d3cf92
1.06,1.0,101,1,2,1,4,0xb2d815a8d
21032.16,2.0,111,2,3,1,6,0x3b9b47b1d
200644.63,3.0,76,3,4,1,8,0xb2d0d401
164.88,1.0,2,1,2,4,7,0xb2d95420
80574.7,2.0,0,3,3,4,10,0xb2d39818
100004.22,2.0,70,3,3,1,7,0xb2d9a292
53.65,1.0,56,1,2,2,5,0xb2d96ad8
199527.69,1.0,9,3,2,3,8,0x3b9ae020d
100001.06,2.0,224,3,3,1,7,0xb2d6fc40
110.33,1.0,9,1,2,3,6,0xb2d49142
76612.17,2.0,2,3,3,4,10,0xb2d3118dd
24666.88,1.0,0,2,2,4,8,0xb2d69b4e
48095.21,1.0,42,2,2,2,6,0xb2d6359bd
35942.42,3.0,10,2,4,3,9,0xb2d26618d
1544.6,1.0,12,1,2,3,6,0xb2d304d2
332265.14,3.0,14,4,4,3,11,0xb2d5964dd
154042.74,2.0,196,3,3,1,7,0xb2d5eb4d
1956.08,1.0,184,1,2,1,4,0xb2d2a193d
10117.76,1.0,4,2,2,4,8,0xb2d9109d
206813.36,3.0,1,3,4,4,11,0xb2d579b6
150097.85,2.0,74,3,3,1,7,0xb2d208bcd
11.3,1.0,11,1,2,3,6,0xb2d6b9de
200078.04,3.0,32,3,4,2,9,0xb2d9eefd
14385.04,2.0,191,2,3,1,6,0xb2d0a1c9d
0.31,1.0,4,1,2,4,7,0xb2d8f001d
132473.78,2.0,10,3,3,3,9,0xb2d6b2fc
66104.79,2.0,20,3,3,2,8,0xb2d108ab
80705.62,2.0,10,3,3,3,9,0xb2d1187e
299829.11,1.0,0,3,2,4,9,0xb2d540ca
1501164.02,5.0,21,4,4,2,10,0xb2d60854
21.71,1.0,28,1,2,2,5,0xb2d6bcc2
21038.45,1.0,2,2,2,4,8,0xb2d6e6db
1746052.54,2.0,0,4,3,4,11,0xb2d2bcc3
0.78,1.0,92,1,2,1,4,0xb2d11f23
5.63,4.0,16,1,4,2,7,0xb2d0bafed
7259.24,1.0,9,2,2,3,7,0xb2d37a69
250000.0,2.0,17,3,3,2,8,0xb2d6f23bd
805.29,1.0,9,1,2,3,6,0xb2d3826ed
249044.71,3.0,8,3,4,3,10,0xb2d0d2b5d
1605.3,1.0,184,1,2,1,4,0xb2d16974d
10038.2,2.0,0,2,3,4,9,0xb2d597f2
51158.8,1.0,4,2,2,4,8,0xb2d6c0af
2659.45,1.0,92,1,2,1,4,0xb2d3b3f7d
639027.9,15.0,25,4,4,2,10,0xb2d2b774
8.97,1.0,27,1,2,2,5,0xb2da0a5e
100763.66,4.0,13,3,4,3,10,0xb2d2b162d
628186.78,3.0,97,4,4,1,9,0xb2d06914
500596.29,1.0,13,4,2,3,9,0xb2d2e075
70100.74,2.0,13,3,3,3,9,0xb2d88ec3d
5261.03,1.0,173,2,2,1,5,0xb2d47068d
9.82,1.0,20,1,2,2,5,0xb2d5a72c
1513.43,1.0,9,1,2,3,6,0xb2d5aadc
129000.0,4.0,3,3,4,4,11,0xb2d5b0fad
586.47,2.0,92,1,3,1,5,0xb2d4b9fed
170075.0,2.0,92,3,3,1,7,0xb2d0bb60
122247.81,5.0,73,3,4,1,8,0xb2d2e7bf
5254.59,1.0,5,2,2,3,7,0xb2d83c22
165913.04,3.0,0,3,4,4,11,0xb2d075f5
200000.04,2.0,15,3,3,3,9,0xb2d582db
6105.15,2.0,1,2,3,4,9,0xb2d412ce
277.38,1.0,67,1,2,1,4,0xb2d0d807d
7007.06,1.0,5,2,2,3,7,0xb2d344f4d
8105.66,1.0,20,2,2,2,6,0xb2d6d280
56224.2,1.0,11,3,2,3,8,0xb2d8ddee
10316.75,1.0,184,2,2,1,5,0xb2d2a4a2d
5520.15,1.0,14,2,2,3,7,0xb2d921aa
250000.0,2.0,29,3,3,2,8,0xb2da0b45
0.0,1.0,1,1,2,4,7,0xb2d68bd1d
528000.0,4.0,1,4,4,4,12,0xb2d0cc61d
20000.0,1.0,4,2,2,4,8,0xb2d67de1
200000.0,2.0,1,3,3,4,10,0xb2d192e4
223589.31,2.0,6,3,3,3,9,0xb2d1c541
60063.55,2.0,37,3,3,2,8,0xb2d651a7d
447826.67,4.0,25,4,4,2,10,0xb2d39734d
5717.19,1.0,0,2,2,4,8,0xb2d43ae1
4019780.68,1.0,0,4,2,4,10,0xb2d42d02d
1091979.83,3.0,0,4,4,4,12,0xb2d48b55d
303198.18,2.0,48,4,3,2,9,0xb2d7c62ad
123503.48,2.0,70,3,3,1,7,0xb2d07b2b
451428.98,3.0,60,4,4,2,10,0xb2d9a99d
600811.64,6.0,8,4,4,3,11,0xb2d229e4
4211.65,1.0,4,2,2,4,8,0xb2d3bdba
573.56,1.0,1,1,2,4,7,0xb2d1eff2d
7686.13,1.0,0,2,2,4,8,0xb2d912ebd
75314.16,1.0,29,3,2,2,7,0xb2d52cfb
564176.18,6.0,186,4,4,1,9,0xb2d25bd0d
380002.06,6.0,11,4,4,3,11,0xb2d18d0bd
8443.46,1.0,18,2,2,2,6,0xb2d979ee
700013.54,8.0,6,4,4,3,11,0xb2d1a5a1
300006.33,4.0,0,3,4,4,11,0xb2d8dc6a
406958.43,4.0,30,4,4,2,10,0xb2d6b2e7d
2729.57,1.0,134,1,2,1,4,0xb2d33858
10394.78,1.0,188,2,2,1,5,0xb2d109cf
7302.39,1.0,2,2,2,4,8,0xb2d85d2bd
794506.62,5.0,49,4,4,2,10,0xb2d44289d
400728.21,3.0,26,4,4,2,10,0xb2d6e1db
100000.78,3.0,3,3,4,4,11,0xb2d557b9d
1176053.37,5.0,1,4,4,4,12,0xb2d34747d
15360.05,1.0,0,2,2,4,8,0xb2d1a299d
60.38,1.0,9,1,2,3,6,0xb2d51078
410866.2,9.0,1,4,4,4,12,0xb2d5b001
50000.48,2.0,41,2,3,2,7,0xb2d3b762d
23483.61,1.0,10,2,2,3,7,0xb2d25386
402597.45,3.0,4,4,4,4,12,0xb2d94a62d
10028.84,1.0,92,2,2,1,5,0xb2d5e5ad
1562.7,5.0,18,1,4,2,7,0x3b9b2b3ad
2031006.64,25.0,4,4,4,4,12,0xb2d0d173
2751356.72,11.0,15,4,4,3,11,0xb2d64eedd
106061.77,3.0,48,3,4,2,9,0xb2d3cf0f
55000.55,4.0,0,3,4,4,11,0xb2d2f281
18.6,1.0,31,1,2,2,5,0xb2d96e84
24909.22,1.0,7,2,2,3,7,0xb2d5cf1fd
13028.85,1.0,92,2,2,1,5,0xb2d31ce0d
8881.56,1.0,14,2,2,3,7,0xb2d8c8e1
3508.89,1.0,0,2,2,4,8,0xb2d50afc
3161.11,1.0,3,2,2,4,8,0xb2d933d5
664308.87,4.0,52,4,4,2,10,0xb2d06aea
2390061.25,5.0,92,4,4,1,9,0xb2d39a6cd
10116797.12,2.0,39,4,3,2,9,0xb2d628c5d
600000.0,2.0,20,4,3,2,9,0xb2da29fc
0.0,1.0,4,1,2,4,7,0xb2d50f70d
275000.0,4.0,1,3,4,4,11,0xb2d0b471d
4349.69,1.0,8,2,2,3,7,0xb2d0d7e8
2.65,1.0,48,1,2,2,5,0xb2d9ca8e
180016.76,3.0,18,3,4,2,9,0xb2d57140
11347.83,1.0,0,2,2,4,8,0xb2d359d2
1829582.48,5.0,1,4,4,4,12,0xb2d24b06
397167.02,4.0,63,4,4,2,10,0xb2d8596fd
200063.4,2.0,24,3,3,2,8,0xb2d787ed
58138.85,1.0,10,3,2,3,8,0xb2d2c1edd
500011.74,2.0,105,4,3,1,8,0xb2d78cad
265078.17,4.0,97,3,4,1,8,0xb2d070d7
3215.04,1.0,7,2,2,3,7,0xb2d753be
95017.11,3.0,15,3,4,3,10,0xb2d23dafd
2.74,1.0,18,1,2,2,5,0xb2d956b8
4058.33,1.0,92,2,2,1,5,0xb2d4098bd
23253.36,1.0,9,2,2,3,7,0xb2d4006dd
440.16,1.0,20,1,2,2,5,0xb2d3a1d8
500000.04,2.0,17,4,3,2,9,0xb2d9e1bb
300000.0,2.0,12,3,3,3,9,0xb2d9651a
4914.77,1.0,10,2,2,3,7,0xb2d68e6dd
200017.13,2.0,2,3,3,4,10,0xb2d2e9e9
200813.35,2.0,16,3,3,2,8,0xb2d91581d
764.07,1.0,42,1,2,2,5,0xb2d4b637d
257778.01,2.0,5,3,3,3,9,0xb2d5196f
143183.95,3.0,83,3,4,1,8,0xb2d3bf9c
1162.42,1.0,6,1,2,3,6,0xb2d2f72dd
51.52,1.0,5,1,2,3,6,0xb2d5c7d6d
700014.23,4.0,3,4,4,4,12,0xb2d6d3d0
150001.58,2.0,13,3,3,3,9,0xb2d95e0b
1000011.09,2.0,24,4,3,2,9,0xb2d9497c
16.78,1.0,71,1,2,1,4,0xb2d8c7fb
110863.9,1.0,0,3,2,4,9,0xb2d5682a
2584842.8,5.0,32,4,4,2,10,0xb2d46893
100447.39,2.0,171,3,3,1,7,0xb2d45a5f
286311.01,6.0,0,3,4,4,11,0x3b9b183e
1100000.0,3.0,0,4,4,4,12,0xb2d4be64
428332.93,12.0,76,4,4,1,9,0xb2d11155
1300000.0,2.0,3,4,3,4,11,0xb2da0ba1
409957.38,2.0,28,4,3,2,9,0xb2d65852
831437.23,10.0,2,4,4,4,12,0xb2d6aab0d
500715.59,5.0,11,4,4,3,11,0xb2d56337
250062.88,3.0,10,3,4,3,10,0xb2d60f3ad
2000554.3,5.0,1,4,4,4,12,0xb2d6cbdd
100010.83,2.0,1,3,3,4,10,0xb2d9b7c3
75316.74,1.0,7,3,2,3,8,0xb2d2f8d1
1.61,1.0,4,1,2,4,7,0xb2d2d5e9
200029.49,2.0,3,3,3,4,10,0xb2d62980
301.86,1.0,40,1,2,2,5,0xb2d432aad
640752.96,6.0,0,4,4,4,12,0xb2d59a73d
685079.24,5.0,9,4,4,3,11,0x3b9b1014d
76.25,1.0,8,1,2,3,6,0xb2d30afad
12895.84,1.0,10,2,2,3,7,0xb2d1c33ed
40082.73,1.0,1,2,2,4,8,0xb2d46c50
8939529.19,7.0,3,4,4,4,12,0x3b9b2925
227489.42,8.0,1,3,4,4,11,0xb2d34740d
124.32,1.0,74,1,2,1,4,0xb2d5823a
200007.63,2.0,118,3,3,1,7,0xb2d51bf1d
0.0,1.0,4,1,2,4,7,0xb2d3afd5
336287.24,5.0,0,4,4,4,12,0xb2d23ef0
460000.0,8.0,0,4,4,4,12,0xb2d37910
15.07,1.0,11,1,2,3,6,0xb2d33dda
75001.01,1.0,1,3,2,4,9,0xb2d1e9cb
5933.84,1.0,9,2,2,3,7,0xb2d6fb21d
19997.57,1.0,2,2,2,4,8,0xb2d3a111d
1277.35,1.0,168,1,2,1,4,0xb2d40693d
300011.67,2.0,31,3,3,2,8,0xb2d622be
288537.03,18.0,1,3,4,4,11,0xb2d59eea
370000.4,6.0,5,4,4,3,11,0xb2d17807d
2800130.89,2.0,0,4,3,4,11,0xb2d8f3bbd
500000.0,2.0,4,4,3,4,11,0xb2da611d
0.18,1.0,33,1,2,2,5,0xb2d9282b
1694.94,1.0,184,1,2,1,4,0xb2d2d905d
1381.61,1.0,92,1,2,1,4,0xb2d129ded
266.84,1.0,8,1,2,3,6,0xb2d1c9cd
2401.81,2.0,92,1,3,1,5,0xb2d0d5cbd
272948.39,2.0,93,3,3,1,7,0xb2d5212c
1646.67,1.0,9,1,2,3,6,0xb2d408e9
155135.77,2.0,14,3,3,3,9,0xb2d5df98d
1106.33,1.0,10,1,2,3,6,0xb2d3d9e6d
1970.78,1.0,25,1,2,2,5,0x3b9b3951
113112.63,2.0,0,3,3,4,10,0xb2da03b1
26592.7,1.0,0,2,2,4,8,0xb2d2b5cd
411386.45,4.0,25,4,4,2,10,0xb2d0b5f7d
2548.17,1.0,12,1,2,3,6,0xb2d07cc0d
29.83,1.0,14,1,2,3,6,0xb2d91c8a
752.68,1.0,8,1,2,3,6,0xb2d1fb10d
2742.2,1.0,9,1,2,3,6,0xb2d26021
633.89,1.0,0,1,2,4,7,0xb2d21350
200977.5,2.0,22,3,3,2,8,0xb2d6f6cf
3545.65,1.0,92,2,2,1,5,0xb2d0fbfdd
18.26,1.0,0,1,2,4,7,0xb2d8d354d
0.94,1.0,5,1,2,3,6,0xb2d61f1d
7094.52,1.0,96,2,2,1,5,0xb2d2cd55d
500006.67,3.0,0,4,4,4,12,0xb2d6c977
30001.27,2.0,186,2,3,1,6,0xb2d85ed7
280008.21,3.0,15,3,4,3,10,0xb2d204b2
1765.86,1.0,65,1,2,2,5,0xb2d8f4fbd
70485.08,2.0,160,3,3,1,7,0xb2d65688
250000.78,2.0,17,3,3,2,8,0xb2d65ca0
29581.24,1.0,0,2,2,4,8,0xb2d50b2c
0.0,1.0,1,1,2,4,7,0xb2da444b
150060.86,1.0,1,3,2,4,9,0xb2d4f684
4.32,1.0,11,1,2,3,6,0xb2d39d7f
266831.72,5.0,0,3,4,4,11,0xb2d3999c
182404.61,5.0,4,3,4,4,11,0xb2d101d1
100003.74,3.0,70,3,4,1,8,0xb2d1f31c
1669.51,1.0,134,1,2,1,4,0xb2d61c1cd
1535016.2,2.0,25,4,3,2,9,0xb2da0a9a
670485.89,4.0,31,4,4,2,10,0xb2d256ab
5556.97,1.0,32,2,2,2,6,0xb2d43ad8d
54240.01,1.0,116,3,2,1,6,0xb2d5db83d
20000.21,2.0,189,2,3,1,6,0xb2d856fad
138243.67,3.0,87,3,4,1,8,0xb2d4fe2a
92288.63,2.0,14,3,3,3,9,0xb2d2f909
1481.36,1.0,11,1,2,3,6,0xb2d1f585
279860.0,4.0,4,3,4,4,11,0xb2da24a1
762642.02,6.0,3,4,4,4,12,0xb2d26286
501893.89,2.0,31,4,3,2,9,0xb2d6e3fbd
220091.07,7.0,24,3,4,2,9,0xb2d20b8b
527837.44,2.0,49,4,3,2,9,0xb2d3a675
5168.63,1.0,0,2,2,4,8,0xb2d6bb7ed
17490.42,3.0,4,2,4,4,10,0xb2d10473
281229.1,6.0,0,3,4,4,11,0xb2d2dde5d
21011.56,2.0,179,2,3,1,6,0xb2d36249d
224177.76,3.0,0,3,4,4,11,0xb2d93463
860935.89,5.0,0,4,4,4,12,0xb2d593ecd
101093.76,2.0,0,3,3,4,10,0xb2d8933d
4286.13,1.0,81,2,2,1,5,0xb2d2f9ee
1956.95,1.0,165,1,2,1,4,0xb2d4058cd
66402.03,3.0,140,3,4,1,8,0xb2d52a73
400851.04,5.0,6,4,4,3,11,0xb2d64cd5
7744.74,1.0,0,2,2,4,8,0xb2d6b574d
536.03,1.0,110,1,2,1,4,0xb2d19a43
221669.34,4.0,85,3,4,1,8,0xb2d083a8d
1571950.13,5.0,55,4,4,2,10,0xb2d28d3c
806081.65,7.0,2,4,4,4,12,0xb2d65f91
99007.77,5.0,14,3,4,3,10,0xb2d5b045d
198379.94,1.0,10,3,2,3,8,0xb2d43550
1781225.2,8.0,4,4,4,4,12,0x3b9b0fe0
297798.6,5.0,14,3,4,3,10,0xb2d350bf
3025.72,1.0,92,2,2,1,5,0xb2d36063
26803.32,1.0,34,2,2,2,6,0xb2d48ffd
150001.58,2.0,14,3,3,3,9,0xb2da39ec
1573.11,2.0,1,1,3,4,8,0xb2d5f0f4
8022.55,1.0,184,2,2,1,5,0xb2d0ad2c
3.74,1.0,0,1,2,4,7,0xb2d2b7b6
103236.4,3.0,195,3,4,1,8,0xb2d1a4f5
9728.35,1.0,18,2,2,2,6,0xb2d6bcebd
22.64,1.0,87,1,2,1,4,0xb2d6b38c
30000.95,2.0,10,2,3,3,8,0xb2d95fbd
70368.94,8.0,48,3,4,2,9,0x3b9b47aa
5203.2,3.0,1,2,4,4,10,0xb2d0655b
15886.29,1.0,9,2,2,3,7,0xb2d42f0d
18627.35,4.0,8,2,4,3,9,0x3b9af24d
6.88,1.0,273,1,2,1,4,0xb2d4276ad
326191.74,1.0,4,4,2,4,10,0xb2d14cd8
51022.39,2.0,67,2,3,1,6,0xb2d626a9d
80603.16,1.0,0,3,2,4,9,0xb2d16cc2d
600006.33,3.0,28,4,4,2,10,0xb2d9d8a1
937.31,1.0,55,1,2,2,5,0xb2d690ec
239.8,11.0,0,1,4,4,9,0x3b9b17f8d
18894.02,2.0,10,2,3,3,8,0xb2d183d9
875537.44,5.0,11,4,4,3,11,0xb2d26de0d
594571.28,2.0,92,4,3,1,8,0x3b9b0f49
933.31,1.0,24,1,2,2,5,0xb2d23ca8d
410712.86,5.0,8,4,4,3,11,0x3b9b343f
692011.15,9.0,11,4,4,3,11,0xb2d1e0c6d
281683.18,9.0,0,3,4,4,11,0x3b9af112
101365.75,2.0,33,3,3,2,8,0xb2d6570f
50.24,1.0,26,1,2,2,5,0xb2d219b5
2630410.82,4.0,0,4,4,4,12,0xb2d5f6b0d
3487.81,1.0,0,2,2,4,8,0xb2d8f620
670007.48,4.0,19,4,4,2,10,0xb2d4b9b2
82183.45,3.0,95,3,4,1,8,0xb2d5cbd5
61.28,1.0,189,1,2,1,4,0xb2d25884
215140.67,4.0,4,3,4,4,11,0xb2d5a7bb
36775.12,2.0,0,2,3,4,9,0xb2d4c936d
52033.32,2.0,87,2,3,1,6,0xb2d593f8
1315.37,1.0,184,1,2,1,4,0xb2d1772d
347482.01,3.0,0,4,4,4,12,0xb2d69eb8
200084.59,2.0,286,3,3,1,7,0xb2d5dd02
2830.86,1.0,1,1,2,4,7,0xb2d9b2a5
500006.11,3.0,5,4,4,3,11,0xb2d9ea2c
0.0,1.0,7,1,2,3,6,0xb2d1d9cc
716732.99,3.0,1,4,4,4,12,0xb2d11e74
600036.87,4.0,18,4,4,2,10,0xb2d6b774d
34566.0,3.0,0,2,4,4,10,0xb2d56847
196.82,1.0,22,1,2,2,5,0xb2d0ceea
325310.13,3.0,0,4,4,4,12,0xb2d26d78d
225741.33,2.0,175,3,3,1,7,0xb2d41aacd
4554.1,1.0,9,2,2,3,7,0xb2d390b6d
200033.45,4.0,1,3,4,4,11,0xb2d0abc5
60956.86,2.0,41,3,3,2,8,0xb2d1355ad
1200550.75,7.0,74,4,4,1,9,0x3b9b1328
356217.66,8.0,11,4,4,3,11,0x3b9b3b70
47.3,1.0,4,1,2,4,7,0xb2d3f4a1
315504.39,16.0,3,4,4,4,12,0xb2d06a88
470034.01,4.0,1,4,4,4,12,0xb2d5bfc6d
150732.28,3.0,2,3,4,4,11,0xb2d8d225d
15507.71,1.0,278,2,2,1,5,0xb2d59cb9
9.28,1.0,77,1,2,1,4,0xb2d34422
331.54,1.0,56,1,2,2,5,0xb2d2a800
758299.03,5.0,0,4,4,4,12,0xb2d0cbbdd
343.3,1.0,2,1,2,4,7,0xb2d11c20
2641207.68,2.0,3,4,3,4,11,0xb2d638fad
50019.03,2.0,27,2,3,2,7,0xb2da03d2
57355.93,1.0,20,3,2,2,7,0xb2d0fa55
1320000.0,2.0,5,4,3,3,10,0xb2da5f2b
26409.24,1.0,0,2,2,4,8,0xb2d8f94b
2060022.98,9.0,4,4,4,4,12,0xb2d22735d
483.24,1.0,3,1,2,4,7,0xb2d943d1
71041.56,2.0,137,3,3,1,7,0xb2d0f667d
46338.16,2.0,19,2,3,2,7,0xb2d1a024
500539.0,6.0,1,4,4,4,12,0xb2d52b5b
10646.49,3.0,0,2,4,4,10,0xb2d20f96
1420000.0,2.0,13,4,3,3,10,0xb2d9601c
156.91,1.0,2,1,2,4,7,0xb2d34360
1598.74,1.0,5,1,2,3,6,0xb2d6c440
673698.77,2.0,3,4,3,4,11,0xb2d4dbabd
2000.0,1.0,9,1,2,3,6,0xb2d8db4a
480000.0,17.0,1,4,4,4,12,0x3b9b366c
173002.96,4.0,117,3,4,1,8,0xb2d1a4de
6809.66,1.0,147,2,2,1,5,0xb2d6deded
53191.85,1.0,0,3,2,4,9,0xb2da4c32
168000.0,7.0,4,3,4,4,11,0xb2d65981d
27888.63,1.0,10,2,2,3,7,0xb2da294f
8021.52,5.0,92,2,4,1,7,0xb2d08cb8
500000.0,2.0,13,4,3,3,10,0xb2d9606c
1748.42,1.0,92,1,2,1,4,0xb2d0ebc8d
904312.59,3.0,0,4,4,4,12,0xb2d238cfd
153004.52,4.0,125,3,4,1,8,0xb2d08529
810017.1,2.0,59,4,3,2,9,0xb2d8fcdbd
203149.95,2.0,87,3,3,1,7,0xb2d5e92cd
837.46,1.0,25,1,2,2,5,0xb2d47a3f
100014.43,7.0,3,3,4,4,11,0x3b9b459b
21.35,1.0,0,1,2,4,7,0xb2d6e1acd
100227.94,3.0,53,3,4,2,9,0xb2d57f8dd
255.18,3.0,4,1,4,4,9,0x3b9af226
60.52,1.0,24,1,2,2,5,0xb2d2f6cfd
400043.72,3.0,0,4,4,4,12,0xb2d65c94d
162333.18,8.0,11,3,4,3,10,0xb2d5dbd6
14.82,1.0,62,1,2,2,5,0xb2d651da
37003.89,1.0,0,2,2,4,8,0xb2d64939
47.26,1.0,9,1,2,3,6,0xb2d9430b
3565.08,1.0,28,2,2,2,6,0xb2d2e5a0
4781552.3,10.0,0,4,4,4,12,0x3b9af0bf
370029.41,2.0,13,4,3,3,10,0xb2d957af
60001.27,2.0,74,3,3,1,7,0xb2d99c92
3046.24,1.0,184,2,2,1,5,0xb2d1d119d
0.0,2.0,0,1,3,4,8,0x3b9af191d
30726.17,1.0,0,2,2,4,8,0xb2d2b7add
10151.06,1.0,184,2,2,1,5,0xb2d56a7dd
10001.06,2.0,18,2,3,2,7,0xb2d603e9
182294.99,2.0,97,3,3,1,7,0xb2d11d73
47355.14,1.0,4,2,2,4,8,0xb2d90776
8.66,2.0,11,1,3,3,7,0xb2d2d0d9
1.58,1.0,101,1,2,1,4,0xb2d7f54ed
111089.87,1.0,21,3,2,2,7,0xb2d58474d
0.41,1.0,3,1,2,4,7,0xb2d68779d
1086.15,1.0,161,1,2,1,4,0xb2d26e23d
194623.04,8.0,15,3,4,3,10,0x3b9b42bfd
80770.01,2.0,56,3,3,2,8,0xb2d2a4bed
102026.02,2.0,76,3,3,1,7,0xb2d310fe
45440.18,3.0,6,2,4,3,9,0xb2d4247b
52849.49,2.0,143,3,3,1,7,0xb2d41f16d
110145.88,2.0,221,3,3,1,7,0xb2d2ba33d
49998.95,1.0,7,2,2,3,7,0xb2d95f36
523.28,3.0,9,1,4,3,8,0xb2d27bb1
180288.63,5.0,4,3,4,4,11,0xb2d2bb8b
16.84,1.0,8,1,2,3,6,0xb2d6dc4cd
20023.86,1.0,122,2,2,1,5,0xb2d6e1c0d
1264873.63,36.0,0,4,4,4,12,0xb2d18ec1
364750.11,3.0,92,4,4,1,9,0xb2d3d62dd
40666.5,2.0,0,2,3,4,9,0xb2d28b4c
8273.22,1.0,184,2,2,1,5,0x3b9b268f
69.78,1.0,6,1,2,3,6,0xb2d609af
11.68,1.0,21,1,2,2,5,0xb2d0b806d
131760.98,2.0,73,3,3,1,7,0xb2d36231d
1120.18,1.0,184,1,2,1,4,0xb2d1a2ced
18.64,2.0,1,1,3,4,8,0xb2d9326f
3565.17,1.0,5,2,2,3,7,0xb2d42b3fd
269494.87,3.0,97,3,4,1,8,0xb2d1083d
10058.9,3.0,184,2,4,1,7,0xb2d26fcad
500000.0,3.0,8,4,4,3,11,0xb2d6904a
30000.95,2.0,60,2,3,2,7,0xb2d6539d
410004.17,5.0,45,4,4,2,10,0xb2d11849d
100033.41,2.0,93,3,3,1,7,0xb2d5f486
500000.0,2.0,22,4,3,2,9,0xb2da206f
592984.3,3.0,108,4,4,1,9,0xb2d65b43d
330000.0,4.0,3,4,4,4,12,0xb2d5b5a9d
324.15,1.0,9,1,2,3,6,0xb2d6c499
1500000.04,3.0,15,4,4,3,11,0xb2d9e164
1423.26,2.0,184,1,3,1,5,0xb2d12b02
200043.25,3.0,129,3,4,1,8,0xb2d17436d
4.06,1.0,84,1,2,1,4,0xb2d3527d
819.95,1.0,29,1,2,2,5,0xb2d404ff
23.68,1.0,8,1,2,3,6,0xb2d28ffdd
4076.8,1.0,2,2,2,4,8,0xb2d6b4dfd
464303.07,1.0,0,4,2,4,10,0xb2d8f1e3
1652.94,1.0,1,1,2,4,7,0xb2d589bb
400000.0,4.0,8,4,4,3,11,0xb2d410fdd
2606.18,1.0,92,1,2,1,4,0xb2d40e58d
276318.07,2.0,60,3,3,2,8,0xb2d19414
13283.26,1.0,274,2,2,1,5,0xb2d3ce45
200712.09,2.0,28,3,3,2,8,0xb2d6399e
107845.87,7.0,6,3,4,3,10,0x3b9adafcd
200421.18,2.0,11,3,3,3,9,0xb2d9929c
80.31,1.0,60,1,2,2,5,0xb2d9a910
11103.87,6.0,8,2,4,3,9,0xb2d0685c
209439.27,5.0,3,3,4,4,11,0xb2d6180ad
32.43,1.0,10,1,2,3,6,0xb2d34361
3041.72,1.0,5,2,2,3,7,0xb2d2e9af
50026.26,2.0,0,2,3,4,9,0xb2d597b4
1283.01,1.0,9,1,2,3,6,0xb2d5f07f
1010.49,1.0,184,1,2,1,4,0xb2d2b840
380396.19,1.0,0,4,2,4,10,0xb2d1b2b1
302139.19,2.0,10,4,3,3,10,0xb2d9567e
5590.06,4.0,0,2,4,4,10,0x3b9b102b
169.2,1.0,0,1,2,4,7,0xb2d2b5e0
6.67,1.0,38,1,2,2,5,0xb2d6d3bf
870492.93,14.0,0,4,4,4,12,0x3b9add59
50907.85,2.0,206,2,3,1,6,0xb2d5bd2f
1003625.95,4.0,5,4,4,3,11,0xb2d63c3fd
18538.32,1.0,1,2,2,4,8,0xb2d6f43cd
2854.86,1.0,10,1,2,3,6,0xb2d3a87dd
329000.72,5.0,0,4,4,4,12,0xb2d629f7d
200014.56,3.0,13,3,4,3,10,0xb2da0620
82325.71,2.0,0,3,3,4,10,0xb2d64fb5d
43211.96,2.0,101,2,3,1,6,0xb2d583a1d
245.51,1.0,48,1,2,2,5,0xb2d357f9
57091.95,1.0,16,3,2,2,7,0xb2d60f39
1007893.28,2.0,35,4,3,2,9,0xb2d62a31d
36.1,1.0,0,1,2,4,7,0xb2d31933
33792.92,1.0,1,2,2,4,8,0xb2d68785d
1280.86,1.0,184,1,2,1,4,0xb2d3bfbbd
197585.45,3.0,182,3,4,1,8,0xb2d6ab77d
16.0,1.0,48,1,2,2,5,0xb2d24a73d
45.96,1.0,89,1,2,1,4,0xb2d593ef
48.15,1.0,5,1,2,3,6,0xb2d8e99d
41941.09,1.0,14,2,2,3,7,0xb2d32cc4
92715.81,2.0,11,3,3,3,9,0xb2d0e779d
250681.61,11.0,0,3,4,4,11,0x3b9b12c2d
20000.3,3.0,95,2,4,1,7,0xb2d5364b
87955.08,2.0,80,3,3,1,7,0xb2d579af
16.98,1.0,0,1,2,4,7,0xb2d6351f
302131.71,2.0,76,4,3,1,8,0xb2d99d36
749000.0,6.0,8,4,4,3,11,0xb2d368dad
0.92,1.0,8,1,2,3,6,0xb2d64c3a
156003.79,3.0,92,3,4,1,8,0xb2d4dcdad
1108.58,1.0,92,1,2,1,4,0xb2d34a7dd
10486.46,2.0,3,2,3,4,9,0xb2d91ee4
43.62,1.0,5,1,2,3,6,0xb2d6ad1c
105629.79,2.0,49,3,3,2,8,0xb2d28202d
1402.15,1.0,169,1,2,1,4,0xb2d243e3d
1702.94,1.0,18,1,2,2,5,0xb2d60bddd
270041.76,2.0,83,3,3,1,7,0xb2d3ffdf
1374.51,1.0,228,1,2,1,4,0xb2d62d77
175290.35,5.0,21,3,4,2,9,0xb2d5726b
86019.55,2.0,18,3,3,2,8,0xb2d1588bd
250663.16,6.0,10,3,4,3,10,0xb2d504cfd
126112.75,2.0,17,3,3,2,8,0xb2d16268
304920.38,1.0,1,4,2,4,10,0xb2d26892
5126.38,1.0,184,2,2,1,5,0xb2d53deed
200000.0,2.0,13,3,3,3,9,0xb2da3fd3
50001.06,2.0,185,2,3,1,6,0xb2d6ad59
375010.5,3.0,25,4,4,2,10,0xb2d98a36
1823.82,1.0,15,1,2,3,6,0xb2d7077ed
7603.74,3.0,92,2,4,1,7,0xb2d17a3b
631285.5,8.0,0,4,4,4,12,0xb2d14a03
27.35,1.0,3,1,2,4,7,0xb2d433e2d
2078.79,1.0,10,1,2,3,6,0xb2d1d1c0d
40547.72,1.0,0,2,2,4,8,0xb2d15394d
65909.53,1.0,9,3,2,3,8,0xb2d47267
200005.35,1.0,4,3,2,4,9,0xb2d55ce2
117.75,1.0,49,1,2,2,5,0xb2d38c8ad
3128.72,1.0,92,2,2,1,5,0xb2d11980
4878.39,1.0,18,2,2,2,6,0xb2d6c4c4
1154.18,2.0,184,1,3,1,5,0xb2d09879d
700658.95,4.0,1,4,4,4,12,0xb2d0dbac
235618.7,3.0,0,3,4,4,11,0xb2d62e0a
6966.51,2.0,46,2,3,2,7,0xb2d200d4d
336587.44,1.0,4,4,2,4,10,0xb2d37315
17.54,1.0,0,1,2,4,7,0xb2d60f6c
1142115.37,6.0,73,4,4,1,9,0xb2d0fe15
1254.46,1.0,4,1,2,4,7,0xb2d92594
0.28,1.0,0,1,2,4,7,0xb2d85b70d
49.13,1.0,36,1,2,2,5,0xb2d9aab4
285.13,1.0,46,1,2,2,5,0xb2d24599
923014.01,8.0,37,4,4,2,10,0xb2d5a4c9
448031.69,5.0,10,4,4,3,11,0xb2d1bed7
708008.63,3.0,165,4,4,1,9,0xb2d6af50
4.92,1.0,17,1,2,2,5,0xb2d1f6ef
600000.0,4.0,0,4,4,4,12,0xb2d9bada
400000.0,3.0,21,4,4,2,10,0xb2d950a6d
366.31,1.0,5,1,2,3,6,0xb2d346e5
30000.32,2.0,147,2,3,1,6,0xb2d903b8
678.96,1.0,2,1,2,4,7,0xb2d96acdd
329160.51,3.0,4,4,4,4,12,0xb2d41963d
2.63,1.0,13,1,2,3,6,0xb2d6c1f1d
299.4,1.0,0,1,2,4,7,0xb2d78348
254594.37,4.0,23,3,4,2,9,0xb2d08069
124527.18,1.0,154,3,2,1,6,0xb2d1dab0
261460.85,3.0,10,3,4,3,10,0xb2d0dfbed
38014.58,1.0,0,2,2,4,8,0xb2d3319a
32889.78,1.0,1,2,2,4,8,0xb2d65041
30.34,1.0,11,1,2,3,6,0xb2d93700
47.77,1.0,9,1,2,3,6,0xb2d90c34
161004.1,4.0,6,3,4,3,10,0xb2d53a8b
107602.74,10.0,0,3,4,4,11,0xb2d2ba23d
600041.69,3.0,3,4,4,4,12,0xb2d64033
1284.5,1.0,184,1,2,1,4,0xb2d58940
1282084.54,12.0,0,4,4,4,12,0xb2d17124d
8614.87,1.0,2,2,2,4,8,0xb2d3c46ed
755.09,1.0,5,1,2,3,6,0xb2d6b32e
3789.85,1.0,3,2,2,4,8,0xb2d1d8be
109714.0,2.0,184,3,3,1,7,0xb2d0f976
164859.78,5.0,39,3,4,2,9,0xb2d50f2dd
3970.77,1.0,4,2,2,4,8,0xb2d62276d
20413.98,2.0,0,2,3,4,9,0xb2d53045
22.55,1.0,0,1,2,4,7,0xb2d6e165
417130.43,2.0,109,4,3,1,8,0xb2d6f173
200010.83,2.0,77,3,3,1,7,0xb2d65b72d
300055.12,2.0,41,3,3,2,8,0xb2d62029
200001.9,2.0,13,3,3,3,9,0xb2d8df59d
80.09,1.0,9,1,2,3,6,0xb2d43205
76000.8,2.0,48,3,3,2,8,0xb2d91235
5119.78,2.0,89,2,3,1,6,0xb2d0988c
11.36,1.0,7,1,2,3,6,0xb2d7e2e2d
1406.15,1.0,92,1,2,1,4,0xb2d29581
920209.12,4.0,19,4,4,2,10,0xb2d42e08d
9592.36,1.0,0,2,2,4,8,0xb2d6b7c6
81858.0,1.0,12,3,2,3,8,0xb2d2151f
305095.1,3.0,108,4,4,1,9,0xb2d588fa
85092.95,9.0,0,3,4,4,11,0x3b9af0cad
80889.18,1.0,2,3,2,4,9,0xb2d3a373
10063.86,2.0,31,2,3,2,7,0xb2d31600
12.17,1.0,66,1,2,2,5,0xb2d8c9a5
15552.32,1.0,10,2,2,3,7,0xb2d43826d
323000.0,29.0,7,4,4,3,11,0xb2d1c2a6
120.96,1.0,4,1,2,4,7,0xb2d9161d
1679.1,1.0,115,1,2,1,4,0xb2d8cfc7d
200000.84,2.0,8,3,3,3,9,0xb2d9aca9
17710.7,1.0,23,2,2,2,6,0xb2d30d0fd
226.94,1.0,0,1,2,4,7,0xb2d30349
109542.02,2.0,0,3,3,4,10,0xb2d2824b
500119.63,1.0,3,4,2,4,10,0xb2d08055d
10158.39,1.0,22,2,2,2,6,0xb2d61a31d
400335.51,3.0,13,4,4,3,11,0xb2d6abfa
38877.71,1.0,21,2,2,2,6,0xb2d60a43d
106377.76,2.0,171,3,3,1,7,0xb2d5ee6dd
21521.08,1.0,174,2,2,1,5,0xb2d5c94f
3500.94,1.0,9,2,2,3,7,0xb2d78122
200720.88,2.0,26,3,3,2,8,0xb2d9bc28
1084658.53,6.0,0,4,4,4,12,0xb2d102df
26171.58,1.0,184,2,2,1,5,0xb2d0e9ded
333335.22,3.0,27,4,4,2,10,0xb2d29618
898879.15,5.0,82,4,4,1,9,0xb2d087a5d
11736.54,1.0,59,2,2,2,6,0xb2d6a6c4
60000.63,2.0,31,3,3,2,8,0xb2d93b72
402846.7,2.0,22,4,3,2,9,0xb2d8cd4b
650017.82,2.0,14,4,3,3,10,0xb2d9a0f0
400004.64,3.0,13,4,4,3,11,0xb2d608cdd
150001.06,3.0,66,3,4,2,9,0xb2d5061fd
643620.3,13.0,0,4,4,4,12,0xb2d07856
5982.04,5.0,5,2,4,3,9,0xb2d06580
102124.5,6.0,5,3,4,3,10,0xb2d156eb
500052.59,2.0,20,4,3,2,9,0xb2d988ce
103669.84,2.0,25,3,3,2,8,0x3b9b2d1ed
360721.22,6.0,24,4,4,2,10,0xb2d0947ad
1901479.87,8.0,29,4,4,2,10,0xb2d07791
252447.59,6.0,34,3,4,2,9,0xb2d436c9
1016.09,1.0,184,1,2,1,4,0xb2d112fa
200966.23,2.0,90,3,3,1,7,0xb2d61553d
309514.88,2.0,17,4,3,2,9,0xb2d249e0d
8232.79,1.0,3,2,2,4,8,0xb2d97a7c
350316.31,2.0,4,4,3,4,11,0xb2d6d4a9d
50000.53,2.0,52,2,3,2,7,0xb2d90b94
35699.85,1.0,10,2,2,3,7,0xb2d74d3c
455.76,1.0,4,1,2,4,7,0xb2d6cf0f
2623.44,1.0,11,1,2,3,6,0xb2d373f2
297008.73,3.0,4,3,4,4,11,0xb2d170b6d
200025.94,2.0,60,3,3,2,8,0xb2d94d58
40000.42,2.0,98,2,3,1,6,0xb2d96ffad
18795.7,1.0,15,2,2,3,7,0xb2d2e1f0
16495.47,1.0,0,2,2,4,8,0xb2d3ba5dd
1324.28,2.0,92,1,3,1,5,0xb2d1704f
51262.09,1.0,184,2,2,1,5,0xb2d0d24f
467.46,1.0,6,1,2,3,6,0xb2d58e2b
500407.79,4.0,104,4,4,1,9,0xb2d10596
400051.06,16.0,17,4,4,2,10,0xb2d4eb48
6781900.55,11.0,20,4,4,2,10,0x3b9af0bfd
292465.15,11.0,0,3,4,4,11,0xb2d32731d
700005.9,2.0,71,4,3,1,8,0xb2d548c7d
776.78,1.0,81,1,2,1,4,0xb2d6b383
75358.75,1.0,13,3,2,3,8,0xb2da2b54
40665.52,1.0,0,2,2,4,8,0xb2d464e2d
1011365.9,4.0,3,4,4,4,12,0x3b9b0fc7
20003.27,2.0,50,2,3,2,7,0xb2d0caca
2756.8,1.0,3,1,2,4,7,0xb2d3ef94
491773.24,2.0,32,4,3,2,9,0xb2d17506
10.02,1.0,10,1,2,3,6,0xb2d8e7f2
100004.22,2.0,168,3,3,1,7,0xb2d641d5d
7.77,1.0,65,1,2,2,5,0xb2d38ce7d
510559.79,4.0,3,4,4,4,12,0xb2d29500
707411.82,3.0,0,4,4,4,12,0xb2d0d560d
200060.17,2.0,53,3,3,2,8,0xb2d9b4c3
512886.26,2.0,8,4,3,3,10,0xb2d67cba
114206.54,2.0,179,3,3,1,7,0xb2d4cc8fd
28.3,1.0,184,1,2,1,4,0xb2d0a51e
2723.1,1.0,9,1,2,3,6,0xb2d34c1cd
14540.8,1.0,0,2,2,4,8,0xb2d1e75cd
20000.21,2.0,143,2,3,1,6,0xb2d6eaff
74.88,1.0,24,1,2,2,5,0xb2d58517
418.24,1.0,77,1,2,1,4,0xb2d1c824
60002.22,3.0,172,3,4,1,8,0xb2d8c37d
11775.34,1.0,8,2,2,3,7,0xb2d26acd
6624.13,1.0,63,2,2,2,6,0xb2d38296d
12616.54,1.0,0,2,2,4,8,0xb2d6a7b3d
901973.11,5.0,32,4,4,2,10,0xb2d6aba8d
7021.58,1.0,92,2,2,1,5,0xb2d60282d
25174.76,1.0,18,2,2,2,6,0xb2d34065
1130078.34,14.0,0,4,4,4,12,0xb2d38e1cd
2929.47,1.0,9,2,2,3,7,0xb2d349d8
9.64,1.0,18,1,2,2,5,0xb2d0baddd
2.11,1.0,21,1,2,2,5,0xb2da0439
817.4,1.0,24,1,2,2,5,0xb2d3e2dc
53000.0,2.0,96,3,3,1,7,0xb2d28dfbd
505330.48,2.0,112,4,3,1,8,0xb2d78022d
840032.21,15.0,0,4,4,4,12,0xb2d22344
8.43,1.0,23,1,2,2,5,0xb2d37271
511822.62,77.0,0,4,4,4,12,0x3b9ad591
83.66,1.0,50,1,2,2,5,0xb2d26d47
3003.87,1.0,19,2,2,2,6,0xb2d9297a
123618.67,12.0,0,3,4,4,11,0xb2d5d0cad
375744.08,7.0,20,4,4,2,10,0xb2d57954d
1660.88,1.0,8,1,2,3,6,0xb2d31c35
136516.98,3.0,32,3,4,2,9,0xb2d2e3d7
453037.79,5.0,6,4,4,3,11,0xb2d7884fd
207826.97,2.0,184,3,3,1,7,0xb2d62790
160455.71,2.0,0,3,3,4,10,0xb2d98068d
230936.07,4.0,13,3,4,3,10,0xb2d576a7d
68005.34,2.0,249,3,3,1,7,0xb2d44a6fd
88194.45,1.0,22,3,2,2,7,0xb2d14da5
900000.0,1.0,0,4,2,4,10,0xb2d9798cd
651777.62,3.0,29,4,4,2,10,0xb2d8fef3d
482020.13,5.0,4,4,4,4,12,0xb2d5ef9d
903022.72,6.0,1,4,4,4,12,0xb2d5e611d
494303.91,2.0,24,4,3,2,9,0xb2d2f3e4d
2400501.31,2.0,60,4,3,2,9,0xb2d237c7
382400.85,2.0,14,4,3,3,10,0xb2d1d12ad
9101.44,1.0,0,2,2,4,8,0xb2d4f60c
505624.76,4.0,91,4,4,1,9,0xb2d2aa9ed
199.2,1.0,14,1,2,3,6,0xb2d1e14bd
3587270.11,16.0,14,4,4,3,11,0xb2d0ce93d
305616.32,5.0,19,4,4,2,10,0xb2d2ea08
2089.24,1.0,184,1,2,1,4,0xb2d1a571d
350018.03,2.0,1,4,3,4,11,0xb2d1c4eed
807725.79,4.0,27,4,4,2,10,0xb2d65085
32135.1,1.0,20,2,2,2,6,0xb2d3e652
7631.07,1.0,14,2,2,3,7,0xb2d689f3
329803.13,14.0,8,4,4,3,11,0xb2d250d7d
7806.91,1.0,0,2,2,4,8,0xb2d6447c
1804.48,1.0,184,1,2,1,4,0xb2d572a5
545055.17,5.0,69,4,4,1,9,0xb2d2609dd
205689.63,2.0,92,3,3,1,7,0xb2d62790d
52.77,1.0,50,1,2,2,5,0xb2d996d9
33813.5,1.0,46,2,2,2,6,0xb2d2f27ad
21486.82,2.0,1,2,3,4,9,0xb2d54c85
1104820.31,3.0,0,4,4,4,12,0xb2d23586d
30565.16,7.0,3,2,4,4,10,0xb2d06274d
10157.23,1.0,126,2,2,1,5,0xb2d39f70
8333.77,1.0,15,2,2,3,7,0xb2da21c8
4613.61,1.0,10,2,2,3,7,0xb2d50907
1083512.73,13.0,0,4,4,4,12,0xb2d310d0d
102.85,1.0,50,1,2,2,5,0xb2d3a327
33983.41,1.0,1,2,2,4,8,0xb2d6c0bb
4373.6,1.0,184,2,2,1,5,0xb2d42e3ad
2398315.34,2.0,0,4,3,4,11,0x3b9b485c
48.39,1.0,22,1,2,2,5,0xb2da036b
1409630.19,15.0,4,4,4,4,12,0xb2d18f8d
130001.79,3.0,52,3,4,2,9,0xb2d12addd
3839.42,2.0,1,2,3,4,9,0xb2d14961d
210521.88,2.0,151,3,3,1,7,0xb2d4d033d
512595.39,11.0,1,4,4,4,12,0xb2d4116d
270000.21,5.0,0,3,4,4,11,0xb2d597fc
200000.0,2.0,0,3,3,4,10,0xb2d9834ed
306597.85,2.0,13,4,3,3,10,0xb2d61e63
601777.27,3.0,19,4,4,2,10,0xb2d91284
210460.78,2.0,1,3,3,4,10,0xb2d4c8eb
1505506.78,3.0,15,4,4,3,11,0xb2d8e347d
692292.94,15.0,83,4,4,1,9,0xb2d14615
20048.05,2.0,69,2,3,1,6,0xb2d61070d
150029.86,3.0,217,3,4,1,8,0xb2d39ab0
66279.24,1.0,188,3,2,1,6,0xb2d3a5c3d
568023.28,3.0,116,4,4,1,9,0xb2d8f446d
2002.69,1.0,18,1,2,2,5,0xb2d6b6c6d
57232.66,2.0,0,3,3,4,10,0xb2d69b9e
391486.05,3.0,21,4,4,2,10,0xb2d381ce
200100.0,2.0,1,3,3,4,10,0xb2da2154
30000.0,2.0,4,2,3,4,9,0xb2da5c15
516979.06,6.0,17,4,4,2,10,0xb2d63d9c
200126.77,2.0,3,3,3,4,10,0xb2d23bfcd
243.99,1.0,9,1,2,3,6,0xb2d3ca95
6000000.91,28.0,0,4,4,4,12,0xb2d4ffa2d
380071.95,3.0,17,4,4,2,10,0xb2d5e361
10850000.0,5.0,10,4,4,3,11,0xb2d0bfd7d
5535.32,1.0,133,2,2,1,5,0xb2d17b97
2400130.79,3.0,8,4,4,3,11,0xb2d92b17d
144308.31,2.0,0,3,3,4,10,0xb2d62d75
240000.95,6.0,99,3,4,1,8,0xb2d3b5d6d
13906.16,1.0,21,2,2,2,6,0xb2d96774
100013.81,2.0,25,3,3,2,8,0xb2d594f3d
103467.68,2.0,9,3,3,3,9,0xb2d57a51d
70112.3,4.0,66,3,4,2,9,0xb2d66773d
215744.3,2.0,1,3,3,4,10,0xb2d12fa9
213393.29,9.0,10,3,4,3,10,0xb2d5b315d
1517.71,7.0,7,1,4,3,8,0xb2d069ffd
256010.16,4.0,80,3,4,1,8,0xb2d14760d
200197.54,3.0,27,3,4,2,9,0xb2da065a
32001.48,3.0,62,2,4,2,8,0xb2d63f2f
1076.28,1.0,222,1,2,1,4,0xb2d6d6b2d
2810.44,1.0,184,1,2,1,4,0xb2d208ca
8720.44,1.0,10,2,2,3,7,0xb2d6e7e7d
3352.53,2.0,2,2,3,4,9,0xb2d11062d
1704.77,1.0,184,1,2,1,4,0xb2d2a9ef
200002.36,2.0,15,3,3,3,9,0xb2d5e056d
961624.4,3.0,8,4,4,3,11,0xb2d4ac59d
122.83,1.0,19,1,2,2,5,0xb2d21ea3
381619.1,4.0,39,4,4,2,10,0xb2d5200fd
158032.8,4.0,4,3,4,4,11,0xb2d35d21
232120.2,2.0,24,3,3,2,8,0xb2d1bb0bd
17656.87,1.0,0,2,2,4,8,0xb2d6acbbd
202296.89,2.0,97,3,3,1,7,0xb2d644db
849.1,1.0,8,1,2,3,6,0xb2d479b0
534.15,1.0,4,1,2,4,7,0xb2d3205c
212837.27,1.0,195,3,2,1,6,0xb2d3b5a9
111.04,1.0,9,1,2,3,6,0xb2d8f3bf
213225.74,7.0,4,3,4,4,11,0xb2d5987dd
5163244.48,21.0,1,4,4,4,12,0xb2d5ca4ad
1060000.77,7.0,7,4,4,3,11,0xb2d623df
26.16,1.0,89,1,2,1,4,0xb2d6b166
3179.05,1.0,184,2,2,1,5,0xb2d35db1d
606032.6,12.0,4,4,4,4,12,0xb2d921bdd
416485.17,5.0,5,4,4,3,11,0xb2d58cad
449554.15,2.0,20,4,3,2,9,0xb2d9317b
0.08,1.0,3,1,2,4,7,0xb2d1ff51d
18.53,1.0,32,1,2,2,5,0xb2d3ef48d
4.0,1.0,20,1,2,2,5,0xb2d3f72f
120003.91,3.0,41,3,4,2,9,0xb2d9da95
608.23,1.0,0,1,2,4,7,0xb2d8ea74
1135.22,2.0,17,1,3,2,6,0xb2d33e11
13.87,1.0,0,1,2,4,7,0xb2d5a767
179908.1,3.0,27,3,4,2,9,0xb2d2dcbfd
705047.8,6.0,4,4,4,4,12,0xb2d5ff67d
191006.08,3.0,51,3,4,2,9,0xb2d57cc8d
1969.98,1.0,67,1,2,1,4,0xb2d0f7ac
1318387.51,3.0,136,4,4,1,9,0xb2d53767d
253312.0,5.0,70,3,4,1,8,0xb2d2e7ead
2883.78,1.0,3,1,2,4,7,0xb2d17347
261176.85,2.0,4,3,3,4,10,0xb2d28d66
113900.0,1.0,2,3,2,4,9,0xb2d95742
20140.62,1.0,175,2,2,1,5,0xb2d5100e
500015.83,2.0,80,4,3,1,8,0xb2d98a40
200253.81,1.0,128,3,2,1,6,0xb2d8f8dd
81861.4,2.0,0,3,3,4,10,0xb2d34a56
200000.0,2.0,14,3,3,3,9,0xb2da3e21
1420.52,1.0,92,1,2,1,4,0xb2d271c8
100001.47,4.0,92,3,4,1,8,0xb2d78e89d
209007.95,3.0,48,3,4,2,9,0xb2d0d4a8
42569.65,5.0,0,2,4,4,10,0xb2d30a76
359167.49,3.0,27,4,4,2,10,0xb2d6c02c
44376.83,1.0,1,2,2,4,8,0xb2d69629d
121373.76,3.0,24,3,4,2,9,0xb2d651c9
0.22,1.0,1,1,2,4,7,0xb2d5e707
1022.6,1.0,10,1,2,3,6,0xb2d2e970d
120007.18,3.0,11,3,4,3,10,0xb2d56ae0
23.53,1.0,208,1,2,1,4,0xb2d23fb6
357.66,1.0,10,1,2,3,6,0xb2d2ac6c
500000.0,3.0,14,4,4,3,11,0xb2d99a84
130077.87,3.0,60,3,4,2,9,0xb2d6cedb
602.1,1.0,42,1,2,2,5,0xb2d60fa8d
1080.56,1.0,0,1,2,4,7,0xb2d2c488
444.56,1.0,52,1,2,2,5,0xb2d1a786
450004.75,2.0,25,4,3,2,9,0xb2da15fe
1260061.08,7.0,0,4,4,4,12,0xb2d2bb19
227.13,1.0,66,1,2,2,5,0xb2d2406bd
455000.0,1.0,1,4,2,4,10,0xb2da3941
326465.18,1.0,3,4,2,4,10,0xb2d3af23
150103.22,2.0,59,3,3,2,8,0xb2d8fdfd
131042.45,2.0,45,3,3,2,8,0xb2d6e243
1050133.76,2.0,18,4,3,2,9,0xb2d5abbf
110076.25,2.0,92,3,3,1,7,0xb2d17bbe
15857.68,1.0,0,2,2,4,8,0xb2d65014d
150127.33,5.0,4,3,4,4,11,0xb2d68ac1d
505.83,1.0,10,1,2,3,6,0xb2d42e55d
46267.45,1.0,0,2,2,4,8,0xb2d974e4
640018.68,3.0,11,4,4,3,11,0xb2d1f457d
164094.56,3.0,59,3,4,2,9,0xb2d535b3d
550011.83,11.0,9,4,4,3,11,0xb2d8cd7ad
7914.21,1.0,92,2,2,1,5,0x3b9af56cd
1382.17,2.0,0,1,3,4,8,0xb2d09c89d
200010.56,3.0,18,3,4,2,9,0xb2d426c8
64005.63,2.0,108,3,3,1,7,0xb2d4fea9d
51550.43,1.0,194,2,2,1,5,0xb2d5d535d
5001.05,1.0,15,2,2,3,7,0xb2d9b2fb
18843.73,1.0,17,2,2,2,6,0xb2d6ea5d
230385.16,2.0,19,3,3,2,8,0xb2d8d604d
505877.17,2.0,80,4,3,1,8,0xb2d53f9ad
3475192.75,19.0,0,4,4,4,12,0xb2d07460
386224.79,6.0,1,4,4,4,12,0xb2d63147
45.97,1.0,21,1,2,2,5,0xb2d6bb9b
303.73,1.0,48,1,2,2,5,0xb2d24f56
501822.55,2.0,33,4,3,2,9,0xb2d6aa2f
5106.51,1.0,3,2,2,4,8,0xb2d91f52
83574.48,1.0,11,3,2,3,8,0xb2d49029d
3198.49,1.0,0,2,2,4,8,0xb2d68ee2d
60695.66,1.0,11,3,2,3,8,0xb2d91fed
833.45,1.0,4,1,2,4,7,0xb2d52dd9
260015.83,1.0,9,3,2,3,8,0xb2d308ac
255810.53,2.0,131,3,3,1,7,0xb2d108f8
240048.0,2.0,18,3,3,2,8,0xb2da0b47
215.62,1.0,22,1,2,2,5,0xb2d1ce42
570100.63,4.0,34,4,4,2,10,0xb2d63d7fd
24315.27,1.0,6,2,2,3,7,0xb2d74599d
2675807.44,2.0,108,4,3,1,8,0xb2d654b8
107.96,1.0,9,1,2,3,6,0xb2d58cfb
610.55,1.0,15,1,2,3,6,0xb2d6b543
601421.03,4.0,67,4,4,1,9,0xb2d99430
19520.76,1.0,9,2,2,3,7,0xb2d5d813d
14649.75,1.0,0,2,2,4,8,0xb2d3eb9bd
52067.06,1.0,92,2,2,1,5,0xb2d411e3d
251752.27,2.0,0,3,3,4,10,0xb2d24c24
858.3,1.0,14,1,2,3,6,0xb2d38d7c
16.77,1.0,54,1,2,2,5,0xb2d6591d
505620.61,5.0,4,4,4,4,12,0xb2d6c606d
104010.38,2.0,25,3,3,2,8,0xb2d62176d
300180.41,4.0,63,4,4,2,10,0xb2d48945d
412080.45,4.0,1,4,4,4,12,0xb2d91594
13671.48,1.0,2,2,2,4,8,0xb2d9690a
50889.0,2.0,188,2,3,1,6,0xb2d3f6db
182679.72,3.0,175,3,4,1,8,0xb2d43815d
150001.58,3.0,28,3,4,2,9,0xb2da0c91
323000.0,3.0,26,4,4,2,10,0xb2da0161
1770456.89,2.0,3,4,3,4,11,0xb2d12321d
12811.55,3.0,5,2,4,3,9,0xb2d2e901
165438.2,3.0,97,3,4,1,8,0xb2d46ca6d
1506.0,2.0,41,1,3,2,6,0xb2d67eddd
52.16,1.0,12,1,2,3,6,0xb2d1a15ed
50012.14,2.0,3,2,3,4,9,0xb2d92001d
613048.6,9.0,3,4,4,4,12,0xb2d5c48dd
257022.14,3.0,2,3,4,4,11,0xb2d548a0d
24797.55,1.0,1,2,2,4,8,0xb2d3cc29
86009.93,2.0,18,3,3,2,8,0xb2d349e6
1280.56,1.0,145,1,2,1,4,0xb2d67ecb
6063.51,1.0,184,2,2,1,5,0xb2d24fb2d
2.81,1.0,76,1,2,1,4,0xb2d48ff5
797.88,1.0,57,1,2,2,5,0xb2d278a5
12082.96,1.0,27,2,2,2,6,0xb2d6c676d
427790.69,4.0,18,4,4,2,10,0xb2d2f6d1
76550.41,13.0,0,3,4,4,11,0x3b9b3eecd
200276.3,6.0,0,3,4,4,11,0xb2d09655
180015.9,3.0,147,3,4,1,8,0xb2d0de0ed
70000.74,2.0,214,3,3,1,7,0xb2d7782e
26.7,1.0,280,1,2,1,4,0xb2d268b5
3232.02,1.0,0,2,2,4,8,0xb2d918ded
1782752.73,1.0,0,4,2,4,10,0xb2d8d02a
202553.79,2.0,103,3,3,1,7,0xb2d6be64d
75817.65,2.0,31,3,3,2,8,0xb2d69e19
10000000.0,7.0,0,4,4,4,12,0xb2d37b98
252014.49,3.0,73,3,4,1,8,0xb2d63ba3
14.86,1.0,10,1,2,3,6,0xb2d54d1b
5043.29,1.0,5,2,2,3,7,0xb2d33da7
824510.6,3.0,111,4,4,1,9,0xb2d39351
1610.27,1.0,140,1,2,1,4,0xb2d1da83d
197.07,1.0,21,1,2,2,5,0xb2d6fd12
3856.96,1.0,14,2,2,3,7,0xb2d23726
1705.64,1.0,0,1,2,4,7,0xb2d4d13bd
339503.93,4.0,4,4,4,4,12,0xb2d16ff0
11.66,1.0,10,1,2,3,6,0xb2d93e7a
450408.23,2.0,0,4,3,4,11,0xb2d3623c
10000.21,2.0,185,2,3,1,6,0xb2d6a4d0
5157.81,1.0,15,2,2,3,7,0xb2d9b31f
20002.1,1.0,0,2,2,4,8,0xb2d2e00cd
480000.15,3.0,13,4,4,3,11,0xb2d96457d
524526.87,4.0,86,4,4,1,9,0xb2d20635d
50.68,1.0,28,1,2,2,5,0xb2d6b22d
200586.09,2.0,59,3,3,2,8,0xb2d3c757d
240064.65,6.0,10,3,4,3,10,0xb2d094cfd
854099.98,9.0,3,4,4,4,12,0xb2d0776fd
50010.58,2.0,90,2,3,1,6,0xb2d40f77d
102352.81,4.0,19,3,4,2,9,0xb2d5bc45d
10337.48,2.0,47,2,3,2,7,0xb2d50532
35031.7,3.0,12,2,4,3,9,0xb2d12d64d
45845.73,1.0,0,2,2,4,8,0xb2d63b66d
246024.69,3.0,77,3,4,1,8,0xb2d4ac66
100005.28,2.0,70,3,3,1,7,0xb2d9a130
60079.23,2.0,70,3,3,1,7,0xb2d5cb6cd
375672.12,7.0,1,4,4,4,12,0xb2d10d5d
200009.26,2.0,5,3,3,3,9,0xb2d3ca43d
520938.96,2.0,18,4,3,2,9,0xb2d5fcf2d
81.37,2.0,1,1,3,4,8,0x3b9af2a8d
1055001.32,12.0,0,4,4,4,12,0xb2d4f9b2
35920.6,1.0,3,2,2,4,8,0xb2d21a24d
17293.39,1.0,0,2,2,4,8,0xb2d2361ad
50172.13,8.0,20,2,4,2,8,0xb2d1065d
274730.87,4.0,10,3,4,3,10,0xb2d21417d
58.8,1.0,80,1,2,1,4,0xb2d5815d
24820.49,1.0,10,2,2,3,7,0xb2d6508c
2106.41,1.0,40,1,2,2,5,0xb2d78cced
5984.23,1.0,92,2,2,1,5,0xb2d389a4
30004.85,2.0,53,2,3,2,7,0xb2d9bca7
774.94,1.0,5,1,2,3,6,0xb2d8c95f
444973.23,2.0,6,4,3,3,10,0xb2d9b5c4
135533.64,3.0,10,3,4,3,10,0xb2d3aa7c
500000.0,2.0,20,4,3,2,9,0xb2da2c20
15866.69,1.0,0,2,2,4,8,0xb2d6b4d9d
229.12,2.0,9,1,3,3,7,0xb2d20688d
601970.59,4.0,6,4,4,3,11,0xb2d24e7b
1000052.52,3.0,21,4,4,2,10,0xb2d6bd20d
108901.23,3.0,55,3,4,2,9,0xb2d1a125
111713.32,2.0,9,3,3,3,9,0xb2d8fd9ed
1192.4,1.0,184,1,2,1,4,0xb2d25be4d
800.5,1.0,0,1,2,4,7,0xb2d54bf3
76986.74,4.0,8,3,4,3,10,0x3b9b27cf
1900091.62,4.0,5,4,4,3,11,0xb2d958d6d
2895.6,1.0,35,2,2,2,6,0xb2d43298
19204.63,1.0,0,2,2,4,8,0xb2d906c1d
23317.0,1.0,136,2,2,1,5,0xb2d61e85d
7524.43,1.0,3,2,2,4,8,0xb2d9942d
678.03,1.0,0,1,2,4,7,0xb2d30489d
25023.55,1.0,21,2,2,2,6,0xb2d244f6
13454.0,1.0,0,2,2,4,8,0xb2d8f898d
50007.88,2.0,186,2,3,1,6,0xb2d57553
485798.87,2.0,64,4,3,2,9,0xb2d5c8d7
2011.55,1.0,240,1,2,1,4,0xb2d4180fd
90264.48,2.0,1,3,3,4,10,0xb2d26185
35000.65,2.0,1,2,3,4,9,0xb2d58cc9
217.63,1.0,9,1,2,3,6,0xb2d52fdad
170001.79,2.0,52,3,3,2,8,0xb2d90c97d
608.75,1.0,56,1,2,2,5,0xb2d27dcdd
5.35,1.0,82,1,2,1,4,0xb2d6e703
1507465.37,3.0,27,4,4,2,10,0xb2d598ced
501293.35,4.0,37,4,4,2,10,0xb2d6692bd
90.2,1.0,31,1,2,2,5,0xb2d59cc2
446801.57,4.0,102,4,4,1,9,0xb2d076fdd
775321.51,7.0,10,4,4,3,11,0xb2d42310d
487.04,1.0,0,1,2,4,7,0xb2d642e7
67.65,1.0,21,1,2,2,5,0xb2d69013d
6819.33,1.0,15,2,2,3,7,0xb2d4f8da
33584.91,2.0,2,2,3,4,9,0x3b9af18d
14001.72,2.0,59,2,3,2,7,0xb2d0cf59
18148.42,1.0,26,2,2,2,6,0xb2d2e49c
14.1,2.0,76,1,3,1,5,0xb2d1dcbb
280008.88,2.0,46,3,3,2,8,0xb2d8c5d3d
371.97,1.0,7,1,2,3,6,0xb2d5f12c
597.8,1.0,17,1,2,2,5,0xb2d3b604
5352.87,1.0,92,2,2,1,5,0x3b9b309ad
13.27,1.0,3,1,2,4,7,0xb2d6b7c1d
750000.0,4.0,9,4,4,3,11,0xb2d6ee24d
36021.52,2.0,67,2,3,1,6,0xb2d67d99
5836.7,2.0,184,2,3,1,6,0x3b9b28a8
400016.89,2.0,34,4,3,2,9,0xb2d32a43
953862.52,4.0,0,4,4,4,12,0xb2d23ab9
280031.79,3.0,25,3,4,2,9,0xb2d266f8
386.0,1.0,10,1,2,3,6,0xb2d92657
280054.52,4.0,1,3,4,4,11,0xb2d69a82
100160.78,3.0,6,3,4,3,10,0xb2d5efdf
442803.13,9.0,0,4,4,4,12,0xb2d0da8b
470462.53,2.0,209,4,3,1,8,0xb2d29b4bd
501776.55,2.0,6,4,3,3,10,0xb2d8fa35d
344083.06,4.0,77,4,4,1,9,0xb2d458f6d
260325.34,5.0,0,3,4,4,11,0xb2d41b37d
20921.68,1.0,3,2,2,4,8,0xb2d6b70dd
13.29,1.0,11,1,2,3,6,0xb2da06e2
100028.71,4.0,18,3,4,2,9,0xb2d29f22d
101152.84,2.0,80,3,3,1,7,0xb2d6b470d
191960.76,1.0,6,3,2,3,8,0xb2d6e337
1681.11,1.0,19,1,2,2,5,0xb2d6d13b
123244.57,3.0,75,3,4,1,8,0xb2d2455fd
220005.5,3.0,118,3,4,1,8,0xb2d9217a
300010.08,5.0,116,3,4,1,8,0xb2d15501
140.49,2.0,74,1,3,1,5,0x3b9b327a
545.83,1.0,60,1,2,2,5,0xb2d1dd58
100002.11,2.0,39,3,3,2,8,0xb2d9ef84
34.2,1.0,82,1,2,1,4,0xb2d85750
86902.93,4.0,0,3,4,4,11,0xb2d377cd
73765.84,2.0,76,3,3,1,7,0xb2d3ab86
125280.14,3.0,192,3,4,1,8,0xb2d2a36e
176852.64,2.0,0,3,3,4,10,0xb2d3933c
677.31,1.0,6,1,2,3,6,0xb2d59135
10004.43,1.0,52,2,2,2,6,0xb2d9cbf9
693180.03,5.0,48,4,4,2,10,0xb2d586a8d
41.17,1.0,29,1,2,2,5,0xb2d631dc
1722.78,1.0,184,1,2,1,4,0xb2d1fa9dd
301252.73,3.0,16,4,4,2,10,0xb2d5117ed
250051.71,3.0,122,3,4,1,8,0xb2d3a544
220732.16,3.0,35,3,4,2,9,0xb2d9482dd
90002.85,3.0,39,3,4,2,9,0xb2d99420
91449.14,3.0,55,3,4,2,9,0xb2d610ba
253362.57,6.0,10,3,4,3,10,0xb2d43069d
311419.0,1.0,19,4,2,2,8,0xb2d631ced
67.6,1.0,77,1,2,1,4,0xb2d291d8
250048.23,2.0,129,3,3,1,7,0xb2d2cf80
900161.03,2.0,24,4,3,2,9,0xb2d377edd
90000.0,5.0,1,3,4,4,11,0xb2d4760bd
208.61,1.0,75,1,2,1,4,0xb2d6d26e
5262.67,1.0,92,2,2,1,5,0xb2d171d0d
50008.93,2.0,118,2,3,1,6,0xb2d5753fd
15806.06,4.0,0,2,4,4,10,0x3b9b1858
3.73,1.0,5,1,2,3,6,0xb2d2c337
200002.84,2.0,15,3,3,3,9,0xb2da3452
10145.27,1.0,184,2,2,1,5,0xb2d1144fd
170020.86,2.0,136,3,3,1,7,0xb2d6821c
200009.87,2.0,199,3,3,1,7,0xb2d5ba3c
16.89,1.0,32,1,2,2,5,0xb2d9208ed
870022.99,8.0,21,4,4,2,10,0xb2d649e1d
2.16,1.0,184,1,2,1,4,0xb2d23117
90.12,1.0,10,1,2,3,6,0xb2d8f210
15222.29,1.0,20,2,2,2,6,0xb2d0febad
83094.95,2.0,108,3,3,1,7,0xb2d56d85
15051.68,1.0,18,2,2,2,6,0xb2d26f6ed
5469.35,1.0,101,2,2,1,5,0xb2d8de9ed
24519.86,1.0,15,2,2,3,7,0xb2d90184
1051.8,1.0,171,1,2,1,4,0xb2d332e1d
209057.66,8.0,80,3,4,1,8,0xb2d1cf71
416451.79,13.0,6,4,4,3,11,0xb2d2b506
0.22,1.0,40,1,2,2,5,0xb2d46f36
10049.51,1.0,184,2,2,1,5,0xb2d2e8e7d
1615099.21,6.0,0,4,4,4,12,0xb2d473f5d
200001.23,5.0,1,3,4,4,11,0xb2d2d6b2
200005.34,2.0,87,3,3,1,7,0xb2d6eec0
18862773.33,10.0,0,4,4,4,12,0xb2d59381d
202.4,1.0,27,1,2,2,5,0xb2d5ffde
913194.19,3.0,22,4,4,2,10,0xb2d3aba9
14469.47,2.0,92,2,3,1,6,0xb2d07f5cd
352.29,2.0,26,1,3,2,6,0xb2d6f0acd
1.13,1.0,115,1,2,1,4,0xb2d3bc95
1801.1,1.0,20,1,2,2,5,0xb2d6dd70
13389.73,1.0,0,2,2,4,8,0xb2d22741d
4343.85,1.0,21,2,2,2,6,0xb2d1a766
1651.66,2.0,184,1,3,1,5,0x3b9adef0
771649.26,5.0,0,4,4,4,12,0xb2d14960
2043.59,1.0,8,1,2,3,6,0xb2d30ada
573554.36,3.0,7,4,4,3,11,0xb2d63637
500000.0,2.0,14,4,3,3,10,0xb2da3ba4
942.59,1.0,19,1,2,2,5,0xb2d3d721
7000.37,1.0,4,2,2,4,8,0xb2da1a80
221950.3,4.0,0,3,4,4,11,0xb2d09ab8
500015.83,2.0,77,4,3,1,8,0xb2d992c6
1015.55,1.0,184,1,2,1,4,0xb2d14587
316793.66,3.0,14,4,4,3,11,0xb2d4ff71
113337.08,2.0,1,3,3,4,10,0xb2d59bded
60000.63,2.0,28,3,3,2,8,0xb2da0b75
707.05,1.0,0,1,2,4,7,0xb2d39e9e
1661458.16,5.0,61,4,4,2,10,0x3b9b388c
0.63,1.0,32,1,2,2,5,0xb2da03b7
39.38,1.0,41,1,2,2,5,0xb2d643be
2694.63,1.0,0,1,2,4,7,0xb2d5bdbfd
300468.09,2.0,3,4,3,4,11,0xb2d5bad1
6030.64,1.0,3,2,2,4,8,0xb2d34361d
30471.36,1.0,11,2,2,3,7,0xb2d55aa1
1216.44,1.0,7,1,2,3,6,0xb2d4ce85
4051.64,1.0,2,2,2,4,8,0xb2d10cff
17.72,1.0,68,1,2,1,4,0xb2d63b76d
62052.53,3.0,87,3,4,1,8,0xb2d589acd
240000.0,2.0,11,3,3,3,9,0xb2da4b58
670115.47,3.0,3,4,4,4,12,0xb2d69082d
185.85,1.0,1,1,2,4,7,0xb2d8ca76d
4796.27,1.0,3,2,2,4,8,0xb2d3b2d8
2108000.0,17.0,0,4,4,4,12,0xb2d198aad
259.81,1.0,36,1,2,2,5,0xb2d6d4a4
0.0,1.0,9,1,2,3,6,0xb2d6e30c
10530.54,1.0,212,2,2,1,5,0xb2d4db7c
315502.81,2.0,129,4,3,1,8,0xb2d57071
710000.0,6.0,7,4,4,3,11,0xb2d087b6
30517.74,1.0,92,2,2,1,5,0xb2d1174e
294016.59,2.0,282,3,3,1,7,0xb2d2f258d
50000.53,2.0,14,2,3,3,8,0xb2da3a88
604122.15,6.0,1,4,4,4,12,0x3b9b34eb
911460.78,7.0,9,4,4,3,11,0x3b9b3ea2
50001.58,2.0,92,2,3,1,6,0xb2d643e0d
634041.09,5.0,11,4,4,3,11,0xb2d41f01d
400098.46,3.0,8,4,4,3,11,0xb2d22cfbd
169418.57,1.0,4,3,2,4,9,0xb2d599bdd
124.34,1.0,3,1,2,4,7,0xb2d2f7cdd
1526.54,1.0,92,1,2,1,4,0xb2d31e58
67967.02,1.0,0,3,2,4,9,0xb2d3ec66d
175.94,1.0,9,1,2,3,6,0xb2d56552d
900000.88,4.0,7,4,4,3,11,0xb2d92d93
386.94,1.0,61,1,2,2,5,0xb2d59904
200052.68,2.0,14,3,3,3,9,0xb2d54df1
135.01,1.0,9,1,2,3,6,0xb2d57e4e
1122.05,1.0,184,1,2,1,4,0xb2d20f37
17.19,1.0,7,1,2,3,6,0xb2d5825ed
2634.06,1.0,184,1,2,1,4,0xb2d24338d
16.34,1.0,16,1,2,2,5,0xb2d684c5d
70216.11,2.0,73,3,3,1,7,0xb2d37c62
100818.07,1.0,0,3,2,4,9,0xb2d3ecd1d
13760.32,1.0,0,2,2,4,8,0xb2d1e67c
50000.0,2.0,1,2,3,4,9,0xb2da5f99
1581562.42,4.0,43,4,4,2,10,0x3b9b34e4d
279072.21,4.0,0,3,4,4,11,0xb2d39c0d
30000.95,2.0,60,2,3,2,7,0xb2d27438
688.61,2.0,0,1,3,4,8,0x3b9b372b
500000.0,2.0,0,4,3,4,11,0xb2d98433d
504270.53,4.0,147,4,4,1,9,0xb2d6fd1f
501780.3,2.0,56,4,3,2,9,0xb2d6dd90
20650.41,2.0,171,2,3,1,6,0xb2d5fcfdd
110003.7,4.0,11,3,4,3,10,0xb2d205ab
371429.78,6.0,14,4,4,3,11,0xb2d9ad6d
100509.27,2.0,1,3,3,4,10,0xb2d13292
602.06,11.0,0,1,4,4,9,0xb2d0b50fd
0.0,1.0,9,1,2,3,6,0xb2d4c0a7
1252.06,1.0,300,1,2,1,4,0xb2d44b5cd
630023.15,5.0,6,4,4,3,11,0xb2d2b7d0d
300211.06,2.0,0,4,3,4,11,0xb2d996c7
296784.19,2.0,3,3,3,4,10,0xb2d0c6f7d
9614.4,1.0,0,2,2,4,8,0xb2d972f1
761241.5,8.0,1,4,4,4,12,0xb2d657ecd
81141.4,1.0,184,3,2,1,6,0xb2d198f7
394340.7,4.0,70,4,4,1,9,0xb2d4125cd
25.38,1.0,18,1,2,2,5,0xb2d0a82e
230256.0,2.0,69,3,3,1,7,0xb2d5e247d
20004.08,2.0,199,2,3,1,6,0xb2d5bd99d
75408.64,1.0,147,3,2,1,6,0xb2d52044
1183003.01,10.0,21,4,4,2,10,0xb2d8d5dd
1116.3,1.0,156,1,2,1,4,0xb2d1ea3c
703004.07,2.0,15,4,3,3,10,0xb2d51a08d
989.76,1.0,0,1,2,4,7,0xb2d25000
351243.24,2.0,32,4,3,2,9,0xb2d8d7b6
2.47,2.0,5,1,3,3,7,0xb2d2bb37d
650176.1,3.0,0,4,4,4,12,0xb2d98c13
333585.08,3.0,6,4,4,3,11,0xb2d57b86
504482.35,3.0,34,4,4,2,10,0xb2d6fe88
402842.39,2.0,19,4,3,2,9,0xb2d8db56
80001.69,2.0,235,3,3,1,7,0xb2d6e908
1346.39,2.0,4,1,3,4,8,0xb2d2f897
913.18,1.0,21,1,2,2,5,0xb2d3e5d1
990017.13,3.0,10,4,4,3,11,0xb2d14fa6d
1780267.51,8.0,14,4,4,3,11,0xb2d5ff05
1030051.73,10.0,31,4,4,2,10,0xb2d91b53d
8591.15,1.0,15,2,2,3,7,0xb2d9e6a3
40084.75,2.0,1,2,3,4,9,0xb2d37c67
1869.36,1.0,5,1,2,3,6,0xb2d8dc20
50192.49,2.0,0,2,3,4,9,0xb2d9e2c2
110032.91,3.0,21,3,4,2,9,0xb2d95f43
117016.74,2.0,1,3,3,4,10,0xb2d341f9d
33.32,1.0,1,1,2,4,7,0xb2d5ab6ed
500220.01,4.0,9,4,4,3,11,0xb2d2d05cd
194.39,1.0,15,1,2,3,6,0xb2d5abdd
703921.54,5.0,0,4,4,4,12,0xb2d5625a
3574.84,1.0,22,2,2,2,6,0xb2d27e41
8235.82,1.0,2,2,2,4,8,0xb2d4023fd
296005.37,8.0,56,3,4,2,9,0xb2d3d36ad
600185.39,3.0,0,4,4,4,12,0xb2d5f419d
459261.45,8.0,42,4,4,2,10,0xb2d247add
10.99,1.0,167,1,2,1,4,0xb2d8d7db
429479.33,9.0,21,4,4,2,10,0xb2d1d99ed
37924.7,1.0,1,2,2,4,8,0xb2d4f386
1138.08,1.0,1,1,2,4,7,0xb2d30349d
441.0,1.0,1,1,2,4,7,0xb2d91c72
100003.17,2.0,104,3,3,1,7,0xb2d95dc6d
36984.52,1.0,0,2,2,4,8,0xb2d65802
337518.0,4.0,12,4,4,3,11,0xb2d60a5f
3421.99,1.0,4,2,2,4,8,0xb2d3e672
7963.4,1.0,5,2,2,3,7,0xb2d33237
420203.55,2.0,216,4,3,1,8,0xb2d766fc
37483.73,1.0,21,2,2,2,6,0xb2d08d3d
70554.88,3.0,2,3,4,4,11,0xb2d5c01b
7381.62,1.0,92,2,2,1,5,0xb2d1c466
15.88,1.0,16,1,2,2,5,0xb2d6fc6c
10309.69,3.0,24,2,4,2,8,0xb2d08804d
11.05,1.0,54,1,2,2,5,0xb2d94c24
2015.75,1.0,2,1,2,4,7,0xb2d78e04
1317.24,1.0,168,1,2,1,4,0xb2d4b92c
668.86,1.0,3,1,2,4,7,0xb2d69d97
11278.53,1.0,6,2,2,3,7,0xb2d47609
210256.99,3.0,14,3,4,3,10,0xb2d58385d
501650.01,1.0,5,4,2,3,9,0xb2d1c4b3
52351.8,1.0,302,3,2,1,6,0xb2d2343a
13088.86,2.0,54,2,3,2,7,0xb2d7a7d5
250066.09,4.0,18,3,4,2,9,0xb2d4c3ff
235009.53,3.0,11,3,4,3,10,0xb2d49bbb
60359.72,3.0,11,3,4,3,10,0xb2d6825f
156238.36,3.0,19,3,4,2,9,0xb2d6d895d
100410.85,3.0,111,3,4,1,8,0xb2d6aedb
865953.37,16.0,8,4,4,3,11,0xb2d3afae
1144250.8,9.0,11,4,4,3,11,0xb2d07ba9
301722.35,3.0,33,4,4,2,10,0xb2d6a68bd
240004.23,4.0,20,3,4,2,9,0xb2d95bced
828000.0,12.0,0,4,4,4,12,0xb2d2146e
200052.87,2.0,18,3,3,2,8,0xb2d6080d
75371.45,2.0,52,3,3,2,8,0xb2d61539
1216.47,1.0,14,1,2,3,6,0xb2d08536d
66046.86,2.0,3,3,3,4,10,0xb2d16b04
170022.46,5.0,6,3,4,3,10,0xb2d0af8d
200033.14,2.0,70,3,3,1,7,0xb2d6e68ad
6262.59,1.0,0,2,2,4,8,0xb2d68b0bd
153491.18,3.0,181,3,4,1,8,0xb2d09f9c
500723.16,2.0,235,4,3,1,8,0xb2d62660
172178.82,3.0,59,3,4,2,9,0xb2d5729e
4105.85,1.0,20,2,2,2,6,0xb2d1c873d
11003.5,1.0,49,2,2,2,6,0xb2d70017
208351.28,2.0,133,3,3,1,7,0xb2d83bafd
265103.68,4.0,108,3,4,1,8,0xb2d0bf18d
0.21,1.0,211,1,2,1,4,0xb2d6886f
97597.64,1.0,184,3,2,1,6,0xb2d269b2d
3002.24,1.0,71,2,2,1,5,0xb2d552cc
0.0,1.0,207,1,2,1,4,0xb2d69021d
413706.03,3.0,35,4,4,2,10,0xb2d0a59cd
360858.74,2.0,19,4,3,2,9,0xb2d640f9
400119.67,2.0,31,4,3,2,9,0xb2d68203d
509013.09,2.0,21,4,3,2,9,0xb2d164c6
210000.0,2.0,0,3,3,4,10,0xb2d9831dd
216723.32,2.0,58,3,3,2,8,0xb2d68aead
100048.47,6.0,95,3,4,1,8,0xb2d62fa8d
1001.38,1.0,141,1,2,1,4,0xb2d913e6
168000.89,2.0,3,3,3,4,10,0xb2d33537
225047.8,2.0,90,3,3,1,7,0xb2d10904d
2963.97,1.0,8,2,2,3,7,0xb2d2fd96
1119.43,1.0,8,1,2,3,6,0xb2d5d224d
150001.58,2.0,47,3,3,2,8,0xb2d916c8d
6819.84,1.0,22,2,2,2,6,0xb2d5668e
26974.91,1.0,41,2,2,2,6,0xb2d4887ed
500016.89,4.0,12,4,4,3,11,0xb2d94e34
500022.17,3.0,26,4,4,2,10,0xb2d93f5d
3535.85,1.0,184,2,2,1,5,0xb2d2a40ad
8.81,1.0,13,1,2,3,6,0xb2d5d2b4
100146.72,6.0,0,3,4,4,11,0x3b9b3a82
12936.02,1.0,3,2,2,4,8,0xb2d2c12b
500055.28,2.0,6,4,3,3,10,0xb2da4a24
500781.1,3.0,14,4,4,3,11,0xb2d6df92
260093.38,4.0,3,3,4,4,11,0xb2d92036
150175.79,2.0,175,3,3,1,7,0xb2d2697bd
208269.07,4.0,10,3,4,3,10,0xb2d32f12
90079.7,1.0,0,3,2,4,9,0xb2d25447
328100.92,3.0,61,4,4,2,10,0xb2d6eb75
25804.32,7.0,0,2,4,4,10,0x3b9b4646d
50001.8,2.0,228,2,3,1,6,0xb2d5657b
18528.67,1.0,0,2,2,4,8,0xb2d69110
309.47,1.0,15,1,2,3,6,0xb2d1cce2
252483.7,5.0,0,3,4,4,11,0xb2d1b886
404319.89,3.0,33,4,4,2,10,0xb2d1f987
593.94,1.0,0,1,2,4,7,0xb2d6bf5a
10000.32,2.0,39,2,3,2,7,0xb2d9b26c
9782.37,1.0,21,2,2,2,6,0xb2d512e3d
10184.09,1.0,24,2,2,2,6,0xb2d2457a
210.06,1.0,14,1,2,3,6,0xb2d9df3c
450074.83,3.0,4,4,4,4,12,0xb2d970b2
764570.48,4.0,4,4,4,4,12,0xb2d40f95
26.26,3.0,41,1,4,2,7,0xb2d6d7d2
10011.87,2.0,117,2,3,1,6,0xb2d59b63
20168.03,1.0,184,2,2,1,5,0xb2d373cad
10032.45,4.0,8,2,4,3,9,0xb2d32806
16.14,1.0,35,1,2,2,5,0xb2d14267
100005.28,2.0,20,3,3,2,8,0xb2da1bbf
258351.99,1.0,42,3,2,2,7,0xb2d57dfb
71560.2,2.0,89,3,3,1,7,0xb2d17b90d
130014.6,3.0,6,3,4,3,10,0xb2d42813
292.12,1.0,15,1,2,3,6,0xb2d90b81
2853.61,1.0,16,1,2,2,5,0xb2d2d8c3
150008.59,3.0,10,3,4,3,10,0xb2d51281
200000.1,2.0,5,3,3,3,9,0xb2d6a9b5d
6424.14,1.0,10,2,2,3,7,0xb2d34163d
220006.87,4.0,0,3,4,4,11,0xb2d59b6fd
145330.99,3.0,0,3,4,4,11,0xb2d62d3b
409142.66,4.0,102,4,4,1,9,0xb2d1a08cd
1001747.45,3.0,0,4,4,4,12,0xb2d3ca7c
2900064.39,3.0,10,4,4,3,11,0xb2d9603f
543026.58,4.0,92,4,4,1,9,0xb2d4e9a7
552538.22,3.0,0,4,4,4,12,0xb2d53885d
292818.6,4.0,101,3,4,1,8,0xb2d0ad7c
12009.38,2.0,43,2,3,2,7,0xb2d6a380d
100012.78,2.0,110,3,3,1,7,0xb2d6cde2d
31001.77,1.0,184,2,2,1,5,0xb2d23e5dd
4205639.34,7.0,3,4,4,4,12,0xb2d1fb52
186475.44,2.0,179,3,3,1,7,0xb2d17d11d
474033.65,6.0,53,4,4,2,10,0xb2d5ee14
250014.1,2.0,87,3,3,1,7,0xb2d0ae0f
10340.71,2.0,70,2,3,1,6,0xb2d63931d
20014.69,2.0,48,2,3,2,7,0xb2d812ea
1212.7,1.0,20,1,2,2,5,0xb2d23f23
2098254.32,24.0,0,4,4,4,12,0xb2d34b96
407.88,1.0,10,1,2,3,6,0xb2d55a01
23103.88,1.0,0,2,2,4,8,0xb2d28dd4d
82375.21,2.0,200,3,3,1,7,0xb2d5c45d
584.79,1.0,10,1,2,3,6,0xb2d10b19d
101817.9,2.0,92,3,3,1,7,0x3b9b25eed
1059.42,2.0,184,1,3,1,5,0xb2d48d86d
1130490.33,9.0,14,4,4,3,11,0xb2d6a727d
210000.43,2.0,7,3,3,3,9,0xb2d5a84ed
40.84,1.0,11,1,2,3,6,0xb2d83ac0d
28113.83,5.0,4,2,4,4,10,0x3b9b124e
274.0,1.0,10,1,2,3,6,0xb2d95809
140009.08,3.0,95,3,4,1,8,0xb2d2da13
30317.0,1.0,2,2,2,4,8,0xb2d55a45
693186.55,8.0,27,4,4,2,10,0xb2d63f6ad
101673.83,2.0,39,3,3,2,8,0xb2d1a812
460039.4,3.0,0,4,4,4,12,0xb2d8e65ed
50707.27,1.0,10,2,2,3,7,0xb2d383edd
100001.35,2.0,3,3,3,4,10,0xb2d5d4a4
259160.08,3.0,56,3,4,2,9,0xb2d2a53e
5000000.0,2.0,0,4,3,4,11,0xb2d8e46e
43034.36,4.0,0,2,4,4,10,0xb2d407ccd
99.13,1.0,14,1,2,3,6,0xb2d5efdc
65078.59,3.0,98,3,4,1,8,0xb2d61ce8
20544.72,1.0,2,2,2,4,8,0xb2d6c2d8
350037.94,1.0,0,4,2,4,10,0xb2d2e98c
311045.57,4.0,39,4,4,2,10,0xb2d610e8
50000.22,3.0,0,2,4,4,10,0xb2d39bc5d
32159.55,1.0,0,2,2,4,8,0xb2d09e55
80003.29,3.0,112,3,4,1,8,0xb2d648c0d
270000.0,2.0,4,3,3,4,10,0xb2d975c9d
313001.16,7.0,3,4,4,4,12,0xb2d5bd07
371730.76,3.0,87,4,4,1,9,0xb2d59e64d
47314.22,1.0,44,2,2,2,6,0xb2d3cbccd
146.37,1.0,3,1,2,4,7,0xb2d2c81d
220187.8,4.0,67,3,4,1,8,0xb2d60351d
663667.44,5.0,150,4,4,1,9,0xb2d6d126
9507.98,1.0,77,2,2,1,5,0xb2d42e8ed
70731.59,2.0,218,3,3,1,7,0xb2d3d99bd
20000.63,2.0,228,2,3,1,6,0xb2d6f21f
2021320.98,2.0,84,4,3,1,8,0xb2d2e1e7d
100084.24,2.0,97,3,3,1,7,0xb2d58f7a
101753.19,2.0,38,3,3,2,8,0xb2d38399d
501971.73,2.0,48,4,3,2,9,0xb2d9d670
790034.76,3.0,8,4,4,3,11,0xb2d41188
11039.65,1.0,21,2,2,2,6,0xb2d59523
104102.82,2.0,59,3,3,2,8,0xb2d41111
1125336.88,1.0,0,4,2,4,10,0xb2d30e93d
24400.24,1.0,0,2,2,4,8,0xb2d6b6b2d
50212.65,2.0,92,2,3,1,6,0xb2d0aba7
302843.13,5.0,0,4,4,4,12,0xb2d5ee14d
500005.28,2.0,27,4,3,2,9,0xb2d93f98d
7321.66,1.0,9,2,2,3,7,0xb2d4f639
1244960.04,6.0,32,4,4,2,10,0xb2d63d99
11903.18,3.0,0,2,4,4,10,0xb2d2111d
412050.25,6.0,0,4,4,4,12,0xb2d0d8ec
1200860.88,5.0,6,4,4,3,11,0xb2d1930c
1476806.25,6.0,4,4,4,4,12,0xb2d0db7dd
200044.91,2.0,0,3,3,4,10,0xb2d935bfd
3020.46,1.0,92,2,2,1,5,0xb2d39c23
15.6,1.0,33,1,2,2,5,0xb2d9620e
1.79,2.0,18,1,3,2,6,0xb2d8ea07
246703.37,2.0,80,3,3,1,7,0xb2d5ac49
330368.23,4.0,12,4,4,3,11,0xb2d4999e
271020.78,2.0,29,3,3,2,8,0xb2d9b7d2
201421.31,2.0,26,3,3,2,8,0xb2d8ce0b
1408.48,1.0,184,1,2,1,4,0xb2d325bad
8805.8,1.0,36,2,2,2,6,0xb2d1bf86d
634955.77,2.0,209,4,3,1,8,0xb2d2d64e
850032.7,4.0,0,4,4,4,12,0xb2d24fc5
0.11,1.0,26,1,2,2,5,0xb2d15452
1304618.47,2.0,29,4,3,2,9,0xb2d244d8
6.64,1.0,56,1,2,2,5,0xb2d5eb29d
14.61,1.0,21,1,2,2,5,0xb2d3440b
114825.34,1.0,6,3,2,3,8,0xb2d37693d
240.16,1.0,10,1,2,3,6,0xb2d94265
3527.05,1.0,92,2,2,1,5,0xb2d344f5
300753.21,2.0,144,4,3,1,8,0xb2d34a35
110938.25,1.0,92,3,2,1,6,0xb2d234ead
960229.72,6.0,76,4,4,1,9,0xb2d146c2
1000000.0,2.0,2,4,3,4,11,0xb2d93561d
449675.69,3.0,19,4,4,2,10,0xb2d65891
14103.99,1.0,6,2,2,3,7,0xb2d0dd99
2117.5,1.0,92,1,2,1,4,0xb2d1da1bd
358523.46,1.0,33,4,2,2,8,0xb2d6198ad
303160.64,3.0,10,4,4,3,11,0xb2d3ac2ed
16278.72,1.0,0,2,2,4,8,0xb2d15f79
1145.67,1.0,24,1,2,2,5,0xb2d2e56e
0.0,1.0,2,1,2,4,7,0xb2d17f55
512444.41,2.0,103,4,3,1,8,0xb2d6f5cdd
100006.2,2.0,18,3,3,2,8,0xb2d5bba6
30006.94,2.0,137,2,3,1,6,0xb2d5e3f2
20145.75,2.0,0,2,3,4,9,0xb2d69e81
41446.85,1.0,0,2,2,4,8,0xb2d5a922d
243100.1,1.0,3,3,2,4,9,0xb2d9411fd
120003.8,1.0,11,3,2,3,8,0xb2d894a9
346000.8,4.0,4,4,4,4,12,0xb2d30bd1d
382558.66,3.0,21,4,4,2,10,0xb2d62613d
200005.09,2.0,11,3,3,3,9,0xb2d65c7b
150742.17,6.0,20,3,4,2,9,0xb2d62af0d
80000.17,4.0,4,3,4,4,11,0xb2d073d5
2293.85,1.0,92,1,2,1,4,0xb2d43be0d
791025.98,10.0,1,4,4,4,12,0xb2d5d78c
19.66,1.0,10,1,2,3,6,0xb2d55ae0d
10449.27,1.0,1,2,2,4,8,0xb2d6b5c9
1172.02,1.0,10,1,2,3,6,0xb2d35e1a
508907.3,2.0,22,4,3,2,9,0xb2d3f141d
11.66,2.0,19,1,3,2,6,0xb2d6018bd
50054.54,2.0,53,2,3,2,7,0xb2d63340
182.79,1.0,0,1,2,4,7,0xb2d559e7
400046.49,3.0,12,4,4,3,11,0xb2d5a22bd
7.67,1.0,53,1,2,2,5,0xb2d259a6
407985.94,6.0,28,4,4,2,10,0x3b9b443cd
365125.65,3.0,122,4,4,1,9,0xb2d140bfd
300448.68,2.0,32,4,3,2,9,0xb2d16c44d
412464.4,7.0,0,4,4,4,12,0xb2d36b46d
622.67,1.0,17,1,2,2,5,0xb2d25f9e
56.89,1.0,88,1,2,1,4,0xb2d46a15
11896.31,1.0,16,2,2,2,6,0xb2d90aea
909.23,1.0,2,1,2,4,7,0xb2d90204
10279.22,2.0,3,2,3,4,9,0xb2d621c5
14.54,1.0,116,1,2,1,4,0xb2d16c1ad
650518.57,4.0,1,4,4,4,12,0xb2d63c05d
440184.07,3.0,16,4,4,2,10,0xb2d45afcd
100001.06,2.0,13,3,3,3,9,0xb2d95cd3d
325333.8,2.0,217,4,3,1,8,0xb2d6242d
92.92,1.0,58,1,2,2,5,0xb2d574f5d
100001.61,2.0,0,3,3,4,10,0xb2d39f99
30000.25,4.0,3,2,4,4,10,0xb2d6657a
1671.99,11.0,184,1,4,1,6,0xb2d085fdd
7601.37,1.0,0,2,2,4,8,0xb2d69f60
4613208.01,78.0,0,4,4,4,12,0x3b9ae400
300042.34,2.0,102,3,3,1,7,0xb2d6d28a
1719.71,1.0,9,1,2,3,6,0xb2d8ee60
480000.33,8.0,0,4,4,4,12,0xb2d273b0
5001455.44,4.0,76,4,4,1,9,0xb2d639af
3300.94,1.0,272,2,2,1,5,0xb2d39051
204135.15,8.0,6,3,4,3,10,0xb2d07892
182170.35,4.0,153,3,4,1,8,0xb2d0d402d
109545.55,3.0,200,3,4,1,8,0xb2d19c39d
1138.08,3.0,10,1,4,3,8,0xb2d3fbe3
20.84,1.0,22,1,2,2,5,0xb2d0a5bcd
1517.93,1.0,0,1,2,4,7,0xb2d2bd6e
715015.08,6.0,18,4,4,2,10,0xb2d16454d
968159.77,16.0,1,4,4,4,12,0xb2d5d78cd
200050.83,3.0,83,3,4,1,8,0xb2d56479d
8097.01,1.0,20,2,2,2,6,0xb2d18a41d
463519.69,6.0,32,4,4,2,10,0xb2d311ca
59311.61,1.0,18,3,2,2,7,0xb2d24ec1d
24327.0,1.0,6,2,2,3,7,0xb2da04bc
1013060.71,4.0,4,4,4,4,12,0xb2d5cb6fd
1245.27,1.0,0,1,2,4,7,0xb2d27711d
300079.77,4.0,8,3,4,3,10,0xb2d56766d
430.1,1.0,8,1,2,3,6,0xb2d8ce1b
900030.79,6.0,18,4,4,2,10,0xb2d95b97d
527020.93,9.0,4,4,4,4,12,0xb2d3cc39d
3645.31,1.0,184,2,2,1,5,0xb2d16cf1
2619.25,4.0,59,1,4,2,7,0xb2d6a0dd
205031.92,4.0,189,3,4,1,8,0xb2d3eae8d
400403.78,2.0,0,4,3,4,11,0xb2d9bd85
2283938.63,1.0,0,4,2,4,10,0xb2d6fdf9d
59.56,1.0,10,1,2,3,6,0xb2d9490f
228.64,1.0,88,1,2,1,4,0xb2d260b3d
148306.29,2.0,18,3,3,2,8,0xb2d30ed9d
221818.02,17.0,0,3,4,4,11,0xb2d5b0d3
205862.21,3.0,38,3,4,2,9,0xb2d59bcb
14.14,1.0,0,1,2,4,7,0xb2d2c8f2d
240570.51,3.0,108,3,4,1,8,0xb2d46e59d
409.39,1.0,4,1,2,4,7,0xb2d8225a
10000.63,2.0,209,2,3,1,6,0xb2d64d8ad
7116887.47,1.0,0,4,2,4,10,0xb2d3736ad
572228.86,6.0,0,4,4,4,12,0xb2d22145
551960.25,2.0,30,4,3,2,9,0xb2d8ff5c
100164.35,2.0,32,3,3,2,8,0xb2d6e03f
800716.54,5.0,18,4,4,2,10,0xb2d1c7f7
100002.84,2.0,115,3,3,1,7,0xb2d6bf56
415445.11,3.0,70,4,4,1,9,0xb2d64238
15058246.69,6.0,39,4,4,2,10,0xb2d111f7d
8271054.19,6.0,11,4,4,3,11,0xb2d421c3d
1191915.23,5.0,6,4,4,3,11,0xb2d0ed9e
200083.46,2.0,13,3,3,3,9,0xb2d6470fd
11757.21,3.0,0,2,4,4,10,0x3b9af1a2d
50000.0,2.0,1,2,3,4,9,0xb2da63aa
6877.89,1.0,0,2,2,4,8,0xb2d33bacd
22573.06,1.0,24,2,2,2,6,0xb2d62849
25681.03,1.0,184,2,2,1,5,0xb2d2f665d
510000.64,2.0,10,4,3,3,10,0xb2d969a2
200008.45,2.0,101,3,3,1,7,0xb2d7eddfd
10341.23,1.0,4,2,2,4,8,0xb2d6c6c3
49.29,1.0,72,1,2,1,4,0xb2d46626
60.52,1.0,7,1,2,3,6,0xb2d31117
280027.85,2.0,19,3,3,2,8,0xb2d5e038d
1107615.08,4.0,14,4,4,3,11,0xb2d41bded
10000.21,2.0,39,2,3,2,7,0xb2d9f07b
204852.99,2.0,30,3,3,2,8,0xb2d5981fd
661.48,1.0,0,1,2,4,7,0xb2d8ee9d
311.08,1.0,24,1,2,2,5,0xb2d2bd91
21564.97,1.0,26,2,2,2,6,0xb2d2cab4
501441.36,5.0,48,4,4,2,10,0xb2d57762d
588163.21,9.0,1,4,4,4,12,0xb2d20fa1
10045.6,2.0,6,2,3,3,8,0xb2d68c75d
90035.68,1.0,0,3,2,4,9,0xb2d2b151
162205.4,2.0,16,3,3,2,8,0xb2d1ed6ed
196088.46,2.0,249,3,3,1,7,0xb2d1dca2d
5927.82,1.0,0,2,2,4,8,0xb2d906bfd
2586.75,1.0,9,1,2,3,6,0xb2d92663
1441144.84,2.0,1,4,3,4,11,0xb2d28aa0
5140.58,1.0,105,2,2,1,5,0xb2d21951
1250035.55,6.0,14,4,4,3,11,0xb2d06c1e
1040000.68,4.0,0,4,4,4,12,0xb2d57475d
250647.48,2.0,174,3,3,1,7,0xb2d1e338
50373.46,1.0,20,2,2,2,6,0xb2d98682
105193.96,5.0,0,3,4,4,11,0x3b9af1c7d
75.92,1.0,5,1,2,3,6,0xb2d6bcc7
6533.25,7.0,0,2,4,4,10,0x3b9b1a42
6.53,1.0,8,1,2,3,6,0xb2d8a620
137133.05,5.0,21,3,4,2,9,0xb2d3ea9a
240059.09,3.0,6,3,4,3,10,0xb2d43f88d
105015.94,2.0,224,3,3,1,7,0xb2d4ac39d
150007.92,3.0,4,3,4,4,11,0xb2d9f755
35925.59,2.0,0,2,3,4,9,0xb2d5aca0d
1.35,1.0,47,1,2,2,5,0xb2d86d8d
70121.38,2.0,168,3,3,1,7,0xb2d4b17a
20000.21,2.0,6,2,3,3,8,0xb2d96cc8d
287028.75,9.0,6,3,4,3,10,0xb2d580ac
100074.28,2.0,98,3,3,1,7,0xb2d6bbae
500000.0,2.0,27,4,3,2,9,0xb2da11fe
2236061.39,7.0,24,4,4,2,10,0xb2d29e58d
25.64,1.0,66,1,2,2,5,0xb2d43509
152542.37,1.0,70,3,2,1,6,0xb2d5a2a8d
255237.41,3.0,0,3,4,4,11,0xb2d09c83d
86.45,1.0,33,1,2,2,5,0xb2d9d142
600000.0,4.0,0,4,4,4,12,0xb2d0bfbf
913276.27,7.0,34,4,4,2,10,0xb2d10841d
3423670.08,1.0,92,4,2,1,7,0xb2d264b6d
106350.77,2.0,147,3,3,1,7,0xb2d3f75c
100095.64,2.0,46,3,3,2,8,0xb2d11211
602035.59,2.0,102,4,3,1,8,0xb2d1b23ed
457666.1,4.0,0,4,4,4,12,0xb2d3e92d
2872993.05,1.0,0,4,2,4,10,0xb2d9158ad
1523.55,1.0,184,1,2,1,4,0xb2d13e47d
407.11,1.0,10,1,2,3,6,0xb2d50965
33.25,1.0,18,1,2,2,5,0xb2d16bca
1.1,1.0,63,1,2,2,5,0xb2d6c526
110578.5,4.0,3,3,4,4,11,0xb2d6eec4
12537.9,1.0,0,2,2,4,8,0xb2d60f63
30003.84,2.0,20,2,3,2,7,0xb2d6001f
52.78,1.0,8,1,2,3,6,0xb2d2d9f7d
700064.06,3.0,0,4,4,4,12,0xb2d5703c
1226.32,1.0,3,1,2,4,7,0xb2d177b8
6.64,1.0,76,1,2,1,4,0xb2d57e60d
30049.82,2.0,4,2,3,4,9,0xb2d0ac59d
42848.22,1.0,38,2,2,2,6,0xb2d0bc4f
13123.48,1.0,8,2,2,3,7,0xb2d2cc51d
1425.49,1.0,21,1,2,2,5,0xb2d5c864
3.19,1.0,35,1,2,2,5,0xb2d38b30d
1927.15,1.0,19,1,2,2,5,0xb2d475aed
98125.15,1.0,11,3,2,3,8,0xb2d31ea6d
500029.62,4.0,10,4,4,3,11,0x3b9b2598
4059.36,3.0,184,2,4,1,7,0xb2d06a0cd
23439.93,1.0,9,2,2,3,7,0xb2d2b5c0d
280094.58,2.0,2,3,3,4,10,0xb2d93577d
60.99,1.0,26,1,2,2,5,0xb2d90304
60003.54,3.0,48,3,4,2,9,0xb2d1b500
434.79,1.0,14,1,2,3,6,0xb2d8e475
384.56,2.0,1,1,3,4,8,0xb2d0cf00
4873.67,1.0,20,2,2,2,6,0xb2d8faf8
12820.44,1.0,0,2,2,4,8,0xb2d973b3
326061.96,9.0,0,4,4,4,12,0xb2d210be
3713.33,1.0,184,2,2,1,5,0xb2d3adf3d
170010.52,3.0,4,3,4,4,11,0xb2d26f9e
9540.18,1.0,21,2,2,2,6,0xb2d5827ad
973.4,1.0,10,1,2,3,6,0xb2d5387c
527.49,1.0,8,1,2,3,6,0xb2d13b92d
1324.75,2.0,184,1,3,1,5,0xb2d1db8f
35468.37,1.0,1,2,2,4,8,0xb2d716fed
513332.99,6.0,4,4,4,4,12,0xb2d5fa8a
1635982.66,7.0,53,4,4,2,10,0xb2d1ca3cd
4080.78,1.0,31,2,2,2,6,0xb2d93c74d
2603.98,1.0,155,1,2,1,4,0xb2d8f968
500000.0,2.0,26,4,3,2,9,0xb2d946a8d
21858.9,2.0,0,2,3,4,9,0xb2d1af3dd
197056.77,2.0,4,3,3,4,10,0xb2d2876d
45.6,1.0,0,1,2,4,7,0xb2d906a0
4460.81,1.0,14,2,2,3,7,0xb2d2072fd
270.33,1.0,12,1,2,3,6,0xb2d91ed3
295000.79,3.0,10,3,4,3,10,0xb2d96778d
2331.72,1.0,92,1,2,1,4,0xb2d2145a
3076057.3,15.0,6,4,4,3,11,0xb2d1e4bcd
26000.27,2.0,32,2,3,2,7,0xb2da04c3
500000.0,2.0,25,4,3,2,9,0xb2d94c1cd
92996.14,2.0,0,3,3,4,10,0xb2d1a3a9
3000203.38,2.0,264,4,3,1,8,0xb2d62723d
1969.52,1.0,25,1,2,2,5,0xb2d4b1d7
100041.73,2.0,0,3,3,4,10,0xb2d62d27
30000.32,2.0,14,2,3,3,8,0xb2da37dd
1716.6,2.0,135,1,3,1,5,0xb2d1a44a
347449.5,1.0,0,4,2,4,10,0xb2d51cf7
73.47,1.0,32,1,2,2,5,0xb2d8ddd4
1123.45,1.0,184,1,2,1,4,0xb2d3ffbd
2364.49,1.0,6,1,2,3,6,0xb2d7073f
670007.45,4.0,18,4,4,2,10,0xb2d4b9b2d
7101.59,1.0,1,2,2,4,8,0xb2da1ec4
77700.14,2.0,4,3,3,4,10,0xb2d22bd0
50270.93,6.0,0,2,4,4,10,0x3b9b39a5
10147.35,1.0,184,2,2,1,5,0xb2d5e56e
21859.62,1.0,0,2,2,4,8,0xb2d34c1fd
7679.3,1.0,0,2,2,4,8,0xb2d3bc7e
10009.4,1.0,3,2,2,4,8,0xb2d92eca
0.05,1.0,6,1,2,3,6,0xb2d6c64a
8431.63,1.0,92,2,2,1,5,0xb2d15119d
420941.99,3.0,84,4,4,1,9,0xb2d4ebd0d
10000.32,2.0,10,2,3,3,8,0xb2d961e1d
1205.77,1.0,92,1,2,1,4,0xb2d12c4ad
1482.51,1.0,184,1,2,1,4,0xb2d25142
171356.97,4.0,11,3,4,3,10,0xb2d3978c
12143.8,1.0,4,2,2,4,8,0xb2d9dd8c
4667.16,1.0,20,2,2,2,6,0xb2d9caa0
1015075.06,2.0,8,4,3,3,10,0xb2d3bba3
5055.89,1.0,184,2,2,1,5,0xb2d281c3d
300000.45,2.0,1,3,3,4,10,0xb2d989ee
334265.33,5.0,0,4,4,4,12,0xb2d9281dd
308421.55,5.0,1,4,4,4,12,0xb2d21240d
1261.58,1.0,0,1,2,4,7,0xb2d29d35
500390.81,7.0,1,4,4,4,12,0xb2d9051ad
145955.5,3.0,25,3,4,2,9,0xb2d3f32a
2103.8,1.0,184,1,2,1,4,0xb2d1627ad
181082.99,2.0,4,3,3,4,10,0xb2d11287
70670.18,2.0,1,3,3,4,10,0xb2d1cdad
43602.85,1.0,21,2,2,2,6,0xb2d66090d
1142.65,1.0,184,1,2,1,4,0xb2d0ead0
3859.34,1.0,188,2,2,1,5,0xb2d2f67bd
171603.73,9.0,3,3,4,4,11,0xb2d643add
100004.22,2.0,92,3,3,1,7,0xb2d65d83d
620000.0,5.0,4,4,4,4,12,0xb2d6d3d0d
306597.33,1.0,1,4,2,4,10,0xb2d2266c
20063.16,1.0,190,2,2,1,5,0xb2d78173d
10034.13,1.0,92,2,2,1,5,0xb2d5d7d4d
6197.86,1.0,60,2,2,2,6,0xb2d6383fd
433331.51,3.0,139,4,4,1,9,0xb2d5fa8ad
5934.58,1.0,224,2,2,1,5,0xb2d233cfd
214093.02,2.0,174,3,3,1,7,0xb2d46568
10887.94,1.0,0,2,2,4,8,0xb2d3f5bf
116.16,1.0,10,1,2,3,6,0xb2d31884d
177500.0,4.0,0,3,4,4,11,0xb2d4fbff
31260.26,1.0,0,2,2,4,8,0xb2d6a59d
51320.99,1.0,45,2,2,2,6,0xb2d60af0d
20000.63,2.0,53,2,3,2,7,0xb2d9ca44
194.14,1.0,45,1,2,2,5,0xb2d5bdb6
3073.54,1.0,9,2,2,3,7,0xb2d3bbac
3656.23,1.0,92,2,2,1,5,0xb2d3fc7e
988.35,1.0,13,1,2,3,6,0xb2d50634
209144.33,3.0,0,3,4,4,11,0xb2d5abd5
1000010.58,8.0,231,4,4,1,9,0xb2d17702
1006.86,1.0,92,1,2,1,4,0xb2d42245d
2.67,1.0,39,1,2,2,5,0xb2d76947d
439776.08,2.0,89,4,3,1,8,0xb2d69234d
70028.62,1.0,0,3,2,4,9,0xb2d92ee1d
2892.91,1.0,9,2,2,3,7,0xb2d4df84
450000.0,3.0,0,4,4,4,12,0xb2d96f7b
551472.11,5.0,24,4,4,2,10,0xb2d271a0
400023.35,5.0,116,4,4,1,9,0xb2d193bcd
20019.19,2.0,2,2,3,4,9,0xb2d55139
810347.41,10.0,8,4,4,3,11,0xb2d56074d
209330.92,2.0,93,3,3,1,7,0xb2d1c8bc
27.74,1.0,158,1,2,1,4,0xb2d589a2
90051.21,3.0,27,3,4,2,9,0xb2d92e4ed
10144.44,1.0,4,2,2,4,8,0xb2d648ac
200062.68,2.0,14,3,3,3,9,0xb2d6960f
515075.88,7.0,1,4,4,4,12,0xb2d0dbf5d
30000.67,4.0,18,2,4,2,8,0xb2d69b39d
150004.58,3.0,143,3,4,1,8,0xb2d45820
537.57,1.0,9,1,2,3,6,0xb2d2d446
480000.0,2.0,4,4,3,4,11,0xb2d172b2
5435.22,1.0,8,2,2,3,7,0xb2d28c74
2660.9,1.0,28,1,2,2,5,0xb2d22b36
1676.09,1.0,92,1,2,1,4,0xb2d3614bd
1073.1,1.0,109,1,2,1,4,0xb2d78177
250061.0,2.0,3,3,3,4,10,0xb2d621d5
6063.1,1.0,29,2,2,2,6,0xb2d77491
161.46,2.0,76,1,3,1,5,0xb2d10f15
1371.67,4.0,3,1,4,4,9,0xb2d0a4dfd
3131.73,1.0,184,2,2,1,5,0xb2d11980d
481844.37,5.0,0,4,4,4,12,0xb2d1adc0d
603622.7,4.0,9,4,4,3,11,0xb2d297e2
7605.89,1.0,10,2,2,3,7,0xb2d5b4dfd
110002.43,3.0,101,3,4,1,8,0xb2d6396ad
812009.31,11.0,21,4,4,2,10,0xb2d7a916d
76374.22,1.0,18,3,2,2,7,0xb2d24129d
250000.0,2.0,1,3,3,4,10,0xb2d61b16
46.45,1.0,88,1,2,1,4,0xb2d8a14a
90002.75,3.0,12,3,4,3,10,0xb2d93971d
0.29,1.0,4,1,2,4,7,0xb2d91c33d
70688.17,1.0,3,3,2,4,9,0xb2d2d51f
4416.7,1.0,184,2,2,1,5,0xb2d22417
3123.71,1.0,1,2,2,4,8,0xb2d27399d
150007.4,2.0,39,3,3,2,8,0xb2d28759d
106090.25,4.0,10,3,4,3,10,0xb2d5eda6
330486.44,3.0,0,4,4,4,12,0xb2d06b1ed
200801.72,1.0,0,3,2,4,9,0xb2d20d4dd
80288.95,1.0,2,3,2,4,9,0xb2d14759
466618.51,5.0,13,4,4,3,11,0x3b9af199
102419.5,1.0,5,3,2,3,8,0xb2d16624
2885.87,1.0,16,1,2,2,5,0xb2d962e3
172000.0,2.0,9,3,3,3,9,0xb2d17cf2d
616044.05,3.0,2,4,4,4,12,0xb2d10fb9
972746.45,3.0,5,4,4,3,11,0xb2d7577cd
675826.3,52.0,0,4,4,4,12,0x3b9b1823d
200010.35,4.0,39,3,4,2,9,0xb2d17321d
718.07,1.0,0,1,2,4,7,0xb2d6b8dc
15013.92,3.0,106,2,4,1,7,0x3b9b2f9a
1506618.74,2.0,0,4,3,4,11,0xb2d23fd5
17677.07,1.0,0,2,2,4,8,0xb2d6b4c9d
2231.67,1.0,10,1,2,3,6,0xb2d2f132d
3906.56,1.0,2,2,2,4,8,0xb2d8699ed
0.0,1.0,9,1,2,3,6,0xb2d4f1d1
201421.01,2.0,64,3,3,2,8,0xb2d9b50b
50019.27,2.0,81,2,3,1,6,0xb2d5ad32d
379209.55,2.0,110,4,3,1,8,0xb2d6ef43d
108178.38,2.0,12,3,3,3,9,0x3b9b1017d
342076.0,8.0,10,4,4,3,11,0xb2d2dabed
200710.46,2.0,17,3,3,2,8,0xb2d9e175
1059013.86,4.0,35,4,4,2,10,0xb2d0c212
183256.52,3.0,38,3,4,2,9,0xb2d383c9
702084.06,3.0,0,4,4,4,12,0xb2d93174d
10173.56,1.0,15,2,2,3,7,0xb2d63f7a
151739.49,1.0,0,3,2,4,9,0xb2d6ac7d
67445.97,1.0,21,3,2,2,7,0xb2d39283d
101904.85,3.0,47,3,4,2,9,0xb2d184f5d
781280.43,2.0,0,4,3,4,11,0xb2d51f6f
51190.84,5.0,4,2,4,4,10,0xb2d0b305d
60570.69,1.0,1,3,2,4,9,0xb2d306b3
605000.0,9.0,0,4,4,4,12,0xb2d19fd0
50032.73,2.0,1,2,3,4,9,0xb2d684c9
11052.96,1.0,0,2,2,4,8,0xb2d6b83ad
9.58,1.0,37,1,2,2,5,0xb2d2ce7c
139.64,1.0,4,1,2,4,7,0xb2d64e95
3.88,1.0,53,1,2,2,5,0xb2d69300
410006.36,5.0,3,4,4,4,12,0xb2d3c09a
169217.19,1.0,0,3,2,4,9,0xb2d51ea1
1120.89,1.0,184,1,2,1,4,0xb2d6150f
13836.04,1.0,2,2,2,4,8,0xb2d2ede4d
95026.24,2.0,136,3,3,1,7,0xb2d29878
1796067.3,17.0,11,4,4,3,11,0xb2d104fd
96944.71,1.0,184,3,2,1,6,0xb2d55c8bd
327007.11,2.0,164,4,3,1,8,0xb2d48846d
15479.93,1.0,16,2,2,2,6,0xb2d6c9ead
11.29,1.0,33,1,2,2,5,0xb2d8d0e8d
7.55,1.0,1,1,2,4,7,0xb2d948a1
16827.55,1.0,0,2,2,4,8,0xb2d6da8bd
2990.47,1.0,0,2,2,4,8,0xb2d93766
26125.33,14.0,0,2,4,4,10,0x3b9af1ebd
60831.84,4.0,4,3,4,4,11,0xb2d42dd3d
2199.15,1.0,10,1,2,3,6,0xb2d8e602
22234.47,4.0,0,2,4,4,10,0xb2d5e6af
336770.28,3.0,11,4,4,3,11,0xb2d11b21d
42.86,1.0,67,1,2,1,4,0xb2d99a8b
4130.26,1.0,252,2,2,1,5,0xb2d65d4ad
5750010.0,9.0,0,4,4,4,12,0xb2d97c81
5147.18,1.0,8,2,2,3,7,0xb2d6f4c6
300118.3,2.0,256,4,3,1,8,0xb2d5ff20d
373.0,1.0,12,1,2,3,6,0xb2d938e8
547.48,2.0,15,1,3,3,7,0xb2d57b95
500052.87,3.0,62,4,4,2,10,0xb2d32022d
70055.28,2.0,184,3,3,1,7,0xb2d44131d
10210000.0,3.0,3,4,4,4,12,0xb2d8f78ed
289.0,1.0,6,1,2,3,6,0xb2d37c4b
170001.79,2.0,92,3,3,1,7,0xb2d60248d
10777.42,1.0,29,2,2,2,6,0xb2d92c02
224601.43,3.0,66,3,4,2,9,0xb2d63afb
250010.77,2.0,27,3,3,2,8,0xb2d93c9cd
1325.55,2.0,184,1,3,1,5,0xb2d1704fd
402368.42,3.0,122,4,4,1,9,0xb2d3883d
1915879.19,5.0,32,4,4,2,10,0xb2d6b9e9d
33.46,1.0,12,1,2,3,6,0xb2d5cb46d
6664.19,5.0,171,2,4,1,7,0x3b9b28dbd
361973.9,3.0,34,4,4,2,10,0xb2d3c965
1189.24,1.0,92,1,2,1,4,0xb2d20ca0d
500008.79,4.0,27,4,4,2,10,0xb2d0b01b
2786587.86,11.0,1,4,4,4,12,0xb2d07c62
400067.95,11.0,6,4,4,3,11,0xb2d07fa2
12356.3,1.0,141,2,2,1,5,0xb2d37c3cd
40000.84,3.0,102,2,4,1,7,0xb2d6f60e
135809.39,1.0,92,3,2,1,6,0x3b9b40c9d
196510.57,1.0,22,3,2,2,7,0xb2d2147b
200000.0,2.0,64,3,3,2,8,0xb2d9b258
2107326.01,8.0,0,4,4,4,12,0x3b9b17fb
400006.18,8.0,13,4,4,3,11,0xb2d763efd
660.99,1.0,18,1,2,2,5,0xb2d913ca
5816.48,1.0,0,2,2,4,8,0xb2d69e1e
10001.17,1.0,8,2,2,3,7,0xb2d9f416
300131.28,2.0,4,4,3,4,11,0xb2d9b581
5204.54,1.0,239,2,2,1,5,0xb2d2d058
11453.3,1.0,43,2,2,2,6,0xb2d1dbbd
32.45,1.0,50,1,2,2,5,0xb2d9ba3c
664228.82,3.0,3,4,4,4,12,0xb2d4e927
9499.3,2.0,66,2,3,2,7,0xb2d39f77d
300000.63,2.0,10,3,3,3,9,0xb2d92684
50054.07,2.0,168,2,3,1,6,0xb2d11223
30119.98,1.0,184,2,2,1,5,0xb2d55a81
494.6,1.0,2,1,2,4,7,0xb2d2afbf
503.77,1.0,13,1,2,3,6,0xb2da25d9
2048.77,1.0,184,1,2,1,4,0xb2d333f3d
204266.27,2.0,200,3,3,1,7,0xb2d7c41b
7.07,1.0,0,1,2,4,7,0xb2d9f3f2
716401.53,7.0,14,4,4,3,11,0xb2d9cfc2
346688.44,5.0,32,4,4,2,10,0xb2d61e98d
170001.79,2.0,77,3,3,1,7,0xb2d99838
152.86,3.0,3,1,4,4,9,0xb2d52214
50001.6,2.0,41,2,3,2,7,0xb2d63755
20013.51,2.0,10,2,3,3,8,0xb2d548dc
126566.26,2.0,4,3,3,4,10,0xb2d6277d
607.22,1.0,20,1,2,2,5,0xb2d1ec0d
5720.57,1.0,56,2,2,2,6,0xb2d5a92a
87994.99,2.0,0,3,3,4,10,0x3b9af230d
501156.87,5.0,0,4,4,4,12,0xb2d2767e
9021.64,4.0,13,2,4,3,9,0xb2d2d314
190150.0,3.0,78,3,4,1,8,0xb2d1a8f2d
1233.03,1.0,0,1,2,4,7,0xb2d1656d
1290.47,5.0,0,1,4,4,9,0xb2d09d76
375828.6,2.0,27,4,3,2,9,0xb2d65885d
112001.76,4.0,119,3,4,1,8,0xb2d6f737d
200002.11,2.0,18,3,3,2,8,0xb2d956e1d
61193.14,2.0,5,3,3,3,9,0xb2d8a164
340010.2,5.0,18,4,4,2,10,0xb2d5cebf
15137.53,1.0,92,2,2,1,5,0xb2d5c999d
252664.72,2.0,30,3,3,2,8,0xb2d8c397d
1292.31,1.0,184,1,2,1,4,0xb2d2a9b8d
55.34,1.0,10,1,2,3,6,0xb2d9b192
500006.6,1.0,0,4,2,4,10,0xb2d28a33d
427003.8,3.0,18,4,4,2,10,0xb2d304b2
404929.1,5.0,25,4,4,2,10,0xb2d4d1a5
60024.53,2.0,70,3,3,1,7,0xb2d5685fd
655014.89,2.0,181,4,3,1,8,0xb2d12e13
510.06,1.0,8,1,2,3,6,0xb2d2d2b2
726.76,1.0,63,1,2,2,5,0xb2d5ed99
24.55,1.0,0,1,2,4,7,0xb2d8d61f
180184.72,4.0,0,3,4,4,11,0xb2d15717d
500011.72,4.0,21,4,4,2,10,0xb2d1d05dd
27.14,1.0,0,1,2,4,7,0xb2d2f95f
255076.78,2.0,0,3,3,4,10,0xb2d3c16dd
1007104.98,2.0,32,4,3,2,9,0xb2d8fb2c
590413.33,6.0,33,4,4,2,10,0xb2d38c5d
350043.92,4.0,8,4,4,3,11,0xb2d3bea0
505765.09,8.0,0,4,4,4,12,0xb2d3fd7b
4765.71,1.0,19,2,2,2,6,0xb2d30716d
1012.41,2.0,184,1,3,1,5,0xb2d06aaad
307011.51,4.0,83,4,4,1,9,0xb2d12da9d
481000.0,7.0,0,4,4,4,12,0xb2d408add
105845.31,1.0,141,3,2,1,6,0xb2d3904ed
24.38,1.0,11,1,2,3,6,0xb2d82703d
48000.11,4.0,3,2,4,4,10,0xb2d5a7d7d
60179.62,2.0,122,3,3,1,7,0xb2d559de
69997.68,2.0,0,3,3,4,10,0xb2d55e11
23673.46,1.0,147,2,2,1,5,0xb2d1b1bcd
1981.11,1.0,92,1,2,1,4,0x3b9b2cefd
60490.16,2.0,4,3,3,4,10,0xb2d242b7
1014.66,1.0,92,1,2,1,4,0xb2d13e59
10539.29,2.0,17,2,3,2,7,0xb2d2e113d
2879.18,1.0,5,1,2,3,6,0xb2d0c628
746050.48,9.0,11,4,4,3,11,0xb2d50f2cd
245074.27,8.0,27,3,4,2,9,0xb2d64ce4
560427.03,4.0,0,4,4,4,12,0xb2d4f6d3
13.67,1.0,76,1,2,1,4,0xb2d3ec0fd
262.7,1.0,11,1,2,3,6,0xb2d308fe
2667.58,3.0,81,1,4,1,6,0xb2d0848ed
91551785.62,4.0,10,4,4,3,11,0xb2d61280d
102387.56,2.0,123,3,3,1,7,0x3b9b350fd
2066.27,1.0,183,1,2,1,4,0xb2d8253cd
7.02,1.0,26,1,2,2,5,0xb2d297b7
272498.19,6.0,0,3,4,4,11,0x3b9b242dd
144.97,1.0,16,1,2,2,5,0xb2d30c56
200002.11,2.0,41,3,3,2,8,0xb2d920c7
80078.18,2.0,95,3,3,1,7,0xb2d189cfd
1025506.51,5.0,0,4,4,4,12,0xb2d978c1
26.46,1.0,32,1,2,2,5,0xb2d8f5d7
50026.03,2.0,10,2,3,3,8,0xb2d16177
2556099.12,5.0,32,4,4,2,10,0xb2d385acd
2.99,1.0,19,1,2,2,5,0xb2d91b49
5657.71,1.0,20,2,2,2,6,0xb2d98662
139203.47,2.0,6,3,3,3,9,0xb2d3a2ccd
274882.38,3.0,11,3,4,3,10,0xb2d0bd6cd
250001.52,2.0,20,3,3,2,8,0xb2d6adead
1521.64,1.0,0,1,2,4,7,0xb2d63667
5387.87,1.0,30,2,2,2,6,0xb2d76acad
15051.61,1.0,213,2,2,1,5,0xb2d6edc7
40104.3,2.0,55,2,3,2,7,0xb2d6f04bd
769485.39,6.0,4,4,4,4,12,0xb2d5de70
316009.82,4.0,8,4,4,3,11,0xb2d6cc62
355017.92,6.0,11,4,4,3,11,0xb2d65983
1359.33,1.0,92,1,2,1,4,0xb2d14f26
1080067.79,11.0,5,4,4,3,11,0xb2d0b251d
210017.27,4.0,15,3,4,3,10,0xb2d48314
21797.96,1.0,0,2,2,4,8,0xb2d43c0a
0.59,1.0,0,1,2,4,7,0xb2d17782
11380.85,1.0,2,2,2,4,8,0xb2d473b1
124295.34,1.0,7,3,2,3,8,0xb2d62d29d
1795031.43,13.0,0,4,4,4,12,0xb2d181a4d
15132.78,1.0,92,2,2,1,5,0xb2d3669ad
50001.06,2.0,80,2,3,1,6,0xb2d5d23c
33.57,1.0,7,1,2,3,6,0xb2d28786
43163.03,2.0,2,2,3,4,9,0xb2d9d8a3
5885.83,1.0,0,2,2,4,8,0xb2d7881cd
1576009.75,6.0,6,4,4,3,11,0xb2d156aa
259.56,1.0,21,1,2,2,5,0xb2d4e1f7
436.56,3.0,20,1,4,2,7,0xb2d0b18ed
200075.91,2.0,47,3,3,2,8,0xb2d4523ad
106701.1,3.0,18,3,4,2,9,0xb2d193b1
914551.18,2.0,5,4,3,3,10,0xb2d3c938
222300.3,2.0,0,3,3,4,10,0xb2d3c731d
203248.72,3.0,12,3,4,3,10,0xb2d640d0
3616.15,1.0,92,2,2,1,5,0xb2d1f75d
240.18,1.0,11,1,2,3,6,0xb2d64a17
120006.33,2.0,13,3,3,3,9,0xb2d95b76
122431.14,3.0,90,3,4,1,8,0xb2d23000
526.85,1.0,8,1,2,3,6,0xb2d6a987
9430.93,1.0,184,2,2,1,5,0xb2d5c7ee
2.44,1.0,15,1,2,3,6,0xb2d4bde9
2000464.44,1.0,32,4,2,2,8,0xb2d9b833
5089040.98,3.0,0,4,4,4,12,0x3b9b37e1d
1822441.1,6.0,25,4,4,2,10,0xb2d412d1d
475.74,1.0,28,1,2,2,5,0xb2d23047
777.71,1.0,6,1,2,3,6,0xb2d2a2b8
1267.17,1.0,1,1,2,4,7,0xb2d6a900
4029.14,1.0,184,2,2,1,5,0xb2d2098ed
6560.31,1.0,1,2,2,4,8,0xb2d399c4d
1236.89,1.0,9,1,2,3,6,0xb2d5acc2d
719.64,1.0,7,1,2,3,6,0xb2d1f4a0
51001.08,2.0,31,2,3,2,7,0xb2d93a18
110781.02,4.0,60,3,4,2,9,0xb2d668bfd
1217.97,1.0,150,1,2,1,4,0xb2d3bcf5
131364.5,3.0,18,3,4,2,9,0xb2d6ae03
101251.4,2.0,11,3,3,3,9,0xb2d6f8e1
458184.91,3.0,33,4,4,2,10,0xb2d2c271
520140.43,3.0,0,4,4,4,12,0xb2d375cdd
72177.95,4.0,0,3,4,4,11,0xb2d4068e
241089.21,1.0,0,3,2,4,9,0xb2d60551
586783.63,2.0,40,4,3,2,9,0xb2d78b79d
395000.2,10.0,8,4,4,3,11,0xb2d5bd3cd
254.82,1.0,55,1,2,2,5,0xb2d62075
210010.59,2.0,18,3,3,2,8,0xb2d9854c
50440.42,3.0,53,2,4,2,8,0xb2d67f92d
100051.74,2.0,92,3,3,1,7,0xb2d47473
2760.05,1.0,7,1,2,3,6,0xb2d6efd4d
4078.81,1.0,184,2,2,1,5,0xb2d07234d
1.37,1.0,11,1,2,3,6,0xb2d5d122
280877.57,3.0,10,3,4,3,10,0xb2d1556ad
121119.8,7.0,5,3,4,3,10,0xb2d57f4ad
67101.2,2.0,111,3,3,1,7,0xb2d633e1d
15954.91,1.0,2,2,2,4,8,0xb2d2b7b5
300000.0,2.0,13,3,3,3,9,0xb2da405e
29057.39,1.0,0,2,2,4,8,0xb2d6b4a5d
450026.8,1.0,0,4,2,4,10,0xb2d8ce34
60001.17,2.0,39,3,3,2,8,0xb2d4f6e0
1271.39,1.0,92,1,2,1,4,0xb2d14415d
337814.45,3.0,20,4,4,2,10,0xb2d3380ed
150641.37,2.0,24,3,3,2,8,0xb2d8f226d
101193.44,1.0,81,3,2,1,6,0xb2d8d73dd
5086.98,1.0,92,2,2,1,5,0xb2d34913
6.03,2.0,7,1,3,3,7,0x3b9b3ea0
60002.53,2.0,60,3,3,2,8,0xb2d9b751
807.65,1.0,61,1,2,2,5,0xb2d63c7c
479228.45,10.0,3,4,4,4,12,0xb2d4aa51
250000.58,3.0,3,3,4,4,11,0xb2da1a94
680020.21,3.0,56,4,4,2,10,0xb2d5bbad
1477.4,1.0,21,1,2,2,5,0xb2d45bc2
8481.63,1.0,10,2,2,3,7,0xb2d2f24fd
9810.44,1.0,12,2,2,3,7,0xb2d22997d
7.99,1.0,9,1,2,3,6,0xb2d33380d
36063.37,4.0,60,2,4,2,8,0xb2d5fd1dd
50960.5,2.0,136,2,3,1,6,0xb2d57e52d
51065.6,1.0,26,2,2,2,6,0xb2d3e94dd
5002.01,1.0,48,2,2,2,6,0xb2d23747
263708.4,8.0,0,3,4,4,11,0xb2d2e7d6
70034.94,2.0,157,3,3,1,7,0xb2d2872d
6971.55,1.0,22,2,2,2,6,0xb2d43276
69883.89,2.0,0,3,3,4,10,0xb2d06d47
277830.51,3.0,106,3,4,1,8,0xb2d64670
6650.45,1.0,133,2,2,1,5,0xb2d6892bd
77334.63,1.0,11,3,2,3,8,0xb2d14da5d
450015.72,7.0,95,4,4,1,9,0xb2d598af
3000730.42,2.0,11,4,3,3,10,0xb2d6c223d
1010.55,1.0,184,1,2,1,4,0xb2d2dd11d
233165.6,1.0,20,3,2,2,7,0xb2d1d9f1
430000.0,22.0,1,4,4,4,12,0xb2d56611
52033.13,2.0,74,2,3,1,6,0xb2d1eb37
1741.26,1.0,184,1,2,1,4,0xb2d34cec
454000.0,1.0,3,4,2,4,10,0xb2d2cd14d
3991.85,1.0,20,2,2,2,6,0xb2d3c369
100036.44,2.0,175,3,3,1,7,0xb2d8a27dd
27840.15,1.0,0,2,2,4,8,0xb2d609add
10.86,1.0,11,1,2,3,6,0xb2d6d3bfd
387.42,1.0,0,1,2,4,7,0xb2d5637e
4171.56,1.0,28,2,2,2,6,0xb2d5b037
689.4,1.0,11,1,2,3,6,0xb2d901fe
300006.33,2.0,24,3,3,2,8,0xb2d14991
1003556.42,6.0,37,4,4,2,10,0xb2d9a66b
5555.92,2.0,0,2,3,4,9,0x3b9b38f3
1913.79,1.0,92,1,2,1,4,0xb2d2f2e3d
4412.26,1.0,6,2,2,3,7,0xb2d2fef6
13912.0,1.0,0,2,2,4,8,0xb2da0534
39080.3,2.0,172,2,3,1,6,0xb2d541a0
259007.06,9.0,11,3,4,3,10,0xb2d5550a
306073.97,6.0,0,4,4,4,12,0xb2d0d849
0.0,1.0,10,1,2,3,6,0xb2d69768
80186.6,1.0,0,3,2,4,9,0xb2d305d4d
70002.22,2.0,25,3,3,2,8,0xb2d0e7bd
117.12,1.0,4,1,2,4,7,0xb2d90202d
240031.72,2.0,53,3,3,2,8,0xb2d6c55ed
837.66,1.0,0,1,2,4,7,0xb2d6bc19
260486.32,2.0,151,3,3,1,7,0xb2d5c4bc
15310.8,1.0,159,2,2,1,5,0xb2d684ccd
548669.08,4.0,0,4,4,4,12,0xb2d2eb7ad
100030.81,2.0,104,3,3,1,7,0xb2d12003d
2912.95,1.0,184,2,2,1,5,0xb2d2bd26
313015.37,7.0,3,4,4,4,12,0xb2d1886d
18730.44,1.0,23,2,2,2,6,0xb2d090d5
5793.74,1.0,3,2,2,4,8,0xb2d0affe
7588.61,1.0,0,2,2,4,8,0xb2d343d6
2275111.98,7.0,112,4,4,1,9,0xb2d072ddd
210088.82,7.0,41,3,4,2,9,0xb2d6e20cd
143006.66,2.0,164,3,3,1,7,0xb2d6053ed
203500.99,2.0,143,3,3,1,7,0xb2d625ff
52278.15,2.0,95,3,3,1,7,0xb2d58496
48202.63,3.0,13,2,4,3,9,0xb2d99441
2579.46,1.0,14,1,2,3,6,0xb2d92c97
1.29,1.0,25,1,2,2,5,0xb2d204ebd
100003.17,2.0,46,3,3,2,8,0xb2d9d985
1.02,1.0,35,1,2,2,5,0xb2d2e0a7d
201911.99,3.0,68,3,4,1,8,0xb2d88fc2
143251.58,9.0,4,3,4,4,11,0xb2d0b41e
3165.41,1.0,92,2,2,1,5,0xb2d28ebb
247.0,1.0,35,1,2,2,5,0xb2d8df12
475250.74,5.0,55,4,4,2,10,0x3b9b32e4d
9.43,1.0,6,1,2,3,6,0xb2d386b0
400042.49,2.0,6,4,3,3,10,0xb2d8f245d
50000.0,1.0,1,2,2,4,8,0xb2da69f7
252235.17,2.0,0,3,3,4,10,0xb2d407ed
300000.0,2.0,20,3,3,2,8,0xb2d95711
125000.06,2.0,38,3,3,2,8,0x3b9b26ead
138034.48,1.0,0,3,2,4,9,0xb2d2d176
29265.11,1.0,0,2,2,4,8,0xb2d33f14
15431.1,1.0,0,2,2,4,8,0xb2d906cc
600014.27,2.0,175,4,3,1,8,0xb2d606cd
70103.46,2.0,185,3,3,1,7,0xb2d52ed7
80055.3,2.0,98,3,3,1,7,0xb2d13c80d
2254049.66,12.0,3,4,4,4,12,0xb2d3b56dd
70415.07,1.0,47,3,2,2,7,0xb2d788f4
4735.83,1.0,20,2,2,2,6,0xb2d31bf1d
80004.22,2.0,92,3,3,1,7,0xb2d65cb0
608529.62,2.0,78,4,3,1,8,0xb2d91ca6d
43.8,2.0,6,1,3,3,7,0xb2d933f3
9339.54,1.0,3,2,2,4,8,0xb2d38890
9346.47,1.0,2,2,2,4,8,0xb2d0b490
29732.99,1.0,13,2,2,3,7,0xb2d34822
150135.42,3.0,12,3,4,3,10,0xb2d14a28
14.81,1.0,39,1,2,2,5,0xb2d25ebe
91.7,1.0,10,1,2,3,6,0xb2d678a6
93712.47,1.0,184,3,2,1,6,0xb2d1ad30
9086.73,1.0,92,2,2,1,5,0xb2d2acc2d
507.11,1.0,3,1,2,4,7,0xb2d3f129
645000.0,6.0,0,4,4,4,12,0xb2d30f8a
850051.09,6.0,0,4,4,4,12,0xb2d503aed
1110095.09,3.0,132,4,4,1,9,0xb2d64507
429585.92,5.0,27,4,4,2,10,0xb2d5d901d
7.62,1.0,6,1,2,3,6,0xb2d5c308d
363.64,1.0,2,1,2,4,7,0xb2d24b59
4594283.78,4.0,136,4,4,1,9,0xb2d1a4ebd
701145.98,14.0,0,4,4,4,12,0xb2d1f874d
300020.13,2.0,83,3,3,1,7,0xb2d5856f
1193696.61,4.0,4,4,4,4,12,0xb2d22ab8
201421.0,2.0,61,3,3,2,8,0xb2d9c02f
31256.4,3.0,183,2,4,1,7,0xb2d0bf00d
65092.32,2.0,104,3,3,1,7,0xb2d50a19
10042.39,1.0,92,2,2,1,5,0xb2d32febd
254836.45,4.0,5,3,4,3,10,0xb2d1f14a
7768.98,1.0,0,2,2,4,8,0xb2d8c512d
451.66,1.0,3,1,2,4,7,0xb2d5a1b0
0.0,1.0,2,1,2,4,7,0xb2d3e959
557110.32,7.0,0,4,4,4,12,0xb2d12aa7d
3588.9,1.0,0,2,2,4,8,0xb2d10bb6
91002.72,3.0,41,3,4,2,9,0xb2d64afed
40000.0,2.0,3,2,3,4,9,0xb2d9765bd
1683.14,1.0,0,1,2,4,7,0xb2d91604
1505.86,1.0,92,1,2,1,4,0xb2d0ef9a
13.97,1.0,40,1,2,2,5,0xb2d6f02b
200098.74,2.0,25,3,3,2,8,0xb2d67aa2
10607.23,1.0,11,2,2,3,7,0xb2d3194d
16890.41,2.0,59,2,3,2,7,0xb2d198e0d
180101.76,3.0,10,3,4,3,10,0xb2d5793c
110034.02,2.0,2,3,3,4,10,0xb2d570f3d
157.25,1.0,3,1,2,4,7,0xb2d95191
131.45,1.0,14,1,2,3,6,0xb2d1d98b
20000.84,2.0,92,2,3,1,6,0xb2d62aff
3199.04,1.0,168,2,2,1,5,0xb2d2d3acd
10070.52,2.0,44,2,3,2,7,0xb2d9de5b
2125.29,3.0,0,1,4,4,9,0x3b9b45b4d
515000.74,3.0,6,4,4,3,11,0xb2d5c635
3687.72,3.0,92,2,4,1,7,0xb2d2dab7
200354.2,2.0,0,3,3,4,10,0xb2d6d95b
892319.17,21.0,0,4,4,4,12,0x3b9b46c3d
90046.12,3.0,26,3,4,2,9,0xb2d0df96d
200000.0,2.0,3,3,3,4,10,0xb2d97d1fd
3.74,1.0,60,1,2,2,5,0xb2d60e07
497337.8,2.0,0,4,3,4,11,0xb2d6b57a
441090.44,7.0,18,4,4,2,10,0xb2d60fa2d
101291.06,1.0,4,3,2,4,9,0xb2d59beb
12594.07,1.0,3,2,2,4,8,0xb2d90e05d
50003.17,2.0,25,2,3,2,7,0xb2d5b5dbd
1750142.46,10.0,9,4,4,3,11,0xb2d23bc3d
0.74,1.0,5,1,2,3,6,0xb2d64897d
100000.0,3.0,2,3,4,4,11,0xb2d5ac21d
500000.0,2.0,13,4,3,3,10,0xb2d9610d
619.86,1.0,0,1,2,4,7,0xb2d2fdac
2252511.56,2.0,0,4,3,4,11,0xb2d1ae9b
66880.73,4.0,0,3,4,4,11,0x3b9af196d
10899.32,2.0,16,2,3,2,7,0xb2d9eeb5
407822.31,3.0,92,4,4,1,9,0xb2d6988bd
0.21,1.0,69,1,2,1,4,0xb2d5d0f6
390218.41,3.0,19,4,4,2,10,0xb2d33b8dd
250000.0,2.0,17,3,3,2,8,0xb2da3704
31515.67,1.0,21,2,2,2,6,0xb2d5d3a5
156.25,1.0,9,1,2,3,6,0xb2d92ce0
504638.44,1.0,133,4,2,1,7,0xb2d687d4d
1000000.0,1.0,4,4,2,4,10,0xb2da5b57
300139.51,2.0,0,4,3,4,11,0xb2d1d942d
130055.83,3.0,0,3,4,4,11,0xb2d58973
3.76,1.0,98,1,2,1,4,0xb2d40056
8632.22,1.0,24,2,2,2,6,0xb2d642dcd
51604.18,1.0,92,2,2,1,5,0xb2d22116
230000.0,2.0,27,3,3,2,8,0xb2d9ec19
9902.04,1.0,3,2,2,4,8,0xb2d76a56
102102.44,3.0,94,3,4,1,8,0xb2d695c5
611.22,1.0,0,1,2,4,7,0xb2d51f30
70053.93,2.0,0,3,3,4,10,0xb2d68484
310000.0,2.0,14,4,3,3,10,0xb2da3bb7
350043.25,2.0,27,4,3,2,9,0xb2d901e0
5004.99,1.0,0,2,2,4,8,0xb2d359d2d
3712.64,1.0,0,2,2,4,8,0xb2d3cf16
301466.87,8.0,74,4,4,1,9,0xb2d53385
117287.05,1.0,8,3,2,3,8,0xb2d23a7ed
25204.02,1.0,2,2,2,4,8,0xb2d0959d
339018.01,2.0,98,4,3,1,8,0xb2d68af1
280108.15,4.0,10,3,4,3,10,0xb2d4b32a
460029.71,4.0,56,4,4,2,10,0xb2d41a9f
12270.53,2.0,13,2,3,3,8,0xb2d2e764
280013.49,5.0,67,3,4,1,8,0xb2d207ce
495.56,1.0,10,1,2,3,6,0xb2d21c45
439465.56,3.0,0,4,4,4,12,0x3b9b0e66
20000.42,2.0,74,2,3,1,6,0xb2d99bf3
281147.22,6.0,80,3,4,1,8,0xb2d3b1ec
1.87,1.0,11,1,2,3,6,0xb2d959c4
18704.01,1.0,0,2,2,4,8,0xb2d21eba
376815.06,3.0,0,4,4,4,12,0xb2d210b7d
17590.12,1.0,39,2,2,2,6,0xb2d5d966d
1018613.46,2.0,82,4,3,1,8,0xb2d6b604d
400000.0,3.0,0,4,4,4,12,0xb2d983ae
685962.89,9.0,0,4,4,4,12,0x3b9af1ff
10000.32,2.0,53,2,3,2,7,0xb2d85770
60040.56,2.0,200,3,3,1,7,0xb2d1f302
25171.6,1.0,2,2,2,4,8,0xb2d3b14a
120004.12,5.0,56,3,4,2,9,0xb2d98601
400001.15,2.0,23,4,3,2,9,0xb2d8d084d
20882.62,2.0,5,2,3,3,8,0xb2d13ea6
2954.11,1.0,0,2,2,4,8,0xb2d6b181
52154.2,1.0,0,3,2,4,9,0xb2d3326e
1722337.9,4.0,1,4,4,4,12,0xb2d16da7
266226.58,7.0,0,3,4,4,11,0xb2d65564d
16920.77,1.0,14,2,2,3,7,0xb2d6c07d
785000.0,10.0,7,4,4,3,11,0x3b9b185bd
50393.39,2.0,108,2,3,1,6,0xb2d6b339
511134.08,14.0,12,4,4,3,11,0x3b9b38d9
1025.31,2.0,32,1,3,2,6,0xb2d35a3d
221263.91,2.0,49,3,3,2,8,0xb2d347f3d
100003.7,3.0,20,3,4,2,9,0xb2da10f6
200024.14,2.0,19,3,3,2,8,0xb2d78585
785.88,1.0,55,1,2,2,5,0xb2d3ea99
202131.85,2.0,95,3,3,1,7,0xb2d97bbb
44787817.31,3.0,66,4,4,2,10,0x3b9af39dd
603005.46,4.0,39,4,4,2,10,0xb2d25b22
330007.91,4.0,14,4,4,3,11,0xb2d62378
12831.63,1.0,2,2,2,4,8,0xb2d55eafd
1529.84,1.0,184,1,2,1,4,0xb2d0ec2b
3094474.03,4.0,8,4,4,3,11,0xb2d634d4d
200002.18,2.0,11,3,3,3,9,0xb2d61021d
5.18,1.0,17,1,2,2,5,0xb2d37c3b
243070.86,6.0,18,3,4,2,9,0xb2d6a35d
2340.42,1.0,20,1,2,2,5,0xb2d6debf
254053.35,3.0,102,3,4,1,8,0xb2d8f225
204668.85,3.0,189,3,4,1,8,0x3b9b36cb
2115009.05,9.0,8,4,4,3,11,0xb2d17ba6d
3512.59,1.0,3,2,2,4,8,0xb2d3306e
2210.16,1.0,180,1,2,1,4,0xb2d444db
1606388.28,3.0,20,4,4,2,10,0xb2d3c938d
50219.95,1.0,184,2,2,1,5,0xb2d5d2f5d
750142.36,2.0,55,4,3,2,9,0xb2d6faf2
200611.42,2.0,74,3,3,1,7,0xb2d2e070
87644.05,2.0,26,3,3,2,8,0xb2d57998d
230004.48,3.0,42,3,4,2,9,0xb2d5c712
2832.02,1.0,10,1,2,3,6,0xb2d7fc65d
130233.89,3.0,0,3,4,4,11,0xb2d426d1
1169.24,1.0,92,1,2,1,4,0xb2d3372bd
6994.14,1.0,2,2,2,4,8,0xb2d2da53
100332.96,2.0,230,3,3,1,7,0xb2d65926d
75000.14,2.0,5,3,3,3,9,0xb2d8fa0c
2015.1,3.0,4,1,4,4,9,0xb2d2a385
271.37,1.0,2,1,2,4,7,0xb2d2755d
600093.66,3.0,8,4,4,3,11,0xb2d20504d
16006.95,2.0,0,2,3,4,9,0xb2d8f6c1
1234.85,1.0,13,1,2,3,6,0xb2d2ce25d
609768.18,2.0,0,4,3,4,11,0xb2d4ee98d
1042.62,1.0,184,1,2,1,4,0xb2d26983d
31.82,1.0,6,1,2,3,6,0xb2d96ab5
100138.24,2.0,15,3,3,3,9,0xb2d3ab7b
3356.34,1.0,5,2,2,3,7,0xb2d0b94bd
101195.31,2.0,77,3,3,1,7,0xb2d8d445
42056.85,1.0,20,2,2,2,6,0xb2d68ecf
50117.64,2.0,184,2,3,1,6,0xb2d341d9d
1516.65,2.0,92,1,3,1,5,0xb2d16463d
65.83,1.0,3,1,2,4,7,0xb2d4e113
1989.91,1.0,92,1,2,1,4,0xb2d1f7d6
764762.99,6.0,70,4,4,1,9,0xb2d1a419
160099.05,2.0,0,3,3,4,10,0xb2d9341fd
240042.36,7.0,4,3,4,4,11,0xb2d58148
331699.98,2.0,0,4,3,4,11,0xb2d5041f
55042.2,1.0,4,3,2,4,9,0xb2d97748
20272.78,1.0,21,2,2,2,6,0xb2da06f1
17.13,1.0,184,1,2,1,4,0xb2d1d84ed
440326.07,3.0,0,4,4,4,12,0xb2d5f491
8188.85,1.0,92,2,2,1,5,0xb2d2549e
470003.4,11.0,18,4,4,2,10,0xb2d57a03
16511.1,1.0,92,2,2,1,5,0xb2d282ee
914410.91,10.0,3,4,4,4,12,0x3b9b3d23d
500000.0,3.0,17,4,4,2,10,0xb2d9a574
300093.09,3.0,4,3,4,4,11,0xb2d5c377
0.0,1.0,2,1,2,4,7,0xb2da4b65
404326.57,4.0,20,4,4,2,10,0xb2d5bcf6d
28972.71,1.0,32,2,2,2,6,0xb2d69f0ed
5820.41,1.0,184,2,2,1,5,0xb2d1d888d
201195.25,2.0,10,3,3,3,9,0xb2d5d6b7d
180072.29,3.0,90,3,4,1,8,0xb2d4493b
10714.64,1.0,92,2,2,1,5,0xb2d2c9e7
21.96,1.0,14,1,2,3,6,0xb2d6bb9bd
68.85,1.0,8,1,2,3,6,0xb2d8cb95
360503.75,4.0,6,4,4,3,11,0x3b9b3bc9d
2537.85,1.0,184,1,2,1,4,0xb2d13f4fd
90150.96,2.0,19,3,3,2,8,0xb2d37c6b
200743.17,2.0,48,3,3,2,8,0xb2d4141ad
581080.88,3.0,5,4,4,3,11,0xb2d561a3d
1672.12,1.0,7,1,2,3,6,0xb2d58446d
470000.0,6.0,7,4,4,3,11,0xb2d59c9bd
35001.0,3.0,10,2,4,3,9,0xb2d95fe6
105000.0,1.0,9,3,2,3,8,0xb2d956c9
9299.68,1.0,184,2,2,1,5,0xb2d5cbf2d
461.37,1.0,50,1,2,2,5,0xb2d601e8d
92.34,1.0,49,1,2,2,5,0xb2d8b064
6039.68,1.0,3,2,2,4,8,0xb2d6891ad
1421.17,6.0,10,1,4,3,8,0x3b9b46b7d
749.22,1.0,10,1,2,3,6,0xb2d55201d
25.58,2.0,84,1,3,1,5,0xb2d60e87
500001.18,3.0,23,4,4,2,10,0xb2d6e65e
254.8,1.0,18,1,2,2,5,0xb2d30ac2
420024.64,5.0,129,4,4,1,9,0xb2d18100
812278.23,10.0,11,4,4,3,11,0xb2d1e97fd
118405.88,3.0,3,3,4,4,11,0xb2d62379d
250000.0,3.0,4,3,4,4,11,0xb2d3ec36
300000.0,2.0,29,3,3,2,8,0xb2da0be6
500000.15,2.0,14,4,3,3,10,0xb2d9d781
789.93,1.0,0,1,2,4,7,0xb2d17674d
192064.91,4.0,60,3,4,2,9,0xb2d600e8
1893.07,1.0,92,1,2,1,4,0xb2d25c25
1259098.22,2.0,0,4,3,4,11,0xb2d59bf8
562085.17,6.0,3,4,4,4,12,0x3b9b37e7d
201703.88,4.0,48,3,4,2,9,0x3b9b1667
238091.55,5.0,53,3,4,2,9,0xb2d256d0
420790.45,3.0,29,4,4,2,10,0xb2d6def9
603850.57,6.0,25,4,4,2,10,0xb2d56e57
1001776.04,3.0,29,4,4,2,10,0xb2d9f18f
2349.09,1.0,17,1,2,2,5,0xb2d1a163d
430034.2,3.0,70,4,4,1,9,0xb2d61125d
3067.26,1.0,0,2,2,4,8,0xb2d4f966
430018.18,2.0,118,4,3,1,8,0xb2d6454ad
324094.31,2.0,145,4,3,1,8,0xb2d5d525d
121101.45,4.0,6,3,4,3,10,0xb2d91fa3
12366.36,1.0,0,2,2,4,8,0xb2d30555
3479.12,1.0,84,2,2,1,5,0xb2d5872d
505660.09,2.0,6,4,3,3,10,0xb2d4eac6
5357.63,1.0,164,2,2,1,5,0xb2d3b84b
21683.0,1.0,279,2,2,1,5,0xb2d4278fd
4986.28,1.0,0,2,2,4,8,0xb2d4cc10
7877462.53,3.0,11,4,4,3,11,0xb2d5519a
6057.25,2.0,45,2,3,2,7,0x3b9b3ddcd
52.47,1.0,75,1,2,1,4,0xb2d29fda
13.41,1.0,26,1,2,2,5,0xb2d9e85a
8882.24,1.0,20,2,2,2,6,0xb2d8c707d
6441.68,1.0,1,2,2,4,8,0xb2d9868a
63309.6,2.0,20,3,3,2,8,0xb2d64256
504403.32,2.0,73,4,3,1,8,0xb2d61091
272256.44,4.0,6,3,4,3,10,0xb2d6ab26d
230980.2,2.0,0,3,3,4,10,0x3b9b40dd
83865.56,1.0,8,3,2,3,8,0xb2d3717b
321788.22,11.0,10,4,4,3,11,0xb2d42930
360033.38,3.0,116,4,4,1,9,0xb2d6d0a2d
7855.45,1.0,33,2,2,2,6,0xb2d6a559
18287.2,1.0,25,2,2,2,6,0xb2d53d9d
30818.54,2.0,92,2,3,1,6,0xb2d08fbcd
3178.08,1.0,3,2,2,4,8,0xb2d6b52c
70379.88,3.0,189,3,4,1,8,0xb2d58b53d
350074.99,4.0,11,4,4,3,11,0xb2d0ecdcd
4142.51,1.0,19,2,2,2,6,0xb2d90d69d
500065.95,11.0,3,4,4,4,12,0xb2d554f1
934102.79,9.0,11,4,4,3,11,0xb2d19237d
1051.11,1.0,184,1,2,1,4,0xb2d062b1
202264.53,5.0,28,3,4,2,9,0x3b9b1253
733113.29,10.0,21,4,4,2,10,0xb2d105fe
2.95,1.0,26,1,2,2,5,0xb2d6d3e0d
1229.66,1.0,31,1,2,2,5,0xb2d0d646
24841.11,1.0,0,2,2,4,8,0xb2d1cf38d
287286.82,4.0,6,3,4,3,10,0xb2d1218dd
50083.78,2.0,0,2,3,4,9,0xb2d95f3a
554053.14,5.0,48,4,4,2,10,0xb2d16a48
1.13,1.0,29,1,2,2,5,0xb2d2e4ef
1443005.24,12.0,0,4,4,4,12,0x3b9b0fc0d
8.61,1.0,1,1,2,4,7,0xb2d60fab
475685.11,4.0,63,4,4,2,10,0xb2d10aff
1785.72,2.0,122,1,3,1,5,0xb2d86e89
500000.03,3.0,10,4,4,3,11,0xb2d6105b
564902.2,7.0,0,4,4,4,12,0xb2d06703
30701.69,2.0,60,2,3,2,7,0xb2d6bbc2d
1598.68,1.0,92,1,2,1,4,0xb2d26aa6
50229.98,2.0,59,2,3,2,7,0xb2d5c97c
2005.98,1.0,92,1,2,1,4,0xb2d6127fd
1070021.46,3.0,181,4,4,1,9,0xb2d68ad2
2973.69,1.0,7,2,2,3,7,0xb2d31940
22.87,1.0,37,1,2,2,5,0xb2d9c055
90733.93,2.0,38,3,3,2,8,0xb2d3547e
1836242.84,10.0,18,4,4,2,10,0xb2d3eb74
11579.55,1.0,0,2,2,4,8,0xb2d2a88e
11445.84,1.0,4,2,2,4,8,0xb2d23c9f
170002.64,4.0,35,3,4,2,9,0xb2d6ff99
100896.78,2.0,102,3,3,1,7,0xb2d7bfd2
107999.48,4.0,0,3,4,4,11,0xb2d5899bd
11961.93,1.0,0,2,2,4,8,0xb2d6c45d
5325.42,1.0,0,2,2,4,8,0xb2d475a4
107271.96,2.0,6,3,3,3,9,0xb2d5f582
49231.87,1.0,0,2,2,4,8,0xb2d67f50d
80503.98,3.0,110,3,4,1,8,0xb2d5bf1e
23742.08,1.0,25,2,2,2,6,0xb2d9d79a
200696.1,2.0,18,3,3,2,8,0xb2d22dcd
1941.4,1.0,0,1,2,4,7,0xb2d2e176
1012.62,1.0,0,1,2,4,7,0xb2d57845
759.98,1.0,52,1,2,2,5,0xb2d6ea08
1696551.55,6.0,92,4,4,1,9,0x3b9af5bcd
4951.7,1.0,0,2,2,4,8,0xb2d6f2fb
900041.51,3.0,3,4,4,4,12,0xb2d693e6
472407.24,3.0,25,4,4,2,10,0xb2d35ad8
641547.29,1.0,0,4,2,4,10,0xb2d2409fd
61160.72,1.0,92,3,2,1,6,0xb2d34d61d
200995.9,2.0,0,3,3,4,10,0xb2d3cd2e
1297.39,1.0,9,1,2,3,6,0xb2d3a7f7d
3969.12,1.0,3,2,2,4,8,0xb2d25d1bd
4088.9,1.0,92,2,2,1,5,0xb2d252f1
10089.01,2.0,18,2,3,2,7,0xb2d9fc2b
1175.55,1.0,184,1,2,1,4,0xb2d131b3d
3.79,1.0,2,1,2,4,7,0xb2d90700
6187.51,1.0,2,2,2,4,8,0xb2d6bfaad
600030.67,3.0,6,4,4,3,11,0xb2d963fb
50001.39,3.0,38,2,4,2,8,0xb2d8ef1dd
1120742.85,7.0,9,4,4,3,11,0xb2d6de32d
1331820.39,6.0,0,4,4,4,12,0xb2d40432d
32717.95,1.0,130,2,2,1,5,0xb2d279bdd
166.29,2.0,1,1,3,4,8,0xb2d7ef30
164011.99,2.0,101,3,3,1,7,0xb2d1bba3
3250.83,2.0,184,2,3,1,6,0xb2d0a2ae
2094.18,1.0,12,1,2,3,6,0xb2d6bdd5
2032395.59,3.0,7,4,4,3,11,0x3b9b3174
500072.2,2.0,96,4,3,1,8,0xb2d40973
60172.63,3.0,4,3,4,4,11,0xb2d6f8ad
0.97,1.0,4,1,2,4,7,0xb2d5e5ded
6240.14,1.0,5,2,2,3,7,0xb2d29d2ed
90001.9,2.0,235,3,3,1,7,0xb2d6e8aa
466627.49,2.0,15,4,3,3,10,0xb2d3fc93
892.87,1.0,9,1,2,3,6,0xb2d6fc66
1529.84,1.0,15,1,2,3,6,0xb2d38163
276534.17,6.0,1,3,4,4,11,0xb2d78030
2819.29,1.0,1,1,2,4,7,0xb2d327d7
1023.44,1.0,184,1,2,1,4,0xb2d5318bd
201288.77,1.0,201,3,2,1,6,0xb2d3bb84
448.25,1.0,1,1,2,4,7,0xb2d4d0ab
332023.93,10.0,18,4,4,2,10,0xb2d503b7
206049.28,3.0,164,3,4,1,8,0x3b9b4755d
1383.62,1.0,184,1,2,1,4,0xb2d4bcfdd
100001.06,2.0,48,3,3,2,8,0xb2d91316
69667.52,8.0,0,3,4,4,11,0xb2d2a3f6d
0.12,2.0,82,1,3,1,5,0xb2d4db21
5481.08,1.0,7,2,2,3,7,0xb2d2e17dd
1432995.76,6.0,59,4,4,2,10,0xb2d18122
100004.22,2.0,70,3,3,1,7,0xb2d9a393
131058.46,3.0,77,3,4,1,8,0xb2d56eced
550027.71,2.0,27,4,3,2,9,0xb2d367e2
501851.14,2.0,38,4,3,2,9,0xb2d8e28b
123437.11,2.0,8,3,3,3,9,0xb2d5f624d
7874.74,1.0,0,2,2,4,8,0xb2d68e39
6.47,1.0,33,1,2,2,5,0xb2d74a13
1160.55,1.0,9,1,2,3,6,0xb2d8e7b1d
100007.73,2.0,249,3,3,1,7,0xb2d44931
700000.0,3.0,6,4,4,3,11,0xb2d8f2b1d
956067.49,6.0,21,4,4,2,10,0xb2d682d3
101721.85,3.0,57,3,4,2,9,0xb2d643f1
31382.55,96.0,1,2,4,4,10,0xb2d4a6bc
2157837.03,2.0,36,4,3,2,9,0xb2d9e435
0.25,2.0,41,1,3,2,6,0xb2d95604
288600.77,1.0,0,3,2,4,9,0xb2d24429d
60458.34,3.0,18,3,4,2,9,0xb2d62ec6d
200032.49,2.0,21,3,3,2,8,0xb2d61b3dd
202003.07,2.0,80,3,3,1,7,0xb2d5eff2
520079.46,4.0,7,4,4,3,11,0xb2d38fb9d
250003.48,2.0,20,3,3,2,8,0xb2d5efd8d
381.45,1.0,11,1,2,3,6,0xb2d912b6
20002.65,3.0,59,2,4,2,8,0xb2d61403
127064.51,5.0,0,3,4,4,11,0xb2d62259
2344.7,1.0,9,1,2,3,6,0xb2d57628
4459.48,1.0,21,2,2,2,6,0xb2d9d1b9
76876.2,1.0,9,3,2,3,8,0xb2d78e1c
60000.0,4.0,0,3,4,4,11,0xb2d646fe
12517.12,1.0,0,2,2,4,8,0xb2d35372d
120004.93,6.0,13,3,4,3,10,0xb2d6382cd
1.41,1.0,0,1,2,4,7,0xb2d97830
500000.0,2.0,2,4,3,4,11,0xb2d97f71
90000.74,3.0,4,3,4,4,11,0xb2d98705
610092.02,4.0,2,4,4,4,12,0xb2d2ec31d
187864.69,4.0,25,3,4,2,9,0xb2d60088d
16482.12,1.0,3,2,2,4,8,0xb2d54e2b
397758.17,8.0,0,4,4,4,12,0xb2d55d96
18714.16,1.0,18,2,2,2,6,0xb2d23b1a
500005.28,2.0,80,4,3,1,8,0xb2d98b31
132203.46,1.0,6,3,2,3,8,0xb2d69970
200032.03,3.0,4,3,4,4,11,0xb2d1662fd
178178.93,3.0,1,3,4,4,11,0xb2d075a8
233000.0,3.0,0,3,4,4,11,0xb2d950ebd
0.0,2.0,33,1,3,2,6,0xb2d944bc
724453.85,3.0,13,4,4,3,11,0xb2d0de2fd
406117.58,3.0,41,4,4,2,10,0xb2d64238d
464927.1,3.0,5,4,4,3,11,0xb2d5cb5bd
100.62,1.0,7,1,2,3,6,0xb2d3e767
5522.05,2.0,92,2,3,1,6,0xb2d205e6d
98808.23,3.0,4,3,4,4,11,0xb2d58a64d
3089098.7,49.0,0,4,4,4,12,0xb2d100efd
460023.59,2.0,2,4,3,4,11,0xb2d1775bd
1900080.23,2.0,52,4,3,2,9,0xb2d6d274
2023.78,1.0,184,1,2,1,4,0xb2d21cfdd
262386.35,2.0,0,3,3,4,10,0xb2d60cfb
11.41,1.0,11,1,2,3,6,0xb2d9102d
3147.3,1.0,184,2,2,1,5,0xb2d1495dd
35000.49,3.0,10,2,4,3,9,0xb2d53036
50049.27,2.0,2,2,3,4,9,0xb2d62d6b
2303.26,1.0,92,1,2,1,4,0xb2d202fb
52000.55,2.0,28,2,3,2,7,0xb2da0bb6
52099.33,1.0,208,2,2,1,5,0xb2d4a3dad
644.21,1.0,0,1,2,4,7,0xb2d0d927
600021.87,5.0,165,4,4,1,9,0xb2d4dd38d
200000.61,2.0,3,3,3,4,10,0xb2d6af2c
932577.04,4.0,7,4,4,3,11,0xb2d698c3d
257011.37,5.0,14,3,4,3,10,0xb2d5ebbd
4901.68,1.0,10,2,2,3,7,0xb2d20f9a
978.04,1.0,11,1,2,3,6,0xb2d47efc
20091.46,2.0,158,2,3,1,6,0xb2d590c8
555219.28,4.0,53,4,4,2,10,0xb2d91785
836940.35,4.0,1,4,4,4,12,0xb2d78d9f
350003.2,4.0,28,4,4,2,10,0xb2d8c5a6d
100145.77,4.0,102,3,4,1,8,0xb2d56fd2
62.97,1.0,0,1,2,4,7,0xb2d8d10e
200007.32,2.0,42,3,3,2,8,0xb2d9deb4
795000.0,26.0,0,4,4,4,12,0xb2d5d586
496882.8,2.0,112,4,3,1,8,0xb2d50c00d
100045.93,2.0,125,3,3,1,7,0xb2d5c00f
425709.03,16.0,3,4,4,4,12,0xb2d2a6f6
3042.69,1.0,8,2,2,3,7,0xb2d559eb
3828.88,1.0,16,2,2,2,6,0xb2d20e87d
2428.62,1.0,74,1,2,1,4,0xb2d69932
222555.82,2.0,2,3,3,4,10,0xb2d6c647
10716.97,1.0,0,2,2,4,8,0xb2d6d704
57891.19,1.0,67,3,2,1,6,0xb2d1a7ba
90092.06,3.0,18,3,4,2,9,0xb2d4bea3
174867.02,3.0,179,3,4,1,8,0xb2d24e65d
600.0,1.0,0,1,2,4,7,0xb2d57a50
130.83,1.0,0,1,2,4,7,0xb2d6c966
2.13,1.0,19,1,2,2,5,0xb2d68d19d
20101.59,2.0,92,2,3,1,6,0xb2d60cb1d
2101.85,1.0,1,1,2,4,7,0xb2d6feda
40693.78,1.0,3,2,2,4,8,0xb2d12ac1
93727.38,4.0,3,3,4,4,11,0x3b9b2d43d
796705.43,10.0,0,4,4,4,12,0xb2d1716ad
1012205.83,2.0,136,4,3,1,8,0xb2d15beed
330004.12,3.0,7,4,4,3,11,0xb2da094e
400083.39,2.0,4,4,3,4,11,0xb2d92b72
1721.41,2.0,9,1,3,3,7,0x3b9aee7f
3538.95,1.0,0,2,2,4,8,0xb2d36a3d
500903.22,5.0,11,4,4,3,11,0xb2d621aad
890001.38,6.0,3,4,4,4,12,0xb2d1c1cc
1.0,2.0,60,1,3,2,6,0xb2d56eb3d
3.01,1.0,3,1,2,4,7,0xb2d0959e
880000.0,6.0,2,4,4,4,12,0xb2d2e076
62106.21,2.0,104,3,3,1,7,0xb2d53778d
160008.45,2.0,111,3,3,1,7,0xb2d78811
93529.48,1.0,9,3,2,3,8,0xb2d25386d
27.14,1.0,10,1,2,3,6,0xb2d6a7abd
4134.66,1.0,21,2,2,2,6,0xb2d963e9
30000.74,3.0,34,2,4,2,8,0xb2d9a091
5715.79,1.0,9,2,2,3,7,0xb2d92ae2
40077.97,2.0,167,2,3,1,6,0xb2d4c96d
95018.87,6.0,39,3,4,2,9,0xb2d77f70
750105.29,4.0,0,4,4,4,12,0xb2d94c06d
14860.32,1.0,20,2,2,2,6,0xb2d8b1f1
4880.81,1.0,184,2,2,1,5,0xb2d2f57ad
480059.39,5.0,6,4,4,3,11,0xb2da1e4e
467.61,1.0,5,1,2,3,6,0xb2d8f4d7d
75336.28,1.0,55,3,2,2,7,0xb2d52044d
11744.55,1.0,1,2,2,4,8,0xb2d534b8
600114.72,8.0,8,4,4,3,11,0xb2d6a101
90170.45,3.0,18,3,4,2,9,0xb2d6dcb2d
3.13,1.0,6,1,2,3,6,0xb2d40056d
200383.6,4.0,40,3,4,2,9,0x3b9b49e3d
503183.1,2.0,33,4,3,2,9,0xb2d6d8e1d
2373.46,1.0,138,1,2,1,4,0xb2d2020fd
1000010.56,2.0,25,4,3,2,9,0xb2da0c8e
19767.6,1.0,1,2,2,4,8,0xb2d362f9
500000.0,3.0,0,4,4,4,12,0xb2d42577
525505.26,1.0,47,4,2,2,8,0xb2d59a3cd
8837.37,2.0,92,2,3,1,6,0x3b9b1388d
60001.28,7.0,0,3,4,4,11,0xb2d64083
6489.28,1.0,10,2,2,3,7,0xb2d4b4ca
307.56,2.0,92,1,3,1,5,0xb2d1053c
3680.36,1.0,9,2,2,3,7,0xb2d5ef31d
240405.13,3.0,259,3,4,1,8,0xb2d07cf8
25572.31,1.0,184,2,2,1,5,0x3b9b3a85d
2084.14,1.0,3,1,2,4,7,0xb2d5ccc5
120003.83,2.0,53,3,3,2,8,0xb2d0ea12
17.4,1.0,68,1,2,1,4,0xb2d977a0
375.53,1.0,0,1,2,4,7,0xb2d6acfed
100002.11,2.0,8,3,3,3,9,0xb2da465b
957.41,1.0,9,1,2,3,6,0xb2d62c2dd
100006.61,2.0,216,3,3,1,7,0xb2d32970
9244.65,1.0,0,2,2,4,8,0xb2d2c682
203766.77,1.0,1,3,2,4,9,0xb2d7fd59d
230816.98,2.0,34,3,3,2,8,0xb2d9ff7e
1990.22,1.0,5,1,2,3,6,0xb2d99e55
242205.12,6.0,0,3,4,4,11,0x3b9b3f1d
533.53,1.0,0,1,2,4,7,0xb2d62a52
13565.9,1.0,21,2,2,2,6,0xb2d2a9fc
1749.25,1.0,5,1,2,3,6,0xb2d62a09d
930039.31,3.0,11,4,4,3,11,0xb2d78f3fd
16043.91,1.0,3,2,2,4,8,0xb2d6de91
1454.85,1.0,0,1,2,4,7,0xb2d54f49d
250000.0,2.0,1,3,3,4,10,0xb2da53a3
2.95,1.0,25,1,2,2,5,0xb2d31fb5
200794.6,2.0,7,3,3,3,9,0xb2d49d68
464408.04,4.0,13,4,4,3,11,0xb2d256b9d
3821.88,1.0,0,2,2,4,8,0xb2d54683d
3109.21,1.0,0,2,2,4,8,0xb2d2b5f8
18509.26,1.0,78,2,2,1,5,0xb2d1ebe5
233261.99,2.0,3,3,3,4,10,0xb2d3c4be
220040.02,2.0,22,3,3,2,8,0xb2d9d231
103103.72,3.0,53,3,4,2,9,0xb2d065f6d
36.66,1.0,92,1,2,1,4,0xb2d253d0d
3969.76,1.0,0,2,2,4,8,0xb2d91b5f
200720.85,2.0,39,3,3,2,8,0xb2d9a7ae
0.54,2.0,75,1,3,1,5,0xb2d8d8aed
15006.93,1.0,13,2,2,3,7,0xb2d83d7bd
250326.24,1.0,0,3,2,4,9,0xb2d55ea8d
10072.53,1.0,92,2,2,1,5,0xb2d38b56d
94062.63,2.0,4,3,3,4,10,0xb2d58ee4
951199.52,3.0,0,4,4,4,12,0xb2d06b32
7074.28,1.0,11,2,2,3,7,0xb2d3ff97d
237533.86,1.0,34,3,2,2,7,0xb2d90f85
102761.66,3.0,92,3,4,1,8,0xb2d2f702
205689.25,2.0,30,3,3,2,8,0xb2d656b7
0.79,2.0,5,1,3,3,7,0x3b9b1808
10538.23,1.0,31,2,2,2,6,0xb2d7091c
401421.07,2.0,56,4,3,2,9,0xb2d9cac5
154521.51,2.0,1,3,3,4,10,0xb2d21118
421009.58,1.0,87,4,2,1,7,0xb2d53782d
2059.89,1.0,67,1,2,1,4,0xb2d63c5cd
153087.12,2.0,83,3,3,1,7,0xb2d54b38
70030.48,3.0,142,3,4,1,8,0xb2d7d074d
236869.6,2.0,35,3,3,2,8,0xb2d2597cd
1973.9,1.0,184,1,2,1,4,0xb2d0de98d
407.69,1.0,13,1,2,3,6,0x3b9b3f51
1442288.92,11.0,0,4,4,4,12,0xb2d0e60b
455007.76,10.0,11,4,4,3,11,0xb2d47281d
1727126.78,7.0,0,4,4,4,12,0xb2d17f2d
49394.98,1.0,1,2,2,4,8,0xb2d2029b
111777.7,4.0,21,3,4,2,9,0xb2d5e349
100141.23,4.0,10,3,4,3,10,0x3b9b389a
40206.32,2.0,14,2,3,3,8,0xb2d0787f
806343.11,8.0,5,4,4,3,11,0xb2d11edcd
760.9,1.0,8,1,2,3,6,0xb2d64a2e
48875.92,1.0,21,2,2,2,6,0xb2d60ace
2534.61,1.0,4,1,2,4,7,0xb2d6c058
3155.28,1.0,92,2,2,1,5,0xb2d2c053d
44460.18,1.0,184,2,2,1,5,0xb2d28c4d
505647.72,2.0,65,4,3,2,9,0xb2d9349b
2919879.96,2.0,15,4,3,3,10,0xb2d93afc
51310.37,1.0,92,2,2,1,5,0xb2d3bf42d
965105.97,80.0,8,4,4,3,11,0xb2d4a6efd
3739.91,1.0,18,2,2,2,6,0xb2d0d7c1
546611.31,16.0,3,4,4,4,12,0xb2d0b9ca
1535521.82,19.0,0,4,4,4,12,0x3b9ae3f1d
656017.31,8.0,55,4,4,2,10,0xb2d4adc9
3175.61,1.0,0,2,2,4,8,0xb2d4d206
969.42,1.0,19,1,2,2,5,0xb2d06615
50000.53,2.0,70,2,3,1,6,0xb2d9a5e8
1009.27,1.0,184,1,2,1,4,0xb2d213fb
2.23,1.0,78,1,2,1,4,0xb2d4451a
638076.06,5.0,6,4,4,3,11,0xb2d8d758
1617020.96,24.0,10,4,4,3,11,0xb2d58e94
3350624.1,10.0,0,4,4,4,12,0x3b9b1814
490000.0,3.0,5,4,4,3,11,0xb2d99976
110081.82,3.0,3,3,4,4,11,0xb2d1730a
400083.51,3.0,14,4,4,3,11,0xb2d6ef42d
113550.15,3.0,5,3,4,3,10,0xb2d24f8a
120001.27,2.0,186,3,3,1,7,0xb2d88f1b
70740.04,1.0,4,3,2,4,9,0xb2d2e81f
10.56,1.0,18,1,2,2,5,0xb2d954d3d
2165.89,1.0,184,1,2,1,4,0xb2d35358d
86.07,1.0,4,1,2,4,7,0xb2d12441d
768000.0,14.0,5,4,4,3,11,0xb2d16d8d
100000.01,2.0,84,3,3,1,7,0xb2d2885b
1812.67,1.0,184,1,2,1,4,0xb2d0a27c
4203.71,1.0,1,2,2,4,8,0xb2d6fee5
752.33,1.0,75,1,2,1,4,0xb2d45ef1
1572.21,1.0,92,1,2,1,4,0xb2d114a4
200002.74,2.0,15,3,3,3,9,0xb2da2a78
4.34,1.0,0,1,2,4,7,0xb2d1dad2
471255.68,4.0,10,4,4,3,11,0xb2d0c517d
124220.54,2.0,35,3,3,2,8,0xb2d584d5d
263641.95,3.0,3,3,4,4,11,0xb2d3d5bfd
1345.36,1.0,1,1,2,4,7,0xb2d2bcf4
6222.67,1.0,184,2,2,1,5,0xb2d28e32
80039.52,2.0,97,3,3,1,7,0xb2d4be57
384.49,1.0,6,1,2,3,6,0xb2d4ee7fd
25176.97,1.0,95,2,2,1,5,0xb2d417b5d
1093.84,1.0,184,1,2,1,4,0xb2d2f2d0d
1055.17,1.0,0,1,2,4,7,0xb2d6e067d
1250328.32,9.0,11,4,4,3,11,0xb2d54b13d
270224.74,4.0,0,3,4,4,11,0xb2d0da6ad
20528.08,1.0,184,2,2,1,5,0xb2d37c43d
654478.43,6.0,4,4,4,4,12,0xb2d49139d
18130.52,1.0,92,2,2,1,5,0xb2d3545cd
335031.97,2.0,18,4,3,2,9,0xb2d2c655
50016.18,3.0,27,2,4,2,8,0xb2d4ebfe
3346.15,10.0,184,2,4,1,7,0xb2d0ca46d
1000040.85,6.0,53,4,4,2,10,0xb2d636b4
270105.49,4.0,94,3,4,1,8,0xb2d1890dd
3331.32,1.0,1,2,2,4,8,0xb2d5387cd
1360000.0,1.0,0,4,2,4,10,0xb2da6bdc
303227.31,3.0,19,4,4,2,10,0xb2d145aed
457000.82,3.0,14,4,4,3,11,0xb2d6c5bd
101781.88,2.0,116,3,3,1,7,0xb2d0d71b
28822.59,1.0,0,2,2,4,8,0xb2d64accd
757.18,1.0,13,1,2,3,6,0xb2d6b0cdd
1235063.36,4.0,5,4,4,3,11,0xb2d54ea2d
321.74,1.0,1,1,2,4,7,0xb2d40a15
65671.51,3.0,0,3,4,4,11,0xb2d0d88ad
5813.4,1.0,23,2,2,2,6,0xb2d252a9d
1290.95,1.0,9,1,2,3,6,0xb2d6ef29
213217.79,1.0,5,3,2,3,8,0xb2d2c007d
260174.36,2.0,0,3,3,4,10,0xb2d95c88d
8057.65,2.0,4,2,3,4,9,0x3b9b0e3f
487672.78,4.0,136,4,4,1,9,0xb2d064c7d
7611.77,1.0,184,2,2,1,5,0xb2d591d6d
0.0,2.0,1,1,3,4,8,0xb2d91ece
306543.54,2.0,6,4,3,3,10,0xb2d129a3
534.82,1.0,10,1,2,3,6,0xb2d90544
120034.69,3.0,70,3,4,1,8,0xb2d580b0
43.45,2.0,54,1,3,2,6,0xb2d0c886
140985.99,5.0,0,3,4,4,11,0xb2d1d8a2
351896.19,6.0,0,4,4,4,12,0x3b9b0e57
607.27,1.0,10,1,2,3,6,0xb2d95864d
53651.95,2.0,174,3,3,1,7,0xb2d18613d
110169.54,3.0,0,3,4,4,11,0xb2d6211fd
50006.05,2.0,136,2,3,1,6,0xb2d4f139
205736.85,2.0,76,3,3,1,7,0xb2d4279a
34.46,1.0,13,1,2,3,6,0xb2d14c88d
4582.18,1.0,0,2,2,4,8,0xb2d859c8
120018.22,2.0,75,3,3,1,7,0xb2d56629
3556.45,1.0,4,2,2,4,8,0xb2d57f40
1428.13,1.0,305,1,2,1,4,0xb2d46812
130006.24,4.0,10,3,4,3,10,0xb2d5fbc0d
150017.11,2.0,92,3,3,1,7,0xb2d42e24d
33513.33,1.0,0,2,2,4,8,0xb2d28e31
1555.76,1.0,6,1,2,3,6,0xb2d24c16d
196129.2,1.0,4,3,2,4,9,0xb2d32968
1.24,1.0,13,1,2,3,6,0xb2d86e1b
9421.33,1.0,0,2,2,4,8,0xb2d6a751
456427.19,5.0,77,4,4,1,9,0xb2d17adbd
271395.26,7.0,19,3,4,2,9,0xb2d655edd
200020.85,2.0,22,3,3,2,8,0xb2d8d036
0.79,1.0,63,1,2,2,5,0xb2d5d9fe
5086.84,1.0,194,2,2,1,5,0xb2d7c572
3067.42,1.0,1,2,2,4,8,0xb2d60a89d
414.32,1.0,0,1,2,4,7,0xb2d33500d
530082.13,2.0,192,4,3,1,8,0xb2d3f708
254008.26,2.0,42,3,3,2,8,0xb2d57c3c
550001.3,6.0,2,4,4,4,12,0xb2d1f7b5d
680003.87,3.0,1,4,4,4,12,0xb2d1bb89d
60673.63,2.0,27,3,3,2,8,0xb2d6ae03d
20001.68,2.0,11,2,3,3,8,0xb2da26bb
80097.41,4.0,8,3,4,3,10,0xb2d68910
670092.58,2.0,18,4,3,2,9,0xb2d98db9
1344.01,1.0,10,1,2,3,6,0xb2d60e1b
55000.0,1.0,1,3,2,4,9,0xb2da4f75
453023.24,2.0,97,4,3,1,8,0xb2d07e5a
5027.73,1.0,148,2,2,1,5,0xb2d6541c
170028.55,3.0,3,3,4,4,11,0xb2d65a42
1007.29,1.0,119,1,2,1,4,0xb2d65567
131054.69,10.0,6,3,4,3,10,0x3b9af17c
422006.21,6.0,0,4,4,4,12,0xb2d79148d
167.98,1.0,6,1,2,3,6,0xb2d2d931
500028.19,2.0,8,4,3,3,10,0xb2d96fb0d
1023.09,1.0,125,1,2,1,4,0xb2d344e6
38463.33,2.0,1,2,3,4,9,0xb2d0bb98d
14.43,1.0,11,1,2,3,6,0xb2d67e0c
205797.12,2.0,91,3,3,1,7,0xb2d6acacd
390.2,1.0,66,1,2,2,5,0xb2d19741
3854.85,1.0,184,2,2,1,5,0xb2d3f121
260000.0,2.0,25,3,3,2,8,0xb2d90313
600006.33,3.0,18,4,4,2,10,0xb2d9543fd
50059.17,2.0,18,2,3,2,7,0xb2d275dcd
244679.71,2.0,69,3,3,1,7,0xb2d61801d
8.48,1.0,12,1,2,3,6,0xb2d0cba3d
200214.85,2.0,57,3,3,2,8,0xb2d5a83a
273053.43,2.0,20,3,3,2,8,0xb2d23f05
21007.28,2.0,25,2,3,2,7,0xb2d94199
94484.67,1.0,1,3,2,4,9,0xb2d52905d
371024.17,10.0,0,4,4,4,12,0xb2d1b00f
20739.7,1.0,214,2,2,1,5,0xb2d3cc3dd
1145332.55,6.0,18,4,4,2,10,0xb2d656aa
19.16,1.0,81,1,2,1,4,0xb2d15975
407.0,1.0,35,1,2,2,5,0xb2d1dd60
2684.96,1.0,8,1,2,3,6,0xb2d3ed2fd
37.44,1.0,2,1,2,4,7,0xb2d965f9
81.12,1.0,13,1,2,3,6,0xb2d67e8fd
5874.1,1.0,291,2,2,1,5,0xb2d16cc7d
245.94,1.0,18,1,2,2,5,0xb2d929c0d
1641.55,1.0,0,1,2,4,7,0xb2d964d2
1828.92,1.0,92,1,2,1,4,0xb2d06a18
1007042.27,2.0,1,4,3,4,11,0xb2d1461b
4461.69,1.0,2,2,2,4,8,0xb2d9ddc9
230020.53,4.0,6,3,4,3,10,0xb2d2acfc
3715.89,1.0,0,2,2,4,8,0xb2d6476c
10035.95,1.0,92,2,2,1,5,0xb2d5b360d
1308145.86,14.0,6,4,4,3,11,0xb2d69a32
930022.02,7.0,11,4,4,3,11,0xb2d623dfd
50000.33,2.0,32,2,3,2,7,0xb2d28d1d
84.93,1.0,10,1,2,3,6,0xb2d1f34b
800307.57,4.0,18,4,4,2,10,0xb2d62823d
5261.46,1.0,19,2,2,2,6,0xb2d9e0f8
556543.1,2.0,10,4,3,3,10,0xb2d56b26d
688003.14,18.0,0,4,4,4,12,0x3b9ae511
153.64,1.0,9,1,2,3,6,0xb2d29278
3115.78,1.0,3,2,2,4,8,0xb2d8d533
11920.99,1.0,0,2,2,4,8,0xb2da28f0
3.11,1.0,23,1,2,2,5,0xb2d290e4
3700.61,1.0,7,2,2,3,7,0xb2d9cfb0
30000.32,2.0,25,2,3,2,7,0xb2da1604
1247130.45,7.0,7,4,4,3,11,0xb2d122c0
520022.14,7.0,11,4,4,3,11,0xb2d63ade
403000.0,4.0,0,4,4,4,12,0xb2d64358d
5049.91,1.0,184,2,2,1,5,0xb2d0fffc
42097.68,1.0,3,2,2,4,8,0xb2d33fcd
379.56,1.0,14,1,2,3,6,0xb2d2b730
226846.88,1.0,184,3,2,1,6,0xb2d61264d
136245.42,1.0,0,3,2,4,9,0xb2d6c2abd
807067.49,9.0,21,4,4,2,10,0xb2d41547d
500028.46,4.0,3,4,4,4,12,0xb2d10f5e
15464.38,1.0,0,2,2,4,8,0xb2d972d5
190510.23,4.0,6,3,4,3,10,0xb2d2c788
769043.86,9.0,0,4,4,4,12,0xb2d145ac
165.56,1.0,0,1,2,4,7,0xb2d7edff
500071.96,3.0,3,4,4,4,12,0xb2d9fc2a
39964.6,1.0,3,2,2,4,8,0xb2d40915
0.0,1.0,92,1,2,1,4,0xb2d2d92bd
510635.26,2.0,101,4,3,1,8,0xb2d675a4d
115527.39,3.0,63,3,4,2,9,0xb2d14598d
14999.25,1.0,6,2,2,3,7,0xb2d6f396
1188000.0,7.0,3,4,4,4,12,0xb2d07ecf
4866.04,1.0,18,2,2,2,6,0xb2d69751
38262.4,1.0,6,2,2,3,7,0xb2d2c579d
480015.27,2.0,4,4,3,4,11,0xb2d6b007
52924.43,2.0,202,3,3,1,7,0xb2d1b8cad
2.19,1.0,11,1,2,3,6,0xb2d6869d
6888.42,1.0,0,2,2,4,8,0xb2d2ef4dd
0.15,1.0,3,1,2,4,7,0xb2d1f332
200029.65,2.0,4,3,3,4,10,0xb2d6af56d
420046.41,4.0,4,4,4,4,12,0xb2d3bf3fd
1088.04,1.0,92,1,2,1,4,0x3b9adedfd
268.59,1.0,46,1,2,2,5,0xb2d564bb
1015.85,1.0,184,1,2,1,4,0xb2d12b05
640000.1,13.0,0,4,4,4,12,0xb2d6a26e
1244.29,1.0,184,1,2,1,4,0xb2d2facfd
36.25,1.0,11,1,2,3,6,0xb2d8d4de
155333.02,1.0,7,3,2,3,8,0xb2d62581d
722696.09,3.0,3,4,4,4,12,0xb2d53b3f
227727.25,2.0,87,3,3,1,7,0xb2d59033d
2750.54,1.0,5,1,2,3,6,0xb2d8d2eb
502150.68,2.0,0,4,3,4,11,0xb2d61956
5016.01,1.0,184,2,2,1,5,0xb2d67fbfd
542.19,1.0,74,1,2,1,4,0xb2d1037c
72848.58,2.0,95,3,3,1,7,0xb2d43cc6d
8096.7,2.0,92,2,3,1,6,0x3b9ad3b4d
380016.29,7.0,55,4,4,2,10,0xb2d6844dd
7649.93,1.0,0,2,2,4,8,0xb2d37194
1006417.27,4.0,132,4,4,1,9,0xb2d5211e
300715.35,4.0,30,4,4,2,10,0xb2d8f894d
100947.26,2.0,28,3,3,2,8,0xb2d6f101
4361.7,1.0,125,2,2,1,5,0xb2d3c4d3
9.39,1.0,81,1,2,1,4,0xb2d96bdb
15260.15,1.0,11,2,2,3,7,0xb2d3edd7
200063.96,2.0,13,3,3,3,9,0xb2d7ed85
23021.75,1.0,194,2,2,1,5,0xb2d54baa
654003.39,5.0,14,4,4,3,11,0xb2d2576d
500118.25,2.0,94,4,3,1,8,0xb2d22882
110.63,1.0,7,1,2,3,6,0xb2d8c810
30000.95,3.0,48,2,4,2,8,0xb2d9d473
3920.38,1.0,0,2,2,4,8,0xb2d38dd2d
42167.7,1.0,6,2,2,3,7,0xb2d27ddcd
1433.34,1.0,0,1,2,4,7,0xb2d276e4
190001.67,4.0,4,3,4,4,11,0xb2d9fce1
4976.08,1.0,27,2,2,2,6,0xb2d9c7a0
188435.18,3.0,20,3,4,2,9,0xb2d31f82
5490.75,1.0,42,2,2,2,6,0xb2d40619d
85283.85,2.0,11,3,3,3,9,0xb2d6117b
255270.87,3.0,18,3,4,2,9,0xb2d193ae
60000.0,4.0,0,3,4,4,11,0xb2d60921d
1030135.63,3.0,47,4,4,2,10,0xb2d7e3aad
10325.33,2.0,0,2,3,4,9,0xb2d5ebd5
50004.69,2.0,28,2,3,2,7,0xb2d4f1d9
292161.53,5.0,6,3,4,3,10,0xb2d35a44
2308.4,1.0,197,1,2,1,4,0xb2d6ba30d
325187.05,2.0,13,4,3,3,10,0xb2d50903d
197.21,1.0,27,1,2,2,5,0xb2d50a43
40467.78,2.0,111,2,3,1,6,0xb2d630b3
3.41,2.0,0,1,3,4,8,0xb2d0bd26d
551846.59,5.0,22,4,4,2,10,0xb2d57a06d
31449.51,1.0,3,2,2,4,8,0xb2d2b2ef
34560.42,1.0,111,2,2,1,5,0xb2d4543dd
262001.07,3.0,16,3,4,2,9,0xb2d91a3b
1815.12,1.0,211,1,2,1,4,0xb2d3700dd
2089.31,1.0,9,1,2,3,6,0xb2d4c808
4352.45,1.0,184,2,2,1,5,0xb2d3af50d
531101.78,3.0,27,4,4,2,10,0xb2d9c6b9
2290082.91,7.0,13,4,4,3,11,0xb2d1b42cd
20000.42,2.0,11,2,3,3,8,0xb2da4221
52647.39,2.0,70,3,3,1,7,0xb2d4fc34d
300000.0,2.0,89,3,3,1,7,0xb2d8c80d
53005.15,2.0,7,3,3,3,9,0xb2d4d92fd
10000.21,2.0,11,2,3,3,8,0xb2da3fbb
80006.8,3.0,31,3,4,2,9,0xb2d86f51d
2267.98,1.0,92,1,2,1,4,0xb2d3a3e8d
1090010.7,3.0,19,4,4,2,10,0xb2d78eeed
1.0,2.0,92,1,3,1,5,0xb2d1a89ed
1030107.42,6.0,24,4,4,2,10,0xb2d3a57dd
1527.35,1.0,184,1,2,1,4,0xb2d0f08ed
500005.28,2.0,31,4,3,2,9,0xb2d939a3
100528.29,3.0,181,3,4,1,8,0xb2d5e674
1460.59,1.0,216,1,2,1,4,0xb2d17543d
203503.72,5.0,3,3,4,4,11,0xb2d0c5ba
6223.53,1.0,8,2,2,3,7,0xb2d9f3da
30001.04,2.0,70,2,3,1,6,0xb2d9a59b
3316.47,1.0,19,2,2,2,6,0xb2d2fe68
1000120.11,4.0,3,4,4,4,12,0xb2d7fe42d
311483.67,4.0,19,4,4,2,10,0x3b9b3c72d
141122.51,3.0,47,3,4,2,9,0xb2d598f7d
65058.83,1.0,184,3,2,1,6,0xb2d1bb9e
310104.27,2.0,92,4,3,1,8,0xb2d433cad
1010711.54,2.0,32,4,3,2,9,0xb2d776ec
990165.38,5.0,22,4,4,2,10,0xb2d14c58d
279798.02,7.0,6,3,4,3,10,0xb2d0a9d9d
6235.75,1.0,171,2,2,1,5,0xb2d1a03dd
51206.43,3.0,92,2,4,1,7,0xb2d5f1ec
328900.81,2.0,47,4,3,2,9,0xb2d2882bd
6551.78,1.0,6,2,2,3,7,0xb2d6a70d
10175.69,3.0,107,2,4,1,7,0xb2d0a205
62543.83,2.0,0,3,3,4,10,0xb2d25be7d
2194.03,1.0,0,1,2,4,7,0xb2d423ba
23612.67,1.0,92,2,2,1,5,0xb2d30f64d
73.09,1.0,6,1,2,3,6,0xb2d6aed8
0.33,1.0,6,1,2,3,6,0xb2d91d35
1542076.18,6.0,76,4,4,1,9,0xb2d3cd34d
9355.62,1.0,5,2,2,3,7,0xb2d315a7
4644.06,1.0,0,2,2,4,8,0xb2d3f3ae
500007.59,6.0,3,4,4,4,12,0xb2d651e2
1351.52,1.0,23,1,2,2,5,0xb2d69b89
713069.83,2.0,39,4,3,2,9,0xb2d1cc54d
33187.4,1.0,0,2,2,4,8,0xb2d55302
803079.68,5.0,0,4,4,4,12,0xb2d0f163
82000.96,9.0,31,3,4,2,9,0xb2d60198
400073.51,2.0,20,4,3,2,9,0xb2d0d99a
132125.17,2.0,118,3,3,1,7,0xb2d390cd
5023.69,1.0,92,2,2,1,5,0xb2d482d4
150004.22,4.0,34,3,4,2,9,0xb2d8ecafd
202132.19,2.0,112,3,3,1,7,0xb2d39b3c
240.91,3.0,53,1,4,2,7,0xb2d30c68
65.92,1.0,2,1,2,4,7,0xb2d7073fd
535650.09,2.0,109,4,3,1,8,0xb2d95c7e
14898.03,1.0,17,2,2,2,6,0xb2d78d7dd
350000.0,2.0,58,4,3,2,9,0xb2d902fb
20004.86,2.0,53,2,3,2,7,0xb2d2b047
672007.41,2.0,21,4,3,2,9,0xb2d13929
302243.07,5.0,0,4,4,4,12,0xb2d17738d
10851.18,1.0,10,2,2,3,7,0xb2d99db4
160001.69,5.0,47,3,4,2,9,0xb2d90462
1289.99,1.0,92,1,2,1,4,0xb2d0da65
4398.88,1.0,92,2,2,1,5,0xb2d4cd7c
208236.29,2.0,6,3,3,3,9,0xb2d5af4cd
117248.02,4.0,0,3,4,4,11,0xb2d2ed61
40000.3,2.0,4,2,3,4,9,0xb2d40bc8d
502276.24,2.0,24,4,3,2,9,0xb2d44318
990479.15,4.0,1,4,4,4,12,0xb2d5f9c0
50402.37,1.0,5,2,2,3,7,0xb2d921e9
142314.3,1.0,1,3,2,4,9,0xb2d45eddd
220000.0,2.0,33,3,3,2,8,0xb2d92ffb
150063.76,3.0,79,3,4,1,8,0xb2d570c4
512.8,1.0,42,1,2,2,5,0xb2d3aa8b
210236.17,5.0,24,3,4,2,9,0xb2d366b1d
760775.57,4.0,25,4,4,2,10,0xb2d574bbd
398.13,1.0,18,1,2,2,5,0xb2d3a90dd
6743.78,1.0,20,2,2,2,6,0xb2d30445d
160005.07,2.0,31,3,3,2,8,0xb2d93571
245084.91,4.0,0,3,4,4,11,0xb2d5ede8
816.66,1.0,0,1,2,4,7,0xb2d59e5a
500000.0,2.0,12,4,3,3,10,0xb2d9ebf9
102.08,1.0,8,1,2,3,6,0xb2d25a91
34644.5,1.0,21,2,2,2,6,0xb2d60a7e
60041.46,2.0,90,3,3,1,7,0xb2d5f56a
80003.38,2.0,92,3,3,1,7,0xb2d62e2e
402609.52,3.0,5,4,4,3,11,0xb2d94517
14466.74,1.0,62,2,2,2,6,0xb2d366a2d
502964.55,5.0,43,4,4,2,10,0xb2d30f0d
19971.05,1.0,110,2,2,1,5,0xb2d376cfd
1027.73,1.0,92,1,2,1,4,0x3b9b3200
102.66,1.0,14,1,2,3,6,0xb2d8d2b7
351574.98,6.0,0,4,4,4,12,0xb2d068c2d
2777.91,1.0,0,1,2,4,7,0xb2d43fb5d
31810.11,1.0,2,2,2,4,8,0xb2d6bcda
69.11,1.0,35,1,2,2,5,0xb2d5dd9f
24758.52,1.0,2,2,2,4,8,0xb2d2337e
80053.35,2.0,0,3,3,4,10,0xb2d5effbd
102140.81,2.0,4,3,3,4,10,0xb2d5d48ed
1415.9,1.0,0,1,2,4,7,0xb2d1291a
6558.29,1.0,0,2,2,4,8,0xb2d51b6b
32700.91,1.0,3,2,2,4,8,0xb2d2b7bf
150013.39,2.0,17,3,3,2,8,0xb2d6938ed
448.16,1.0,20,1,2,2,5,0xb2d42a28
916.44,1.0,4,1,2,4,7,0xb2d69a42
230161.31,1.0,117,3,2,1,6,0xb2d6e29ed
54.89,1.0,90,1,2,1,4,0xb2d89ef6
86213.46,2.0,0,3,3,4,10,0xb2d1c805d
393121.02,2.0,31,4,3,2,9,0xb2d18573d
167425.27,2.0,80,3,3,1,7,0xb2d6029b
8509.39,1.0,86,2,2,1,5,0xb2d42e85
11.39,1.0,19,1,2,2,5,0xb2d1612e
2672607.6,8.0,56,4,4,2,10,0xb2d6e4bb
2545.19,1.0,92,1,2,1,4,0xb2d54012d
572426.06,6.0,7,4,4,3,11,0xb2d198c1d
140028.53,3.0,8,3,4,3,10,0xb2d589c0d
230009.27,6.0,39,3,4,2,9,0xb2d2ac2bd
67.05,1.0,51,1,2,2,5,0xb2d6a2c6
976573.15,14.0,1,4,4,4,12,0xb2d20aabd
100181.83,2.0,259,3,3,1,7,0xb2d1dd55
500009.61,3.0,22,4,4,2,10,0xb2d44a0dd
102918.84,7.0,0,3,4,4,11,0xb2d1a542
914033.7,9.0,8,4,4,3,11,0xb2d6d2df
1490132.05,4.0,98,4,4,1,9,0xb2d41256
16.66,1.0,9,1,2,3,6,0xb2d51a48
301702.78,2.0,30,4,3,2,9,0xb2d71871
90612.5,5.0,53,3,4,2,9,0xb2d55e1fd
400008.44,2.0,95,4,3,1,8,0xb2d97643d
300090.68,3.0,20,3,4,2,9,0xb2d910dfd
703704.49,13.0,1,4,4,4,12,0xb2d5a9ba
7836.62,1.0,15,2,2,3,7,0xb2d5d4bcd
1400000.58,5.0,5,4,4,3,11,0xb2d4e8fc
10366.44,1.0,40,2,2,2,6,0xb2d5ea08d
1825.41,1.0,1,1,2,4,7,0xb2d790dc
8801.01,1.0,0,2,2,4,8,0xb2d901f4
450000.56,4.0,10,4,4,3,11,0xb2d6f04ad
522080.15,3.0,184,4,4,1,9,0xb2d12a3cd
1.64,1.0,5,1,2,3,6,0xb2d945c0
10001.94,2.0,107,2,3,1,6,0xb2d9148ad
42352.33,2.0,6,2,3,3,8,0xb2d19ec4d
47.94,1.0,19,1,2,2,5,0xb2d5aacf
89905.86,2.0,0,3,3,4,10,0xb2d601d6
705.93,1.0,6,1,2,3,6,0xb2d34f46
611545.47,13.0,0,4,4,4,12,0xb2d62b95
90020.06,2.0,52,3,3,2,8,0xb2d16890d
2594.12,1.0,92,1,2,1,4,0xb2d4c841
82.97,1.0,10,1,2,3,6,0xb2d4f7fdd
371121.88,3.0,30,4,4,2,10,0xb2d65ea3d
250001.16,3.0,3,3,4,4,11,0xb2d8d788
2957.14,1.0,6,2,2,3,7,0xb2d7471dd
329105.25,2.0,58,4,3,2,9,0xb2d6b62a
11187.62,1.0,15,2,2,3,7,0xb2d996d0
194.55,1.0,10,1,2,3,6,0xb2d3aecbd
3.66,1.0,7,1,2,3,6,0xb2d34c93
304001.55,8.0,3,4,4,4,12,0xb2d6570c
100176.55,3.0,5,3,4,3,10,0x3b9aced9d
573036.67,5.0,0,4,4,4,12,0xb2d183d7d
301065.81,2.0,56,4,3,2,9,0xb2d99304
13.18,2.0,3,1,3,4,8,0xb2d07d61
13483.29,1.0,126,2,2,1,5,0xb2d632e2
100001.06,2.0,62,3,3,2,8,0xb2d8f497
3700000.0,2.0,92,4,3,1,8,0xb2d959f8d
457319.95,8.0,0,4,4,4,12,0xb2d0a745
176.19,1.0,9,1,2,3,6,0xb2d76d30
937.83,1.0,45,1,2,2,5,0xb2d5b1a5
244013.96,15.0,11,3,4,3,10,0xb2d573b2
10034.91,1.0,37,2,2,2,6,0xb2d37036
90180.2,2.0,102,3,3,1,7,0xb2d13f7ed
750008.72,4.0,1,4,4,4,12,0xb2d9554d
82.97,1.0,49,1,2,2,5,0xb2d8f724
450000.0,2.0,1,4,3,4,11,0xb2d62537d
20002.79,2.0,33,2,3,2,7,0xb2d58735d
10322.62,2.0,103,2,3,1,6,0xb2d5e67e
3496.15,1.0,4,2,2,4,8,0xb2d8f31f
1405770.75,3.0,24,4,4,2,10,0xb2d31cfed
69000.94,4.0,31,3,4,2,9,0xb2d6e76a
358882.89,1.0,0,4,2,4,10,0xb2d5e189
1715.62,1.0,10,1,2,3,6,0xb2d41ed7
1008.79,1.0,184,1,2,1,4,0xb2d3471ad
200041.41,4.0,28,3,4,2,9,0xb2d5b28b
51834.52,2.0,3,2,3,4,9,0xb2d5ce80
1093.05,1.0,184,1,2,1,4,0xb2d36890
103126.41,1.0,184,3,2,1,6,0xb2d165fc
210002.85,2.0,98,3,3,1,7,0xb2d639dd
100100.0,2.0,1,3,3,4,10,0xb2da5cd2
336074.61,5.0,39,4,4,2,10,0xb2d58177
8.75,3.0,7,1,4,3,8,0xb2d8f260
383739.99,4.0,10,4,4,3,11,0x3b9b0e44
200868.47,1.0,18,3,2,2,7,0xb2d78482
211660.79,7.0,1,3,4,4,11,0xb2d1e00b
5293.68,1.0,2,2,2,4,8,0xb2d3ce33d
50011.56,2.0,129,2,3,1,6,0xb2d55cf2d
51656.74,2.0,130,2,3,1,6,0xb2d5d505d
7011.87,3.0,1,2,4,4,10,0x3b9b1947d
0.0,1.0,3,1,2,4,7,0xb2d34cdb
121694.54,9.0,0,3,4,4,11,0x3b9ae8c2
4.29,1.0,7,1,2,3,6,0xb2d26a60
11917.16,1.0,0,2,2,4,8,0xb2d6b857
500343.51,5.0,22,4,4,2,10,0xb2d63248d
315285.14,4.0,55,4,4,2,10,0xb2d3a3f4
15001236.2,4.0,27,4,4,2,10,0xb2d9ffa7
272000.0,4.0,0,3,4,4,11,0xb2da31de
557476.53,4.0,206,4,4,1,9,0xb2d3b96a
878031.32,6.0,56,4,4,2,10,0xb2d240c2
1067.14,1.0,0,1,2,4,7,0xb2d6485f
402932.17,3.0,13,4,4,3,11,0xb2d59516d
75.33,1.0,13,1,2,3,6,0xb2d0f2d3
2197727.81,13.0,3,4,4,4,12,0xb2d0b7f1d
1534.57,1.0,9,1,2,3,6,0xb2d587f2d
10316.42,1.0,189,2,2,1,5,0xb2d5d81bd
63004.69,5.0,47,3,4,2,9,0xb2d823b4
105147.07,1.0,57,3,2,2,7,0xb2d2f6ee
17187.7,1.0,0,2,2,4,8,0xb2d6cf0fd
862596.13,9.0,8,4,4,3,11,0xb2d50147
128387.59,3.0,14,3,4,3,10,0xb2d27be2
11975.07,1.0,10,2,2,3,7,0xb2d4282bd
403309.13,3.0,0,4,4,4,12,0xb2d5d212
454387.2,2.0,206,4,3,1,8,0xb2d27294
30480.42,3.0,4,2,4,4,10,0xb2d90c52
240946.86,2.0,104,3,3,1,7,0xb2d1273dd
0.05,1.0,0,1,2,4,7,0xb2d57b81
66069.91,3.0,21,3,4,2,9,0xb2d0740e
251.26,1.0,3,1,2,4,7,0xb2d6da8cd
51230.12,2.0,125,2,3,1,6,0xb2d3d2fed
120411.02,3.0,92,3,4,1,8,0xb2d08e29
150013.0,4.0,19,3,4,2,9,0xb2d5d3e6
20016.09,3.0,182,2,4,1,7,0xb2d88c51
3438.36,1.0,10,2,2,3,7,0xb2d5ccaa
820.72,1.0,4,1,2,4,7,0xb2d2c22e
4859.68,3.0,0,2,4,4,10,0xb2d2766d
1092555.84,5.0,10,4,4,3,11,0xb2d94e4e
50010.09,2.0,82,2,3,1,6,0xb2d40f60
50001.58,2.0,74,2,3,1,6,0xb2d9994f
435484.29,3.0,39,4,4,2,10,0xb2d6baabd
24046.01,5.0,37,2,4,2,8,0x3b9adb4d
709797.67,3.0,4,4,4,4,12,0xb2d4371a
2325.11,2.0,10,1,3,3,7,0xb2d3f423
3.59,1.0,33,1,2,2,5,0xb2d9d363
120446.68,2.0,55,3,3,2,8,0xb2d2850d
30001.58,2.0,20,2,3,2,7,0xb2da1a9a
35808.27,1.0,4,2,2,4,8,0xb2d601b3
244006.07,3.0,39,3,4,2,9,0xb2d36c64d
150074.22,1.0,0,3,2,4,9,0xb2d9a7c8
1867.33,3.0,13,1,4,3,8,0xb2d15279
2010103.09,2.0,0,4,3,4,11,0xb2d3d3b4
80261.95,1.0,0,3,2,4,9,0xb2d6e322
371454.34,3.0,0,4,4,4,12,0xb2d0d2b8
621012.76,7.0,70,4,4,1,9,0xb2d0796a
51456.55,2.0,3,2,3,4,9,0xb2d5ff77d
500000.0,2.0,10,4,3,3,10,0xb2d9691dd
627120.85,6.0,3,4,4,4,12,0xb2d81e6ed
3272973.24,9.0,0,4,4,4,12,0xb2d5dbed
20000.21,2.0,21,2,3,2,7,0xb2da21d9
1151063.28,1.0,0,4,2,4,10,0xb2d3feb0
7.2,1.0,32,1,2,2,5,0xb2d42a78
1912.56,1.0,56,1,2,2,5,0xb2d63ac1d
2920.71,1.0,181,2,2,1,5,0xb2d634bd
2214.99,1.0,14,1,2,3,6,0xb2d6a4ca
325333.2,6.0,77,4,4,1,9,0xb2d1c59e
1137676.07,5.0,0,4,4,4,12,0xb2d1d664
1100.15,1.0,92,1,2,1,4,0xb2d245b0
462156.55,3.0,21,4,4,2,10,0xb2d6d896
450710.79,3.0,21,4,4,2,10,0xb2d6eb00
200786.85,2.0,97,3,3,1,7,0xb2d0dc42d
1069.9,1.0,10,1,2,3,6,0xb2d7f3f4
660000.0,5.0,6,4,4,3,11,0xb2d1c43e
7137.38,1.0,15,2,2,3,7,0xb2da04df
457793.78,4.0,14,4,4,3,11,0xb2d649f1
27.64,1.0,0,1,2,4,7,0xb2d23e6cd
309802.2,2.0,105,4,3,1,8,0xb2d61e63d
2287.96,1.0,0,1,2,4,7,0xb2d621c6d
45.13,1.0,34,1,2,2,5,0xb2d1e5b4
16075.72,1.0,3,2,2,4,8,0xb2d3b935
200007.39,2.0,80,3,3,1,7,0xb2d8d2ce
850999.15,5.0,27,4,4,2,10,0xb2d5d3c3d
3814.6,1.0,0,2,2,4,8,0xb2d7aea4d
629846.18,5.0,24,4,4,2,10,0xb2d5c46fd
11.84,1.0,39,1,2,2,5,0xb2d98991
344445.33,3.0,1,4,4,4,12,0xb2d58b34d
57.61,1.0,10,1,2,3,6,0xb2d33a4a
106027.28,1.0,10,3,2,3,8,0xb2d3a51e
488720.53,8.0,3,4,4,4,12,0xb2d436c9d
84000.0,5.0,8,3,4,3,10,0xb2d56441
277526.23,3.0,96,3,4,1,8,0x3b9ad016
1280000.0,2.0,3,4,3,4,11,0xb2d97930d
5238.24,3.0,10,2,4,3,9,0xb2d1a20fd
100001.29,3.0,25,3,4,2,9,0xb2d411f9d
20292.93,1.0,12,2,2,3,7,0xb2d8fac6
39.0,1.0,5,1,2,3,6,0xb2d2ed13
1060.89,1.0,0,1,2,4,7,0xb2d791b3
1250002.11,3.0,0,4,4,4,12,0xb2da2020
2101.38,1.0,9,1,2,3,6,0xb2d54fbd
3086.61,1.0,9,2,2,3,7,0xb2d13f6fd
1505.44,1.0,138,1,2,1,4,0xb2d5692fd
1874.01,1.0,92,1,2,1,4,0xb2d3a27cd
10089.02,1.0,153,2,2,1,5,0xb2d0cd79d
177967.25,2.0,92,3,3,1,7,0xb2d1bc32
1212.97,1.0,2,1,2,4,7,0xb2d22b98
251616.1,7.0,25,3,4,2,9,0xb2d60626
645046.0,15.0,1,4,4,4,12,0xb2d4f515d
497033.94,4.0,8,4,4,3,11,0xb2d2d003d
424627.72,4.0,4,4,4,4,12,0xb2d11816
501000.0,1.0,3,4,2,4,10,0xb2d97937d
201752.18,3.0,1,3,4,4,11,0xb2d86f83
46597.12,1.0,7,2,2,3,7,0xb2d6bdbe
1121.99,1.0,5,1,2,3,6,0xb2d34e26
123316.83,2.0,63,3,3,2,8,0xb2d5d103d
12.3,1.0,4,1,2,4,7,0xb2d8d91e
1226.0,1.0,184,1,2,1,4,0xb2d0e2a1d
3809.81,1.0,195,2,2,1,5,0xb2d61f6e
500011.32,3.0,92,4,4,1,9,0xb2d6373dd
5080.35,1.0,184,2,2,1,5,0xb2d10199
6694.42,1.0,137,2,2,1,5,0xb2d5b965
6696.78,2.0,184,2,3,1,6,0xb2d17c65
1433.2,1.0,10,1,2,3,6,0xb2d7882ad
30006.13,2.0,20,2,3,2,7,0xb2d3ac67d
2.11,1.0,4,1,2,4,7,0xb2d0d719
580000.09,2.0,13,4,3,3,10,0x3b9b31d1
70005.7,2.0,53,3,3,2,8,0xb2d9bdb3
987.36,2.0,15,1,3,3,7,0xb2d16c2ed
130525.09,3.0,62,3,4,2,9,0xb2d46e49
247209.05,1.0,16,3,2,2,7,0xb2d2a1f1
40023.04,19.0,0,2,4,4,10,0x3b9b3ba4
2839.56,1.0,8,1,2,3,6,0xb2d3793a
4833.17,1.0,2,2,2,4,8,0xb2d129ad
321869.66,5.0,32,4,4,2,10,0xb2d13bc8
0.0,1.0,8,1,2,3,6,0xb2d3b478d
151002.41,2.0,139,3,3,1,7,0xb2d2b657
50172.46,2.0,62,2,3,2,7,0xb2d6f8add
244324.89,12.0,1,3,4,4,11,0xb2d2b158d
282341.0,2.0,35,3,3,2,8,0xb2d10802d
20002.96,1.0,1,2,2,4,8,0xb2d9c2a4
573.26,1.0,0,1,2,4,7,0xb2d43931d
366141.0,4.0,41,4,4,2,10,0xb2d2eac0
1623577.23,11.0,1,4,4,4,12,0xb2d5988a
105009.81,2.0,6,3,3,3,9,0xb2d5f845d
47134.84,1.0,4,2,2,4,8,0xb2d1e944d
1057.13,1.0,2,1,2,4,7,0xb2d6dc2b
604.8,1.0,0,1,2,4,7,0xb2d2b5ac
236596.97,9.0,0,3,4,4,11,0xb2d210bb
50626.01,1.0,95,2,2,1,5,0xb2d61cd1
725420.94,5.0,122,4,4,1,9,0xb2d0dbc4d
0.82,1.0,1,1,2,4,7,0xb2d4329a
545000.0,2.0,23,4,3,2,9,0xb2d2812ad
2100000.0,1.0,1,4,2,4,10,0xb2da62ac
284.8,1.0,4,1,2,4,7,0xb2d5655b
53002.24,2.0,83,3,3,1,7,0xb2d2aaa6
1008.17,1.0,9,1,2,3,6,0xb2d57e81
39377.16,1.0,118,2,2,1,5,0xb2d37c30d
12850.66,1.0,32,2,2,2,6,0xb2d43a83
810366.91,4.0,26,4,4,2,10,0xb2d6276d
50123.66,2.0,13,2,3,3,8,0xb2d5aa70
115455.36,1.0,0,3,2,4,9,0xb2d3e2c1d
5122.27,1.0,1,2,2,4,8,0xb2d65002
12.07,4.0,66,1,4,2,7,0xb2d20761
478433.29,4.0,87,4,4,1,9,0xb2d400cbd
3700.74,1.0,22,2,2,2,6,0xb2d30bc5
10056968.0,2.0,31,4,3,2,9,0xb2d68dd0d
1372.59,1.0,183,1,2,1,4,0xb2d6a5d7d
115295.81,4.0,39,3,4,2,9,0xb2d13217d
100081.22,2.0,83,3,3,1,7,0xb2d3b1c8
5832358.84,2.0,28,4,3,2,9,0xb2d4cc4c
107970.51,1.0,300,3,2,1,6,0xb2d201b2
143002.54,8.0,3,3,4,4,11,0xb2d208f0d
10026.62,1.0,35,2,2,2,6,0xb2d69274d
202212.46,2.0,92,3,3,1,7,0xb2d0e923
10581.2,1.0,0,2,2,4,8,0xb2d6aa69
165639.19,3.0,53,3,4,2,9,0xb2d062f1d
3778.3,1.0,197,2,2,1,5,0xb2d20597
100008.89,2.0,0,3,3,4,10,0xb2d64532d
200010.91,2.0,14,3,3,3,9,0xb2d98acf
244006.52,11.0,34,3,4,2,9,0xb2d575f9d
50544.88,2.0,128,2,3,1,6,0xb2d6d0ce
463.21,2.0,23,1,3,2,6,0xb2d0b922d
20129.17,1.0,10,2,2,3,7,0xb2d4305f
26289.61,1.0,20,2,2,2,6,0xb2d1e7f5
334710.08,3.0,108,4,4,1,9,0xb2d11900d
1000.22,1.0,1,1,2,4,7,0xb2d53041
500972.59,3.0,4,4,4,4,12,0xb2d5aaa1
5010.39,1.0,70,2,2,1,5,0xb2d6c6e2d
170048.84,3.0,32,3,4,2,9,0xb2d5358ed
7007.28,1.0,18,2,2,2,6,0xb2d6d4ea
284.11,1.0,49,1,2,2,5,0xb2d14727
30000.84,4.0,13,2,4,3,9,0xb2d5ec69
1050.55,2.0,184,1,3,1,5,0xb2d25afc
7945.81,1.0,9,2,2,3,7,0xb2d91068d
23.22,1.0,60,1,2,2,5,0xb2d8fce1d
25042.84,2.0,52,2,3,2,7,0xb2d6d0f6d
2012197.87,17.0,1,4,4,4,12,0xb2d0cdf3
1054.06,1.0,92,1,2,1,4,0x3b9b0e0a
39738.56,8.0,3,2,4,4,10,0x3b9b1a3ad
503553.05,2.0,68,4,3,1,8,0xb2d5b753
105025.97,2.0,77,3,3,1,7,0xb2d65e74d
250043.49,5.0,182,3,4,1,8,0xb2d2f349d
500000.0,2.0,0,4,3,4,11,0xb2da6a9f
4003.38,1.0,1,2,2,4,8,0xb2d6bcbfd
1242.37,1.0,66,1,2,2,5,0xb2d262b3d
607560.36,3.0,87,4,4,1,9,0xb2d5e852d
809670.6,3.0,32,4,4,2,10,0xb2d6a90e
202131.98,2.0,103,3,3,1,7,0xb2d969a7d
2408.8,1.0,2,1,2,4,7,0xb2d92914
0.68,1.0,184,1,2,1,4,0xb2d283a6
270687.76,8.0,3,3,4,4,11,0xb2d40cd4d
250053.64,7.0,34,3,4,2,9,0xb2d62e4d
20632.74,1.0,0,2,2,4,8,0xb2d8c532d
10001.09,2.0,199,2,3,1,6,0xb2d5cdde
502440.89,4.0,21,4,4,2,10,0xb2d5631ad
36477.68,1.0,3,2,2,4,8,0xb2d2b601
130763.96,4.0,83,3,4,1,8,0xb2d1766d
22037.83,1.0,0,2,2,4,8,0xb2d3ef21d
104522.72,2.0,27,3,3,2,8,0xb2d5705ed
1481.59,1.0,5,1,2,3,6,0xb2d289ae
34552.22,1.0,7,2,2,3,7,0xb2d4b920d
50248.68,2.0,3,2,3,4,9,0xb2d44dc5
21.73,2.0,50,1,3,2,6,0xb2d465c9d
2709.2,1.0,0,1,2,4,7,0xb2d172b2d
177.32,1.0,10,1,2,3,6,0xb2d5312a
102527.66,2.0,34,3,3,2,8,0xb2d32b05d
1610513.88,4.0,11,4,4,3,11,0xb2d6e9f6d
500010.98,3.0,31,4,4,2,10,0xb2d18306d
3392.11,1.0,16,2,2,2,6,0xb2d621fd
1232.18,1.0,92,1,2,1,4,0xb2d3085cd
6561.54,1.0,25,2,2,2,6,0xb2d6af58d
133074.14,3.0,34,3,4,2,9,0xb2d48427d
3671.97,1.0,1,2,2,4,8,0xb2d754b9
450905.33,4.0,25,4,4,2,10,0xb2d1fc39d
475501.67,3.0,14,4,4,3,11,0xb2d11f7ed
3878.01,1.0,245,2,2,1,5,0xb2d22313
307634.63,2.0,141,4,3,1,8,0xb2d54ed5
100462.37,1.0,4,3,2,4,9,0xb2d62795d
182638.33,2.0,21,3,3,2,8,0xb2d6be03
12588.53,1.0,184,2,2,1,5,0xb2d2883ed
100014.36,2.0,12,3,3,3,9,0xb2d6d1a0
100016.49,2.0,158,3,3,1,7,0xb2d26122
2.07,1.0,45,1,2,2,5,0xb2d90b7a
4764.87,1.0,10,2,2,3,7,0xb2d302fa
640005.16,10.0,0,4,4,4,12,0xb2d15439
1000.95,1.0,99,1,2,1,4,0xb2d74743d
212.76,1.0,231,1,2,1,4,0xb2d5e0aa
232529.98,1.0,8,3,2,3,8,0xb2d9a185
540040.97,11.0,1,4,4,4,12,0xb2d5f86fd
300054.54,2.0,92,3,3,1,7,0xb2d1542dd
1097.9,1.0,92,1,2,1,4,0xb2d2f5e5d
400222.0,1.0,3,4,2,4,10,0xb2d967d6
6261.27,1.0,92,2,2,1,5,0xb2d28745
520068.38,4.0,12,4,4,3,11,0xb2d614d9d
10277.46,1.0,18,2,2,2,6,0xb2d54c15
170016.89,4.0,27,3,4,2,9,0xb2d1fdba
400486.51,4.0,113,4,4,1,9,0xb2d19b2c
63046.55,4.0,20,3,4,2,9,0xb2d210e5d
12387.58,1.0,0,2,2,4,8,0xb2d315b3d
10000.11,2.0,32,2,3,2,7,0xb2da02f0
240830.54,2.0,7,3,3,3,9,0xb2d4df56
5380.84,1.0,11,2,2,3,7,0xb2d930aa
3593.06,1.0,0,2,2,4,8,0xb2d8feeb
12140.06,3.0,9,2,4,3,9,0xb2d24ac0
360.38,1.0,4,1,2,4,7,0xb2d60778
248999.26,8.0,3,3,4,4,11,0xb2d339c9
1503.85,1.0,92,1,2,1,4,0xb2d14b41d
2419479.08,24.0,0,4,4,4,12,0x3b9b2318d
254022.29,2.0,25,3,3,2,8,0xb2d64431
24000.76,2.0,228,2,3,1,6,0xb2d6f163
101124.59,2.0,10,3,3,3,9,0xb2d78a91
0.33,1.0,74,1,2,1,4,0xb2d63cc7d
1790.7,1.0,19,1,2,2,5,0xb2d2a243
1.28,1.0,58,1,2,2,5,0xb2d9a871
805520.61,4.0,16,4,4,2,10,0xb2d1aab4d
223943.06,3.0,70,3,4,1,8,0xb2d4d08d
5990.56,1.0,8,2,2,3,7,0xb2d91a98
150.35,1.0,68,1,2,1,4,0xb2d8e38b
10000.58,2.0,38,2,3,2,7,0xb2d654b6
92.03,1.0,2,1,2,4,7,0xb2d69a76
206009.93,2.0,11,3,3,3,9,0xb2d41fc2
2414.95,1.0,32,1,2,2,5,0xb2d30164
2451.3,1.0,184,1,2,1,4,0xb2d0bf79d
162723.67,1.0,9,3,2,3,8,0xb2d7f345d
475.95,1.0,2,1,2,4,7,0xb2d8d8e3
210201.65,2.0,90,3,3,1,7,0xb2d3f448d
499062.72,7.0,1,4,4,4,12,0xb2d45867
700950.47,1.0,1,4,2,4,10,0xb2d4777cd
7969723.8,4.0,4,4,4,4,12,0xb2d10a6c
4201.06,1.0,18,2,2,2,6,0xb2d5d402
10000.43,2.0,7,2,3,3,8,0xb2d37359
4.91,1.0,1,1,2,4,7,0xb2d6c19bd
101184.5,3.0,0,3,4,4,11,0x3b9b17fdd
30008.12,2.0,67,2,3,1,6,0xb2d3b1ae
3927.55,1.0,0,2,2,4,8,0xb2d6bffcd
50933.21,2.0,111,2,3,1,6,0xb2d6afd8
734024.95,4.0,3,4,4,4,12,0xb2d3bc59d
5.11,1.0,4,1,2,4,7,0xb2d5f98f
402853.71,3.0,74,4,4,1,9,0xb2d5484d
1617.8,1.0,10,1,2,3,6,0xb2d8de0b
80549.88,3.0,83,3,4,1,8,0xb2d6ec54
1009.44,1.0,184,1,2,1,4,0xb2d30e42
610000.71,4.0,9,4,4,3,11,0xb2d0ea25
20369.26,1.0,32,2,2,2,6,0xb2d38fafd
48830.62,1.0,15,2,2,3,7,0xb2d2d915
45021.7,4.0,4,2,4,4,10,0xb2d27080d
56246.1,2.0,83,3,3,1,7,0xb2d56088d
380051.7,2.0,6,4,3,3,10,0xb2d747bcd
1090.7,2.0,217,1,3,1,5,0xb2d08ef5d
152704.07,3.0,31,3,4,2,9,0xb2d311cbd
805.4,1.0,4,1,2,4,7,0xb2d64549
4.29,1.0,25,1,2,2,5,0xb2d3a57b
150.0,1.0,0,1,2,4,7,0xb2d54f63d
1528000.0,7.0,8,4,4,3,11,0xb2d33e52d
50001.06,2.0,11,2,3,3,8,0xb2da4384
30130.42,1.0,92,2,2,1,5,0xb2d1e76cd
0.01,1.0,1,1,2,4,7,0xb2d8ff73d
208493.34,2.0,77,3,3,1,7,0xb2d3be30
48104.23,2.0,41,2,3,2,7,0xb2d08ecfd
3000000.0,2.0,3,4,3,4,11,0xb2d3f423d
161020.41,4.0,67,3,4,1,8,0xb2d1dacf
30003.37,3.0,109,2,4,1,7,0xb2d6fd84
61450.52,2.0,83,3,3,1,7,0x3b9b47f1
2999.98,1.0,40,2,2,2,6,0xb2d9297ad
330343.31,1.0,3,4,2,4,10,0xb2d78337d
24123.49,1.0,15,2,2,3,7,0xb2d6d51d
44551.73,2.0,26,2,3,2,7,0xb2d43b7a
10168.13,1.0,0,2,2,4,8,0xb2d26d23
1120067.77,8.0,4,4,4,4,12,0xb2d6e613d
20210.04,1.0,0,2,2,4,8,0xb2d189dbd
1726.3,1.0,176,1,2,1,4,0xb2d1fbfb
5050.33,1.0,0,2,2,4,8,0xb2d32cd0
5279.95,1.0,0,2,2,4,8,0xb2d6bfbbd
600013.91,5.0,8,4,4,3,11,0xb2d64aad
26.39,1.0,67,1,2,1,4,0xb2d9322f
200006.33,2.0,10,3,3,3,9,0xb2d9600a
0.0,1.0,1,1,2,4,7,0xb2d311b3
124281.99,2.0,0,3,3,4,10,0xb2d63330
33586.99,1.0,22,2,2,2,6,0xb2d5e5cb
4766.04,1.0,10,2,2,3,7,0xb2d94a31
70000.21,3.0,4,3,4,4,11,0xb2d8e43b
60035.98,2.0,52,3,3,2,8,0xb2d1a8f5
202339.51,3.0,4,3,4,4,11,0xb2d149c5
59227.69,2.0,32,3,3,2,8,0xb2d8e1abd
38.58,1.0,173,1,2,1,4,0xb2d28b13
5886.84,2.0,92,2,3,1,6,0xb2d59eec
701.85,1.0,0,1,2,4,7,0xb2d58ebb
50002.86,2.0,0,2,3,4,9,0xb2d682bb
300054.46,2.0,92,3,3,1,7,0xb2d2d347d
2.5,1.0,18,1,2,2,5,0xb2d6bb09
400104.48,2.0,92,4,3,1,8,0xb2d6475fd
6882.21,1.0,92,2,2,1,5,0xb2d36bbfd
532001.07,10.0,1,4,4,4,12,0xb2d5b11a
230063.64,2.0,6,3,3,3,9,0xb2d583b3d
510128.83,3.0,213,4,4,1,9,0xb2d24dbd
2.96,1.0,54,1,2,2,5,0xb2d907de
4220.04,2.0,184,2,3,1,6,0xb2d1fcf1
31661.73,1.0,0,2,2,4,8,0xb2d62d78d
3232.42,1.0,0,2,2,4,8,0xb2d3caf2
1120022.96,6.0,2,4,4,4,12,0xb2d5b6c9
1463.81,1.0,92,1,2,1,4,0xb2d2bc1ad
3180000.0,9.0,0,4,4,4,12,0xb2d6a872d
707.72,1.0,19,1,2,2,5,0xb2d68fe7
322054.23,4.0,24,4,4,2,10,0xb2d19313d
360076.95,7.0,1,4,4,4,12,0xb2d1c974
399.81,1.0,10,1,2,3,6,0xb2d80295
450120.47,3.0,5,4,4,3,11,0xb2d59a4f
112901.23,4.0,0,3,4,4,11,0xb2d33064
150000.0,3.0,1,3,4,4,11,0xb2d17c57
1001.17,1.0,121,1,2,1,4,0xb2d91a72
1353852.83,4.0,13,4,4,3,11,0xb2d964f5d
13309.69,1.0,0,2,2,4,8,0xb2d27430
50000.0,2.0,0,2,3,4,9,0xb2d9c44e
242623.53,46.0,1,3,4,4,11,0xb2d09f01d
500000.0,2.0,28,4,3,2,9,0xb2d9da89
320000.37,4.0,0,4,4,4,12,0xb2d15d33
1.14,1.0,7,1,2,3,6,0xb2d5adb8
131780.74,2.0,118,3,3,1,7,0xb2d400edd
597823.93,1.0,38,4,2,2,8,0xb2d3ca2ed
1158.84,1.0,92,1,2,1,4,0xb2d2918d
2027.99,1.0,92,1,2,1,4,0xb2d38b79
329.13,1.0,5,1,2,3,6,0xb2d2ebbd
108456.62,2.0,228,3,3,1,7,0xb2d32940d
39779.67,1.0,9,2,2,3,7,0xb2d53d8ad
250596.82,6.0,0,3,4,4,11,0xb2d64889
2255.6,1.0,40,1,2,2,5,0xb2d9e2f8
434941.26,12.0,6,4,4,3,11,0xb2d1a939
179770.53,2.0,90,3,3,1,7,0xb2d38c48
108942.89,4.0,83,3,4,1,8,0xb2d3b1c7d
518788.4,3.0,22,4,4,2,10,0xb2d0f3d1
1609.57,1.0,6,1,2,3,6,0xb2d69b7d
270130.37,3.0,1,3,4,4,11,0xb2d24f36d
70078.98,3.0,66,3,4,2,9,0xb2d62fcc
50789.87,3.0,76,2,4,1,7,0xb2d5ac15d
11000.04,1.0,3,2,2,4,8,0xb2d8d59d
1268.18,1.0,2,1,2,4,7,0xb2d2b616
33179.31,1.0,0,2,2,4,8,0xb2d3048cd
515024.93,7.0,13,4,4,3,11,0xb2d0b4c3
1002.94,1.0,92,1,2,1,4,0xb2d54bfbd
84450.37,1.0,2,3,2,4,9,0xb2d6a3f6d
452262.68,5.0,70,4,4,1,9,0xb2d083e2d
14862.03,2.0,47,2,3,2,7,0xb2d0c088d
525327.06,2.0,27,4,3,2,9,0xb2d2981cd
235060.08,2.0,157,3,3,1,7,0xb2d526d7
1110961.99,28.0,0,4,4,4,12,0xb2d36337d
804.61,1.0,24,1,2,2,5,0xb2d2e519
1.53,1.0,11,1,2,3,6,0xb2d44da0
53.57,1.0,5,1,2,3,6,0xb2d5c0ba
9051.97,1.0,3,2,2,4,8,0xb2d6f42f
170002.71,2.0,28,3,3,2,8,0xb2d63a67
2.72,1.0,62,1,2,2,5,0xb2d59662
300003.17,2.0,45,3,3,2,8,0xb2d91bd1
13625.09,1.0,89,2,2,1,5,0xb2d2d925
3665.99,1.0,8,2,2,3,7,0xb2d3d1f8
12223.61,1.0,0,2,2,4,8,0xb2d41f87d
6214.93,6.0,0,2,4,4,10,0x3b9ae49cd
31343.63,2.0,171,2,3,1,6,0xb2d5fe38d
1407.74,2.0,92,1,3,1,5,0xb2d2d3dd
635.78,1.0,14,1,2,3,6,0xb2d49da0d
540000.0,5.0,5,4,4,3,11,0xb2d63694
461000.7,4.0,1,4,4,4,12,0xb2d55e2c
430046.27,7.0,21,4,4,2,10,0xb2d243f2
5.59,1.0,184,1,2,1,4,0xb2d3992fd
3599.26,1.0,11,2,2,3,7,0xb2d652c9d
6.42,1.0,9,1,2,3,6,0xb2d6c12bd
535023.38,7.0,18,4,4,2,10,0xb2d0f55e
426057.49,3.0,196,4,4,1,9,0xb2d17df1d
800000.0,15.0,0,4,4,4,12,0xb2d0d1c6d
761412.54,11.0,0,4,4,4,12,0xb2d24a9ed
6271.03,1.0,184,2,2,1,5,0x3b9b0f2ad
155245.7,2.0,186,3,3,1,7,0xb2d2c643
1248000.0,29.0,0,4,4,4,12,0xb2d3b3d4
1131.64,1.0,17,1,2,2,5,0xb2d4f69b
113623.3,9.0,0,3,4,4,11,0xb2d14c8ad
21642.55,1.0,9,2,2,3,7,0xb2d0a5f9
501860.18,2.0,35,4,3,2,9,0xb2d6910ed
204321.08,1.0,19,3,2,2,7,0xb2d3973d
0.26,1.0,0,1,2,4,7,0xb2d2d77d
583062.82,7.0,172,4,4,1,9,0xb2d520ed
200056.72,4.0,159,3,4,1,8,0x3b9b3164d
2913.38,1.0,3,2,2,4,8,0xb2d93f72
926.29,1.0,0,1,2,4,7,0xb2d99c4e
150007.93,2.0,105,3,3,1,7,0xb2d95a7cd
805050.96,14.0,34,4,4,2,10,0x3b9b32bd
225.84,1.0,7,1,2,3,6,0xb2d671e8
604205.26,7.0,0,4,4,4,12,0xb2d61c41
200002.11,2.0,66,3,3,2,8,0xb2d8eda8d
227405.64,5.0,0,3,4,4,11,0xb2d2fb61d
100004.43,4.0,59,3,4,2,9,0xb2d69064d
800000.79,6.0,0,4,4,4,12,0xb2d5736a
4000.08,1.0,3,2,2,4,8,0xb2d9a78a
332.46,1.0,9,1,2,3,6,0xb2d610d9
10009.08,1.0,7,2,2,3,7,0xb2d94a44d
10044.74,1.0,184,2,2,1,5,0xb2d5c2f5
2434.17,1.0,92,1,2,1,4,0xb2d0af0bd
254627.51,3.0,18,3,4,2,9,0xb2d64431d
48250.15,1.0,5,2,2,3,7,0xb2d29dbb
4656.95,1.0,0,2,2,4,8,0xb2d968e2
6.1,1.0,0,1,2,4,7,0xb2d3f472
1854.05,3.0,184,1,4,1,6,0x3b9b36f1d
6656.17,1.0,8,2,2,3,7,0xb2d2b5d2d
8035.08,1.0,92,2,2,1,5,0xb2d50f83
30074.63,2.0,55,2,3,2,7,0xb2d6cedbd
5007.07,1.0,0,2,2,4,8,0xb2d6b556
2746.37,1.0,8,1,2,3,6,0xb2d26129d
531937.73,6.0,69,4,4,1,9,0xb2d230f8
175000.68,5.0,63,3,4,2,9,0xb2d2c805
516.11,1.0,5,1,2,3,6,0xb2d6b261d
1720036.29,2.0,6,4,3,3,10,0xb2d4369c
140032.3,8.0,20,3,4,2,9,0xb2d5b837d
163424.15,1.0,0,3,2,4,9,0xb2d618e0
124668.86,1.0,25,3,2,2,7,0xb2d643bc
122.42,1.0,42,1,2,2,5,0xb2d63a91d
20699.15,1.0,40,2,2,2,6,0xb2d34dff
1.01,1.0,48,1,2,2,5,0xb2d6d4c9
568926.34,11.0,1,4,4,4,12,0xb2d0dd94
250005.28,2.0,25,3,3,2,8,0xb2d9a2bd
36334.19,1.0,9,2,2,3,7,0xb2d48d73
7714.38,4.0,9,2,4,3,9,0x3b9b1019
229000.01,2.0,16,3,3,2,8,0xb2d99988
299675.87,4.0,0,3,4,4,11,0xb2d1c3dc
42050.18,1.0,0,2,2,4,8,0xb2d21984
214.66,1.0,9,1,2,3,6,0xb2d217d3d
41559.71,1.0,13,2,2,3,7,0xb2d6a6e2d
174040.42,6.0,19,3,4,2,9,0xb2d103fe
207595.14,3.0,143,3,4,1,8,0xb2d42435d
400005.06,8.0,42,4,4,2,10,0xb2d7050dd
34123.71,1.0,10,2,2,3,7,0xb2d5d4b5d
70000.0,1.0,4,3,2,4,9,0xb2d5bbb0
2002908.4,3.0,3,4,4,4,12,0xb2d95199
640.58,1.0,22,1,2,2,5,0xb2d20775
41066.37,3.0,0,2,4,4,10,0xb2d75740
224742.03,4.0,25,3,4,2,9,0xb2d93cec
20000.55,2.0,206,2,3,1,6,0xb2d5ba35
133.07,1.0,10,1,2,3,6,0xb2d42d8d
426387.77,5.0,24,4,4,2,10,0xb2d1719a
36.94,1.0,29,1,2,2,5,0xb2d59f89
301422.12,3.0,9,4,4,3,11,0xb2d8eb5fd
4373.8,1.0,161,2,2,1,5,0xb2d502b1d
3736.46,1.0,0,2,2,4,8,0xb2d6b9b1
286092.91,5.0,18,3,4,2,9,0xb2d63d1a
2313.33,1.0,8,1,2,3,6,0xb2d6efd7
120225.44,2.0,217,3,3,1,7,0xb2d344ac
919102.26,3.0,25,4,4,2,10,0xb2d4c04bd
101566.85,2.0,62,3,3,2,8,0xb2d626edd
447.41,1.0,208,1,2,1,4,0xb2d4ef78d
52267.41,2.0,47,3,3,2,8,0xb2d1d1ed
353091.03,12.0,6,4,4,3,11,0xb2d41eaf
402849.81,3.0,74,4,4,1,9,0xb2d90737d
899876.92,11.0,40,4,4,2,10,0xb2d10eb4
140085.9,3.0,97,3,4,1,8,0xb2d26efbd
90895.3,2.0,74,3,3,1,7,0xb2d4c040
483781.05,5.0,0,4,4,4,12,0xb2d311a1
202674.67,2.0,71,3,3,1,7,0xb2d5a698d
54938.02,1.0,3,3,2,4,9,0xb2d2898a
550000.0,2.0,8,4,3,3,10,0xb2da358c
200015.79,4.0,67,3,4,1,8,0xb2d55160d
841007.52,5.0,0,4,4,4,12,0xb2d1724fd
470033.15,5.0,55,4,4,2,10,0xb2d23c00
9192.54,1.0,3,2,2,4,8,0xb2d44201
23.14,1.0,0,1,2,4,7,0xb2da3e95
1896.65,1.0,4,1,2,4,7,0xb2d2e216d
120352.34,2.0,70,3,3,1,7,0xb2d4f8a8
495021.89,6.0,11,4,4,3,11,0xb2d0e704
341873.07,4.0,69,4,4,1,9,0xb2d1164c
1992.49,1.0,184,1,2,1,4,0x3b9ae0f2d
22482.57,1.0,7,2,2,3,7,0xb2d2831d
201421.01,2.0,33,3,3,2,8,0xb2d8f6f6
36159.83,1.0,9,2,2,3,7,0xb2d47151d
2028642.99,4.0,96,4,4,1,9,0xb2d86b62d
259587.53,7.0,0,3,4,4,11,0x3b9b2c6bd
4044.8,1.0,0,2,2,4,8,0xb2d8a0c2
7270.93,1.0,10,2,2,3,7,0xb2d535e1
5865.44,1.0,234,2,2,1,5,0xb2d0fdcdd
6048.17,1.0,7,2,2,3,7,0xb2d37198d
11484.97,1.0,80,2,2,1,5,0xb2d2a752d
165764.98,2.0,0,3,3,4,10,0xb2d28a3bd
758.24,1.0,0,1,2,4,7,0xb2d5b545
2109631.68,9.0,11,4,4,3,11,0xb2d62713
162.32,1.0,6,1,2,3,6,0xb2d6a807
593.21,1.0,0,1,2,4,7,0xb2d8c846d
70000.0,3.0,4,3,4,4,11,0xb2d60ec2
622204.7,2.0,24,4,3,2,9,0xb2d90006
207639.35,4.0,77,3,4,1,8,0xb2d5cf54
2.76,1.0,184,1,2,1,4,0xb2d2d7e8
16.83,2.0,80,1,3,1,5,0x3b9b31d8
100007.72,2.0,157,3,3,1,7,0xb2d44931d
371070.98,12.0,31,4,4,2,10,0xb2d2139ad
63054.46,4.0,1,3,4,4,11,0x3b9af2cf
23866.35,1.0,18,2,2,2,6,0xb2d5d7ff
25.92,1.0,54,1,2,2,5,0xb2d905b9
2363.82,1.0,16,1,2,2,5,0xb2d6a80e
960067.53,5.0,8,4,4,3,11,0xb2d9a793
75426.38,1.0,9,3,2,3,8,0xb2d6f9af
1700000.0,7.0,7,4,4,3,11,0xb2d40bf5d
4062.64,1.0,184,2,2,1,5,0xb2d2854dd
294953.28,4.0,193,3,4,1,8,0xb2d0ad7cd
11042.08,1.0,1,2,2,4,8,0xb2d8f237
255176.09,3.0,0,3,4,4,11,0xb2d2b5b0
1015.63,1.0,184,1,2,1,4,0xb2d13e59d
100057.69,3.0,74,3,4,1,8,0xb2d5fbded
1191.84,1.0,92,1,2,1,4,0xb2d1f81f
240078.52,2.0,29,3,3,2,8,0xb2d29273d
231728.45,3.0,18,3,4,2,9,0xb2d441d5d
50615.73,2.0,0,2,3,4,9,0xb2d551d0
138808.02,6.0,55,3,4,2,9,0xb2d16ddcd
6333.12,1.0,105,2,2,1,5,0xb2d2156d
969524.82,1.0,9,4,2,3,9,0xb2d43518
47.5,1.0,25,1,2,2,5,0xb2d93c28
542.89,1.0,4,1,2,4,7,0xb2d6f817
200000.0,2.0,4,3,3,4,10,0xb2da543b
10264.64,1.0,102,2,2,1,5,0xb2d6ff75d
415000.0,2.0,18,4,3,2,9,0xb2da3315
200000.0,2.0,2,3,3,4,10,0xb2d9b823
4515.62,2.0,10,2,3,3,8,0x3b9aee7fd
67239.29,1.0,9,3,2,3,8,0xb2d6d1ecd
200205.38,6.0,28,3,4,2,9,0x3b9b380b
124018.7,2.0,76,3,3,1,7,0xb2d31770
18241.11,1.0,13,2,2,3,7,0xb2d6280c
257418.9,4.0,108,3,4,1,8,0xb2d48dead
19193.79,1.0,2,2,2,4,8,0xb2d91e80
1400.51,1.0,4,1,2,4,7,0xb2d27a47d
668.33,2.0,60,1,3,2,6,0xb2d5d040d
651641.9,3.0,4,4,4,4,12,0xb2d93205
230021.06,4.0,3,3,4,4,11,0xb2d13d56
16.15,1.0,18,1,2,2,5,0xb2da10f9
3254758.79,8.0,4,4,4,4,12,0xb2d44af6
27.25,1.0,26,1,2,2,5,0xb2d34a3bd
2.89,1.0,39,1,2,2,5,0xb2d25ba1d
1010.8,1.0,184,1,2,1,4,0xb2d29c5f
126519.91,2.0,92,3,3,1,7,0xb2d1fc3e
19570.47,1.0,0,2,2,4,8,0xb2d32798
10089.46,1.0,11,2,2,3,7,0xb2d8f1e4
415927.89,5.0,25,4,4,2,10,0xb2d79058
1019.19,1.0,184,1,2,1,4,0xb2d29979
10001.16,2.0,3,2,3,4,9,0xb2d9293a
45568.63,1.0,257,2,2,1,5,0xb2d328b9
3025.75,1.0,11,2,2,3,7,0xb2d3a08e
3980.91,1.0,184,2,2,1,5,0xb2d36395
624676.42,3.0,1,4,4,4,12,0xb2d3accd
100000.0,2.0,6,3,3,3,9,0xb2d96e60
6638.26,1.0,92,2,2,1,5,0xb2d0907d
300001.57,2.0,58,3,3,2,8,0xb2d233f0d
2231520.88,5.0,0,4,4,4,12,0xb2d64208d
2030.93,1.0,10,1,2,3,6,0xb2d34cee
200000.0,1.0,1,3,2,4,9,0xb2da694f
1020113.17,5.0,166,4,4,1,9,0xb2d44c65
317713.5,3.0,175,4,4,1,9,0xb2d1965cd
17075.41,1.0,27,2,2,2,6,0xb2d4707bd
129242.01,4.0,0,3,4,4,11,0xb2d0ba7cd
482294.28,1.0,4,4,2,4,10,0xb2d21583
1014244.96,3.0,110,4,4,1,9,0xb2d59f05d
270000.0,2.0,4,3,3,4,10,0xb2da51cb
200000.0,1.0,0,3,2,4,9,0xb2da5b93
1460000.0,7.0,1,4,4,4,12,0xb2d3a441
406186.41,3.0,13,4,4,3,11,0xb2d3c2ebd
122068.06,2.0,10,3,3,3,9,0xb2d962d8
10077.44,1.0,92,2,2,1,5,0xb2d5e990
10906.19,1.0,0,2,2,4,8,0xb2d61133
93250.61,1.0,0,3,2,4,9,0xb2d24789d
500000.0,2.0,4,4,3,4,11,0xb2d9764a
202240.91,2.0,32,3,3,2,8,0xb2d920c7d
5680.75,1.0,68,2,2,1,5,0xb2d305a4d
104.45,1.0,5,1,2,3,6,0xb2d7ee7e
603010.21,4.0,0,4,4,4,12,0xb2d5407f
190490.8,5.0,0,3,4,4,11,0xb2d0e79d
0.0,1.0,4,1,2,4,7,0xb2da5f6e
53824.27,2.0,206,3,3,1,7,0xb2d31bbed
201344.83,3.0,132,3,4,1,8,0xb2d6570fd
500110.78,2.0,0,4,3,4,11,0xb2d648db
133001.32,5.0,0,3,4,4,11,0xb2d14895d
20000.84,2.0,14,2,3,3,8,0xb2da3531
1.51,1.0,75,1,2,1,4,0xb2d69c3d
53641.99,2.0,20,3,3,2,8,0xb2d0d57e
1160.57,1.0,92,1,2,1,4,0xb2d271b0d
526296.09,8.0,0,4,4,4,12,0xb2d07052
211851.11,3.0,21,3,4,2,9,0xb2d53060d
700205.68,2.0,210,4,3,1,8,0xb2d0eafc
261870.52,5.0,4,3,4,4,11,0xb2d393d5
691837.62,2.0,0,4,3,4,11,0xb2d918c7
1022108.39,3.0,6,4,4,3,11,0xb2d41574d
7.88,2.0,91,1,3,1,5,0xb2d53a6fd
288263.37,4.0,11,3,4,3,10,0xb2d49bbbd
187457.19,3.0,4,3,4,4,11,0xb2d27fcd
458000.0,3.0,15,4,4,3,11,0xb2d6f6c7
3309295.76,1.0,7,4,2,3,9,0xb2d47f5c
321000.0,6.0,0,4,4,4,12,0xb2d12238d
441468.41,16.0,11,4,4,3,11,0xb2d65e53
265742.65,4.0,83,3,4,1,8,0xb2d1778dd
17.56,1.0,187,1,2,1,4,0xb2d3a8dad
482170.74,3.0,27,4,4,2,10,0xb2d6a43d
100216.34,2.0,5,3,3,3,9,0xb2d5e558
206185.06,2.0,193,3,3,1,7,0xb2d21d71d
1682336.72,6.0,35,4,4,2,10,0xb2d0d2eed
12.01,1.0,16,1,2,2,5,0xb2d92686
3641002.83,44.0,0,4,4,4,12,0xb2d3c208d
70004.21,3.0,90,3,4,1,8,0xb2d3ec16d
2.99,1.0,6,1,2,3,6,0xb2d27791
51001.06,4.0,11,2,4,3,9,0xb2da3acb
780020.69,4.0,6,4,4,3,11,0xb2d8e7c2
95.19,1.0,4,1,2,4,7,0xb2d2065d
369.24,1.0,38,1,2,2,5,0xb2d441b4
250218.89,10.0,1,3,4,4,11,0xb2d16d9ad
55030.75,2.0,164,3,3,1,7,0xb2d25c1dd
5101.34,1.0,10,2,2,3,7,0xb2d3743ed
423637.93,4.0,20,4,4,2,10,0xb2d1b32a
85352.79,1.0,0,3,2,4,9,0xb2d3164d
15752.28,1.0,26,2,2,2,6,0xb2d3a99e
3.42,1.0,2,1,2,4,7,0xb2d6d379
462.97,1.0,10,1,2,3,6,0xb2d6c543
184815.4,2.0,11,3,3,3,9,0xb2d42be6
200710.42,2.0,31,3,3,2,8,0xb2d93ef4d
700217.95,5.0,39,4,4,2,10,0xb2d1bd55
150008.33,3.0,4,3,4,4,11,0xb2d3f68d
97.63,1.0,32,1,2,2,5,0xb2d63d04
8464.87,1.0,0,2,2,4,8,0xb2d6b7fe
75.37,1.0,1,1,2,4,7,0xb2d4061e
571.53,1.0,6,1,2,3,6,0xb2d1beadd
900093.49,5.0,0,4,4,4,12,0xb2d65ac0d
1883.02,1.0,184,1,2,1,4,0xb2d32ae9d
3067.72,2.0,184,2,3,1,6,0xb2d2c8c7
10449.95,1.0,96,2,2,1,5,0xb2d64d0ed
302347.18,3.0,0,4,4,4,12,0xb2d1a945d
9992.72,1.0,20,2,2,2,6,0xb2d4039fd
16515.35,1.0,184,2,2,1,5,0xb2d0979fd
24002.72,2.0,56,2,3,2,7,0xb2d5d15c
208349.05,2.0,6,3,3,3,9,0xb2d3bce4
64459.34,5.0,49,3,4,2,9,0xb2d37cc5
381626.83,1.0,0,4,2,4,10,0xb2d60bf8
510051.68,3.0,6,4,4,3,11,0xb2d5c0dc
711.76,1.0,9,1,2,3,6,0xb2d70131
200000.0,2.0,18,3,3,2,8,0xb2da3359
4801.52,1.0,25,2,2,2,6,0xb2d9980e
63.54,1.0,13,1,2,3,6,0xb2d4ee0c
30822.48,1.0,17,2,2,2,6,0xb2d99aaa
159270.64,10.0,3,3,4,4,11,0x3b9af5e5
342448.59,2.0,0,4,3,4,11,0xb2d646b8d
1096.19,1.0,22,1,2,2,5,0xb2d69199
1.34,1.0,80,1,2,1,4,0xb2d97290
910000.0,6.0,0,4,4,4,12,0xb2d6d6b5d
51768.93,1.0,4,2,2,4,8,0xb2d5b014
2847.13,1.0,92,1,2,1,4,0xb2d0e636d
643.5,2.0,0,1,3,4,8,0xb2d075e1d
8450.13,1.0,0,2,2,4,8,0xb2d65aba
1015214.71,3.0,0,4,4,4,12,0xb2d27689d
163.0,1.0,76,1,2,1,4,0xb2d2ded6
2956.45,1.0,184,2,2,1,5,0xb2d320c2
60001.9,2.0,94,3,3,1,7,0xb2d868b3d
4002.27,1.0,19,2,2,2,6,0xb2d6b722
4312.84,1.0,92,2,2,1,5,0xb2d3f935d
112213.91,3.0,51,3,4,2,9,0xb2d5cfa8
55649.81,3.0,49,3,4,2,9,0xb2d60e7ed
2.43,1.0,0,1,2,4,7,0xb2d29f84d
1172.23,1.0,0,1,2,4,7,0xb2d2fd8a
1288718.05,30.0,21,4,4,2,10,0xb2d6e161d
252620.87,2.0,1,3,3,4,10,0xb2d58b4b
51479.57,1.0,5,2,2,3,7,0xb2d3a9cad
3298.69,1.0,9,2,2,3,7,0xb2d505ba
4744.11,2.0,155,2,3,1,6,0x3b9b340dd
915312.06,7.0,96,4,4,1,9,0xb2d12034d
200006.34,2.0,102,3,3,1,7,0xb2d9600ad
973.23,1.0,8,1,2,3,6,0xb2d8e410
2324.39,1.0,42,1,2,2,5,0xb2d3905cd
100011.97,2.0,139,3,3,1,7,0xb2d58159d
5448.84,1.0,2,2,2,4,8,0xb2da1cab
70000.74,2.0,77,3,3,1,7,0xb2d99748
545.97,1.0,7,1,2,3,6,0xb2d97990
180909.18,4.0,38,3,4,2,9,0xb2d7546f
660028.35,6.0,210,4,4,1,9,0xb2d6f434
204037.06,2.0,0,3,3,4,10,0xb2d2c4af
300029.27,2.0,3,3,3,4,10,0xb2d6685d
23737.02,1.0,10,2,2,3,7,0xb2d6f5ba
480093.03,5.0,10,4,4,3,11,0xb2d0b3cb
206023.85,2.0,74,3,3,1,7,0xb2d65984d
169086.3,3.0,0,3,4,4,11,0xb2d10c26
228244.34,1.0,6,3,2,3,8,0xb2d3b474d
400009.75,4.0,39,4,4,2,10,0xb2d11821
581374.97,2.0,7,4,3,3,10,0xb2d29298d
1050497.43,3.0,12,4,4,3,11,0xb2d23215
726332.74,2.0,4,4,3,4,11,0xb2d49e9bd
2564.7,1.0,0,1,2,4,7,0xb2d3454e
261001.99,4.0,6,3,4,3,10,0xb2d302f3d
6890.91,1.0,13,2,2,3,7,0xb2d3483b
9.16,1.0,39,1,2,2,5,0xb2d58ed2
3034138.39,5.0,7,4,4,3,11,0xb2d276c5
250888.06,2.0,29,3,3,2,8,0xb2d8c434
88406.93,1.0,10,3,2,3,8,0xb2d98a44
404.95,1.0,10,1,2,3,6,0xb2d2fa91
318723.72,5.0,0,4,4,4,12,0xb2d28520
1591008.2,4.0,0,4,4,4,12,0xb2d43a33
461.8,1.0,34,1,2,2,5,0xb2d7a7d5d
4730.7,1.0,92,2,2,1,5,0xb2d1cb8dd
12354.51,1.0,0,2,2,4,8,0xb2d6c047d
14677.72,1.0,18,2,2,2,6,0xb2d34070
6467.21,1.0,79,2,2,1,5,0xb2d0c321
600048.06,2.0,4,4,3,4,11,0xb2d5cca1
50.0,1.0,5,1,2,3,6,0xb2d9b7be
186.99,1.0,4,1,2,4,7,0xb2d25063
500073.04,2.0,3,4,3,4,11,0xb2d62b60d
1239363.45,13.0,39,4,4,2,10,0xb2d4ef1fd
755430.38,5.0,3,4,4,4,12,0xb2d281de
333039.48,2.0,53,4,3,2,9,0xb2d0cbc6
1217.33,4.0,92,1,4,1,6,0xb2d2c351
200004.22,2.0,95,3,3,1,7,0xb2d975de
100002.11,2.0,31,3,3,2,8,0xb2d93aa2
300878.51,13.0,1,4,4,4,12,0x3b9af2d3
6366.22,1.0,20,2,2,2,6,0xb2d912ba
400769.63,12.0,47,4,4,2,10,0xb2d081f7d
350003.69,2.0,14,4,3,3,10,0xb2da39ca
51501.31,1.0,0,2,2,4,8,0xb2d3a8d2
380178.88,3.0,192,4,4,1,9,0x3b9b37be
0.84,1.0,81,1,2,1,4,0xb2d8d4d3d
4017.94,1.0,30,2,2,2,6,0xb2d9d282
87.45,1.0,0,1,2,4,7,0xb2d2e4f5d
1370.67,1.0,27,1,2,2,5,0xb2d5be3f
3545.65,1.0,10,2,2,3,7,0xb2d8d1f9
7201.62,1.0,42,2,2,2,6,0xb2d423e6
30001.47,4.0,41,2,4,2,8,0xb2d619a9
51774.67,1.0,76,2,2,1,5,0xb2d27c8c
1874.69,1.0,12,1,2,3,6,0xb2d4c810
50007.75,2.0,32,2,3,2,7,0xb2d191cf
400068.66,2.0,1,4,3,4,11,0xb2d51cf7d
0.0,1.0,3,1,2,4,7,0xb2d6805c
1439.34,2.0,184,1,3,1,5,0x3b9b48ced
90005.08,7.0,3,3,4,4,11,0xb2d61fadd
206003.76,2.0,20,3,3,2,8,0xb2d8d5e1d
2028000.0,9.0,1,4,4,4,12,0xb2d8d2ecd
373273.0,5.0,1,4,4,4,12,0xb2d5a9ae
280996.36,2.0,43,3,3,2,8,0xb2d69825d
10002.32,1.0,31,2,2,2,6,0xb2d6581b
660028.32,6.0,118,4,4,1,9,0xb2d6f434d
1441.08,1.0,10,1,2,3,6,0xb2d3eeded
25000.26,2.0,13,2,3,3,8,0xb2d95d2dd
129.3,1.0,9,1,2,3,6,0xb2d8d0c2
2528.91,1.0,1,1,2,4,7,0xb2d2f05b
12269.3,1.0,98,2,2,1,5,0xb2d1dbaf
15189.9,1.0,92,2,2,1,5,0xb2d511cad
1600016.89,2.0,14,4,3,3,10,0xb2da37b4
512.72,1.0,19,1,2,2,5,0xb2d17362d
73025.54,4.0,11,3,4,3,10,0xb2d7c6cc
100002.11,2.0,11,3,3,3,9,0xb2da4183
200000.21,2.0,13,3,3,3,9,0xb2d95e40
7263.27,1.0,10,2,2,3,7,0xb2d614ad
1860025.6,9.0,1,4,4,4,12,0x3b9ad351
150096.09,2.0,3,3,3,4,10,0xb2d5026dd
232.71,1.0,12,1,2,3,6,0xb2d0d232
6595.17,1.0,0,2,2,4,8,0xb2d6fd7dd
80052.22,2.0,46,3,3,2,8,0xb2d61e8f
1877528.62,7.0,11,4,4,3,11,0x3b9acec3d
20789.59,2.0,39,2,3,2,7,0xb2d59da2
593.07,1.0,7,1,2,3,6,0xb2d92265
829.02,1.0,72,1,2,1,4,0xb2d6705dd
1888.35,1.0,0,1,2,4,7,0xb2d0bb93
516996.54,2.0,136,4,3,1,8,0xb2d56e6d
50909.65,2.0,34,2,3,2,7,0xb2d685eed
208077.85,2.0,21,3,3,2,8,0xb2d63a2b
33252.38,1.0,133,2,2,1,5,0xb2d5f161d
850888.02,3.0,8,4,4,3,11,0xb2d14806
265085.63,5.0,12,3,4,3,10,0xb2d93674
597716.91,4.0,39,4,4,2,10,0xb2d5af34d
22.59,1.0,28,1,2,2,5,0xb2d787f5
705007.27,4.0,4,4,4,4,12,0xb2d3bb3cd
63745.63,1.0,92,3,2,1,6,0xb2d3a189
371.91,1.0,1,1,2,4,7,0xb2d28793
28241.67,1.0,4,2,2,4,8,0xb2d70917
1000000.0,2.0,10,4,3,3,10,0xb2d96990d
339.13,1.0,71,1,2,1,4,0xb2d5c523d
230000.0,3.0,13,3,4,3,10,0xb2d96028
140079.49,3.0,1,3,4,4,11,0xb2d58277
13712.17,1.0,11,2,2,3,7,0xb2d8e52f
54428.73,3.0,0,3,4,4,11,0x3b9af181d
612003.22,14.0,0,4,4,4,12,0xb2d1f8bf
422203.96,14.0,2,4,4,4,12,0xb2d67f02
2395.36,1.0,184,1,2,1,4,0xb2d26741d
356227.21,2.0,34,4,3,2,9,0xb2d6d995
611707.79,5.0,11,4,4,3,11,0xb2d1bb9d
32663.02,1.0,4,2,2,4,8,0xb2d62678
395066.84,9.0,1,4,4,4,12,0xb2d5ee63d
260001.87,6.0,4,3,4,4,11,0xb2d9b6e8
550006.25,4.0,5,4,4,3,11,0xb2d9969c
379071.41,6.0,18,4,4,2,10,0xb2d5659fd
10050.59,2.0,111,2,3,1,6,0xb2d94d7ad
3269.06,1.0,184,2,2,1,5,0xb2d17366d
200000.0,2.0,11,3,3,3,9,0xb2da4af2
17994.3,1.0,29,2,2,2,6,0xb2d2ce00
157007.99,2.0,0,3,3,4,10,0xb2d69fddd
250496.75,2.0,1,3,3,4,10,0xb2d69ad6
290125.35,8.0,0,3,4,4,11,0xb2d06879d
68.03,1.0,0,1,2,4,7,0xb2d6d389
1136.07,1.0,6,1,2,3,6,0xb2d39f31
152386.19,2.0,179,3,3,1,7,0xb2d650e1d
700900.76,4.0,4,4,4,4,12,0xb2d5aaa1d
160008.46,2.0,203,3,3,1,7,0xb2d78811d
313131.12,4.0,0,4,4,4,12,0xb2d5dd26d
1490238.45,5.0,1,4,4,4,12,0xb2d103f2
500695.37,2.0,0,4,3,4,11,0xb2d5ed96
80000.0,2.0,6,3,3,3,9,0xb2d96f60d
512.62,1.0,0,1,2,4,7,0xb2d9baf0
40082.77,2.0,90,2,3,1,6,0xb2d5e197d
346177.26,7.0,84,4,4,1,9,0xb2d19947
362516.33,5.0,6,4,4,3,11,0xb2d42afa
511999.12,4.0,0,4,4,4,12,0xb2d24f2ad
202187.23,12.0,13,3,4,3,10,0xb2d5a9bad
14825.15,1.0,184,2,2,1,5,0xb2d3e448d
27974.06,5.0,14,2,4,3,9,0xb2d31b7ad
1159.88,1.0,1,1,2,4,7,0xb2d37cccd
25000.37,2.0,102,2,3,1,6,0xb2d964c0d
18221.4,1.0,1,2,2,4,8,0xb2d73b4bd
681051.86,4.0,28,4,4,2,10,0xb2d1bd55d
315059.43,5.0,1,4,4,4,12,0xb2d0a458
22317.63,2.0,0,2,3,4,9,0xb2d26582
91480.85,5.0,3,3,4,4,11,0xb2d62fc5d
723012.41,13.0,1,4,4,4,12,0xb2d3a002d
981037.81,9.0,3,4,4,4,12,0xb2d25c73
1840.4,1.0,92,1,2,1,4,0xb2d528c0d
3121.07,1.0,0,2,2,4,8,0xb2d1d61d
216.4,1.0,10,1,2,3,6,0xb2d2f279
50003.09,2.0,14,2,3,3,8,0xb2da321b
6880.52,1.0,162,2,2,1,5,0xb2d24895
7063.2,1.0,183,2,2,1,5,0xb2d49462d
695006.74,6.0,0,4,4,4,12,0xb2d25830d
255327.13,2.0,1,3,3,4,10,0xb2d5cabe
250293.16,2.0,27,3,3,2,8,0xb2d4b370d
1303.25,1.0,184,1,2,1,4,0xb2d3529bd
86.25,1.0,72,1,2,1,4,0xb2d21320
40226.42,1.0,0,2,2,4,8,0xb2d54baf
403167.32,1.0,1,4,2,4,10,0xb2d3a001
977.39,1.0,10,1,2,3,6,0xb2d78e1b
0.0,1.0,90,1,2,1,4,0xb2d1d79a
30220.36,1.0,184,2,2,1,5,0xb2d405a2d
5223.48,1.0,22,2,2,2,6,0xb2d17d7b
65.29,1.0,42,1,2,2,5,0xb2d6e6b3
1320962.25,5.0,12,4,4,3,11,0xb2d6271dd
180319.14,6.0,13,3,4,3,10,0xb2d0dfa1d
0.85,1.0,81,1,2,1,4,0xb2d07a61d
1054552.6,2.0,245,4,3,1,8,0xb2d446d1d
205222.92,2.0,3,3,3,4,10,0xb2d0b3bf
100157.62,2.0,25,3,3,2,8,0xb2d48b4d
40907.96,3.0,23,2,4,2,8,0xb2d3edb6d
4704.52,1.0,15,2,2,3,7,0xb2d8cac9
40014.57,1.0,13,2,2,3,7,0xb2d1fb27
59558.58,1.0,1,3,2,4,9,0xb2d78797
309.0,1.0,1,1,2,4,7,0xb2d8cefd
427039.06,2.0,91,4,3,1,8,0xb2d59cdc
600006.35,2.0,231,4,3,1,8,0xb2d6eefdd
53188.6,1.0,6,3,2,3,8,0xb2d323dd
60002.65,3.0,3,3,4,4,11,0xb2d223e5d
8.44,1.0,14,1,2,3,6,0xb2d0adcf
10427.74,1.0,98,2,2,1,5,0xb2d56103d
120000.0,2.0,3,3,3,4,10,0xb2d97210
300019.38,2.0,8,3,3,3,9,0xb2d5f766
280069.81,2.0,214,3,3,1,7,0xb2d56087
24242.11,1.0,18,2,2,2,6,0xb2d5d113
3765.51,1.0,12,2,2,3,7,0xb2d99140
892513.08,6.0,14,4,4,3,11,0xb2d575dcd
14.25,1.0,33,1,2,2,5,0xb2d32faf
86289.95,3.0,0,3,4,4,11,0x3b9b0fda
835.26,1.0,5,1,2,3,6,0xb2d26ce8
552143.44,5.0,32,4,4,2,10,0xb2d783e7d
591.47,1.0,24,1,2,2,5,0xb2d6fe79
1430000.0,6.0,0,4,4,4,12,0xb2d32dd7d
4370.25,1.0,166,2,2,1,5,0xb2d41f33
27384.48,1.0,3,2,2,4,8,0xb2d23d9f
500000.04,2.0,27,4,3,2,9,0xb2d9af7e
618102.59,12.0,7,4,4,3,11,0xb2d57992
726045.45,8.0,2,4,4,4,12,0xb2d0b42c
610.63,1.0,6,1,2,3,6,0xb2d65a01d
5056.35,1.0,184,2,2,1,5,0xb2d2bf38
330512.07,3.0,4,4,4,4,12,0xb2d167aad
2401.01,1.0,0,1,2,4,7,0xb2d6fff5d
791.79,1.0,77,1,2,1,4,0xb2d4d1f1d
400089.71,4.0,18,4,4,2,10,0xb2d64631d
33219.77,1.0,120,2,2,1,5,0xb2d24497
500010.56,2.0,10,4,3,3,10,0xb2d963a1
431894.08,4.0,39,4,4,2,10,0xb2d0a972d
1391002.39,7.0,17,4,4,2,10,0xb2d23944
120032.81,3.0,39,3,4,2,9,0xb2d1b340d
816.87,1.0,80,1,2,1,4,0xb2d3f49fd
4701.94,2.0,184,2,3,1,6,0x3b9b396fd
500027.26,3.0,1,4,4,4,12,0xb2d980edd
39722.92,1.0,158,2,2,1,5,0xb2d3b4f4
291427.14,4.0,9,3,4,3,10,0xb2d14d52d
3144.2,1.0,1,2,2,4,8,0xb2d30e8bd
435.76,1.0,11,1,2,3,6,0xb2d54cdd
391220.47,2.0,0,4,3,4,11,0xb2d8db30d
1765.59,1.0,9,1,2,3,6,0xb2d8130cd
1.46,1.0,17,1,2,2,5,0xb2d6bf95
161483.11,3.0,18,3,4,2,9,0xb2d1fa97d
51850.44,2.0,3,2,3,4,9,0xb2d4da42
1541.21,1.0,184,1,2,1,4,0xb2d1ba4ad
178205.71,5.0,2,3,4,4,11,0xb2d354c2
1388.32,1.0,184,1,2,1,4,0xb2d1f0e2d
39.0,1.0,7,1,2,3,6,0xb2d1a79f
90066.62,1.0,0,3,2,4,9,0xb2d588bd
682.14,1.0,1,1,2,4,7,0xb2d47debd
1976402.88,9.0,11,4,4,3,11,0xb2d5b7efd
150071.82,4.0,0,3,4,4,11,0xb2d1bb4fd
170049.3,4.0,10,3,4,3,10,0xb2d575f7
964323.4,5.0,9,4,4,3,11,0xb2d430b7
5450.48,1.0,92,2,2,1,5,0xb2d3f3a6d
13876.59,1.0,0,2,2,4,8,0xb2d5d906
130322.32,2.0,228,3,3,1,7,0xb2d3816f
1827000.0,8.0,3,4,4,4,12,0xb2d2a22ed
861.63,1.0,9,1,2,3,6,0xb2d5eedfd
615971.42,6.0,6,4,4,3,11,0xb2d61050d
501776.1,2.0,43,4,3,2,9,0xb2d9e97c
10044.16,1.0,46,2,2,2,6,0xb2d2c0ae
105740.77,2.0,101,3,3,1,7,0xb2d22509
204322.56,2.0,30,3,3,2,8,0xb2d5040c
50006.33,2.0,13,2,3,3,8,0xb2d1749b
119524.03,2.0,125,3,3,1,7,0xb2d1097cd
1557.51,1.0,72,1,2,1,4,0xb2d28a52
1690.84,1.0,10,1,2,3,6,0xb2d995f0
1374.21,1.0,0,1,2,4,7,0xb2d696ff
115241.77,6.0,11,3,4,3,10,0xb2d6081d
500606.74,2.0,4,4,3,4,11,0xb2d47ec6
9080855.35,3.0,0,4,4,4,12,0xb2d93619d
25001.32,2.0,13,2,3,3,8,0xb2d959c9d
1843.15,1.0,8,1,2,3,6,0xb2d6f5e7d
1653.54,1.0,31,1,2,2,5,0xb2d41bbc
22788.72,1.0,4,2,2,4,8,0xb2d5ba51d
340034.62,4.0,102,4,4,1,9,0xb2d1c77a
60007.63,3.0,3,3,4,4,11,0xb2da2af1
0.08,1.0,8,1,2,3,6,0xb2d5d6c9
7190.0,1.0,6,2,2,3,7,0xb2d423a1d
73361.88,2.0,164,3,3,1,7,0xb2d45242d
636.67,1.0,5,1,2,3,6,0xb2d6ef95
733499.92,8.0,3,4,4,4,12,0x3b9af2c8d
3757.14,6.0,11,2,4,3,9,0xb2d8d1fbd
252693.4,3.0,0,3,4,4,11,0xb2d1e324
2027.55,1.0,71,1,2,1,4,0xb2d858c7
450358.14,14.0,25,4,4,2,10,0xb2d4ee01
976.53,1.0,1,1,2,4,7,0xb2d6b55d
442.48,1.0,19,1,2,2,5,0xb2d31ba4
57247.27,4.0,0,3,4,4,11,0xb2d2b4c0
4.42,1.0,9,1,2,3,6,0xb2d6b761d
1128676.37,10.0,3,4,4,4,12,0xb2d1aeb2d
500076.06,3.0,26,4,4,2,10,0xb2d9c7ff
50005.72,1.0,19,2,2,2,6,0xb2d4ee5a
14.68,1.0,78,1,2,1,4,0xb2d21bfed
15009.98,3.0,32,2,4,2,8,0xb2d8f4b7
5797.68,1.0,1,2,2,4,8,0xb2d85161
6.68,1.0,10,1,2,3,6,0xb2d9636d
9808.15,2.0,3,2,3,4,9,0x3b9b4702
800058.42,4.0,29,4,4,2,10,0xb2d43494
1410005.29,12.0,4,4,4,4,12,0xb2d0bd49d
371021.68,5.0,28,4,4,2,10,0xb2d44ac9
620766.62,6.0,4,4,4,4,12,0xb2d280a0
2376.92,1.0,166,1,2,1,4,0x3b9b3b16
1949.91,1.0,92,1,2,1,4,0xb2d45af0d
142411.54,2.0,256,3,3,1,7,0xb2d44c02d
457400.0,1.0,0,4,2,4,10,0xb2d9169dd
36475.21,1.0,8,2,2,3,7,0xb2d2c0b6
53370.71,2.0,18,3,3,2,8,0xb2d4d5cdd
1513.66,1.0,92,1,2,1,4,0xb2d26fa9d
1501813.09,5.0,11,4,4,3,11,0x3b9b2fdfd
876.18,1.0,10,1,2,3,6,0xb2d21a6d
16337.63,1.0,184,2,2,1,5,0xb2d578ec
361.96,1.0,0,1,2,4,7,0xb2d74a77d
238357.2,3.0,55,3,4,2,9,0xb2d54252
270127.33,4.0,69,3,4,1,8,0xb2d1c34cd
1230491.62,6.0,59,4,4,2,10,0xb2d1bb76d
100000.0,2.0,3,3,3,4,10,0xb2d975a4d
61134.9,2.0,143,3,3,1,7,0xb2d60f77d
41.44,1.0,19,1,2,2,5,0xb2d786f9
500152.18,4.0,7,4,4,3,11,0xb2d10645
2961.62,1.0,0,2,2,4,8,0xb2d3435f
210042.78,2.0,28,3,3,2,8,0xb2d5d476
386696.29,4.0,5,4,4,3,11,0xb2d170c3d
511957.54,1.0,12,4,2,3,9,0xb2d59a59d
360004.34,4.0,48,4,4,2,10,0xb2d59b74
1610852.41,5.0,11,4,4,3,11,0xb2d16157d
270856.69,2.0,96,3,3,1,7,0xb2d9794c
3.57,1.0,69,1,2,1,4,0xb2d9702f
15067.41,1.0,181,2,2,1,5,0xb2d3a7a5
811408.0,6.0,6,4,4,3,11,0xb2d281ded
500000.0,2.0,1,4,3,4,11,0xb2da66a4
359076.94,3.0,168,4,4,1,9,0xb2d28b85
39824.59,1.0,32,2,2,2,6,0xb2d69fd8d
29153.49,1.0,10,2,2,3,7,0xb2d408efd
53352.79,2.0,181,3,3,1,7,0xb2d3989bd
450004.91,3.0,6,4,4,3,11,0xb2d6a259d
4310.79,2.0,25,2,3,2,7,0x3b9b46cfd
190008.44,2.0,66,3,3,2,8,0xb2d56bb3d
100.0,1.0,6,1,2,3,6,0xb2d17de9
367068.18,3.0,4,4,4,4,12,0xb2d17785
32327.67,1.0,184,2,2,1,5,0xb2d0df25
50001.58,2.0,52,2,3,2,7,0xb2d90702
102024.84,1.0,209,3,2,1,6,0xb2d5be2fd
551318.34,1.0,92,4,2,1,7,0xb2d3f8d6d
11956.02,1.0,123,2,2,1,5,0xb2d24e35
300013.16,4.0,53,3,4,2,9,0xb2d26c53d
4771.0,1.0,92,2,2,1,5,0xb2d0e61ed
50756.75,1.0,184,2,2,1,5,0xb2d215e9
567732.62,3.0,1,4,4,4,12,0xb2d56a7a
205690.13,2.0,78,3,3,1,7,0xb2d6c744
16026.84,1.0,1,2,2,4,8,0xb2d5793d
210081.52,2.0,3,3,3,4,10,0xb2d14ffa
3678.61,1.0,0,2,2,4,8,0xb2d1add9d
440133.18,5.0,0,4,4,4,12,0xb2d569b3
1392.58,1.0,4,1,2,4,7,0xb2d91257d
291675.55,3.0,4,3,4,4,11,0xb2d1200bd
250017.03,3.0,69,3,4,1,8,0xb2d28892d
190.48,1.0,1,1,2,4,7,0xb2d0e2f2d
78084.02,1.0,9,3,2,3,8,0xb2d59cea
118144.79,2.0,1,3,3,4,10,0xb2d5f6d6d
29.66,4.0,1,1,4,4,9,0x3b9b45db
3883.75,1.0,0,2,2,4,8,0xb2d07443
801695.49,4.0,0,4,4,4,12,0xb2d98cba
348018.34,2.0,31,4,3,2,9,0xb2d682e9d
1061.11,3.0,308,1,4,1,6,0xb2d1cca1
756277.1,3.0,0,4,4,4,12,0xb2d5ee41
11000.17,2.0,14,2,3,3,8,0xb2d63f5e
1866.97,1.0,92,1,2,1,4,0xb2d0c312d
360468.85,8.0,31,4,4,2,10,0xb2d5bba5d
13468.34,1.0,18,2,2,2,6,0xb2d1dd3d
150163.35,2.0,1,3,3,4,10,0xb2d24a87
11.21,1.0,13,1,2,3,6,0xb2d1f915
5004676.89,1.0,70,4,2,1,7,0xb2d6f097d
923656.07,25.0,22,4,4,2,10,0xb2d0b1e8
28.94,1.0,11,1,2,3,6,0xb2d2fd98
80732.75,5.0,83,3,4,1,8,0xb2d54698d
170010.67,2.0,53,3,3,2,8,0xb2d27064
9947.3,1.0,1,2,2,4,8,0xb2d53f39
660147.48,3.0,66,4,4,2,10,0xb2d1dc61d
122059.59,2.0,90,3,3,1,7,0xb2d2c23e
4529.08,1.0,1,2,2,4,8,0xb2d96bf4
10000.08,2.0,92,2,3,1,6,0xb2d64f55
65052.66,2.0,99,3,3,1,7,0xb2d57ed5
0.0,1.0,1,1,2,4,7,0xb2d3b60c
1374.11,6.0,0,1,4,4,9,0xb2d06b0a
310038.95,2.0,49,4,3,2,9,0xb2d29e16
320000.0,2.0,0,4,3,4,11,0xb2d60d62
9854.81,1.0,7,2,2,3,7,0xb2d6bb64
15.87,1.0,77,1,2,1,4,0xb2d3fca8d
300037.55,2.0,103,3,3,1,7,0xb2d2186dd
282173.1,5.0,93,3,4,1,8,0xb2d0977fd
5011.25,1.0,223,2,2,1,5,0xb2d6ffaed
501776.14,2.0,30,4,3,2,9,0xb2d8f755
59.79,1.0,6,1,2,3,6,0xb2d65e03
5217.31,1.0,6,2,2,3,7,0xb2d665e8
74264.13,1.0,140,3,2,1,6,0xb2d1dc57d
330725.16,5.0,0,4,4,4,12,0xb2d1987ad
920135.36,3.0,28,4,4,2,10,0xb2d13732
287015.79,11.0,3,3,4,4,11,0xb2d2e3f1
13134.93,1.0,173,2,2,1,5,0xb2d3a312
361412.69,6.0,3,4,4,4,12,0xb2d3bd2cd
70341.69,2.0,0,3,3,4,10,0xb2d14594d
40003.4,2.0,177,2,3,1,6,0xb2d361c8
30008.87,2.0,94,2,3,1,6,0xb2d57b57
861.22,2.0,14,1,3,3,7,0xb2d0820c
258.12,1.0,30,1,2,2,5,0xb2d834da
621098.77,4.0,11,4,4,3,11,0xb2d1b9a9d
312007.16,6.0,4,4,4,4,12,0xb2d16a33d
30576.44,1.0,0,2,2,4,8,0xb2d9552fd
206397.29,2.0,29,3,3,2,8,0xb2d6db00
209715.67,3.0,120,3,4,1,8,0xb2d34e5d
40001.27,3.0,12,2,4,3,9,0xb2d74abb
8788.81,1.0,10,2,2,3,7,0xb2d4c178
89001.88,2.0,95,3,3,1,7,0xb2d972dbd
1956666.07,2.0,3,4,3,4,11,0xb2d0bb8d
231752.33,3.0,0,3,4,4,11,0xb2d62f6e
1.94,1.0,38,1,2,2,5,0xb2d53559
0.0,2.0,53,1,3,2,6,0xb2d18f68
1812052.64,4.0,39,4,4,2,10,0xb2d42746
20117.72,3.0,76,2,4,1,7,0xb2d8a007
2807.74,1.0,92,1,2,1,4,0xb2d208cad
10000.7,2.0,83,2,3,1,6,0xb2d983e7
532.61,1.0,50,1,2,2,5,0xb2d5303a
11971.48,1.0,9,2,2,3,7,0xb2d397d1
1933120.84,12.0,0,4,4,4,12,0xb2d475ddd
220005.11,3.0,20,3,4,2,9,0xb2d94aaa
102535.87,4.0,0,3,4,4,11,0xb2d588e7d
653056.99,9.0,25,4,4,2,10,0xb2d5df75d
122292.43,1.0,202,3,2,1,6,0xb2d5d26ad
501776.73,2.0,39,4,3,2,9,0xb2d8eb24d
8112.29,1.0,118,2,2,1,5,0xb2d4543fd
2260122.32,4.0,39,4,4,2,10,0xb2d294b1d
393968.41,3.0,11,4,4,3,11,0xb2d240ab
19301.65,1.0,33,2,2,2,6,0xb2d41fb7d
132.85,2.0,84,1,3,1,5,0xb2d306b8d
2155.41,1.0,3,1,2,4,7,0xb2d37b85d
4268.64,1.0,61,2,2,2,6,0xb2d3b559
5884.81,1.0,6,2,2,3,7,0xb2d93e9c
89784.68,1.0,49,3,2,2,7,0xb2d37cfa
500001.06,3.0,22,4,4,2,10,0xb2d6e65ed
117399.81,3.0,1,3,4,4,11,0xb2d1d9e6
22469.07,2.0,9,2,3,3,8,0xb2d5c86bd
690903.43,5.0,0,4,4,4,12,0xb2d6bdbad
7684.43,1.0,11,2,2,3,7,0xb2d5d6a2d
11.58,1.0,54,1,2,2,5,0xb2d452e7
30339.87,2.0,0,2,3,4,9,0xb2d7c793d
4376.46,1.0,5,2,2,3,7,0xb2d2ceded
501776.04,2.0,31,4,3,2,9,0xb2d90f0d
368001.46,3.0,18,4,4,2,10,0xb2d9280ad
119.81,1.0,7,1,2,3,6,0xb2d63e0d
16018.16,1.0,29,2,2,2,6,0xb2d58b93
233335.46,2.0,32,3,3,2,8,0xb2d1d9f1d
266055.79,5.0,41,3,4,2,9,0xb2d28febd
960935.17,2.0,185,4,3,1,8,0xb2d11334
52848.27,2.0,67,3,3,1,7,0xb2d51626d
14.9,1.0,8,1,2,3,6,0xb2d30943d
140000.05,3.0,0,3,4,4,11,0xb2d1857cd
20394.53,1.0,10,2,2,3,7,0xb2d3cf6b
29.79,1.0,1,1,2,4,7,0xb2d7802ed
22040.45,3.0,63,2,4,2,8,0xb2d5a99d
7345.52,2.0,5,2,3,3,8,0xb2d65978
79.03,1.0,18,1,2,2,5,0xb2d59fa5
110111.12,2.0,10,3,3,3,9,0xb2d68ac4
310016.7,6.0,14,4,4,3,11,0xb2d265f3
210000.0,3.0,3,3,4,4,11,0xb2d95ff7d
280884.14,2.0,171,3,3,1,7,0xb2d2e398
280941.01,5.0,195,3,4,1,8,0xb2d07a45d
10412.79,1.0,38,2,2,2,6,0xb2d5dc3dd
122176.33,2.0,206,3,3,1,7,0xb2d5c47a
42483.94,2.0,92,2,3,1,6,0xb2d438f3d
150029.83,3.0,125,3,4,1,8,0xb2d39ab0d
1069.67,2.0,0,1,3,4,8,0xb2d30baa
10454.22,1.0,7,2,2,3,7,0xb2d2b4ddd
2376.59,1.0,37,1,2,2,5,0xb2d13881d
1202723.75,5.0,6,4,4,3,11,0xb2d5ebf0d
155.48,1.0,9,1,2,3,6,0xb2d8c942d
75.2,1.0,25,1,2,2,5,0xb2d24737
1379087.36,6.0,90,4,4,1,9,0xb2d4ec1d
2776.17,1.0,92,1,2,1,4,0xb2d30dad
83.39,1.0,80,1,2,1,4,0xb2d8d02f
200013.6,2.0,119,3,3,1,7,0xb2d0cce1
1238399.34,6.0,8,4,4,3,11,0xb2d256abd
2.37,1.0,63,1,2,2,5,0xb2d36fdb
54.51,1.0,3,1,2,4,7,0xb2d5cf62
59.85,2.0,61,1,3,2,6,0xb2d0a62e
515.84,1.0,49,1,2,2,5,0xb2d40295
306401.33,3.0,102,4,4,1,9,0xb2d6a18d
201315.3,4.0,0,3,4,4,11,0xb2d69fecd
1677.54,1.0,92,1,2,1,4,0xb2d3aab1
54610.59,2.0,92,3,3,1,7,0xb2d3c74dd
1000220.57,2.0,13,4,3,3,10,0xb2d95d7d
14540.17,1.0,301,2,2,1,5,0xb2d3f698d
200021.21,2.0,11,3,3,3,9,0xb2d65997
20.83,2.0,56,1,3,2,6,0xb2d39b08d
110669.64,3.0,18,3,4,2,9,0xb2d85bdb
10043.49,1.0,10,2,2,3,7,0xb2d6893bd
3398.58,1.0,2,2,2,4,8,0xb2d2dcd5d
0.0,1.0,6,1,2,3,6,0xb2d2969d
11370.62,1.0,92,2,2,1,5,0xb2d30530d
1785826.27,10.0,6,4,4,3,11,0xb2d1838f
476948.13,3.0,11,4,4,3,11,0xb2d29e4b
10083.08,1.0,23,2,2,2,6,0xb2d37cc4
62152.18,1.0,0,3,2,4,9,0xb2d31d70d
899.34,1.0,2,1,2,4,7,0xb2d25113
210745.99,2.0,46,3,3,2,8,0xb2d9e5a2
52833.71,1.0,3,3,2,4,9,0xb2d2c1df
1576.69,1.0,184,1,2,1,4,0xb2d1f8ba
7.6,1.0,26,1,2,2,5,0xb2da08b7
20761.02,2.0,39,2,3,2,7,0xb2d6457e
412130.71,1.0,3,4,2,4,10,0xb2d1e742d
551568.15,3.0,4,4,4,4,12,0xb2d656fd
332.76,1.0,9,1,2,3,6,0xb2d64149
80716.11,2.0,3,3,3,4,10,0xb2d5ff19d
42.76,1.0,14,1,2,3,6,0xb2d2268e
2082137.16,7.0,4,4,4,4,12,0xb2d78f5cd
50390.28,2.0,11,2,3,3,8,0xb2d14fdcd
696068.55,9.0,8,4,4,3,11,0xb2d6b83bd
430091.22,5.0,111,4,4,1,9,0xb2d5b29b
632266.15,3.0,8,4,4,3,11,0xb2d3e74b
14222.29,4.0,0,2,4,4,10,0x3b9b38acd
330000.0,2.0,2,4,3,4,11,0xb2d99914
100070.06,3.0,11,3,4,3,10,0xb2d6d6a5
7731.84,1.0,15,2,2,3,7,0xb2d24630d
400045.97,2.0,15,4,3,3,10,0xb2d6f749
221000.21,2.0,78,3,3,1,7,0xb2d2ff20
200004.22,2.0,74,3,3,1,7,0xb2d99e44
51119.46,1.0,21,2,2,2,6,0xb2d25d41
207.51,1.0,47,1,2,2,5,0xb2d25f5a
200000.05,2.0,26,3,3,2,8,0xb2da131f
500000.65,2.0,10,4,3,3,10,0xb2d967b9
169943.45,1.0,10,3,2,3,8,0xb2d3e516
1009.83,1.0,92,1,2,1,4,0xb2d29c5fd
200058.58,2.0,210,3,3,1,7,0xb2d77f07d
100012.67,1.0,20,3,2,2,7,0xb2d9c0b6
20146.54,1.0,92,2,2,1,5,0xb2d5f279d
2800000.17,15.0,1,4,4,4,12,0xb2d0d3a7d
147.43,2.0,10,1,3,3,7,0xb2d4e112
24463.84,1.0,0,2,2,4,8,0xb2d94cb3
2416.33,1.0,2,1,2,4,7,0xb2d26b63
300011.76,3.0,109,3,4,1,8,0xb2d4c23c
111073.33,3.0,119,3,4,1,8,0xb2d5999cd
16080.66,1.0,6,2,2,3,7,0xb2d6c2b0
3468.1,1.0,92,2,2,1,5,0xb2d2034ad
602563.14,3.0,19,4,4,2,10,0xb2d1eba1
567758.77,8.0,0,4,4,4,12,0x3b9b3d40d
590003.92,3.0,0,4,4,4,12,0xb2d97f67
188068.62,4.0,147,3,4,1,8,0xb2d22481
484.78,1.0,0,1,2,4,7,0xb2d65a59d
300000.0,2.0,0,3,3,4,10,0xb2d96f75
65006.7,1.0,8,3,2,3,8,0xb2d9ec5b
464.63,2.0,130,1,3,1,5,0xb2d176fa
1874.45,1.0,1,1,2,4,7,0xb2d1f990d
1950.04,1.0,2,1,2,4,7,0xb2d8f4a9
43411.03,2.0,28,2,3,2,7,0xb2d4df1dd
5770.81,5.0,16,2,4,2,8,0xb2d11aaad
353137.47,2.0,9,4,3,3,10,0xb2d6f056
773303.72,5.0,0,4,4,4,12,0x3b9af10bd
8369.04,1.0,6,2,2,3,7,0xb2d23eea
200710.49,2.0,49,3,3,2,8,0xb2d9daec
66815.05,3.0,19,3,4,2,9,0xb2d5ea84d
1137591.66,5.0,18,4,4,2,10,0xb2d1c30d
0.0,1.0,2,1,2,4,7,0xb2d9274b
300000.0,2.0,20,3,3,2,8,0xb2da2d08
50001.58,2.0,10,2,3,3,8,0xb2d960b7
800024.27,4.0,32,4,4,2,10,0xb2d9b12f
67173.03,2.0,4,3,3,4,10,0xb2d29a22
14675.06,1.0,20,2,2,2,6,0xb2d303de
1034.58,1.0,145,1,2,1,4,0xb2d5f641
300000.0,2.0,4,3,3,4,10,0xb2d979d3
25070.85,1.0,0,2,2,4,8,0xb2d49535d
2.92,1.0,0,1,2,4,7,0xb2d69baf
15002.82,2.0,20,2,3,2,7,0xb2d4b6a8
10363.18,1.0,9,2,2,3,7,0xb2d97778
1077.59,1.0,184,1,2,1,4,0x3b9aefa4d
99.51,1.0,6,1,2,3,6,0xb2d2f351
300009.51,3.0,125,3,4,1,8,0xb2d08900d
71092.61,4.0,52,3,4,2,9,0xb2d64aab
300006.33,2.0,80,3,3,1,7,0xb2d940e6
341569.5,3.0,63,4,4,2,10,0xb2d9a74f
597230.61,5.0,4,4,4,4,12,0xb2d580dbd
180000.4,3.0,3,3,4,4,11,0xb2d9723d
645.57,1.0,0,1,2,4,7,0xb2d6b532
14278.32,1.0,7,2,2,3,7,0xb2d6bb00
251000.82,3.0,20,3,4,2,9,0xb2d5ff3fd
3100919.45,8.0,6,4,4,3,11,0xb2d9e6f2
931028.85,5.0,0,4,4,4,12,0xb2d0aba8
3633.03,1.0,0,2,2,4,8,0xb2d6e6fa
451116.67,3.0,13,4,4,3,11,0xb2d6d920d
5679.15,1.0,4,2,2,4,8,0xb2d7917d
658.86,1.0,6,1,2,3,6,0xb2d2fe1c
325049.24,3.0,4,4,4,4,12,0xb2d5a169
1113.78,1.0,184,1,2,1,4,0x3b9b2e73
530035.91,6.0,5,4,4,3,11,0xb2d6d0ded
120001.27,2.0,98,3,3,1,7,0xb2d96434d
1065680.5,4.0,0,4,4,4,12,0xb2d5dcce
10283.93,1.0,1,2,2,4,8,0xb2d769bad
400098.82,3.0,5,4,4,3,11,0xb2d64236
990026.93,8.0,13,4,4,3,11,0xb2d630b1d
15.13,1.0,4,1,2,4,7,0xb2d80dd1d
20095.49,1.0,13,2,2,3,7,0xb2d97d28
45.66,3.0,25,1,4,2,7,0xb2d255ccd
1420000.0,1.0,0,4,2,4,10,0xb2d97056d
286480.0,1.0,4,3,2,4,9,0xb2da0023
500231.35,2.0,5,4,3,3,10,0xb2d9764ad
1020.11,1.0,0,1,2,4,7,0xb2d906a8d
408.29,1.0,7,1,2,3,6,0xb2d0ac42
5248.89,1.0,184,2,2,1,5,0xb2d28bdb
500000.0,2.0,12,4,3,3,10,0xb2d96473d
30001.27,2.0,42,2,3,2,7,0xb2d9e5f7
84.75,1.0,10,1,2,3,6,0xb2d94369
680000.43,5.0,1,4,4,4,12,0xb2d421fbd
2018.72,1.0,184,1,2,1,4,0xb2d2db07d
45.31,1.0,90,1,2,1,4,0xb2d547fb
36227.38,1.0,1,2,2,4,8,0xb2d382b1d
533674.82,12.0,0,4,4,4,12,0xb2d0b3bad
90041.25,2.0,193,3,3,1,7,0xb2d518a5
603717.94,1.0,0,4,2,4,10,0xb2d69f3dd
667.83,1.0,14,1,2,3,6,0xb2d6473f
80001.69,2.0,18,3,3,2,8,0xb2da2c52
1012945.44,7.0,6,4,4,3,11,0xb2d53053d
2877.62,1.0,92,1,2,1,4,0xb2d2345b
300100.19,1.0,0,4,2,4,10,0xb2d2a9e3
7198.13,1.0,14,2,2,3,7,0xb2d0f33f
1001485.6,2.0,92,4,3,1,8,0xb2d634aed
230536.91,2.0,81,3,3,1,7,0xb2d88b72d
11912.72,1.0,10,2,2,3,7,0xb2d911af
3168.06,3.0,92,2,4,1,7,0x3b9b4335d
1360.6,1.0,0,1,2,4,7,0xb2d2a10fd
600109.74,7.0,0,4,4,4,12,0xb2d625b1
21770.75,1.0,1,2,2,4,8,0xb2d6cad2
609.4,1.0,87,1,2,1,4,0xb2d4e736
0.21,1.0,81,1,2,1,4,0xb2d8d021d
13448.5,1.0,0,2,2,4,8,0xb2d2cbee
5.0,1.0,6,1,2,3,6,0xb2d2b422
580092.13,4.0,6,4,4,3,11,0xb2d78d8d
2432.25,1.0,9,1,2,3,6,0xb2d431e4
4016.45,1.0,0,2,2,4,8,0xb2d68629
1140005.32,7.0,3,4,4,4,12,0xb2d0b6c4
1872842.46,10.0,10,4,4,3,11,0xb2d4c8f0
910074.52,4.0,18,4,4,2,10,0xb2d6c3aad
101832.8,2.0,1,3,3,4,10,0xb2d279e8d
287467.22,4.0,0,3,4,4,11,0xb2d176b2
20214.26,1.0,184,2,2,1,5,0xb2d25f10d
70052.53,8.0,17,3,4,2,9,0xb2d3d544d
0.0,1.0,0,1,2,4,7,0xb2d91a82
2012954.25,2.0,1,4,3,4,11,0xb2d39494
2811.92,3.0,2,1,4,4,9,0xb2d09f51d
11274.88,1.0,21,2,2,2,6,0xb2d6d56c
6776.02,1.0,47,2,2,2,6,0xb2d2e879
342.31,1.0,19,1,2,2,5,0xb2d3b003d
304583.9,3.0,5,4,4,3,11,0xb2d67eafd
300006.03,3.0,1,3,4,4,11,0xb2d64d72d
75898768.11,3.0,55,4,4,2,10,0xb2d4e92c
140948.96,4.0,10,3,4,3,10,0xb2d5acab
680089.1,16.0,3,4,4,4,12,0xb2d60594d
1434.39,1.0,6,1,2,3,6,0xb2d6c492
25977.08,3.0,53,2,4,2,8,0xb2d0f8bfd
30000.32,2.0,25,2,3,2,7,0xb2da1506
110037.41,2.0,143,3,3,1,7,0xb2d645a9
2714.22,1.0,184,1,2,1,4,0xb2d50ed1d
9807.52,1.0,17,2,2,2,6,0xb2d9ec61
3776.85,1.0,61,2,2,2,6,0xb2d205c8
100103.19,4.0,91,3,4,1,8,0xb2d2c4d9d
992.52,1.0,2,1,2,4,7,0xb2d2b918
1511.52,1.0,10,1,2,3,6,0xb2d9446f
688000.0,4.0,4,4,4,4,12,0xb2d5bc54d
1100845.79,3.0,6,4,4,3,11,0xb2d8e820
3809.69,1.0,3,2,2,4,8,0xb2d22601
17108.35,1.0,11,2,2,3,7,0xb2d3caadd
2.11,1.0,6,1,2,3,6,0xb2d846ae
751805.01,3.0,0,4,4,4,12,0xb2d6ad4f
1048.11,2.0,0,1,3,4,8,0x3b9b19fd
452019.68,4.0,14,4,4,3,11,0xb2d57112d
1782656.73,1.0,1,4,2,4,10,0xb2d6feec
710000.08,2.0,19,4,3,2,9,0xb2d5aaa7
100776.48,2.0,67,3,3,1,7,0xb2d31f82d
1316915.64,3.0,63,4,4,2,10,0xb2d478de
5192.64,1.0,184,2,2,1,5,0xb2d1ba42
3415.72,1.0,0,2,2,4,8,0xb2d298b1
244265.13,2.0,160,3,3,1,7,0xb2d8ef0ed
37461.56,1.0,1,2,2,4,8,0xb2d6505c
508357.71,5.0,105,4,4,1,9,0xb2d5c263d
25407.64,1.0,2,2,2,4,8,0xb2d399ea
2016.91,3.0,184,1,4,1,6,0xb2d14ee9d
404468.94,3.0,4,4,4,4,12,0xb2d248aad
1451.35,1.0,10,1,2,3,6,0xb2da0b30
3869.17,1.0,1,2,2,4,8,0xb2d5cfd2
296000.0,2.0,1,3,3,4,10,0xb2da679c
4374.03,1.0,1,2,2,4,8,0xb2d78636
2391.02,1.0,92,1,2,1,4,0xb2d2f188d
333.55,1.0,21,1,2,2,5,0xb2d37839d
105.56,2.0,60,1,3,2,6,0xb2d23563
84176.29,1.0,3,3,2,4,9,0xb2d2ecf0
10.43,1.0,0,1,2,4,7,0xb2d5c96e
5468.3,1.0,11,2,2,3,7,0xb2d4183ed
1140.46,1.0,11,1,2,3,6,0xb2d8f8a2
3.2,1.0,90,1,2,1,4,0xb2d5f1f9d
230082.44,3.0,25,3,4,2,9,0xb2d8c9aa
375430.95,2.0,0,4,3,4,11,0xb2d4732a
2036.16,1.0,1,1,2,4,7,0xb2d5bf75d
423326.47,4.0,8,4,4,3,11,0xb2d1eaea
10000.11,2.0,34,2,3,2,7,0xb2d9209d
206837.33,3.0,41,3,4,2,9,0xb2d10b53d
30.06,1.0,59,1,2,2,5,0xb2d5ca38
622139.22,6.0,34,4,4,2,10,0xb2d271a0d
130694.37,3.0,8,3,4,3,10,0xb2d8ebeb
465015.31,2.0,110,4,3,1,8,0xb2d600d6
139241.0,2.0,11,3,3,3,9,0xb2d5d3d2
272108.19,2.0,10,3,3,3,9,0xb2d57f58d
10000.11,2.0,8,2,3,3,8,0xb2da4a06
1.35,1.0,47,1,2,2,5,0xb2d6b381
161100.05,3.0,1,3,4,4,11,0xb2d912d3d
1533612.97,13.0,4,4,4,4,12,0x3b9adcc5d
301073.91,2.0,35,4,3,2,9,0xb2d9f892
14793.45,1.0,21,2,2,2,6,0xb2d906d4
472037.64,7.0,0,4,4,4,12,0xb2d4339fd
203179.1,5.0,3,3,4,4,11,0xb2d56081
1057658.39,4.0,21,4,4,2,10,0xb2d41444d
28632.44,1.0,6,2,2,3,7,0xb2d42303
462466.69,3.0,10,4,4,3,11,0xb2d53831d
3265.8,1.0,92,2,2,1,5,0xb2d1ae01d
200008.44,2.0,48,3,3,2,8,0xb2d90ca5d
229.47,1.0,16,1,2,2,5,0xb2d4c8f4
36518.5,1.0,9,2,2,3,7,0xb2d28962d
72398.23,2.0,200,3,3,1,7,0xb2d58135
100945.48,2.0,200,3,3,1,7,0xb2d66694
108.86,1.0,38,1,2,2,5,0xb2d9c290
105.57,1.0,28,1,2,2,5,0xb2d9b677
1723.18,1.0,280,1,2,1,4,0xb2d2d15b
1006.98,1.0,125,1,2,1,4,0xb2d595a0
200006.17,2.0,9,3,3,3,9,0xb2d0bc75
803552.63,3.0,7,4,4,3,11,0xb2d9a559
502747.56,3.0,22,4,4,2,10,0xb2d91331d
204668.21,3.0,97,3,4,1,8,0x3b9b36cbd
20370.14,1.0,41,2,2,2,6,0xb2d2ace6
201164.35,5.0,0,3,4,4,11,0x3b9b380bd
130004.12,2.0,221,3,3,1,7,0xb2d6fcde
1606.57,1.0,92,1,2,1,4,0xb2d24e0bd
13270.51,1.0,182,2,2,1,5,0xb2d3ce45d
6047.57,3.0,0,2,4,4,10,0xb2d2be5b
7.0,1.0,2,1,2,4,7,0xb2d868bd
150019.33,3.0,78,3,4,1,8,0xb2d64141d
20019.11,1.0,64,2,2,2,6,0xb2d91f2b
4.51,1.0,61,1,2,2,5,0xb2d14675
10.54,1.0,37,1,2,2,5,0xb2d66082
203829.8,2.0,41,3,3,2,8,0xb2d4b367
73.08,1.0,26,1,2,2,5,0xb2d5b01f
267005.96,6.0,93,3,4,1,8,0xb2d435b7
273556.42,4.0,94,3,4,1,8,0xb2d6bb14
1015.31,1.0,15,1,2,3,6,0xb2d39b25d
429997.06,4.0,24,4,4,2,10,0xb2d16cfbd
60000.63,2.0,46,3,3,2,8,0xb2d9e319
15234.36,1.0,1,2,2,4,8,0xb2d2a20fd
108493.86,1.0,181,3,2,1,6,0xb2d35bc8
1355.46,1.0,184,1,2,1,4,0xb2d2e371d
101206.48,1.0,0,3,2,4,9,0xb2d505de
302131.93,2.0,75,4,3,1,8,0xb2d8e1d6d
277.78,1.0,69,1,2,1,4,0xb2d233f6
1247.24,1.0,4,1,2,4,7,0xb2d6de9c
440000.97,3.0,0,4,4,4,12,0xb2d8e910
482786.1,2.0,3,4,3,4,11,0xb2d4d9f6
20144.11,2.0,41,2,3,2,7,0xb2d6473ad
486344.16,4.0,8,4,4,3,11,0xb2d11b47
575671.69,3.0,2,4,4,4,12,0xb2d1878b
2020.54,1.0,184,1,2,1,4,0xb2d2c94bd
190004.94,2.0,0,3,3,4,10,0xb2d174b1
847.69,5.0,0,1,4,4,9,0x3b9b1004d
1201742.84,1.0,0,4,2,4,10,0xb2d946f4
50932.65,1.0,23,2,2,2,6,0xb2d5d9fad
316222.35,5.0,69,4,4,1,9,0x3b9b32cfd
1330.81,1.0,41,1,2,2,5,0xb2d53af8d
5929.7,1.0,108,2,2,1,5,0xb2d361b6
4015.75,1.0,184,2,2,1,5,0xb2d0f6a6
121614.23,2.0,47,3,3,2,8,0xb2d55277
522000.0,12.0,3,4,4,4,12,0xb2d55c9bd
464561.73,4.0,181,4,4,1,9,0xb2d43b93
555320.81,6.0,0,4,4,4,12,0xb2d27e00d
1273750.0,10.0,9,4,4,3,11,0xb2d0a43fd
35001.19,4.0,76,2,4,1,7,0xb2d6ec91
445992.14,6.0,94,4,4,1,9,0xb2d100a6d
5101.44,4.0,7,2,4,3,9,0xb2d8cde1
8842.81,1.0,5,2,2,3,7,0xb2d6edd8d
500000.0,1.0,0,4,2,4,10,0xb2d94487
0.0,2.0,61,1,3,2,6,0xb2d4dd75
16005.78,1.0,12,2,2,3,7,0xb2d6c0d3
4237.03,1.0,154,2,2,1,5,0xb2d5406e
83093.36,4.0,56,3,4,2,9,0xb2d41a44d
1536.37,2.0,168,1,3,1,5,0xb2d4f98f
181767.08,1.0,4,3,2,4,9,0xb2d56834d
410.0,1.0,4,1,2,4,7,0xb2d6beed
1429774.15,9.0,4,4,4,4,12,0xb2d23a3cd
454895.14,10.0,6,4,4,3,11,0xb2d14c8f
446.15,1.0,0,1,2,4,7,0xb2d33b2b
350000.0,2.0,0,4,3,4,11,0xb2da6bc5
100662.27,6.0,0,3,4,4,11,0xb2d07f11
602007.47,14.0,8,4,4,3,11,0xb2d57992d
4130.55,1.0,18,2,2,2,6,0xb2d2b679d
297.88,1.0,60,1,2,2,5,0xb2d38ca5d
120922.08,7.0,11,3,4,3,10,0xb2d29005
300134.5,7.0,40,4,4,2,10,0xb2d23dced
250018.15,3.0,7,3,4,3,10,0xb2d5c4ed
42642.91,1.0,3,2,2,4,8,0xb2d17119d
325396.84,9.0,0,4,4,4,12,0xb2d06529
1065736.83,10.0,3,4,4,4,12,0xb2d10d72
76684.74,2.0,14,3,3,3,9,0xb2d69e19d
723.58,2.0,0,1,3,4,8,0xb2d13ff4
24589.8,1.0,14,2,2,3,7,0xb2d31945d
60000.63,2.0,35,3,3,2,8,0xb2d9d884
3626.32,1.0,0,2,2,4,8,0x3b9af16d
907133.66,5.0,11,4,4,3,11,0xb2d5e90a
184.94,3.0,92,1,4,1,6,0x3b9b12c7
4050940.5,1.0,31,4,2,2,8,0xb2d87963
840349.51,5.0,0,4,4,4,12,0xb2d4d318d
3849.81,1.0,0,2,2,4,8,0xb2d90e33
200000.0,2.0,0,3,3,4,10,0xb2d58c0d
1213126.2,2.0,1,4,3,4,11,0xb2d22f5fd
1621370.08,3.0,77,4,4,1,9,0xb2d991a2
52986.56,1.0,8,3,2,3,8,0xb2d1da7ed
522256.94,2.0,20,4,3,2,9,0xb2d3fc93d
345.52,1.0,39,1,2,2,5,0xb2d45ccb
2555693.26,3.0,16,4,4,2,10,0xb2d48dc3d
273009.42,5.0,39,3,4,2,9,0xb2d38265
2001133.6,2.0,74,4,3,1,8,0xb2d3a2cdd
66343.33,3.0,48,3,4,2,9,0xb2d52a73d
101074.71,2.0,11,3,3,3,9,0xb2d60666d
122049.97,6.0,1,3,4,4,11,0xb2d1fd0d
100001.33,2.0,75,3,3,1,7,0xb2d13ac4
65279.68,1.0,2,3,2,4,9,0xb2d93490
420575.42,2.0,10,4,3,3,10,0xb2d3ccfd
17.25,1.0,17,1,2,2,5,0xb2d37e05d
8436.01,10.0,0,2,4,4,10,0x3b9af125d
2923.46,1.0,0,2,2,4,8,0xb2d3114a
136816.5,4.0,48,3,4,2,9,0xb2d478f2d
261094.21,3.0,97,3,4,1,8,0xb2d18d1a
12.45,1.0,2,1,2,4,7,0xb2d32ecc
5.63,1.0,12,1,2,3,6,0xb2d5a719d
1298573.88,8.0,6,4,4,3,11,0xb2d4b6dfd
210031.47,4.0,87,3,4,1,8,0xb2d08a03
650402.84,2.0,28,4,3,2,9,0xb2d1baf1d
471153.09,10.0,28,4,4,2,10,0xb2d625c3
20395.22,1.0,184,2,2,1,5,0xb2d3efbad
208.39,2.0,6,1,3,3,7,0xb2d0a63bd
35428.17,1.0,10,2,2,3,7,0xb2d62071
1684349.24,4.0,20,4,4,2,10,0xb2d6ce0c
515000.0,3.0,5,4,4,3,11,0xb2d5f0f9d
16720.73,1.0,49,2,2,2,6,0xb2d390abd
478093.47,4.0,196,4,4,1,9,0xb2d32972
1296.04,1.0,15,1,2,3,6,0xb2d1e0d8
1629451.25,2.0,34,4,3,2,9,0xb2d6db95
327129.11,4.0,62,4,4,2,10,0xb2d4b420d
52883.86,1.0,184,3,2,1,6,0xb2d37a4e
684.12,1.0,9,1,2,3,6,0xb2d4da3a
210278.5,2.0,211,3,3,1,7,0xb2d69847d
210024.7,5.0,60,3,4,2,9,0xb2d68677
230256.45,3.0,27,3,4,2,9,0xb2d2b4d7
209674.64,2.0,263,3,3,1,7,0xb2d5099d
5132.38,1.0,1,2,2,4,8,0xb2d486dbd
155.8,1.0,3,1,2,4,7,0xb2d6fb6c
150007.6,2.0,157,3,3,1,7,0xb2d1f995d
284324.96,3.0,34,3,4,2,9,0xb2d5a1a5d
441305.0,8.0,0,4,4,4,12,0x3b9b4642d
3300.58,1.0,9,2,2,3,7,0xb2d567eed
106183.08,5.0,6,3,4,3,10,0xb2d166c8d
813732.91,36.0,4,4,4,4,12,0x3b9af0ffd
80089.02,2.0,13,3,3,3,9,0xb2d3e5fa
300715.29,4.0,48,4,4,2,10,0xb2d9c5a0
4225.84,1.0,92,2,2,1,5,0xb2d3aea8
722.25,1.0,0,1,2,4,7,0xb2d31578
700024.19,1.0,7,4,2,3,9,0xb2d78399
2098.31,1.0,92,1,2,1,4,0xb2d2141b
20545.13,1.0,14,2,2,3,7,0xb2d3b610d
30000.32,2.0,224,2,3,1,6,0xb2d64303
2443059.18,5.0,9,4,4,3,11,0xb2d1b9ae
4.04,1.0,75,1,2,1,4,0xb2d7694a
700011.71,3.0,8,4,4,3,11,0xb2d6e4e9d
9.49,2.0,84,1,3,1,5,0xb2d0774c
9405.05,1.0,14,2,2,3,7,0xb2d7f067
530000.0,3.0,11,4,4,3,11,0xb2da4c3d
11196071.98,1.0,3,4,2,4,10,0xb2d43c7f
45965.1,1.0,184,2,2,1,5,0xb2d26168d
183066.54,10.0,13,3,4,3,10,0xb2d60576d
16.61,1.0,8,1,2,3,6,0xb2d970b9
325165.95,5.0,161,4,4,1,9,0x3b9acf47d
2.3,1.0,39,1,2,2,5,0xb2d0fdfa
501207.48,19.0,0,4,4,4,12,0xb2d0b646d
140232.72,6.0,1,3,4,4,11,0xb2d649cdd
6345.5,1.0,184,2,2,1,5,0xb2d3afde
90001.67,3.0,45,3,4,2,9,0xb2d0b1b8
1700069.79,19.0,11,4,4,3,11,0xb2d107bdd
500037.71,3.0,21,4,4,2,10,0xb2d9891b
3100.0,2.0,92,2,3,1,6,0xb2d637ac
79885.24,6.0,0,3,4,4,11,0xb2d0937d
1.13,1.0,161,1,2,1,4,0xb2d8d9d5
94436.6,5.0,9,3,4,3,10,0xb2d56980
850119.41,5.0,32,4,4,2,10,0xb2d070e7
104357.3,1.0,10,3,2,3,8,0xb2d6215ed
171.07,2.0,21,1,3,2,6,0xb2d6a438
10172.29,1.0,92,2,2,1,5,0xb2d0a5b5d
150949.48,5.0,38,3,4,2,9,0xb2d56dedd
180070.32,6.0,24,3,4,2,9,0xb2d55f64
300026.7,2.0,13,3,3,3,9,0xb2d16eced
1465.26,1.0,79,1,2,1,4,0xb2d4170b
205111.16,2.0,25,3,3,2,8,0xb2d28f4f
1740426.23,12.0,0,4,4,4,12,0xb2d37fea
398566.19,4.0,3,4,4,4,12,0xb2d17272
110045.45,3.0,6,3,4,3,10,0xb2da1261
1131255.44,7.0,0,4,4,4,12,0xb2d6a4f9
35572.9,1.0,20,2,2,2,6,0xb2d2a474
600212.75,2.0,15,4,3,3,10,0xb2d2bdff
13113.22,1.0,0,2,2,4,8,0xb2d0c9f1
4032.67,1.0,0,2,2,4,8,0xb2d93d7ad
3266.05,1.0,2,2,2,4,8,0xb2d6e941d
7634.15,1.0,117,2,2,1,5,0xb2d4877dd
170271.75,5.0,7,3,4,3,10,0xb2d667dbd
76.11,1.0,0,1,2,4,7,0xb2d4d324
500000.91,2.0,10,4,3,3,10,0xb2d58b7ed
613000.18,4.0,1,4,4,4,12,0xb2d68bb0d
525746.7,7.0,4,4,4,4,12,0xb2d5a93bd
549435.4,4.0,4,4,4,4,12,0xb2d1fee8d
5116.81,1.0,184,2,2,1,5,0xb2d65a76d
504492.04,2.0,116,4,3,1,8,0xb2d51c6c
150059.61,4.0,63,3,4,2,9,0xb2d0e8d2d
121679.33,2.0,167,3,3,1,7,0xb2d50f23
315551.32,2.0,221,4,3,1,8,0xb2d57071d
207827.62,2.0,15,3,3,3,9,0xb2d5b44bd
2979.1,1.0,6,2,2,3,7,0xb2d745a0
48052.66,1.0,46,2,2,2,6,0xb2d3bc60d
10.35,1.0,60,1,2,2,5,0xb2d8c6e7
5937.34,1.0,105,2,2,1,5,0xb2d69929
100036.31,2.0,20,3,3,2,8,0xb2d94d78d
120072.04,2.0,0,3,3,4,10,0xb2d91837d
963844.83,7.0,6,4,4,3,11,0xb2d5dc1f
516013.13,2.0,0,4,3,4,11,0xb2d3a89f
195400.0,4.0,0,3,4,4,11,0xb2d176b2d
100005.75,3.0,21,3,4,2,9,0xb2d53ff1
815606.79,3.0,1,4,4,4,12,0xb2d2bc9ed
302131.5,2.0,62,4,3,2,9,0xb2d9be1c
51272.89,2.0,90,2,3,1,6,0xb2d41047d
310002.77,3.0,0,4,4,4,12,0xb2d0d2a6d
290068.82,7.0,0,3,4,4,11,0x3b9b3c73
29.54,1.0,4,1,2,4,7,0xb2d68142d
2178.98,1.0,7,1,2,3,6,0xb2d1dda8
730232.97,5.0,20,4,4,2,10,0xb2d25b86d
1525048.36,2.0,164,4,3,1,8,0xb2d5d2b6
3728.81,1.0,16,2,2,2,6,0xb2d6a663d
1117.88,1.0,13,1,2,3,6,0xb2d95101
502496.3,3.0,47,4,4,2,10,0xb2d16f9ed
205657.08,2.0,2,3,3,4,10,0xb2d119a6
3984.07,3.0,250,2,4,1,7,0xb2d2c53b
35872.9,1.0,1,2,2,4,8,0xb2d6cc5e
5540.41,1.0,29,2,2,2,6,0xb2d92cd5
672.83,1.0,0,1,2,4,7,0xb2d3119cd
4330.54,3.0,0,2,4,4,10,0x3b9b463ad
211808.6,3.0,27,3,4,2,9,0xb2d57bbc
100003.17,2.0,46,3,3,2,8,0xb2d9db5c
106090.34,4.0,102,3,4,1,8,0xb2d5eda6d
304265.15,2.0,24,4,3,2,9,0xb2d90cb3d
3058.29,1.0,5,2,2,3,7,0xb2d78019
1039735.24,2.0,12,4,3,3,10,0xb2d35158
0.0,1.0,5,1,2,3,6,0xb2d96af0d
14723.7,1.0,7,2,2,3,7,0xb2d6aa69d
100021.52,2.0,4,3,3,4,10,0xb2d22de9d
712.8,1.0,8,1,2,3,6,0xb2d30bcb
1112547.83,3.0,11,4,4,3,11,0xb2d417a3d
62012.48,2.0,47,3,3,2,8,0xb2d69810
2757.09,1.0,184,1,2,1,4,0xb2d2611b
10658.0,1.0,28,2,2,2,6,0xb2d6b7c3d
538784.28,3.0,1,4,4,4,12,0xb2d2cecb
37.04,1.0,41,1,2,2,5,0xb2d6562dd
400004.24,2.0,5,4,3,3,10,0xb2d87b61
10.72,1.0,101,1,2,1,4,0xb2d20a16
1321508.96,4.0,25,4,4,2,10,0xb2d1081fd
15084.72,2.0,25,2,3,2,7,0xb2d68ca9d
25.34,1.0,11,1,2,3,6,0xb2d9acf3
3054.96,1.0,12,2,2,3,7,0xb2d39e80d
352904.2,3.0,5,4,4,3,11,0xb2d0e9b2
3482.3,1.0,0,2,2,4,8,0xb2d6ba23
1922.12,1.0,51,1,2,2,5,0xb2d8e422
3463.53,1.0,0,2,2,4,8,0xb2d6279d
1700050.04,2.0,14,4,3,3,10,0xb2d93135d
100039.61,2.0,39,3,3,2,8,0xb2d232f4
1689.48,1.0,18,1,2,2,5,0xb2d41494d
70005.17,2.0,28,3,3,2,8,0xb2d12720d
1253.26,1.0,10,1,2,3,6,0xb2d4b965d
156729.07,2.0,94,3,3,1,7,0xb2d50ce7d
291347.37,3.0,92,3,4,1,8,0xb2d0aaefd
50861.47,2.0,1,2,3,4,9,0xb2d5881cd
1973.73,2.0,124,1,3,1,5,0xb2d07de8d
100002.11,2.0,60,3,3,2,8,0xb2d9bc59
15.06,2.0,27,1,3,2,6,0xb2d6afa2
10.21,1.0,4,1,2,4,7,0xb2d54bafd
10203.49,1.0,92,2,2,1,5,0xb2d55d31
5566.46,1.0,0,2,2,4,8,0xb2da38cc
2241064.14,8.0,15,4,4,3,11,0xb2d0ec6fd
1.11,1.0,18,1,2,2,5,0xb2d632bed
1035583.09,2.0,135,4,3,1,8,0xb2d6689b
510818.46,2.0,11,4,3,3,10,0xb2d708a5
24.33,1.0,61,1,2,2,5,0xb2d6693c
541029.98,7.0,6,4,4,3,11,0xb2d25ff2
450013.21,4.0,1,4,4,4,12,0xb2d25c83
1832.66,1.0,13,1,2,3,6,0xb2d261dcd
280000.0,2.0,6,3,3,3,9,0xb2d2085cd
439845.43,2.0,66,4,3,2,9,0xb2d5e99cd
2462.35,1.0,5,1,2,3,6,0xb2d3bf0ed
4265.25,1.0,0,2,2,4,8,0xb2d2555b
13702.86,1.0,11,2,2,3,7,0xb2d5c19fd
160300.93,2.0,8,3,3,3,9,0xb2d6dfd1
0.85,1.0,1,1,2,4,7,0xb2d53509
208.62,1.0,15,1,2,3,6,0xb2d69360d
1031913.37,3.0,26,4,4,2,10,0xb2d24b06d
106.4,1.0,112,1,2,1,4,0xb2d2926fd
100012.5,2.0,1,3,3,4,10,0xb2d6fd1dd
5354.8,2.0,6,2,3,3,8,0x3b9b39bc
200162.44,2.0,26,3,3,2,8,0xb2d6eb80
320300.5,3.0,3,4,4,4,12,0xb2d8902fd
73475.24,3.0,15,3,4,3,10,0xb2d55a17
60069.24,2.0,221,3,3,1,7,0xb2d116dbd
11454.01,1.0,14,2,2,3,7,0xb2d6d51dd
82205.48,2.0,13,3,3,3,9,0xb2d5dcbcd
108.36,1.0,62,1,2,2,5,0xb2d6b484
2317.51,2.0,0,1,3,4,8,0x3b9b38f3d
336644.75,4.0,0,4,4,4,12,0x3b9b4859d
277037.82,3.0,80,3,4,1,8,0xb2d62c4bd
302698.6,3.0,143,4,4,1,9,0xb2d55f41d
20017.13,1.0,0,2,2,4,8,0xb2d60deb
20012.45,6.0,125,2,4,1,7,0xb2d0b01fd
3380.94,1.0,1,2,2,4,8,0xb2d8586f
154749.49,3.0,0,3,4,4,11,0xb2d4103a
1900186.49,5.0,0,4,4,4,12,0xb2d4554cd
50315.97,2.0,47,2,3,2,7,0xb2d6e76fd
29284.93,1.0,0,2,2,4,8,0xb2d69e9e
686133.95,3.0,1,4,4,4,12,0xb2d5277bd
1184.73,3.0,126,1,4,1,6,0x3b9b28e2
3200073.47,3.0,21,4,4,2,10,0xb2d3af4d
410001.6,6.0,45,4,4,2,10,0xb2d10727d
54.81,1.0,0,1,2,4,7,0xb2d3f5b2
35773.89,6.0,0,2,4,4,10,0xb2d186c3d
10001.36,8.0,3,2,4,4,10,0x3b9b406d
500060.49,3.0,13,4,4,3,11,0xb2d9e90f
61789.0,1.0,82,3,2,1,6,0xb2d6e243d
10498.91,1.0,20,2,2,2,6,0xb2da1fff
4288807.24,4.0,73,4,4,1,9,0xb2d27685
1204262.86,3.0,18,4,4,2,10,0xb2d9147cd
212.34,1.0,42,1,2,2,5,0xb2d11ab5
310682.36,2.0,1,4,3,4,11,0xb2d0d780
664030.81,10.0,0,4,4,4,12,0xb2d61052d
40300.94,1.0,1,2,2,4,8,0xb2d14b7bd
146903.01,1.0,10,3,2,3,8,0xb2d6f49a
18531.65,1.0,92,2,2,1,5,0x3b9adc68d
1244.43,1.0,14,1,2,3,6,0x3b9b320b
520039.25,4.0,3,4,4,4,12,0xb2d68078
9.09,1.0,34,1,2,2,5,0xb2d62493
70000.74,2.0,6,3,3,3,9,0xb2d96b47d
1311.92,1.0,122,1,2,1,4,0xb2d649a0
7025.39,2.0,10,2,3,3,8,0xb2d0aef6
563.6,1.0,2,1,2,4,7,0xb2d2d6fcd
16.84,1.0,60,1,2,2,5,0xb2d2154bd
71971.59,2.0,74,3,3,1,7,0xb2d657ffd
1084.53,1.0,3,1,2,4,7,0xb2d17755d
2.82,1.0,21,1,2,2,5,0xb2d640f3
310014.3,3.0,48,4,4,2,10,0xb2d99c17
223348.84,5.0,0,3,4,4,11,0xb2d21113d
813237.36,11.0,3,4,4,4,12,0xb2d0f329d
1483.08,2.0,231,1,3,1,5,0xb2d08255d
1422.41,1.0,9,1,2,3,6,0xb2d2ab20
494.87,1.0,60,1,2,2,5,0xb2d5bcd2d
552.53,1.0,19,1,2,2,5,0xb2d2c7ae
2003.29,1.0,166,1,2,1,4,0xb2d8e5a2d
182047.21,5.0,10,3,4,3,10,0xb2d085c6
95.25,1.0,13,1,2,3,6,0xb2d20be0
240907.69,2.0,15,3,3,3,9,0xb2d56c4dd
310021.19,4.0,11,4,4,3,11,0xb2d5107ad
1943.97,1.0,10,1,2,3,6,0xb2d8ce04d
87.51,1.0,20,1,2,2,5,0xb2d4ad5ed
403585.01,3.0,61,4,4,2,10,0xb2d8346c
1161.7,1.0,14,1,2,3,6,0xb2d2df70d
1427.66,1.0,10,1,2,3,6,0xb2d8f2dd
50002.22,2.0,116,2,3,1,6,0xb2d6ac17d
1010010.24,3.0,0,4,4,4,12,0xb2d90e5a
2032.05,1.0,0,1,2,4,7,0xb2d5302bd
6495.83,1.0,63,2,2,2,6,0xb2d2dbf7d
35280.36,2.0,0,2,3,4,9,0xb2d2bc8c
253245.81,2.0,1,3,3,4,10,0xb2d24796d
100845.19,2.0,19,3,3,2,8,0xb2d63dec
43427.81,1.0,3,2,2,4,8,0xb2d62e15
53657.3,1.0,9,3,2,3,8,0xb2d3c0b5
310021.31,2.0,17,4,3,2,9,0xb2d56581
100565.1,2.0,83,3,3,1,7,0xb2d6294a
18257.93,1.0,22,2,2,2,6,0xb2d8f0f1
763.63,1.0,33,1,2,2,5,0xb2d3a35fd
2.93,1.0,17,1,2,2,5,0xb2d0d581
205002.56,5.0,3,3,4,4,11,0xb2d8f78dd
119922.15,2.0,0,3,3,4,10,0xb2d421af
72.14,1.0,5,1,2,3,6,0xb2d8c89b
570035.29,4.0,7,4,4,3,11,0xb2d31dbdd
400098.77,3.0,11,4,4,3,11,0xb2d69b19
16.89,1.0,55,1,2,2,5,0xb2d9b58b
550073.59,4.0,31,4,4,2,10,0xb2d3f590d
7565.71,1.0,1,2,2,4,8,0xb2d964a3
1527989.22,2.0,125,4,3,1,8,0xb2d62832
128373.0,1.0,4,3,2,4,9,0xb2d26775
1006214.51,2.0,1,4,3,4,11,0xb2d8ffc0d
400019.63,3.0,8,4,4,3,11,0xb2d571a9d
13.68,1.0,62,1,2,2,5,0xb2d6045e
117073.96,3.0,19,3,4,2,9,0xb2d0ccded
659013.43,8.0,11,4,4,3,11,0xb2d08373
63551.74,6.0,0,3,4,4,11,0xb2d1c01cd
20079.49,1.0,184,2,2,1,5,0xb2d601e3
40008.64,2.0,10,2,3,3,8,0xb2d94ee3d
340.7,1.0,69,1,2,1,4,0xb2d6ece4d
172608.56,2.0,0,3,3,4,10,0xb2d68531d
200020.88,2.0,17,3,3,2,8,0xb2d98c1f
231167.27,4.0,77,3,4,1,8,0xb2d10fcdd
1519.67,1.0,0,1,2,4,7,0xb2d3b7cbd
50012.76,2.0,200,2,3,1,6,0xb2d56e9ed
0.08,1.0,3,1,2,4,7,0xb2d27d61
204119.53,3.0,0,3,4,4,11,0xb2d14d4ad
2142.05,1.0,35,1,2,2,5,0xb2d65a78
1135082.99,4.0,4,4,4,4,12,0xb2d6429cd
1535.33,1.0,0,1,2,4,7,0xb2d6ced3d
5054.14,1.0,184,2,2,1,5,0xb2d29fac
41.16,1.0,21,1,2,2,5,0xb2d0c16cd
1012.93,1.0,184,1,2,1,4,0xb2d20c52
503910.37,3.0,32,4,4,2,10,0xb2d971f9d
409954.61,2.0,215,4,3,1,8,0xb2d776e7d
471544.24,5.0,0,4,4,4,12,0xb2d2de19d
1525.54,1.0,124,1,2,1,4,0xb2d598e6
131080.77,2.0,25,3,3,2,8,0xb2d13934
77722.05,1.0,6,3,2,3,8,0xb2d473ad
154.89,1.0,8,1,2,3,6,0xb2da2c6a
403821.13,3.0,41,4,4,2,10,0xb2d657b8
9813.04,1.0,0,2,2,4,8,0xb2d9741c
301272.91,5.0,11,4,4,3,11,0xb2d4f6b8
332.94,1.0,40,1,2,2,5,0xb2d92382d
311263.0,4.0,3,4,4,4,12,0xb2d288e3d
2414.6,1.0,9,1,2,3,6,0xb2d59d90d
6001.52,1.0,20,2,2,2,6,0xb2d9b962
85007.12,2.0,12,3,3,3,9,0xb2d7beae
67737.23,1.0,98,3,2,1,6,0xb2d37bef
2292.07,1.0,0,1,2,4,7,0xb2d8ea23
202278.4,3.0,32,3,4,2,9,0xb2d60b9b
182531.59,2.0,15,3,3,3,9,0xb2d58b9d
6.12,1.0,14,1,2,3,6,0xb2d69c85
420354.46,4.0,0,4,4,4,12,0xb2d8db98d
200094.07,2.0,16,3,3,2,8,0xb2d6960fd
5690.35,6.0,92,2,4,1,7,0x3b9b13ec
323216.89,2.0,134,4,3,1,8,0xb2d5a123
117.03,1.0,124,1,2,1,4,0xb2d39290d
125483.3,3.0,6,3,4,3,10,0xb2d188a2d
398.0,1.0,0,1,2,4,7,0xb2d0f49f
164938.09,1.0,100,3,2,1,6,0xb2d62c11
13758.65,1.0,12,2,2,3,7,0xb2d2d0a2
5255.42,1.0,11,2,2,3,7,0xb2d3f733
124003.28,4.0,34,3,4,2,9,0xb2d939fdd
27416.07,1.0,0,2,2,4,8,0xb2d6c2ce
215340.95,2.0,231,3,3,1,7,0xb2d2a737d
25025.03,2.0,101,2,3,1,6,0xb2d6466ed
3522.28,1.0,1,2,2,4,8,0xb2d6bfd7
4519.87,1.0,20,2,2,2,6,0xb2d62d54
490009.29,6.0,12,4,4,3,11,0xb2d952bbd
475000.0,2.0,3,4,3,4,11,0xb2d96e14
105102.73,2.0,123,3,3,1,7,0xb2d1a3e9d
200050.32,2.0,14,3,3,3,9,0xb2d5d05ad
70001.53,2.0,12,3,3,3,9,0xb2d3c414d
2000000.0,2.0,15,4,3,3,10,0xb2da2608
2429.59,1.0,80,1,2,1,4,0xb2d645f4
50017.21,4.0,172,2,4,1,7,0xb2d7d4f4
500000.83,3.0,26,4,4,2,10,0xb2d7833cd
376415.84,5.0,30,4,4,2,10,0xb2d0c1b4d
418.0,1.0,29,1,2,2,5,0xb2d97e53
1730842.25,2.0,2,4,3,4,11,0xb2da3419
96988.61,2.0,26,3,3,2,8,0xb2d3d67f
4856.75,1.0,42,2,2,2,6,0xb2d458e5
5557.97,1.0,2,2,2,4,8,0xb2d65cefd
113603.75,4.0,18,3,4,2,9,0xb2d57a88d
896416.11,18.0,7,4,4,3,11,0xb2d53029d
8.66,1.0,10,1,2,3,6,0xb2d6b1fe
3040.04,1.0,184,2,2,1,5,0xb2d3be37d
184771.84,1.0,22,3,2,2,7,0xb2d5ad31
7.19,1.0,27,1,2,2,5,0xb2d61627d
51474.55,2.0,67,2,3,1,6,0xb2d640a6
166316.07,8.0,34,3,4,2,9,0x3b9b3899d
400000.0,3.0,2,4,4,4,12,0xb2d8f888
2239.76,1.0,0,1,2,4,7,0xb2d3350f
400008.09,3.0,28,4,4,2,10,0xb2d25d9a
505407.91,5.0,84,4,4,1,9,0xb2d655c8
107048.61,5.0,15,3,4,3,10,0xb2d10405
13686.68,1.0,0,2,2,4,8,0xb2d2078d
50006.25,2.0,153,2,3,1,6,0xb2d606b4
173663.06,2.0,20,3,3,2,8,0xb2d34471
30076.31,1.0,2,2,2,4,8,0xb2d8d2fbd
509458.66,2.0,10,4,3,3,10,0xb2d9cc2c
82.47,2.0,67,1,3,1,5,0xb2d2314c
2.89,1.0,35,1,2,2,5,0xb2d29866
3.0,1.0,7,1,2,3,6,0xb2d5b368
10397.66,1.0,8,2,2,3,7,0xb2d5f1be
6637.38,1.0,7,2,2,3,7,0xb2d29dbbd
4220000.0,19.0,0,4,4,4,12,0xb2d56a2a
58253.51,2.0,0,3,3,4,10,0xb2d09c69
54689.37,1.0,18,3,2,2,7,0xb2d5da54d
0.0,1.0,1,1,2,4,7,0xb2d604b9
50079.63,2.0,27,2,3,2,7,0xb2d28496d
3004.34,1.0,146,2,2,1,5,0xb2d6924d
8231.03,1.0,235,2,2,1,5,0xb2d166f8d
44.79,1.0,30,1,2,2,5,0xb2d37197
404841.69,3.0,19,4,4,2,10,0xb2d63951
61092.67,2.0,209,3,3,1,7,0xb2d5b152
131472.28,4.0,77,3,4,1,8,0xb2d59b24d
6969.14,1.0,4,2,2,4,8,0xb2d37aa9
630754.03,5.0,28,4,4,2,10,0xb2d63cf7d
4347.48,1.0,9,2,2,3,7,0xb2d559b8
345183.62,4.0,46,4,4,2,10,0xb2d1c1a4
52006.04,2.0,37,2,3,2,7,0xb2d56267
450288.37,3.0,106,4,4,1,9,0xb2d8e08ad
1200050.22,2.0,21,4,3,2,9,0xb2d6e255
13407.58,1.0,3,2,2,4,8,0xb2d640ff
104839.6,3.0,97,3,4,1,8,0xb2d4b8b4d
100276.38,2.0,18,3,3,2,8,0xb2d29ae5
90.14,1.0,15,1,2,3,6,0xb2d9d8f4
14337.34,1.0,8,2,2,3,7,0xb2d5d2bf
50051.22,1.0,100,2,2,1,5,0xb2d4e5af
59363.15,1.0,3,3,2,4,9,0xb2d96e84d
32.71,1.0,60,1,2,2,5,0xb2d3042b
36.09,1.0,4,1,2,4,7,0xb2d94e12d
108.5,1.0,1,1,2,4,7,0xb2d743cc
434779.31,3.0,207,4,4,1,9,0xb2d25f48d
3779.17,1.0,12,2,2,3,7,0xb2d0bdbd
3741.67,1.0,12,2,2,3,7,0xb2d5cc92
210120.51,3.0,52,3,4,2,9,0xb2d10b13
301097.41,2.0,5,4,3,3,10,0xb2d87a17
10679776.82,6.0,15,4,4,3,11,0xb2d0e9ad
74232.53,1.0,11,3,2,3,8,0xb2d5a503d
290550.5,4.0,0,3,4,4,11,0xb2d5ab9c
26.48,2.0,20,1,3,2,6,0xb2d4b6ca
1491.55,1.0,0,1,2,4,7,0xb2d6e7dd
4659335.85,3.0,18,4,4,2,10,0xb2d1dcff
10159.81,1.0,0,2,2,4,8,0xb2d2aab4
1733530.83,9.0,19,4,4,2,10,0xb2d621d7
105824.56,1.0,26,3,2,2,7,0xb2d61c02
3943.88,1.0,16,2,2,2,6,0xb2d8edc8
50002.11,2.0,14,2,3,3,8,0xb2da2ee2
270060.3,5.0,21,3,4,2,9,0xb2d08a03d
390008.5,12.0,25,4,4,2,10,0xb2d209d4
22.66,1.0,34,1,2,2,5,0xb2d78dcad
380003.4,4.0,30,4,4,2,10,0xb2d6172ad
5.76,2.0,63,1,3,2,6,0xb2d330a6d
18533.15,1.0,62,2,2,2,6,0xb2d8f8e9
140021.53,3.0,20,3,4,2,9,0xb2d90bb0
6063.1,1.0,2,2,2,4,8,0xb2d91611
74.22,1.0,1,1,2,4,7,0xb2d925a0
881721.89,10.0,3,4,4,4,12,0xb2d0a515d
494309.43,5.0,1,4,4,4,12,0xb2d44a69d
120005.58,2.0,18,3,3,2,8,0xb2d6ee89d
851000.0,77.0,0,4,4,4,12,0xb2d23940d
3374.17,1.0,40,2,2,2,6,0xb2d6c638d
300009.52,2.0,92,3,3,1,7,0xb2d65fadd
68040.19,3.0,83,3,4,1,8,0xb2d66a12d
110.56,1.0,18,1,2,2,5,0xb2d9bfd9
10.89,1.0,0,1,2,4,7,0xb2d68e9ad
2163.17,1.0,0,1,2,4,7,0xb2d6bd73d
578848.82,3.0,0,4,4,4,12,0xb2d41a32
53517.59,1.0,35,3,2,2,7,0xb2d61fd2d
210012.62,3.0,0,3,4,4,11,0xb2d8e510
7370.53,5.0,0,2,4,4,10,0xb2d1bedd
700187.98,3.0,139,4,4,1,9,0xb2d5bdaad
91719.4,2.0,40,3,3,2,8,0xb2d102ccd
1030.38,1.0,10,1,2,3,6,0xb2d785f1
20438.9,1.0,3,2,2,4,8,0xb2d60755
200000.0,2.0,6,3,3,3,9,0xb2da59f2
601.9,6.0,0,1,4,4,9,0x3b9b46ca
1180000.04,6.0,3,4,4,4,12,0xb2d116e2
1602.43,1.0,92,1,2,1,4,0xb2d1fb2d
701139.39,11.0,0,4,4,4,12,0xb2d08ded
500000.0,3.0,4,4,4,4,12,0xb2da36d6
512592.08,4.0,1,4,4,4,12,0xb2d42affd
101133.47,1.0,2,3,2,4,9,0xb2d29ae5d
1000000.13,2.0,48,4,3,2,9,0xb2d10e08
170098.58,3.0,1,3,4,4,11,0xb2d51553
4866867.42,4.0,24,4,4,2,10,0xb2d5d9c9
20435.71,2.0,48,2,3,2,7,0xb2d5fd7bd
4154.43,1.0,5,2,2,3,7,0xb2d0e70b
1015.48,1.0,92,1,2,1,4,0xb2d0feb4
195000.0,1.0,3,3,2,4,9,0xb2d96212d
112029.1,2.0,151,3,3,1,7,0xb2d2d332
302.6,1.0,0,1,2,4,7,0xb2d38dfad
140010.72,3.0,26,3,4,2,9,0xb2d4f129d
119544.15,12.0,0,3,4,4,11,0xb2d0b6ff
228290.98,4.0,21,3,4,2,9,0xb2d557d4d
185685.53,2.0,104,3,3,1,7,0xb2d7bd1e
462.41,1.0,7,1,2,3,6,0xb2d954e8
270982.79,2.0,184,3,3,1,7,0xb2d20247
919.32,1.0,10,1,2,3,6,0xb2d2788b
497372.91,2.0,110,4,3,1,8,0xb2d15a11d
72482.77,3.0,3,3,4,4,11,0xb2d58e24d
634794.07,5.0,0,4,4,4,12,0xb2d5e939d
4870.52,46.0,1,2,4,4,10,0xb2d4a6cc
54.88,1.0,74,1,2,1,4,0xb2d20f61
4060.04,1.0,184,2,2,1,5,0xb2d25bce
30668.21,1.0,29,2,2,2,6,0xb2d749c1
65002.95,3.0,167,3,4,1,8,0xb2d4a17a
2392.81,1.0,126,1,2,1,4,0xb2d5e667
390.28,1.0,12,1,2,3,6,0xb2d327e2
50907.39,2.0,1,2,3,4,9,0xb2d64e6f
1112009.22,8.0,6,4,4,3,11,0xb2d91447
200004.22,2.0,46,3,3,2,8,0xb2d9dee4
20294.57,3.0,0,2,4,4,10,0xb2d6d87fd
170107.67,3.0,0,3,4,4,11,0xb2d180a0d
2186405.55,7.0,6,4,4,3,11,0xb2d19a8cd
325146.13,2.0,132,4,3,1,8,0xb2d3d831
18345.43,1.0,0,2,2,4,8,0xb2d16eead
18161.42,1.0,3,2,2,4,8,0xb2d31d13
29200.14,1.0,6,2,2,3,7,0xb2d6a66cd
4981492.21,13.0,1,4,4,4,12,0xb2d552cdd
104.94,1.0,10,1,2,3,6,0xb2d36cf4
80070.46,4.0,18,3,4,2,9,0xb2d5f6e1
300042.21,2.0,1,3,3,4,10,0xb2d283bd
310315.17,5.0,0,4,4,4,12,0xb2d1c59ed
4142.27,1.0,92,2,2,1,5,0xb2d20416
1001.17,1.0,121,1,2,1,4,0xb2d919de
503014.68,4.0,42,4,4,2,10,0xb2d103ead
515.18,1.0,15,1,2,3,6,0xb2d9778f
9094.98,1.0,5,2,2,3,7,0xb2d392b9
18483.75,2.0,92,2,3,1,6,0x3b9b37ebd
509884.28,2.0,125,4,3,1,8,0xb2d57c69
55646.91,1.0,0,3,2,4,9,0xb2d627f9
3289.73,1.0,29,2,2,2,6,0xb2d28597
4215.22,1.0,1,2,2,4,8,0xb2d9a459
370825.26,2.0,0,4,3,4,11,0xb2d210ecd
500786.27,1.0,9,4,2,3,9,0xb2d478c7d
30.07,1.0,22,1,2,2,5,0xb2d35153
1148.01,1.0,12,1,2,3,6,0xb2d56d01
64019.37,1.0,18,3,2,2,7,0xb2d5d489
320979.35,4.0,47,4,4,2,10,0xb2d3ca4b
1219.75,1.0,92,1,2,1,4,0xb2d3465ad
8.25,1.0,7,1,2,3,6,0xb2d2e32b
87.59,1.0,69,1,2,1,4,0xb2d1b6c0
4505.77,1.0,19,2,2,2,6,0xb2d95701
3852.27,1.0,9,2,2,3,7,0xb2d6cef2
106.52,1.0,13,1,2,3,6,0xb2d6182d
60134.63,2.0,42,3,3,2,8,0xb2d34ad0
604263.14,5.0,32,4,4,2,10,0xb2d654c6
2611641.72,3.0,23,4,4,2,10,0xb2d22963d
205492.63,1.0,184,3,2,1,6,0xb2d0e291d
0.82,1.0,38,1,2,2,5,0xb2d1bdee
50002.64,2.0,55,2,3,2,7,0xb2d8fc82d
1300045.39,3.0,20,4,4,2,10,0xb2d8e6da
251003.18,9.0,46,3,4,2,9,0xb2d41a3c
6021.38,1.0,0,2,2,4,8,0xb2d2b4b4
501782.58,3.0,37,4,4,2,10,0xb2d8d318d
459827.87,5.0,0,4,4,4,12,0xb2d4cbd8
390008.07,4.0,0,4,4,4,12,0xb2d502ad
400016.91,2.0,126,4,3,1,8,0xb2d32a43d
3261.21,1.0,95,2,2,1,5,0xb2d132c1d
10122.24,1.0,11,2,2,3,7,0xb2d63587d
52026770.24,5.0,4,4,4,4,12,0xb2d6ccd5d
11528.9,1.0,3,2,2,4,8,0xb2d285bd
243752.62,4.0,18,3,4,2,9,0xb2d07fe4d
423461.95,2.0,13,4,3,3,10,0xb2d6cbc1
1030645.78,8.0,8,4,4,3,11,0xb2d4e80e
1419.27,1.0,0,1,2,4,7,0xb2d60c52
200000.4,2.0,20,3,3,2,8,0xb2d238f8d
200000.0,2.0,20,3,3,2,8,0xb2d78e0e
20000.21,2.0,77,2,3,1,6,0xb2d9931c
300003.17,2.0,6,3,3,3,9,0xb2d96bb3d
125000.0,3.0,8,3,4,3,10,0xb2d1abb8
2522.6,1.0,16,1,2,2,5,0xb2d77668
501035.51,4.0,7,4,4,3,11,0xb2d21292d
4.17,1.0,1,1,2,4,7,0xb2d22ef7
20181.9,3.0,3,2,4,4,10,0xb2d5c19d
40002.76,3.0,25,2,4,2,8,0xb2d7080e
4531.93,1.0,236,2,2,1,5,0xb2d2987dd
572486.32,2.0,0,4,3,4,11,0xb2d2962bd
130110.39,2.0,90,3,3,1,7,0xb2d1a224d
40182.37,1.0,12,2,2,3,7,0xb2d3c1ce
6766.7,1.0,184,2,2,1,5,0xb2d17422
42095.25,4.0,33,2,4,2,8,0xb2d1991d
592000.9,8.0,1,4,4,4,12,0xb2d0b4b1
33201.3,1.0,10,2,2,3,7,0xb2d6c4b6d
50000.53,2.0,48,2,3,2,7,0xb2d9dc03
2269.73,1.0,1,1,2,4,7,0xb2d2a1f3
50000.53,2.0,18,2,3,2,7,0xb2da320c
900000.0,5.0,9,4,4,3,11,0xb2d8cdb0
301424.66,2.0,42,4,3,2,9,0xb2d5b5bcd
302951.41,2.0,4,4,3,4,11,0xb2d953ac
466532.79,4.0,8,4,4,3,11,0xb2d23a72
273.74,1.0,65,1,2,2,5,0xb2d91c72d
430091.13,5.0,19,4,4,2,10,0xb2d5b29bd
0.1,2.0,62,1,3,2,6,0xb2d0c15f
5322.19,1.0,92,2,2,1,5,0xb2d169ab
400010.66,2.0,23,4,3,2,9,0xb2d98715
2649.28,2.0,184,1,3,1,5,0x3b9b2eeb
260268.91,2.0,0,3,3,4,10,0xb2d42de7
22313.49,1.0,7,2,2,3,7,0xb2d31d98
63172.94,6.0,0,3,4,4,11,0xb2d57285d
200000.0,2.0,18,3,3,2,8,0xb2d958ae
362633.81,2.0,32,4,3,2,9,0xb2d2cd82d
56035.74,1.0,28,3,2,2,7,0xb2d14e1a
9060.62,1.0,184,2,2,1,5,0xb2d0f2dbd
1577.66,1.0,92,1,2,1,4,0xb2d42426d
703974.57,6.0,6,4,4,3,11,0xb2d4ea01d
70001.88,4.0,39,3,4,2,9,0xb2d57aa7d
5731.08,1.0,1,2,2,4,8,0xb2d69626d
57971.85,2.0,14,3,3,3,9,0xb2d0f8d3
1393033.15,17.0,6,4,4,3,11,0xb2d175e6d
43.12,1.0,0,1,2,4,7,0xb2d83b16
60.38,1.0,35,1,2,2,5,0xb2d923f7
80000.84,2.0,92,3,3,1,7,0xb2d66575d
106.66,1.0,2,1,2,4,7,0xb2d2a2c0d
60.56,2.0,1,1,3,4,8,0xb2da4eec
120007.99,3.0,76,3,4,1,8,0xb2d4f33ad
140041.68,2.0,129,3,3,1,7,0xb2d35ae5
1019416.52,16.0,4,4,4,4,12,0xb2d4f595d
118206.01,4.0,5,3,4,3,10,0xb2d5c5eb
200006.23,3.0,0,3,4,4,11,0xb2d93f6f
650119.55,5.0,20,4,4,2,10,0xb2d188e7
501009.18,3.0,63,4,4,2,10,0xb2d1d281d
10008.07,1.0,33,2,2,2,6,0xb2d41a90d
1095.53,1.0,16,1,2,2,5,0xb2d683ddd
400998.89,3.0,166,4,4,1,9,0xb2d49265d
1989231.73,1.0,0,4,2,4,10,0xb2d9277fd
91053.46,4.0,1,3,4,4,11,0xb2d949a0d
2592336.5,5.0,0,4,4,4,12,0xb2d14235d
14733.54,1.0,184,2,2,1,5,0xb2d4edf0
4176.75,1.0,150,2,2,1,5,0xb2d5dfb9d
28.34,1.0,2,1,2,4,7,0xb2d4f813d
332113.24,5.0,4,4,4,4,12,0xb2d64641
1586.86,1.0,1,1,2,4,7,0xb2d2ef40d
60004.36,2.0,59,3,3,2,8,0xb2d63ca5
700590.15,5.0,11,4,4,3,11,0xb2d6a96b
140011.05,3.0,14,3,4,3,10,0xb2d5b1de
30248.54,2.0,108,2,3,1,6,0xb2d4b50b
494000.44,8.0,3,4,4,4,12,0xb2d5568d
240.81,1.0,0,1,2,4,7,0xb2d78cfc
421024.26,7.0,4,4,4,4,12,0xb2d58dd7d
731106.1,8.0,11,4,4,3,11,0xb2d5ac00d
10050.06,1.0,92,2,2,1,5,0xb2d0aca9
0.58,1.0,19,1,2,2,5,0xb2d99866
100020.48,2.0,12,3,3,3,9,0xb2d309d3
133428.96,2.0,12,3,3,3,9,0xb2d6261b
200088.07,6.0,82,3,4,1,8,0xb2d2d916
3302.07,1.0,0,2,2,4,8,0xb2d5290e
3570.9,3.0,184,2,4,1,7,0xb2d06457
223013.1,2.0,14,3,3,3,9,0xb2d17e93d
10355.97,2.0,92,2,3,1,6,0xb2d62ca5d
17.21,1.0,73,1,2,1,4,0xb2d7806c
150004.57,3.0,96,3,4,1,8,0xb2d5b72ed
20161.3,1.0,0,2,2,4,8,0xb2d45cd4d
30157.02,1.0,179,2,2,1,5,0xb2d4debdd
82178.64,3.0,3,3,4,4,11,0xb2d5cbd5d
4045592.39,1.0,0,4,2,4,10,0x3b9b2c5ed
788030.86,8.0,108,4,4,1,9,0x3b9b4865d
281.5,1.0,6,1,2,3,6,0xb2d2d18e
6.61,1.0,1,1,2,4,7,0xb2d69c85d
500004.03,2.0,11,4,3,3,10,0xb2d63bf4d
2014221.74,2.0,13,4,3,3,10,0xb2d6ddc1
9.26,1.0,21,1,2,2,5,0xb2d68e3e
571944.17,2.0,5,4,3,3,10,0xb2d6aacbd
100005.37,2.0,151,3,3,1,7,0xb2d252ad
105102.23,2.0,0,3,3,4,10,0xb2d2c6ed
5382.62,1.0,2,2,2,4,8,0xb2d27c5d
706484.69,6.0,0,4,4,4,12,0xb2d06505
123365.01,2.0,136,3,3,1,7,0xb2d22b14d
2902.5,1.0,3,2,2,4,8,0xb2d23479
329.86,1.0,9,1,2,3,6,0xb2d6a500
29.51,1.0,0,1,2,4,7,0xb2d402f0d
516997.5,2.0,228,4,3,1,8,0xb2d56e6dd
27.69,1.0,42,1,2,2,5,0xb2d56c08
53106.35,2.0,60,3,3,2,8,0xb2d5acb7
270021.76,5.0,16,3,4,2,9,0xb2d39bfed
1188.66,1.0,17,1,2,2,5,0xb2d1ea21
701782.13,4.0,30,4,4,2,10,0xb2d6abb9
171.12,1.0,0,1,2,4,7,0xb2d31ddc
14127.97,1.0,0,2,2,4,8,0xb2d6ab41
680078.2,6.0,13,4,4,3,11,0xb2d68707
267021.38,2.0,31,3,3,2,8,0xb2d21f2a
403.16,1.0,16,1,2,2,5,0xb2d0cfbe
70003.4,2.0,91,3,3,1,7,0xb2d5b827
67.72,1.0,4,1,2,4,7,0xb2d113e0d
50022.17,2.0,52,2,3,2,7,0xb2d17b64
256737.17,2.0,0,3,3,4,10,0xb2d24c24d
33213.95,1.0,12,2,2,3,7,0xb2d5066ed
71.5,1.0,7,1,2,3,6,0xb2d5f625d
9998.71,1.0,25,2,2,2,6,0xb2d57e7e
97319.89,1.0,0,3,2,4,9,0xb2d315b2d
172923.51,1.0,20,3,2,2,7,0xb2d48f7fd
6.87,1.0,0,1,2,4,7,0xb2d91349d
600000.0,2.0,29,4,3,2,9,0xb2da0a75
5000.53,1.0,20,2,2,2,6,0xb2d92faa
90001.68,3.0,147,3,4,1,8,0xb2d1b19dd
4669.4,2.0,7,2,3,3,8,0xb2d6b1a7
390013.14,2.0,186,4,3,1,8,0xb2d84de5d
326399.7,2.0,53,4,3,2,9,0xb2d21583d
372000.0,2.0,6,4,3,3,10,0xb2da4ea2
12.52,1.0,7,1,2,3,6,0xb2d91ea2
350574.92,2.0,9,4,3,3,10,0xb2d7ebdd
1.39,1.0,26,1,2,2,5,0xb2d3c2f1d
10033.64,1.0,45,2,2,2,6,0xb2d5ec4a
6419.85,1.0,92,2,2,1,5,0xb2d27623d
369183.88,7.0,3,4,4,4,12,0xb2d1910ed
780170.68,5.0,4,4,4,4,12,0xb2d13947d
268000.0,2.0,4,3,3,4,10,0xb2d9794cd
14284.33,1.0,2,2,2,4,8,0xb2d2b5cc
60.7,1.0,28,1,2,2,5,0xb2d196bb
56161.35,3.0,7,3,4,3,10,0xb2d247aed
813806.91,4.0,18,4,4,2,10,0xb2d6276dd
150078.52,2.0,252,3,3,1,7,0xb2d177f7d
32000.0,14.0,1,2,4,4,10,0xb2d0866dd
1109.83,1.0,27,1,2,2,5,0xb2d1fcffd
92.65,1.0,0,1,2,4,7,0xb2d5b59d
786830.15,5.0,143,4,4,1,9,0xb2d20956d
16812.19,1.0,0,2,2,4,8,0xb2d91fa2
156278.58,8.0,67,3,4,1,8,0xb2d1147a
43116.33,3.0,0,2,4,4,10,0xb2d56f30
502463.93,5.0,52,4,4,2,10,0xb2d11c1ad
39.55,1.0,4,1,2,4,7,0xb2d3ee54
96.98,1.0,0,1,2,4,7,0xb2d566a9
1743.09,1.0,16,1,2,2,5,0xb2d6ffc0
51.65,1.0,1,1,2,4,7,0xb2d2164c
50007.41,2.0,125,2,3,1,6,0xb2d415f6d
100527.24,2.0,2,3,3,4,10,0xb2d8e406d
4035.58,3.0,92,2,4,1,7,0xb2d5faef
4.47,1.0,54,1,2,2,5,0xb2d6f07c
900007.75,4.0,12,4,4,3,11,0xb2d773d6
60.17,1.0,92,1,2,1,4,0xb2d2b3bdd
1090.98,1.0,22,1,2,2,5,0xb2d30e19
240073.0,2.0,100,3,3,1,7,0xb2d93b02d
4904.32,1.0,1,2,2,4,8,0xb2d701b2d
160056.79,5.0,0,3,4,4,11,0xb2d5aa3d
0.0,1.0,1,1,2,4,7,0xb2d8cadb
2296.11,2.0,184,1,3,1,5,0x3b9b37a8d
37.14,1.0,1,1,2,4,7,0xb2d2eeb2
300035.86,3.0,10,3,4,3,10,0xb2d126ad
32137.02,1.0,184,2,2,1,5,0xb2d2af14
3004.1,1.0,92,2,2,1,5,0xb2d3953bd
9714.17,1.0,184,2,2,1,5,0xb2d11b2d
100000000.0,2.0,5,4,3,3,10,0xb2d970e3d
1011005.99,3.0,8,4,4,3,11,0xb2d65e4a
402844.65,2.0,13,4,3,3,10,0xb2d9221f
2000.84,1.0,0,1,2,4,7,0xb2d6fe7e
855998.3,1.0,0,4,2,4,10,0xb2d659acd
100002.32,2.0,13,3,3,3,9,0xb2d9509a
1075.16,1.0,10,1,2,3,6,0xb2d3c079
500000.0,2.0,13,4,3,3,10,0xb2d95fc0d
723293.55,5.0,32,4,4,2,10,0xb2d10e14d
100008.59,2.0,60,3,3,2,8,0xb2d685e3
202138.7,2.0,28,3,3,2,8,0xb2d65ec5
10491.63,1.0,8,2,2,3,7,0xb2d9f25f
50010.0,2.0,6,2,3,3,8,0xb2da51ef
202601.81,3.0,18,3,4,2,9,0x3b9b4569d
110004.51,2.0,49,3,3,2,8,0xb2d61734d
86.69,1.0,14,1,2,3,6,0xb2d37c88
230042.12,3.0,125,3,4,1,8,0xb2d64464
90036.91,3.0,41,3,4,2,9,0xb2d6c9d5d
89870.92,1.0,141,3,2,1,6,0xb2d37cfad
4.05,1.0,7,1,2,3,6,0xb2d254f6d
13136.3,4.0,0,2,4,4,10,0x3b9b0e7c
1015.19,1.0,92,1,2,1,4,0xb2d120be
50787.95,2.0,147,2,3,1,6,0xb2d6419bd
16520.91,1.0,19,2,2,2,6,0xb2d43e9d
160071.28,3.0,35,3,4,2,9,0xb2d47334
400876.05,3.0,10,4,4,3,11,0xb2d716d0
4704.01,1.0,16,2,2,2,6,0xb2d8c603d
30184.37,3.0,8,2,4,3,9,0xb2d23d4c
300107.29,3.0,20,4,4,2,10,0xb2d60e47d
44.21,2.0,18,1,3,2,6,0xb2d9c236
300024.05,3.0,11,3,4,3,10,0xb2d56bd0
133106.12,5.0,4,3,4,4,11,0xb2d565e7
12179.4,1.0,0,2,2,4,8,0xb2d6accad
13090.45,1.0,184,2,2,1,5,0xb2d289ce
5026.18,1.0,9,2,2,3,7,0xb2d25129d
1270499.05,5.0,129,4,4,1,9,0xb2d1c228
61565.25,2.0,0,3,3,4,10,0xb2d65272
79.96,1.0,123,1,2,1,4,0xb2d5f708
6864.14,1.0,0,2,2,4,8,0xb2d58cd2d
2860085.38,5.0,88,4,4,1,9,0xb2d1b69c
10.56,2.0,54,1,3,2,6,0xb2d9a926
65002.74,2.0,213,3,3,1,7,0xb2d68267d
506260.94,4.0,1,4,4,4,12,0xb2d69b86
1486.2,2.0,92,1,3,1,5,0x3b9b258a
16379.26,2.0,8,2,3,3,8,0xb2d3779cd
73.27,1.0,158,1,2,1,4,0xb2d5c3a0
1050196.49,14.0,4,4,4,4,12,0x3b9af143
752919.33,9.0,0,4,4,4,12,0xb2d3ae70
20001.18,2.0,139,2,3,1,6,0xb2d57e03
7935.09,2.0,10,2,3,3,8,0xb2d08b1a
603885.83,3.0,9,4,4,3,11,0xb2d6d205d
3027.75,1.0,184,2,2,1,5,0xb2d2c68b
1425.34,1.0,11,1,2,3,6,0xb2d54853
10.56,1.0,3,1,2,4,7,0xb2d50407
780179.77,3.0,102,4,4,1,9,0xb2d422e0d
700009.26,3.0,10,4,4,3,11,0xb2d4417c
334348.21,1.0,0,4,2,4,10,0xb2d61ba1
158144.5,4.0,6,3,4,3,10,0xb2d612f2
2009.0,1.0,92,1,2,1,4,0xb2d5f223d
88704.75,3.0,60,3,4,2,9,0xb2d69810d
99.33,2.0,23,1,3,2,6,0xb2d1ef0bd
40790.91,2.0,18,2,3,2,7,0xb2d28364d
102452.78,3.0,49,3,4,2,9,0xb2d2a38fd
260055.82,2.0,132,3,3,1,7,0xb2d0ea98d
120755.71,1.0,9,3,2,3,8,0xb2d91c41
1650.87,1.0,159,1,2,1,4,0xb2d25904d
10355.53,2.0,0,2,3,4,9,0xb2d625aed
136.29,1.0,19,1,2,2,5,0xb2d31905
400079.23,2.0,136,4,3,1,8,0xb2d491bcd
13120.63,1.0,0,2,2,4,8,0xb2d69f10
4948.85,1.0,6,2,2,3,7,0xb2d61c5e
200012.64,8.0,60,3,4,2,9,0xb2d5f41c
50002.39,2.0,14,2,3,3,8,0xb2d14e85
427000.06,3.0,21,4,4,2,10,0xb2d304b2d
1323000.0,15.0,10,4,4,3,11,0xb2d237d6
2702443.0,6.0,0,4,4,4,12,0xb2d468f0d
5.88,1.0,82,1,2,1,4,0xb2d1e7f5d
531459.32,4.0,83,4,4,1,9,0x3b9b3394
11043.74,1.0,6,2,2,3,7,0xb2d2da9a
66755.77,1.0,0,3,2,4,9,0xb2d55bbed
367873.86,12.0,0,4,4,4,12,0x3b9b1a36
906993.29,3.0,27,4,4,2,10,0xb2d53adfd
2964.44,1.0,92,2,2,1,5,0xb2d30ea9d
170012.3,3.0,0,3,4,4,11,0xb2d10670
21.24,1.0,286,1,2,1,4,0xb2d34236
201064.2,2.0,184,3,3,1,7,0xb2d16fce
21058.83,1.0,15,2,2,3,7,0xb2d6a43bd
10020.49,1.0,203,2,2,1,5,0xb2d106a2
457000.45,14.0,0,4,4,4,12,0xb2d56580d
82374.85,2.0,108,3,3,1,7,0xb2d5c45dd
7928.82,1.0,11,2,2,3,7,0xb2d9df11
1640028.08,4.0,6,4,4,3,11,0xb2d65a19d
495.46,1.0,9,1,2,3,6,0xb2d310ef
100001.06,2.0,74,3,3,1,7,0xb2d99ff0
54570.62,1.0,50,3,2,2,7,0xb2d95d6bd
6566.71,1.0,184,2,2,1,5,0xb2d23914
775925.39,2.0,8,4,3,3,10,0xb2d18f25
101829.61,1.0,0,3,2,4,9,0xb2d6dc27
90003.01,2.0,139,3,3,1,7,0xb2d90bbed
311528.3,3.0,46,4,4,2,10,0xb2d2405bd
35.22,1.0,39,1,2,2,5,0xb2d563a4d
240020.77,5.0,42,3,4,2,9,0xb2d2acfcd
18487.05,1.0,1,2,2,4,8,0xb2d6f3d7d
341626.83,5.0,26,4,4,2,10,0xb2d2d28ad
3297.77,1.0,180,2,2,1,5,0xb2d39051d
150004.26,3.0,3,3,4,4,11,0xb2d23d90
0.06,1.0,28,1,2,2,5,0xb2d36744d
70837.48,2.0,15,3,3,3,9,0x3b9b29bed
500149.06,2.0,10,4,3,3,10,0xb2d6438bd
615116.21,6.0,28,4,4,2,10,0xb2d61a79d
7859.55,1.0,13,2,2,3,7,0xb2d2cacb
20420.85,1.0,0,2,2,4,8,0xb2d78c3c
60640.56,1.0,1,3,2,4,9,0xb2d4da87
33781.87,1.0,18,2,2,2,6,0xb2d6f061
50023.4,2.0,214,2,3,1,6,0xb2d0d130
4991.15,1.0,15,2,2,3,7,0xb2d93eed
500000.0,3.0,0,4,4,4,12,0xb2d6dfe6
4119062.05,5.0,0,4,4,4,12,0xb2d16983
163666.61,1.0,3,3,2,4,9,0xb2d3b62bd
100431.49,2.0,24,3,3,2,8,0xb2d5be71
5409.36,1.0,92,2,2,1,5,0xb2d11bf5
17639.86,1.0,2,2,2,4,8,0xb2d6fbb7
560217.86,3.0,0,4,4,4,12,0xb2d900ca
3491.77,1.0,7,2,2,3,7,0xb2d3483bd
10000.47,2.0,92,2,3,1,6,0xb2d087c3
1070273.38,2.0,12,4,3,3,10,0xb2d8d1a1
854.84,1.0,24,1,2,2,5,0xb2d24f71
5500000.0,1.0,0,4,2,4,10,0xb2d325b1
225425.53,6.0,0,3,4,4,11,0x3b9af2a9
100003.17,2.0,10,3,3,3,9,0xb2d961b9d
381264.87,1.0,13,4,2,3,9,0xb2d3a92fd
3050089.42,9.0,6,4,4,3,11,0xb2d1e521
822805.77,7.0,34,4,4,2,10,0xb2d51e07d
50002.11,2.0,60,2,3,2,7,0xb2d9b770
10067.12,1.0,92,2,2,1,5,0xb2d361d1
302928.25,3.0,80,4,4,1,9,0xb2d4168c
800020.97,5.0,16,4,4,2,10,0xb2d786b1d
281004.44,5.0,18,3,4,2,9,0xb2d62bcdd
584033.64,3.0,182,4,4,1,9,0xb2d1c04c
50098.36,2.0,80,2,3,1,6,0xb2d5d7b8d
429.79,1.0,0,1,2,4,7,0xb2d2e631
446000.0,9.0,0,4,4,4,12,0xb2d18256
4203.71,1.0,1,2,2,4,8,0xb2d700f3
467448.07,11.0,3,4,4,4,12,0xb2d28918
485034.35,4.0,45,4,4,2,10,0xb2d6b934
82000.87,3.0,31,3,4,2,9,0xb2d8f727
306038.0,2.0,9,4,3,3,10,0xb2da1a24
80052.4,2.0,231,3,3,1,7,0xb2d17c1ed
6943120.03,11.0,8,4,4,3,11,0xb2d97a71
480005.0,2.0,6,4,3,3,10,0xb2d9eac1
40002.12,4.0,28,2,4,2,8,0xb2d15359
600195.33,1.0,4,4,2,4,10,0xb2d21e3e
2218.45,1.0,0,1,2,4,7,0xb2d31af8d
90012.36,14.0,0,3,4,4,11,0x3b9b3d59
167107.13,3.0,0,3,4,4,11,0xb2d77354
600853.41,3.0,17,4,4,2,10,0xb2d38548d
1348.75,1.0,15,1,2,3,6,0xb2d48525
1000.0,1.0,0,1,2,4,7,0xb2d69071
20354.15,2.0,164,2,3,1,6,0xb2d5c72cd
261151.79,1.0,4,3,2,4,9,0xb2d5ec66
2240.56,1.0,156,1,2,1,4,0xb2d21df2
2.73,1.0,0,1,2,4,7,0xb2d27c56
130574.01,2.0,28,3,3,2,8,0xb2d3f469
10000.21,2.0,11,2,3,3,8,0xb2da4242
0.67,1.0,32,1,2,2,5,0xb2d93070d
959141.11,6.0,95,4,4,1,9,0xb2d53628
56.66,1.0,105,1,2,1,4,0xb2d4239c
503628.63,2.0,60,4,3,2,9,0xb2d97fed
300052.77,2.0,4,3,3,4,10,0xb2d415a2d
51026.34,1.0,92,2,2,1,5,0xb2d0d05c
2420.64,1.0,1,1,2,4,7,0xb2d6ff9b
23212.78,1.0,0,2,2,4,8,0xb2d85c7f
10110.31,1.0,184,2,2,1,5,0xb2d28b2bd
24533.88,1.0,15,2,2,3,7,0xb2d8d518d
100011.06,2.0,39,3,3,2,8,0xb2d0fa5f
2.78,1.0,71,1,2,1,4,0xb2d57c3cd
229346.73,5.0,1,3,4,4,11,0xb2d69003
4102.04,1.0,60,2,2,2,6,0xb2d3054c
40.54,1.0,28,1,2,2,5,0xb2d409f9
1130.21,1.0,184,1,2,1,4,0xb2d22745
50000.53,2.0,20,2,3,2,7,0xb2d951a2
2538.14,1.0,0,1,2,4,7,0xb2d5daa6
90045.03,4.0,0,3,4,4,11,0xb2d57620d
5279.14,1.0,0,2,2,4,8,0xb2d9d2c3
1073.85,1.0,7,1,2,3,6,0xb2d58492
251001.81,5.0,0,3,4,4,11,0xb2d74b22d
375119.39,4.0,27,4,4,2,10,0xb2d4346dd
8941.59,1.0,18,2,2,2,6,0xb2d5c7e8
150009.34,2.0,228,3,3,1,7,0xb2d3df86
70001.48,2.0,92,3,3,1,7,0xb2d67dc0d
500027.99,3.0,10,4,4,3,11,0xb2d39c1c
313.05,1.0,8,1,2,3,6,0xb2d512bf
12338.93,1.0,41,2,2,2,6,0xb2d070abd
500000.0,2.0,28,4,3,2,9,0xb2da0d60
10000.11,2.0,90,2,3,1,6,0xb2d8a8e8d
9095.38,1.0,92,2,2,1,5,0xb2d15e8d
52241.04,2.0,83,3,3,1,7,0xb2d61e2a
206566.96,4.0,1,3,4,4,11,0xb2d3654ad
190024.3,5.0,9,3,4,3,10,0xb2d9190b
69.17,1.0,41,1,2,2,5,0xb2d1b3fbd
57351.08,1.0,232,3,2,1,6,0xb2d11508
52589.8,1.0,0,3,2,4,9,0xb2d63286d
100040.58,2.0,196,3,3,1,7,0xb2d574d1d
113233.26,2.0,0,3,3,4,10,0xb2d3380dd
2.11,1.0,78,1,2,1,4,0xb2d17fcd
400083.99,2.0,7,4,3,3,10,0xb2d6e450
200005.07,9.0,56,3,4,2,9,0xb2d5b4c6
1772780.84,4.0,80,4,4,1,9,0xb2d57a7bd
15262.65,2.0,263,2,3,1,6,0xb2d5d231
10611.11,1.0,184,2,2,1,5,0xb2d20306d
160023.56,3.0,76,3,4,1,8,0xb2d17b8cd
1706498.31,6.0,4,4,4,4,12,0xb2d716ad
280716.85,6.0,30,3,4,2,9,0xb2d9bc12
16.39,1.0,37,1,2,2,5,0xb2d67bddd
150229.7,2.0,0,3,3,4,10,0xb2d68e07d
1018.21,1.0,92,1,2,1,4,0xb2d29979d
0.0,2.0,61,1,3,2,6,0xb2d51292
317.39,1.0,3,1,2,4,7,0xb2d25349
1371.11,1.0,92,1,2,1,4,0xb2d39f66
1009.52,1.0,92,1,2,1,4,0xb2d2b840d
450155.27,5.0,8,4,4,3,11,0xb2d0f7d3
1185040.81,7.0,24,4,4,2,10,0xb2d0d400d
669676.2,6.0,18,4,4,2,10,0xb2d5376bd
300002.75,2.0,3,3,3,4,10,0xb2d8e3fdd
80015.51,2.0,18,3,3,2,8,0xb2d8f55c
10192.23,1.0,160,2,2,1,5,0xb2d2e40c
200002.11,2.0,69,3,3,1,7,0xb2d8e98f
83854.54,3.0,11,3,4,3,10,0xb2d5512dd
15121.39,1.0,21,2,2,2,6,0xb2d6eb30
6.85,1.0,25,1,2,2,5,0xb2d6d968d
115.25,1.0,4,1,2,4,7,0xb2d40a30
1207394.52,8.0,3,4,4,4,12,0xb2d6401ed
630.34,1.0,0,1,2,4,7,0xb2d6a1a7
361020.59,9.0,32,4,4,2,10,0xb2d1739ed
5400.15,1.0,117,2,2,1,5,0xb2d93995
169005.35,2.0,11,3,3,3,9,0xb2da3cf6
141.55,1.0,38,1,2,2,5,0xb2d67f16d
250093.93,3.0,48,3,4,2,9,0xb2d275b0
964228.76,9.0,32,4,4,2,10,0xb2d2ea44
17254.02,1.0,0,2,2,4,8,0xb2d5ee12
201046.25,4.0,0,3,4,4,11,0xb2d5af27
68.41,1.0,12,1,2,3,6,0xb2d55640
26329.74,1.0,4,2,2,4,8,0xb2d96e3b
88.7,1.0,9,1,2,3,6,0xb2d6f86d
20000.9,2.0,116,2,3,1,6,0xb2d5ae2a
1861.99,1.0,12,1,2,3,6,0xb2d312a1
260002.74,2.0,24,3,3,2,8,0xb2d94b02
51833.88,1.0,81,2,2,1,5,0xb2d87963d
105702.63,2.0,39,3,3,2,8,0xb2d24a70d
6982.83,1.0,18,2,2,2,6,0xb2d99503
8386.14,1.0,0,2,2,4,8,0xb2d3296b
50000.54,2.0,18,2,3,2,7,0xb2d9a567
1151251.92,6.0,9,4,4,3,11,0xb2d24cadd
1706.08,1.0,27,1,2,2,5,0xb2d361be
6008.55,1.0,0,2,2,4,8,0xb2d36235
201421.19,2.0,80,3,3,1,7,0xb2d993b7
300033.7,2.0,20,3,3,2,8,0xb2d953f8d
65241.01,2.0,3,3,3,4,10,0xb2d3e421
100928.87,2.0,209,3,3,1,7,0xb2d56e73
3394.21,1.0,1,2,2,4,8,0xb2d3f2c0d
2312.46,12.0,92,1,4,1,6,0xb2d120eb
100205.88,1.0,187,3,2,1,6,0xb2d34e2d
506090.43,2.0,18,4,3,2,9,0xb2d6a387d
10015.61,2.0,67,2,3,1,6,0xb2d59f1d
6963.66,1.0,6,2,2,3,7,0xb2d95d16
780836.87,2.0,35,4,3,2,9,0xb2d87a9f
470000.0,2.0,7,4,3,3,10,0xb2da3d29
151223.85,3.0,11,3,4,3,10,0xb2d45be6
150004.75,3.0,41,3,4,2,9,0xb2d78b72d
100015.37,3.0,116,3,4,1,8,0xb2d146c4
307466.25,2.0,35,4,3,2,9,0xb2d6864fd
2.4,1.0,89,1,2,1,4,0xb2d590d8
608755.98,1.0,3,4,2,4,10,0xb2d164a3
1020.89,1.0,92,1,2,1,4,0x3b9b40af
87319.56,2.0,12,3,3,3,9,0xb2d2b33c
1219.44,2.0,179,1,3,1,5,0xb2d079d9
10.3,3.0,1,1,4,4,9,0xb2d26881
597791.04,19.0,0,4,4,4,12,0xb2d09505d
61266.8,1.0,92,3,2,1,6,0xb2d2ad7ad
300089.91,2.0,124,3,3,1,7,0xb2d5ec4b
120071.65,2.0,11,3,3,3,9,0xb2d69d70d
1070749.84,10.0,5,4,4,3,11,0xb2d4d6fd
55381.75,1.0,92,3,2,1,6,0xb2d366c5d
440000.0,3.0,8,4,4,3,11,0xb2d9e7ce
1041.04,1.0,0,1,2,4,7,0xb2d6fbb7d
1136.51,1.0,92,1,2,1,4,0xb2d178b9
1121.23,1.0,20,1,2,2,5,0xb2d9bf61
105.62,2.0,11,1,3,3,7,0xb2d06cc8d
570056.24,4.0,20,4,4,2,10,0xb2d5e7c7d
518942.27,3.0,24,4,4,2,10,0xb2d688f9
103027.45,1.0,92,3,2,1,6,0xb2d165fcd
580037.72,4.0,27,4,4,2,10,0xb2d2c5c6d
5385.28,1.0,47,2,2,2,6,0xb2d41072d
530039.83,2.0,147,4,3,1,8,0xb2d26ac2
27.05,1.0,4,1,2,4,7,0xb2d4b356
10750.19,1.0,5,2,2,3,7,0xb2d6a958d
100011.58,2.0,122,3,3,1,7,0xb2d5cf27d
123.75,1.0,26,1,2,2,5,0xb2d93cd6
3021314.97,2.0,62,4,3,2,9,0xb2d4a230d
813.96,1.0,14,1,2,3,6,0xb2d3bf26
767918.45,14.0,4,4,4,4,12,0xb2d6e700
227099.51,5.0,0,3,4,4,11,0xb2d575af
200000.0,2.0,28,3,3,2,8,0xb2d943a8
205028.18,2.0,1,3,3,4,10,0xb2d9161cd
307404.98,4.0,10,4,4,3,11,0xb2d207ec
4.64,1.0,125,1,2,1,4,0xb2d218d4d
10692.1,1.0,15,2,2,3,7,0xb2d52ca7
0.42,1.0,4,1,2,4,7,0xb2d66827
1696836.7,10.0,0,4,4,4,12,0xb2d1e4f8
66.85,1.0,6,1,2,3,6,0xb2d58e27d
7185.62,1.0,184,2,2,1,5,0xb2d1761ed
23926.09,1.0,9,2,2,3,7,0xb2d69b38d
500000.0,2.0,3,4,3,4,11,0xb2d97dba
150001.58,2.0,80,3,3,1,7,0xb2d7ee27d
205004.33,2.0,74,3,3,1,7,0xb2d99c6b
1255.32,1.0,16,1,2,2,5,0xb2d2582d
195005.06,2.0,217,3,3,1,7,0xb2d7432e
10001.42,2.0,55,2,3,2,7,0xb2d8e479d
2317476.19,1.0,49,4,2,2,8,0xb2d1782dd
6891.96,1.0,184,2,2,1,5,0xb2d0ec84d
109873.65,7.0,160,3,4,1,8,0x3b9adb11d
2080813.38,14.0,1,4,4,4,12,0xb2d366c2d
400065.1,2.0,83,4,3,1,8,0xb2d592e9d
57.74,1.0,64,1,2,2,5,0xb2d8364b
6.04,1.0,36,1,2,2,5,0xb2d2a53b
23.22,1.0,31,1,2,2,5,0xb2d86d12
256683.09,2.0,0,3,3,4,10,0xb2d8d1cfd
0.0,1.0,4,1,2,4,7,0xb2d170a7
408014.62,3.0,27,4,4,2,10,0xb2d9ae9f
820369.66,3.0,21,4,4,2,10,0x3b9b3672d
759550.15,2.0,83,4,3,1,8,0xb2d24226
1781.38,1.0,267,1,2,1,4,0xb2d41d5ed
141.99,1.0,9,1,2,3,6,0xb2d1885fd
29.7,1.0,9,1,2,3,6,0xb2d41dab
280030.96,2.0,118,3,3,1,7,0xb2d58e1b
74509.68,1.0,34,3,2,2,7,0xb2d496c6
1099.04,1.0,2,1,2,4,7,0xb2d60bd5
200000.0,2.0,1,3,3,4,10,0xb2da6387
20037.34,2.0,11,2,3,3,8,0xb2d91255d
950065.28,3.0,28,4,4,2,10,0xb2d1c4b2d
0.0,1.0,2,1,2,4,7,0xb2d620f6
100002.11,2.0,38,3,3,2,8,0xb2d92956
890255.62,5.0,56,4,4,2,10,0xb2d0f556
1602.42,1.0,1,1,2,4,7,0xb2d63008d
4212.32,1.0,5,2,2,3,7,0xb2d9127ad
2014212.16,2.0,81,4,3,1,8,0xb2d8d87dd
13.31,1.0,39,1,2,2,5,0xb2d23fccd
66986.94,1.0,3,3,2,4,9,0xb2d3956ed
300097.43,2.0,11,3,3,3,9,0xb2d08d99
64944.82,1.0,4,3,2,4,9,0xb2d39575d
20920.59,3.0,138,2,4,1,7,0xb2d404fc
982.67,1.0,11,1,2,3,6,0xb2d37f69d
4668.86,1.0,3,2,2,4,8,0xb2d964a2
2438.86,1.0,184,1,2,1,4,0xb2d1d724
41.94,1.0,18,1,2,2,5,0xb2d91be7
100223.96,3.0,32,3,4,2,9,0xb2d63343
14.14,1.0,5,1,2,3,6,0xb2d4da76
1300000.2,5.0,6,4,4,3,11,0xb2d21bab
269294.45,3.0,116,3,4,1,8,0xb2d5749bd
162755.12,4.0,49,3,4,2,9,0xb2d2e1ff
669.65,2.0,231,1,3,1,5,0xb2d16640d
50012.14,1.0,11,2,2,3,7,0xb2d9136ed
7255.18,1.0,2,2,2,4,8,0xb2d6bb70
992080.38,7.0,5,4,4,3,11,0xb2d5539f
4099.78,1.0,184,2,2,1,5,0xb2d3925fd
591429.36,2.0,48,4,3,2,9,0xb2d43641
763.19,1.0,27,1,2,2,5,0xb2d45ce8
214.78,1.0,32,1,2,2,5,0xb2d26b98d
62604.37,2.0,1,3,3,4,10,0xb2d41732d
1290045.8,5.0,193,4,4,1,9,0xb2d3ad92
200001.34,4.0,124,3,4,1,8,0xb2d2625ad
1184.93,1.0,92,1,2,1,4,0xb2d14fa3d
602.15,1.0,0,1,2,4,7,0xb2d8c58e
16024.34,1.0,29,2,2,2,6,0xb2d6d314d
336563.26,8.0,5,4,4,3,11,0xb2d5df44
926175.59,1.0,3,4,2,4,10,0xb2d6de74
157437.79,6.0,48,3,4,2,9,0xb2d4f161
561083.4,6.0,112,4,4,1,9,0xb2d11b44
5536.63,1.0,0,2,2,4,8,0xb2d4fee9
91038.46,2.0,25,3,3,2,8,0xb2d7088fd
836006.59,7.0,31,4,4,2,10,0xb2d1a23fd
300000.0,2.0,28,3,3,2,8,0xb2da0de6
101024.96,2.0,182,3,3,1,7,0xb2d4dfa2d
1516.25,1.0,240,1,2,1,4,0xb2d42117d
19940.18,1.0,46,2,2,2,6,0xb2d688d1
3568.73,1.0,15,2,2,3,7,0xb2d9cdd7
25047.96,2.0,1,2,3,4,9,0xb2d5c01cd
460555.51,8.0,10,4,4,3,11,0x3b9b0fb3d
300000.0,2.0,18,3,3,2,8,0xb2da35d2
7140.96,1.0,1,2,2,4,8,0xb2d6e6acd
900179.61,3.0,11,4,4,3,11,0xb2d9e16a
80000.82,2.0,9,3,3,3,9,0xb2d5720ad
1784.89,1.0,236,1,2,1,4,0xb2d10aac
61148.22,1.0,7,3,2,3,8,0xb2d1bd26d
600027.44,6.0,4,4,4,4,12,0xb2da216a
2294.63,1.0,19,1,2,2,5,0xb2d24280d
400027.44,2.0,19,4,3,2,9,0xb2d78fc3
1.1,4.0,1,1,4,4,9,0x3b9b46bd
15.52,1.0,88,1,2,1,4,0xb2d86c37d
53.98,1.0,2,1,2,4,7,0xb2d967be
492822.0,6.0,21,4,4,2,10,0xb2d1636e
9770.48,1.0,10,2,2,3,7,0xb2d5d2db
500009.5,2.0,6,4,3,3,10,0xb2d93ed7d
1.48,1.0,12,1,2,3,6,0xb2d5dd4fd
101083.45,3.0,116,3,4,1,8,0xb2d65736d
361357.56,2.0,5,4,3,3,10,0xb2d8f5e1d
5052.76,1.0,184,2,2,1,5,0xb2d2b81ed
1000.8,2.0,92,1,3,1,5,0x3b9b142b
1661039.25,4.0,60,4,4,2,10,0xb2d236b6d
5.28,1.0,32,1,2,2,5,0xb2d8de3c
488.21,1.0,0,1,2,4,7,0xb2d937c5
565751.78,3.0,76,4,4,1,9,0xb2d0b123d
271049.46,5.0,0,3,4,4,11,0xb2d6d8efd
0.59,1.0,5,1,2,3,6,0xb2d95475
303296.15,2.0,41,4,3,2,9,0xb2d6a5ac
2909.12,1.0,9,2,2,3,7,0xb2d4ce85d
385925.13,7.0,1,4,4,4,12,0xb2d122a8d
1683468.66,11.0,0,4,4,4,12,0xb2d5b290d
273196.19,2.0,56,3,3,2,8,0xb2d3b3c4
14000.26,2.0,199,2,3,1,6,0xb2d68aa4d
12509.04,2.0,67,2,3,1,6,0xb2d2facd
21533.96,1.0,49,2,2,2,6,0xb2d59875d
70000.0,3.0,0,3,4,4,11,0xb2d979df
57470.74,1.0,2,3,2,4,9,0xb2d3c068
13111.43,1.0,6,2,2,3,7,0xb2d4f168d
71968.58,5.0,0,3,4,4,11,0xb2d98a91
2940249.84,3.0,1,4,4,4,12,0xb2d4bce6d
330036.27,2.0,1,4,3,4,11,0xb2d95478
415.71,1.0,19,1,2,2,5,0xb2d5e189d
109.51,1.0,22,1,2,2,5,0xb2d2fc0d
4424.42,1.0,92,2,2,1,5,0xb2d0f8edd
0.99,1.0,0,1,2,4,7,0xb2d985e4
60851.97,2.0,168,3,3,1,7,0xb2d3a551
12662.52,1.0,9,2,2,3,7,0xb2d3ff87
5185.72,1.0,2,2,2,4,8,0xb2d8fc50d
150644.94,4.0,1,3,4,4,11,0xb2d0e74dd
2.8,1.0,16,1,2,2,5,0xb2d2a706d
100000.0,6.0,1,3,4,4,11,0xb2d4bd21d
1079.19,1.0,184,1,2,1,4,0xb2d2cd3fd
405617.56,4.0,1,4,4,4,12,0xb2d156e7
790027.1,5.0,24,4,4,2,10,0xb2d6e496
51110.1,1.0,10,2,2,3,7,0xb2d41df7d
1501648.58,2.0,0,4,3,4,11,0xb2d93756d
718019.62,4.0,5,4,4,3,11,0xb2d4b3f1d
2341966.51,11.0,10,4,4,3,11,0xb2d1be1ad
2646.85,1.0,5,1,2,3,6,0xb2d5538f
32001.33,4.0,55,2,4,2,8,0xb2d642afd
300000.0,2.0,4,3,3,4,10,0xb2da557e
55.53,1.0,6,1,2,3,6,0xb2d6258b
40000.42,2.0,31,2,3,2,7,0xb2d64d05
50008.17,2.0,187,2,3,1,6,0xb2d6309bd
62082.46,1.0,0,3,2,4,9,0xb2d62453
61502.55,1.0,24,3,2,2,7,0xb2d346c3
14330.81,1.0,20,2,2,2,6,0xb2d68e57
316.14,1.0,26,1,2,2,5,0xb2d265a1
66200.0,2.0,0,3,3,4,10,0xb2d2267b
177.9,1.0,15,1,2,3,6,0xb2d9d15b
301517.2,3.0,24,4,4,2,10,0xb2d5b039
2263.5,1.0,2,1,2,4,7,0xb2d0bd27
8525.16,1.0,20,2,2,2,6,0xb2d4b946
1616.26,1.0,0,1,2,4,7,0xb2d8dc30d
529272.63,7.0,0,4,4,4,12,0xb2d56149
3485.27,2.0,0,2,3,4,9,0xb2d65e36d
465.9,1.0,4,1,2,4,7,0xb2d13ee2
6700.11,1.0,19,2,2,2,6,0xb2d9e074
50019.01,2.0,41,2,3,2,7,0xb2d90e66d
7007.28,1.0,18,2,2,2,6,0xb2d6b6ba
9495.05,1.0,2,2,2,4,8,0xb2d54e4d
1020.92,1.0,181,1,2,1,4,0xb2d27615
243419.6,18.0,0,3,4,4,11,0xb2d188da
205238.17,4.0,116,3,4,1,8,0x3b9b3d32
500000.0,3.0,2,4,4,4,12,0xb2d682ea
40004.29,3.0,10,2,4,3,9,0xb2d45d35
150002.69,2.0,1,3,3,4,10,0xb2d639c9d
1451.13,1.0,24,1,2,2,5,0xb2d6c405
10239.46,2.0,0,2,3,4,9,0xb2d7bd8b
170044.17,1.0,0,3,2,4,9,0xb2d50788
653.47,1.0,20,1,2,2,5,0xb2d3789ad
84.82,1.0,57,1,2,2,5,0xb2d12152
0.0,1.0,184,1,2,1,4,0xb2d3c1f5d
390000.0,6.0,0,4,4,4,12,0xb2d1011ed
770091.64,10.0,1,4,4,4,12,0xb2d4c05cd
5638.28,1.0,2,2,2,4,8,0xb2d622ee
190006.22,4.0,83,3,4,1,8,0xb2d21239d
14.36,2.0,16,1,3,2,6,0xb2d5040b
165265.96,12.0,4,3,4,4,11,0xb2d2111e
502892.37,26.0,0,4,4,4,12,0xb2d085d1
760273.91,1.0,184,4,2,1,7,0xb2d3a353d
124286.18,2.0,92,3,3,1,7,0xb2d63330d
7571.72,1.0,5,2,2,3,7,0xb2d9fc84
142928.42,2.0,12,3,3,3,9,0xb2d0f421d
2160.04,1.0,27,1,2,2,5,0xb2d39252
340895.35,7.0,12,4,4,3,11,0xb2d49048
200063.18,2.0,14,3,3,3,9,0xb2d5e9d9
2536.87,2.0,15,1,3,3,7,0xb2d0d77f
8174.11,1.0,11,2,2,3,7,0xb2d406d0d
51779.76,2.0,10,2,3,3,8,0xb2d49332d
310032.56,3.0,73,4,4,1,9,0xb2d067ce
460000.0,5.0,5,4,4,3,11,0xb2d414c7d
100379.14,2.0,21,3,3,2,8,0xb2d95269
24727.28,1.0,160,2,2,1,5,0xb2d52fdcd
50483.35,2.0,14,2,3,3,8,0xb2d22534d
50535.84,1.0,53,2,2,2,6,0xb2d236e1
436505.06,5.0,87,4,4,1,9,0xb2d10f80
74241.07,3.0,0,3,4,4,11,0xb2d06c99
152558.09,2.0,0,3,3,4,10,0xb2d6027c
50006.02,3.0,13,2,4,3,9,0xb2d5c1e9
3767.21,1.0,10,2,2,3,7,0xb2d2b5bdd
2929.48,1.0,141,2,2,1,5,0xb2d58825d
50051.49,2.0,0,2,3,4,9,0xb2d3491ad
300050.6,6.0,5,3,4,3,10,0xb2d78af1d
401423.43,2.0,33,4,3,2,9,0xb2d918c3d
114516.75,4.0,4,3,4,4,11,0xb2d1a246d
351205.33,5.0,27,4,4,2,10,0xb2d479a1d
116000.0,4.0,2,3,4,4,11,0xb2d146ebd
241472.24,5.0,15,3,4,3,10,0x3b9b2511
51813.95,2.0,160,2,3,1,6,0xb2d2c2d2d
15409.64,1.0,25,2,2,2,6,0xb2d24fdad
28262.1,1.0,11,2,2,3,7,0xb2d35704d
273581.51,3.0,4,3,4,4,11,0xb2d21198
61638.2,1.0,92,3,2,1,6,0xb2d1f7a0d
60100.66,2.0,39,3,3,2,8,0xb2d9efaa
100075.19,2.0,90,3,3,1,7,0xb2d50cd4d
132020.63,2.0,231,3,3,1,7,0xb2d62ed8d
750000.0,6.0,16,4,4,2,10,0xb2d25db2
300824.72,1.0,0,4,2,4,10,0xb2d6d450
203554.17,2.0,154,3,3,1,7,0xb2d6dd88d
982.02,1.0,13,1,2,3,6,0xb2d0bdbdd
59934.15,1.0,1,3,2,4,9,0xb2d8ca12
32669.56,1.0,1,2,2,4,8,0xb2d6bfd8
116075.82,3.0,10,3,4,3,10,0xb2d24fa2
62425.2,3.0,18,3,4,2,9,0xb2d51c99d
2023.37,1.0,92,1,2,1,4,0xb2d57f5cd
2950000.0,7.0,4,4,4,4,12,0xb2d06ca2
260012.19,6.0,101,3,4,1,8,0xb2d3c15dd
2348.37,1.0,0,1,2,4,7,0xb2d717d1
500010.56,2.0,95,4,3,1,8,0xb2d975f4d
81996.08,1.0,30,3,2,2,7,0xb2d2029bd
574428.74,6.0,60,4,4,2,10,0xb2d3a49e
11.09,1.0,67,1,2,1,4,0xb2d92264
683.75,1.0,0,1,2,4,7,0xb2d6db3c
142010.84,4.0,0,3,4,4,11,0xb2d9e1df
454008.83,8.0,11,4,4,3,11,0xb2d4cd9b
3005.65,1.0,0,2,2,4,8,0xb2d92351
327897.17,4.0,25,4,4,2,10,0xb2d5c5da
111152.38,3.0,184,3,4,1,8,0x3b9b1598d
907.45,1.0,26,1,2,2,5,0xb2d967d6d
5535.84,2.0,184,2,3,1,6,0xb2d2dab4
15001.63,2.0,14,2,3,3,8,0xb2da1ff6
1663.28,1.0,92,1,2,1,4,0xb2d2295cd
31335.93,1.0,12,2,2,3,7,0xb2d2bbae
1024548.4,2.0,138,4,3,1,8,0xb2d6186e
1420059.25,13.0,31,4,4,2,10,0xb2d1ff93
80554.98,4.0,31,3,4,2,9,0xb2d436d4d
514572.16,3.0,0,4,4,4,12,0xb2d2995a
257011.28,2.0,160,3,3,1,7,0xb2d225bfd
270000.0,2.0,0,3,3,4,10,0xb2da6a9d
100107.31,2.0,7,3,3,3,9,0xb2d29bbe
5040.34,1.0,184,2,2,1,5,0xb2d5fe08d
853212.35,8.0,0,4,4,4,12,0xb2d121f3d
102888.22,2.0,21,3,3,2,8,0xb2d32e2c
500000.0,3.0,1,4,4,4,12,0xb2d70558
3071.82,1.0,0,2,2,4,8,0xb2d6ce7bd
2557813.25,4.0,0,4,4,4,12,0xb2d0bfb3
284.71,1.0,27,1,2,2,5,0xb2d97eac
1150009.36,15.0,13,4,4,3,11,0xb2d105a2
58516.06,2.0,1,3,3,4,10,0xb2d47291
150099.71,2.0,132,3,3,1,7,0xb2d6f6fe
36361.36,1.0,1,2,2,4,8,0xb2d8f763
20155.71,1.0,8,2,2,3,7,0xb2d42365
2316.76,1.0,92,1,2,1,4,0xb2d1fec4d
8710.41,1.0,13,2,2,3,7,0xb2d5780e
576.0,1.0,0,1,2,4,7,0xb2d56e63
1348.17,1.0,184,1,2,1,4,0xb2d24ff2
50002.53,2.0,10,2,3,3,8,0xb2d594e0
10620.4,1.0,4,2,2,4,8,0xb2d627bf
306083.57,2.0,56,4,3,2,9,0xb2d9c661
480015.12,3.0,165,4,4,1,9,0xb2d4fd03
300098.53,4.0,119,3,4,1,8,0xb2d61f4bd
360009.65,6.0,87,4,4,1,9,0xb2d3cbd5d
83001.93,3.0,52,3,4,2,9,0xb2d65a1c
5555.74,1.0,0,2,2,4,8,0xb2d5cc07
500419.58,6.0,0,4,4,4,12,0xb2d5b75fd
41476.02,1.0,0,2,2,4,8,0xb2d1e9cbd
5837.32,1.0,69,2,2,1,5,0xb2d688f5
200009.62,2.0,23,3,3,2,8,0xb2d07a3b
31643.61,1.0,0,2,2,4,8,0xb2d9cf2b
286.26,1.0,1,1,2,4,7,0xb2d548fc
110001.8,3.0,21,3,4,2,9,0xb2d9eebe
520001.35,8.0,0,4,4,4,12,0xb2d37789d
30550.88,2.0,56,2,3,2,7,0xb2d41422d
2185.9,1.0,10,1,2,3,6,0xb2d6f600d
10224.35,1.0,38,2,2,2,6,0xb2d45a14
536405.34,2.0,92,4,3,1,8,0xb2d0a644d
15.81,1.0,47,1,2,2,5,0xb2d348f2
180008.61,5.0,3,3,4,4,11,0xb2d3a646d
2100.5,1.0,27,1,2,2,5,0xb2d5b1efd
181645.98,3.0,25,3,4,2,9,0xb2d921e8
2399.46,1.0,0,1,2,4,7,0xb2d6bf21
31683.9,1.0,18,2,2,2,6,0xb2d6bdc7
10032.64,1.0,92,2,2,1,5,0xb2d3eb30d
170033.82,2.0,48,3,3,2,8,0xb2d0fdfad
53.98,1.0,84,1,2,1,4,0xb2d24774d
1734367.45,2.0,0,4,3,4,11,0xb2d10c70d
50002.98,2.0,66,2,3,2,7,0xb2d5dcc7d
12958.04,1.0,92,2,2,1,5,0xb2d14b76d
206401.49,2.0,276,3,3,1,7,0xb2d6b27f
300.27,1.0,47,1,2,2,5,0xb2d6e0e0d
2835.33,2.0,184,1,3,1,5,0xb2d1a0a8d
687621.92,8.0,1,4,4,4,12,0xb2d4b90ed
241.33,2.0,20,1,3,2,6,0xb2d36080
164396.39,8.0,10,3,4,3,10,0xb2d1147ad
1007.7,1.0,184,1,2,1,4,0xb2d2e346d
650712.76,5.0,18,4,4,2,10,0xb2d55c8c
602934.79,6.0,33,4,4,2,10,0xb2d620f9d
182.45,1.0,10,1,2,3,6,0xb2d2f1ad
27737.23,1.0,0,2,2,4,8,0xb2d6c2b3
1.54,1.0,10,1,2,3,6,0xb2d68c1e
9.69,1.0,93,1,2,1,4,0xb2d3c3c0
300012.68,2.0,161,3,3,1,7,0xb2d8e698d
210.36,1.0,10,1,2,3,6,0xb2d526e2
7204.99,1.0,15,2,2,3,7,0xb2d8d5dcd
366025.15,2.0,59,4,3,2,9,0xb2d8deab
823.73,1.0,9,1,2,3,6,0xb2d299bd
800000.94,5.0,0,4,4,4,12,0xb2d8decb
400852.75,3.0,4,4,4,4,12,0xb2d8399b
1900457.66,6.0,5,4,4,3,11,0xb2d08170d
50002.79,2.0,195,2,3,1,6,0xb2d61b40d
83.26,1.0,2,1,2,4,7,0xb2d64ec5
130014.46,3.0,83,3,4,1,8,0xb2d8cd8cd
5.4,7.0,8,1,4,3,8,0xb2d4e21b
250004.13,8.0,56,3,4,2,9,0xb2d3c5a6
1570.4,3.0,1,1,4,4,9,0xb2d17827
2390026.23,3.0,5,4,4,3,11,0xb2d909de
2182172.0,5.0,3,4,4,4,12,0xb2d6471cd
598.55,3.0,7,1,4,3,8,0x3b9b0fce
344.57,1.0,61,1,2,2,5,0xb2d6a3a0
1595.0,1.0,18,1,2,2,5,0xb2d2d133
451000.0,4.0,8,4,4,3,11,0xb2d4f5dc
1220.29,1.0,184,1,2,1,4,0xb2d0da1d
862002.14,6.0,0,4,4,4,12,0xb2d6b329d
2.86,1.0,11,1,2,3,6,0xb2d49514
1421.89,2.0,92,1,3,1,5,0xb2d12b02d
5.48,1.0,23,1,2,2,5,0xb2d938c2
1675.64,1.0,21,1,2,2,5,0xb2d43221d
255112.76,2.0,4,3,3,4,10,0xb2d3d5d2d
15110.71,1.0,92,2,2,1,5,0xb2d0f0e1d
113954.63,2.0,179,3,3,1,7,0xb2d227d8
400049.74,4.0,90,4,4,1,9,0xb2d54ac0
268753.67,3.0,6,3,4,3,10,0xb2d33f0a
201474.27,2.0,30,3,3,2,8,0xb2d68865
533314.57,6.0,0,4,4,4,12,0xb2d0b9d0d
94565.01,2.0,13,3,3,3,9,0xb2d5cad6
0.99,1.0,17,1,2,2,5,0xb2d2fdf5
3.0,1.0,0,1,2,4,7,0xb2d4fd11d
1364826.65,1.0,7,4,2,3,9,0xb2d2f128d
828.43,1.0,23,1,2,2,5,0xb2d20d91
250071.13,2.0,235,3,3,1,7,0xb2d60faed
8637.07,1.0,92,2,2,1,5,0xb2d11196d
2878.88,1.0,217,1,2,1,4,0xb2d46e18d
301488.2,6.0,8,4,4,3,11,0xb2d41174
150001.58,2.0,105,3,3,1,7,0xb2d95e4a
1215.41,2.0,184,1,3,1,5,0xb2d1f653d
81062.73,4.0,75,3,4,1,8,0xb2d08a1a
70000.0,3.0,0,3,4,4,11,0xb2d597f2d
3908.05,1.0,145,2,2,1,5,0xb2d43542
1216.56,2.0,0,1,3,4,8,0x3b9b3378
100014.28,2.0,11,3,3,3,9,0xb2da011e
420009.34,4.0,0,4,4,4,12,0xb2d18dc5d
16837.4,1.0,10,2,2,3,7,0xb2d56061
210018.3,2.0,27,3,3,2,8,0xb2d55435d
50086.76,2.0,24,2,3,2,7,0xb2d19c9ad
10205.26,1.0,81,2,2,1,5,0xb2d6a30fd
14.35,1.0,83,1,2,1,4,0xb2d97311
426003.15,7.0,67,4,4,1,9,0xb2d4fbfad
2721.71,1.0,52,1,2,2,5,0xb2d7a776
6000063.33,2.0,61,4,3,2,9,0xb2d9ac33
250732.32,5.0,64,3,4,2,9,0xb2d11418d
569.82,1.0,3,1,2,4,7,0xb2d38965
527.08,2.0,1,1,3,4,8,0xb2d08342
391036.02,12.0,11,4,4,3,11,0xb2d67fec
145672.92,1.0,29,3,2,2,7,0xb2d35adc
403937.36,3.0,69,4,4,1,9,0xb2d17046
205085.31,2.0,167,3,3,1,7,0xb2d1c3c3d
30007.32,2.0,0,2,3,4,9,0xb2d40f6f
14780.47,1.0,0,2,2,4,8,0xb2d688dad
22074.96,1.0,0,2,2,4,8,0xb2d6c0b0
10677.64,2.0,5,2,3,3,8,0xb2d5f1bed
1338043.32,9.0,14,4,4,3,11,0xb2d07f76
255086.65,6.0,1,3,4,4,11,0xb2d1bc8fd
0.0,4.0,2,1,4,4,9,0xb2d1cc56d
370026.39,3.0,119,4,4,1,9,0xb2d5635dd
1984.58,1.0,0,1,2,4,7,0xb2d4ce6f
198.83,1.0,21,1,2,2,5,0xb2d9519fd
104437.23,6.0,39,3,4,2,9,0xb2d56980d
3875.94,1.0,5,2,2,3,7,0xb2d2be15
200000.41,3.0,0,3,4,4,11,0xb2d2a3a5d
351243.23,2.0,31,4,3,2,9,0xb2d93f21d
200000.0,2.0,2,3,3,4,10,0xb2d49f05
83.97,1.0,68,1,2,1,4,0xb2d218bb
6007.54,1.0,10,2,2,3,7,0xb2d4424e
1400999.77,9.0,6,4,4,3,11,0x3b9b248dd
404.39,1.0,24,1,2,2,5,0xb2d23e0a
602.62,1.0,0,1,2,4,7,0xb2d95572
201609.61,3.0,16,3,4,2,9,0x3b9b2f77
5.37,1.0,60,1,2,2,5,0xb2d970da
1008.14,1.0,90,1,2,1,4,0xb2d3e3cfd
92634.89,6.0,0,3,4,4,11,0xb2d5746bd
320012.99,3.0,15,4,4,3,11,0xb2d9393ad
1772.2,1.0,184,1,2,1,4,0xb2d20b0d
417176.48,3.0,6,4,4,3,11,0xb2d0caebd
30001.27,2.0,49,2,3,2,7,0xb2d9d2a9
23.44,1.0,0,1,2,4,7,0xb2d5b580d
54148.33,2.0,52,3,3,2,8,0xb2d2ba00d
2297.33,1.0,1,1,2,4,7,0xb2d23fa2
13298.54,1.0,199,2,2,1,5,0xb2d1cfff
50608.38,3.0,0,2,4,4,10,0xb2d192d4d
224400.95,5.0,17,3,4,2,9,0xb2d9d8c2
380000.43,6.0,1,4,4,4,12,0xb2d58a8c
1348.78,1.0,0,1,2,4,7,0xb2d68ddf
1021.57,1.0,131,1,2,1,4,0xb2d59f2a
80003.07,2.0,157,3,3,1,7,0xb2d2a477d
12249.19,1.0,184,2,2,1,5,0xb2d1c3f3d
9679.64,2.0,270,2,3,1,6,0xb2d53481d
9873.23,1.0,95,2,2,1,5,0xb2d2540d
114005.63,3.0,77,3,4,1,8,0xb2d52b62d
1461511.07,3.0,87,4,4,1,9,0xb2d06d0ed
262.55,1.0,10,1,2,3,6,0xb2d51719d
7518.64,2.0,132,2,3,1,6,0xb2d6fe84d
124295.34,1.0,7,3,2,3,8,0xb2d6276a
38.39,1.0,10,1,2,3,6,0xb2d1bfd0
1626374.41,10.0,0,4,4,4,12,0x3b9b18ee
46068.36,1.0,10,2,2,3,7,0xb2d8b660d
82905.25,2.0,3,3,3,4,10,0xb2d62075d
607674.28,3.0,0,4,4,4,12,0xb2d92b22
50001.06,2.0,18,2,3,2,7,0xb2da2cc8
369.29,1.0,13,1,2,3,6,0xb2d5d773
70098.17,2.0,86,3,3,1,7,0xb2d51553d
218.15,1.0,2,1,2,4,7,0xb2d1d594
17423.04,1.0,34,2,2,2,6,0xb2d7869f
1420015.47,11.0,39,4,4,2,10,0xb2d546dbd
600014.76,3.0,15,4,4,3,11,0xb2d91fc6
235960.52,1.0,0,3,2,4,9,0xb2d790c3
58582.68,2.0,92,3,3,1,7,0x3b9ad26c
2250.79,1.0,14,1,2,3,6,0xb2d8ca6c
650.6,1.0,116,1,2,1,4,0xb2d103a1d
390332.42,4.0,25,4,4,2,10,0xb2d30e6ad
421348.8,4.0,20,4,4,2,10,0xb2d5dda3
123959.31,2.0,45,3,3,2,8,0xb2d2e4ec
9699.98,1.0,0,2,2,4,8,0xb2d6b4d0
2179.96,1.0,24,1,2,2,5,0xb2d6feaa
120150.49,12.0,25,3,4,2,9,0x3b9af5e5d
512120.46,6.0,83,4,4,1,9,0xb2d20b0ed
51097.61,2.0,189,2,3,1,6,0xb2d5f44dd
6103.35,1.0,29,2,2,2,6,0xb2d929f9
29.72,1.0,9,1,2,3,6,0xb2d31010
13001.43,2.0,181,2,3,1,6,0xb2d5efee
2408.17,1.0,184,1,2,1,4,0xb2d6512ad
318002.86,3.0,13,4,4,3,11,0xb2d113af
421.01,2.0,4,1,3,4,8,0x3b9b1857d
341106.36,6.0,14,4,4,3,11,0xb2d1e2b0
3806.15,1.0,103,2,2,1,5,0xb2d61f6ed
1696.02,1.0,0,1,2,4,7,0xb2d5d745
240331.25,4.0,3,3,4,4,11,0xb2d3a2bdd
1867.69,1.0,92,1,2,1,4,0xb2d2a4d2
213699.47,6.0,0,3,4,4,11,0x3b9af12dd
50089.39,3.0,81,2,4,1,7,0xb2d685d8
10000.21,2.0,67,2,3,1,6,0xb2d9ae60
10923.73,1.0,1,2,2,4,8,0xb2d29123
520686.81,2.0,29,4,3,2,9,0xb2d1a3f8
425424.47,3.0,135,4,4,1,9,0xb2d36a14d
1014.58,1.0,92,1,2,1,4,0xb2d14587d
650.28,1.0,60,1,2,2,5,0xb2d51c5f
414383.44,2.0,30,4,3,2,9,0xb2d24866d
163457.86,4.0,90,3,4,1,8,0xb2d31cfd
70002.21,3.0,39,3,4,2,9,0xb2d57e48d
1072.21,1.0,0,1,2,4,7,0xb2d0f3ea
189073.55,3.0,0,3,4,4,11,0xb2d381c6
1998.42,1.0,177,1,2,1,4,0xb2d304c6
4005.64,1.0,13,2,2,3,7,0xb2d5c5bc
3041.83,1.0,58,2,2,2,6,0xb2d69e2f
12628.14,2.0,3,2,3,4,9,0xb2d35e70
16940.99,2.0,20,2,3,2,7,0xb2d52d9fd
103195.37,1.0,0,3,2,4,9,0xb2d41330
403714.44,9.0,3,4,4,4,12,0xb2d619bad
193472.17,2.0,0,3,3,4,10,0xb2d4135a
12880000.0,6.0,4,4,4,4,12,0xb2d8e311
59421.92,1.0,8,3,2,3,8,0xb2d6acfad
50000.53,2.0,69,2,3,1,6,0xb2d8eb1b
203080.62,2.0,101,3,3,1,7,0xb2d22237
182946.78,4.0,4,3,4,4,11,0xb2d6904f
170038.28,4.0,41,3,4,2,9,0xb2d1a678
5254.2,1.0,8,2,2,3,7,0xb2d54ad2
150024.4,3.0,6,3,4,3,10,0xb2d533c8d
60368.29,4.0,0,3,4,4,11,0xb2d407a1
91.68,1.0,0,1,2,4,7,0xb2d422fcd
3302014.38,8.0,10,4,4,3,11,0xb2d5dbedd
181603.04,2.0,39,3,3,2,8,0xb2d39c21
818995.76,8.0,0,4,4,4,12,0xb2d2c67fd
10160.24,2.0,129,2,3,1,6,0xb2d64309d
1621.33,1.0,6,1,2,3,6,0xb2d3a38c
17.5,1.0,10,1,2,3,6,0xb2da27b2
4005.59,1.0,120,2,2,1,5,0xb2d8ec11
300857.97,3.0,19,4,4,2,10,0xb2d3dcbf
3115.47,5.0,14,2,4,3,9,0xb2d4f2c7
3244.33,1.0,184,2,2,1,5,0xb2d2b33e
107884.96,1.0,92,3,2,1,6,0xb2d0f243d
71424.2,4.0,31,3,4,2,9,0xb2d59f0bd
15.13,2.0,69,1,3,1,5,0x3b9b41f0
40270.06,1.0,1,2,2,4,8,0xb2d6cf35
2581.37,1.0,191,1,2,1,4,0xb2d6c5ced
1041.46,1.0,4,1,2,4,7,0xb2d6e513
100000.75,3.0,1,3,4,4,11,0xb2d6ad9a
2335.32,1.0,9,1,2,3,6,0xb2d64484
11679.75,1.0,29,2,2,2,6,0xb2d2ce00d
1868345.33,2.0,8,4,3,3,10,0xb2d14c53d
1581.92,1.0,10,1,2,3,6,0xb2d32e35
735607.8,2.0,154,4,3,1,8,0xb2d1bef2d
7461.98,1.0,11,2,2,3,7,0xb2d27c37
50750.59,2.0,27,2,3,2,7,0xb2d62a75
512066.67,4.0,6,4,4,3,11,0xb2d5a19ed
450448.23,4.0,49,4,4,2,10,0xb2d22676d
1325669.41,4.0,15,4,4,3,11,0xb2d223bfd
735323.71,5.0,168,4,4,1,9,0xb2d362db
731991.84,9.0,27,4,4,2,10,0xb2d14d63
198000.5,7.0,1,3,4,4,11,0xb2d48b5b
1023019.08,2.0,6,4,3,3,10,0xb2d1c44ad
150583.52,2.0,193,3,3,1,7,0xb2d6f06e
130118.12,2.0,67,3,3,1,7,0xb2d96109
4425.03,1.0,32,2,2,2,6,0xb2d9d34a
10003.08,2.0,24,2,3,2,7,0xb2d5897f
10002.81,2.0,17,2,3,2,7,0xb2d9e9a0
435320.51,8.0,0,4,4,4,12,0xb2d3b551
209404.86,5.0,87,3,4,1,8,0xb2d1fe7bd
210.62,1.0,9,1,2,3,6,0xb2d6c0b8
2324893.7,3.0,98,4,4,1,9,0xb2d1b643
174.05,1.0,21,1,2,2,5,0xb2d692dc
40000000.0,3.0,8,4,4,3,11,0xb2d69308
338655.17,3.0,125,4,4,1,9,0xb2d59686
357724.0,7.0,11,4,4,3,11,0xb2d0840c
0.0,1.0,9,1,2,3,6,0xb2d5931f
500076.09,3.0,0,4,4,4,12,0xb2d8fc72
95035.51,2.0,83,3,3,1,7,0xb2d42060d
35.79,2.0,60,1,3,2,6,0xb2d1a45c
151200.23,2.0,122,3,3,1,7,0xb2d69cac
100120.12,2.0,87,3,3,1,7,0xb2d1f17d
569106.35,5.0,11,4,4,3,11,0xb2d41049
41741.43,1.0,0,2,2,4,8,0xb2d21301d
9348.31,1.0,0,2,2,4,8,0xb2d91b8d
1600657.77,4.0,3,4,4,4,12,0xb2d11eb4
1010013.44,3.0,14,4,4,3,11,0xb2d69b4bd
977116.73,10.0,25,4,4,2,10,0xb2d504e1d
92.31,1.0,3,1,2,4,7,0xb2d4e568
7455.24,1.0,184,2,2,1,5,0xb2d0bdd4d
800010.0,2.0,0,4,3,4,11,0xb2d97d17
161094.51,5.0,6,3,4,3,10,0xb2d07945
7362.23,1.0,6,2,2,3,7,0xb2d57ab7
17286.31,1.0,18,2,2,2,6,0xb2d0d228
34.15,1.0,6,1,2,3,6,0xb2d6e268d
291000.0,2.0,7,3,3,3,9,0xb2da07dc
3057.86,1.0,17,2,2,2,6,0xb2d6a834
610006.5,10.0,5,4,4,3,11,0xb2d5b445d
62035.66,2.0,111,3,3,1,7,0xb2d3273c
42287.37,2.0,81,2,3,1,6,0xb2d0762fd
440004.92,8.0,11,4,4,3,11,0x3b9b0e34d
2039.35,1.0,0,1,2,4,7,0xb2d32257
898249.2,2.0,0,4,3,4,11,0x3b9b49ccd
165026.59,2.0,0,3,3,4,10,0xb2d2a5fcd
200000.0,2.0,29,3,3,2,8,0xb2da0b60
734.72,1.0,5,1,2,3,6,0xb2d37f8a
450004.99,4.0,24,4,4,2,10,0xb2d8d2d0
210203.8,6.0,11,3,4,3,10,0xb2d629da
14700.47,2.0,92,2,3,1,6,0xb2d5e620
50008.96,3.0,10,2,4,3,9,0xb2d07ce8
30870883.65,2.0,10,4,3,3,10,0xb2d55c92
53305.03,2.0,15,3,3,3,9,0xb2d31931
916010.96,6.0,2,4,4,4,12,0xb2d5988ad
40014.99,1.0,5,2,2,3,7,0xb2d858c7d
2005046.74,24.0,3,4,4,4,12,0xb2d0d173d
0.0,1.0,20,1,2,2,5,0xb2d8e198
1174.34,2.0,0,1,3,4,8,0xb2d1bb5d
361.45,1.0,21,1,2,2,5,0xb2d92843
526252.76,11.0,1,4,4,4,12,0xb2d12402d
414785.64,3.0,1,4,4,4,12,0xb2d0a9c6
4.08,1.0,69,1,2,1,4,0xb2d10740
1010.54,1.0,3,1,2,4,7,0xb2d2a4f1
300879.68,3.0,12,4,4,3,11,0xb2d0fda1
228878.93,2.0,33,3,3,2,8,0xb2d434bc
5634.88,1.0,0,2,2,4,8,0xb2d6b9c1d
621219.43,8.0,0,4,4,4,12,0xb2d20c6a
400000.0,2.0,18,4,3,2,9,0xb2da0ea2
255044.25,3.0,14,3,4,3,10,0xb2d6434cd
32371.58,1.0,0,2,2,4,8,0xb2d294da
770063.15,3.0,10,4,4,3,11,0xb2d18390d
100006.49,2.0,202,3,3,1,7,0xb2d40fdc
29608.22,1.0,0,2,2,4,8,0xb2d6c20f
12.98,1.0,71,1,2,1,4,0xb2d903c3
131007.78,2.0,82,3,3,1,7,0xb2d191fd
203554.63,2.0,16,3,3,2,8,0xb2d6c744d
459.5,1.0,37,1,2,2,5,0xb2d2b5cf
1036.51,1.0,180,1,2,1,4,0xb2d376b1
40201.32,1.0,92,2,2,1,5,0xb2d407d0d
134.5,1.0,77,1,2,1,4,0xb2d8fe1bd
150004.6,2.0,139,3,3,1,7,0xb2d25714
213515.47,1.0,103,3,2,1,6,0xb2d137e2d
1341048.42,4.0,32,4,4,2,10,0xb2d56f84
1806230.09,8.0,14,4,4,3,11,0xb2d6890bd
5.63,1.0,0,1,2,4,7,0xb2d96604
624.92,1.0,1,1,2,4,7,0xb2d4ebe1d
313227.54,4.0,9,4,4,3,11,0xb2d0868f
586076.55,1.0,81,4,2,1,7,0xb2d2a751
42763.78,3.0,184,2,4,1,7,0x3b9b169bd
13300.64,1.0,24,2,2,2,6,0xb2d823edd
85194.07,1.0,227,3,2,1,6,0xb2d51778
460000.85,3.0,9,4,4,3,11,0xb2d7ec55
231756.86,2.0,0,3,3,4,10,0xb2d33f90
190268.33,2.0,22,3,3,2,8,0xb2d1a3bf
50001.58,2.0,18,2,3,2,7,0xb2da22e5
3626210.73,6.0,67,4,4,1,9,0xb2d4cbf5
10513.03,1.0,95,2,2,1,5,0xb2d55999
57326.22,1.0,0,3,2,4,9,0xb2d6b746
42.96,1.0,0,1,2,4,7,0xb2d652cdd
3180.63,1.0,9,2,2,3,7,0xb2d2d217
1430.43,1.0,10,1,2,3,6,0xb2d9f98e
200100.06,2.0,67,3,3,1,7,0xb2d8f0f9
27035.35,1.0,1,2,2,4,8,0xb2d2a07cd
616408.34,3.0,172,4,4,1,9,0xb2d32bffd
45.4,1.0,23,1,2,2,5,0xb2d52030
995.41,1.0,31,1,2,2,5,0xb2d5f927
1161925.0,8.0,1,4,4,4,12,0xb2d6b49ed
430585.87,5.0,3,4,4,4,12,0xb2d4c84fd
87499.56,1.0,3,3,2,4,9,0xb2d697ab
200030.77,3.0,87,3,4,1,8,0xb2d17892d
30000.32,2.0,83,2,3,1,6,0xb2d97c71
3491.64,1.0,5,2,2,3,7,0xb2d9f5c2
308.42,1.0,16,1,2,2,5,0xb2d65797
7068.13,1.0,92,2,2,1,5,0xb2d2a326
61681.96,2.0,26,3,3,2,8,0xb2d420e5
0.0,2.0,59,1,3,2,6,0xb2d8f547
353016.98,2.0,50,4,3,2,9,0xb2d5bcb6
2471.9,1.0,8,1,2,3,6,0xb2d3f37c
1971135.94,7.0,66,4,4,2,10,0xb2d25208
18873.27,1.0,0,2,2,4,8,0xb2d29d49d
138.95,1.0,0,1,2,4,7,0xb2d9086c
3.17,1.0,1,1,2,4,7,0xb2d6bc03
176423.02,2.0,8,3,3,3,9,0xb2d1c541d
86613.63,4.0,0,3,4,4,11,0xb2d8ca8ed
51179.27,2.0,123,2,3,1,6,0xb2d68216d
5565.78,1.0,14,2,2,3,7,0xb2d8dcc2
1021.87,1.0,184,1,2,1,4,0x3b9b40afd
500049.32,2.0,13,4,3,3,10,0xb2d2131a
200040.51,4.0,14,3,4,3,10,0xb2d5f333d
211079.5,5.0,20,3,4,2,9,0xb2d393d5d
24009.35,1.0,45,2,2,2,6,0xb2d91624
224006.04,3.0,92,3,4,1,8,0xb2d9384e
610019.32,2.0,59,4,3,2,9,0xb2d8fa10d
1390.41,2.0,184,1,3,1,5,0xb2d086e1
189000.22,1.0,18,3,2,2,7,0xb2d5fda5d
6281.31,1.0,15,2,2,3,7,0xb2d9c453
501776.04,2.0,30,4,3,2,9,0xb2d61956d
7673.11,1.0,1,2,2,4,8,0xb2d6e682
0.0,1.0,6,1,2,3,6,0xb2d94fdf
1974.0,1.0,0,1,2,4,7,0xb2d6923d
16824.01,1.0,0,2,2,4,8,0xb2d6b079
675.96,1.0,20,1,2,2,5,0xb2d323cbd
200710.42,2.0,36,3,3,2,8,0xb2d6ee14
46.04,1.0,41,1,2,2,5,0xb2d6c184
30211.77,1.0,1,2,2,4,8,0xb2d69741
1073678.22,12.0,26,4,4,2,10,0xb2d310c1d
354981.69,6.0,11,4,4,3,11,0xb2d3dc27
5817.53,1.0,10,2,2,3,7,0xb2d3a41c
330439.15,4.0,3,4,4,4,12,0xb2d4999ed
223820.71,2.0,12,3,3,3,9,0xb2d633c8d
200014.28,2.0,14,3,3,3,9,0xb2d58a14d
70000.01,4.0,6,3,4,3,10,0xb2d3a8cd
50156.16,1.0,9,2,2,3,7,0xb2d6a9db
70100.18,3.0,7,3,4,3,10,0xb2d5b996
932.66,1.0,10,1,2,3,6,0xb2d3d206
1704128.87,10.0,12,4,4,3,11,0xb2d367e3
65089.07,3.0,14,3,4,3,10,0xb2d5fde9
31.67,1.0,75,1,2,1,4,0xb2d990dd
37.57,1.0,9,1,2,3,6,0xb2d94e8b
827000.0,8.0,1,4,4,4,12,0xb2d1110a
1016.07,1.0,92,1,2,1,4,0xb2d1b8fd
3000000.0,2.0,92,4,3,1,8,0xb2d5df7ad
2062.43,1.0,92,1,2,1,4,0xb2d2c58ed
1601023.3,3.0,136,4,4,1,9,0xb2d5b3d4
39125.1,3.0,0,2,4,4,10,0xb2d3b581
202464.6,2.0,10,3,3,3,9,0xb2d59eb2
58323.68,2.0,8,3,3,3,9,0xb2d1e7aa
6729.03,1.0,0,2,2,4,8,0xb2d5d906d
157.7,1.0,10,1,2,3,6,0xb2d94a7b
3199.08,1.0,76,2,2,1,5,0xb2d3c7ea
30227.49,1.0,9,2,2,3,7,0xb2d717c3d
4736.59,1.0,3,2,2,4,8,0xb2d30291
76591.76,1.0,11,3,2,3,8,0xb2d2d3c6d
151292.28,2.0,161,3,3,1,7,0xb2d5d808
1242.97,1.0,84,1,2,1,4,0xb2d1332f
104201.59,2.0,5,3,3,3,9,0xb2d63cba
5365217.18,1.0,0,4,2,4,10,0xb2d4ed00
6018.97,1.0,184,2,2,1,5,0xb2d3e62a
20802.23,1.0,182,2,2,1,5,0xb2d59a80
294017.51,7.0,3,3,4,4,11,0xb2d20cf2
1001051.52,2.0,224,4,3,1,8,0xb2d69191d
7509.15,1.0,26,2,2,2,6,0xb2d928c9
18028.14,1.0,13,2,2,3,7,0xb2d5b603
2081.04,1.0,184,1,2,1,4,0xb2d3a4cc
205632.11,2.0,18,3,3,2,8,0xb2d1f940d
328021.86,9.0,24,4,4,2,10,0xb2d333d0d
502885.29,2.0,8,4,3,3,10,0xb2d6e06ed
200025.31,3.0,63,3,4,2,9,0xb2d6d17ed
4687.09,1.0,32,2,2,2,6,0xb2d9d313
20001.18,2.0,47,2,3,2,7,0xb2d57e03d
533.77,1.0,6,1,2,3,6,0xb2d104bcd
175960.15,7.0,4,3,4,4,11,0xb2d9c56d
18.99,1.0,6,1,2,3,6,0xb2d8de98
1260000.93,3.0,15,4,4,3,11,0xb2d95cfad
100908.44,2.0,200,3,3,1,7,0xb2d6b215
550010.99,5.0,90,4,4,1,9,0xb2d23281
290000.0,2.0,20,3,3,2,8,0xb2da2cae
6019.3,1.0,13,2,2,3,7,0xb2d33c51
2916.46,1.0,92,2,2,1,5,0xb2d06475
30.08,1.0,29,1,2,2,5,0xb2da0041
80039.56,2.0,189,3,3,1,7,0xb2d4be57d
250496.75,2.0,1,3,3,4,10,0xb2d69af1
400247.2,3.0,0,4,4,4,12,0xb2d0a5d8d
1054.82,1.0,4,1,2,4,7,0xb2d6c84f
94006.06,5.0,14,3,4,3,10,0xb2d58105d
1010.97,1.0,184,1,2,1,4,0xb2d142e3d
257.82,1.0,60,1,2,2,5,0xb2d5e5b4d
202710.53,2.0,17,3,3,2,8,0xb2d1e8c8
14322.58,1.0,4,2,2,4,8,0xb2d34040d
471192.92,3.0,10,4,4,3,11,0xb2d5d203d
2308.54,1.0,92,1,2,1,4,0xb2d1a1fdd
0.2,1.0,88,1,2,1,4,0xb2d6074e
209320.28,1.0,7,3,2,3,8,0xb2d59318d
135695.92,4.0,136,3,4,1,8,0xb2d412b0
31078.47,2.0,83,2,3,1,6,0xb2d602d5d
655394.32,3.0,34,4,4,2,10,0xb2d0e5ded
80049.3,2.0,228,3,3,1,7,0xb2d3f546d
500325.08,3.0,3,4,4,4,12,0xb2d94b33d
80081.24,2.0,192,3,3,1,7,0xb2d5ad1dd
140075.15,4.0,0,3,4,4,11,0xb2d19b65
9164.33,1.0,57,2,2,2,6,0xb2d2a31f
31.17,1.0,17,1,2,2,5,0xb2d3edf5
201522.78,3.0,45,3,4,2,9,0xb2d22fa3
1087628.93,3.0,32,4,4,2,10,0x3b9aea6d
300005.85,3.0,31,3,4,2,9,0xb2d5bd82d
0.0,1.0,1,1,2,4,7,0xb2d3a66ed
2643.57,1.0,63,1,2,2,5,0xb2d8e35f
176.74,2.0,0,1,3,4,8,0xb2d4a3bcd
263023.13,2.0,22,3,3,2,8,0xb2d75478
772596.32,6.0,39,4,4,2,10,0xb2d5adbd
5012.96,1.0,6,2,2,3,7,0xb2d93a5d
1350.0,2.0,33,1,3,2,6,0xb2d93a77
3764.45,1.0,9,2,2,3,7,0xb2d57313
113.26,2.0,0,1,3,4,8,0xb2d212fbd
20513.6,1.0,0,2,2,4,8,0xb2d4d4bf
270914.67,2.0,92,3,3,1,7,0xb2d20247d
593188.32,5.0,18,4,4,2,10,0xb2d6532f
200005.28,3.0,83,3,4,1,8,0xb2d8cc52
673.83,1.0,0,1,2,4,7,0xb2d648e2
406004.11,11.0,0,4,4,4,12,0xb2d31530
616421.46,4.0,63,4,4,2,10,0xb2d65067
282.41,1.0,17,1,2,2,5,0xb2d22c02
1236001.58,6.0,98,4,4,1,9,0xb2d0c6bed
100002.11,2.0,38,3,3,2,8,0xb2d928a5d
126.67,1.0,20,1,2,2,5,0xb2d11060
598577.81,4.0,0,4,4,4,12,0xb2d16070
51476.18,1.0,24,2,2,2,6,0xb2d606de
18997.12,1.0,3,2,2,4,8,0xb2d1a7b6
150078.42,2.0,47,3,3,2,8,0xb2d6dbd5
220335.48,2.0,2,3,3,4,10,0x3b9b33bdd
20178.87,3.0,24,2,4,2,8,0xb2d5ba6b
350000.0,2.0,4,4,3,4,11,0xb2da2d50
2387.28,1.0,0,1,2,4,7,0xb2d6a17a
1928.57,1.0,5,1,2,3,6,0xb2d63594d
108073.61,4.0,7,3,4,3,10,0x3b9adfa9d
11131.36,1.0,7,2,2,3,7,0xb2d6bb0bd
3525.92,1.0,0,2,2,4,8,0xb2d34dbd
686097.15,14.0,27,4,4,2,10,0xb2d1a768
6155.25,2.0,0,2,3,4,9,0xb2d18399
3184.18,1.0,0,2,2,4,8,0xb2d21acb
277368.52,3.0,0,3,4,4,11,0xb2d31664d
30006.04,2.0,119,2,3,1,6,0xb2d59538
660010.67,6.0,15,4,4,3,11,0xb2d5df9cd
2.19,1.0,11,1,2,3,6,0xb2d0b213d
1.49,1.0,15,1,2,3,6,0xb2d1b425
1209763.55,4.0,0,4,4,4,12,0xb2d0dfcb
50957.35,2.0,157,2,3,1,6,0xb2d60dfdd
429983.13,2.0,10,4,3,3,10,0xb2d58999d
20000.21,2.0,59,2,3,2,7,0xb2d8febe
20001.0,2.0,98,2,3,1,6,0xb2d7aceb
2.22,1.0,17,1,2,2,5,0xb2d6afdc
118981.96,5.0,184,3,4,1,8,0x3b9af62dd
200710.49,2.0,50,3,3,2,8,0xb2d9d77b
3400672.05,10.0,0,4,4,4,12,0xb2d26a97
10458.09,2.0,38,2,3,2,7,0xb2d61149d
13667.75,6.0,92,2,4,1,7,0x3b9b33cb
69131.4,1.0,7,3,2,3,8,0xb2d238ab
200002.56,2.0,19,3,3,2,8,0xb2d6599fd
30027.93,2.0,202,2,3,1,6,0xb2d60f15d
10000.47,2.0,24,2,3,2,7,0xb2d98f76
127.66,1.0,11,1,2,3,6,0xb2d6c5c3
403174.92,4.0,90,4,4,1,9,0xb2d36058d
3319.68,1.0,5,2,2,3,7,0xb2d329ef
853103.66,2.0,30,4,3,2,9,0xb2d6f5f9
44.22,1.0,75,1,2,1,4,0xb2d63708
437084.17,4.0,6,4,4,3,11,0xb2d46d67d
150009.51,2.0,20,3,3,2,8,0xb2d93ce2
100005.3,2.0,92,3,3,1,7,0xb2d633b7
52448.56,1.0,1,3,2,4,9,0xb2d5f4c7d
1020000.04,3.0,15,4,4,3,11,0xb2d90437
482431.58,4.0,3,4,4,4,12,0xb2d0ebe5d
700015.63,3.0,14,4,4,3,11,0xb2d95aded
250001.57,3.0,23,3,4,2,9,0xb2d5c4edd
607830.18,3.0,2,4,4,4,12,0xb2d14333
120108.21,2.0,97,3,3,1,7,0xb2d46638
50067.78,1.0,8,2,2,3,7,0xb2d1297e
230234.7,2.0,0,3,3,4,10,0xb2d96576d
565.18,1.0,21,1,2,2,5,0xb2d69320d
4520.0,4.0,1,2,4,4,10,0xb2d0e391d
1425.62,1.0,311,1,2,1,4,0xb2d13104
430634.04,2.0,16,4,3,2,9,0xb2d56369
950594.25,4.0,181,4,4,1,9,0xb2d654a2
9035.91,1.0,15,2,2,3,7,0xb2d85ce2
405012.79,7.0,60,4,4,2,10,0xb2d21037
152084.9,3.0,136,3,4,1,8,0xb2d1e89cd
6192.81,1.0,132,2,2,1,5,0xb2d2ec14
81161.66,2.0,4,3,3,4,10,0xb2d94f47d
21465.43,3.0,14,2,4,3,9,0xb2d12e08
850066.62,4.0,140,4,4,1,9,0xb2d5f83b
1355.39,1.0,11,1,2,3,6,0xb2d1be09
8535.9,1.0,9,2,2,3,7,0xb2d8d3ed
13.99,3.0,33,1,4,2,7,0xb2d76a9dd
190105.08,2.0,26,3,3,2,8,0xb2d108eed
50021.63,2.0,92,2,3,1,6,0xb2d64987
818202.63,2.0,2,4,3,4,11,0xb2d37f5b
35125.21,1.0,0,2,2,4,8,0xb2d4c8c1
1173183.91,6.0,14,4,4,3,11,0xb2d1a34d
52398.6,2.0,153,3,3,1,7,0xb2d2f49ad
7648.81,1.0,22,2,2,2,6,0xb2d9bd1f
180038.19,3.0,104,3,4,1,8,0x3b9b3e92d
4.22,1.0,6,1,2,3,6,0xb2d969a8d
7.5,1.0,10,1,2,3,6,0xb2d42dd2d
300002.11,2.0,39,3,3,2,8,0xb2d91b5a
150014.76,2.0,77,3,3,1,7,0xb2d597ea
3120147.1,3.0,0,4,4,4,12,0xb2d6560cd
4295064.66,8.0,20,4,4,2,10,0xb2d21284
4957.22,1.0,0,2,2,4,8,0xb2d68c6c
416595.83,3.0,122,4,4,1,9,0x3b9b3e05
63.87,1.0,7,1,2,3,6,0xb2d93a5dd
13161.79,1.0,10,2,2,3,7,0xb2d59ef4
42.68,1.0,25,1,2,2,5,0xb2d229b5
14863.84,4.0,0,2,4,4,10,0x3b9b0e25
4908.39,1.0,1,2,2,4,8,0xb2d6f834
512188.01,9.0,0,4,4,4,12,0xb2d06978
178011.06,3.0,34,3,4,2,9,0xb2d6b6b1d
35471.49,7.0,234,2,4,1,7,0xb2d0b1a3d
1755925.74,17.0,11,4,4,3,11,0xb2d207c8d
1017530.1,3.0,25,4,4,2,10,0xb2d1f7bbd
520017.31,6.0,2,4,4,4,12,0xb2d0c9a9d
30339.74,2.0,24,2,3,2,7,0xb2d6fbec
2823.27,1.0,0,1,2,4,7,0xb2d1d89e
5367.3,1.0,92,2,2,1,5,0xb2d0d5c4d
2369627.22,22.0,3,4,4,4,12,0xb2d0b3ced
1801.01,1.0,31,1,2,2,5,0xb2d70142d
211896.76,6.0,67,3,4,1,8,0xb2d6610a
100016.14,2.0,6,3,3,3,9,0xb2d3c357
4383.13,1.0,25,2,2,2,6,0xb2d2dcf5
348837.81,1.0,46,4,2,2,8,0xb2d29a2fd
236669.98,2.0,23,3,3,2,8,0xb2d63d6bd
60821.69,3.0,129,3,4,1,8,0xb2d6403e
155532.0,2.0,158,3,3,1,7,0xb2d4d0ca
7.75,1.0,88,1,2,1,4,0xb2d58ce1
4521.03,1.0,92,2,2,1,5,0xb2d1cb33
2126277.65,4.0,76,4,4,1,9,0xb2d6452bd
21530.9,1.0,27,2,2,2,6,0xb2d93b67d
5799.48,1.0,184,2,2,1,5,0xb2d178bf
50000.53,2.0,80,2,3,1,6,0xb2d98fa4
896.75,2.0,83,1,3,1,5,0x3b9b24a6d
2300.95,1.0,0,1,2,4,7,0xb2d6ffb3
32878.36,1.0,71,2,2,1,5,0xb2d5350bd
5397.93,1.0,80,2,2,1,5,0xb2d590bb
1097317.1,4.0,5,4,4,3,11,0xb2d62a73d
765059.44,5.0,52,4,4,2,10,0xb2d5000ed
2474.7,2.0,168,1,3,1,5,0xb2d2644c
368.78,1.0,0,1,2,4,7,0xb2d900be
454083.13,14.0,1,4,4,4,12,0xb2d5e85ad
202131.98,2.0,103,3,3,1,7,0xb2d968b9d
55558.98,2.0,35,3,3,2,8,0xb2d921b2
190047.91,3.0,3,3,4,4,11,0xb2d19b04
151245.92,6.0,24,3,4,2,9,0xb2d65a34d
3071170.86,10.0,1,4,4,4,12,0xb2d50ea3
379006.65,2.0,125,4,3,1,8,0xb2d42cdc
107869.54,7.0,0,3,4,4,11,0x3b9b4217
1969.7,1.0,92,1,2,1,4,0xb2d1f0d7d
700136.11,3.0,19,4,4,2,10,0xb2d26041
39267.56,1.0,20,2,2,2,6,0xb2d30f4f
401.95,1.0,0,1,2,4,7,0xb2d3ce04
533019.24,3.0,27,4,4,2,10,0xb2d3eff6d
230821.96,2.0,54,3,3,2,8,0xb2d98a2b
171005.28,3.0,41,3,4,2,9,0xb2d1c3b9
300054.64,10.0,8,3,4,3,10,0xb2d62e4dd
920979.58,7.0,7,4,4,3,11,0xb2d1d3ddd
46747.08,8.0,0,2,4,4,10,0x3b9b186c
4539.54,1.0,14,2,2,3,7,0xb2d653ca
1160.36,1.0,92,1,2,1,4,0xb2d3a955d
257969.49,7.0,25,3,4,2,9,0xb2d39896
51273.46,2.0,73,2,3,1,6,0xb2d1db01
570004.34,9.0,1,4,4,4,12,0xb2d5c022d
14821.67,1.0,136,2,2,1,5,0xb2d5366f
483609.26,2.0,1,4,3,4,11,0xb2d29e4bd
100010.08,6.0,14,3,4,3,10,0xb2d14234
10825.81,1.0,7,2,2,3,7,0xb2d6bb78
1589.44,1.0,92,1,2,1,4,0xb2d52963
316272.38,3.0,24,4,4,2,10,0xb2d4369d
290015.24,2.0,92,3,3,1,7,0xb2d17ff0d
61151.78,1.0,2,3,2,4,9,0xb2d86e2bd
671756.21,1.0,77,4,2,1,7,0xb2d09ef0
280314.57,4.0,0,3,4,4,11,0xb2d59413d
7495.21,1.0,1,2,2,4,8,0xb2d17d38
98.17,1.0,60,1,2,2,5,0xb2d9797c
880357.26,3.0,0,4,4,4,12,0xb2d57346
40000.42,4.0,34,2,4,2,8,0xb2d63b3bd
38011.36,1.0,92,2,2,1,5,0xb2d2a84f
120089.53,2.0,200,3,3,1,7,0xb2d5735cd
339373.24,2.0,14,4,3,3,10,0xb2d4142d
172004.02,4.0,97,3,4,1,8,0xb2d8c359d
8818.76,1.0,207,2,2,1,5,0xb2d2901f
61053.94,4.0,147,3,4,1,8,0xb2d2cf50
50002.64,3.0,41,2,4,2,8,0xb2d991db
200036.42,2.0,15,3,3,3,9,0xb2d5fc2dd
17526.21,1.0,184,2,2,1,5,0xb2d172c3d
2014.04,1.0,136,1,2,1,4,0xb2d0a04bd
500103.29,3.0,18,4,4,2,10,0xb2da1769
591361.23,8.0,3,4,4,4,12,0xb2d1991dd
7125.5,2.0,57,2,3,2,7,0xb2d06581d
10047.36,1.0,19,2,2,2,6,0xb2d93f90
880108.88,11.0,0,4,4,4,12,0xb2d171b9d
185.08,1.0,12,1,2,3,6,0xb2d527b8
6623.9,1.0,92,2,2,1,5,0xb2d13c2cd
80865.41,2.0,47,3,3,2,8,0xb2d63bffd
600000.32,3.0,4,4,4,4,12,0xb2d9b2d2
20217.36,2.0,10,2,3,3,8,0xb2d5b6ccd
505000.0,2.0,0,4,3,4,11,0xb2d98076d
2618868.9,8.0,14,4,4,3,11,0xb2d8ea83
3168.45,1.0,184,2,2,1,5,0xb2d28ebbd
2988.98,1.0,8,2,2,3,7,0xb2d34df7d
10097.01,1.0,92,2,2,1,5,0xb2d202c6
408738.27,4.0,1,4,4,4,12,0xb2d78c9c
27251.23,1.0,0,2,2,4,8,0xb2d69102
0.28,1.0,4,1,2,4,7,0xb2d6f579
28473.26,2.0,0,2,3,4,9,0x3b9af6d0
304834.46,2.0,0,4,3,4,11,0xb2d6200b
1149.61,1.0,10,1,2,3,6,0xb2d8e141
130000.45,2.0,3,3,3,4,10,0xb2d597af
5854.73,1.0,140,2,2,1,5,0xb2d3ccccd
252347.68,2.0,41,3,3,2,8,0xb2d0b5abd
260001.21,2.0,21,3,3,2,8,0xb2da22c6
203573.89,1.0,3,3,2,4,9,0xb2d2b27b
1000000.0,2.0,21,4,3,2,9,0xb2da2799
1081.89,1.0,8,1,2,3,6,0xb2d2d24c
1086.01,1.0,92,1,2,1,4,0xb2d0f238d
230010.47,3.0,18,3,4,2,9,0xb2d627ec
1123.51,1.0,0,1,2,4,7,0xb2d54f87
170025.92,5.0,98,3,4,1,8,0xb2d0af8dd
2384.59,1.0,37,1,2,2,5,0xb2d412dd
110023.02,3.0,21,3,4,2,9,0xb2d5f887d
180.5,1.0,10,1,2,3,6,0xb2d329c2
24.09,1.0,18,1,2,2,5,0xb2d56f2a
7087.63,1.0,10,2,2,3,7,0xb2d59563d
1460045.04,4.0,3,4,4,4,12,0xb2d6cebd
247021.38,9.0,12,3,4,3,10,0xb2d39666
1000019.16,2.0,20,4,3,2,9,0xb2d903df
3000000.0,3.0,4,4,4,4,12,0xb2d95ead
2031947.46,19.0,0,4,4,4,12,0xb2d11744d
771564.86,9.0,1,4,4,4,12,0xb2d21436d
277.16,1.0,92,1,2,1,4,0xb2d58ccf
1686.16,1.0,92,1,2,1,4,0xb2d11488d
600000.0,4.0,1,4,4,4,12,0xb2d9222fd
5.68,1.0,18,1,2,2,5,0xb2d688be
152059.3,3.0,11,3,4,3,10,0xb2d3d3e2d
120989.2,2.0,70,3,3,1,7,0xb2d17bbed
3627.68,1.0,0,2,2,4,8,0xb2d6963c
4682.35,1.0,10,2,2,3,7,0xb2d3151fd
300094.97,4.0,53,3,4,2,9,0xb2d61f05
73605.83,2.0,2,3,3,4,10,0xb2d1256c
6.04,1.0,83,1,2,1,4,0xb2d6e682d
777007.26,14.0,13,4,4,3,11,0xb2d1b33cd
62.42,1.0,70,1,2,1,4,0xb2d8d437
300044.62,1.0,7,3,2,3,8,0xb2d3c79e
100003.17,2.0,59,3,3,2,8,0xb2d6d9dbd
4559.16,1.0,0,2,2,4,8,0xb2d23e59
80099.88,2.0,41,3,3,2,8,0xb2d91b4f
4203.05,1.0,5,2,2,3,7,0xb2d6a923
182576.41,3.0,34,3,4,2,9,0xb2d09836
278000.74,19.0,1,3,4,4,11,0xb2d5639b
3283.96,1.0,3,2,2,4,8,0xb2d6aed3
2946.51,1.0,200,2,2,1,5,0xb2d21f88d
450132.88,3.0,23,4,4,2,10,0xb2d98747
1433.3,1.0,0,1,2,4,7,0xb2d2b7b0d
4.62,1.0,51,1,2,2,5,0xb2d5d2cc
4.26,1.0,15,1,2,3,6,0xb2d1d27f
1008.02,1.0,184,1,2,1,4,0xb2d530eed
1000209.02,3.0,35,4,4,2,10,0xb2d219e3
1000001.0,1.0,0,4,2,4,10,0xb2da2bdd
1452.07,3.0,184,1,4,1,6,0x3b9adf46
1032.91,1.0,92,1,2,1,4,0xb2d347b0
0.0,1.0,0,1,2,4,7,0xb2da5d40
203219.03,2.0,151,3,3,1,7,0xb2d2b019d
63.33,1.0,18,1,2,2,5,0xb2d209f4
950000.43,5.0,0,4,4,4,12,0xb2d65889
2127.99,1.0,184,1,2,1,4,0xb2d2fac7d
60520.69,1.0,189,3,2,1,6,0xb2d64760d
1337006.27,3.0,100,4,4,1,9,0xb2d40f9d
500006.27,3.0,5,4,4,3,11,0xb2d92432d
2596.61,1.0,184,1,2,1,4,0xb2d4c841d
50001.6,2.0,35,2,3,2,7,0xb2d6270a
3162.94,8.0,0,2,4,4,10,0x3b9b46b9
2011491.13,82.0,0,4,4,4,12,0xb2d251a9
5.32,1.0,51,1,2,2,5,0xb2d6b5c8
2415.77,1.0,2,1,2,4,7,0xb2d20ef1
100001.06,2.0,98,3,3,1,7,0xb2d97091d
215113.46,4.0,15,3,4,3,10,0xb2d0761ad
1646.83,3.0,0,1,4,4,9,0xb2d0853dd
10.03,3.0,89,1,4,1,6,0xb2d0838f
5.71,1.0,27,1,2,2,5,0xb2d37c18
110123.35,2.0,0,3,3,4,10,0xb2d31be8d
1188.1,1.0,21,1,2,2,5,0x3b9b49abd
54.58,1.0,50,1,2,2,5,0xb2d44a27
358.77,1.0,77,1,2,1,4,0xb2d34e25
12584.54,1.0,3,2,2,4,8,0xb2d3d26bd
499917.18,1.0,0,4,2,4,10,0xb2d976a6
46371.93,5.0,14,2,4,3,9,0xb2d384afd
74624.94,3.0,15,3,4,3,10,0xb2d411c2
1465343.98,5.0,1,4,4,4,12,0xb2d1e8b7
4788.5,1.0,23,2,2,2,6,0xb2d97255
51663.35,2.0,8,2,3,3,8,0xb2d66875d
25251.57,1.0,184,2,2,1,5,0xb2d4d3bdd
190069.42,5.0,48,3,4,2,9,0xb2d548c8d
55002.32,2.0,143,3,3,1,7,0xb2d283f6
7886.08,1.0,0,2,2,4,8,0xb2d2370e
605346.28,3.0,83,4,4,1,9,0xb2d157dfd
16045.18,2.0,0,2,3,4,9,0xb2d10b71
151753.25,3.0,8,3,4,3,10,0xb2d45be6d
5479.7,1.0,0,2,2,4,8,0xb2d33612d
200000.0,3.0,0,3,4,4,11,0xb2d317e2
6079.94,1.0,12,2,2,3,7,0xb2d3f5bfd
20000.42,2.0,235,2,3,1,6,0xb2d6e894
5.45,1.0,104,1,2,1,4,0xb2d0f212d
230000.0,6.0,3,3,4,4,11,0xb2d5ced4
100580.33,2.0,3,3,3,4,10,0xb2d0be00
31482.37,1.0,1,2,2,4,8,0xb2d5e776
0.0,1.0,2,1,2,4,7,0xb2d2afd2
488768.34,11.0,0,4,4,4,12,0xb2d1e48ed
30449.71,2.0,73,2,3,1,6,0xb2d644f5
3613.52,1.0,14,2,2,3,7,0xb2d3902d
20000.26,2.0,24,2,3,2,7,0xb2d93132
290.56,1.0,10,1,2,3,6,0xb2d9fa08
1914416.89,7.0,0,4,4,4,12,0xb2d160d6
306398.53,2.0,126,4,3,1,8,0xb2d8a654d
100000.0,2.0,3,3,3,4,10,0xb2d2b800
7191.76,1.0,18,2,2,2,6,0xb2d6c4c4d
1058.86,1.0,92,1,2,1,4,0xb2d111bfd
30804.34,1.0,60,2,2,2,6,0xb2d0d148d
290227.23,11.0,0,3,4,4,11,0xb2d0a446d
390156.85,5.0,4,4,4,4,12,0xb2da03b5
1149.78,1.0,0,1,2,4,7,0xb2d5b373
1000828.22,1.0,3,4,2,4,10,0xb2d6b7abd
20165.68,2.0,126,2,3,1,6,0x3b9b13f4
6.29,1.0,13,1,2,3,6,0xb2d606db
250000.0,3.0,12,3,4,3,10,0xb2d93ed8
500015.39,2.0,0,4,3,4,11,0xb2d98954
30010.48,2.0,123,2,3,1,6,0xb2d64310d
287306.96,4.0,5,3,4,3,10,0xb2d185c5
151326.68,2.0,3,3,3,4,10,0xb2d5ff72d
1206.61,1.0,7,1,2,3,6,0xb2d21297
400120.91,4.0,0,4,4,4,12,0xb2da125a
1473.41,1.0,15,1,2,3,6,0xb2d58eb5
1380.93,1.0,10,1,2,3,6,0xb2d386edd
510079.91,40.0,13,4,4,3,11,0xb2d2b121d
0.0,2.0,69,1,3,1,5,0xb2d40fbf
202244.96,2.0,41,3,3,2,8,0xb2d5f437
900544.59,7.0,2,4,4,4,12,0xb2d64729
100056.26,2.0,158,3,3,1,7,0xb2d237e9
2408.04,1.0,38,1,2,2,5,0xb2d22a3f
1052.99,1.0,2,1,2,4,7,0xb2d5351f
0.0,1.0,0,1,2,4,7,0xb2d41e49d
303389.81,3.0,0,4,4,4,12,0xb2d5e8fc
311392.62,3.0,129,4,4,1,9,0xb2d15d1ad
342709.49,3.0,97,4,4,1,9,0x3b9b35c8
4800405.24,8.0,0,4,4,4,12,0x3b9af16bd
170032.07,7.0,53,3,4,2,9,0xb2d0ff7d
1270.11,1.0,9,1,2,3,6,0xb2d60e1bd
7458.79,1.0,0,2,2,4,8,0xb2d5ff6ad
500000.18,7.0,0,4,4,4,12,0xb2d41079
900029.15,5.0,93,4,4,1,9,0xb2d0b4a9
999049.06,6.0,0,4,4,4,12,0xb2d8fd3e
4231.41,9.0,92,2,4,1,7,0xb2d14912d
22.09,1.0,1,1,2,4,7,0xb2d3ea60
90034.3,2.0,145,3,3,1,7,0xb2d61129
27258.2,1.0,27,2,2,2,6,0xb2d200dd
20000.84,2.0,126,2,3,1,6,0xb2d930c6
255230.57,4.0,1,3,4,4,11,0xb2d93463d
390391.26,3.0,13,4,4,3,11,0xb2d5ff13d
2370285.96,3.0,27,4,4,2,10,0x3b9b485cd
146004.53,5.0,92,3,4,1,8,0xb2d420dc
973.94,1.0,0,1,2,4,7,0xb2d3191dd
100166.18,2.0,25,3,3,2,8,0xb2d6d0b4d
24680.07,2.0,1,2,3,4,9,0xb2d9af78
6692.13,1.0,5,2,2,3,7,0xb2d20f12
9020.23,1.0,10,2,2,3,7,0xb2d6f0fad
250970.65,3.0,0,3,4,4,11,0xb2d98808
970024.25,7.0,6,4,4,3,11,0xb2d429c2
6530.04,1.0,77,2,2,1,5,0xb2d1f7f0
13616.74,1.0,0,2,2,4,8,0xb2d5b2dd
3334190.23,5.0,6,4,4,3,11,0xb2d41f2d
1.68,2.0,62,1,3,2,6,0xb2d513fc
11972.86,1.0,0,2,2,4,8,0xb2d6b4c6
2393.32,2.0,1,1,3,4,8,0xb2d5af18
406643.9,2.0,0,4,3,4,11,0xb2d5d234
202132.14,2.0,110,3,3,1,7,0xb2d958aed
454.56,1.0,10,1,2,3,6,0xb2d95d94
702.1,1.0,8,1,2,3,6,0xb2d6252c
10.46,1.0,2,1,2,4,7,0xb2d602c6d
107308.02,2.0,92,3,3,1,7,0xb2d4da4bd
9422.14,1.0,184,2,2,1,5,0xb2d34f17d
1190.35,1.0,184,1,2,1,4,0xb2d1d9abd
1001.12,1.0,60,1,2,2,5,0xb2d9646c
1051053.36,6.0,12,4,4,3,11,0xb2d621d7d
272978.22,2.0,41,3,3,2,8,0xb2d83c7e
8969.92,1.0,19,2,2,2,6,0xb2d2cba6
979.61,1.0,15,1,2,3,6,0xb2d240c1
711.88,3.0,0,1,4,4,9,0x3b9b3db8
38294.38,1.0,11,2,2,3,7,0xb2d2d3c9d
41274.3,2.0,0,2,3,4,9,0xb2d65563
650621.33,5.0,0,4,4,4,12,0xb2d2816a
1570653.53,3.0,10,4,4,3,11,0xb2d0e70dd
200000.0,2.0,7,3,3,3,9,0xb2da56ab
7014.57,1.0,206,2,2,1,5,0xb2d692a5d
620045.31,11.0,1,4,4,4,12,0xb2d49138d
1488.07,1.0,147,1,2,1,4,0xb2d29b87
4203.71,1.0,1,2,2,4,8,0xb2d7661c
40374.82,2.0,179,2,3,1,6,0xb2d21984d
472838.12,9.0,0,4,4,4,12,0xb2d0defb
2013.43,1.0,0,1,2,4,7,0xb2d64ab0
12118.98,1.0,7,2,2,3,7,0xb2d4ff23d
883.49,1.0,8,1,2,3,6,0xb2d6ce84
56020.81,1.0,69,3,2,1,6,0xb2d36c42
6645.46,1.0,47,2,2,2,6,0xb2d7a7dd
10144.03,1.0,215,2,2,1,5,0xb2d62c1c
20000.63,2.0,87,2,3,1,6,0xb2d8c6a0
15.13,1.0,0,1,2,4,7,0xb2d7c157
0.56,1.0,1,1,2,4,7,0xb2d5c5b9
271044.76,7.0,25,3,4,2,9,0xb2d3c13cd
10252.18,1.0,10,2,2,3,7,0xb2d9249bd
50688.08,2.0,164,2,3,1,6,0xb2d604dbd
2150021.29,7.0,47,4,4,2,10,0xb2d4190fd
8913.53,1.0,0,2,2,4,8,0xb2d5516ad
234019.83,3.0,0,3,4,4,11,0xb2d27753d
1881.24,2.0,152,1,3,1,5,0xb2d69e0bd
146004.87,3.0,6,3,4,3,10,0xb2d50cacd
0.14,1.0,1,1,2,4,7,0xb2d46fb1
531071.9,4.0,30,4,4,2,10,0xb2d7767b
600046.97,2.0,32,4,3,2,9,0xb2d153ecd
2003.46,1.0,174,1,2,1,4,0xb2d8d64dd
37.79,1.0,3,1,2,4,7,0xb2d906c0d
2139.65,1.0,0,1,2,4,7,0xb2d91959
60016.35,4.0,24,3,4,2,9,0xb2d5f806d
263106.35,10.0,0,3,4,4,11,0x3b9b4758
22176.93,1.0,15,2,2,3,7,0xb2d5c24cd
17.73,2.0,50,1,3,2,6,0xb2d65516d
4618.27,1.0,184,2,2,1,5,0xb2d2d4ff
110001.56,3.0,30,3,4,2,9,0xb2d661f1d
210614.62,8.0,41,3,4,2,9,0xb2d0f1b4d
400008.51,2.0,94,4,3,1,8,0xb2d639add
300000.0,2.0,19,3,3,2,8,0xb2d95711d
934.26,2.0,66,1,3,2,6,0xb2d46751
21620.3,1.0,184,2,2,1,5,0xb2d347c6d
2024000.0,10.0,11,4,4,3,11,0xb2d255add
19457.04,1.0,13,2,2,3,7,0xb2d90300
10201.64,1.0,202,2,2,1,5,0xb2d5cf89d
20596.05,1.0,68,2,2,1,5,0xb2d58c9bd
4590.81,1.0,2,2,2,4,8,0xb2d95177
10000.21,2.0,10,2,3,3,8,0xb2d964da
299961.82,1.0,0,3,2,4,9,0xb2d3d068
6247.77,7.0,30,2,4,2,8,0x3b9b12c5d
200601.81,3.0,11,3,4,3,10,0xb2d34a56d
682029.4,3.0,25,4,4,2,10,0xb2d2577e
320120.14,4.0,110,4,4,1,9,0xb2d11f39
3650548.74,6.0,11,4,4,3,11,0xb2d11e9cd
14052.3,1.0,8,2,2,3,7,0xb2d98a9b
103084.07,2.0,168,3,3,1,7,0xb2d6925c
567.63,1.0,21,1,2,2,5,0xb2d1a6e8
147002.13,3.0,95,3,4,1,8,0xb2d8d392
101867.21,1.0,3,3,2,4,9,0xb2d66597d
2217417.2,7.0,0,4,4,4,12,0x3b9b18e3d
2411.1,1.0,0,1,2,4,7,0xb2d33b98
90020.37,3.0,67,3,4,1,8,0xb2d639c3
130040.82,1.0,19,3,2,2,7,0xb2d91e8e
494.22,1.0,0,1,2,4,7,0xb2d9652c
280000.0,5.0,6,3,4,3,10,0xb2d59b7b
40000.84,2.0,38,2,3,2,7,0xb2d2ab74
201165.11,2.0,82,3,3,1,7,0xb2d8fb1cd
9.17,1.0,6,1,2,3,6,0xb2d25188
20455.01,1.0,7,2,2,3,7,0xb2d3ab48d
270011.71,2.0,60,3,3,2,8,0xb2d9b7e7
4926.39,2.0,172,2,3,1,6,0xb2d3b3b6
1810.43,1.0,92,1,2,1,4,0xb2d3ffbf
1132184.72,13.0,11,4,4,3,11,0xb2d53fb5d
463.31,1.0,2,1,2,4,7,0xb2d3906f
446821.31,6.0,1,4,4,4,12,0xb2d3cee4
207007.23,2.0,1,3,3,4,10,0xb2d68555
50053.13,2.0,263,2,3,1,6,0xb2d5ff06
0.64,1.0,11,1,2,3,6,0xb2d6c90c
3.27,1.0,21,1,2,2,5,0xb2d6f759
1424.44,2.0,92,1,3,1,5,0xb2d1d222d
300000.32,5.0,41,3,4,2,9,0xb2d62457
420004.43,2.0,25,4,3,2,9,0xb2da1550
16.19,3.0,28,1,4,2,7,0xb2d27dc3
132115.35,7.0,0,3,4,4,11,0x3b9af0e6d
133043.88,4.0,14,3,4,3,10,0xb2d55111d
200000.0,2.0,15,3,3,3,9,0xb2da3927
8.18,1.0,10,1,2,3,6,0xb2d30c31
8.56,2.0,53,1,3,2,6,0x3b9b48c9
230002.43,3.0,87,3,4,1,8,0xb2d8c3d2
931000.8,8.0,1,4,4,4,12,0xb2d28024d
562387.78,1.0,0,4,2,4,10,0xb2d9f368
20242.77,1.0,8,2,2,3,7,0xb2d37d11d
3014.26,1.0,10,2,2,3,7,0xb2d85b64
2.03,1.0,11,1,2,3,6,0xb2d3fcb8
2841.05,1.0,23,1,2,2,5,0xb2d0a6afd
6047.44,1.0,184,2,2,1,5,0xb2d20ed1
22726.06,3.0,0,2,4,4,10,0x3b9add40
855029.46,3.0,0,4,4,4,12,0xb2d6b59e
4367.54,1.0,6,2,2,3,7,0xb2d694b4
4238840.6,18.0,0,4,4,4,12,0xb2d44ce6
50000.63,2.0,0,2,3,4,9,0xb2d5122cd
566242.52,6.0,10,4,4,3,11,0xb2d1781e
520016.05,12.0,15,4,4,3,11,0xb2d2625f
912.9,5.0,0,1,4,4,9,0xb2d30098d
103415.07,1.0,8,3,2,3,8,0xb2d62599
33000.24,2.0,8,2,3,3,8,0xb2d65a1cd
200000.0,2.0,7,3,3,3,9,0xb2da47f0
911752.32,7.0,74,4,4,1,9,0xb2d2408bd
83574.8,3.0,5,3,4,3,10,0xb2d52c9e
3638.11,1.0,18,2,2,2,6,0xb2d20506
51.26,1.0,51,1,2,2,5,0xb2d36149
101323.9,3.0,4,3,4,4,11,0xb2d46875d
46638.5,3.0,148,2,4,1,7,0xb2d54993
1360096.91,7.0,1,4,4,4,12,0xb2d44476
41053.14,2.0,1,2,3,4,9,0xb2d55f20d
21788.06,1.0,0,2,2,4,8,0xb2d9f58e
22400.53,3.0,17,2,4,2,8,0xb2da0337
700000.0,1.0,1,4,2,4,10,0xb2da6702
241248.65,2.0,75,3,3,1,7,0xb2d6f495d
741554.58,2.0,120,4,3,1,8,0xb2d30b1a
297600.1,9.0,0,3,4,4,11,0x3b9af1f2d
1151439.74,4.0,3,4,4,4,12,0xb2d5f6b4d
50000.45,2.0,1,2,3,4,9,0xb2da52f0
59464.83,2.0,0,3,3,4,10,0xb2d29219
64747.59,1.0,34,3,2,2,7,0xb2d5e5d5d
5030.96,1.0,184,2,2,1,5,0xb2d42d1dd
644298.94,2.0,1,4,3,4,11,0xb2d41166d
420025.32,5.0,13,4,4,3,11,0xb2d10db1d
10000.11,2.0,39,2,3,2,7,0xb2d9f32e
5546.56,2.0,1,2,3,4,9,0xb2d5305b
109484.52,3.0,165,3,4,1,8,0xb2d25ca3d
232000.0,2.0,20,3,3,2,8,0xb2d954ca
52978.55,2.0,20,3,3,2,8,0xb2d2163e
25.01,1.0,0,1,2,4,7,0xb2d4f70d
602265.51,4.0,9,4,4,3,11,0xb2d41789d
151253.94,3.0,10,3,4,3,10,0xb2d6083ed
120435.01,6.0,0,3,4,4,11,0x3b9b18efd
135818.53,3.0,27,3,4,2,9,0xb2d60598d
688475.93,5.0,10,4,4,3,11,0xb2d1b0cc
50445.36,2.0,231,2,3,1,6,0xb2d4b2dbd
80000020.01,5.0,38,4,4,2,10,0xb2d413b3
920801.56,2.0,1,4,3,4,11,0xb2d38000d
3.61,1.0,17,1,2,2,5,0xb2d23c49
307.74,1.0,4,1,2,4,7,0xb2d3278b
50057.59,2.0,95,2,3,1,6,0xb2d4d04d
100020.17,2.0,17,3,3,2,8,0xb2da0ac9
2307.22,1.0,0,1,2,4,7,0xb2d64d8f
161.84,1.0,3,1,2,4,7,0xb2d289f1
500000.0,3.0,10,4,4,3,11,0xb2d96cc3
0.0,1.0,5,1,2,3,6,0xb2da36ec
485578.32,4.0,32,4,4,2,10,0xb2d2ac98
259004.6,2.0,25,3,3,2,8,0xb2d60f52d
1793.11,1.0,10,1,2,3,6,0xb2d6bf61d
29808.99,1.0,138,2,2,1,5,0xb2d6108cd
95637.02,1.0,21,3,2,2,7,0xb2d5359cd
3198.91,2.0,184,2,3,1,6,0xb2d1ce0ed
1067.03,1.0,167,1,2,1,4,0xb2d3175a
3007.68,1.0,252,2,2,1,5,0xb2d6ba60d
3402.3,1.0,1,2,2,4,8,0xb2d2f33c
86005.02,5.0,50,3,4,2,9,0xb2d8faa5
700025.67,8.0,77,4,4,1,9,0xb2d1550f
122230.84,2.0,13,3,3,3,9,0xb2d6baac
81429.51,4.0,42,3,4,2,9,0xb2d08a1ad
317007.04,7.0,31,4,4,2,10,0xb2d17c82d
1058.97,1.0,92,1,2,1,4,0xb2d34cd7d
2234044.13,6.0,3,4,4,4,12,0xb2d67cd5d
2289438.83,77.0,0,4,4,4,12,0xb2d4a6f2
11380.69,1.0,0,2,2,4,8,0xb2d2ab2dd
213646.83,2.0,12,3,3,3,9,0xb2d0f123
430841.16,3.0,9,4,4,3,11,0xb2d52008d
2936.83,1.0,0,2,2,4,8,0xb2d97082
350014.78,4.0,34,4,4,2,10,0xb2d64853d
9042.99,1.0,110,2,2,1,5,0xb2d308cd
2000000.0,1.0,1,4,2,4,10,0xb2d63d5c
5086.34,1.0,53,2,2,2,6,0xb2d6d1bed
14001.2,2.0,73,2,3,1,6,0xb2d4d052
501499.53,2.0,0,4,3,4,11,0xb2d11035
1434.17,1.0,184,1,2,1,4,0xb2d2315cd
900095.22,4.0,7,4,4,3,11,0xb2d6ff70
19.33,1.0,1,1,2,4,7,0xb2d92d74
112961.0,2.0,182,3,3,1,7,0xb2d28b89
211036.58,2.0,10,3,3,3,9,0xb2d28fc3
14.53,1.0,52,1,2,2,5,0xb2d8c52f
200002.52,2.0,10,3,3,3,9,0xb2d5d596d
13960.06,1.0,184,2,2,1,5,0xb2d1d9c6d
100010.83,2.0,200,3,3,1,7,0xb2d5706b
4.74,1.0,12,1,2,3,6,0xb2d1c0a3
50000.0,2.0,1,2,3,4,9,0xb2da5d0e
19.71,1.0,31,1,2,2,5,0xb2d54f43d
154081.88,4.0,17,3,4,2,9,0xb2d086b0
60013.21,2.0,10,3,3,3,9,0xb2d186f7d
154687.57,3.0,18,3,4,2,9,0xb2d58a50
2526.35,1.0,184,1,2,1,4,0xb2d2fe0ad
5.74,1.0,18,1,2,2,5,0xb2d341f2
40019.49,2.0,23,2,3,2,7,0xb2d5a242
584.21,1.0,1,1,2,4,7,0xb2d8fe7c
1711205.04,1.0,168,4,2,1,7,0xb2d62f90
96713.58,6.0,0,3,4,4,11,0xb2d0f4fbd
4302.3,1.0,20,2,2,2,6,0xb2d642f5
80013.76,2.0,172,3,3,1,7,0xb2d5b848
10928.05,1.0,0,2,2,4,8,0xb2d2fd57
1252.63,1.0,5,1,2,3,6,0xb2d8846b
1118613.3,2.0,25,4,3,2,9,0xb2d1538b
500000.54,3.0,3,4,4,4,12,0xb2d42577d
133947.51,1.0,4,3,2,4,9,0xb2d6b2fcd
25343.64,1.0,1,2,2,4,8,0xb2d6cc2b
153009.38,2.0,266,3,3,1,7,0xb2d50f3ad
11.18,1.0,4,1,2,4,7,0xb2d67dd8
607.75,1.0,9,1,2,3,6,0xb2d5fb8b
50640.5,2.0,130,2,3,1,6,0xb2d6e053
250000.21,4.0,6,3,4,3,10,0xb2d6b102
930914.98,7.0,11,4,4,3,11,0xb2d601d2
5031.28,1.0,92,2,2,1,5,0xb2d40a6dd
22.17,1.0,47,1,2,2,5,0xb2d9cf9d
191876.95,4.0,4,3,4,4,11,0xb2d4274ad
150059.66,2.0,179,3,3,1,7,0xb2d10b6d
800520.61,2.0,92,4,3,1,8,0xb2d5812b
300021.1,2.0,4,3,3,4,10,0xb2d96481
739190.41,1.0,0,4,2,4,10,0xb2d2ba87
300030.67,3.0,0,3,4,4,11,0xb2d14fc8
30780.27,1.0,161,2,2,1,5,0xb2d422bad
48.51,1.0,46,1,2,2,5,0xb2d30438
50001.06,2.0,73,2,3,1,6,0xb2d8e38e
4533.3,1.0,12,2,2,3,7,0xb2d6b8e0
1609093.36,8.0,6,4,4,3,11,0xb2d1872ad
711046.48,5.0,98,4,4,1,9,0xb2d197f0d
34.67,1.0,10,1,2,3,6,0xb2d907cd
20578.03,1.0,1,2,2,4,8,0xb2d2f5eb
770860.42,6.0,3,4,4,4,12,0xb2d56bbad
29307.56,3.0,1,2,4,4,10,0xb2d4e7e7d
1698.52,1.0,2,1,2,4,7,0xb2d1e89a
600023.76,4.0,2,4,4,4,12,0xb2d19b1bd
110010.57,2.0,210,3,3,1,7,0xb2d562c2d
210058.7,4.0,18,3,4,2,9,0xb2d67de2
124.77,1.0,63,1,2,2,5,0xb2d7c17a
158.34,1.0,34,1,2,2,5,0xb2d97640
521389.95,7.0,3,4,4,4,12,0x3b9b18ca
222345.2,2.0,104,3,3,1,7,0xb2d964dfd
1218.97,1.0,184,1,2,1,4,0xb2d26d5d
417700.22,5.0,59,4,4,2,10,0xb2d4b2eb
830.49,2.0,0,1,3,4,8,0x3b9af1be
3662.33,1.0,6,2,2,3,7,0xb2d6162f
1062055.41,1.0,6,4,2,3,9,0xb2d56399
200710.43,2.0,42,3,3,2,8,0xb2d922ac
44160.44,2.0,80,2,3,1,6,0xb2d5a6c3
785317.4,5.0,4,4,4,4,12,0xb2d11fa0
10313.64,1.0,20,2,2,2,6,0xb2d4194f
140006.3,3.0,104,3,4,1,8,0xb2d0e7ead
2401.29,1.0,14,1,2,3,6,0xb2d8ca84
400423.88,4.0,0,4,4,4,12,0xb2d554a2d
2758.74,1.0,1,1,2,4,7,0xb2d94f37
30130.19,1.0,10,2,2,3,7,0xb2d68c62d
16576.52,1.0,31,2,2,2,6,0xb2d21ebad
11622.94,3.0,0,2,4,4,10,0xb2d09c85
95.0,1.0,82,1,2,1,4,0xb2d87b3f
100005.28,2.0,20,3,3,2,8,0xb2da1c27
826805.98,5.0,87,4,4,1,9,0xb2d1d698d
551037.76,6.0,8,4,4,3,11,0xb2d19771
160004.32,4.0,47,3,4,2,9,0xb2d3a47c
592429.43,4.0,0,4,4,4,12,0xb2d1781ed
29977.51,1.0,14,2,2,3,7,0xb2d64a09
1001.17,1.0,121,1,2,1,4,0xb2d91a63
200000.0,5.0,8,3,4,3,10,0xb2d6f742
203000.83,2.0,6,3,3,3,9,0xb2d220fc
3670786.28,3.0,179,4,4,1,9,0xb2d1ab19d
637027.26,5.0,55,4,4,2,10,0xb2d511e9
51779.67,2.0,4,2,3,4,9,0xb2d6b379
325374.9,4.0,3,4,4,4,12,0xb2d23423d
130037.47,3.0,32,3,4,2,9,0xb2d11b58d
3.24,1.0,51,1,2,2,5,0xb2d9951f
53808.17,2.0,113,3,3,1,7,0xb2d54d01
124505502.34,8.0,0,4,4,4,12,0xb2d1151e
2025.06,1.0,184,1,2,1,4,0xb2d23275
100003.17,2.0,52,3,3,2,8,0xb2d907ff
1560466.13,6.0,0,4,4,4,12,0xb2d61f77
3967.01,1.0,0,2,2,4,8,0xb2d0f034d
40017.11,3.0,26,2,4,2,8,0xb2d68910d
103001.6,5.0,0,3,4,4,11,0xb2d651de
10.46,1.0,19,1,2,2,5,0xb2d1e824
1123012.34,9.0,11,4,4,3,11,0xb2d0b552
20364.28,2.0,52,2,3,2,7,0xb2d4e8e3
8890.41,1.0,184,2,2,1,5,0xb2d3a450d
805.37,2.0,21,1,3,2,6,0xb2d20500d
3104.26,1.0,1,2,2,4,8,0xb2d4fb73d
50408.63,2.0,4,2,3,4,9,0xb2d51c9f
11978.02,1.0,15,2,2,3,7,0xb2d60a48
1010285.78,4.0,0,4,4,4,12,0xb2d8f9c2
8.41,1.0,0,1,2,4,7,0xb2d368c1
314187.09,5.0,28,4,4,2,10,0xb2d0a948
40350.71,2.0,21,2,3,2,7,0xb2d39951
20970.59,1.0,191,2,2,1,5,0xb2d15ea4
5401.32,1.0,1,2,2,4,8,0xb2d47277d
65049.14,3.0,13,3,4,3,10,0xb2d812ead
268056.83,3.0,143,3,4,1,8,0xb2d2313fd
10000.11,2.0,18,2,3,2,7,0xb2da30fb
200911.26,2.0,5,3,3,3,9,0xb2d9fd83
181.49,1.0,17,1,2,2,5,0xb2d8ec05
12435.08,1.0,1,2,2,4,8,0xb2d32916
73.11,1.0,9,1,2,3,6,0xb2d6411d
380.3,1.0,0,1,2,4,7,0xb2d40553d
5003.31,2.0,18,2,3,2,7,0xb2d145c1d
62282.1,3.0,25,3,4,2,9,0xb2d5c1a8d
200000.0,2.0,4,3,3,4,10,0xb2da6165
3495.28,1.0,3,2,2,4,8,0xb2d6b713d
200000.03,2.0,8,3,3,3,9,0xb2d96fe5d
7443.59,1.0,10,2,2,3,7,0xb2d9909d
62563.91,1.0,0,3,2,4,9,0xb2d3492cd
1.02,1.0,1,1,2,4,7,0xb2d636d2
1589732.06,6.0,1,4,4,4,12,0xb2d46925
340302.55,3.0,0,4,4,4,12,0xb2d22c21
10003.92,2.0,73,2,3,1,6,0xb2d8dfe1d
263004.59,5.0,7,3,4,3,10,0xb2d220fcd
706231.34,30.0,0,4,4,4,12,0x3b9addaa
60000.63,2.0,6,3,3,3,9,0xb2da49fd
51805.55,1.0,29,2,2,2,6,0xb2d33a33
550120.0,4.0,116,4,4,1,9,0xb2d186b2d
5373.39,1.0,0,2,2,4,8,0xb2d6bcf6
2377.88,1.0,184,1,2,1,4,0xb2d3718d
11288.46,1.0,0,2,2,4,8,0xb2d6ace8
342798.27,4.0,0,4,4,4,12,0xb2d1a341
3.76,1.0,52,1,2,2,5,0xb2d60604d
165611.17,1.0,0,3,2,4,9,0xb2d58057
235860.18,4.0,70,3,4,1,8,0xb2d08154d
280069.74,2.0,122,3,3,1,7,0xb2d56087d
13.53,1.0,4,1,2,4,7,0xb2d29ace
5993.21,1.0,0,2,2,4,8,0xb2d4cbdc
225180.41,6.0,0,3,4,4,11,0xb2d16f7c
194466.73,4.0,1,3,4,4,11,0xb2d5e426
109276.94,4.0,0,3,4,4,11,0xb2d0798bd
1665.2,1.0,35,1,2,2,5,0xb2d2d977d
177903.37,3.0,116,3,4,1,8,0xb2d0d1af
354342.09,1.0,63,4,2,2,8,0xb2d32612
40083.93,3.0,22,2,4,2,8,0xb2d63549
3036.18,1.0,272,2,2,1,5,0xb2d41a4ad
1612002.8,5.0,4,4,4,4,12,0xb2d28d3cd
250000.8,4.0,2,3,4,4,11,0xb2d97477d
19.92,1.0,29,1,2,2,5,0xb2d928a2
471230.44,18.0,1,4,4,4,12,0xb2d0e26bd
3103.93,1.0,129,2,2,1,5,0xb2d590bdd
160227.78,2.0,165,3,3,1,7,0xb2d1dab9
3042.8,12.0,1,2,4,4,10,0x3b9b1856d
258721.18,1.0,10,3,2,3,8,0xb2d5574bd
450056.77,7.0,8,4,4,3,11,0xb2d23e03d
131003.23,2.0,32,3,3,2,8,0xb2d921e8d
890074.53,12.0,1,4,4,4,12,0xb2d3d675
610006.19,4.0,2,4,4,4,12,0xb2d5fdbb
210001.88,2.0,13,3,3,3,9,0xb2d9a1d5
20.53,1.0,68,1,2,1,4,0xb2d9a692
2606056.34,17.0,3,4,4,4,12,0xb2d104fdd
3016.5,1.0,45,2,2,2,6,0xb2d3c44ad
7425.73,1.0,0,2,2,4,8,0xb2d2eed2d
15266.57,1.0,1,2,2,4,8,0xb2d6e703d
54.57,1.0,83,1,2,1,4,0xb2d3eafc
250000.0,2.0,0,3,3,4,10,0xb2d983df
915240.98,3.0,56,4,4,2,10,0xb2d11a18d
5018.55,1.0,0,2,2,4,8,0xb2d8e735
235160.68,6.0,3,3,4,4,11,0xb2d64996d
105.97,1.0,10,1,2,3,6,0xb2d6f432d
228.95,1.0,10,1,2,3,6,0xb2d32fe3d
2673.68,1.0,3,1,2,4,7,0xb2d58da6
200002.51,2.0,2,3,3,4,10,0xb2d8ee8d
296917.14,5.0,0,3,4,4,11,0xb2d957fa
710206.95,3.0,39,4,4,2,10,0xb2d1a604d
1935.1,1.0,247,1,2,1,4,0xb2d5cdffd
271546.87,1.0,1,3,2,4,9,0xb2d26250
561400.01,3.0,1,4,4,4,12,0xb2d0dd05d
600002.64,4.0,14,4,4,3,11,0xb2d9a10a
90016.78,4.0,8,3,4,3,10,0xb2d5bd37d
471862.34,4.0,112,4,4,1,9,0xb2d06435d
3467.9,1.0,184,2,2,1,5,0xb2d2179cd
500008.89,1.0,3,4,2,4,10,0xb2d5e7a5d
508.13,1.0,39,1,2,2,5,0x3b9b46a4d
400663.87,3.0,13,4,4,3,11,0xb2d9d077
210367.8,3.0,0,3,4,4,11,0xb2d9ff91
0.0,1.0,7,1,2,3,6,0xb2d78b5d
2032.34,1.0,184,1,2,1,4,0xb2d10f74
14456.92,1.0,137,2,2,1,5,0xb2d6bd1fd
12712.98,2.0,18,2,3,2,7,0xb2d4c5e6d
31.67,1.0,60,1,2,2,5,0xb2d8f43ed
60000.63,2.0,5,3,3,3,9,0xb2d96b37
1212695.59,3.0,52,4,4,2,10,0xb2d0fd76
48.2,1.0,22,1,2,2,5,0xb2d4b68e
110006.87,3.0,12,3,4,3,10,0xb2d95a9fd
100121.9,5.0,1,3,4,4,11,0xb2d3a5a8
700828.84,5.0,0,4,4,4,12,0xb2d5625ad
501.87,1.0,0,1,2,4,7,0xb2d5d8b7
90445.21,2.0,38,3,3,2,8,0xb2d29b3d
5224.54,1.0,5,2,2,3,7,0xb2d9346e
187979.04,1.0,0,3,2,4,9,0xb2d600d5
274156.14,3.0,2,3,4,4,11,0xb2d0ca9fd
302005.03,3.0,0,4,4,4,12,0xb2d78d7ad
30001.42,3.0,68,2,4,1,7,0xb2d6e326
489861.2,10.0,28,4,4,2,10,0xb2d32130
0.0,1.0,3,1,2,4,7,0xb2d119ed
18240.13,1.0,41,2,2,2,6,0xb2d6d131
1491.24,1.0,92,1,2,1,4,0xb2d289bbd
103184.06,1.0,1,3,2,4,9,0xb2d24907d
11065.74,1.0,2,2,2,4,8,0xb2d6bbb4d
401019.98,4.0,27,4,4,2,10,0xb2d30f0dd
1173.58,1.0,92,1,2,1,4,0xb2d23002
1951.5,1.0,4,1,2,4,7,0xb2d2c4b0d
2.01,1.0,101,1,2,1,4,0xb2d230c9d
50006.98,2.0,46,2,3,2,7,0xb2d8ff51
3.02,1.0,31,1,2,2,5,0xb2d295e3
11049.18,1.0,184,2,2,1,5,0xb2d5b169
350003.17,3.0,18,4,4,2,10,0xb2d95493d
673367.09,4.0,15,4,4,3,11,0xb2d18884d
399.02,1.0,54,1,2,2,5,0xb2d5ee86
20000.21,2.0,28,2,3,2,7,0xb2da0a42
2272.67,1.0,10,1,2,3,6,0xb2d67d41
1188.27,1.0,184,1,2,1,4,0xb2d26d3d
1000000.0,2.0,4,4,3,4,11,0xb2d4346e
331857.79,8.0,9,4,4,3,11,0xb2d0759b
100117.96,2.0,127,3,3,1,7,0xb2d5d768
370043.26,7.0,7,4,4,3,11,0xb2d155e3d
1020.41,1.0,92,1,2,1,4,0xb2d26c74
750.66,1.0,9,1,2,3,6,0xb2d57888
4281.91,1.0,126,2,2,1,5,0xb2d5dcfcd
200000.0,2.0,21,3,3,2,8,0xb2da26e4
104.54,2.0,147,1,3,1,5,0xb2d412ced
99435.14,1.0,0,3,2,4,9,0xb2d5bec1
215316.11,3.0,200,3,4,1,8,0xb2d372ae
14003.66,1.0,62,2,2,2,6,0xb2d30a5d
202210.21,2.0,84,3,3,1,7,0xb2d68693
46133.66,1.0,9,2,2,3,7,0xb2d29cdad
2565.25,1.0,2,1,2,4,7,0xb2d69b0a
1369.96,1.0,184,1,2,1,4,0xb2d26e71
1000031.67,2.0,25,4,3,2,9,0xb2da0f27
13890.64,1.0,12,2,2,3,7,0xb2d913d9
328.35,1.0,9,1,2,3,6,0xb2d5ec3b
17992.86,1.0,91,2,2,1,5,0xb2d15543
50002.11,2.0,97,2,3,1,6,0xb2d8363ed
10.45,1.0,28,1,2,2,5,0xb2d9c6a1
1108116.95,20.0,0,4,4,4,12,0xb2d23f1dd
471946.57,3.0,35,4,4,2,10,0xb2d14194d
838.48,1.0,48,1,2,2,5,0xb2d17501
100279.33,1.0,19,3,2,2,7,0xb2d9c676
1744.05,1.0,0,1,2,4,7,0xb2d2aa6e
20506.61,2.0,122,2,3,1,6,0xb2d5eb83
100060.7,2.0,77,3,3,1,7,0xb2d0c437
6728.35,1.0,4,2,2,4,8,0xb2d3e4f8
1428.58,1.0,22,1,2,2,5,0xb2d2cd5b
222000.11,4.0,80,3,4,1,8,0xb2d6fa31d
3005.93,1.0,8,2,2,3,7,0xb2d6f026
1436.79,1.0,92,1,2,1,4,0xb2d40715d
79261.33,1.0,7,3,2,3,8,0xb2d3b46cd
518.03,1.0,68,1,2,1,4,0xb2d955a4
3077.79,1.0,10,2,2,3,7,0xb2d28e27d
780399.69,11.0,25,4,4,2,10,0xb2d65d51d
243157.65,4.0,12,3,4,3,10,0xb2d640d0d
202843.09,2.0,134,3,3,1,7,0xb2d92260
15.13,1.0,65,1,2,2,5,0xb2d4024fd
797882.45,13.0,4,4,4,4,12,0xb2d3981cd
353311.53,3.0,0,4,4,4,12,0xb2d0d39a
70270.88,2.0,92,3,3,1,7,0xb2d3db48
1456.12,1.0,190,1,2,1,4,0xb2d643e1d
50000.0,2.0,3,2,3,4,9,0xb2d975a2d
5000000.0,2.0,3,4,3,4,11,0xb2d97640d
4545.3,1.0,191,2,2,1,5,0xb2d647d1d
33.01,1.0,32,1,2,2,5,0xb2d5be68
790015.16,4.0,4,4,4,4,12,0xb2d97deed
601826.14,1.0,93,4,2,1,7,0xb2d2a5d0d
5062.13,1.0,92,2,2,1,5,0xb2d2192cd
58256.8,5.0,92,3,4,1,8,0xb2d1a6ba
807.67,1.0,0,1,2,4,7,0xb2d35deb
318493.19,3.0,110,4,4,1,9,0xb2d2b28fd
928.54,1.0,32,1,2,2,5,0xb2d591e4d
323097.05,2.0,57,4,3,2,9,0xb2d0e8bdd
768540.94,8.0,0,4,4,4,12,0xb2d21177
301098.03,2.0,31,4,3,2,9,0xb2d47dc7
1566015.77,15.0,0,4,4,4,12,0xb2d253e7d
987612.47,3.0,27,4,4,2,10,0xb2d8f300
2035.7,1.0,2,1,2,4,7,0xb2d210ffd
5008.78,1.0,0,2,2,4,8,0xb2d33d95
43.67,1.0,10,1,2,3,6,0xb2d6b04f
312179.46,6.0,60,4,4,2,10,0xb2d4ebc7
6455.42,1.0,92,2,2,1,5,0xb2d20df2d
223178.51,6.0,11,3,4,3,10,0xb2d55d22
1019035.43,4.0,14,4,4,3,11,0xb2d286fa
8959.29,1.0,23,2,2,2,6,0xb2d26041d
161806.34,1.0,26,3,2,2,7,0xb2d942e3
12803.79,1.0,3,2,2,4,8,0xb2d33650d
1520.38,1.0,219,1,2,1,4,0xb2d4004a
20018.79,1.0,98,2,2,1,5,0xb2d85757
500000.0,2.0,9,4,3,3,10,0xb2d96d9dd
860027.53,6.0,0,4,4,4,12,0xb2d22293d
2327.02,1.0,18,1,2,2,5,0xb2d3406ad
550000.01,4.0,15,4,4,3,11,0xb2d56f10d
90058.63,2.0,63,3,3,2,8,0xb2d67e7bd
0.07,1.0,92,1,2,1,4,0xb2d0e79f
472829.03,5.0,0,4,4,4,12,0xb2d85ad7d
500000.0,4.0,12,4,4,3,11,0xb2d10645d
2536990.92,7.0,9,4,4,3,11,0xb2d0961cd
510000.0,3.0,6,4,4,3,11,0xb2da3f5c
560081.2,2.0,64,4,3,2,9,0xb2d22b6b
400080.86,3.0,14,4,4,3,11,0xb2d5d556
102962.81,2.0,92,3,3,1,7,0xb2d26501d
3256.14,1.0,184,2,2,1,5,0x3b9b1821d
100134.7,2.0,161,3,3,1,7,0xb2d43435d
27.37,1.0,3,1,2,4,7,0xb2d3fbd4
4262.54,1.0,1,2,2,4,8,0xb2d6efd7d
1680025.76,7.0,1,4,4,4,12,0xb2d94e7cd
752.43,1.0,38,1,2,2,5,0xb2d37c5bd
497009.37,7.0,69,4,4,1,9,0xb2d31fce
1237.11,1.0,184,1,2,1,4,0xb2d2a6f1d
1165.1,1.0,260,1,2,1,4,0xb2d33087d
88.53,1.0,39,1,2,2,5,0xb2d5ea2dd
2088.78,1.0,92,1,2,1,4,0xb2d19895d
1765833.78,6.0,32,4,4,2,10,0xb2d22c18
1686.8,1.0,0,1,2,4,7,0xb2d2d2b7
160126.18,3.0,41,3,4,2,9,0xb2d907e9d
50026.93,2.0,69,2,3,1,6,0xb2d5d389d
1000000.0,2.0,4,4,3,4,11,0xb2da48f8
600740.83,13.0,4,4,4,4,12,0xb2d99535
3482.46,1.0,176,2,2,1,5,0xb2d5872dd
122305.33,2.0,153,3,3,1,7,0xb2d15831d
710012.02,12.0,0,4,4,4,12,0xb2d62dfad
12453.29,1.0,21,2,2,2,6,0xb2d6d56a
108811.47,2.0,13,3,3,3,9,0xb2d5943bd
74029.8,1.0,3,3,2,4,9,0xb2d30a2e
3494.38,2.0,13,2,3,3,8,0x3b9b454e
2912839.09,9.0,3,4,4,4,12,0xb2d0d08d
94.64,1.0,13,1,2,3,6,0xb2d274b9
26469.58,1.0,184,2,2,1,5,0xb2d3befd
60564.15,2.0,3,3,3,4,10,0xb2d2778a
0.0,1.0,10,1,2,3,6,0xb2d90697
511.2,1.0,10,1,2,3,6,0xb2d9fd2a
1004.22,1.0,184,1,2,1,4,0xb2d5ebcad
28095.23,2.0,4,2,3,4,9,0xb2d35c83
261.4,1.0,5,1,2,3,6,0xb2d52beb
200084.78,2.0,6,3,3,3,9,0xb2d6080dd
661.62,1.0,10,1,2,3,6,0xb2d8cef5
1566.08,1.0,92,1,2,1,4,0xb2d27b05d
425643.14,4.0,101,4,4,1,9,0xb2d28941
50012.61,1.0,0,2,2,4,8,0xb2da67da
285852.44,9.0,4,3,4,4,11,0xb2d06548d
340692.26,5.0,1,4,4,4,12,0xb2d6944fd
6459.88,1.0,1,2,2,4,8,0xb2d2e087d
254.97,1.0,12,1,2,3,6,0xb2d69c7d
509661.85,4.0,109,4,4,1,9,0xb2d118d2
85155.62,2.0,4,3,3,4,10,0xb2d5d2a6d
451520.37,2.0,125,4,3,1,8,0xb2d50f93
31273.08,2.0,10,2,3,3,8,0xb2d65563d
2009.28,1.0,14,1,2,3,6,0xb2d6bd35d
1012.24,1.0,184,1,2,1,4,0xb2d0ea7e
280000.57,2.0,6,3,3,3,9,0xb2d63e3c
25954.75,1.0,159,2,2,1,5,0xb2d0dc83
114054.62,2.0,14,3,3,3,9,0xb2d55c3ed
928.7,1.0,10,1,2,3,6,0xb2d57191
24321.45,1.0,0,2,2,4,8,0xb2d1581e
53003.28,2.0,92,3,3,1,7,0xb2d0d84d
63366.75,4.0,5,3,4,3,10,0xb2d2d524d
10000.11,2.0,25,2,3,2,7,0xb2da160d
19468.44,1.0,29,2,2,2,6,0xb2d17521
68.79,2.0,28,1,3,2,6,0xb2d5ae64
21344.76,1.0,46,2,2,2,6,0xb2d1be09d
25285.65,1.0,27,2,2,2,6,0xb2d42f95
217158.19,2.0,196,3,3,1,7,0xb2d165a7
1841.1,1.0,14,1,2,3,6,0xb2d5fbd1d
253841.39,3.0,130,3,4,1,8,0xb2d649e0d
1269.87,1.0,0,1,2,4,7,0xb2d2fe9ed
4154.71,1.0,184,2,2,1,5,0xb2d58d20d
3891.17,1.0,0,2,2,4,8,0xb2d1fbeb
10417.19,1.0,0,2,2,4,8,0xb2d8ede7
125058.58,2.0,3,3,3,4,10,0xb2d39358d
700000.0,3.0,10,4,4,3,11,0xb2d8d74fd
36159.73,2.0,0,2,3,4,9,0xb2d8e166
20.47,1.0,17,1,2,2,5,0xb2d33d02
120002.53,2.0,1,3,3,4,10,0xb2d946d5d
22248.36,1.0,0,2,2,4,8,0xb2d62a2b
1682.94,1.0,92,1,2,1,4,0xb2d2a179
10095.82,2.0,177,2,3,1,6,0xb2d3346f
7016.42,1.0,0,2,2,4,8,0xb2d6b4b3d
53095.92,2.0,206,3,3,1,7,0xb2d3fbe7d
400046.02,2.0,1,4,3,4,11,0xb2d77390
12896.41,1.0,20,2,2,2,6,0xb2d68e6bd
6324.42,1.0,9,2,2,3,7,0xb2d61841
24592.21,1.0,20,2,2,2,6,0xb2d62d13d
130793.01,1.0,84,3,2,1,6,0xb2d643bcd
1149044.87,9.0,5,4,4,3,11,0xb2d08674d
8700091.83,2.0,31,4,3,2,9,0xb2d935a9
10000.42,5.0,5,2,4,3,9,0xb2d95045d
340009.48,2.0,66,4,3,2,9,0xb2d6cd5f
4638.11,1.0,10,2,2,3,7,0xb2d8f1db
4675.41,1.0,0,2,2,4,8,0xb2d327fbd
46257.83,1.0,5,2,2,3,7,0xb2d5d830
190008.04,2.0,217,3,3,1,7,0xb2d71a0f
336525.33,4.0,92,4,4,1,9,0xb2d0a429d
103215.2,2.0,4,3,3,4,10,0xb2d5bff7
211079.29,5.0,94,3,4,1,8,0xb2d565ee
1654353.93,4.0,11,4,4,3,11,0xb2d2a1a7
18558.09,1.0,0,2,2,4,8,0xb2d4eeddd
2908.71,1.0,13,2,2,3,7,0xb2d31231
350065.44,4.0,7,4,4,3,11,0xb2d67ddf
450006.5,4.0,0,4,4,4,12,0xb2d5f157
853.48,1.0,1,1,2,4,7,0xb2d69a76d
703.18,1.0,30,1,2,2,5,0xb2d64939d
12895.98,1.0,4,2,2,4,8,0xb2d6ccb0
100020.63,2.0,119,3,3,1,7,0xb2d51720
430016.64,10.0,27,4,4,2,10,0xb2d40685
10998.74,1.0,65,2,2,2,6,0xb2d7ec2ad
9879.83,3.0,7,2,4,3,9,0xb2d064a9d
1614.69,1.0,132,1,2,1,4,0xb2d27b1f
158.6,1.0,2,1,2,4,7,0xb2d90ad1d
2366.52,1.0,3,1,2,4,7,0xb2d2b7ab
780802.87,13.0,1,4,4,4,12,0x3b9b291c
15.64,1.0,18,1,2,2,5,0xb2d51a35
4441622.71,16.0,1,4,4,4,12,0x3b9ad78ad
200871.25,2.0,92,3,3,1,7,0xb2d16fced
500000.0,3.0,15,4,4,3,11,0xb2da3867
34300.79,2.0,7,2,3,3,8,0xb2d1d692
103622.97,2.0,8,3,3,3,9,0xb2d5192d
0.0,2.0,0,1,3,4,8,0xb2d97619
40454.31,1.0,22,2,2,2,6,0xb2d40dec
1452.51,1.0,0,1,2,4,7,0xb2d87ad1
5042.86,2.0,92,2,3,1,6,0x3b9b2729
722450.43,5.0,15,4,4,3,11,0xb2d24f9b
6776613.66,8.0,42,4,4,2,10,0xb2d1297d
404023.76,5.0,0,4,4,4,12,0xb2d14f7cd
29173.94,5.0,0,2,4,4,10,0xb2d29bd0
252664.87,2.0,99,3,3,1,7,0xb2d9700e
8654.71,1.0,29,2,2,2,6,0xb2d92cc4
90051.55,4.0,8,3,4,3,10,0xb2d570a1d
464272.81,10.0,25,4,4,2,10,0xb2d572b2
404.97,1.0,8,1,2,3,6,0xb2d985ad
2201.06,1.0,4,1,2,4,7,0xb2d8da1b
612.74,1.0,47,1,2,2,5,0xb2d52a86
1291.06,1.0,4,1,2,4,7,0xb2d63e6fd
475127.24,5.0,56,4,4,2,10,0xb2d0df19d
370050.0,1.0,0,4,2,4,10,0xb2da5ccc
155.39,1.0,67,1,2,1,4,0xb2d95d23
13074.87,1.0,0,2,2,4,8,0xb2d6c1acd
2.33,1.0,0,1,2,4,7,0xb2d69221
230152.19,7.0,4,3,4,4,11,0xb2d2cd5e
200004.22,2.0,73,3,3,1,7,0xb2d8e1a4d
909.74,2.0,0,1,3,4,8,0x3b9b3b54
771742.08,2.0,5,4,3,3,10,0xb2d8c84b
750074.29,4.0,6,4,4,3,11,0xb2d10ca3d
150000.0,2.0,0,3,3,4,10,0xb2d3c5c6
132.57,1.0,8,1,2,3,6,0xb2d12175
1142.91,1.0,92,1,2,1,4,0xb2d3f181
3573434.41,23.0,0,4,4,4,12,0x3b9b0e20d
753125.61,9.0,14,4,4,3,11,0xb2d1a82c
4152.65,1.0,5,2,2,3,7,0xb2d589add
1226.55,1.0,10,1,2,3,6,0xb2d9d3f7
1863.55,1.0,47,1,2,2,5,0xb2d5ed99d
29402.54,1.0,0,2,2,4,8,0xb2d40406
4545.62,1.0,83,2,2,1,5,0xb2d6c6ad
600099.15,4.0,196,4,4,1,9,0xb2d0efe1d
1000021.8,2.0,206,4,3,1,8,0xb2d5b003d
4030.19,3.0,1,2,4,4,10,0xb2d08df0
410697.53,3.0,127,4,4,1,9,0xb2d6aabbd
1001.88,1.0,188,1,2,1,4,0xb2d805d2d
1724.51,1.0,9,1,2,3,6,0xb2d3d13c
2215.43,1.0,5,1,2,3,6,0xb2d275df
60.61,1.0,13,1,2,3,6,0xb2d9d46b
78315.19,12.0,0,3,4,4,11,0x3b9b4638d
17717.41,1.0,20,2,2,2,6,0xb2d6b9ded
20270.1,1.0,9,2,2,3,7,0xb2d40d45
33551.61,1.0,12,2,2,3,7,0xb2d2dfe7d
286148.39,2.0,0,3,3,4,10,0x3b9b3d9fd
8042.81,1.0,16,2,2,2,6,0xb2d43273
911535.97,3.0,75,4,4,1,9,0xb2d58685
67877.53,3.0,0,3,4,4,11,0xb2d07c86d
255017.22,3.0,3,3,4,4,11,0xb2d0cd74d
301006.45,2.0,0,4,3,4,11,0xb2d0febbd
75430.99,2.0,63,3,3,2,8,0xb2d44032
399.28,1.0,18,1,2,2,5,0xb2d50dc4d
2001.27,1.0,69,1,2,1,4,0xb2d8ee4cd
79205.73,1.0,184,3,2,1,6,0xb2d1aa9ed
300080.0,1.0,0,3,2,4,9,0xb2da411d
330006.64,4.0,42,4,4,2,10,0xb2d97fe6
400087.43,3.0,2,4,4,4,12,0xb2d64711d
901.65,1.0,35,1,2,2,5,0xb2d9612e
730055.58,11.0,3,4,4,4,12,0xb2d4d95e
320000.38,2.0,8,4,3,3,10,0xb2d6cf7e
274351.68,2.0,76,3,3,1,7,0xb2d13fc5d
500917.84,2.0,111,4,3,1,8,0xb2d504afd
62965.05,2.0,171,3,3,1,7,0xb2d24de4
180391.93,4.0,38,3,4,2,9,0xb2d414c1d
470015.14,6.0,18,4,4,2,10,0xb2d8e2ccd
73.93,1.0,19,1,2,2,5,0xb2d2cba6d
56252.85,2.0,1,3,3,4,10,0xb2d230b0
202259.06,1.0,0,3,2,4,9,0xb2d422a7
57838.02,2.0,6,3,3,3,9,0xb2d6c198
146054.96,1.0,11,3,2,3,8,0xb2d6facfd
2118.19,1.0,15,1,2,3,6,0xb2d882f4
4.09,1.0,40,1,2,2,5,0xb2d1fc76
100008.76,2.0,2,3,3,4,10,0xb2d5c878d
5001.08,1.0,17,2,2,2,6,0xb2d23d9b
7105.08,1.0,153,2,2,1,5,0xb2d53592
200000.77,2.0,4,3,3,4,10,0xb2d87974
22.28,1.0,3,1,2,4,7,0xb2d6d719
2336.88,1.0,92,1,2,1,4,0xb2d3792f
1007.11,1.0,92,1,2,1,4,0xb2d39f9ed
4412.67,1.0,92,2,2,1,5,0xb2d0f0c8d
1154.8,1.0,21,1,2,2,5,0xb2d23e86d
4155.11,1.0,92,2,2,1,5,0x3b9accb7
2375.6,1.0,92,1,2,1,4,0xb2d3718dd
35004.24,3.0,18,2,4,2,8,0xb2d53036d
120108.31,2.0,189,3,3,1,7,0xb2d46638d
340337.78,3.0,0,4,4,4,12,0xb2d1776fd
7030.85,1.0,184,2,2,1,5,0xb2d42830
80003.45,5.0,8,3,4,3,10,0x3b9b1006
3000001.37,3.0,0,4,4,4,12,0xb2d96f43
10616.25,1.0,184,2,2,1,5,0xb2d2bc3e
5560.2,1.0,151,2,2,1,5,0xb2d40655d
210334.91,3.0,18,3,4,2,9,0xb2d698e3
208004.39,2.0,87,3,3,1,7,0xb2d17636
800038.78,3.0,6,4,4,3,11,0xb2d217d2d
561.08,1.0,5,1,2,3,6,0xb2d8e09a
67360.13,3.0,0,3,4,4,11,0xb2d98254
530039.87,2.0,239,4,3,1,8,0xb2d26ac2d
803502.18,3.0,32,4,4,2,10,0xb2d719b7
250000.53,3.0,14,3,4,3,10,0xb2d29659
30435.6,2.0,132,2,3,1,6,0xb2d61747d
134.05,2.0,14,1,3,3,7,0xb2d4fab2d
31825.48,1.0,5,2,2,3,7,0xb2d69b4ed
381017.8,6.0,19,4,4,2,10,0xb2d97ca0d
1294.79,1.0,184,1,2,1,4,0xb2d1f04ad
5681.85,1.0,205,2,2,1,5,0xb2d4b402
171528.73,4.0,10,3,4,3,10,0xb2d1636ed
360796.95,3.0,0,4,4,4,12,0xb2d533abd
501199.53,3.0,27,4,4,2,10,0xb2d97e1ad
101278.51,4.0,95,3,4,1,8,0xb2d59dc6d
7220.33,1.0,20,2,2,2,6,0xb2d6c84ad
80036.04,2.0,151,3,3,1,7,0xb2d1044e
300004.44,3.0,22,3,4,2,9,0xb2da1f47
101014.98,3.0,21,3,4,2,9,0xb2d35391d
15093.42,1.0,2,2,2,4,8,0xb2d6e16c
304403.23,2.0,4,4,3,4,11,0xb2d88e5fd
4036.63,1.0,0,2,2,4,8,0xb2d6b558d
35776.62,2.0,0,2,3,4,9,0xb2d0693f
1015.03,1.0,92,1,2,1,4,0xb2d11d42
365009.16,6.0,41,4,4,2,10,0xb2d5d087d
201452.29,2.0,15,3,3,3,9,0xb2d4ee02
100425.39,2.0,3,3,3,4,10,0xb2d915c2
1502.82,1.0,184,1,2,1,4,0xb2d0da5f
36654.61,1.0,2,2,2,4,8,0xb2d9daa9
10.63,1.0,46,1,2,2,5,0xb2d3743a
455479.84,5.0,0,4,4,4,12,0xb2d781c1
49.71,2.0,58,1,3,2,6,0xb2d30499
493270.28,7.0,189,4,4,1,9,0x3b9b480ed
596118.9,5.0,20,4,4,2,10,0xb2d0bf3b
40488.33,3.0,28,2,4,2,8,0xb2d68d37d
100404.17,2.0,11,3,3,3,9,0xb2d5f647d
50001.58,2.0,6,2,3,3,8,0xb2d9655b
50023.66,3.0,60,2,4,2,8,0xb2d9239b
475000.8,10.0,22,4,4,2,10,0xb2d4205ed
1.61,1.0,15,1,2,3,6,0xb2d119a7
10215.76,1.0,184,2,2,1,5,0xb2d5bc49
224892.26,2.0,34,3,3,2,8,0xb2d5e158d
50003.76,2.0,28,2,3,2,7,0xb2d1ebe1
82184.41,2.0,153,3,3,1,7,0xb2d49605d
128.9,1.0,9,1,2,3,6,0xb2d90054
12800.81,1.0,6,2,2,3,7,0xb2d755c8d
124543.24,5.0,168,3,4,1,8,0xb2d56f3ed
201716.85,2.0,46,3,3,2,8,0xb2d6948dd
3103986.84,5.0,87,4,4,1,9,0xb2d6e297
100298.64,3.0,70,3,4,1,8,0xb2d6327c
30.21,1.0,54,1,2,2,5,0xb2d7096f
10366.88,2.0,7,2,3,3,8,0xb2d12fa4
21479.86,1.0,4,2,2,4,8,0xb2d5b761
1263.75,1.0,10,1,2,3,6,0xb2d568de
70005.41,3.0,0,3,4,4,11,0xb2d5b089d
432.45,1.0,19,1,2,2,5,0xb2d63e97
17692.95,2.0,0,2,3,4,9,0xb2d8ebd1d
1123607.25,7.0,0,4,4,4,12,0xb2d646d5d
1285294.2,4.0,144,4,4,1,9,0xb2d62a32
351647.55,3.0,4,4,4,4,12,0xb2d62067
1.06,1.0,18,1,2,2,5,0xb2d2481ad
2001.83,1.0,1,1,2,4,7,0xb2d917b3
30.93,1.0,8,1,2,3,6,0xb2d348cad
38.58,1.0,15,1,2,3,6,0xb2d2d33b
0.0,1.0,20,1,2,2,5,0xb2d98639
100710.24,3.0,31,3,4,2,9,0xb2d1fe5cd
510.59,1.0,5,1,2,3,6,0xb2d97738
106649.07,2.0,70,3,3,1,7,0xb2d495b0
8952.08,1.0,15,2,2,3,7,0xb2d98e40
454980.94,4.0,11,4,4,3,11,0xb2d672fdd
361498.53,3.0,15,4,4,3,11,0xb2d8e108d
404018.33,2.0,143,4,3,1,8,0xb2d12b3b
29879.54,1.0,92,2,2,1,5,0xb2d395f2
672.38,2.0,66,1,3,2,6,0xb2d1266e
2005.87,1.0,92,1,2,1,4,0xb2d61b93d
200000.84,2.0,19,3,3,2,8,0xb2d8d876d
8170.53,1.0,184,2,2,1,5,0xb2d35b9c
20882.94,2.0,38,2,3,2,7,0xb2d4f557
2000096.92,2.0,32,4,3,2,9,0xb2d92cbdd
9234.0,1.0,10,2,2,3,7,0xb2d2b209
2626.24,1.0,0,1,2,4,7,0xb2d2c20a
440007.56,4.0,15,4,4,3,11,0xb2d07dafd
300330.46,3.0,66,4,4,2,10,0xb2d43586d
150092.96,4.0,28,3,4,2,9,0xb2d134c5
50000002.0,2.0,92,4,3,1,8,0xb2d532bdd
60037.58,2.0,98,3,3,1,7,0xb2d4a5acd
69362.46,1.0,10,3,2,3,8,0xb2d68c08d
4112.32,1.0,206,2,2,1,5,0xb2d15bd4
9311.52,1.0,10,2,2,3,7,0xb2d6d424
0.21,1.0,67,1,2,1,4,0xb2d580d0
503552.79,2.0,75,4,3,1,8,0xb2d9a0cf
17.52,1.0,59,1,2,2,5,0xb2d31606d
39329.14,2.0,0,2,3,4,9,0xb2d92b44d
223487.06,4.0,42,3,4,2,9,0xb2d0b3bfd
10.06,2.0,39,1,3,2,6,0xb2d26ba9d
50022.69,1.0,52,2,2,2,6,0xb2d43447
19.28,2.0,14,1,3,3,7,0xb2d57b95d
1195056.65,7.0,0,4,4,4,12,0xb2d07f9b
21044.3,1.0,11,2,2,3,7,0xb2d951d3
57021.04,4.0,3,3,4,4,11,0xb2d9244bd
30002.25,3.0,55,2,4,2,8,0xb2d9afe9
566808.26,2.0,0,4,3,4,11,0xb2d237c6
826877.89,2.0,123,4,3,1,8,0xb2d34ba6d
100006.19,7.0,23,3,4,2,9,0xb2d3547cd
11.18,1.0,62,1,2,2,5,0xb2d69877
220549.27,3.0,28,3,4,2,9,0xb2d60eedd
35.47,1.0,82,1,2,1,4,0xb2d1d534d
47469.52,2.0,4,2,3,4,9,0xb2d21ea2
370012.38,6.0,18,4,4,2,10,0x3b9b102c
180007.69,2.0,77,3,3,1,7,0xb2d57a3dd
500008.97,2.0,4,4,3,4,11,0xb2da11dc
200497.52,2.0,0,3,3,4,10,0xb2d67a81d
44243.05,2.0,2,2,3,4,9,0xb2d2b9df
4571476.83,10.0,1,4,4,4,12,0xb2d141d3
2811922.11,4.0,5,4,4,3,11,0xb2d3b609d
525499.83,2.0,0,4,3,4,11,0xb2d0da4f
590002.43,3.0,18,4,4,2,10,0xb2da26d1
33474.82,1.0,184,2,2,1,5,0xb2d31c15
896.55,1.0,9,1,2,3,6,0xb2d4aa0d
57616077.77,4.0,66,4,4,2,10,0x3b9aee2ed
20000.63,2.0,95,2,3,1,6,0xb2d972d9
130029.38,2.0,105,3,3,1,7,0xb2d2b3d0d
1051836.6,3.0,0,4,4,4,12,0xb2d65d75d
7102.11,1.0,10,2,2,3,7,0xb2d9d798
361034.08,4.0,0,4,4,4,12,0xb2d6338f
756330.64,8.0,15,4,4,3,11,0xb2d1a82cd
79.06,1.0,7,1,2,3,6,0xb2d7a6a3
100435.1,2.0,3,3,3,4,10,0xb2d0a30bd
250804.8,4.0,228,3,4,1,8,0xb2d638ddd
20002.16,1.0,15,2,2,3,7,0xb2d4ea79
27000.29,2.0,80,2,3,1,6,0xb2d9902e
63.33,1.0,24,1,2,2,5,0xb2da11f2
2754.44,1.0,92,1,2,1,4,0xb2d2611bd
6017.78,1.0,1,2,2,4,8,0xb2d34837d
56054.07,2.0,239,3,3,1,7,0xb2d0ec66d
291185.72,9.0,4,3,4,4,11,0xb2d7f458d
10000.11,2.0,18,2,3,2,7,0xb2da0870
48.42,1.0,17,1,2,2,5,0xb2d993de
171.85,1.0,9,1,2,3,6,0xb2d32b00
102536.93,1.0,84,3,2,1,6,0xb2d1238bd
50038.06,2.0,19,2,3,2,7,0xb2d21bb3d
2.32,1.0,69,1,2,1,4,0xb2d348a7
11810.05,1.0,92,2,2,1,5,0xb2d080c0d
200876.82,2.0,11,3,3,3,9,0xb2da1e5a
200972.5,2.0,19,3,3,2,8,0xb2d5b71d
53246.45,1.0,8,3,2,3,8,0xb2d2b82bd
23382.92,3.0,4,2,4,4,10,0xb2d06524
20378.0,1.0,162,2,2,1,5,0xb2d5ef19
1006.33,1.0,184,1,2,1,4,0xb2d24248
604924.3,5.0,20,4,4,2,10,0xb2d68273
130011.62,2.0,101,3,3,1,7,0xb2d1791b
100428.64,10.0,4,3,4,4,11,0xb2d63460
564425.91,5.0,14,4,4,3,11,0xb2d21751
173318.41,2.0,139,3,3,1,7,0xb2d37b8fd
1520.71,1.0,92,1,2,1,4,0x3b9b19e2d
400015.19,6.0,24,4,4,2,10,0xb2d24398d
576429.24,1.0,0,4,2,4,10,0xb2d2f9cdd
1000010.56,2.0,66,4,3,2,9,0xb2d8f112d
281697.13,2.0,13,3,3,3,9,0xb2d0f3c4d
3000.0,1.0,3,2,2,4,8,0xb2d944b3
294271.92,9.0,7,3,4,3,10,0xb2d5d9c3d
1169.47,5.0,0,1,4,4,9,0xb2d06481d
553660.4,4.0,5,4,4,3,11,0xb2d38c5dd
472.28,1.0,19,1,2,2,5,0xb2d2017a
10372.88,1.0,0,2,2,4,8,0xb2d5c98b
2483889.02,24.0,0,4,4,4,12,0xb2d22553d
500000.0,2.0,18,4,3,2,9,0xb2da3325
4671.42,1.0,92,2,2,1,5,0xb2d40bad
70188.07,2.0,28,3,3,2,8,0xb2d5d391d
722398.14,1.0,1,4,2,4,10,0xb2d428b5d
200521.45,2.0,91,3,3,1,7,0xb2d98239
500076.3,2.0,6,4,3,3,10,0xb2d90b5c
224292.61,1.0,3,3,2,4,9,0xb2d202b1
5331.81,1.0,14,2,2,3,7,0xb2d8d61d
51028.31,2.0,73,2,3,1,6,0xb2d5b027
247462.18,5.0,0,3,4,4,11,0x3b9af2c6d
1184000.0,15.0,4,4,4,4,12,0xb2d5c1ae
517215.6,1.0,3,4,2,4,10,0xb2d6128c
975.05,1.0,1,1,2,4,7,0xb2d8c844
1503152.45,4.0,151,4,4,1,9,0xb2d77ff2d
90073.75,5.0,118,3,4,1,8,0xb2d07af4d
80000.1,2.0,5,3,3,3,9,0xb2d102e8
207907.31,4.0,6,3,4,3,10,0xb2d3eeabd
10304.11,1.0,5,2,2,3,7,0xb2d78918d
150.0,1.0,15,1,2,3,6,0xb2d964d7
113.09,1.0,67,1,2,1,4,0xb2d33c16d
205616.56,2.0,35,3,3,2,8,0xb2d685b2d
251732.78,3.0,68,3,4,1,8,0xb2d58796d
311.75,1.0,60,1,2,2,5,0xb2d5f3eb
2540418.15,11.0,1,4,4,4,12,0xb2d0b52ad
3640933.92,5.0,158,4,4,1,9,0xb2d12adfd
32.69,1.0,0,1,2,4,7,0xb2d564b9d
102.6,1.0,16,1,2,2,5,0xb2d9b80e
12006.2,1.0,92,2,2,1,5,0xb2d20ef7
56189.99,1.0,92,3,2,1,6,0xb2d31d06d
17.1,1.0,43,1,2,2,5,0xb2d949b9
6427.08,1.0,0,2,2,4,8,0xb2d343d6d
722137.31,8.0,0,4,4,4,12,0xb2d5c253
8256.54,1.0,41,2,2,2,6,0xb2d6b91b
1063000.0,17.0,0,4,4,4,12,0xb2d42eb7
110275.95,2.0,0,3,3,4,10,0xb2da33ea
1182.35,1.0,6,1,2,3,6,0xb2d57622
3500888.53,9.0,0,4,4,4,12,0xb2d8e74b
12709.27,1.0,1,2,2,4,8,0xb2d65026
7.82,1.0,8,1,2,3,6,0xb2d6fbba
17.57,1.0,22,1,2,2,5,0xb2d433d6
570092.47,4.0,14,4,4,3,11,0xb2d6a225d
7.37,1.0,57,1,2,2,5,0xb2d6e4dfd
0.97,1.0,9,1,2,3,6,0xb2d4cdff
22493.53,1.0,0,2,2,4,8,0xb2d8dd12d
192181.82,3.0,25,3,4,2,9,0xb2d93cbcd
408830.46,6.0,19,4,4,2,10,0xb2d3ce60d
2658.7,1.0,10,1,2,3,6,0xb2d0742e
17.96,1.0,10,1,2,3,6,0xb2d51a48d
1704.74,1.0,3,1,2,4,7,0xb2d3b5fe
60023.16,2.0,140,3,3,1,7,0xb2d6a9f4
12281.09,1.0,190,2,2,1,5,0xb2d1dbafd
1269.64,1.0,19,1,2,2,5,0xb2d92217
160076.43,3.0,208,3,4,1,8,0xb2d569c8
1.06,1.0,40,1,2,2,5,0xb2d337f6
1015.01,1.0,92,1,2,1,4,0xb2d11e8f
200205.47,2.0,60,3,3,2,8,0xb2d11ef8d
1937.18,3.0,184,1,4,1,6,0xb2d081d8d
995024.72,3.0,131,4,4,1,9,0xb2d221b3d
39572.98,1.0,0,2,2,4,8,0xb2d6c630d
239000.0,8.0,0,3,4,4,11,0xb2d2b0c5d
6467.6,1.0,184,2,2,1,5,0xb2d553b1d
97844.78,2.0,0,3,3,4,10,0xb2d2b4a3d
10000.32,2.0,11,2,3,3,8,0xb2da1ae7
11.12,1.0,3,1,2,4,7,0xb2d32e44
36073.46,1.0,126,2,2,1,5,0xb2d2e14a
6230303.78,13.0,0,4,4,4,12,0xb2d2489cd
37811.28,3.0,92,2,4,1,7,0x3b9ada8b
5.59,1.0,39,1,2,2,5,0xb2d92030d
184304.56,2.0,0,3,3,4,10,0xb2d5f020
1117.23,1.0,7,1,2,3,6,0xb2d22b31
8113.75,1.0,0,2,2,4,8,0xb2d607fb
298.07,1.0,10,1,2,3,6,0xb2d67d71
107059.07,7.0,16,3,4,2,9,0xb2d189ff
120.48,3.0,0,1,4,4,9,0xb2d25510d
6791.75,1.0,14,2,2,3,7,0xb2d69531d
432.58,1.0,9,1,2,3,6,0xb2d31a04d
64168.64,2.0,139,3,3,1,7,0xb2d152f1
50000.53,2.0,34,2,3,2,7,0xb2d9328ed
51006.72,1.0,6,2,2,3,7,0xb2d0f22f
500002.58,3.0,16,4,4,2,10,0xb2d90340d
100115.53,3.0,136,3,4,1,8,0xb2d27ef2
273609.81,2.0,20,3,3,2,8,0xb2d434bcd
1000101.31,5.0,20,4,4,2,10,0xb2d5e76cd
300008.66,2.0,136,3,3,1,7,0xb2d623aad
300264.35,2.0,5,4,3,3,10,0xb2d929a3d
100009.9,3.0,39,3,4,2,9,0xb2d55f9dd
80020.96,3.0,34,3,4,2,9,0xb2d486a7d
130001.37,2.0,228,3,3,1,7,0xb2d6f696
100252.06,2.0,83,3,3,1,7,0xb2d5271c
9176.35,2.0,92,2,3,1,6,0xb2d28a93
1290.69,2.0,92,1,3,1,5,0xb2d32ef5
1529.66,1.0,184,1,2,1,4,0xb2d215c3
204981.29,2.0,238,3,3,1,7,0xb2d42381
14015.15,1.0,21,2,2,2,6,0xb2d6dd5fd
885104.0,2.0,231,4,3,1,8,0xb2d19255
19839.32,1.0,29,2,2,2,6,0xb2d6d300
33.79,1.0,11,1,2,3,6,0xb2d345c8
21273.58,1.0,24,2,2,2,6,0xb2d629f6d
291844.41,6.0,0,3,4,4,11,0xb2d29e47
808653.78,5.0,0,4,4,4,12,0xb2d10615
223265.03,3.0,43,3,4,2,9,0xb2d69fef
1687.78,1.0,184,1,2,1,4,0xb2d11409d
205148.21,2.0,48,3,3,2,8,0xb2d67dc5d
108960.4,2.0,154,3,3,1,7,0xb2d2ad8bd
89677.94,2.0,3,3,3,4,10,0xb2d400c8
544.75,1.0,19,1,2,2,5,0xb2d244d6d
3295.68,1.0,92,2,2,1,5,0xb2d3c471d
404263.79,2.0,98,4,3,1,8,0xb2d70671
188423.49,1.0,0,3,2,4,9,0xb2d282c3d
1477668.52,3.0,87,4,4,1,9,0xb2d09fd3
231.4,1.0,8,1,2,3,6,0xb2d8cfaf
1342.95,1.0,20,1,2,2,5,0xb2d781a6
726034.31,11.0,11,4,4,3,11,0x3b9af1e1d
453.02,1.0,9,1,2,3,6,0xb2d3fdba
570.78,1.0,10,1,2,3,6,0xb2d35ac4
18855.55,1.0,5,2,2,3,7,0xb2d6c4ef
651.49,1.0,20,1,2,2,5,0xb2d2efb7
244222.6,4.0,66,3,4,2,9,0xb2d3f242
7012.95,1.0,1,2,2,4,8,0xb2d50f39d
6.4,1.0,87,1,2,1,4,0xb2d8a69a
102128.53,1.0,3,3,2,4,9,0xb2d2437d
250065.79,4.0,13,3,4,3,10,0xb2d51281d
404951.87,13.0,10,4,4,3,11,0xb2d3af5bd
260070.51,3.0,60,3,4,2,9,0xb2d2cc3fd
5.33,1.0,32,1,2,2,5,0xb2d3ce8d
608000.0,2.0,12,4,3,3,10,0xb2da46fc
3133.68,1.0,184,2,2,1,5,0xb2d3263fd
2336.86,1.0,92,1,2,1,4,0xb2d13019d
187168.01,3.0,6,3,4,3,10,0xb2d23447
30559.8,2.0,263,2,3,1,6,0xb2d59921d
196.04,1.0,0,1,2,4,7,0xb2d17685
1286895.03,26.0,0,4,4,4,12,0xb2d559e6
699853.46,3.0,116,4,4,1,9,0xb2d27f6cd
220199.19,5.0,76,3,4,1,8,0x3b9b3618
71054.64,6.0,4,3,4,4,11,0xb2d0c720
10001.92,2.0,6,2,3,3,8,0xb2d4dc25d
811.99,2.0,6,1,3,3,7,0xb2d2552a
93601.99,2.0,87,3,3,1,7,0xb2d422b3d
8.74,1.0,10,1,2,3,6,0xb2d3084bd
502776.93,2.0,10,4,3,3,10,0xb2d67f5c
4880.04,1.0,3,2,2,4,8,0xb2d34829
40595.44,1.0,3,2,2,4,8,0xb2d56158d
2000000.0,1.0,0,4,2,4,10,0xb2da04a2
1000000.0,3.0,0,4,4,4,12,0xb2d212cb
1243.51,1.0,0,1,2,4,7,0xb2d154dc
2700012.8,9.0,6,4,4,3,11,0xb2d32408d
14525.23,1.0,0,2,2,4,8,0xb2d2565e
671767.92,7.0,24,4,4,2,10,0xb2d56cb9
202842.92,2.0,4,3,3,4,10,0xb2d7445ad
147.26,1.0,2,1,2,4,7,0xb2d5052d
206900.26,1.0,92,3,2,1,6,0xb2d0b844d
29935.32,1.0,10,2,2,3,7,0xb2d41f69
105096.57,2.0,0,3,3,4,10,0xb2d32f6bd
181246.44,3.0,11,3,4,3,10,0xb2d2800f
500182.4,4.0,33,4,4,2,10,0xb2d52a06d
610011.14,4.0,30,4,4,2,10,0xb2d40ffb
12158.52,1.0,164,2,2,1,5,0xb2d3a013
78335.1,1.0,92,3,2,1,6,0xb2d1759d
675085.98,1.0,13,4,2,3,9,0xb2d688d6
2316.17,2.0,6,1,3,3,7,0x3b9b3c47d
50001.58,2.0,80,2,3,1,6,0xb2d8d343
30880.08,2.0,4,2,3,4,9,0xb2d311a8d
5061.56,1.0,20,2,2,2,6,0xb2d3b539
10606.06,1.0,92,2,2,1,5,0xb2d2bc3ed
460004.86,3.0,49,4,4,2,10,0xb2d9d64e
1460.91,1.0,53,1,2,2,5,0xb2d65a5e
51.18,1.0,6,1,2,3,6,0xb2d9cc7b
338532.42,5.0,13,4,4,3,11,0xb2d5f231d
1800058.87,4.0,31,4,4,2,10,0xb2d251db
5.28,1.0,39,1,2,2,5,0xb2d1d213
244150.66,2.0,70,3,3,1,7,0xb2d1fbdcd
1224.61,1.0,11,1,2,3,6,0xb2d2c3f0
5129.76,1.0,0,2,2,4,8,0xb2d21ba9d
10421.42,1.0,0,2,2,4,8,0xb2d6e7b0d
828.87,1.0,20,1,2,2,5,0xb2d220edd
200710.81,2.0,9,3,3,3,9,0xb2d8d40f
1089.86,1.0,187,1,2,1,4,0xb2d5f981
181001.91,3.0,6,3,4,3,10,0xb2d94194
4867.16,1.0,92,2,2,1,5,0xb2d11757d
481.99,1.0,20,1,2,2,5,0xb2d6dbb5
128496.19,1.0,0,3,2,4,9,0xb2d0b4ccd
1058.84,1.0,184,1,2,1,4,0xb2d34414
5.81,1.0,43,1,2,2,5,0xb2d62db0
50753.27,1.0,195,2,2,1,5,0xb2d587fd
174259.93,5.0,0,3,4,4,11,0xb2d31889
8602.76,1.0,10,2,2,3,7,0xb2d6bd52d
1065.38,1.0,1,1,2,4,7,0xb2d2ff30
2738.5,1.0,7,1,2,3,6,0xb2d1bc33
300065.7,2.0,136,3,3,1,7,0xb2d3082a
1459.44,1.0,92,1,2,1,4,0xb2d28699d
1910633.5,5.0,5,4,4,3,11,0xb2d25b6f
200762.64,2.0,29,3,3,2,8,0xb2d81d75
200058.81,3.0,129,3,4,1,8,0xb2d138cc
22384.53,1.0,14,2,2,3,7,0xb2d69439
363158.2,5.0,56,4,4,2,10,0xb2d60493
12.11,1.0,1,1,2,4,7,0xb2d58542d
4374.46,1.0,0,2,2,4,8,0xb2d8b1d1
1405890.82,7.0,9,4,4,3,11,0xb2d11ac1d
105027.92,2.0,10,3,3,3,9,0xb2d4df5c
154503.99,3.0,123,3,4,1,8,0xb2d5f8f1
4121569.69,2.0,14,4,3,3,10,0xb2d59d42d
21.52,1.0,60,1,2,2,5,0xb2d9bf5d
25.86,1.0,42,1,2,2,5,0xb2d9584ed
51893.87,2.0,193,2,3,1,6,0xb2d58641
8684.73,1.0,6,2,2,3,7,0xb2d96438
230816.98,2.0,39,3,3,2,8,0xb2d9f5cc
65.66,1.0,20,1,2,2,5,0xb2d93092
4241.05,1.0,13,2,2,3,7,0xb2d26a3ad
240206.87,2.0,109,3,3,1,7,0xb2d5a623d
600001.86,4.0,4,4,4,4,12,0xb2d78c02
1217210.21,7.0,1,4,4,4,12,0xb2d84e62d
3379893.85,5.0,102,4,4,1,9,0x3b9b3755d
600000.0,2.0,14,4,3,3,10,0xb2da3bd7
75866.24,1.0,6,3,2,3,8,0xb2d57091
287.85,1.0,8,1,2,3,6,0xb2d69e1ed
1610.94,1.0,184,1,2,1,4,0xb2d5a81cd
101.5,1.0,75,1,2,1,4,0xb2d17f2ed
50002.64,2.0,56,2,3,2,7,0xb2d9bd57
1391.28,1.0,5,1,2,3,6,0xb2d9bd02
47.07,1.0,11,1,2,3,6,0xb2d3117f
29220.93,1.0,5,2,2,3,7,0xb2d2ebd1d
20741.2,5.0,0,2,4,4,10,0xb2d06777
960026.71,5.0,3,4,4,4,12,0xb2d2ca53d
16136.5,1.0,0,2,2,4,8,0xb2d6b46b
235009.45,3.0,4,3,4,4,11,0xb2d5cee4
100069.57,2.0,10,3,3,3,9,0xb2d438e6d
300014.97,4.0,7,3,4,3,10,0xb2d57f0ad
3119.38,1.0,27,2,2,2,6,0xb2d184d9d
23025.23,3.0,4,2,4,4,10,0xb2d63db3
35.39,1.0,0,1,2,4,7,0xb2d68a01
46988.57,2.0,0,2,3,4,9,0xb2d4f294
700000.0,3.0,18,4,4,2,10,0xb2d94df7
520000.84,4.0,14,4,4,3,11,0xb2d635efd
2125.82,1.0,123,1,2,1,4,0xb2d2e348
3.45,2.0,4,1,3,4,8,0x3b9b1006d
3450.48,1.0,3,2,2,4,8,0xb2d9f256
131019.28,2.0,108,3,3,1,7,0xb2d3a5af
2673670.28,19.0,1,4,4,4,12,0xb2d25135
9093.83,1.0,92,2,2,1,5,0xb2d3120f
1344046.99,12.0,0,4,4,4,12,0xb2d103d8
360006.96,3.0,11,4,4,3,11,0xb2d97fdad
1106.21,1.0,92,1,2,1,4,0xb2d8925a
2000000.0,3.0,4,4,4,4,12,0xb2d55852
359.67,1.0,41,1,2,2,5,0xb2d5ecff
62976.21,1.0,0,3,2,4,9,0xb2d5a882
70726.84,1.0,47,3,2,2,7,0xb2d566ad
9429.26,1.0,6,2,2,3,7,0xb2d7452fd
0.08,1.0,88,1,2,1,4,0xb2d2e30e
480056.51,8.0,31,4,4,2,10,0xb2d18696
94373.92,1.0,18,3,2,2,7,0xb2d3836ed
15708.12,1.0,184,2,2,1,5,0xb2d0eea8d
161.04,1.0,9,1,2,3,6,0xb2d4b316
6718.68,1.0,46,2,2,2,6,0xb2d4f5edd
1306.35,1.0,8,1,2,3,6,0xb2d997ca
100017.12,2.0,99,3,3,1,7,0xb2d2620dd
160090.96,3.0,137,3,4,1,8,0xb2d690c0
350106.56,4.0,108,4,4,1,9,0xb2d5771bd
9203.84,1.0,0,2,2,4,8,0xb2d78750
200000.0,2.0,0,3,3,4,10,0xb2d65398
18529.34,1.0,6,2,2,3,7,0xb2d97b44
42009.11,4.0,18,2,4,2,8,0xb2d2c36d
40773.03,1.0,0,2,2,4,8,0xb2d8ea12d
270714.08,3.0,5,3,4,3,10,0xb2d5622c
29491.79,1.0,35,2,2,2,6,0xb2d39039
617352.42,7.0,0,4,4,4,12,0x3b9af259
239.61,1.0,3,1,2,4,7,0xb2d92f24
8.8,1.0,69,1,2,1,4,0xb2d5db48d
310000.0,7.0,0,4,4,4,12,0xb2d1149dd
830016.15,3.0,18,4,4,2,10,0xb2d9bc71
4427.45,1.0,138,2,2,1,5,0xb2d2d5b4
200127.63,1.0,0,3,2,4,9,0xb2d38261
20079.65,3.0,0,2,4,4,10,0xb2d212b5
10061.21,1.0,0,2,2,4,8,0xb2d6ede4d
1020954.05,2.0,10,4,3,3,10,0xb2d91489d
130005.17,3.0,0,3,4,4,11,0xb2d6015d
2723.44,1.0,9,1,2,3,6,0xb2d3c171d
300000.61,2.0,1,3,3,4,10,0xb2d33e71d
962832.53,5.0,80,4,4,1,9,0xb2d16ebc
212.91,1.0,0,1,2,4,7,0xb2d17d79
644220.88,13.0,0,4,4,4,12,0x3b9b0ed3
101004.5,3.0,83,3,4,1,8,0xb2d372fed
51270.11,4.0,0,2,4,4,10,0xb2d35e70d
1348.12,1.0,8,1,2,3,6,0xb2d283f7
125011.97,2.0,213,3,3,1,7,0xb2d5f5c1
1856000.8,5.0,18,4,4,2,10,0xb2d075f9d
478156.21,3.0,3,4,4,4,12,0xb2d556f3
187500.34,4.0,0,3,4,4,11,0xb2d212abd
320027.01,6.0,4,4,4,4,12,0xb2d438d5
2012.02,1.0,92,1,2,1,4,0xb2d4154c
4750744.42,13.0,0,4,4,4,12,0x3b9b0e19d
170082.18,5.0,31,3,4,2,9,0xb2d1a3d3
1259139.55,8.0,26,4,4,2,10,0xb2d1c78c
125012.84,1.0,5,3,2,3,8,0xb2d3f189
788.65,1.0,0,1,2,4,7,0xb2d36acb
656901.68,3.0,0,4,4,4,12,0xb2d29299
470206.24,3.0,18,4,4,2,10,0xb2d38d65
100037.7,2.0,6,3,3,3,9,0xb2d5efc7
103181.54,2.0,25,3,3,2,8,0xb2d28830d
10000.11,3.0,42,2,4,2,8,0x3b9b181a
3.86,1.0,101,1,2,1,4,0xb2d5b32fd
81159.09,2.0,3,3,3,4,10,0xb2d6358a
12508157.93,9.0,0,4,4,4,12,0xb2d0c863
70267.12,1.0,184,3,2,1,6,0xb2d54a83d
2849.85,1.0,3,1,2,4,7,0xb2d441d0
4806.27,1.0,10,2,2,3,7,0xb2d6d83dd
5510.75,1.0,199,2,2,1,5,0xb2d2691e
163970.13,2.0,1,3,3,4,10,0xb2d2121b
611.46,1.0,1,1,2,4,7,0xb2d2105e
2000021.13,2.0,139,4,3,1,8,0xb2d5993bd
1300000.0,53.0,9,4,4,3,11,0xb2d118ced
10974.88,1.0,16,2,2,2,6,0xb2d6a96dd
575000.35,7.0,1,4,4,4,12,0xb2d2ce2e
139481.07,3.0,5,3,4,3,10,0xb2d14ccb
22.28,1.0,25,1,2,2,5,0xb2d6ff72
562726.99,4.0,1,4,4,4,12,0xb2d0d7f0d
232.05,1.0,19,1,2,2,5,0xb2d23535d
447105.63,2.0,201,4,3,1,8,0xb2d5cd36
510.79,1.0,3,1,2,4,7,0xb2d61b12
251796.37,2.0,9,3,3,3,9,0xb2d694aa
63180.58,2.0,1,3,3,4,10,0xb2d103f7
5.63,1.0,6,1,2,3,6,0xb2d32555
213858.93,3.0,25,3,4,2,9,0xb2d17f37
707.16,1.0,157,1,2,1,4,0xb2d2b920d
120002.53,2.0,24,3,3,2,8,0xb2d9493b
102.04,1.0,92,1,2,1,4,0xb2d0fec9d
200719.11,3.0,11,3,4,3,10,0xb2d4206fd
713355.38,4.0,6,4,4,3,11,0xb2d23c70
71.71,1.0,54,1,2,2,5,0xb2d11ee9d
1003.84,3.0,184,1,4,1,6,0xb2d32dc9d
17572.36,1.0,14,2,2,3,7,0xb2d6993bd
30000.84,3.0,34,2,4,2,8,0xb2d7de29d
620000.0,4.0,3,4,4,4,12,0xb2d146b7d
200004.75,2.0,1,3,3,4,10,0xb2d7ee9a
8551.23,1.0,0,2,2,4,8,0xb2d87ea1
20749.62,1.0,11,2,2,3,7,0xb2d2cf12
1.75,1.0,6,1,2,3,6,0xb2d68e5f
140873.77,9.0,5,3,4,3,10,0xb2d482fd
732795.28,5.0,16,4,4,2,10,0xb2d3e387
60003.86,2.0,81,3,3,1,7,0xb2d58148d
989869.44,8.0,1,4,4,4,12,0xb2d55c8f
52.33,1.0,78,1,2,1,4,0xb2d23725
72.97,1.0,9,1,2,3,6,0xb2d56290
360754.96,5.0,14,4,4,3,11,0xb2d67599
1214.83,1.0,184,1,2,1,4,0xb2d366b5d
3790.84,1.0,92,2,2,1,5,0xb2d10638d
485405.58,2.0,8,4,3,3,10,0xb2d3a118
23.05,1.0,9,1,2,3,6,0xb2d57bb0
71336.42,2.0,184,3,3,1,7,0xb2d359fcd
0.0,1.0,3,1,2,4,7,0xb2d36b9d
161113.07,2.0,167,3,3,1,7,0xb2d652d0d
210119.18,4.0,0,3,4,4,11,0xb2d3f633
91676.25,1.0,60,3,2,2,7,0xb2d6bbd6
463347.19,5.0,74,4,4,1,9,0xb2d4e20dd
3.17,1.0,18,1,2,2,5,0xb2d63add
100039.33,2.0,90,3,3,1,7,0xb2d6016ad
1150089.86,2.0,0,4,3,4,11,0xb2d25e6a
413249.58,4.0,13,4,4,3,11,0xb2d3bcdd
332000.61,9.0,0,4,4,4,12,0xb2d560f6d
200155.29,3.0,1,3,4,4,11,0xb2d22ef4d
140011.87,3.0,0,3,4,4,11,0xb2d633c3
252175.81,11.0,27,3,4,2,9,0xb2d5b118
47323.81,1.0,0,2,2,4,8,0xb2d5293e
10164.66,2.0,118,2,3,1,6,0xb2d6484fd
260213.08,3.0,23,3,4,2,9,0xb2d10b31
466902.28,5.0,25,4,4,2,10,0xb2d23a72d
10116.49,1.0,33,2,2,2,6,0xb2d4d088
606327.08,4.0,77,4,4,1,9,0xb2d78046d
493831.47,2.0,0,4,3,4,11,0xb2d11198d
1250.5,1.0,92,1,2,1,4,0xb2d132e6d
162.21,1.0,46,1,2,2,5,0xb2d0bfde
344397.85,6.0,38,4,4,2,10,0xb2d39c88
121666.81,3.0,14,3,4,3,10,0xb2d4f557d
349578.92,5.0,29,4,4,2,10,0xb2d43cff
35001.11,2.0,39,2,3,2,7,0xb2d9e774
126.94,1.0,6,1,2,3,6,0xb2d915a7
4662.28,1.0,0,2,2,4,8,0xb2d9f191
227655.83,2.0,0,3,3,4,10,0xb2d95417d
617027.11,2.0,118,4,3,1,8,0xb2d566ce
120006.53,4.0,8,3,4,3,10,0xb2d3b3ead
506957.47,5.0,0,4,4,4,12,0xb2d07ccb
8169.68,1.0,15,2,2,3,7,0xb2d43d5a
478.7,1.0,25,1,2,2,5,0xb2d79978
50958.56,1.0,184,2,2,1,5,0xb2d2eedc
11079.14,1.0,3,2,2,4,8,0xb2d4326fd
452338.02,9.0,19,4,4,2,10,0xb2d3a546d
658000.0,4.0,74,4,4,1,9,0xb2d580e4
100000.0,2.0,4,3,3,4,10,0xb2d0b5a4
100002.1,2.0,235,3,3,1,7,0xb2d2d5f7
5000193.28,2.0,31,4,3,2,9,0xb2d407fe
35000.86,2.0,9,2,3,3,8,0xb2d8e157
130.7,1.0,64,1,2,2,5,0xb2d0d92d
44796.34,1.0,10,2,2,3,7,0xb2d39e1fd
9.37,1.0,31,1,2,2,5,0xb2d59d50
10000.42,2.0,92,2,3,1,6,0xb2d635dbd
46.19,3.0,7,1,4,3,8,0x3b9b2846d
10344.28,1.0,162,2,2,1,5,0xb2d5d462d
7207.15,1.0,104,2,2,1,5,0xb2d96495
54.73,1.0,77,1,2,1,4,0xb2d41595d
224002.11,3.0,0,3,4,4,11,0xb2d9384ed
4962.32,3.0,0,2,4,4,10,0xb2d35d4a
292048.12,3.0,6,3,4,3,10,0xb2d11840
50035.32,2.0,3,2,3,4,9,0xb2d60e2e
504060.99,12.0,4,4,4,4,12,0xb2d156fdd
5955.7,1.0,232,2,2,1,5,0xb2d23b40d
70025.98,3.0,6,3,4,3,10,0xb2d5e349d
300.03,1.0,5,1,2,3,6,0xb2d950e7
10147.24,1.0,184,2,2,1,5,0xb2d5e7b7
7210.34,1.0,25,2,2,2,6,0xb2d2788f
360029.14,4.0,60,4,4,2,10,0xb2d5f8b4d
1032626.45,7.0,97,4,4,1,9,0xb2d0d147
225037.91,4.0,136,3,4,1,8,0xb2d2b99a
401.28,1.0,21,1,2,2,5,0xb2d270aad
1003.77,1.0,184,1,2,1,4,0xb2d63120d
1644.91,1.0,44,1,2,2,5,0xb2d5ce7f
112363.82,2.0,143,3,3,1,7,0xb2d23b23d
58.95,4.0,18,1,4,2,7,0xb2d29b7f
1087000.72,4.0,0,4,4,4,12,0xb2d10c3a
967.31,1.0,1,1,2,4,7,0xb2d91704d
1218.5,4.0,184,1,4,1,6,0xb2d2c351d
330125.35,6.0,8,4,4,3,11,0xb2d0d8ca
500008.46,3.0,15,4,4,3,11,0xb2d5baf4d
26.91,1.0,47,1,2,2,5,0xb2d5bfb4
135336.73,9.0,0,3,4,4,11,0xb2d210b5
373600.14,2.0,73,4,3,1,8,0xb2d8c9a5d
70007.52,2.0,66,3,3,2,8,0xb2d6be8dd
6106.07,1.0,92,2,2,1,5,0xb2d5c8c4
2500.96,1.0,42,1,2,2,5,0xb2d29c22
40479.87,1.0,52,2,2,2,6,0xb2d6a8e9
1236.35,1.0,1,1,2,4,7,0xb2d1fb03
201437.22,2.0,50,3,3,2,8,0xb2d57274d
789001.35,7.0,8,4,4,3,11,0xb2d58584
451583.93,2.0,1,4,3,4,11,0xb2d8f201d
643167.3,2.0,0,4,3,4,11,0xb2d9833b
1883.6,1.0,92,1,2,1,4,0xb2d0b0a5d
1783.18,1.0,144,1,2,1,4,0xb2d10aacd
9.7,1.0,11,1,2,3,6,0xb2d91415
113.18,1.0,31,1,2,2,5,0xb2d2f748
230056.69,2.0,15,3,3,3,9,0xb2d96e80d
43617.74,2.0,130,2,3,1,6,0xb2d11114d
42052.85,1.0,9,2,2,3,7,0xb2d33bbb
23655.28,1.0,15,2,2,3,7,0xb2d139d2d
56883.8,1.0,10,3,2,3,8,0xb2d50a84
20010.69,2.0,18,2,3,2,7,0xb2d1c3e2
885.61,4.0,0,1,4,4,9,0xb2d0bf44
183000.0,9.0,0,3,4,4,11,0xb2d5841c
80003.44,2.0,34,3,3,2,8,0xb2d459c0
350000.01,2.0,1,4,3,4,11,0xb2d477d1d
2.84,6.0,0,1,4,4,9,0x3b9b46cad
195091.81,3.0,108,3,4,1,8,0xb2d413c3d
1527.02,1.0,18,1,2,2,5,0xb2d23a98
1019.86,1.0,184,1,2,1,4,0xb2d37268d
11319847.73,3.0,184,4,4,1,9,0xb2d40eaad
56696.81,2.0,27,3,3,2,8,0xb2d255c1
702.77,1.0,6,1,2,3,6,0xb2d5d47e
500011.31,2.0,16,4,3,2,9,0xb2d78a51
559896.55,4.0,7,4,4,3,11,0xb2d10596d
14273.14,1.0,6,2,2,3,7,0xb2d75650
1831.92,1.0,184,1,2,1,4,0xb2d19f6a
21.11,1.0,67,1,2,1,4,0xb2d8ef03
0.0,1.0,7,1,2,3,6,0xb2d1aa63
51.0,1.0,62,1,2,2,5,0xb2d6d5ab
206074.83,2.0,19,3,3,2,8,0xb2d61ed1
384.97,1.0,4,1,2,4,7,0xb2d6f0d7
2701.81,1.0,0,1,2,4,7,0xb2d6be4ad
50001.58,2.0,66,2,3,2,7,0xb2d8ee39
511902.2,2.0,92,4,3,1,8,0xb2d3f89f
681.9,1.0,1,1,2,4,7,0xb2d311a6
131120.68,2.0,0,3,3,4,10,0xb2d14ae0
250013.41,4.0,83,3,4,1,8,0xb2d77fabd
7533.92,1.0,19,2,2,2,6,0xb2d2d632
1499.24,1.0,184,1,2,1,4,0xb2d427f1
3628.77,1.0,302,2,2,1,5,0xb2d0b2b1
5052.18,1.0,184,2,2,1,5,0xb2d2bdc9d
6028.33,1.0,184,2,2,1,5,0xb2d3a004d
517549.83,5.0,6,4,4,3,11,0xb2d07fa5d
493204.99,6.0,38,4,4,2,10,0xb2d61f04
8071914.88,2.0,0,4,3,4,11,0xb2d2eaaed
7.52,2.0,29,1,3,2,6,0xb2d963b0
183262.69,5.0,0,3,4,4,11,0xb2d2f232d
12.47,1.0,21,1,2,2,5,0xb2d98c2b
13139.66,1.0,18,2,2,2,6,0xb2d642f5d
1000000.01,2.0,185,4,3,1,8,0xb2d53fa0d
5086.53,1.0,9,2,2,3,7,0xb2d9742e
335089.95,2.0,8,4,3,3,10,0xb2d9186d
40417.02,1.0,14,2,2,3,7,0xb2d5d1bdd
1574.07,1.0,10,1,2,3,6,0xb2d87fb4
30695.27,1.0,49,2,2,2,6,0xb2d37c9cd
346611.88,3.0,77,4,4,1,9,0xb2d3f60dd
9.47,1.0,7,1,2,3,6,0xb2d5861b
3360043.72,10.0,0,4,4,4,12,0xb2d10bc1d
65002.06,2.0,10,3,3,3,9,0xb2d9600f
53281.75,2.0,27,3,3,2,8,0xb2d2318d
10000.11,2.0,14,2,3,3,8,0xb2da3852
20633.27,2.0,258,2,3,1,6,0x3b9b2b57
3394.17,1.0,0,2,2,4,8,0xb2d6b920
10086.05,1.0,71,2,2,1,5,0xb2d63c65d
164142.58,3.0,31,3,4,2,9,0xb2d12653d
1881.0,1.0,92,1,2,1,4,0x3b9adf02
60079.69,3.0,63,3,4,2,9,0xb2d5b6f0d
94.68,5.0,0,1,4,4,9,0xb2d439c8
151329.88,4.0,57,3,4,2,9,0xb2d24bef
320023.97,2.0,63,4,3,2,9,0xb2d96f75d
334247.89,6.0,55,4,4,2,10,0xb2d0eb0e
300014.63,3.0,92,3,4,1,8,0xb2d32a5f
1125.47,1.0,92,1,2,1,4,0xb2d631be
300049.74,3.0,1,3,4,4,11,0xb2d5c4a5d
30.41,1.0,15,1,2,3,6,0xb2d488a8d
450832.74,3.0,13,4,4,3,11,0xb2d3c352
113.45,1.0,30,1,2,2,5,0xb2d630fb
650302.19,2.0,17,4,3,2,9,0xb2d41188d
1.1,1.0,7,1,2,3,6,0xb2d8ebf1d
30000.32,2.0,42,2,3,2,7,0xb2d9e87f
0.0,1.0,4,1,2,4,7,0xb2d9658b
1002250.52,2.0,3,4,3,4,11,0xb2d8f8afd
27.58,1.0,4,1,2,4,7,0xb2d579a8
201.97,1.0,35,1,2,2,5,0xb2d30555d
1635.85,1.0,184,1,2,1,4,0xb2d17d85d
11.62,1.0,92,1,2,1,4,0xb2d29432d
9200.0,1.0,10,2,2,3,7,0xb2da04c0
816025.22,15.0,21,4,4,2,10,0xb2d16d8dd
65148.22,2.0,0,3,3,4,10,0xb2d0bf13d
764014.13,7.0,5,4,4,3,11,0xb2d188c3
19547.81,1.0,6,2,2,3,7,0xb2d97458
552530.48,5.0,20,4,4,2,10,0xb2d68de2
80582.48,2.0,200,3,3,1,7,0xb2d33a8bd
11200.17,1.0,12,2,2,3,7,0xb2d0b47bd
8510.79,1.0,0,2,2,4,8,0xb2d32109d
103007.74,2.0,136,3,3,1,7,0xb2d19ae9d
12499.1,1.0,14,2,2,3,7,0xb2d78efa
249784.17,4.0,0,3,4,4,11,0x3b9b0e6bd
255332.63,2.0,197,3,3,1,7,0xb2d7ede3
170015.85,1.0,3,3,2,4,9,0xb2d2e66a
2347.27,1.0,173,1,2,1,4,0xb2d314e3d
648161.69,5.0,5,4,4,3,11,0xb2d1d571
10058.31,1.0,92,2,2,1,5,0xb2d0d0e7
8694.5,1.0,1,2,2,4,8,0xb2d304dbd
341729.72,4.0,16,4,4,2,10,0xb2d3412a
22949.98,1.0,15,2,2,3,7,0xb2d30c31d
205647.45,3.0,1,3,4,4,11,0xb2d554abd
26.02,1.0,41,1,2,2,5,0xb2d4f125d
43.12,1.0,0,1,2,4,7,0xb2d5b33e
1319095.67,18.0,0,4,4,4,12,0x3b9af16fd
56234.94,2.0,151,3,3,1,7,0xb2d08ba4d
358007.51,4.0,95,4,4,1,9,0xb2d131bad
100071.86,2.0,174,3,3,1,7,0xb2d20113d
30000.53,3.0,20,2,4,2,8,0xb2d4fdedd
165919.78,3.0,95,3,4,1,8,0xb2d60d0dd
91789.75,1.0,169,3,2,1,6,0xb2d26ab3
1576883.24,5.0,133,4,4,1,9,0xb2d4f8d1
4370.44,1.0,184,2,2,1,5,0xb2d5abce
500000.1,3.0,15,4,4,3,11,0xb2da071e
5253.73,1.0,92,2,2,1,5,0x3b9b2c92
801875.91,4.0,35,4,4,2,10,0xb2d23979
636.7,1.0,35,1,2,2,5,0xb2d3808f
650311.34,4.0,3,4,4,4,12,0xb2d76af8
100002.11,2.0,221,3,3,1,7,0xb2d6faa2
152353.82,2.0,221,3,3,1,7,0xb2d1c07ed
0.53,1.0,18,1,2,2,5,0xb2d956e2d
224233.38,3.0,0,3,4,4,11,0xb2d07b48
150096.44,2.0,53,3,3,2,8,0xb2d62706
27.45,1.0,18,1,2,2,5,0xb2d98647
760000.0,2.0,28,4,3,2,9,0xb2da0e14
1028.98,1.0,77,1,2,1,4,0xb2d51f65d
154364.95,3.0,95,3,4,1,8,0xb2d64d90d
2106.95,1.0,165,1,2,1,4,0xb2d6598a
1205.37,1.0,92,1,2,1,4,0xb2d241b9d
733916.28,7.0,3,4,4,4,12,0xb2d19e77d
482.8,2.0,13,1,3,3,7,0xb2d9524cd
155922.72,2.0,31,3,3,2,8,0xb2d1fc6ed
135.09,3.0,14,1,4,3,8,0xb2d1a09e
160041.01,2.0,74,3,3,1,7,0xb2d8d737d
311448.13,6.0,10,4,4,3,11,0x3b9af0c3d
139.97,1.0,0,1,2,4,7,0xb2d717e2
12452.76,1.0,0,2,2,4,8,0xb2d8c4f7
100074.53,4.0,18,3,4,2,9,0xb2d1b0ffd
1.1,1.0,82,1,2,1,4,0xb2d2ee71
1451122.63,4.0,14,4,4,3,11,0xb2d145cd
268000.0,4.0,1,3,4,4,11,0xb2d5fc2f
261914.12,7.0,1,3,4,4,11,0xb2d2f05d
85026.9,2.0,18,3,3,2,8,0xb2d41356
633044.33,8.0,11,4,4,3,11,0xb2d25c6e
880000.0,2.0,7,4,3,3,10,0xb2da1c0a
14554.4,1.0,39,2,2,2,6,0xb2d5abb7
348545.42,5.0,0,4,4,4,12,0x3b9b3bd5d
103004.71,3.0,10,3,4,3,10,0xb2d18cee
63269.09,2.0,0,3,3,4,10,0xb2d67d3d
12915.51,1.0,103,2,2,1,5,0xb2d959c3
500297.8,2.0,14,4,3,3,10,0xb2d274b9d
2112684.39,6.0,3,4,4,4,12,0xb2d0cbd1d
782.02,2.0,4,1,3,4,8,0x3b9af25c
155245.46,2.0,94,3,3,1,7,0xb2d2c643d
920334.75,28.0,0,4,4,4,12,0x3b9b46a0d
29970.68,1.0,0,2,2,4,8,0xb2d27d07d
88997.73,4.0,0,3,4,4,11,0xb2d31549d
772966.05,3.0,77,4,4,1,9,0xb2d5b02b
44.04,1.0,0,1,2,4,7,0xb2d1c097
5605.5,1.0,10,2,2,3,7,0xb2d2d22f
14687.8,1.0,184,2,2,1,5,0xb2d3158dd
431.65,1.0,6,1,2,3,6,0xb2d534f2
10048.12,2.0,29,2,3,2,7,0xb2da03a5
18.18,1.0,133,1,2,1,4,0xb2d91e50
2028.71,1.0,184,1,2,1,4,0xb2d46477
136493.32,11.0,0,3,4,4,11,0xb2d2f34ed
432566.22,4.0,42,4,4,2,10,0xb2d8de91d
150005.14,4.0,125,3,4,1,8,0xb2d20481d
504045.29,2.0,58,4,3,2,9,0xb2d5d0f4
19.05,1.0,4,1,2,4,7,0xb2d2f06ed
350002.22,18.0,14,4,4,3,11,0xb2d631fb
20103.3,1.0,20,2,2,2,6,0xb2da026b
301325.7,4.0,4,4,4,4,12,0xb2d07497d
124906.73,4.0,0,3,4,4,11,0xb2d210f8d
3367.64,1.0,16,2,2,2,6,0xb2d38232
1711.49,1.0,10,1,2,3,6,0xb2d7906b
226660.98,6.0,66,3,4,2,9,0x3b9b4697
25409.31,1.0,3,2,2,4,8,0xb2d12df2
803014.24,5.0,32,4,4,2,10,0xb2d25b22d
58601.52,1.0,140,3,2,1,6,0xb2d3c332
3532.16,2.0,119,2,3,1,6,0xb2d2fac5d
1315765.38,8.0,0,4,4,4,12,0xb2d0c268
7514.65,1.0,122,2,2,1,5,0xb2d586d2d
47.16,1.0,69,1,2,1,4,0xb2d62bed
23897.55,1.0,1,2,2,4,8,0xb2d64784
350500.89,2.0,10,4,3,3,10,0xb2d91e4c
9.89,1.0,3,1,2,4,7,0xb2d99579
34.98,1.0,15,1,2,3,6,0xb2d9baae
250065.17,4.0,31,3,4,2,9,0xb2d17910
100022.69,8.0,11,3,4,3,10,0xb2d938b7
330000.16,8.0,0,4,4,4,12,0xb2d665b1d
131264.88,3.0,143,3,4,1,8,0xb2d60b79d
33603.74,1.0,11,2,2,3,7,0xb2d995fc
70073.34,2.0,74,3,3,1,7,0xb2d5cb97
50002.01,2.0,32,2,3,2,7,0xb2da00b8
1102.74,1.0,92,1,2,1,4,0xb2d526b3d
3967.41,1.0,6,2,2,3,7,0xb2d9303e
117630.17,5.0,28,3,4,2,9,0xb2d47428
494212.51,2.0,99,4,3,1,8,0xb2d96e6fd
2893.63,1.0,92,2,2,1,5,0xb2d1e09e
612.07,1.0,20,1,2,2,5,0xb2d309a1
200049.42,4.0,95,3,4,1,8,0xb2d337e4
1020.34,1.0,89,1,2,1,4,0xb2d20f61d
4200037.5,4.0,0,4,4,4,12,0xb2d9c066
202975.36,2.0,105,3,3,1,7,0xb2d29bff
13857.51,1.0,92,2,2,1,5,0xb2d3b79dd
2912034.8,12.0,27,4,4,2,10,0xb2d4f56a
39291.4,1.0,26,2,2,2,6,0xb2d8fb5bd
2311.38,1.0,11,1,2,3,6,0xb2d67d5d
200000.0,2.0,0,3,3,4,10,0xb2d0b6c8
377473.65,4.0,52,4,4,2,10,0xb2d65574d
200251.79,2.0,105,3,3,1,7,0xb2d2f6e8
50028.62,2.0,0,2,3,4,9,0xb2d18876
812.4,1.0,11,1,2,3,6,0xb2d3026dd
3878.19,1.0,9,2,2,3,7,0xb2d60c0a
116815.72,3.0,9,3,4,3,10,0xb2d0749bd
552080.94,4.0,0,4,4,4,12,0xb2d254f2d
153904.96,2.0,3,3,3,4,10,0xb2d12ee6d
250645.86,4.0,196,3,4,1,8,0xb2d3b573d
0.0,1.0,6,1,2,3,6,0xb2d3ed88d
290223.13,25.0,0,3,4,4,11,0x3b9af266
537661.64,5.0,0,4,4,4,12,0xb2d24aead
4044.56,3.0,0,2,4,4,10,0xb2d210ea
281026.44,6.0,0,3,4,4,11,0xb2d2613f
60660.91,1.0,50,3,2,2,7,0xb2d390ae
368919.59,6.0,1,4,4,4,12,0xb2d1bc17
900000.0,2.0,12,4,3,3,10,0xb2d8e310
1086.35,5.0,184,1,4,1,6,0xb2d15244d
253666.48,5.0,0,3,4,4,11,0xb2d3cebbd
82657.55,2.0,4,3,3,4,10,0xb2d645e3
980013.38,17.0,19,4,4,2,10,0xb2d956e0d
277.43,1.0,184,1,2,1,4,0xb2d58ccfd
289.93,3.0,4,1,4,4,9,0x3b9b3ae1d
149.46,1.0,5,1,2,3,6,0xb2d266b7d
10017.84,1.0,20,2,2,2,6,0xb2d30c55d
634204.01,4.0,0,4,4,4,12,0x3b9b460ed
1049.42,1.0,306,1,2,1,4,0xb2d51ba7
300010.64,3.0,19,3,4,2,9,0xb2d78d00
414551.69,6.0,12,4,4,3,11,0xb2d2b47ad
442483.18,4.0,13,4,4,3,11,0xb2d61166
1580.02,1.0,12,1,2,3,6,0xb2d437f5
651000.97,2.0,9,4,3,3,10,0xb2d639a2
15061.68,1.0,184,2,2,1,5,0xb2d5f7aa
390045.29,7.0,3,4,4,4,12,0xb2d3ad84
368154.13,3.0,12,4,4,3,11,0xb2d5ece3d
1044.04,1.0,218,1,2,1,4,0xb2d3d99d
50398.96,1.0,0,2,2,4,8,0xb2d294ee
133005.62,3.0,11,3,4,3,10,0x3b9b2c1ed
24010.9,1.0,17,2,2,2,6,0xb2d68e95
255.77,1.0,14,1,2,3,6,0xb2d69658
600023.23,2.0,68,4,3,1,8,0xb2d6b6c3
106619.81,2.0,132,3,3,1,7,0xb2d3db33
510.56,1.0,1,1,2,4,7,0xb2d27dc7
1.52,1.0,61,1,2,2,5,0xb2d2b790
394033.33,4.0,6,4,4,3,11,0xb2d1a400
3046.96,1.0,92,2,2,1,5,0xb2d22f8bd
19.16,2.0,74,1,3,1,5,0xb2d211a6
6387648.15,74.0,1,4,4,4,12,0xb2d2267d
262572.94,3.0,0,3,4,4,11,0xb2d1ada7d
24901.51,1.0,18,2,2,2,6,0xb2d4c83ed
600000.0,3.0,11,4,4,3,11,0xb2da4913
121889.21,4.0,18,3,4,2,9,0xb2d1db01d
705536.41,5.0,7,4,4,3,11,0x3b9b4423
110004.64,2.0,92,3,3,1,7,0xb2d61552d
713.66,1.0,10,1,2,3,6,0xb2d43518d
600015.12,4.0,4,4,4,4,12,0xb2d6b773d
10000000.0,2.0,46,4,3,2,9,0xb2d70410
323018.67,3.0,14,4,4,3,11,0xb2d78c7bd
108.55,1.0,33,1,2,2,5,0xb2d40fd1
115.17,1.0,88,1,2,1,4,0xb2d244ce
4002.2,1.0,0,2,2,4,8,0xb2d6d1b9d
858690.88,4.0,5,4,4,3,11,0xb2d0fefa
3.67,1.0,21,1,2,2,5,0xb2d38c82d
4996.23,1.0,269,2,2,1,5,0xb2d29201d
40001.35,4.0,48,2,4,2,8,0xb2d15359d
200000.12,4.0,73,3,4,1,8,0xb2d27e06
205975.14,3.0,110,3,4,1,8,0xb2d175bed
273024.06,3.0,23,3,4,2,9,0xb2d37741
272010.19,1.0,12,3,2,3,8,0xb2d93da3d
110.18,1.0,63,1,2,2,5,0xb2d6e709d
90285.98,2.0,3,3,3,4,10,0xb2d3c4f1d
17.59,1.0,65,1,2,2,5,0xb2d6357e
450128.56,4.0,0,4,4,4,12,0xb2d5fdead
219882.54,1.0,7,3,2,3,8,0xb2d69b29
2435.15,1.0,28,1,2,2,5,0xb2d2c237
7670.81,1.0,20,2,2,2,6,0xb2d2d632d
460000.0,3.0,2,4,4,4,12,0xb2d5e7b5d
3419.92,1.0,92,2,2,1,5,0xb2d30fa0d
673141.69,7.0,23,4,4,2,10,0xb2d56cb9d
5.88,1.0,0,1,2,4,7,0xb2d6a1d2
240000.0,2.0,12,3,3,3,9,0xb2da2068
503552.55,2.0,64,4,3,2,9,0xb2d97f71d
451253.91,5.0,1,4,4,4,12,0xb2d0d2d7
956822.85,4.0,1,4,4,4,12,0xb2d5637cd
227013.81,2.0,104,3,3,1,7,0xb2d3cf0b
30001.27,2.0,42,2,3,2,7,0xb2d9e67b
597027.46,6.0,0,4,4,4,12,0xb2d2048dd
185686.19,2.0,196,3,3,1,7,0xb2d7bd1ed
33625.09,2.0,217,2,3,1,6,0xb2d61e31
13.89,1.0,41,1,2,2,5,0xb2d6c41ad
0.88,1.0,13,1,2,3,6,0xb2d5154ed
10165.67,2.0,203,2,3,1,6,0xb2d6473e
495457.36,2.0,7,4,3,3,10,0xb2d6e9e3
135893.18,4.0,4,3,4,4,11,0xb2d43822d
30001.29,2.0,199,2,3,1,6,0xb2d5ce25
252888.14,2.0,28,3,3,2,8,0xb2d929e1d
50521.41,2.0,129,2,3,1,6,0xb2d63df6d
330064.15,6.0,34,4,4,2,10,0xb2d16fcad
1199.58,1.0,184,1,2,1,4,0x3b9af08ed
110008.23,4.0,53,3,4,2,9,0xb2d393a5d
55817.98,1.0,4,3,2,4,9,0xb2d4c810d
5069.96,1.0,4,2,2,4,8,0xb2d357e1
4.22,1.0,124,1,2,1,4,0xb2d74a13d
520001.96,5.0,80,4,4,1,9,0xb2d3ecb6d
10109.7,1.0,15,2,2,3,7,0xb2d6c4cb
50741.02,1.0,0,2,2,4,8,0xb2d2f388d
10876.39,1.0,0,2,2,4,8,0xb2d0f55c
1014.88,1.0,92,1,2,1,4,0xb2d12b05d
500015.83,2.0,59,4,3,2,9,0xb2d8fa72
1047403.9,2.0,20,4,3,2,9,0xb2d6918a
2648540.25,4.0,139,4,4,1,9,0x3b9b4694
33713.57,1.0,23,2,2,2,6,0xb2d0ce8c
1102.87,1.0,113,1,2,1,4,0xb2d1ddfa
290553.03,10.0,0,3,4,4,11,0xb2d6d023
871963.4,12.0,3,4,4,4,12,0xb2d0aa16
7005.5,1.0,10,2,2,3,7,0xb2d68618d
160640.31,3.0,19,3,4,2,9,0xb2d2a32bd
12113.17,1.0,30,2,2,2,6,0xb2d657e0d
69.02,1.0,10,1,2,3,6,0xb2d65093
86.01,1.0,12,1,2,3,6,0xb2d4bc9c
411003.85,3.0,3,4,4,4,12,0xb2d337d0
410142.69,4.0,55,4,4,2,10,0xb2d5857cd
83.3,1.0,28,1,2,2,5,0xb2d6c40f
0.0,1.0,6,1,2,3,6,0xb2d64ed7
135442.24,3.0,33,3,4,2,9,0xb2d3aa7cd
8701.97,3.0,92,2,4,1,7,0xb2d253a4
173219.96,3.0,56,3,4,2,9,0xb2d439cbd
774129.85,13.0,0,4,4,4,12,0xb2d06b75d
268.67,1.0,23,1,2,2,5,0xb2d98b50
858.69,1.0,0,1,2,4,7,0xb2d6bdd9d
173364.0,4.0,1,3,4,4,11,0xb2d1b9ff
1112.39,1.0,105,1,2,1,4,0xb2d5a740
341063.4,4.0,7,4,4,3,11,0xb2d5cc5e
205041.28,2.0,37,3,3,2,8,0xb2d6eea5
101101.06,3.0,0,3,4,4,11,0xb2d5bfe9d
61242.76,3.0,0,3,4,4,11,0x3b9b43c8
430.19,1.0,0,1,2,4,7,0xb2d6bdf5
220889.42,3.0,6,3,4,3,10,0xb2da3d43
74435.48,6.0,1,3,4,4,11,0xb2d1dfc9d
3614.3,1.0,5,2,2,3,7,0xb2d144e2d
131921.87,2.0,73,3,3,1,7,0xb2d4260fd
252227.93,3.0,70,3,4,1,8,0xb2d648eed
524217.69,7.0,11,4,4,3,11,0xb2d13560
6356.82,1.0,21,2,2,2,6,0xb2d1a653d
20741.04,1.0,10,2,2,3,7,0xb2d28e21d
1801720.88,4.0,0,4,4,4,12,0xb2d11770
465170.33,5.0,143,4,4,1,9,0xb2d1a667d
500000.0,3.0,4,4,4,4,12,0xb2d97c5e
420.53,1.0,0,1,2,4,7,0xb2d61e89
500115.69,2.0,213,4,3,1,8,0xb2d1c50a
900004.23,3.0,13,4,4,3,11,0xb2d10f25
250000.0,2.0,12,3,3,3,9,0xb2d96503
46.43,1.0,70,1,2,1,4,0xb2d62b6fd
720027.89,3.0,3,4,4,4,12,0xb2d4c042d
230001.43,3.0,5,3,4,3,10,0xb2d189c2d
300001.06,3.0,27,3,4,2,9,0xb2d94180
16302.6,2.0,140,2,3,1,6,0x3b9aedb5
513554.3,3.0,32,4,4,2,10,0xb2d5b518d
43.94,1.0,83,1,2,1,4,0xb2d60009
1033.87,2.0,184,1,3,1,5,0x3b9b42a5d
137749.16,2.0,31,3,3,2,8,0xb2d1000dd
61180.19,1.0,0,3,2,4,9,0xb2d58e15
100752.27,2.0,4,3,3,4,10,0xb2d3b9e6
430319.7,6.0,67,4,4,1,9,0xb2d12be5d
106.41,1.0,9,1,2,3,6,0xb2d33c0f
130209.95,2.0,59,3,3,2,8,0xb2d8dccad
2911.36,1.0,92,2,2,1,5,0xb2d34651d
122027.71,3.0,10,3,4,3,10,0xb2d1e04c
547181.19,6.0,6,4,4,3,11,0xb2d06f22d
100002.11,2.0,31,3,3,2,8,0xb2d93875
155215.01,3.0,21,3,4,2,9,0xb2d54b3c
282984.81,2.0,13,3,3,3,9,0xb2d7fc69d
76547.34,1.0,1,3,2,4,9,0xb2d61539d
1669.61,1.0,12,1,2,3,6,0xb2d2f110
7922.27,1.0,2,2,2,4,8,0xb2d39579
200086.58,2.0,185,3,3,1,7,0xb2d5e8fa
63018.27,4.0,95,3,4,1,8,0xb2d2c014
131568.99,1.0,2,3,2,4,9,0xb2d8f732
200001.68,2.0,25,3,3,2,8,0xb2d90688
22070.87,3.0,4,2,4,4,10,0xb2d596a1d
40224.55,3.0,35,2,4,2,8,0xb2d91fc4d
110002.44,7.0,3,3,4,4,11,0xb2d54ae2d
310094.93,2.0,32,4,3,2,9,0xb2d62029d
50003.44,2.0,0,2,3,4,9,0xb2d68a95d
1051.47,1.0,26,1,2,2,5,0xb2d5cd3f
620567.72,9.0,18,4,4,2,10,0xb2d2eae0
12128.09,2.0,5,2,3,3,8,0xb2d2e764d
2.52,1.0,92,1,2,1,4,0xb2d0c149
30159.19,1.0,205,2,2,1,5,0xb2d5dc13d
148.14,1.0,75,1,2,1,4,0xb2d398d6
202842.99,2.0,129,3,3,1,7,0xb2d71688
452083.6,6.0,10,4,4,3,11,0xb2d59092d
72.35,1.0,0,1,2,4,7,0xb2d59201d
133389.1,7.0,7,3,4,3,10,0xb2d5e60ad
13100.62,1.0,92,2,2,1,5,0xb2d58c5ed
315162.76,3.0,70,4,4,1,9,0xb2d06e26
1521155.96,1.0,19,4,2,2,8,0xb2d2eb6ed
1041.49,1.0,7,1,2,3,6,0xb2d6dc3c
20000.63,2.0,53,2,3,2,7,0xb2d9ca94
794467.66,5.0,0,4,4,4,12,0xb2d6c8f2d
433114.73,2.0,21,4,3,2,9,0xb2d22518d
48.56,1.0,41,1,2,2,5,0xb2d91102
4111.38,1.0,2,2,2,4,8,0xb2d53052d
362240.32,4.0,11,4,4,3,11,0xb2d5c4cad
1059.56,1.0,32,1,2,2,5,0xb2d65163
54.52,1.0,20,1,2,2,5,0xb2d880df
200006.98,2.0,179,3,3,1,7,0xb2d5d059d
76897.17,2.0,11,3,3,3,9,0xb2d4051dd
200000.0,2.0,25,3,3,2,8,0xb2da1a9e
151391.74,1.0,0,3,2,4,9,0xb2d65802d
50002.11,2.0,83,2,3,1,6,0xb2d8cdc3
600000.0,3.0,3,4,4,4,12,0xb2d9c564
300022.49,4.0,8,3,4,3,10,0xb2d63f0bd
210018.74,5.0,12,3,4,3,10,0xb2d0ab96
21198.11,1.0,13,2,2,3,7,0xb2d30f81
501845.1,3.0,11,4,4,3,11,0xb2d646da
3079.52,1.0,0,2,2,4,8,0xb2d8d5e2
722685.06,1.0,9,4,2,3,9,0xb2d307f6d
348020.77,4.0,42,4,4,2,10,0xb2d2443ad
237762.02,1.0,126,3,2,1,6,0xb2d90f85d
20001.85,2.0,12,2,3,3,8,0xb2d68d00d
213746.46,1.0,11,3,2,3,8,0xb2d2abb6
134.32,1.0,33,1,2,2,5,0xb2d6a2bc
3056.43,1.0,9,2,2,3,7,0xb2d42d70d
3070.1,1.0,21,2,2,2,6,0xb2d2e77a
23984.69,1.0,34,2,2,2,6,0xb2d34649d
1144491.95,22.0,0,4,4,4,12,0xb2d2c302d
30462.02,2.0,9,2,3,3,8,0xb2d20059d
552.63,1.0,82,1,2,1,4,0xb2d60d69d
1011.39,1.0,184,1,2,1,4,0xb2d14502d
1572.83,1.0,9,1,2,3,6,0xb2d33473
3632.71,1.0,84,2,2,1,5,0xb2d30a22d
399002.84,3.0,7,4,4,3,11,0xb2d69e03
602132.28,3.0,18,4,4,2,10,0xb2d3f0a1d
300048.47,2.0,15,3,3,3,9,0xb2d58c29d
81223.33,1.0,0,3,2,4,9,0xb2d193ebd
30.95,1.0,18,1,2,2,5,0xb2d98c43
24861.61,2.0,8,2,3,3,8,0xb2d15dba
7825.42,1.0,0,2,2,4,8,0xb2d979e2
400000.0,2.0,7,4,3,3,10,0xb2d92bcad
1310848.82,6.0,25,4,4,2,10,0xb2d4a710
150608.02,6.0,0,3,4,4,11,0xb2d1eaecd
253891.16,1.0,55,3,2,2,7,0xb2d24c85
161.97,1.0,25,1,2,2,5,0xb2d1b573d
6694.82,1.0,92,2,2,1,5,0xb2d1cc36d
13574.79,1.0,0,2,2,4,8,0xb2d1a002
259.39,1.0,33,1,2,2,5,0xb2d654b8d
565001.81,11.0,0,4,4,4,12,0xb2d3a9d6d
37077.27,4.0,3,2,4,4,10,0xb2d5808cd
0.76,1.0,2,1,2,4,7,0xb2d63673
4947.95,1.0,4,2,2,4,8,0xb2d43c7d
400363.7,4.0,0,4,4,4,12,0xb2d3aff5d
6826.31,1.0,11,2,2,3,7,0xb2d6802a
450210.96,2.0,4,4,3,4,11,0xb2d0b9e6d
810079.6,5.0,11,4,4,3,11,0xb2d9bd65
212195.68,2.0,0,3,3,4,10,0xb2d5dd68
300071.49,3.0,25,3,4,2,9,0xb2d5e0fbd
280991.21,3.0,24,3,4,2,9,0xb2d938acd
6.85,1.0,0,1,2,4,7,0xb2da0d5b
2101.7,1.0,3,1,2,4,7,0xb2d8db02d
51273.3,2.0,10,2,3,3,8,0xb2d2a3a0
40138.25,1.0,184,2,2,1,5,0xb2d651e0
110762.37,2.0,245,3,3,1,7,0xb2d2920f
5632.74,1.0,17,2,2,2,6,0xb2d9a084
350.3,3.0,38,1,4,2,7,0x3b9b39b6d
105537.47,3.0,53,3,4,2,9,0x3b9b24c2d
10105.78,2.0,24,2,3,2,7,0xb2d1f129d
307382.22,4.0,11,4,4,3,11,0xb2d5e7c9d
200003.87,4.0,19,3,4,2,9,0xb2d1b624
55047.19,1.0,232,3,2,1,6,0xb2d36b08
211074.76,1.0,92,3,2,1,6,0xb2d1fcf8d
200000.03,2.0,0,3,3,4,10,0xb2d6b102d
8.09,1.0,21,1,2,2,5,0xb2d6c21e
65908.65,1.0,80,3,2,1,6,0xb2d650b3d
1547329.85,4.0,11,4,4,3,11,0xb2d6a1f6d
291028.01,9.0,10,3,4,3,10,0xb2d415fad
8250.18,1.0,10,2,2,3,7,0xb2d25e2d
1391.92,1.0,138,1,2,1,4,0xb2d39c12
952032.92,4.0,67,4,4,1,9,0xb2d1ada2
14814.2,2.0,111,2,3,1,6,0xb2d06ea1
3.17,1.0,71,1,2,1,4,0xb2d445a0d
5855.24,1.0,10,2,2,3,7,0xb2d305c5d
400000.0,3.0,56,4,4,2,10,0xb2d9027d
16473.6,1.0,47,2,2,2,6,0xb2d8c9a0d
237321.75,3.0,172,3,4,1,8,0xb2d07231d
4105.47,2.0,184,2,3,1,6,0x3b9b332ad
230004.86,2.0,179,3,3,1,7,0xb2d6b57ad
120095.59,5.0,52,3,4,2,9,0xb2d588b1d
0.0,1.0,5,1,2,3,6,0xb2d3fd44
8.1,1.0,6,1,2,3,6,0xb2d3ba96
1003552.38,2.0,18,4,3,2,9,0xb2d91635d
104483.95,2.0,2,3,3,4,10,0xb2d1cc1bd
501042.61,3.0,139,4,4,1,9,0xb2d28283d
1216.14,1.0,135,1,2,1,4,0xb2d6c2f7
758205.21,7.0,1,4,4,4,12,0xb2d10d26d
2027.61,2.0,184,1,3,1,5,0xb2d1a7f8d
141073.42,3.0,94,3,4,1,8,0xb2d5d0d5
500000.0,4.0,26,4,4,2,10,0xb2d94790
250003.69,2.0,7,3,3,3,9,0xb2d956a6
500001.46,2.0,5,4,3,3,10,0xb2d8df4e
1320.15,2.0,28,1,3,2,6,0xb2d9d426
409.82,1.0,10,1,2,3,6,0xb2d57e7ed
11277.39,1.0,4,2,2,4,8,0xb2d39560d
400006.32,3.0,6,4,4,3,11,0xb2d5fe69
3101.42,1.0,7,2,2,3,7,0xb2d7f078
4407.57,1.0,22,2,2,2,6,0xb2d21d76d
1.5,1.0,58,1,2,2,5,0xb2d6ebbf
202843.31,2.0,111,3,3,1,7,0xb2d913ee
612106.45,1.0,0,4,2,4,10,0xb2d311ad
300098.64,2.0,97,3,3,1,7,0xb2d699e6d
18116.93,1.0,2,2,2,4,8,0xb2d2f541
28708.45,1.0,92,2,2,1,5,0xb2d3e681d
200767.14,2.0,26,3,3,2,8,0xb2d5f659d
100000.0,2.0,9,3,3,3,9,0xb2d95cc0
4265.65,1.0,9,2,2,3,7,0xb2d3ba5b
0.27,1.0,5,1,2,3,6,0xb2d2f231d
510002.11,2.0,3,4,3,4,11,0xb2d95840d
12144.92,1.0,5,2,2,3,7,0xb2d2b5e1d
43877.14,1.0,3,2,2,4,8,0xb2d4bc5dd
20036.95,2.0,175,2,3,1,6,0xb2d55b31
30180.78,4.0,24,2,4,2,8,0xb2d94591d
1.78,1.0,59,1,2,2,5,0xb2d3caf2d
200010.11,2.0,25,3,3,2,8,0xb2d93b90
20000.43,3.0,11,2,4,3,9,0xb2da21b5
500036.05,3.0,3,4,4,4,12,0xb2d986bd
100070.86,2.0,49,3,3,2,8,0xb2d1a321
42001.33,2.0,80,2,3,1,6,0xb2d988bd
10393.8,1.0,184,2,2,1,5,0xb2d28fc4
100048.89,2.0,36,3,3,2,8,0xb2d78a10d
410013.53,3.0,101,4,4,1,9,0xb2d1c162d
23.52,1.0,9,1,2,3,6,0xb2d5071c
84073.69,1.0,74,3,2,1,6,0xb2d3e924
607978.33,6.0,32,4,4,2,10,0xb2d4d9ced
40002.17,2.0,231,2,3,1,6,0xb2d6eb74
32852.94,1.0,0,2,2,4,8,0xb2d29887
200058.61,2.0,116,3,3,1,7,0xb2d56e78
20000.21,2.0,59,2,3,2,7,0xb2d9001cd
934.75,1.0,24,1,2,2,5,0xb2d1cf1ad
169.9,1.0,3,1,2,4,7,0xb2d634a0
6036.47,1.0,23,2,2,2,6,0xb2d69b46
6179.07,1.0,1,2,2,4,8,0xb2d968da
1619271.37,5.0,21,4,4,2,10,0xb2d63796
3558938.36,3.0,5,4,4,3,11,0xb2d21263d
45230.26,1.0,0,2,2,4,8,0xb2d1b09b
184493.45,1.0,5,3,2,3,8,0xb2d32d75d
310631.42,1.0,2,4,2,4,10,0xb2d6dd62d
103113.1,2.0,5,3,3,3,9,0xb2d597b4d
1862.05,1.0,134,1,2,1,4,0xb2d6c9a9d
20108.17,2.0,82,2,3,1,6,0xb2d605e2
1079933.25,1.0,0,4,2,4,10,0xb2d6a46ed
36.13,2.0,63,1,3,2,6,0xb2d43aff
110144.68,3.0,129,3,4,1,8,0xb2d5ceef
202513.51,2.0,118,3,3,1,7,0xb2d26c75
1085000.93,1.0,1,4,2,4,10,0xb2d1efb6d
3790.87,2.0,92,2,3,1,6,0x3b9b1029
51829.84,1.0,21,2,2,2,6,0xb2d3bf76
73.85,1.0,19,1,2,2,5,0xb2d101c2d
714507.59,2.0,16,4,3,2,9,0xb2d69a87
239172.06,2.0,165,3,3,1,7,0xb2d17699d
500082.72,3.0,129,4,4,1,9,0x3b9b25e8
90681.25,4.0,0,3,4,4,11,0xb2d93cd4
3565.74,1.0,8,2,2,3,7,0xb2d293b2
4.22,1.0,6,1,2,3,6,0xb2d95f41d
50002.11,2.0,49,2,3,2,7,0xb2d9d446
223005.28,4.0,74,3,4,1,8,0xb2d60e34
68059.97,2.0,80,3,3,1,7,0xb2d11f90d
10033.82,1.0,92,2,2,1,5,0xb2d5dab8d
1337.77,1.0,11,1,2,3,6,0xb2d90201d
1481.81,1.0,92,1,2,1,4,0xb2d34a09d
1450018.56,11.0,4,4,4,4,12,0x3b9b3f4d
150007.51,4.0,8,3,4,3,10,0xb2d51058
518502.11,2.0,122,4,3,1,8,0xb2d3a675d
249223.76,2.0,54,3,3,2,8,0xb2d40f3bd
1685.74,1.0,184,1,2,1,4,0xb2d2c77cd
10002.64,2.0,3,2,3,4,9,0xb2d68014d
782.07,1.0,4,1,2,4,7,0xb2d6acde
10029.63,1.0,92,2,2,1,5,0xb2d2e2b5
1085.84,1.0,4,1,2,4,7,0xb2d3ab44
100000.0,2.0,8,3,3,3,9,0xb2d44930d
2030.56,1.0,18,1,2,2,5,0xb2d6b12d
35.82,1.0,11,1,2,3,6,0xb2d27106d
12113.33,2.0,24,2,3,2,7,0xb2d6f799
2.52,1.0,11,1,2,3,6,0xb2d51c4ad
511139.32,3.0,32,4,4,2,10,0xb2d648fad
15002.4,2.0,92,2,3,1,6,0xb2d5f29d
225000.13,4.0,1,3,4,4,11,0xb2da000d
517212.76,4.0,74,4,4,1,9,0xb2d637eb
8336.28,1.0,10,2,2,3,7,0xb2d1ca13d
100462.75,1.0,4,3,2,4,9,0xb2d62d21d
81.12,1.0,9,1,2,3,6,0xb2d23bed
509147.91,7.0,0,4,4,4,12,0xb2d1d8c2
1200048.56,2.0,25,4,3,2,9,0xb2d68b24
200000.0,2.0,8,3,3,3,9,0xb2da51f1
250114.88,2.0,77,3,3,1,7,0xb2d6143e
200000.42,2.0,9,3,3,3,9,0xb2d9f264
257055.77,3.0,97,3,4,1,8,0xb2d18ebed
372382.15,5.0,4,4,4,4,12,0xb2d154fa
470010.45,3.0,10,4,4,3,11,0xb2d91e40
52488.9,2.0,4,3,3,4,10,0xb2d5db8fd
2000304.15,3.0,0,4,4,4,12,0xb2d53068
401.66,1.0,6,1,2,3,6,0xb2d5d1bb
137549.23,2.0,129,3,3,1,7,0xb2d570ef
920001.27,5.0,10,4,4,3,11,0xb2d1a63fd
10000.32,2.0,31,2,3,2,7,0xb2d933d6
299000.0,8.0,3,3,4,4,11,0xb2d17068d
27.9,1.0,10,1,2,3,6,0xb2d2c3e2
4095076.0,15.0,1,4,4,4,12,0xb2d17888d
10419.27,1.0,1,2,2,4,8,0xb2d347c8
119493.25,2.0,6,3,3,3,9,0xb2d1aeda
50097.57,1.0,3,2,2,4,8,0xb2d2e0f0d
2546.62,1.0,0,1,2,4,7,0xb2d5e42bd
14121.37,2.0,0,2,3,4,9,0xb2d689e2d
894.96,1.0,77,1,2,1,4,0xb2d28149
142007.87,7.0,3,3,4,4,11,0xb2d0da4cd
8444.51,1.0,4,2,2,4,8,0xb2d478c3
3663.22,1.0,18,2,2,2,6,0xb2d58e98
658917.68,1.0,1,4,2,4,10,0xb2d4be61
200722.09,2.0,50,3,3,2,8,0xb2d9d338
10000.11,2.0,77,2,3,1,6,0xb2d997f5
21997.18,1.0,5,2,2,3,7,0xb2d1e1a2
9709.55,1.0,13,2,2,3,7,0x3b9b34b5
301627.67,2.0,60,4,3,2,9,0xb2d9b982
81370.93,2.0,139,3,3,1,7,0xb2d62b0ed
2858.46,1.0,291,1,2,1,4,0xb2d68044
6462.36,2.0,0,2,3,4,9,0x3b9b2530d
2222.02,1.0,0,1,2,4,7,0xb2d4ce6a
6977.95,1.0,0,2,2,4,8,0xb2d69bbb
25.51,1.0,18,1,2,2,5,0xb2d28222
16216.45,1.0,15,2,2,3,7,0xb2d9452b
120005.78,3.0,70,3,4,1,8,0xb2d635f3
153.07,1.0,35,1,2,2,5,0xb2d21973
26058.85,1.0,3,2,2,4,8,0xb2d3f3b0
1415.11,1.0,8,1,2,3,6,0xb2d3ca9a
110656.85,1.0,58,3,2,2,7,0xb2d9bbed
12.86,1.0,13,1,2,3,6,0xb2d631c7d
274.98,1.0,11,1,2,3,6,0xb2d3a0b2
10322.82,1.0,7,2,2,3,7,0xb2d6aab1
15744.44,1.0,3,2,2,4,8,0xb2d34065d
1339.96,1.0,144,1,2,1,4,0xb2d6f92e
6.33,1.0,88,1,2,1,4,0xb2d63ec5d
3801.99,1.0,0,2,2,4,8,0xb2d99458
101169.49,1.0,7,3,2,3,8,0xb2d2e1ef
116.98,1.0,64,1,2,2,5,0xb2d8a85c
0.78,1.0,0,1,2,4,7,0xb2d78cd8
2096.99,1.0,126,1,2,1,4,0xb2d70411d
280016.61,2.0,5,3,3,3,9,0xb2d94154d
816038.71,2.0,18,4,3,2,9,0xb2d8da93d
2458.6,1.0,4,1,2,4,7,0xb2d79155d
145.69,1.0,10,1,2,3,6,0xb2d25b53
2011.73,1.0,92,1,2,1,4,0xb2d22d20
687827.04,2.0,3,4,3,4,11,0xb2d589a9
10010.96,2.0,9,2,3,3,8,0xb2da22d5
1000023.0,2.0,66,4,3,2,9,0xb2d4e205d
186577.06,1.0,0,3,2,4,9,0xb2d9b324
3.79,2.0,41,1,3,2,6,0xb2d469f4
9371.89,1.0,0,2,2,4,8,0xb2d43bc6
410005.49,3.0,11,4,4,3,11,0xb2d6f27c
50078.11,3.0,4,2,4,4,10,0xb2d6376bd
110132.27,7.0,6,3,4,3,10,0xb2d592bc
1189.97,1.0,210,1,2,1,4,0xb2d286ce
71398.61,1.0,7,3,2,3,8,0xb2d8f5c5
38000.3,3.0,24,2,4,2,8,0xb2d3cf2fd
566927.53,2.0,0,4,3,4,11,0xb2d1714fd
120000.0,2.0,6,3,3,3,9,0xb2d9321c
113.35,1.0,9,1,2,3,6,0xb2d5b8c1
100001.06,2.0,39,3,3,2,8,0xb2d9efcc
351390.77,4.0,10,4,4,3,11,0xb2d18449
3.76,1.0,17,1,2,2,5,0xb2d95875d
80179.37,2.0,1,3,3,4,10,0xb2d63e05d
44114.05,1.0,0,2,2,4,8,0xb2d570af
700716.86,4.0,11,4,4,3,11,0xb2d9cd09
478061.65,2.0,117,4,3,1,8,0xb2d22045d
364.57,1.0,33,1,2,2,5,0xb2d51e57d
35949.62,9.0,0,2,4,4,10,0xb2d44a99d
1143.97,2.0,92,1,3,1,5,0xb2d248bd
1310023.23,7.0,3,4,4,4,12,0xb2d26e5d
104072.57,2.0,11,3,3,3,9,0xb2d19618d
135271.28,2.0,125,3,3,1,7,0xb2d163dd
360025.43,3.0,11,4,4,3,11,0xb2d64cdb
1841.6,1.0,10,1,2,3,6,0xb2d79380
0.88,1.0,0,1,2,4,7,0xb2d6aaaed
8.52,1.0,38,1,2,2,5,0xb2d941b5d
70167.69,1.0,0,3,2,4,9,0xb2d100d7d
9812.46,1.0,92,2,2,1,5,0xb2d25937
547104.18,2.0,2,4,3,4,11,0xb2d12961d
1142887.82,4.0,0,4,4,4,12,0xb2d40bbed
9207.67,1.0,0,2,2,4,8,0xb2d4972e
133887.0,2.0,60,3,3,2,8,0xb2d323ae
1360001.2,10.0,2,4,4,4,12,0xb2d17948
340072.6,3.0,0,4,4,4,12,0xb2d2112ad
1066.77,1.0,92,1,2,1,4,0xb2d0e1b8d
4796.25,1.0,0,2,2,4,8,0xb2d8c8b1
1208.13,1.0,16,1,2,2,5,0xb2d60a03
9226.15,1.0,11,2,2,3,7,0xb2d6cb04d
50074.17,2.0,174,2,3,1,6,0xb2d5f93a
500015.83,2.0,11,4,3,3,10,0xb2da3e42
45000.0,1.0,2,2,2,4,8,0xb2d926be
243819.29,7.0,6,3,4,3,10,0xb2d2a038
63312.76,1.0,3,3,2,4,9,0xb2d554eed
3356.66,1.0,1,2,2,4,8,0xb2d7025dd
2205.01,1.0,92,1,2,1,4,0x3b9b3993d
11078.76,2.0,184,2,3,1,6,0xb2d28507
2603947.8,4.0,3,4,4,4,12,0xb2d099fed
73447.12,4.0,0,3,4,4,11,0xb2d61415
200000.0,2.0,0,3,3,4,10,0xb2d8e351
550701.27,5.0,3,4,4,4,12,0xb2d6c307
217.0,1.0,5,1,2,3,6,0xb2d1fb00
50.89,1.0,16,1,2,2,5,0xb2d4821f
200011.07,2.0,188,3,3,1,7,0xb2d20ec8
5113.47,1.0,184,2,2,1,5,0xb2d5746fd
2471.33,2.0,6,1,3,3,7,0x3b9b3adb
200002.12,3.0,32,3,4,2,9,0xb2d9c07c
928.24,1.0,36,1,2,2,5,0xb2d414b1
220743.65,3.0,97,3,4,1,8,0xb2d3d92b
38432.59,2.0,4,2,3,4,9,0xb2d0cdbc
1362.08,3.0,92,1,4,1,6,0x3b9aded9
10863.69,1.0,10,2,2,3,7,0xb2d63107
0.09,1.0,6,1,2,3,6,0xb2d6821d
24.18,1.0,4,1,2,4,7,0xb2d67dfc
4621.46,3.0,0,2,4,4,10,0xb2d08dd2
81.64,2.0,32,1,3,2,6,0xb2d6ead1d
260023.32,5.0,80,3,4,1,8,0xb2d915b7
752287.84,7.0,1,4,4,4,12,0xb2d1f021
4.06,1.0,64,1,2,2,5,0xb2d2d9b8
581054.0,4.0,70,4,4,1,9,0xb2d23250d
526851.09,2.0,4,4,3,4,11,0xb2d3e1ddd
40035.78,2.0,3,2,3,4,9,0xb2d2ce2ed
51017.19,2.0,181,2,3,1,6,0xb2d40589d
626062.04,10.0,20,4,4,2,10,0xb2d6e700d
39646.32,2.0,2,2,3,4,9,0xb2d3c40bd
110008.39,2.0,39,3,3,2,8,0xb2d44c3c
49254.67,2.0,5,2,3,3,8,0xb2d60143d
1050157.08,5.0,52,4,4,2,10,0xb2d3d2ead
10990.89,1.0,66,2,2,2,6,0xb2d0a461d
564.65,1.0,0,1,2,4,7,0xb2d2ebfcd
286826.92,5.0,27,3,4,2,9,0xb2d5269fd
86026.48,5.0,6,3,4,3,10,0xb2d60b2ad
460000.0,1.0,7,4,2,3,9,0xb2da39aa
1682806.1,6.0,1,4,4,4,12,0xb2d520dfd
1179080.04,21.0,0,4,4,4,12,0xb2d247d7d
5094.79,1.0,30,2,2,2,6,0xb2d69f86
29969.58,1.0,3,2,2,4,8,0xb2d6b5ff
50553.1,2.0,74,2,3,1,6,0xb2d88b0ed
72270.52,3.0,97,3,4,1,8,0xb2d56bff
2.34,1.0,71,1,2,1,4,0xb2d93c32d
214374.6,6.0,1,3,4,4,11,0xb2d6fb0fd
615831.36,4.0,78,4,4,1,9,0xb2d6113fd
400010.42,3.0,16,4,4,2,10,0xb2d9d560
5537.01,1.0,0,2,2,4,8,0xb2d29b81
57122.29,1.0,4,3,2,4,9,0xb2d1695e
281208.11,2.0,4,3,3,4,10,0xb2d11541
33.32,1.0,46,1,2,2,5,0xb2d2f410
50187.41,1.0,0,2,2,4,8,0xb2d921d2
80001.36,3.0,74,3,4,1,8,0xb2d781aed
251776.53,2.0,82,3,3,1,7,0xb2d98c49
400117.96,3.0,47,4,4,2,10,0xb2d57eafd
100002.84,2.0,92,3,3,1,7,0xb2d4708b
205527.8,3.0,129,3,4,1,8,0xb2d59473d
403019.91,7.0,92,4,4,1,9,0xb2d0d137
0.0,1.0,23,1,2,2,5,0xb2d0ba17
16.15,1.0,0,1,2,4,7,0xb2d58ce2
6584.15,1.0,10,2,2,3,7,0xb2d6ebc9d
164042.44,4.0,39,3,4,2,9,0xb2d074b8d
32097.94,2.0,92,2,3,1,6,0xb2d22e47
862899.36,3.0,0,4,4,4,12,0xb2d0d7a8
540014.19,5.0,57,4,4,2,10,0xb2d5a729
30001.26,3.0,27,2,4,2,8,0xb2d92ef9
46415.88,1.0,18,2,2,2,6,0xb2d6097ad
1122.98,1.0,184,1,2,1,4,0xb2d3689ad
7388.71,1.0,184,2,2,1,5,0xb2d1c466d
310982.38,1.0,294,4,2,1,7,0xb2d46c36
157355.13,1.0,29,3,2,2,7,0xb2d5c119
4430176.99,6.0,63,4,4,2,10,0xb2d1d3cf
815.79,1.0,20,1,2,2,5,0xb2d3b388d
400000.01,2.0,5,4,3,3,10,0xb2d90ae5
1071.81,1.0,253,1,2,1,4,0xb2d34817d
211263.78,3.0,0,3,4,4,11,0xb2d067b4
245.61,1.0,2,1,2,4,7,0xb2d1e096
9299.65,1.0,2,2,2,4,8,0xb2d2c20f
177034.59,3.0,1,3,4,4,11,0xb2d29b7cd
442109.39,4.0,0,4,4,4,12,0xb2d4e774d
810136.67,5.0,108,4,4,1,9,0xb2d3600dd
37170.68,1.0,214,2,2,1,5,0xb2d59dc4
395546.39,4.0,1,4,4,4,12,0xb2d5821c
9500.16,3.0,39,2,4,2,8,0xb2d95de3
331687.69,8.0,6,4,4,3,11,0xb2d0759bd
10001.0,2.0,56,2,3,2,7,0xb2d6c704
3051.93,1.0,92,2,2,1,5,0xb2d29f4cd
1208.0,1.0,54,1,2,2,5,0xb2d3459b
311600.8,4.0,1,4,4,4,12,0xb2d4e435
11051.53,1.0,15,2,2,3,7,0xb2d9399c
50596.89,2.0,62,2,3,2,7,0xb2d6c3a7d
50092.99,2.0,12,2,3,3,8,0xb2d6bff6
420009.87,3.0,73,4,4,1,9,0xb2d1e785d
310.01,1.0,6,1,2,3,6,0xb2d6f7c2d
745941.78,3.0,168,4,4,1,9,0xb2d49d5cd
11.92,1.0,35,1,2,2,5,0xb2d53a4c
20048.59,4.0,118,2,4,1,7,0xb2d5eb85
811300.82,5.0,3,4,4,4,12,0xb2d4ae22
251007.25,2.0,20,3,3,2,8,0xb2d4a5d3d
10000.11,2.0,97,2,3,1,6,0xb2d85748
252024.01,3.0,25,3,4,2,9,0xb2d193aed
1857.71,1.0,0,1,2,4,7,0xb2d87bfe
21943.11,1.0,1,2,2,4,8,0xb2d358a1
212808.44,1.0,22,3,2,2,7,0xb2d28fc3d
261498.23,3.0,41,3,4,2,9,0xb2d68388
39.98,1.0,9,1,2,3,6,0xb2d9ffd0
6106.59,1.0,9,2,2,3,7,0xb2d3fa92
0.0,2.0,0,1,3,4,8,0xb2d981b6
110097.52,3.0,18,3,4,2,9,0xb2d0e5e9d
1.28,1.0,19,1,2,2,5,0xb2d6c0a3
735318.6,5.0,76,4,4,1,9,0xb2d362dbd
8047.85,1.0,10,2,2,3,7,0xb2d22ed8d
1801.77,1.0,8,1,2,3,6,0xb2d9c2e1
5245.31,1.0,20,2,2,2,6,0xb2d118ff
300816.95,2.0,4,4,3,4,11,0xb2d42617d
277894.8,2.0,127,3,3,1,7,0xb2d93329d
210722.87,6.0,22,3,4,2,9,0xb2d377ebd
677553.38,1.0,13,4,2,3,9,0xb2d4c0d0
72.55,1.0,31,1,2,2,5,0xb2d26422
1101270.88,6.0,18,4,4,2,10,0xb2d41687
1996.09,1.0,158,1,2,1,4,0xb2d3ca7d
154236.27,2.0,0,3,3,4,10,0xb2d3091d
20379.24,2.0,15,2,3,3,8,0xb2d64d3c
45018.16,3.0,17,2,4,2,8,0xb2d56e3f
740000.0,6.0,7,4,4,3,11,0xb2d23b83d
450010.01,4.0,22,4,4,2,10,0xb2d93c96d
200001.9,2.0,12,3,3,3,9,0xb2da4287
1648.99,1.0,9,1,2,3,6,0xb2d6c119
3426.53,1.0,21,2,2,2,6,0xb2d0fa55d
945018.88,3.0,1,4,4,4,12,0xb2d10d1bd
1076.59,1.0,140,1,2,1,4,0xb2d373c2
843.45,1.0,9,1,2,3,6,0xb2d59568d
500000.0,2.0,10,4,3,3,10,0xb2d96b2cd
151347.03,3.0,3,3,4,4,11,0xb2d0d2e5d
29.12,1.0,66,1,2,2,5,0xb2d1100e
333107.47,3.0,63,4,4,2,10,0xb2d48e35d
3353642.8,5.0,3,4,4,4,12,0xb2d5ce78
30000.95,2.0,77,2,3,1,6,0xb2d99452
42434.68,1.0,1,2,2,4,8,0xb2d6c06e
11073.65,1.0,0,2,2,4,8,0xb2d6ddf3d
122.95,1.0,0,1,2,4,7,0xb2d9138dd
837598.38,8.0,1,4,4,4,12,0xb2d6ebb8
92056.34,3.0,56,3,4,2,9,0xb2d4cefed
157145.61,4.0,19,3,4,2,9,0xb2d5bce6
316153.82,5.0,0,4,4,4,12,0xb2d1979ad
38.06,1.0,88,1,2,1,4,0xb2d24ac7
1320.05,1.0,7,1,2,3,6,0xb2d256e8
5578.01,1.0,3,2,2,4,8,0xb2d6b6aa
50329.89,4.0,152,2,4,1,7,0x3b9b3ace
640013.52,2.0,186,4,3,1,8,0xb2d87d91d
496.3,1.0,27,1,2,2,5,0xb2d68cbed
50951.72,1.0,6,2,2,3,7,0xb2d3a9a7d
3663.92,1.0,13,2,2,3,7,0xb2d23999d
502542.6,2.0,36,4,3,2,9,0xb2d643b3
1972026.81,8.0,1,4,4,4,12,0xb2d656a5d
11001.1,2.0,65,2,3,2,7,0xb2d96e73
1000147.5,6.0,0,4,4,4,12,0x3b9b2715d
420000.91,5.0,0,4,4,4,12,0xb2d417acd
10.32,1.0,35,1,2,2,5,0xb2d5c8c4d
60102.55,2.0,15,3,3,3,9,0xb2d9e49b
52296.06,2.0,25,3,3,2,8,0xb2d4548d
2401.01,1.0,0,1,2,4,7,0xb2d7661cd
67927.59,1.0,6,3,2,3,8,0xb2d43664d
5.59,1.0,56,1,2,2,5,0xb2d98ff4
1001.27,1.0,127,1,2,1,4,0xb2d70859d
594370.98,3.0,12,4,4,3,11,0xb2d64b7a
1095.46,1.0,23,1,2,2,5,0xb2d45954d
10000.11,2.0,92,2,3,1,6,0xb2d5cb5d
262914.42,3.0,1,3,4,4,11,0xb2d921add
429860.0,3.0,0,4,4,4,12,0xb2d550bed
238970.12,7.0,4,3,4,4,11,0x3b9b2c61d
126112.86,2.0,109,3,3,1,7,0xb2d16268d
566202.24,3.0,3,4,4,4,12,0xb2d906e1
440062.03,15.0,6,4,4,3,11,0xb2d5c813d
944.05,1.0,92,1,2,1,4,0x3b9ad11b
26453.42,1.0,49,2,2,2,6,0xb2d37c1dd
15182.48,2.0,136,2,3,1,6,0xb2d63433d
279006.62,14.0,28,3,4,2,9,0xb2d3eea3d
37.66,1.0,24,1,2,2,5,0xb2d98329
175564.79,3.0,10,3,4,3,10,0xb2d064c5
500000.0,3.0,1,4,4,4,12,0xb2d97fe5
80015.97,5.0,1,3,4,4,11,0xb2d0e5d4d
10030.12,1.0,295,2,2,1,5,0xb2d106a2d
102920.28,2.0,74,3,3,1,7,0xb2d65a6f
106402.62,3.0,66,3,4,2,9,0xb2d2609c
561421.09,1.0,12,4,2,3,9,0xb2d29932d
11.7,1.0,58,1,2,2,5,0xb2d5ceca
3702.52,1.0,1,2,2,4,8,0xb2d8ed82
528992.86,3.0,5,4,4,3,11,0xb2d8c73fd
500081.36,2.0,12,4,3,3,10,0xb2d91dced
100054.82,2.0,235,3,3,1,7,0xb2d54abf
1009.64,1.0,184,1,2,1,4,0xb2d1b942
67032.62,4.0,4,3,4,4,11,0xb2d43b5fd
29028.84,1.0,7,2,2,3,7,0xb2d6964dd
31146.21,1.0,134,2,2,1,5,0xb2d78565
140008.25,3.0,3,3,4,4,11,0xb2d2da13d
197.08,1.0,67,1,2,1,4,0xb2d64068
30304.62,1.0,184,2,2,1,5,0xb2d0eeaa
300002.78,2.0,13,3,3,3,9,0xb2d4f8ff
392.92,1.0,8,1,2,3,6,0xb2d9f5e1
5259.08,1.0,0,2,2,4,8,0xb2d312f6d
21115.08,2.0,1,2,3,4,9,0xb2d59523d
390015.56,4.0,31,4,4,2,10,0xb2d6841a
520110.27,5.0,63,4,4,2,10,0xb2d184edd
223.59,1.0,3,1,2,4,7,0xb2d361b6d
100256.69,2.0,19,3,3,2,8,0xb2d40dbe
10.49,1.0,12,1,2,3,6,0xb2d1bac4
620019.87,3.0,59,4,4,2,10,0xb2d65d57d
6906.16,1.0,11,2,2,3,7,0xb2d17521d
7717.06,1.0,3,2,2,4,8,0xb2d820b3
20190.28,2.0,0,2,3,4,9,0xb2d13d19d
135276.34,2.0,217,3,3,1,7,0xb2d163ddd
130412.45,1.0,92,3,2,1,6,0xb2d3d311d
50333.71,1.0,92,2,2,1,5,0xb2d400ff
240005.1,2.0,7,3,3,3,9,0xb2d0d421d
298621.7,2.0,0,3,3,4,10,0xb2d0f9b6d
316808.67,1.0,5,4,2,3,9,0xb2d28bbbd
3342.92,1.0,0,2,2,4,8,0xb2d6ba9ad
9450.99,1.0,0,2,2,4,8,0xb2d689f1
16258.77,1.0,3,2,2,4,8,0xb2d43267
5151.36,1.0,1,2,2,4,8,0xb2d3b4a7
1796.21,1.0,18,1,2,2,5,0xb2d483d9
40579.98,1.0,41,2,2,2,6,0xb2d31eb8d
204276.01,10.0,11,3,4,3,10,0xb2d628fa
315856.81,2.0,231,4,3,1,8,0xb2d12699
500000.0,2.0,7,4,3,3,10,0xb2d94a52
385000.87,15.0,0,4,4,4,12,0xb2d3bd0e
121764.46,4.0,0,3,4,4,11,0xb2d092f8
16.72,2.0,13,1,3,3,7,0xb2d7018e
385907.5,11.0,0,4,4,4,12,0x3b9af1acd
11028.26,1.0,92,2,2,1,5,0xb2d3b80bd
66771.64,1.0,3,3,2,4,9,0xb2d5a606d
393376.34,10.0,7,4,4,3,11,0x3b9ad54fd
3193919.32,3.0,1,4,4,4,12,0xb2d5384b
81125.89,2.0,67,3,3,1,7,0xb2d16705
21311.23,1.0,2,2,2,4,8,0xb2d5ea61d
100005.02,2.0,66,3,3,2,8,0xb2d8d675
120571.56,2.0,94,3,3,1,7,0xb2d3f469d
204266.11,2.0,196,3,3,1,7,0xb2d69ec6d
7866.73,1.0,2,2,2,4,8,0xb2d48699
68838.25,3.0,116,3,4,1,8,0xb2d129d4
972.96,1.0,18,1,2,2,5,0xb2d1fe07
70.9,1.0,20,1,2,2,5,0xb2d6bd63
65.37,1.0,7,1,2,3,6,0xb2d41659
2.52,1.0,184,1,2,1,4,0xb2d0c149d
1016080.53,5.0,0,4,4,4,12,0xb2d23a39
160850.83,2.0,24,3,3,2,8,0xb2d6149ad
1204.65,1.0,168,1,2,1,4,0xb2d3457fd
15000.0,2.0,9,2,3,3,8,0xb2d377c0
17.91,1.0,8,1,2,3,6,0xb2d08ffd
336.82,1.0,1,1,2,4,7,0xb2d32976
5045.26,1.0,0,2,2,4,8,0xb2d7edf0d
900000.0,5.0,8,4,4,3,11,0xb2d78187d
639000.0,5.0,5,4,4,3,11,0xb2d6005ad
183661.53,4.0,10,3,4,3,10,0xb2d89033
19568.36,1.0,1,2,2,4,8,0xb2d2f9f1d
1914.91,1.0,184,1,2,1,4,0xb2d17f26d
4561.62,1.0,300,2,2,1,5,0xb2d393a8
729353.83,5.0,63,4,4,2,10,0xb2d68647
50089.52,2.0,60,2,3,2,7,0xb2d19ae8
180.68,1.0,1,1,2,4,7,0xb2d906ba
80.69,2.0,21,1,3,2,6,0xb2d23f4b
29432.13,1.0,0,2,2,4,8,0xb2d8dc9b
287000.01,4.0,0,3,4,4,11,0xb2d9694e
586.29,1.0,8,1,2,3,6,0xb2d60a5cd
701.28,1.0,10,1,2,3,6,0xb2d2c989
1106100.65,5.0,2,4,4,4,12,0xb2d1a22b
25076.07,1.0,92,2,2,1,5,0xb2d60b9dd
423.2,1.0,27,1,2,2,5,0xb2d5aa1fd
18465.93,1.0,5,2,2,3,7,0xb2d18d64
50010.66,2.0,41,2,3,2,7,0xb2d9239bd
50883.2,4.0,184,2,4,1,7,0xb2d2a272
4180.19,1.0,131,2,2,1,5,0xb2d0c96ed
210757.72,3.0,18,3,4,2,9,0xb2d48149d
527017.23,3.0,47,4,4,2,10,0xb2d0c38bd
635.87,1.0,9,1,2,3,6,0xb2d80f4d
104787.29,1.0,49,3,2,2,7,0xb2d37c2b
370659.14,1.0,2,4,2,4,10,0xb2d4deac
26.01,2.0,4,1,3,4,8,0xb2d1d644
17.21,1.0,75,1,2,1,4,0xb2d98927
12637.7,1.0,5,2,2,3,7,0xb2d6cb38
165283.8,8.0,0,3,4,4,11,0xb2d4bdc3
319194.02,2.0,0,4,3,4,11,0xb2d350f2d
32.07,1.0,14,1,2,3,6,0xb2d9b259
19.82,1.0,89,1,2,1,4,0xb2d3bfa6
709409.56,14.0,24,4,4,2,10,0xb2d35c05d
41816.24,1.0,92,2,2,1,5,0xb2d22042
174041.9,3.0,3,3,4,4,11,0xb2d60e0e
367.22,1.0,167,1,2,1,4,0xb2d43fba
80081.09,2.0,13,3,3,3,9,0xb2d6dd74
200008.0,1.0,3,3,2,4,9,0xb2d5d9d3
86055.51,2.0,12,3,3,3,9,0xb2d5fd0ad
153093.04,3.0,39,3,4,2,9,0xb2d60b9e
2796.85,1.0,92,1,2,1,4,0xb2d15c8f
1496404.42,1.0,3,4,2,4,10,0xb2d422eb
9204.53,1.0,29,2,2,2,6,0xb2d923e7
1350063.85,10.0,18,4,4,2,10,0xb2d486ccd
7421.16,1.0,7,2,2,3,7,0xb2d4b878
200000.7,2.0,1,3,3,4,10,0xb2d5ccbb
51001.08,2.0,92,2,3,1,6,0xb2d2c4b7
50505.42,1.0,218,2,2,1,5,0xb2d6a4c9d
32465.55,1.0,92,2,2,1,5,0xb2d3490e
203178.2,3.0,8,3,4,3,10,0xb2d36cafd
454025.86,3.0,6,4,4,3,11,0xb2d53c54d
16.05,1.0,26,1,2,2,5,0xb2d6d8af
60000.63,2.0,53,3,3,2,8,0xb2d9cfc0
65.92,2.0,52,1,3,2,6,0xb2d316fad
9543.33,1.0,9,2,2,3,7,0xb2d8df8d
337007.68,5.0,6,4,4,3,11,0xb2d8df92d
18629.17,1.0,184,2,2,1,5,0xb2d28b51d
4990.4,1.0,9,2,2,3,7,0xb2d60762
270011.41,2.0,108,3,3,1,7,0xb2d16c68d
328112.25,3.0,129,4,4,1,9,0xb2d076cfd
5342.97,1.0,184,2,2,1,5,0xb2d2a0f1d
340098.85,3.0,31,4,4,2,10,0xb2d5ef61
19826.53,1.0,5,2,2,3,7,0xb2d60755d
120009.97,2.0,60,3,3,2,8,0xb2d99fc5
3053064.27,12.0,14,4,4,3,11,0xb2d7c64bd
170022.03,1.0,14,3,2,3,8,0xb2d0d48bd
25000.79,2.0,56,2,3,2,7,0xb2d9c562
25370.5,2.0,1,2,3,4,9,0xb2d0f7ec
26898.18,1.0,222,2,2,1,5,0xb2d24a5ed
501776.04,2.0,33,4,3,2,9,0xb2d97ea2
30648.13,1.0,140,2,2,1,5,0xb2d2e71bd
1000004.01,2.0,6,4,3,3,10,0xb2d51e85
80359.85,2.0,76,3,3,1,7,0xb2d5bd6dd
1322.35,1.0,92,1,2,1,4,0xb2d2565b
21000.84,2.0,65,2,3,2,7,0xb2d97300d
9849.49,1.0,184,2,2,1,5,0x3b9b1a10
311649.99,2.0,143,4,3,1,8,0xb2d60348d
1330199.67,9.0,0,4,4,4,12,0xb2d6a8cf
160023.65,3.0,2,3,4,4,11,0xb2d1efd2
1549.55,1.0,5,1,2,3,6,0xb2d6a02d
200035.1,2.0,5,3,3,3,9,0xb2d64d9e
50635.59,2.0,92,2,3,1,6,0xb2d34924d
7986.09,1.0,27,2,2,2,6,0xb2d7835bd
50133.28,4.0,60,2,4,2,8,0xb2d5923e
28149.68,1.0,18,2,2,2,6,0xb2d2661ed
20035.34,1.0,4,2,2,4,8,0xb2d0f055
4840.28,1.0,0,2,2,4,8,0xb2d6d5a2
10213.6,1.0,1,2,2,4,8,0xb2d2b60c
302.1,1.0,18,1,2,2,5,0xb2d21333d
300000.0,2.0,13,3,3,3,9,0xb2da3fd1
61.34,1.0,281,1,2,1,4,0xb2d25884d
172151.33,4.0,0,3,4,4,11,0xb2d8fdfdd
260098.19,3.0,89,3,4,1,8,0xb2d2e772
200000.0,2.0,19,3,3,2,8,0xb2d9590ad
1525.25,1.0,238,1,2,1,4,0xb2d2e3b3d
173.95,1.0,25,1,2,2,5,0xb2d299d5
8049.14,1.0,0,2,2,4,8,0xb2d6acb7d
60067.62,2.0,55,3,3,2,8,0xb2d65272d
87.64,2.0,8,1,3,3,7,0xb2d3f70e
80004.92,2.0,92,3,3,1,7,0xb2d496ec
4490.17,1.0,0,2,2,4,8,0xb2d0bb87d
767669.12,3.0,39,4,4,2,10,0xb2d683b3d
600000.0,4.0,6,4,4,3,11,0xb2d685f2d
720.01,1.0,10,1,2,3,6,0xb2d48f3f
10106.12,2.0,4,2,3,4,9,0xb2d5d125
350000.0,4.0,3,4,4,4,12,0xb2d97354
12.88,1.0,11,1,2,3,6,0xb2d99527
2425.53,1.0,179,1,2,1,4,0xb2d3ae44
4000612.53,1.0,5,4,2,3,9,0xb2d88f5b
26717.63,2.0,1,2,3,4,9,0xb2d54fda
64873.48,1.0,3,3,2,4,9,0xb2d0e2a8d
7.29,1.0,43,1,2,2,5,0xb2d24d6cd
500042.84,17.0,0,4,4,4,12,0xb2d35ce1
1012.09,1.0,184,1,2,1,4,0xb2d4211c
1889.13,1.0,184,1,2,1,4,0xb2d29a25d
17000000.0,3.0,0,4,4,4,12,0xb2da6658
3548.1,1.0,32,2,2,2,6,0xb2d6895b
60702.43,2.0,6,3,3,3,9,0xb2d50940
0.36,1.0,3,1,2,4,7,0xb2d5f42dd
8199.91,1.0,184,2,2,1,5,0xb2d0659e
305441.38,2.0,196,4,3,1,8,0xb2d5347e
10182.2,1.0,92,2,2,1,5,0xb2d2f456
35010.23,2.0,40,2,3,2,7,0xb2d54a9bd
15502.0,1.0,2,2,2,4,8,0xb2d2eb94
2647.07,1.0,92,1,2,1,4,0xb2d1a5b9d
131267.34,2.0,18,3,3,2,8,0xb2d42787d
5124002.22,21.0,0,4,4,4,12,0xb2d09368
40000.0,3.0,67,2,4,1,7,0xb2d65511
467977.91,1.0,19,4,2,2,8,0xb2d49453
200061.46,2.0,23,3,3,2,8,0xb2d87e05
10655.28,1.0,27,2,2,2,6,0xb2d1f256
2084159.4,2.0,4,4,3,4,11,0xb2d57988
124701.12,7.0,83,3,4,1,8,0xb2d2e7bfd
230004.01,3.0,56,3,4,2,9,0xb2d9c116
96.19,1.0,17,1,2,2,5,0xb2d9dbce
204004.22,7.0,25,3,4,2,9,0x3b9af6b9
407821.4,3.0,91,4,4,1,9,0xb2d6fb53
370085.09,4.0,0,4,4,4,12,0xb2d6e376
6644.89,1.0,10,2,2,3,7,0xb2d69841
602155.1,3.0,50,4,4,2,10,0xb2d18b7c
2655.38,1.0,92,1,2,1,4,0xb2d290c0d
130341.73,4.0,102,3,4,1,8,0xb2d7801ed
56034.66,2.0,153,3,3,1,7,0xb2d4d0acd
260736.88,2.0,4,3,3,4,10,0xb2d62dd9
2001776.05,6.0,15,4,4,3,11,0xb2d9f965
177065.78,4.0,46,3,4,2,9,0xb2d49f6fd
150031.05,2.0,0,3,3,4,10,0xb2d967f3
2593.84,1.0,198,1,2,1,4,0xb2d2f06fd
97617.22,3.0,0,3,4,4,11,0xb2d1ae92d
13.97,1.0,41,1,2,2,5,0xb2d3921d
5007333.54,10.0,92,4,4,1,9,0xb2d14fd7d
0.0,18.0,5,1,4,3,8,0xb2d18547
0.82,13.0,6,1,4,3,8,0xb2d06893
420217.72,3.0,21,4,4,2,10,0xb2d6939cd
591020.24,3.0,6,4,4,3,11,0xb2d4b9de
12162.58,1.0,92,2,2,1,5,0xb2d38886
2082.21,1.0,189,1,2,1,4,0xb2d0d118
48315.61,3.0,0,2,4,4,10,0xb2d59055
1159.95,1.0,184,1,2,1,4,0xb2d2918dd
300003.17,2.0,203,3,3,1,7,0xb2d78bd4
372628.83,2.0,61,4,3,2,9,0xb2d9c033
200050.92,2.0,5,3,3,3,9,0xb2d6813a
707872.28,2.0,99,4,3,1,8,0xb2d6268e
4686.26,1.0,1,2,2,4,8,0xb2d54fbcd
50006.31,2.0,182,2,3,1,6,0xb2d557aad
310174.24,4.0,4,4,4,4,12,0xb2d5f352
725719.13,5.0,4,4,4,4,12,0xb2d88af6d
150000.0,2.0,0,3,3,4,10,0xb2d980f9
116259.8,2.0,0,3,3,4,10,0xb2d26006
570003.35,10.0,0,4,4,4,12,0xb2d7891dd
455027.71,3.0,60,4,4,2,10,0xb2d511c0d
1.37,1.0,18,1,2,2,5,0xb2d95784d
6891.92,1.0,25,2,2,2,6,0xb2d97d03
310044.21,3.0,20,4,4,2,10,0xb2d9099cd
615734.44,2.0,76,4,3,1,8,0xb2d10269
400031.67,3.0,55,4,4,2,10,0xb2d91516d
68.66,1.0,90,1,2,1,4,0xb2d3300b
1501858.15,3.0,0,4,4,4,12,0xb2d6bcb9
756.03,1.0,14,1,2,3,6,0xb2d58b99
3530.59,1.0,77,2,2,1,5,0xb2d31932
60048.61,2.0,10,3,3,3,9,0xb2d4f17f
11.65,1.0,70,1,2,1,4,0xb2d56964d
10674.08,4.0,0,2,4,4,10,0xb2d0908ad
233310.5,3.0,10,3,4,3,10,0xb2d5f8ddd
5391345.36,9.0,70,4,4,1,9,0xb2d4090cd
14533.58,1.0,1,2,2,4,8,0xb2d32748d
20000.84,2.0,182,2,3,1,6,0xb2d8a65c
15050.24,1.0,1,2,2,4,8,0xb2d34362
120507.34,1.0,0,3,2,4,9,0xb2d307f0
1990.35,8.0,5,1,4,3,8,0x3b9b4337
5511.85,1.0,184,2,2,1,5,0xb2d20dd2
0.0,1.0,7,1,2,3,6,0xb2d19bcf
4444.63,1.0,10,2,2,3,7,0xb2d93003
4423.02,1.0,92,2,2,1,5,0x3b9b393a
1708022.24,7.0,6,4,4,3,11,0xb2d2b795
20180.82,2.0,6,2,3,3,8,0xb2d35c83d
2401.01,1.0,0,1,2,4,7,0xb2d6fee5d
450000.0,3.0,13,4,4,3,11,0xb2da1286
300051.81,4.0,60,3,4,2,9,0xb2d4003d
270011.42,2.0,92,3,3,1,7,0xb2d63ea4d
103799.85,6.0,6,3,4,3,10,0xb2d19f1d
536.83,2.0,7,1,3,3,7,0xb2d959fb
60001.2,2.0,35,3,3,2,8,0xb2d3bb73d
1000000.0,2.0,5,4,3,3,10,0xb2d5f3fd
51014.66,2.0,193,2,3,1,6,0xb2d1baee
502861.12,3.0,0,4,4,4,12,0xb2d8d9ab
202715.41,2.0,17,3,3,2,8,0xb2d91a3bd
5996.54,1.0,10,2,2,3,7,0xb2d94c00
478158.88,3.0,4,4,4,4,12,0xb2d556f3d
300002.68,4.0,61,3,4,2,9,0xb2d204e0
7379.06,1.0,0,2,2,4,8,0xb2d2123ed
18317.96,1.0,4,2,2,4,8,0xb2d3903d
383198.65,3.0,42,4,4,2,10,0xb2d949aa
152019.49,2.0,77,3,3,1,7,0xb2d3ba16d
32.47,1.0,44,1,2,2,5,0xb2d39edb
20066.88,2.0,6,2,3,3,8,0xb2d57fc5
401408.09,2.0,4,4,3,4,11,0xb2d90410d
1487.29,1.0,92,1,2,1,4,0xb2d20f40
61382.32,4.0,66,3,4,2,9,0xb2d55cfd
5298.83,1.0,67,2,2,1,5,0xb2d2a968d
60085.18,2.0,76,3,3,1,7,0xb2d687a1d
300228.45,4.0,92,4,4,1,9,0xb2d284afd
50005.36,2.0,200,2,3,1,6,0xb2d3f2c9
100071.52,1.0,68,3,2,1,6,0xb2d3aa9c
370018.05,2.0,18,4,3,2,9,0xb2d8d9a9d
1081986.15,8.0,0,4,4,4,12,0xb2d17a5b
147001.59,3.0,25,3,4,2,9,0xb2d25633
17197.44,1.0,1,2,2,4,8,0xb2d32720d
7.05,1.0,167,1,2,1,4,0xb2d5f412
130005.49,2.0,83,3,3,1,7,0xb2d8c5bed
50002.11,2.0,42,2,3,2,7,0xb2d9e457
76390.63,3.0,8,3,4,3,10,0xb2d68928
500135.77,2.0,27,4,3,2,9,0xb2d67e27d
1854.7,1.0,238,1,2,1,4,0xb2d2f2ded
44945.97,1.0,1,2,2,4,8,0xb2d2f060d
20090.64,2.0,35,2,3,2,7,0xb2d926d6d
546987.27,7.0,0,4,4,4,12,0xb2d06703d
16866.25,1.0,14,2,2,3,7,0xb2d40411
236438.39,1.0,20,3,2,2,7,0xb2d53b95
50821.21,2.0,122,2,3,1,6,0xb2d6484c
240016.45,3.0,39,3,4,2,9,0xb2d41013
170002.75,5.0,60,3,4,2,9,0xb2d5d0c3d
3020603.71,12.0,4,4,4,4,12,0xb2d20052d
0.0,1.0,4,1,2,4,7,0xb2d63217
1028.15,1.0,92,1,2,1,4,0xb2d3ebe1
60.12,1.0,112,1,2,1,4,0xb2d6ac6fd
90000.95,2.0,31,3,3,2,8,0xb2d93b92
3545.52,1.0,17,2,2,2,6,0xb2d27cc6
400020.16,2.0,10,4,3,3,10,0xb2d3c27a
21541.37,1.0,207,2,2,1,5,0xb2d4e8fdd
100003.17,2.0,92,3,3,1,7,0xb2d97c94d
63.33,1.0,60,1,2,2,5,0xb2d8fde8
3527.2,1.0,70,2,2,1,5,0xb2d452f3d
18174.26,1.0,10,2,2,3,7,0xb2d26556
50002.06,2.0,8,2,3,3,8,0xb2da24e7
300084.38,2.0,80,3,3,1,7,0xb2d6f9a9
20000.63,2.0,38,2,3,2,7,0xb2d926e4d
104037.87,2.0,154,3,3,1,7,0xb2d17027d
15234.7,1.0,98,2,2,1,5,0xb2d5e672d
139.01,2.0,10,1,3,3,7,0xb2d63292
44.63,1.0,38,1,2,2,5,0xb2d92f65
70479.97,1.0,92,3,2,1,6,0xb2d57fe2d
320956.79,4.0,21,4,4,2,10,0xb2d5038f
148344.88,1.0,10,3,2,3,8,0xb2d3b63b
115005.92,3.0,20,3,4,2,9,0xb2d6003a
405.33,3.0,92,1,4,1,6,0x3b9af519
502463.01,3.0,101,4,4,1,9,0xb2d2c360
204016.12,2.0,80,3,3,1,7,0xb2d2f519d
2586.1,1.0,11,1,2,3,6,0xb2d68a87d
7.16,1.0,42,1,2,2,5,0xb2d4ee0fd
157812.17,2.0,161,3,3,1,7,0xb2d59ccad
4.59,1.0,6,1,2,3,6,0xb2d2b765
2998.64,1.0,184,2,2,1,5,0xb2d2340b
526240.39,3.0,74,4,4,1,9,0xb2d25195d
1574451.11,1.0,4,4,2,4,10,0xb2d5ea9bd
18002.78,2.0,172,2,3,1,6,0xb2d60260
4953.28,9.0,0,2,4,4,10,0xb2d34087
3812356.44,4.0,59,4,4,2,10,0xb2d0c9c8
53134.26,2.0,9,3,3,3,9,0xb2d55013d
21939.65,1.0,21,2,2,2,6,0xb2d94fe4
870.9,1.0,9,1,2,3,6,0xb2d8cf40
307617.32,3.0,111,4,4,1,9,0xb2d630f7
331876.45,10.0,0,4,4,4,12,0xb2d210a5d
1444.01,1.0,184,1,2,1,4,0xb2d1ff10d
51.13,1.0,34,1,2,2,5,0xb2d9a84c
1602.32,1.0,133,1,2,1,4,0xb2d8c5cf
250057.42,2.0,165,3,3,1,7,0xb2d36953
7176.6,1.0,29,2,2,2,6,0xb2d91c8f
3848.17,1.0,215,2,2,1,5,0xb2d59f43d
490031.92,4.0,8,4,4,3,11,0xb2d606d4
1204.02,1.0,92,1,2,1,4,0xb2d27e50d
50000.53,2.0,13,2,3,3,8,0xb2d95d1e
130015.54,4.0,5,3,4,3,10,0xb2d0cb75d
68.72,1.0,0,1,2,4,7,0xb2d5661ed
23009.65,2.0,11,2,3,3,8,0xb2d58b22
3856.98,1.0,0,2,2,4,8,0xb2d570b3
2863134.76,11.0,0,4,4,4,12,0xb2d3e049
200000.0,2.0,0,3,3,4,10,0xb2da51cf
1714.55,1.0,6,1,2,3,6,0xb2d9a41c
55019.16,1.0,7,3,2,3,8,0xb2d8e2d3d
141.71,1.0,14,1,2,3,6,0xb2d35f59d
1069.51,1.0,92,1,2,1,4,0xb2d3be2bd
222103.75,1.0,2,3,2,4,9,0x3b9aef71
16748.05,1.0,11,2,2,3,7,0xb2d68a98
1001078.22,2.0,19,4,3,2,9,0xb2d518d0d
1128.43,1.0,10,1,2,3,6,0xb2d2520d
1.76,1.0,13,1,2,3,6,0xb2d62d7b
215044.52,3.0,75,3,4,1,8,0xb2d0fdefd
200035.24,3.0,38,3,4,2,9,0xb2d6b843d
257775.21,2.0,35,3,3,2,8,0x3b9b3e31
37.43,1.0,57,1,2,2,5,0xb2d5c676d
1240.49,1.0,184,1,2,1,4,0xb2d53596d
6365.49,1.0,46,2,2,2,6,0xb2d2ec4a
50000.0,2.0,6,2,3,3,8,0xb2d96f1bd
2693.23,1.0,10,1,2,3,6,0xb2d69452
100064.21,2.0,112,3,3,1,7,0xb2d24cd7d
190047.1,12.0,24,3,4,2,9,0xb2d229bc
70002.15,4.0,52,3,4,2,9,0xb2d6811d
1621.14,1.0,92,1,2,1,4,0xb2d36d31
100084.3,2.0,31,3,3,2,8,0xb2d25af6d
1804804.29,16.0,3,4,4,4,12,0xb2d14e1f
50568.49,2.0,72,2,3,1,6,0xb2d55f4ed
3741.61,1.0,4,2,2,4,8,0xb2d2926d
310009.3,2.0,22,4,3,2,9,0xb2d9854a
79.9,1.0,8,1,2,3,6,0xb2d8f7ab
50001.41,1.0,0,2,2,4,8,0xb2d24b09d
50001.06,2.0,200,2,3,1,6,0xb2d79214
3545.13,1.0,4,2,2,4,8,0xb2d1bdf9
1859.93,1.0,5,1,2,3,6,0xb2d68c37
63002.46,3.0,56,3,4,2,9,0xb2d9c345
211.62,1.0,6,1,2,3,6,0xb2d91808
40000.12,3.0,7,2,4,3,9,0xb2d6babdd
0.33,1.0,92,1,2,1,4,0xb2d68434d
605920.61,14.0,1,4,4,4,12,0xb2d28918d
2423.2,1.0,87,1,2,1,4,0xb2d3ae44d
0.01,1.0,12,1,2,3,6,0xb2d69865
3621078.18,9.0,4,4,4,4,12,0xb2d16ebed
60854.34,2.0,11,3,3,3,9,0xb2d0ce74d
1897.94,1.0,9,1,2,3,6,0xb2d908fe
2020170.49,4.0,12,4,4,3,11,0xb2d3cf7b
57070.4,3.0,18,3,4,2,9,0xb2d6c90cd
325039.78,2.0,224,4,3,1,8,0xb2d69522d
534831.65,2.0,105,4,3,1,8,0xb2d2bdad
1800041.64,6.0,76,4,4,1,9,0xb2d12d12
1507.67,1.0,24,1,2,2,5,0xb2d2dcf5d
383878.13,4.0,5,4,4,3,11,0xb2d0a51d
50002.11,2.0,14,2,3,3,8,0xb2da3589
333063.49,3.0,18,4,4,2,10,0xb2d5ccbcd
1525048.41,2.0,256,4,3,1,8,0xb2d5d2b6d
105001.37,5.0,38,3,4,2,9,0xb2d63f77d
2467.4,1.0,9,1,2,3,6,0xb2d332a0
202432.88,2.0,45,3,3,2,8,0xb2d6db13
4691.86,1.0,92,2,2,1,5,0xb2d33327
501.94,1.0,19,1,2,2,5,0xb2d5b6d9
10508.61,1.0,0,2,2,4,8,0xb2d5d590
2910.07,4.0,1,2,4,4,10,0xb2d9323ed
15473.08,1.0,4,2,2,4,8,0xb2d9c9ac
61.75,1.0,41,1,2,2,5,0xb2d0a618d
20441.07,2.0,0,2,3,4,9,0xb2d548d9d
591508.76,1.0,6,4,2,3,9,0xb2d5a712
1988999.77,6.0,0,4,4,4,12,0xb2d255aed
5184.37,1.0,0,2,2,4,8,0xb2d20827
1100015.35,10.0,0,4,4,4,12,0xb2d97f7e
2732.97,1.0,3,1,2,4,7,0xb2d206bad
1139.96,1.0,4,1,2,4,7,0xb2d54bd5d
156.38,1.0,5,1,2,3,6,0xb2d3108e
679996.34,3.0,1,4,4,4,12,0xb2d6b340
814313.51,5.0,8,4,4,3,11,0xb2d170ff
1498.42,1.0,6,1,2,3,6,0xb2d68072
6360.52,1.0,0,2,2,4,8,0xb2d5c8add
211266.78,2.0,95,3,3,1,7,0xb2d1baf2d
2202.08,1.0,10,1,2,3,6,0xb2d28acdd
146003.08,2.0,80,3,3,1,7,0xb2d98c9e
100013.3,2.0,59,3,3,2,8,0xb2d6a2d4d
564937.27,3.0,208,4,4,1,9,0xb2d23bdf
285.94,1.0,25,1,2,2,5,0xb2d6b7b7d
187419.96,1.0,1,3,2,4,9,0xb2d6df08d
390444.88,5.0,77,4,4,1,9,0xb2d31e2fd
1008255.44,6.0,40,4,4,2,10,0xb2d1fe60d
271.62,1.0,0,1,2,4,7,0xb2d5fd4ed
189.15,1.0,2,1,2,4,7,0xb2d35822d
100001.06,3.0,18,3,4,2,9,0xb2d949c8
100719.24,2.0,25,3,3,2,8,0xb2d96857d
50074.96,2.0,147,2,3,1,6,0xb2d65a72
110045.9,2.0,38,3,3,2,8,0xb2d3d818d
309008.97,6.0,0,4,4,4,12,0xb2d0d849d
744.28,1.0,0,1,2,4,7,0xb2d511a9
305771.68,2.0,53,4,3,2,9,0xb2d5d0afd
811879.43,3.0,105,4,4,1,9,0xb2d3bf3b
759.28,1.0,0,1,2,4,7,0xb2d1fc3dd
20910.51,1.0,184,2,2,1,5,0xb2d0f85dd
14.7,1.0,0,1,2,4,7,0xb2d28227
176087.4,4.0,12,3,4,3,10,0xb2d191a6d
102.45,1.0,63,1,2,2,5,0xb2d627b2
320559.37,10.0,56,4,4,2,10,0xb2d16b4bd
20001.17,2.0,80,2,3,1,6,0xb2d8cc2f
207415.99,4.0,20,3,4,2,9,0xb2d3ecd8
164712.43,4.0,21,3,4,2,9,0xb2d596dfd
895.89,1.0,1,1,2,4,7,0xb2d2b9c2
1572.89,1.0,0,1,2,4,7,0xb2d867d0d
50483.05,2.0,24,2,3,2,7,0xb2d5c1bd
230000.0,2.0,20,3,3,2,8,0xb2da29d6
407109.01,2.0,39,4,3,2,9,0xb2d202a9d
288116.23,2.0,10,3,3,3,9,0xb2d5ee8f
34112.3,1.0,4,2,2,4,8,0xb2d356b4d
60.5,1.0,10,1,2,3,6,0xb2d97b52
179292.75,6.0,0,3,4,4,11,0xb2d0675b
350481.93,4.0,4,4,4,4,12,0xb2d26533
7097.14,1.0,92,2,2,1,5,0xb2d2888ad
100026.92,2.0,101,3,3,1,7,0xb2d500cfd
6733.86,1.0,10,2,2,3,7,0xb2d95b32d
413475.49,4.0,179,4,4,1,9,0x3b9b38c0
2693927.47,5.0,0,4,4,4,12,0xb2d23096d
414.94,1.0,2,1,2,4,7,0xb2d68126
59933.29,1.0,25,3,2,2,7,0xb2d62664d
11618.59,1.0,4,2,2,4,8,0xb2d31777d
106.26,1.0,67,1,2,1,4,0xb2d6c88d
23342.38,1.0,0,2,2,4,8,0xb2d6472ed
1040054.89,1.0,14,4,2,3,9,0xb2d95d23d
874000.33,4.0,3,4,4,4,12,0xb2d633c9
70001.79,3.0,27,3,4,2,9,0xb2d8f3c6d
4852.37,1.0,14,2,2,3,7,0xb2d1a75bd
52141.88,1.0,189,2,2,1,5,0xb2d29743d
655100.11,3.0,130,4,4,1,9,0xb2d20a5ad
109.83,1.0,76,1,2,1,4,0xb2d63dd3
2026847.2,2.0,26,4,3,2,9,0xb2d5b0f3
593077.75,6.0,4,4,4,4,12,0xb2d0d1a7
742.28,1.0,16,1,2,2,5,0xb2d5d5ac
144451.33,3.0,8,3,4,3,10,0xb2d4548dd
100775.28,1.0,4,3,2,4,9,0xb2d9a12e
234716.82,3.0,18,3,4,2,9,0xb2d2e35bd
57026.73,1.0,0,3,2,4,9,0xb2d5abef
813899.26,15.0,0,4,4,4,12,0x3b9b291cd
304540.4,2.0,54,4,3,2,9,0xb2d43641d
12947.72,3.0,0,2,4,4,10,0x3b9af1edd
24281.24,1.0,103,2,2,1,5,0xb2d6f727d
934000.91,7.0,6,4,4,3,11,0xb2d07e3e
15.21,1.0,67,1,2,1,4,0xb2d8dfdfd
1495987.35,7.0,27,4,4,2,10,0xb2d6cce5
702632.44,5.0,32,4,4,2,10,0xb2da01d8
95.41,1.0,24,1,2,2,5,0xb2d91edf
98.74,1.0,9,1,2,3,6,0xb2d9d2da
55116.05,1.0,15,3,2,3,8,0xb2d69b16
5877.42,1.0,92,2,2,1,5,0xb2d26f44
304268.13,3.0,10,4,4,3,11,0xb2d6a18dd
55409.29,3.0,80,3,4,1,8,0xb2d12ea4
388099.07,7.0,3,4,4,4,12,0xb2d5c5ab
152093.78,3.0,196,3,4,1,8,0xb2d3884ad
3118.63,8.0,92,2,4,1,7,0x3b9ad208
3.69,1.0,11,1,2,3,6,0xb2da4808
628.98,1.0,93,1,2,1,4,0xb2d29519d
11314.34,1.0,92,2,2,1,5,0xb2d2835ed
13159.61,1.0,5,2,2,3,7,0xb2d56a58
50002.99,2.0,27,2,3,2,7,0xb2d9f244
1144.2,1.0,17,1,2,2,5,0xb2d2e146d
200000.0,2.0,6,3,3,3,9,0xb2da5b4f
752.9,1.0,4,1,2,4,7,0xb2d2aca6
1000000.0,10.0,1,4,4,4,12,0xb2d4f898
15781.1,1.0,1,2,2,4,8,0xb2d6cf8b
182672.87,2.0,0,3,3,4,10,0xb2d336f1d
8494.64,1.0,2,2,2,4,8,0xb2d68315
3670.71,1.0,9,2,2,3,7,0xb2d6b0b4d
50293.74,2.0,20,2,3,2,7,0xb2d12063d
1010901.22,7.0,0,4,4,4,12,0xb2d55c8fd
2780046.25,3.0,76,4,4,1,9,0xb2d75a4d
100002.11,2.0,102,3,3,1,7,0xb2d963a0d
2962.83,1.0,0,2,2,4,8,0xb2d96777
5052.77,3.0,92,2,4,1,7,0xb2d27250d
50007.5,2.0,7,2,3,3,8,0xb2d28da3
70135.61,2.0,108,3,3,1,7,0xb2d58f5d
122001.53,4.0,102,3,4,1,8,0xb2d3f378d
43108.76,3.0,1,2,4,4,10,0xb2d62f9ed
6167.61,4.0,5,2,4,3,9,0xb2d07e05
729949.02,2.0,5,4,3,3,10,0xb2d2d90e
100004.22,2.0,41,3,3,2,8,0xb2d91fedd
2061457.02,4.0,5,4,4,3,11,0xb2d0c1bf
500002.08,2.0,1,4,3,4,11,0xb2d9ad96
100014.44,2.0,125,3,3,1,7,0xb2d146d0d
2515563.5,12.0,0,4,4,4,12,0xb2d09759
31965.91,2.0,52,2,3,2,7,0x3b9b3a61d
50005.06,3.0,6,2,4,3,9,0xb2da2f88
382.91,1.0,0,1,2,4,7,0xb2d9454c
2418.97,2.0,21,1,3,2,6,0xb2d0723bd
700786.67,5.0,24,4,4,2,10,0xb2d6e17d
843603.06,10.0,27,4,4,2,10,0xb2d5a207
30000.0,2.0,6,2,3,3,8,0xb2da5029
470254.78,9.0,9,4,4,3,11,0xb2d3c66e
500005.29,2.0,144,4,3,1,8,0xb2d5ba39d
213080.46,2.0,0,3,3,4,10,0xb2d1b1b8
3018233.19,1.0,184,4,2,1,7,0xb2d29a47d
655109.59,3.0,60,4,4,2,10,0xb2d31ccb
33536.12,1.0,22,2,2,2,6,0xb2d0ce8cd
638.54,1.0,1,1,2,4,7,0xb2d66689d
89.41,1.0,19,1,2,2,5,0xb2d90f83
195183.94,1.0,184,3,2,1,6,0x3b9b268cd
1700000.96,4.0,3,4,4,4,12,0xb2d6042d
90002.24,3.0,1,3,4,4,11,0xb2d2a09b
3400201.27,5.0,26,4,4,2,10,0xb2d3cf7bd
220225.36,2.0,4,3,3,4,10,0xb2d59db5
17505.9,2.0,9,2,3,3,8,0xb2d2d0f2d
1294.28,1.0,84,1,2,1,4,0xb2d5a5e9
110045.99,12.0,18,3,4,2,9,0xb2d62b0cd
239.41,1.0,8,1,2,3,6,0xb2d1fdef
1908.65,2.0,92,1,3,1,5,0x3b9b0f37
3651543.36,13.0,5,4,4,3,11,0xb2d26e65d
1804.3,1.0,27,1,2,2,5,0xb2d2a80cd
8024.47,1.0,0,2,2,4,8,0xb2d3ab53
73.03,1.0,88,1,2,1,4,0xb2d3f5a9d
8113.13,11.0,0,2,4,4,10,0x3b9af0c7
3898.94,1.0,1,2,2,4,8,0xb2d700a2
50024.43,2.0,69,2,3,1,6,0xb2d6575e
60088.94,3.0,144,3,4,1,8,0xb2d0da1c
201421.22,2.0,81,3,3,1,7,0xb2d8d74a
1373.75,1.0,2,1,2,4,7,0xb2d368bc
200000.0,2.0,9,3,3,3,9,0xb2d5fb66d
7205.4,1.0,2,2,2,4,8,0xb2d44201d
460009.71,2.0,18,4,3,2,9,0xb2da2a7b
72099.76,2.0,60,3,3,2,8,0xb2d39e0ed
71896.92,3.0,19,3,4,2,9,0xb2d5fb8ad
156729.13,2.0,80,3,3,1,7,0xb2d39bf0d
6458.49,1.0,92,2,2,1,5,0xb2d2a57d
3424.0,1.0,203,2,2,1,5,0xb2d5c57ed
230000.83,8.0,62,3,4,2,9,0xb2d56afdd
160141.73,7.0,3,3,4,4,11,0xb2d64dd2
345.47,1.0,20,1,2,2,5,0xb2d4b3dc
191874.7,5.0,11,3,4,3,10,0xb2d46f29
60373.71,1.0,184,3,2,1,6,0xb2d2db84d
200013.23,2.0,4,3,3,4,10,0xb2d5dc2bd
500818.74,2.0,92,4,3,1,8,0xb2d193c7
499.54,1.0,1,1,2,4,7,0xb2d645e9
182.56,1.0,0,1,2,4,7,0xb2d76868
1047.41,1.0,184,1,2,1,4,0xb2d5c030
1100009.71,6.0,18,4,4,2,10,0xb2d1a8c1
28.59,1.0,15,1,2,3,6,0xb2d58c63
6542.01,1.0,0,2,2,4,8,0xb2d6a1cad
283.87,1.0,11,1,2,3,6,0xb2d6bea7
56557.19,1.0,0,3,2,4,9,0xb2d3bf94
347.61,1.0,69,1,2,1,4,0xb2d2c73cd
955702.52,4.0,0,4,4,4,12,0xb2d5bcc1
41856.41,1.0,184,2,2,1,5,0xb2d22042d
39.2,1.0,2,1,2,4,7,0xb2d2f487
1.74,1.0,20,1,2,2,5,0xb2d2e0e6d
101474.21,2.0,0,3,3,4,10,0xb2d319c9
1883775.63,1.0,4,4,2,4,10,0xb2d56e7d
6327.73,1.0,21,2,2,2,6,0xb2d2c790
100988.09,4.0,25,3,4,2,9,0xb2d5b9cfd
73913.72,1.0,92,3,2,1,6,0xb2d20760d
275050.69,4.0,7,3,4,3,10,0xb2d235b4d
31.1,2.0,58,1,3,2,6,0xb2d69a26d
500052.12,3.0,8,4,4,3,11,0xb2d9ac4c
5178.9,1.0,0,2,2,4,8,0xb2d2c180
142390.1,3.0,1,3,4,4,11,0xb2d950ad
901862.53,6.0,19,4,4,2,10,0xb2d297e2d
55.36,1.0,59,1,2,2,5,0xb2d401c3
191.89,1.0,61,1,2,2,5,0xb2d9a02a
400731.51,3.0,7,4,4,3,11,0xb2d9b7d5
37427.44,1.0,0,2,2,4,8,0xb2d991e0
28897.75,1.0,20,2,2,2,6,0xb2d90480
880301.37,3.0,0,4,4,4,12,0xb2d512c4
2271.32,1.0,32,1,2,2,5,0xb2d398f4d
57385.2,1.0,21,3,2,2,7,0xb2d27dc1
150132.6,4.0,46,3,4,2,9,0xb2d614c0d
240000.42,4.0,18,3,4,2,9,0xb2d94dddd
265311.8,3.0,118,3,4,1,8,0xb2d107e0
1213550.16,3.0,69,4,4,1,9,0x3b9b443ed
7.58,1.0,0,1,2,4,7,0xb2d8f9c3
2214865.68,2.0,125,4,3,1,8,0xb2d3847ad
1305327.15,4.0,20,4,4,2,10,0xb2d36037
431.18,1.0,13,1,2,3,6,0xb2d5f929
116000.0,2.0,8,3,3,3,9,0xb2d50e9cd
70.72,1.0,71,1,2,1,4,0xb2d9679a
735090.28,5.0,7,4,4,3,11,0xb2d5eb52d
10000.42,2.0,38,2,3,2,7,0xb2d92495
682806.78,5.0,0,4,4,4,12,0xb2d54e3f
1874.03,1.0,164,1,2,1,4,0xb2d2f08bd
96.57,1.0,9,1,2,3,6,0xb2d8e4ecd
158003.18,3.0,0,3,4,4,11,0xb2d0b65e
260005.5,3.0,181,3,4,1,8,0xb2d649a3
12019.51,1.0,24,2,2,2,6,0xb2d27ced
1.0,3.0,81,1,4,1,6,0xb2d1f7ec
40025.7,9.0,1,2,4,4,10,0xb2d0dfcd
511000.0,8.0,0,4,4,4,12,0xb2d938b7d
253554.7,3.0,33,3,4,2,9,0xb2d6dee2d
136441.8,3.0,6,3,4,3,10,0xb2d2437dd
6960.14,1.0,9,2,2,3,7,0xb2d399ead
761764.93,13.0,4,4,4,4,12,0xb2d17691
10830314.54,8.0,8,4,4,3,11,0xb2d8cdeb
10000.58,2.0,13,2,3,3,8,0xb2da339a
152121.69,2.0,20,3,3,2,8,0xb2d45199
2565137.62,3.0,48,4,4,2,10,0xb2d4383e
158135.57,13.0,0,3,4,4,11,0xb2d55cc2
6.49,1.0,3,1,2,4,7,0xb2d5d9d3d
1927.82,1.0,12,1,2,3,6,0xb2d9a4c2
300003.17,2.0,196,3,3,1,7,0xb2d7ec49
2013.11,1.0,0,1,2,4,7,0xb2d2e14c
7154.38,1.0,14,2,2,3,7,0xb2d919c4d
100004.22,2.0,90,3,3,1,7,0xb2d8a0bc
2000048.5,11.0,1,4,4,4,12,0xb2d826b6
1015.44,1.0,184,1,2,1,4,0xb2d14eb6d
2860.58,1.0,16,1,2,2,5,0xb2d8f6e5d
226731.85,3.0,26,3,4,2,9,0xb2d8b20ad
93.65,1.0,5,1,2,3,6,0xb2d4b8c4
100900.78,2.0,129,3,3,1,7,0xb2d5ec27
176.22,1.0,18,1,2,2,5,0xb2d0e1e6
151827.53,3.0,20,3,4,2,9,0xb2d0cdb0
2662.89,1.0,12,1,2,3,6,0xb2d2b753
118.65,1.0,2,1,2,4,7,0xb2d6c2d0
313205.61,2.0,11,4,3,3,10,0xb2d1b3edd
80006.09,3.0,101,3,4,1,8,0xb2d440ffd
150047.52,3.0,13,3,4,3,10,0xb2d15097d
3619.55,1.0,30,2,2,2,6,0xb2d36a88
3751.8,1.0,129,2,2,1,5,0xb2d48b95
100013.72,2.0,0,3,3,4,10,0xb2d4fc38
13428287.44,6.0,0,4,4,4,12,0x3b9af3fc
501779.38,3.0,48,4,4,2,10,0xb2d9dc71
51177.63,3.0,0,2,4,4,10,0xb2d212e1
1093.86,2.0,175,1,3,1,5,0xb2d2ecad
10070.92,1.0,2,2,2,4,8,0xb2d49056d
204751.83,2.0,167,3,3,1,7,0xb2d656bad
13.82,1.0,64,1,2,2,5,0xb2d9a3a9
122000.0,3.0,4,3,4,4,11,0xb2d2de9cd
794.34,1.0,231,1,2,1,4,0xb2d53529d
138133.7,1.0,0,3,2,4,9,0xb2d40f9f
41155.14,4.0,0,2,4,4,10,0x3b9b456ed
528270.28,4.0,4,4,4,4,12,0xb2d95b54d
910065.34,7.0,7,4,4,3,11,0xb2d5e133
1.57,1.0,6,1,2,3,6,0xb2d59b9dd
13.45,1.0,23,1,2,2,5,0xb2d9258a
1405.78,1.0,12,1,2,3,6,0xb2d48c66
134.49,1.0,14,1,2,3,6,0xb2d27bedd
0.0,1.0,69,1,2,1,4,0xb2d3a36b
206731.88,2.0,59,3,3,2,8,0xb2d9c551
3700.27,1.0,0,2,2,4,8,0xb2d8d05cd
311055.34,3.0,10,4,4,3,11,0xb2d2afd1
300000.0,3.0,1,3,4,4,11,0xb2d64c0e
34331.83,1.0,71,2,2,1,5,0xb2d157f8
711847.59,5.0,0,4,4,4,12,0xb2d959e8d
20.78,1.0,5,1,2,3,6,0xb2d17320
844.44,1.0,27,1,2,2,5,0xb2da08d0
9994.8,1.0,13,2,2,3,7,0xb2d153b4
77.12,1.0,32,1,2,2,5,0xb2d6a736
702186.56,3.0,18,4,4,2,10,0xb2d57cc0
84.26,1.0,48,1,2,2,5,0xb2d9a708
417.61,1.0,9,1,2,3,6,0xb2d38a36
213137.2,1.0,3,3,2,4,9,0xb2d42bafd
444.1,1.0,32,1,2,2,5,0xb2d97b4a
1058.15,2.0,144,1,3,1,5,0x3b9b4a27
10726.59,1.0,13,2,2,3,7,0xb2d48c5b
5225.61,1.0,7,2,2,3,7,0xb2d6add3d
39819.61,1.0,28,2,2,2,6,0xb2d5cc74d
5604.76,1.0,0,2,2,4,8,0xb2d4a91dd
429356.64,6.0,47,4,4,2,10,0xb2d5fdfa
14271.61,1.0,184,2,2,1,5,0xb2d25421d
42764.07,1.0,2,2,2,4,8,0xb2d700a1d
1070261.62,8.0,161,4,4,1,9,0xb2d50136
6345.74,1.0,1,2,2,4,8,0xb2d43bb2d
20321.3,1.0,4,2,2,4,8,0xb2d580b1d
497.44,1.0,10,1,2,3,6,0xb2d310efd
8216.86,1.0,184,2,2,1,5,0xb2d2eaadd
80612.89,1.0,1,3,2,4,9,0xb2d1deb9
333630.25,4.0,0,4,4,4,12,0xb2d219b7
807.66,1.0,139,1,2,1,4,0xb2d23044d
50099.58,2.0,54,2,3,2,7,0xb2d8cb84
20001.15,2.0,217,2,3,1,6,0xb2d1b52c
200882.62,2.0,49,3,3,2,8,0xb2d6c2ef
10710.0,1.0,3,2,2,4,8,0xb2d3681c
60101.28,2.0,18,3,3,2,8,0xb2d95093
7226.64,1.0,3,2,2,4,8,0xb2d6db48
212740.55,2.0,24,3,3,2,8,0xb2d14ab3d
2.69,1.0,5,1,2,3,6,0xb2d69d54
3469.89,1.0,4,2,2,4,8,0xb2d96c53
93.76,1.0,67,1,2,1,4,0xb2d8f1e9d
208505.45,2.0,6,3,3,3,9,0xb2d4d93a
242645.61,2.0,0,3,3,4,10,0xb2d5b039d
165089.21,4.0,0,3,4,4,11,0xb2d5851dd
20473.43,2.0,101,2,3,1,6,0xb2d6053b
237743.67,2.0,143,3,3,1,7,0xb2d532ddd
200000.86,2.0,1,3,3,4,10,0xb2d6502d
1.27,1.0,17,1,2,2,5,0xb2d53517
1822.24,1.0,34,1,2,2,5,0xb2d1e79e
110005.7,2.0,38,3,3,2,8,0xb2d908f5d
41.22,1.0,15,1,2,3,6,0xb2d1cbd1d
20099.07,2.0,92,2,3,1,6,0xb2d5f629
3043.71,1.0,11,2,2,3,7,0xb2d6a7d5
10206.13,2.0,92,2,3,1,6,0xb2d5e178d
100001.06,2.0,80,3,3,1,7,0xb2d99187
5051.76,1.0,184,2,2,1,5,0xb2d2c3c2d
569875.58,6.0,6,4,4,3,11,0xb2d42202d
15000889.53,3.0,66,4,4,2,10,0xb2d10f15d
49.3,1.0,20,1,2,2,5,0xb2d609d2
3532.93,1.0,92,2,2,1,5,0xb2d184d5d
4347.4,1.0,92,2,2,1,5,0xb2d1fe90
777006.28,5.0,27,4,4,2,10,0xb2d2f87bd
12.74,1.0,60,1,2,2,5,0xb2d50b85
457629.28,7.0,12,4,4,3,11,0xb2d1d6d4d
35226.1,2.0,0,2,3,4,9,0xb2d60e30
47381.77,4.0,0,2,4,4,10,0xb2d6846c
10035.0,1.0,92,2,2,1,5,0xb2d5c490d
10033.78,2.0,12,2,3,3,8,0xb2d2cc43
1836652.14,1.0,4,4,2,4,10,0xb2d9c069
68888.87,1.0,10,3,2,3,8,0xb2d34393
114.34,1.0,24,1,2,2,5,0xb2d373b2
125355.58,3.0,126,3,4,1,8,0xb2d2a460
240009.74,4.0,53,3,4,2,9,0xb2d8f75c
1364396.56,5.0,18,4,4,2,10,0xb2d0eecb
100405.91,3.0,18,3,4,2,9,0xb2d60c9fd
138.25,1.0,29,1,2,2,5,0xb2da031f
793935.75,6.0,74,4,4,1,9,0xb2d08145d
263887.02,4.0,7,3,4,3,10,0xb2d13979
3451097.96,6.0,21,4,4,2,10,0xb2d780c5
1330879.45,10.0,4,4,4,4,12,0xb2d53c57d
2056.87,1.0,3,1,2,4,7,0xb2d342fdd
0.0,1.0,68,1,2,1,4,0xb2d60e4f
10594.87,1.0,14,2,2,3,7,0xb2d3a607
212774.99,4.0,0,3,4,4,11,0xb2d568b4
316035.41,2.0,17,4,3,2,9,0xb2d5d71ed
138111.5,5.0,74,3,4,1,8,0xb2d23f9f
580216.82,2.0,0,4,3,4,11,0xb2d3c022
35733.97,2.0,41,2,3,2,7,0xb2d0900a
6987.9,4.0,184,2,4,1,7,0xb2d0c701
3.06,1.0,9,1,2,3,6,0xb2d6d14e
752564.74,7.0,10,4,4,3,11,0xb2d44d6a
120008.87,2.0,90,3,3,1,7,0xb2d8337f
97250.74,4.0,5,3,4,3,10,0xb2d6a2e7
434017.17,5.0,6,4,4,3,11,0xb2d4390fd
1708.4,1.0,1,1,2,4,7,0xb2d90775
15042.6,1.0,0,2,2,4,8,0xb2d38fb6d
49.78,1.0,4,1,2,4,7,0xb2d8e674
3509.1,1.0,256,2,2,1,5,0xb2d39f76d
450.62,1.0,24,1,2,2,5,0xb2d69eba
6110.72,1.0,0,2,2,4,8,0xb2d6be73d
10.41,1.0,89,1,2,1,4,0xb2d395ad
92276.16,5.0,0,3,4,4,11,0xb2d2b1a1
5.98,1.0,80,1,2,1,4,0xb2d613d3
650753.81,4.0,6,4,4,3,11,0xb2d65324
639.51,1.0,12,1,2,3,6,0xb2d3ef96d
508000.0,8.0,0,4,4,4,12,0xb2d216a4d
910000.0,9.0,3,4,4,4,12,0xb2d2e076d
10001.9,1.0,27,2,2,2,6,0xb2d93cb3d
8.96,1.0,62,1,2,2,5,0xb2d5e45c
730000.0,6.0,0,4,4,4,12,0xb2d087b6d
1210129.41,3.0,18,4,4,2,10,0xb2d5a06e
34419.37,2.0,3,2,3,4,9,0xb2d5a22c
11201.97,1.0,8,2,2,3,7,0xb2d60a96
182539.16,4.0,1,3,4,4,11,0xb2d587ff
1440.9,1.0,184,1,2,1,4,0xb2d1b751d
5510.69,1.0,29,2,2,2,6,0xb2d92986
5888.16,1.0,92,2,2,1,5,0xb2d08d9dd
241915.11,3.0,27,3,4,2,9,0xb2d9cf54
14597.55,1.0,3,2,2,4,8,0xb2d99de9
1400.53,1.0,184,1,2,1,4,0xb2d269c2
4475.86,1.0,10,2,2,3,7,0xb2d9ab28
500000.0,2.0,11,4,3,3,10,0xb2da4bc6
19636.81,1.0,4,2,2,4,8,0xb2d927b8
200000.85,2.0,9,3,3,3,9,0xb2d26df8d
10000.11,1.0,10,2,2,3,7,0xb2d96c91d
430072.36,4.0,27,4,4,2,10,0xb2d4493bd
360035.77,4.0,39,4,4,2,10,0xb2d5f392d
3735.74,1.0,1,2,2,4,8,0xb2d559e9
408001.8,8.0,74,4,4,1,9,0xb2d11038d
183.97,1.0,2,1,2,4,7,0xb2d75665d
2250015.91,15.0,83,4,4,1,9,0xb2d168d9d
58623.77,1.0,0,3,2,4,9,0xb2d0d759
995017.59,10.0,6,4,4,3,11,0xb2d28ee2d
146627.13,2.0,110,3,3,1,7,0xb2d3db41d
5040.21,1.0,184,2,2,1,5,0xb2d3a4c9d
2153399.88,6.0,0,4,4,4,12,0xb2d6898e
93.2,1.0,77,1,2,1,4,0xb2d62841
250000.0,2.0,7,3,3,3,9,0xb2d970b2d
2108086.17,7.0,8,4,4,3,11,0xb2d62533
2352.58,3.0,92,1,4,1,6,0xb2d062ed
366705.67,2.0,60,4,3,2,9,0xb2d5abd3d
2247609.76,12.0,0,4,4,4,12,0xb2d117c6
1448.85,1.0,0,1,2,4,7,0xb2d3ab58
212019.27,2.0,167,3,3,1,7,0xb2d503fd
50002.11,2.0,34,2,3,2,7,0xb2d93035
75400.21,3.0,77,3,4,1,8,0xb2d179bf
457.17,1.0,7,1,2,3,6,0xb2d2c747d
790879.28,2.0,83,4,3,1,8,0xb2d2ef5b
1177.54,1.0,3,1,2,4,7,0xb2d1dacd
226.79,1.0,2,1,2,4,7,0xb2d60c59
35392.65,1.0,9,2,2,3,7,0xb2d69059
600000.0,2.0,5,4,3,3,10,0xb2da5e0d
420782.21,3.0,25,4,4,2,10,0xb2d6c39c
130308.98,4.0,137,3,4,1,8,0xb2d6fc70
1167.38,1.0,218,1,2,1,4,0xb2d650fdd
2350122.31,8.0,87,4,4,1,9,0xb2d0a9e4
67.18,1.0,17,1,2,2,5,0xb2d4d0d6
105481.95,6.0,31,3,4,2,9,0xb2d5fc21d
418392.47,10.0,6,4,4,3,11,0xb2d41031
14777.25,1.0,92,2,2,1,5,0xb2d2c9b1d
1900411.13,8.0,48,4,4,2,10,0xb2d57a71d
1461.31,1.0,106,1,2,1,4,0xb2d14e9dd
5154.8,1.0,10,2,2,3,7,0xb2d8e787d
1280049.34,3.0,58,4,4,2,10,0xb2d25068
51274.8,1.0,98,2,2,1,5,0xb2d62e8ed
55003.36,1.0,0,3,2,4,9,0xb2d64780
78159.14,2.0,9,3,3,3,9,0xb2d28af3d
4450806.7,16.0,11,4,4,3,11,0x3b9b35a2
70090.66,2.0,67,3,3,1,7,0xb2d1c10d
70.16,1.0,10,1,2,3,6,0xb2d479e0d
7.61,1.0,173,1,2,1,4,0xb2d8d105d
80000.0,2.0,4,3,3,4,10,0xb2da3084
209921.38,4.0,126,3,4,1,8,0x3b9b4768
257.19,1.0,9,1,2,3,6,0xb2d4b51f
44272.86,1.0,15,2,2,3,7,0xb2d0d3b7d
212.94,1.0,9,1,2,3,6,0xb2d4eb51
50006.33,1.0,21,2,2,2,6,0xb2d9424f
3469.71,1.0,14,2,2,3,7,0xb2d65042
12009.12,1.0,82,2,2,1,5,0xb2d98cf1
204054.86,2.0,143,3,3,1,7,0xb2d6dfcf
50169.33,2.0,125,2,3,1,6,0xb2d5824b
197943.22,3.0,3,3,4,4,11,0xb2d6260ad
20278.25,2.0,15,2,3,3,8,0xb2d5a442d
1578.08,1.0,6,1,2,3,6,0xb2d606f5
211.55,1.0,1,1,2,4,7,0xb2d5293bd
6844.16,1.0,9,2,2,3,7,0xb2d3fa1a
193240.46,2.0,9,3,3,3,9,0xb2d3d9eb
40055.57,3.0,192,2,4,1,7,0xb2d211a6d
19872.15,1.0,3,2,2,4,8,0xb2d6d2a1d
521065.63,19.0,1,4,4,4,12,0xb2d0d1b8
76.9,2.0,2,1,3,4,8,0xb2d6e9fb
205914.23,2.0,7,3,3,3,9,0xb2d623ccd
1520000.0,8.0,2,4,4,4,12,0xb2d60cd5
1740.14,1.0,92,1,2,1,4,0xb2d27768d
10340.43,1.0,184,2,2,1,5,0xb2d1fb21
15262.01,1.0,69,2,2,1,5,0xb2d4902e
2822.3,1.0,1,1,2,4,7,0xb2d588c0
335.12,1.0,15,1,2,3,6,0xb2d4828bd
1325.27,3.0,0,1,4,4,9,0xb2d0db9e
4.96,1.0,22,1,2,2,5,0xb2d31e94
303.05,1.0,7,1,2,3,6,0xb2d194fd
225995.72,3.0,0,3,4,4,11,0xb2d366b0d
2140007.65,8.0,4,4,4,4,12,0xb2d62dfc
523445.11,12.0,1,4,4,4,12,0xb2d6c9ac
446199.63,4.0,1,4,4,4,12,0xb2d256dcd
4001.75,1.0,28,2,2,2,6,0xb2d8ec11d
600001.0,1.0,1,4,2,4,10,0xb2da4ccb
6419054.31,6.0,0,4,4,4,12,0xb2d63f55
8.76,1.0,29,1,2,2,5,0xb2d3ba51
251553.14,2.0,34,3,3,2,8,0xb2d9323fd
40050.37,3.0,0,2,4,4,10,0xb2d5e0edd
392126.74,5.0,1,4,4,4,12,0xb2d211e1
4699.09,1.0,6,2,2,3,7,0xb2d2ddb6
1028731.31,13.0,3,4,4,4,12,0xb2d136ee
330022.34,3.0,15,4,4,3,11,0xb2d98760
40833.13,3.0,25,2,4,2,8,0xb2d680efd
3232894.56,8.0,0,4,4,4,12,0x3b9b1826d
20930.46,1.0,0,2,2,4,8,0xb2d22188
51527.93,2.0,186,2,3,1,6,0xb2d5a98dd
189.81,1.0,31,1,2,2,5,0xb2d3f16d
0.0,2.0,9,1,3,3,7,0xb2d0fcc0d
53004.65,3.0,11,3,4,3,10,0xb2d64042d
434381.78,2.0,63,4,3,2,9,0xb2d14943d
113305.79,3.0,49,3,4,2,9,0xb2d4af69
100068.2,4.0,1,3,4,4,11,0xb2d2d6b2d
50001.08,2.0,62,2,3,2,7,0xb2d6a268d
404062.31,4.0,6,4,4,3,11,0xb2d126dbd
190002.0,3.0,48,3,4,2,9,0xb2d990ce
201847.66,2.0,53,3,3,2,8,0xb2d109af
153813.23,2.0,27,3,3,2,8,0xb2d98328d
2000.48,2.0,92,1,3,1,5,0xb2d349cad
25776.0,1.0,21,2,2,2,6,0xb2d3dd26
516.4,1.0,75,1,2,1,4,0xb2d2c050d
1272.3,1.0,226,1,2,1,4,0xb2d3e783d
200900.66,2.0,39,3,3,2,8,0xb2d40ddf
450108.02,2.0,66,4,3,2,9,0xb2d5bbadd
250311.01,3.0,42,3,4,2,9,0xb2d479d3d
411036.79,7.0,28,4,4,2,10,0xb2d3ee74d
15255.14,1.0,0,2,2,4,8,0xb2d6bb00d
55961.32,2.0,92,3,3,1,7,0xb2d21fe6
130281.92,5.0,30,3,4,2,9,0xb2d568c6
393000.0,5.0,8,4,4,3,11,0xb2d0c2e6d
6264.63,1.0,92,2,2,1,5,0xb2d3fd0a
200046.24,3.0,10,3,4,3,10,0xb2d5edfcd
1071363.84,3.0,172,4,4,1,9,0xb2d0a862d
100001.61,5.0,1,3,4,4,11,0xb2d629f4d
3190600.0,115.0,0,4,4,4,12,0x3b9b0e2c
346093.09,2.0,7,4,3,3,10,0xb2d0d342d
30082.71,3.0,8,2,4,3,9,0xb2d41a73d
95777.47,1.0,21,3,2,2,7,0xb2d60ad0
0.0,1.0,7,1,2,3,6,0xb2d3e86bd
100027.61,3.0,4,3,4,4,11,0xb2d6468c
21705.38,1.0,0,2,2,4,8,0xb2d6be14
102999.87,2.0,125,3,3,1,7,0xb2d3bce9
320000.53,3.0,4,4,4,4,12,0xb2da4da7
12.01,1.0,54,1,2,2,5,0xb2d17540
2137247.67,14.0,0,4,4,4,12,0xb2d1286cd
18735.38,1.0,2,2,2,4,8,0xb2d67dd8d
50718.83,2.0,143,2,3,1,6,0xb2d35d39
1498.88,1.0,0,1,2,4,7,0xb2d2b7a9
193655.04,5.0,3,3,4,4,11,0xb2d69003d
911.51,1.0,0,1,2,4,7,0xb2d69cad
3711.43,1.0,92,2,2,1,5,0xb2d22d7a
2206.95,1.0,196,1,2,1,4,0xb2d37f6f
1017.53,1.0,75,1,2,1,4,0xb2d58955d
500485.66,2.0,1,4,3,4,11,0xb2da1c1b
2028.51,1.0,92,1,2,1,4,0xb2d25ffdd
10108.21,1.0,66,2,2,2,6,0xb2d5d5c4
95.78,1.0,21,1,2,2,5,0xb2d2549ed
100000.8,2.0,0,3,3,4,10,0xb2d3306dd
381748.6,3.0,3,4,4,4,12,0xb2d5615ad
4293.35,1.0,0,2,2,4,8,0xb2d1523b
984763.25,6.0,41,4,4,2,10,0xb2d59763d
7.87,1.0,8,1,2,3,6,0xb2d7809a
19122.3,1.0,21,2,2,2,6,0xb2d2e312d
8823.42,1.0,12,2,2,3,7,0xb2d61c50
80039.9,2.0,131,3,3,1,7,0xb2d10c07d
50057.76,2.0,53,2,3,2,7,0xb2d61524
12244.68,1.0,48,2,2,2,6,0xb2d6b14dd
663629.6,5.0,12,4,4,3,11,0xb2d5d97cd
19540.09,1.0,15,2,2,3,7,0xb2d40023d
0.0,1.0,7,1,2,3,6,0xb2d13887
23103.54,1.0,184,2,2,1,5,0xb2d26dcc
23125.09,1.0,8,2,2,3,7,0xb2d0da29
5625.79,1.0,48,2,2,2,6,0xb2d70890
2763.45,1.0,6,1,2,3,6,0xb2d20383
8.5,1.0,0,1,2,4,7,0xb2d56351
1885.45,1.0,92,1,2,1,4,0xb2d11009d
419594.21,5.0,4,4,4,4,12,0xb2d25da9d
58.24,1.0,6,1,2,3,6,0xb2d1c1a7d
209826.73,4.0,144,3,4,1,8,0xb2d2d030
282396.84,2.0,13,3,3,3,9,0xb2d07a55d
460079.08,3.0,1,4,4,4,12,0xb2d5f56dd
204265.65,2.0,184,3,3,1,7,0xb2d6b27fd
305634.91,2.0,27,4,3,2,9,0xb2d8cb30
1497.8,1.0,92,1,2,1,4,0xb2d427f1d
200114.36,2.0,7,3,3,3,9,0xb2d139a8d
228019.27,4.0,0,3,4,4,11,0xb2d23aa1
1903.05,1.0,2,1,2,4,7,0xb2d909c0d
250009.41,4.0,45,3,4,2,9,0xb2d10cb8
114.57,1.0,72,1,2,1,4,0xb2d2a8afd
343.53,1.0,11,1,2,3,6,0xb2d51433
353.51,1.0,10,1,2,3,6,0xb2d9f740
3411.74,2.0,1,2,3,4,9,0xb2d529eb
1178.51,1.0,184,1,2,1,4,0xb2d105ff
1024.39,1.0,266,1,2,1,4,0xb2d2f68e
60001.27,2.0,151,3,3,1,7,0xb2d8fdf1d
225012.83,4.0,12,3,4,3,10,0xb2d37a62
20000.0,2.0,3,2,3,4,9,0xb2d972d9d
160052.65,2.0,76,3,3,1,7,0xb2d1b29bd
4.96,1.0,10,1,2,3,6,0xb2d95684
735.68,1.0,92,1,2,1,4,0xb2d1d441d
655185.83,2.0,112,4,3,1,8,0xb2d41caad
55107.66,3.0,0,3,4,4,11,0xb2d6477dd
1008.99,1.0,184,1,2,1,4,0xb2d32b5dd
230112.27,3.0,0,3,4,4,11,0xb2d0c2c2
50000.0,1.0,8,2,2,3,7,0xb2da1ccc
200006.33,3.0,76,3,4,1,8,0xb2d99103
62779.93,8.0,1,3,4,4,11,0x3b9b0e1dd
101300.69,2.0,4,3,3,4,10,0xb2d29861d
1000.54,1.0,92,1,2,1,4,0xb2d23853
542.9,1.0,0,1,2,4,7,0xb2d6e863
1022163.03,2.0,27,4,3,2,9,0xb2d61369d
2130111.6,14.0,0,4,4,4,12,0xb2d5bd18d
215753.96,2.0,221,3,3,1,7,0xb2d364fd
1000000.0,2.0,4,4,3,4,11,0xb2d97b81d
300015.86,3.0,6,3,4,3,10,0xb2d17a80
26438.06,1.0,24,2,2,2,6,0xb2d1fb58
1822.07,1.0,10,1,2,3,6,0xb2d96096
140009.93,2.0,10,3,3,3,9,0xb2d2f33cd
10950.85,1.0,18,2,2,2,6,0xb2d34540d
9133.39,1.0,0,2,2,4,8,0xb2d2c0b5
705836.45,20.0,0,4,4,4,12,0xb2d0a6fed
85.47,1.0,50,1,2,2,5,0xb2d9adb8
381552.75,4.0,49,4,4,2,10,0xb2d6452d
200077.34,2.0,12,3,3,3,9,0xb2d6e78ed
7393.39,1.0,69,2,2,1,5,0xb2d2370ed
5049.37,1.0,6,2,2,3,7,0xb2d6f4a1d
30000.63,2.0,10,2,3,3,8,0xb2d63c8a
1563.75,1.0,2,1,2,4,7,0xb2d154a3d
1060.83,1.0,92,1,2,1,4,0xb2d34ba8d
66000.0,2.0,0,3,3,4,10,0xb2d692b0
399287.38,6.0,2,4,4,4,12,0xb2d0dfb1
8545.04,1.0,0,2,2,4,8,0xb2d6f2fbd
0.0,1.0,6,1,2,3,6,0xb2d5c313
5006.69,1.0,19,2,2,2,6,0xb2d9e07b
79.06,1.0,27,1,2,2,5,0xb2d98f96
150007.94,2.0,92,3,3,1,7,0xb2d64795d
1414.83,1.0,7,1,2,3,6,0xb2d93490d
602.57,7.0,0,1,4,4,9,0x3b9b4337d
44.81,2.0,16,1,3,2,6,0xb2d2e0f5
16890.16,1.0,92,2,2,1,5,0xb2d2fb7cd
215364.26,8.0,16,3,4,2,9,0x3b9b4535
496675.4,3.0,3,4,4,4,12,0xb2d4b89a
39097.42,1.0,1,2,2,4,8,0xb2d2d4c6d
3973.32,1.0,0,2,2,4,8,0xb2d6c0a1
421.59,1.0,47,1,2,2,5,0xb2d280d6d
380006.75,7.0,27,4,4,2,10,0xb2d198a5
6103.06,1.0,29,2,2,2,6,0xb2d91cc2
260009.57,4.0,69,3,4,1,8,0xb2d655fb
131058.37,6.0,49,3,4,2,9,0xb2d10673d
80010.07,5.0,18,3,4,2,9,0xb2d41834
300001.04,2.0,74,3,3,1,7,0xb2d0c6abd
6.0,1.0,2,1,2,4,7,0xb2d6bb8c
26.98,1.0,0,1,2,4,7,0xb2d23759d
601.59,1.0,0,1,2,4,7,0xb2d5931ed
14888.92,1.0,4,2,2,4,8,0xb2d7a699d
17529.76,1.0,9,2,2,3,7,0xb2d34aef
421000.0,5.0,0,4,4,4,12,0xb2d107cb
383337.04,4.0,59,4,4,2,10,0xb2d41806d
20000.84,2.0,94,2,3,1,6,0xb2d85975
1207.28,2.0,0,1,3,4,8,0xb2d0c96b
9681.93,1.0,9,2,2,3,7,0xb2d2ac15d
230120.16,5.0,32,3,4,2,9,0xb2d6268c
8666.58,1.0,2,2,2,4,8,0xb2d58ea7
623117.28,4.0,24,4,4,2,10,0xb2d624e3d
500076.06,2.0,10,4,3,3,10,0xb2d9ef09
3.68,1.0,19,1,2,2,5,0xb2d68f0b
70363.72,3.0,1,3,4,4,11,0xb2d47ea3
360023.5,3.0,0,4,4,4,12,0xb2d4f736
138.23,2.0,34,1,3,2,6,0xb2d6c6a5d
361252.51,14.0,5,4,4,3,11,0xb2d30075
103419.03,2.0,139,3,3,1,7,0xb2d27ea7
250021.38,3.0,14,3,4,3,10,0xb2d9a006
1083.24,2.0,184,1,3,1,5,0x3b9b3aae
124093.97,3.0,132,3,4,1,8,0xb2d38ed0
10009.0,2.0,42,2,3,2,7,0xb2d9c4a0
57.43,1.0,0,1,2,4,7,0xb2d0bb93d
125013.57,2.0,4,3,3,4,10,0xb2d5ff25d
303740.03,5.0,25,4,4,2,10,0xb2d06ebbd
200006.44,2.0,0,3,3,4,10,0xb2d95f44d
52.78,1.0,61,1,2,2,5,0xb2d8d4cd
60020.61,3.0,136,3,4,1,8,0xb2d63b53
11224.41,1.0,4,2,2,4,8,0xb2d6c0c5d
20909.49,1.0,239,2,2,1,5,0xb2d58c4ad
409851.28,2.0,13,4,3,3,10,0xb2d6533d
9397.54,1.0,184,2,2,1,5,0xb2d2509d
50000.53,2.0,31,2,3,2,7,0xb2d93cbd
237945.64,3.0,167,3,4,1,8,0xb2d07cf8d
200712.62,2.0,52,3,3,2,8,0xb2d9cd7f
0.0,1.0,81,1,2,1,4,0xb2d4d82c
780675.1,4.0,19,4,4,2,10,0xb2d635eed
72337.16,1.0,11,3,2,3,8,0xb2d2fdbb
568011.61,1.0,3,4,2,4,10,0xb2d68ff8d
99088.34,3.0,41,3,4,2,9,0xb2d6dba7d
50560.57,2.0,18,2,3,2,7,0xb2d56377
14.07,1.0,4,1,2,4,7,0xb2d64306
140034.53,2.0,2,3,3,4,10,0xb2d93160d
80017.29,2.0,136,3,3,1,7,0xb2d55fac
33028.24,2.0,116,2,3,1,6,0xb2d55634d
449510.85,8.0,0,4,4,4,12,0xb2d0defbd
2522.51,1.0,19,1,2,2,5,0xb2d6c06c
10052.07,1.0,111,2,2,1,5,0xb2d6d611d
672278.43,9.0,10,4,4,3,11,0xb2d2506e
82455.7,1.0,54,3,2,2,7,0xb2d37cbb
104.15,1.0,3,1,2,4,7,0xb2d16d12d
414406.17,3.0,3,4,4,4,12,0xb2d3d063d
3469364.96,24.0,1,4,4,4,12,0xb2d4f122
4660352.16,4.0,59,4,4,2,10,0xb2d3cf3ed
3985.03,1.0,1,2,2,4,8,0xb2d6bb66d
4945.46,1.0,47,2,2,2,6,0xb2d6af93
155165.41,2.0,45,3,3,2,8,0xb2d91a23d
824.06,1.0,1,1,2,4,7,0xb2d6fbf7
152753.48,3.0,25,3,4,2,9,0xb2d16b34
476.7,1.0,40,1,2,2,5,0xb2d6b584d
70001.48,2.0,92,3,3,1,7,0xb2d655e9
244.1,1.0,0,1,2,4,7,0xb2d1a784
1000010.56,2.0,27,4,3,2,9,0xb2d94015
195.58,1.0,4,1,2,4,7,0xb2d7871d
1161.7,1.0,0,1,2,4,7,0xb2d2de0dd
500000.0,2.0,4,4,3,4,11,0xb2d93242
490277.87,8.0,3,4,4,4,12,0xb2d321b8d
50032.04,2.0,7,2,3,3,8,0xb2d48270d
134310.88,2.0,2,3,3,4,10,0xb2d0db9d
107006.04,2.0,77,3,3,1,7,0xb2d24c5dd
3.89,1.0,29,1,2,2,5,0xb2d8f922
60050.12,2.0,98,3,3,1,7,0xb2d57d36
201285.3,2.0,0,3,3,4,10,0xb2d31f6b
6.86,1.0,82,1,2,1,4,0xb2d61b11d
822857.39,6.0,6,4,4,3,11,0xb2d8ef16d
378.42,1.0,10,1,2,3,6,0xb2d960e0
568933.71,3.0,69,4,4,1,9,0xb2d9930e
376029.51,4.0,20,4,4,2,10,0xb2d33d1d
968.02,1.0,12,1,2,3,6,0xb2d217d7
50808.83,3.0,5,2,4,3,9,0xb2d5cb49d
79103.07,1.0,47,3,2,2,7,0xb2d5a2b8
33162.82,1.0,7,2,2,3,7,0xb2d64ecd
20000.63,2.0,92,2,3,1,6,0xb2d6440b
4668.54,1.0,9,2,2,3,7,0xb2d8264dd
566.48,1.0,58,1,2,2,5,0xb2d62a97
0.0,1.0,12,1,2,3,6,0xb2d2baeed
656570.1,3.0,0,4,4,4,12,0xb2d206d3d
4301.65,8.0,1,2,4,4,10,0xb2d34087d
51101.86,16.0,7,2,4,3,9,0xb2d2c1bb
7.97,1.0,35,1,2,2,5,0xb2d14c15
400000.0,3.0,20,4,4,2,10,0xb2da12f7
12.63,1.0,3,1,2,4,7,0xb2d8ed70d
46.23,1.0,13,1,2,3,6,0xb2da0961
33.91,1.0,25,1,2,2,5,0xb2d41229
1006.41,1.0,92,1,2,1,4,0xb2d2edcdd
3004.86,1.0,45,2,2,2,6,0xb2d39d62d
994175.91,6.0,4,4,4,4,12,0xb2d14b22
80001.69,2.0,67,3,3,1,7,0xb2d9ac5f
0.53,1.0,0,1,2,4,7,0xb2d3eba1
110709.36,2.0,47,3,3,2,8,0xb2d1a0ecd
191.39,1.0,11,1,2,3,6,0xb2d23eab
540442.14,5.0,11,4,4,3,11,0xb2d09a0cd
10002.68,2.0,87,2,3,1,6,0xb2d597bad
100004.87,3.0,18,3,4,2,9,0xb2d1222e
10121277.9,2.0,66,4,3,2,9,0xb2d6bd60
10133.01,1.0,119,2,2,1,5,0xb2d30ed6
851717.7,4.0,18,4,4,2,10,0xb2d07166d
10070.72,1.0,0,2,2,4,8,0xb2d69b68
206349.24,2.0,0,3,3,4,10,0xb2d20aaed
30000.0,4.0,4,2,4,4,10,0xb2d633c6d
400012.06,4.0,7,4,4,3,11,0xb2d17339d
873.63,2.0,2,1,3,4,8,0xb2d93749d
130007.36,9.0,11,3,4,3,10,0xb2d16b80d
81344.17,2.0,4,3,3,4,10,0xb2d0bd32d
251.51,1.0,30,1,2,2,5,0xb2d62741
763027.21,4.0,0,4,4,4,12,0xb2d5ad2fd
414000.0,6.0,5,4,4,3,11,0xb2d78d01
943441.9,13.0,1,4,4,4,12,0xb2d2f85e
40945.59,2.0,0,2,3,4,9,0xb2d6bb1fd
102036.51,5.0,2,3,4,4,11,0xb2d53044d
200098.0,2.0,0,3,3,4,10,0xb2d96fb1d
401420.95,2.0,48,4,3,2,9,0xb2d97f4c
265.62,1.0,15,1,2,3,6,0xb2d3a14b
550623.55,4.0,158,4,4,1,9,0xb2d13b3bd
557000.0,24.0,1,4,4,4,12,0xb2d53a2a
2972.02,1.0,0,2,2,4,8,0xb2d50928
141658.18,3.0,11,3,4,3,10,0xb2d1a4f5d
4.06,1.0,64,1,2,2,5,0xb2d7f0c7
4.22,1.0,157,1,2,1,4,0xb2d6d0a0
3052460.81,10.0,0,4,4,4,12,0x3b9ada4ad
20000.21,2.0,31,2,3,2,7,0xb2d92e74
4499081.6,11.0,3,4,4,4,12,0xb2d141d3d
1.0,1.0,92,1,2,1,4,0xb2d29f93
0.0,1.0,7,1,2,3,6,0xb2d65c3ad
2211.92,1.0,92,1,2,1,4,0xb2d0c796d
110838.51,2.0,18,3,3,2,8,0xb2d5ef97
501828.85,2.0,29,4,3,2,9,0xb2d9773cd
3.58,1.0,16,1,2,2,5,0xb2d8ec91
12185.93,1.0,0,2,2,4,8,0xb2d43dbb
189013.92,6.0,46,3,4,2,9,0xb2d0dc38d
58223.05,1.0,6,3,2,3,8,0xb2d6881c
709621.55,18.0,0,4,4,4,12,0x3b9ae511d
379817.38,1.0,71,4,2,1,7,0xb2d64c5dd
100004.69,2.0,41,3,3,2,8,0xb2d550fb
6174493.48,11.0,0,4,4,4,12,0xb2d10799
411.31,1.0,10,1,2,3,6,0xb2d76b2b
300063.9,4.0,4,3,4,4,11,0xb2d0d4d1d
21278.61,3.0,18,2,4,2,8,0xb2d8d087
81468.39,1.0,4,3,2,4,9,0xb2d8da33
102841.28,3.0,31,3,4,2,9,0xb2d621f0
328.4,1.0,0,1,2,4,7,0xb2d62985
3313.3,1.0,1,2,2,4,8,0xb2d26e18d
465062.58,6.0,1,4,4,4,12,0xb2d23bab
300000.0,2.0,7,3,3,3,9,0xb2d958d4
1070152.71,1.0,13,4,2,3,9,0xb2d6b852d
62894.78,2.0,189,3,3,1,7,0xb2d3b6ee
10000.21,2.0,39,2,3,2,7,0xb2d9f090
5139.3,1.0,0,2,2,4,8,0xb2d906b7d
7.26,1.0,50,1,2,2,5,0xb2d4882ad
274712.32,1.0,0,3,2,4,9,0xb2d41ccf
335.66,1.0,3,1,2,4,7,0xb2d9835e
40005.14,3.0,39,2,4,2,8,0xb2d7080ed
90566.17,2.0,22,3,3,2,8,0xb2d63c38d
52184.95,1.0,10,3,2,3,8,0xb2d4ea5ad
120097.98,3.0,175,3,4,1,8,0xb2d119e6
45089.33,2.0,92,2,3,1,6,0xb2d64ac0
100490.55,2.0,92,3,3,1,7,0xb2d632ebd
1708.39,1.0,92,1,2,1,4,0xb2d3a09ad
95.13,1.0,1,1,2,4,7,0xb2d912f9d
104.85,1.0,19,1,2,2,5,0xb2d9966b
256058.58,6.0,67,3,4,1,8,0xb2d1d69fd
12474.42,1.0,69,2,2,1,5,0xb2d2d8cd
41387.04,2.0,49,2,3,2,7,0xb2d55260d
1023.87,1.0,92,1,2,1,4,0xb2d1b608d
50008.0,2.0,1,2,3,4,9,0xb2d979b5
10002.06,2.0,59,2,3,2,7,0xb2d109f4
390047.48,3.0,62,4,4,2,10,0xb2d303d2
0.0,2.0,82,1,3,1,5,0xb2d4e76e
31.7,1.0,83,1,2,1,4,0xb2d50d9f
1936352.37,4.0,11,4,4,3,11,0xb2d49160d
302667.42,2.0,64,4,3,2,9,0xb2d67cbb
60001.9,2.0,31,3,3,2,8,0xb2d7a671
1026.73,1.0,10,1,2,3,6,0xb2d3f45e
87000.0,4.0,0,3,4,4,11,0xb2d69638
131023.24,2.0,0,3,3,4,10,0xb2d15759
748499.86,4.0,0,4,4,4,12,0xb2d210b0d
740104.03,2.0,10,4,3,3,10,0xb2d56c9cd
4530.1,1.0,10,2,2,3,7,0xb2d1fcf9d
46646.85,8.0,3,2,4,4,10,0xb2d534f0
200000.31,3.0,0,3,4,4,11,0xb2d4f511
90799.9,5.0,10,3,4,3,10,0xb2d3a5a8d
266146.85,2.0,8,3,3,3,9,0xb2d1c74cd
6.04,1.0,15,1,2,3,6,0xb2d5e9ce
209920.5,4.0,34,3,4,2,9,0x3b9b4768d
1025.21,1.0,21,1,2,2,5,0xb2d400e9
800041.63,2.0,140,4,3,1,8,0xb2d90e77d
48906.31,1.0,2,2,2,4,8,0xb2d5cdebd
1777.19,1.0,92,1,2,1,4,0xb2d2a376
205037.57,2.0,116,3,3,1,7,0xb2d47330
558149.7,3.0,55,4,4,2,10,0xb2d42e49
6746.12,1.0,29,2,2,2,6,0xb2d926ac
20441.96,3.0,14,2,4,3,9,0xb2d06f66
8941.1,2.0,91,2,3,1,6,0xb2d4bb13d
24.28,1.0,50,1,2,2,5,0xb2d883d2
2049.94,1.0,1,1,2,4,7,0xb2d4a759
95671.65,1.0,0,3,2,4,9,0xb2d0bb9d
0.0,1.0,18,1,2,2,5,0xb2d2fa40
2197.14,1.0,258,1,2,1,4,0xb2d2923cd
2000.26,9.0,0,1,4,4,9,0xb2d09e4c
22473.49,1.0,6,2,2,3,7,0xb2d5b52c
50923.64,2.0,0,2,3,4,9,0xb2d62617
20507.04,1.0,11,2,2,3,7,0xb2d1dd02
3226.53,1.0,184,2,2,1,5,0xb2d0c6d2
887042.72,1.0,60,4,2,2,8,0xb2d14f21
0.72,1.0,1,1,2,4,7,0xb2d284d5d
171.75,1.0,10,1,2,3,6,0xb2d6d5c9
825467.95,2.0,67,4,3,1,8,0xb2d4de9cd
1699.14,1.0,0,1,2,4,7,0xb2d695e6
1059850.2,8.0,20,4,4,2,10,0xb2d5f1acd
4031.16,1.0,37,2,2,2,6,0xb2d6509e
384005.35,5.0,11,4,4,3,11,0xb2d5b365
414035.69,5.0,3,4,4,4,12,0xb2d16708
3755.45,1.0,16,2,2,2,6,0xb2d2b72b
2032.12,1.0,92,1,2,1,4,0xb2d0ee1d
10390.59,2.0,46,2,3,2,7,0xb2d6cf88d
606748.11,3.0,97,4,4,1,9,0xb2d1b76dd
6893.55,1.0,76,2,2,1,5,0xb2d3f1fcd
58.78,1.0,70,1,2,1,4,0xb2d8c3f2
160000.41,3.0,136,3,4,1,8,0xb2d0a7a1
50000.53,2.0,45,2,3,2,7,0xb2d91b70
616075.73,8.0,8,4,4,3,11,0xb2d598bdd
46265.12,6.0,80,2,4,1,7,0xb2d1c248d
3285.49,1.0,54,2,2,2,6,0xb2d57c29
240085.73,6.0,0,3,4,4,11,0xb2d39a4e
10397471.0,23.0,4,4,4,4,12,0xb2d5008ad
404363.88,2.0,90,4,3,1,8,0xb2d85702
403299.68,8.0,2,4,4,4,12,0xb2d56456d
538021.96,4.0,76,4,4,1,9,0xb2d13fd5
647976.14,3.0,34,4,4,2,10,0xb2d21aad
13407.41,1.0,37,2,2,2,6,0xb2d7870c
450000.93,2.0,21,4,3,2,9,0xb2d9855b
32756.78,2.0,193,2,3,1,6,0xb2d5749f
6011.65,1.0,4,2,2,4,8,0xb2d1908c
291436.47,3.0,18,3,4,2,9,0xb2d1528b
110004.34,3.0,4,3,4,4,11,0xb2d6a362d
2058805.6,13.0,7,4,4,3,11,0xb2d14e37d
58001.03,4.0,20,3,4,2,9,0xb2d2f281d
190027.77,4.0,28,3,4,2,9,0xb2d5b9d2d
10002.06,2.0,80,2,3,1,6,0xb2d62bc8
98.81,1.0,104,1,2,1,4,0xb2d0ffc6d
270032.67,3.0,39,3,4,2,9,0xb2d1b209
102590.21,1.0,47,3,2,2,7,0xb2d47131
134594.65,2.0,143,3,3,1,7,0xb2d2f7b4
252837.48,3.0,4,3,4,4,11,0xb2d430c7d
420011.82,5.0,27,4,4,2,10,0xb2d90710d
1697.47,1.0,0,1,2,4,7,0xb2d93a4a
9226.35,1.0,29,2,2,2,6,0xb2d656afd
32473.99,2.0,9,2,3,3,8,0xb2d2461d
441633.69,3.0,49,4,4,2,10,0xb2d90d02d
1100162.95,3.0,39,4,4,2,10,0xb2d07bafd
631000.01,9.0,0,4,4,4,12,0x3b9b182fd
4890.4,1.0,10,2,2,3,7,0xb2d42d30
514070.39,2.0,27,4,3,2,9,0xb2d62cde
151381.9,3.0,4,3,4,4,11,0xb2d64986
1050.47,1.0,111,1,2,1,4,0xb2d67338
1153.26,1.0,1,1,2,4,7,0xb2d7713c
519537.45,2.0,98,4,3,1,8,0xb2d581b0d
500132.82,2.0,27,4,3,2,9,0xb2d24d66d
150358.36,2.0,4,3,3,4,10,0xb2d62722
303.01,1.0,184,1,2,1,4,0xb2d3a182
1481.09,1.0,92,1,2,1,4,0xb2d25142d
121897.68,1.0,54,3,2,2,7,0xb2d17878d
207082.47,3.0,0,3,4,4,11,0xb2d09195d
4002.27,1.0,19,2,2,2,6,0xb2d6b6a3d
15055.41,1.0,14,2,2,3,7,0xb2d976e1
228019.75,4.0,41,3,4,2,9,0xb2d63765
7143.88,1.0,119,2,2,1,5,0xb2d0df0bd
4237.88,1.0,26,2,2,2,6,0xb2d38ca9d
363.97,1.0,0,1,2,4,7,0xb2d8d044
1592.84,1.0,1,1,2,4,7,0xb2d901d6
45260.34,1.0,14,2,2,3,7,0xb2d62112
1.81,1.0,74,1,2,1,4,0xb2d2dd21
207028.66,2.0,0,3,3,4,10,0xb2d2f05dd
450009.78,2.0,10,4,3,3,10,0xb2d9a68c
1681.0,1.0,287,1,2,1,4,0xb2d5b674d
78427.4,1.0,176,3,2,1,6,0xb2d396a1
1083644.22,8.0,45,4,4,2,10,0xb2d325a3d
3.38,1.0,78,1,2,1,4,0xb2d95bf5
1318.15,1.0,70,1,2,1,4,0xb2d6f102
50.31,1.0,4,1,2,4,7,0xb2d52c3c
1204569.48,2.0,13,4,3,3,10,0xb2d56f98d
42726.01,2.0,10,2,3,3,8,0xb2d393d9d
300009.5,2.0,18,3,3,2,8,0xb2da2672
0.0,1.0,1,1,2,4,7,0xb2d25e9d
55266.78,2.0,56,3,3,2,8,0xb2d9a84b
100661.47,2.0,4,3,3,4,10,0xb2d37884d
741633.07,7.0,1,4,4,4,12,0xb2d5c253d
130351.4,6.0,41,3,4,2,9,0xb2d6b602
120225.22,2.0,125,3,3,1,7,0xb2d344acd
71900010.03,2.0,92,4,3,1,8,0xb2d5b136d
8317.53,3.0,92,2,4,1,7,0xb2d0afc8
90064.54,2.0,1,3,3,4,10,0xb2d8f37dd
1463981.58,5.0,2,4,4,4,12,0xb2d3fba0d
69.47,1.0,28,1,2,2,5,0xb2d2aab1
690027.05,25.0,0,4,4,4,12,0xb2d122bfd
200059.07,2.0,16,3,3,2,8,0xb2d638a6
162345.7,4.0,6,3,4,3,10,0xb2d14575
217699.79,4.0,1,3,4,4,11,0xb2d24e44d
1021643.55,3.0,25,4,4,2,10,0xb2d1d1b6
121850.9,4.0,0,3,4,4,11,0xb2d60f1fd
6.33,1.0,59,1,2,2,5,0xb2d9c182
228.71,1.0,17,1,2,2,5,0xb2d8c714
2400151.45,7.0,67,4,4,1,9,0xb2d111bcd
4639.34,1.0,0,2,2,4,8,0xb2d6c172
10163.34,1.0,4,2,2,4,8,0xb2d5dbc7
4377.29,2.0,0,2,3,4,9,0xb2d26582d
9463.38,1.0,12,2,2,3,7,0xb2d212d6d
22608.44,1.0,1,2,2,4,8,0xb2d23e0c
0.33,1.0,49,1,2,2,5,0xb2d5dcd0d
130000.0,1.0,0,3,2,4,9,0xb2d9270c
183503.69,2.0,20,3,3,2,8,0xb2d14bb9
14326.79,1.0,92,2,2,1,5,0xb2d26bc0d
761478.23,7.0,10,4,4,3,11,0xb2d5de70d
155516.28,1.0,92,3,2,1,6,0xb2d17b39
9.46,1.0,68,1,2,1,4,0xb2d6493ed
171.97,1.0,6,1,2,3,6,0xb2d5c4c7
699.42,1.0,12,1,2,3,6,0xb2d38895d
7.61,1.0,184,1,2,1,4,0xb2d3a12dd
2.14,1.0,51,1,2,2,5,0xb2d6dbee
160.03,1.0,10,1,2,3,6,0xb2d45ef5d
300082.54,2.0,129,3,3,1,7,0xb2d55451d
1059.49,1.0,139,1,2,1,4,0xb2d27e5fd
230.89,1.0,18,1,2,2,5,0xb2d5cf11d
399.0,1.0,56,1,2,2,5,0xb2d7821d
523754.33,4.0,76,4,4,1,9,0xb2d245e3d
51949.36,2.0,48,2,3,2,7,0xb2d5b88b
1581643.89,10.0,8,4,4,3,11,0xb2d140cbd
1201988.51,6.0,10,4,4,3,11,0xb2d4e24fd
2153.04,1.0,88,1,2,1,4,0xb2d37ff5
3182.03,1.0,24,2,2,2,6,0xb2d254f0
300009.62,2.0,144,3,3,1,7,0xb2d55e4c
51611.85,2.0,66,2,3,2,7,0xb2d09bee
260019.72,2.0,9,3,3,3,9,0xb2d9f772
1190053.31,6.0,11,4,4,3,11,0xb2d1a0ee
386.79,1.0,9,1,2,3,6,0xb2d3ff63d
5101.51,1.0,9,2,2,3,7,0xb2d8b1b1
40000.84,2.0,39,2,3,2,7,0xb2d9ef60
44.02,1.0,25,1,2,2,5,0xb2d57c05
986.74,1.0,11,1,2,3,6,0xb2d2c4de
782.34,1.0,9,1,2,3,6,0xb2d3f342d
500000.0,5.0,5,4,4,3,11,0xb2d11a74d
2.34,1.0,40,1,2,2,5,0xb2d6215f
211586.94,2.0,3,3,3,4,10,0xb2d3c405d
34543.44,1.0,21,2,2,2,6,0xb2d8b1f1d
105166.55,1.0,237,3,2,1,6,0xb2d4c0abd
1280.69,2.0,92,1,3,1,5,0xb2d26002d
367.42,1.0,0,1,2,4,7,0xb2d83cb7d
10000.11,2.0,14,2,3,3,8,0xb2d63c89
20232.25,1.0,3,2,2,4,8,0xb2d0e15dd
32007.12,4.0,38,2,4,2,8,0xb2d3ea1cd
35.4,2.0,22,1,3,2,6,0xb2d2461dd
462698.19,7.0,3,4,4,4,12,0xb2d0c43fd
1007.26,1.0,92,1,2,1,4,0x3b9b43af
55362.8,2.0,164,3,3,1,7,0xb2d247e7
2680.24,1.0,3,1,2,4,7,0xb2d365c1
180020.06,3.0,53,3,4,2,9,0xb2d5ea8ed
120008.3,2.0,143,3,3,1,7,0x3b9b368c
30364.03,2.0,144,2,3,1,6,0xb2d6d6ae
400069.45,6.0,82,4,4,1,9,0xb2d1b803d
0.0,1.0,10,1,2,3,6,0xb2d94062
239.14,1.0,4,1,2,4,7,0xb2d2e43d
483926.97,3.0,39,4,4,2,10,0xb2d31f6fd
410205.99,2.0,0,4,3,4,11,0xb2d1a9cfd
2025.67,1.0,92,1,2,1,4,0xb2d35b44d
127982.65,2.0,3,3,3,4,10,0xb2d2b3f5d
590000.15,16.0,6,4,4,3,11,0xb2d6cca6d
22002.74,2.0,2,2,3,4,9,0xb2d1d708
51005.68,2.0,39,2,3,2,7,0xb2d5d49a
15141.83,1.0,92,2,2,1,5,0xb2d2bf3d
300000.0,2.0,28,3,3,2,8,0xb2d941f4d
164116.5,2.0,143,3,3,1,7,0xb2d13953
42052.8,1.0,0,2,2,4,8,0xb2d2f8c0
51748.98,1.0,1,2,2,4,8,0xb2d5c1b0d
1297.18,1.0,6,1,2,3,6,0xb2d1cf39
20875.3,1.0,10,2,2,3,7,0xb2d2f03ed
3.93,2.0,14,1,3,3,7,0xb2d0815cd
7812.42,1.0,7,2,2,3,7,0xb2d3d7f1
200661.63,3.0,18,3,4,2,9,0xb2d9041c
31.56,1.0,47,1,2,2,5,0xb2d9a2ad
67799.54,4.0,1,3,4,4,11,0xb2d6594fd
295119.81,2.0,108,3,3,1,7,0xb2d33190d
97980.68,1.0,4,3,2,4,9,0xb2d70922
60011.82,2.0,193,3,3,1,7,0xb2d5a61fd
500000.63,10.0,0,4,4,4,12,0xb2d29f78
1364.16,1.0,92,1,2,1,4,0xb2d16b46
158096.94,11.0,1,3,4,4,11,0xb2d36302
991930.98,8.0,19,4,4,2,10,0xb2d2fa16
1062.4,1.0,92,1,2,1,4,0x3b9b286ed
251942.99,3.0,7,3,4,3,10,0xb2d0fd3a
56.9,1.0,70,1,2,1,4,0xb2d99624
40001.27,2.0,235,2,3,1,6,0xb2d630ab
20.33,1.0,16,1,2,2,5,0xb2d3ab57
104196.92,1.0,83,3,2,1,6,0xb2d0c60f
500000.0,2.0,1,4,3,4,11,0xb2da676a
4679826.33,7.0,9,4,4,3,11,0xb2d3843e
5831.1,2.0,92,2,3,1,6,0x3b9b28a8d
1096.28,1.0,86,1,2,1,4,0xb2d2266cd
24.19,1.0,2,1,2,4,7,0xb2d6b361
91122.07,7.0,18,3,4,2,9,0xb2d53378
1348006.4,6.0,0,4,4,4,12,0xb2d38e7ad
2945324.36,8.0,1,4,4,4,12,0xb2d0d08dd
331252.24,2.0,10,4,3,3,10,0xb2d2dd8e
351091.94,3.0,77,4,4,1,9,0xb2d1786d
181921.4,2.0,143,3,3,1,7,0xb2d0e428d
970074.06,4.0,31,4,4,2,10,0xb2d36740d
226738.67,2.0,24,3,3,2,8,0xb2d0b84cd
8.29,2.0,49,1,3,2,6,0xb2d314a0
7.56,1.0,27,1,2,2,5,0xb2d91805
1024.31,1.0,184,1,2,1,4,0xb2d2c9f7d
73439.17,4.0,0,3,4,4,11,0xb2d0759f
68056.08,1.0,64,3,2,2,7,0xb2d8d2d6
200201.04,2.0,0,3,3,4,10,0xb2d0e27a
200762.48,2.0,214,3,3,1,7,0xb2d665d4
100098.35,3.0,18,3,4,2,9,0x3b9b35c4
403.66,1.0,10,1,2,3,6,0xb2d9f319
400070.86,4.0,0,4,4,4,12,0xb2d74acad
400015.99,4.0,1,4,4,4,12,0xb2d65b12
2619.56,1.0,10,1,2,3,6,0xb2d29554d
3038817.22,8.0,10,4,4,3,11,0xb2d3336dd
50006.77,2.0,92,2,3,1,6,0xb2d53a4a
49003.83,2.0,69,2,3,1,6,0xb2d0bf99d
123259.92,2.0,4,3,3,4,10,0xb2d612c2
2132.61,1.0,0,1,2,4,7,0xb2d7066fd
537951.81,1.0,11,4,2,3,9,0xb2d4606ad
692539.82,4.0,67,4,4,1,9,0xb2d60bc6d
20000.42,2.0,92,2,3,1,6,0xb2d6575ed
60179.79,2.0,214,3,3,1,7,0xb2d559ded
1008.99,1.0,184,1,2,1,4,0xb2d30db5
190003.49,4.0,5,3,4,3,10,0xb2d6e5b8
34.39,1.0,17,1,2,2,5,0xb2d6c5b5
60026.44,10.0,0,3,4,4,11,0xb2d0dfcdd
1945567.53,9.0,6,4,4,3,11,0xb2d1298f
3790.24,1.0,29,2,2,2,6,0xb2d69738
112.64,1.0,0,1,2,4,7,0xb2d5d5ad
1324.76,1.0,25,1,2,2,5,0xb2d6d0f7
3.46,1.0,11,1,2,3,6,0xb2d9542a
205244.15,5.0,0,3,4,4,11,0xb2d17707d
171124.23,3.0,224,3,4,1,8,0xb2d2d307d
306929.98,2.0,41,4,3,2,9,0xb2d12315d
460012.69,8.0,12,4,4,3,11,0xb2d5ba19d
70072.93,2.0,153,3,3,1,7,0xb2d5e7ddd
2610.38,1.0,92,1,2,1,4,0xb2d54c2b
3936.17,1.0,0,2,2,4,8,0xb2d8db99d
634558.92,2.0,28,4,3,2,9,0xb2d5ac10
60473.28,2.0,263,3,3,1,7,0xb2d5f838
2110.65,1.0,92,1,2,1,4,0xb2d31638
19733.32,2.0,0,2,3,4,9,0xb2d26674d
2525.65,1.0,184,1,2,1,4,0xb2d37152
29174.43,1.0,20,2,2,2,6,0xb2d60a91d
83.7,1.0,0,1,2,4,7,0xb2d212c8
200746.58,2.0,40,3,3,2,8,0xb2d69030d
24039.62,1.0,0,2,2,4,8,0xb2d3cbe2d
432127.61,6.0,5,4,4,3,11,0xb2d2288dd
136.91,1.0,68,1,2,1,4,0xb2d16c08d
102666.48,2.0,46,3,3,2,8,0xb2d62ec3
540005.85,2.0,0,4,3,4,11,0xb2d5cb66d
11381.02,2.0,4,2,3,4,9,0xb2d6e26fd
660677.19,8.0,0,4,4,4,12,0xb2d0f2ed
220033.62,19.0,0,3,4,4,11,0xb2d4ce4b
72.71,1.0,0,1,2,4,7,0xb2d609cdd
86717.67,2.0,12,3,3,3,9,0xb2d16a79
4132.73,1.0,0,2,2,4,8,0xb2d8023bd
80096.46,2.0,175,3,3,1,7,0xb2d5abee
19.0,1.0,32,1,2,2,5,0xb2d8f1cd
1154033.14,11.0,5,4,4,3,11,0xb2d5dbe0
780492.97,13.0,1,4,4,4,12,0xb2d196b8
1690.32,1.0,184,1,2,1,4,0xb2d14712d
1003620.75,2.0,33,4,3,2,9,0xb2d6042dd
2603.41,1.0,134,1,2,1,4,0xb2d623f8d
147170.27,7.0,0,3,4,4,11,0xb2d3a945d
6771.63,1.0,184,2,2,1,5,0xb2d2acbbd
2963.21,1.0,17,2,2,2,6,0xb2d45b97d
11234.2,1.0,1,2,2,4,8,0xb2d6f4ba
16.13,1.0,20,1,2,2,5,0xb2d27a67d
33000000.0,3.0,1,4,4,4,12,0xb2d963f9
102240.19,3.0,3,3,4,4,11,0xb2d08534
389903.25,1.0,70,4,2,1,7,0xb2d6bc71d
93414.46,1.0,9,3,2,3,8,0xb2d63bbed
1217.73,1.0,3,1,2,4,7,0xb2d67dd5d
10000.01,2.0,55,2,3,2,7,0xb2d5d214
2085.92,1.0,11,1,2,3,6,0xb2d25d08d
579.41,1.0,55,1,2,2,5,0xb2d4f573
78328.03,2.0,53,3,3,2,8,0xb2d34928d
10037.53,1.0,92,2,2,1,5,0xb2d609bfd
2411.04,1.0,98,1,2,1,4,0xb2d27831
1051451.67,2.0,27,4,3,2,9,0xb2d1f0dad
204478.34,2.0,6,3,3,3,9,0xb2d68393d
8641.14,1.0,10,2,2,3,7,0xb2d8dc0b
24.74,1.0,10,1,2,3,6,0xb2d3d1b9
1143000.0,6.0,6,4,4,3,11,0xb2d1c87fd
142916.36,2.0,24,3,3,2,8,0xb2d122ec
5440.64,1.0,2,2,2,4,8,0xb2d356ccd
200710.42,2.0,40,3,3,2,8,0xb2d9f2d9
56237.18,5.0,0,3,4,4,11,0xb2d97318
1333.13,1.0,1,1,2,4,7,0xb2d5d914d
1280.38,1.0,92,1,2,1,4,0xb2d35e4dd
120008.74,2.0,136,3,3,1,7,0xb2d1d646
7536.84,1.0,0,2,2,4,8,0xb2d6bb74
949656.35,3.0,0,4,4,4,12,0xb2d39ebb
56474.35,3.0,1,3,4,4,11,0xb2d45a8f
3048.77,1.0,3,2,2,4,8,0xb2d60e9b
102620.53,1.0,184,3,2,1,6,0xb2d1540b
10008.15,2.0,92,2,3,1,6,0xb2d5e533
513618.84,2.0,69,4,3,1,8,0xb2d6f56f
474104.44,9.0,4,4,4,4,12,0xb2d636f0
30686.42,1.0,0,2,2,4,8,0xb2d653c9d
2631.6,1.0,15,1,2,3,6,0xb2d27747
10082.39,2.0,3,2,3,4,9,0xb2d63695
331354.72,2.0,37,4,3,2,9,0xb2d626a6d
20093.6,2.0,96,2,3,1,6,0xb2d4164d
600148.93,2.0,7,4,3,3,10,0xb2d5738d
563029.0,8.0,10,4,4,3,11,0xb2d1db14
23081.37,1.0,92,2,2,1,5,0xb2d26dccd
1300253.19,4.0,63,4,4,2,10,0xb2d63c22d
526453.7,6.0,26,4,4,2,10,0xb2d91698d
840000.16,3.0,6,4,4,3,11,0xb2d5c5cb
327590.03,11.0,4,4,4,4,12,0x3b9af245d
2001.5,1.0,80,1,2,1,4,0xb2d6f9f8
500000.0,2.0,0,4,3,4,11,0xb2d97ede
5.66,1.0,4,1,2,4,7,0xb2d52932d
80018.63,2.0,53,3,3,2,8,0xb2d52ca6
93081.97,2.0,0,3,3,4,10,0xb2d6ebbb
10247.06,1.0,23,2,2,2,6,0xb2d177be
240586.73,2.0,158,3,3,1,7,0xb2d36372
2953052.43,5.0,7,4,4,3,11,0xb2d0a961d
2505.49,1.0,218,1,2,1,4,0xb2d748c8
160006.64,5.0,53,3,4,2,9,0xb2d6e11dd
300000.0,2.0,5,3,3,3,9,0xb2da5e5f
12268.66,3.0,184,2,4,1,7,0x3b9af4f0d
300005.28,3.0,69,3,4,1,8,0xb2d68777
490202.78,2.0,7,4,3,3,10,0xb2d8ef6ed
32857.89,1.0,6,2,2,3,7,0xb2d2e1d4d
2929.68,1.0,184,2,2,1,5,0xb2d2331cd
487.79,1.0,4,1,2,4,7,0xb2d0b4c9
470023.67,4.0,35,4,4,2,10,0xb2d4dc49d
500496.22,2.0,132,4,3,1,8,0xb2d15420d
67002.16,4.0,14,3,4,3,10,0xb2d9b415
330002.16,4.0,14,4,4,3,11,0xb2d6c673
160880.61,2.0,10,3,3,3,9,0xb2d19a3dd
2839.92,1.0,24,1,2,2,5,0xb2d4cc1a
300001.0,2.0,29,3,3,2,8,0xb2da0afb
1813.29,1.0,10,1,2,3,6,0xb2d8f312
6473.38,2.0,92,2,3,1,6,0x3b9b0f5a
60098.75,2.0,32,3,3,2,8,0xb2d6e385
4745.21,1.0,89,2,2,1,5,0xb2d42e52
280062.77,2.0,4,3,3,4,10,0xb2d6399a
3040013.72,2.0,1,4,3,4,11,0xb2da3c39
105465.08,2.0,1,3,3,4,10,0xb2d4a31d
31.25,1.0,38,1,2,2,5,0xb2d2fbbfd
615.47,1.0,9,1,2,3,6,0xb2d937af
1323.09,1.0,0,1,2,4,7,0xb2d1dada
874000.0,7.0,1,4,4,4,12,0xb2d24312d
1424926.64,26.0,0,4,4,4,12,0x3b9b3434d
55000.0,1.0,5,3,2,3,8,0xb2d976f0
4768.84,1.0,11,2,2,3,7,0xb2d5cf85
50001.03,2.0,48,2,3,2,7,0xb2d60afed
905155.4,3.0,17,4,4,2,10,0xb2d45cfbd
3201.83,1.0,9,2,2,3,7,0xb2d50cfc
50001.48,3.0,52,2,4,2,8,0xb2d907f3
65270.0,2.0,0,3,3,4,10,0xb2d2f0d7
1509158.99,7.0,10,4,4,3,11,0xb2d1ae51d
100005.29,2.0,105,3,3,1,7,0xb2d95a71
2025.64,1.0,184,1,2,1,4,0xb2d3645dd
1018.18,1.0,92,1,2,1,4,0x3b9b3ddfd
100005.28,2.0,41,3,3,2,8,0xb2d9e42b
150278.02,2.0,133,3,3,1,7,0xb2d3711ed
226341.51,3.0,0,3,4,4,11,0xb2d3954d
110147.0,5.0,0,3,4,4,11,0xb2d6fc19
201158.24,3.0,42,3,4,2,9,0xb2d78db9d
495010.06,3.0,28,4,4,2,10,0xb2d78566d
204265.75,2.0,187,3,3,1,7,0xb2d6ac8cd
2451.53,1.0,11,1,2,3,6,0xb2d58507
37000.0,2.0,6,2,3,3,8,0xb2d17b23
150000.37,3.0,4,3,4,4,11,0xb2d9ef6f
60110.19,1.0,0,3,2,4,9,0xb2d2f7e1
40.81,1.0,2,1,2,4,7,0xb2d29a21d
3223.98,1.0,5,2,2,3,7,0xb2d2602fd
3227.1,1.0,0,2,2,4,8,0xb2d2af89
3665.18,1.0,184,2,2,1,5,0xb2d5e61a
34.16,1.0,79,1,2,1,4,0xb2d45484
130401.6,4.0,4,3,4,4,11,0xb2da049a
132.9,1.0,19,1,2,2,5,0xb2d18056
4.09,1.0,16,1,2,2,5,0xb2d5f597
7721.58,1.0,184,2,2,1,5,0xb2d20502d
7.28,1.0,113,1,2,1,4,0xb2d2e605d
3033841.52,13.0,2,4,4,4,12,0xb2d22ed1d
435061.09,5.0,11,4,4,3,11,0xb2d0d177
282.13,1.0,10,1,2,3,6,0xb2d91e11
514857.4,2.0,41,4,3,2,9,0xb2d58ef9d
200002.52,2.0,19,3,3,2,8,0xb2d78fc2d
2532.23,1.0,0,1,2,4,7,0xb2d2f95fd
1874.62,1.0,18,1,2,2,5,0xb2d5b342d
1011219.55,3.0,21,4,4,2,10,0xb2d6bf16
2339.12,1.0,184,1,2,1,4,0xb2d3792fd
53931.3,2.0,6,3,3,3,9,0xb2d41c4cd
30003.39,2.0,32,2,3,2,7,0xb2d13783
45068.3,2.0,92,2,3,1,6,0xb2d444cc
510023.22,4.0,39,4,4,2,10,0xb2d10d5ad
3755.82,1.0,96,2,2,1,5,0xb2d2926dd
2981.49,1.0,0,2,2,4,8,0xb2d33f10d
58733.54,3.0,5,3,4,3,10,0xb2d0e9a9
8.41,1.0,19,1,2,2,5,0xb2d60094
525203.12,4.0,63,4,4,2,10,0xb2d35d24
105297.9,1.0,14,3,2,3,8,0xb2d5e0c8d
505329.45,2.0,30,4,3,2,9,0xb2d8c3b9d
1014.68,1.0,46,1,2,2,5,0xb2d40b4dd
30012.6,1.0,34,2,2,2,6,0xb2d98478
30000.0,2.0,3,2,3,4,9,0xb2d40f87
121656.74,2.0,8,3,3,3,9,0xb2d3ff3f
153180.71,2.0,0,3,3,4,10,0xb2d54b38d
10836.95,1.0,41,2,2,2,6,0xb2d28a24d
1880029.36,4.0,27,4,4,2,10,0xb2d8f2c0
77.84,1.0,5,1,2,3,6,0xb2d28ea8
222395.55,4.0,6,3,4,3,10,0xb2d980fad
634.2,2.0,184,1,3,1,5,0xb2d24897
500002.09,2.0,18,4,3,2,9,0xb2d422e2
5223.81,1.0,77,2,2,1,5,0xb2d68302
373.03,1.0,62,1,2,2,5,0xb2d6f7c8
92342.63,2.0,15,3,3,3,9,0xb2d31ddbd
372.77,1.0,15,1,2,3,6,0xb2d38ca3d
8529.34,1.0,2,2,2,4,8,0xb2d558c1
6536.18,1.0,0,2,2,4,8,0xb2d1fbde
638.38,1.0,22,1,2,2,5,0xb2d62da7d
13.22,1.0,112,1,2,1,4,0xb2d9476cd
1270048.78,3.0,144,4,4,1,9,0xb2d495a7
180037.77,3.0,116,3,4,1,8,0xb2d451b5d
500000.01,2.0,11,4,3,3,10,0xb2d78661
2786.64,3.0,184,1,4,1,6,0x3b9b1b5a
227470.99,3.0,17,3,4,2,9,0xb2d4927cd
0.0,1.0,1,1,2,4,7,0xb2d90f9b
62226.09,2.0,24,3,3,2,8,0xb2d5c70ed
2251.99,1.0,0,1,2,4,7,0xb2d6d07ad
700081.18,3.0,39,4,4,2,10,0xb2d12c9fd
1501.38,1.0,92,1,2,1,4,0xb2d0da5fd
3094.07,1.0,295,2,2,1,5,0xb2d150e8d
1909386.1,3.0,10,4,4,3,11,0xb2d26156
40008.03,4.0,12,2,4,3,9,0xb2d68b43d
62053.14,2.0,111,3,3,1,7,0xb2d68102
8603.44,1.0,3,2,2,4,8,0xb2d6c265d
27001.78,6.0,8,2,4,3,9,0xb2d170c4d
11.06,1.0,2,1,2,4,7,0xb2d37c86
2929.61,1.0,92,2,2,1,5,0xb2d2adb0
306884.85,6.0,0,4,4,4,12,0xb2d09fc2d
217136.28,1.0,24,3,2,2,7,0xb2d69528
181538.01,1.0,88,3,2,1,6,0xb2d267b8d
44112.08,2.0,17,2,3,2,7,0xb2d09077
5910.27,1.0,0,2,2,4,8,0xb2d8e058
366951.47,3.0,77,4,4,1,9,0xb2d3c965d
72.31,1.0,9,1,2,3,6,0xb2d5897b
50002.64,2.0,209,2,3,1,6,0xb2d68663
26837.11,1.0,30,2,2,2,6,0xb2d0f98ed
330869.03,3.0,30,4,4,2,10,0xb2d25d84d
1229.06,1.0,6,1,2,3,6,0xb2d535d9
2655.92,1.0,2,1,2,4,7,0xb2d0ba8bd
310027.29,6.0,1,4,4,4,12,0xb2d1c096d
9739.99,1.0,0,2,2,4,8,0xb2d69f69
10.68,1.0,7,1,2,3,6,0xb2d26d62d
368.77,1.0,1,1,2,4,7,0xb2d62829
70052.29,2.0,0,3,3,4,10,0xb2d2a079d
779320.28,10.0,10,4,4,3,11,0xb2d603f1
1000021.05,3.0,0,4,4,4,12,0xb2d700aed
122496.36,2.0,0,3,3,4,10,0xb2d5d4a9d
3000327.22,1.0,0,4,2,4,10,0xb2d88f5bd
1002.46,1.0,92,1,2,1,4,0xb2d65575
15184.0,3.0,2,2,4,4,10,0x3b9b0e7dd
595.23,1.0,9,1,2,3,6,0xb2d9d59a
12.81,1.0,1,1,2,4,7,0xb2d6bdf3
100001.06,2.0,7,3,3,3,9,0xb2da4d0e
40056.3,3.0,63,2,4,2,8,0xb2d64500
300005.7,3.0,13,3,4,3,10,0xb2d9cdb3
986278.38,6.0,66,4,4,2,10,0xb2d4cc20d
96.41,1.0,13,1,2,3,6,0xb2d974f9
200710.42,2.0,32,3,3,2,8,0xb2d8f86f
53.16,1.0,2,1,2,4,7,0xb2d7689c
70485.55,2.0,252,3,3,1,7,0xb2d65688d
17018.09,1.0,0,2,2,4,8,0xb2d6a685
501008.62,2.0,74,4,3,1,8,0xb2d99d96
1301873.7,3.0,2,4,4,4,12,0xb2d534a8
1446.89,1.0,92,1,2,1,4,0xb2d1bb34
105.26,1.0,7,1,2,3,6,0xb2d984f8
60005.86,3.0,18,3,4,2,9,0xb2da025e
68002.83,3.0,28,3,4,2,9,0xb2d9a0b6
70974.29,1.0,0,3,2,4,9,0xb2d2ff00
12263.91,1.0,4,2,2,4,8,0xb2d3494b
695000.13,2.0,13,4,3,3,10,0xb2d91b58d
1144.94,1.0,184,1,2,1,4,0xb2d2f979d
601828.85,2.0,4,4,3,4,11,0xb2d657c7
74.27,1.0,50,1,2,2,5,0xb2d54185d
258712.14,5.0,67,3,4,1,8,0xb2d104d1d
34937.93,1.0,5,2,2,3,7,0xb2d1cf6b
500069.27,2.0,21,4,3,2,9,0xb2d5fc33d
200019.81,2.0,1,3,3,4,10,0xb2d8c9aad
85.27,1.0,51,1,2,2,5,0xb2d869d5
250890.8,2.0,44,3,3,2,8,0xb2d9e3fe
50002.64,2.0,13,2,3,3,8,0xb2da32d9
20377.29,1.0,181,2,2,1,5,0xb2d5f588d
1523.39,1.0,3,1,2,4,7,0xb2d30b70
101989.04,2.0,92,3,3,1,7,0xb2d1d3eed
80000.84,2.0,92,3,3,1,7,0xb2d97fc2d
520.72,1.0,9,1,2,3,6,0xb2d67d46
1097.05,2.0,184,1,3,1,5,0xb2d392cd
207084.24,1.0,95,3,2,1,6,0xb2d11e90d
50009.75,2.0,189,2,3,1,6,0xb2d5fca1
100005.29,2.0,189,3,3,1,7,0xb2d8243cd
217151.32,2.0,104,3,3,1,7,0xb2d165a7d
13487.78,1.0,19,2,2,2,6,0xb2d8c49a
922399.6,2.0,0,4,3,4,11,0xb2d6af32d
1351.33,1.0,8,1,2,3,6,0xb2d300e7
697828.76,12.0,4,4,4,4,12,0xb2d724c9
650072.57,3.0,18,4,4,2,10,0xb2d8d37c
342094.75,4.0,106,4,4,1,9,0xb2d11cc9
273.8,1.0,0,1,2,4,7,0xb2d1f47b
608245.05,6.0,1,4,4,4,12,0xb2d09d21
157877.76,2.0,0,3,3,4,10,0xb2d0d8b5
850.07,1.0,14,1,2,3,6,0xb2d75521
423917.63,3.0,85,4,4,1,9,0xb2d37ea5
12585.21,1.0,5,2,2,3,7,0xb2d481c1
10657.15,1.0,10,2,2,3,7,0xb2d20678d
408223.08,10.0,1,4,4,4,12,0xb2d5fdcb
364024.85,3.0,203,4,4,1,9,0xb2d27e88d
226330.61,5.0,11,3,4,3,10,0xb2d4d4d4
53400.32,3.0,12,3,4,3,10,0xb2d1afabd
50000.53,2.0,52,2,3,2,7,0xb2d90c60d
8415304.04,21.0,3,4,4,4,12,0xb2d218e8d
111610.9,1.0,184,3,2,1,6,0xb2d08f7ed
10000.11,2.0,97,2,3,1,6,0xb2d85960d
6407.19,1.0,0,2,2,4,8,0xb2d58b99d
60878.91,2.0,2,3,3,4,10,0xb2d6739ad
1179.14,1.0,184,1,2,1,4,0x3b9b3983d
32.13,15.0,14,1,4,3,8,0xb2d0a6c7
227655.12,3.0,3,3,4,4,11,0xb2d14b9b
56183.39,2.0,47,3,3,2,8,0xb2d68f32
889.24,1.0,70,1,2,1,4,0xb2d3c1f0
10000.11,2.0,6,2,3,3,8,0xb2d928da
1000003.0,2.0,1,4,3,4,11,0xb2da4831
179.56,2.0,7,1,3,3,7,0xb2d9fae8
2073006.38,3.0,15,4,4,3,11,0xb2d6058fd
430035.4,6.0,11,4,4,3,11,0xb2d68298d
50026.54,2.0,5,2,3,3,8,0xb2d98ce5
15134.2,2.0,39,2,3,2,7,0xb2d360a3
2137.65,1.0,9,1,2,3,6,0xb2d40455
480006.7,6.0,3,4,4,4,12,0xb2d550dc
520833.02,4.0,18,4,4,2,10,0xb2d423a8d
11.24,1.0,7,1,2,3,6,0xb2d37ce1
1350928.04,3.0,2,4,4,4,12,0xb2d3fddfd
2424.04,1.0,9,1,2,3,6,0xb2d2200c
2633256.05,11.0,3,4,4,4,12,0xb2d575fc
1879830.51,5.0,58,4,4,2,10,0xb2d949b4
60057.76,2.0,11,3,3,3,9,0xb2d69d06
32724.6,1.0,10,2,2,3,7,0xb2d2b7b4
0.33,1.0,13,1,2,3,6,0xb2d69fdf
110003.11,3.0,15,3,4,3,10,0xb2d655da
1151436.37,5.0,6,4,4,3,11,0xb2d0f7b1
1071.66,1.0,185,1,2,1,4,0xb2d382b9
23651.63,1.0,1,2,2,4,8,0xb2d67f98d
60000.64,3.0,39,3,4,2,9,0xb2d9e107
71244.7,1.0,0,3,2,4,9,0xb2d5e39fd
1837.21,1.0,0,1,2,4,7,0xb2d97063
47.43,1.0,15,1,2,3,6,0xb2d6ca47
1451210.28,3.0,4,4,4,4,12,0xb2d51a1f
208693.66,2.0,94,3,3,1,7,0xb2d411d0
6.75,1.0,11,1,2,3,6,0xb2d617bd
2132926.53,4.0,2,4,4,4,12,0xb2d2e6fad
150000.0,2.0,3,3,3,4,10,0xb2d97341d
23091.18,1.0,184,2,2,1,5,0xb2d60eb4d
3729.67,1.0,16,2,2,2,6,0xb2d17630
1959.56,1.0,27,1,2,2,5,0xb2d5cb27
10012.85,4.0,18,2,4,2,8,0xb2d08ed7
100089.88,2.0,90,3,3,1,7,0xb2d188e0d
100510.81,2.0,4,3,3,4,10,0xb2d6eca5
32017.52,2.0,74,2,3,1,6,0xb2d81615d
240799.2,2.0,35,3,3,2,8,0xb2d4734ad
4500001.0,2.0,6,4,3,3,10,0xb2da58f3
263981.29,5.0,4,3,4,4,11,0xb2d175fed
81.68,1.0,11,1,2,3,6,0xb2d90ac6
210321.94,2.0,8,3,3,3,9,0xb2d6fd7ad
511.75,1.0,3,1,2,4,7,0xb2d591d2
61.14,1.0,2,1,2,4,7,0xb2d6b608
800023.25,3.0,53,4,4,2,10,0xb2d95ccdd
380025.28,4.0,17,4,4,2,10,0xb2d2f6d1d
14219298.87,1.0,4,4,2,4,10,0xb2d4deacd
50002.41,3.0,23,2,4,2,8,0xb2d5c5dfd
390855.06,1.0,0,4,2,4,10,0xb2d64a47
434.22,1.0,18,1,2,2,5,0xb2d1f6f9
343049.73,5.0,102,4,4,1,9,0xb2d3f20e
26.67,1.0,188,1,2,1,4,0xb2d268b5d
995088.11,16.0,20,4,4,2,10,0xb2d5bd73d
45129.38,2.0,4,2,3,4,9,0xb2d96f19d
1017.64,2.0,184,1,3,1,5,0xb2d081e5d
100000.0,2.0,4,3,3,4,10,0xb2da5675
282512.88,4.0,3,3,4,4,11,0xb2d9c2db
510650.76,2.0,80,4,3,1,8,0xb2d56627
204325.91,2.0,43,3,3,2,8,0xb2d069f7
851.39,1.0,0,1,2,4,7,0xb2d284add
136937.32,2.0,14,3,3,3,9,0xb2d1b992
2.33,1.0,4,1,2,4,7,0xb2d11860d
24024.19,1.0,13,2,2,3,7,0xb2d6a9ed
5064.87,1.0,5,2,2,3,7,0xb2d1c10b
50700.0,2.0,8,2,3,3,8,0xb2da493c
14833.94,1.0,18,2,2,2,6,0xb2d979b8
162955.18,4.0,102,3,4,1,8,0xb2d487c2
100001.06,2.0,92,3,3,1,7,0xb2d646b1d
5978.06,1.0,0,2,2,4,8,0xb2d39528d
210277.06,4.0,3,3,4,4,11,0xb2d58b89d
0.5,1.0,3,1,2,4,7,0xb2d26696
0.0,1.0,3,1,2,4,7,0xb2d95692
251.11,2.0,92,1,3,1,5,0x3b9b12e4
102251.98,1.0,4,3,2,4,9,0xb2d78a91d
122.03,1.0,1,1,2,4,7,0xb2d4f7d5
200234.74,2.0,0,3,3,4,10,0xb2d2cf94
240000.0,2.0,6,3,3,3,9,0xb2d8e762
700014.14,8.0,1,4,4,4,12,0xb2d69e3a
1002.47,1.0,92,1,2,1,4,0xb2d60229
5000000.0,2.0,92,4,3,1,8,0xb2d5aa8a
161026.53,1.0,5,3,2,3,8,0xb2d5991a
1128294.59,8.0,6,4,4,3,11,0xb2d2acc0d
199923.5,3.0,77,3,4,1,8,0xb2d50cbf
904202.15,4.0,1,4,4,4,12,0xb2d41b8f
1.76,1.0,10,1,2,3,6,0xb2d6e61bd
5.65,1.0,19,1,2,2,5,0xb2d3107f
1300000.0,11.0,4,4,4,4,12,0xb2d5a9f4
6.1,1.0,49,1,2,2,5,0xb2d785a2
171918.2,1.0,10,3,2,3,8,0xb2d6a2c7
1042.83,4.0,92,1,4,1,6,0x3b9b4936
2679.94,1.0,0,1,2,4,7,0xb2d0f3f6
560256.63,4.0,11,4,4,3,11,0xb2d147ad
23.52,1.0,15,1,2,3,6,0xb2d4a53d
310730.59,2.0,1,4,3,4,11,0xb2d17d66
27134.6,1.0,31,2,2,2,6,0xb2d39b77
619000.69,14.0,3,4,4,4,12,0xb2d242f1d
10000.53,2.0,13,2,3,3,8,0xb2da3389
20000.63,2.0,24,2,3,2,7,0xb2d946ed
60009.76,2.0,11,3,3,3,9,0xb2d35b5c
120071.2,3.0,24,3,4,2,9,0xb2d45e2a
210316.28,3.0,10,3,4,3,10,0xb2d428f4
289197.58,1.0,0,3,2,4,9,0xb2d382e6d
100615.13,3.0,55,3,4,2,9,0xb2d6ce32d
1352.04,1.0,48,1,2,2,5,0xb2d58f9cd
202460.7,2.0,181,3,3,1,7,0xb2d1845cd
40971.6,3.0,77,2,4,1,7,0xb2d47f21
125.99,1.0,0,1,2,4,7,0xb2d3f161
17.7,1.0,12,1,2,3,6,0xb2d698edd
20000.43,3.0,31,2,4,2,8,0xb2d90b66d
51988.53,3.0,29,2,4,2,8,0x3b9b35cf
0.32,1.0,14,1,2,3,6,0xb2da2565
1257.81,1.0,184,1,2,1,4,0xb2d25124d
329264.33,3.0,25,4,4,2,10,0xb2d5c5aed
301294.13,5.0,80,4,4,1,9,0xb2d18c69
966.37,1.0,14,1,2,3,6,0xb2d27a8f
60086.95,4.0,0,3,4,4,11,0xb2d18180
576422.85,5.0,0,4,4,4,12,0xb2d30f9d
424591.01,2.0,70,4,3,1,8,0xb2d5b2c2d
54817.41,1.0,4,3,2,4,9,0xb2d18f47
24.93,2.0,4,1,3,4,8,0xb2d42e71
52.14,1.0,62,1,2,2,5,0xb2d99c83
141023.28,1.0,131,3,2,1,6,0xb2d1de94
1309.7,1.0,69,1,2,1,4,0xb2d16b59d
2407.41,1.0,9,1,2,3,6,0xb2d43d8e
310232.66,26.0,0,4,4,4,12,0x3b9af1bbd
7283.58,3.0,1,2,4,4,10,0x3b9af220d
1003574.52,2.0,30,4,3,2,9,0xb2d982ddd
500744.88,3.0,5,4,4,3,11,0xb2d9acaa
617.9,1.0,1,1,2,4,7,0xb2d52bf5d
1144073.97,6.0,104,4,4,1,9,0xb2d09547d
310013.11,2.0,213,4,3,1,8,0xb2d681e8d
420000.0,2.0,29,4,3,2,9,0xb2da0a70
155829.32,3.0,0,3,4,4,11,0xb2d4191fd
330746.78,4.0,0,4,4,4,12,0xb2d14129
54555.23,5.0,4,3,4,4,11,0xb2d084bbd
100015.0,2.0,93,3,3,1,7,0xb2d56ca0d
5030.11,1.0,164,2,2,1,5,0xb2d251e5
90016.71,2.0,42,3,3,2,8,0xb2d56853
534693.57,2.0,256,4,3,1,8,0xb2d2bbba
210000.25,3.0,9,3,4,3,10,0xb2d6486d
100009.12,3.0,132,3,4,1,8,0xb2d11d97d
7773.06,1.0,0,2,2,4,8,0xb2d981a2
254249.57,3.0,74,3,4,1,8,0xb2d5f204
50000.0,2.0,0,2,3,4,9,0xb2d40494
3321.96,3.0,5,2,4,3,9,0x3b9b2fa4
585590.2,6.0,0,4,4,4,12,0x3b9b18e4
114975.05,1.0,129,3,2,1,6,0xb2d24624
70752.92,3.0,33,3,4,2,9,0xb2d06c3ed
4672.23,1.0,2,2,2,4,8,0xb2d20e0a
55.46,1.0,14,1,2,3,6,0xb2d0c60b
119217.67,3.0,97,3,4,1,8,0xb2d22532d
203493.87,2.0,0,3,3,4,10,0xb2d61b4ad
4.31,1.0,56,1,2,2,5,0xb2d946e8
1360888.58,1.0,92,4,2,1,7,0xb2d10abbd
132342.07,2.0,8,3,3,3,9,0xb2d15759d
430313.09,3.0,19,4,4,2,10,0xb2d61c0c
50413.77,1.0,2,2,2,4,8,0xb2d31954d
53354.84,4.0,0,3,4,4,11,0xb2d4baf0d
5043.29,1.0,92,2,2,1,5,0xb2d2d132d
1004.28,1.0,12,1,2,3,6,0xb2d69e7b
2075.95,1.0,110,1,2,1,4,0xb2d26fbdd
45005.42,2.0,91,2,3,1,6,0xb2d6a4a3
200680.53,2.0,1,3,3,4,10,0xb2d5cbf4d
34.72,1.0,44,1,2,2,5,0xb2d99f6c
100061.22,2.0,111,3,3,1,7,0xb2d3b3f6d
89.29,1.0,5,1,2,3,6,0xb2d7fcc5d
200000.0,2.0,1,3,3,4,10,0xb2d980ebd
1.95,1.0,77,1,2,1,4,0xb2d820b3d
40633.35,1.0,15,2,2,3,7,0xb2d39058
450009.2,4.0,0,4,4,4,12,0xb2d1df57
3.59,2.0,83,1,3,1,5,0xb2d0e0ca
103011.08,2.0,96,3,3,1,7,0xb2d3cbd9
50002.64,2.0,41,2,3,2,7,0xb2d9e652
130039.31,2.0,87,3,3,1,7,0xb2d06b2d
20185.94,1.0,41,2,2,2,6,0xb2d26e81d
0.6,1.0,68,1,2,1,4,0xb2d52a38
68765.23,2.0,18,3,3,2,8,0xb2d202d8d
12406.7,1.0,1,2,2,4,8,0xb2d3d876d
51.19,1.0,14,1,2,3,6,0xb2d94d41
28043830.36,18.0,6,4,4,3,11,0xb2d14d69d
430019.74,2.0,203,4,3,1,8,0xb2d6a346d
10.55,1.0,75,1,2,1,4,0xb2d8f5a9
5377.81,1.0,184,2,2,1,5,0xb2d2b081
393544.18,4.0,0,4,4,4,12,0xb2d22b3d
1723.34,1.0,0,1,2,4,7,0xb2d9bca6
1291.23,1.0,184,1,2,1,4,0xb2d0da65d
683854.94,7.0,1,4,4,4,12,0xb2d53cc9
3242.33,1.0,77,2,2,1,5,0xb2d683c5d
667072.44,7.0,0,4,4,4,12,0xb2d071e1d
100097.35,2.0,63,3,3,2,8,0xb2d36089
21595.84,1.0,5,2,2,3,7,0xb2d68ff4d
50439.48,5.0,25,2,4,2,8,0xb2d92081d
108083.23,2.0,74,3,3,1,7,0xb2d36fd3d
211539.43,1.0,264,3,2,1,6,0xb2d43059d
56982.66,1.0,0,3,2,4,9,0xb2d2b209d
31091.2,2.0,97,2,3,1,6,0xb2d61549
3019.37,2.0,92,2,3,1,6,0xb2d3eed4d
251786.12,2.0,15,3,3,3,9,0xb2d6940a
130105.58,7.0,1,3,4,4,11,0xb2d0a5c0
650197.86,5.0,13,4,4,3,11,0xb2d95e2e
1.32,1.0,61,1,2,2,5,0xb2d59c2f
1.51,1.0,4,1,2,4,7,0xb2d078ae
500000.0,4.0,27,4,4,2,10,0x3b9b2598d
278.03,1.0,9,1,2,3,6,0xb2d364f5
401457.65,3.0,33,4,4,2,10,0xb2d6eb66d
165003.48,2.0,74,3,3,1,7,0xb2d99c5a
30355.94,2.0,28,2,3,2,7,0xb2d0a589
13006.58,1.0,0,2,2,4,8,0xb2d6a685d
750011.03,8.0,0,4,4,4,12,0xb2d560dfd
54009.85,2.0,0,3,3,4,10,0xb2d22d04
660.39,3.0,92,1,4,1,6,0xb2d16b28
661.02,3.0,184,1,4,1,6,0xb2d16b28d
1720049.04,3.0,181,4,4,1,9,0xb2d697b1
690499.78,10.0,3,4,4,4,12,0xb2d280f5
74736.07,1.0,11,3,2,3,8,0xb2d94f3d
1968.48,1.0,184,1,2,1,4,0xb2d28755d
20298.26,1.0,0,2,2,4,8,0xb2d15b16
60001.27,2.0,25,3,3,2,8,0xb2da11e8
8381.09,1.0,3,2,2,4,8,0xb2d6e8b7d
30380.62,1.0,184,2,2,1,5,0xb2d22743
10316.8,1.0,1,2,2,4,8,0xb2d3bc5bd
3546.16,2.0,184,2,3,1,6,0xb2d073d2d
25178.44,2.0,92,2,3,1,6,0xb2d64d45d
150324.61,2.0,29,3,3,2,8,0xb2d5a839
302.88,1.0,13,1,2,3,6,0xb2d4b04ad
15.2,2.0,81,1,3,1,5,0xb2d9206ed
1156703.3,11.0,0,4,4,4,12,0xb2d1fef5d
61638.31,3.0,119,3,4,1,8,0x3b9ad6acd
0.57,3.0,27,1,4,2,7,0xb2d07d48
396.0,1.0,5,1,2,3,6,0xb2d57bee
164415.02,4.0,19,3,4,2,9,0xb2d22e2a
103809.55,7.0,80,3,4,1,8,0xb2d19f1dd
7.89,1.0,75,1,2,1,4,0xb2d2c0c9
1960622.09,5.0,70,4,4,1,9,0xb2d1c758d
746092.94,6.0,5,4,4,3,11,0xb2d26836
530701.93,6.0,0,4,4,4,12,0xb2d148cdd
235696.72,21.0,0,3,4,4,11,0x3b9b44c7
240000.0,2.0,3,3,3,4,10,0xb2d97854d
150693.28,3.0,111,3,4,1,8,0xb2d54fc1
120074.54,2.0,196,3,3,1,7,0xb2d5c1ed
200714.18,2.0,18,3,3,2,8,0xb2d91280d
16794.66,1.0,0,2,2,4,8,0xb2d6b13ad
644872.48,5.0,87,4,4,1,9,0xb2d1a2ca
310000.0,2.0,6,4,3,3,10,0xb2d97377
220000.0,2.0,28,3,3,2,8,0xb2da0d54
1510.27,1.0,92,1,2,1,4,0xb2d108dcd
1814119.62,3.0,97,4,4,1,9,0xb2d319f8
10068.18,1.0,0,2,2,4,8,0xb2d65c28d
0.77,1.0,6,1,2,3,6,0xb2d6b4c6d
75.63,1.0,9,1,2,3,6,0xb2d9e359
600000.24,5.0,1,4,4,4,12,0xb2d6d175
500000.0,3.0,11,4,4,3,11,0xb2d951a7
150250.85,2.0,143,3,3,1,7,0xb2d186e8
562330.27,5.0,32,4,4,2,10,0xb2d0831a
34007.81,1.0,7,2,2,3,7,0xb2d3c2dad
198.7,1.0,9,1,2,3,6,0xb2d6e8d5
229790.12,2.0,31,3,3,2,8,0xb2d591c5d
92.49,1.0,74,1,2,1,4,0xb2d64052
660002.46,4.0,18,4,4,2,10,0xb2d17139d
1831.71,1.0,3,1,2,4,7,0xb2d3622a
1851.85,1.0,26,1,2,2,5,0xb2d20f34
11.61,1.0,42,1,2,2,5,0xb2d9bb1a
316078.52,5.0,3,4,4,4,12,0xb2d58177d
0.0,1.0,6,1,2,3,6,0xb2d8d5d3d
155665.66,1.0,184,3,2,1,6,0xb2d17b39d
1021.25,1.0,1,1,2,4,7,0xb2d2b5e0d
2476.94,1.0,5,1,2,3,6,0xb2d3a0ae
3.0,1.0,4,1,2,4,7,0xb2d1cf5ed
20371.31,2.0,154,2,3,1,6,0xb2d5b821
817.28,1.0,0,1,2,4,7,0xb2d43935d
115043.45,3.0,11,3,4,3,10,0xb2d50a19d
7494.78,1.0,4,2,2,4,8,0xb2d2b457
5117.01,1.0,9,2,2,3,7,0xb2d3b9a4
19728.29,1.0,184,2,2,1,5,0xb2d30d87d
277.63,1.0,20,1,2,2,5,0xb2d93842d
840051.93,7.0,9,4,4,3,11,0xb2d5ff92
4115.67,1.0,9,2,2,3,7,0xb2d31909d
162930.13,1.0,0,3,2,4,9,0xb2d5dbe3d
80286.17,4.0,10,3,4,3,10,0xb2d08bd9d
50077.33,1.0,74,2,2,1,5,0xb2d2977cd
100092.56,1.0,1,3,2,4,9,0xb2d8f826
200719.55,2.0,22,3,3,2,8,0xb2d6b475
60565.34,2.0,0,3,3,4,10,0xb2d5b13e
50002.11,2.0,133,2,3,1,6,0xb2d91f9a
160926.06,1.0,184,3,2,1,6,0xb2d23301d
9437.07,1.0,0,2,2,4,8,0xb2d8daa9
400020.18,2.0,102,4,3,1,8,0xb2d3c27ad
50000.53,2.0,39,2,3,2,7,0xb2d9f1e2
240000.66,7.0,13,3,4,3,10,0xb2d142c6d
26.6,1.0,77,1,2,1,4,0xb2d956c9d
200009.5,3.0,76,3,4,1,8,0xb2d1b93dd
260003.79,4.0,83,3,4,1,8,0xb2d127a2
53265.05,2.0,74,3,3,1,7,0xb2d29450
13.22,1.0,9,1,2,3,6,0xb2d54cd7
36.56,1.0,3,1,2,4,7,0xb2da07f7
7579.46,1.0,165,2,2,1,5,0xb2d5d2fc
1139.97,1.0,9,1,2,3,6,0xb2d6d308d
1084.51,1.0,0,1,2,4,7,0xb2d96868
10071.39,1.0,184,2,2,1,5,0xb2d2eec5
601166.21,12.0,3,4,4,4,12,0xb2d2891bd
31157.34,1.0,112,2,2,1,5,0xb2d6bdd2
1001445.93,3.0,52,4,4,2,10,0xb2d1d1b6d
25.39,1.0,6,1,2,3,6,0xb2d6bc20
3635.04,1.0,5,2,2,3,7,0xb2d439fd
1143004.38,10.0,25,4,4,2,10,0xb2d0b552d
2566.18,1.0,0,1,2,4,7,0xb2d95054
7373.61,1.0,0,2,2,4,8,0xb2d707ed
500010.36,2.0,3,4,3,4,11,0xb2d6e655d
500026.57,2.0,209,4,3,1,8,0xb2d24c7e
45235.1,3.0,0,2,4,4,10,0x3b9b29df
131489.82,3.0,0,3,4,4,11,0xb2d62fba
48168.8,1.0,0,2,2,4,8,0xb2d6330fd
4017.61,9.0,0,2,4,4,10,0xb2d0ad4a
468039.53,11.0,39,4,4,2,10,0xb2d560b7
217212.71,2.0,200,3,3,1,7,0xb2d68b33d
1109.99,1.0,120,1,2,1,4,0xb2d4bd13
1000029.24,4.0,7,4,4,3,11,0xb2d6141f
4513.47,1.0,9,2,2,3,7,0xb2d5a9ec
214020.91,2.0,62,3,3,2,8,0x3b9af6fe
103170.2,1.0,3,3,2,4,9,0xb2d2fab5d
0.69,1.0,5,1,2,3,6,0xb2d30105
720510.2,6.0,11,4,4,3,11,0xb2d172fa
474724.39,3.0,0,4,4,4,12,0xb2d8d15dd
18676328.91,9.0,0,4,4,4,12,0xb2d68141
30995.06,2.0,11,2,3,3,8,0xb2d66b23d
645122.15,4.0,13,4,4,3,11,0xb2d6944ed
130004.36,3.0,8,3,4,3,10,0xb2d3fcffd
10001.02,1.0,9,2,2,3,7,0xb2d8e3f5
60202.32,2.0,32,3,3,2,8,0xb2d9ffb2
692.52,1.0,24,1,2,2,5,0xb2d3aae2
11703.75,1.0,41,2,2,2,6,0xb2d6b5f6d
121.99,1.0,11,1,2,3,6,0xb2d1e652d
3431.01,6.0,4,2,4,4,10,0xb2d4057bd
345530.27,4.0,0,4,4,4,12,0xb2d1558bd
586023.34,4.0,22,4,4,2,10,0xb2d4c7e6
370520.05,5.0,1,4,4,4,12,0xb2d4439d
150004.75,4.0,92,3,4,1,8,0xb2d90f4fd
40502.53,6.0,6,2,4,3,9,0xb2d582de
145812.85,1.0,121,3,2,1,6,0xb2d35adcd
38800.58,1.0,4,2,2,4,8,0xb2d42b42
158853.89,1.0,5,3,2,3,8,0xb2d3af13d
139.71,1.0,5,1,2,3,6,0xb2d92ab2
105529.29,2.0,202,3,3,1,7,0xb2d3c3a9
1744.22,1.0,184,1,2,1,4,0xb2d4dcf3
533.73,3.0,23,1,4,2,7,0xb2d064f5
20086.79,3.0,182,2,4,1,7,0xb2d56af8
150000.53,3.0,3,3,4,4,11,0xb2d921f5
521150.3,6.0,7,4,4,3,11,0x3b9b1a34d
491.52,1.0,6,1,2,3,6,0xb2d91733
120004.24,3.0,10,3,4,3,10,0xb2d5f6db
5081.97,8.0,0,2,4,4,10,0x3b9af12bd
2862.7,1.0,0,1,2,4,7,0xb2d52c3cd
106.55,1.0,2,1,2,4,7,0xb2d91d2e
7715.33,1.0,21,2,2,2,6,0xb2d963c6
647504.52,11.0,4,4,4,4,12,0xb2d10580
100924.22,2.0,56,3,3,2,8,0xb2d37c62d
514234.9,2.0,273,4,3,1,8,0xb2d150dcd
62058.85,2.0,19,3,3,2,8,0xb2da0076
300411.61,3.0,0,4,4,4,12,0xb2d916aad
216000.88,3.0,0,3,4,4,11,0xb2d28169
200119.5,3.0,102,3,4,1,8,0xb2d27647d
552048.76,5.0,5,4,4,3,11,0xb2d06309d
44.06,1.0,70,1,2,1,4,0xb2d3eaf9
22869.94,1.0,0,2,2,4,8,0xb2d0c59bd
210914.52,2.0,180,3,3,1,7,0xb2d17c3ad
540014.99,3.0,60,4,4,2,10,0xb2d976d4
77548.2,1.0,49,3,2,2,7,0xb2d39053d
2000.8,1.0,48,1,2,2,5,0xb2d9dec8
89.95,1.0,6,1,2,3,6,0xb2d6af2dd
650022.39,4.0,12,4,4,3,11,0xb2d76af8d
555659.34,6.0,8,4,4,3,11,0xb2d11b13
38342.71,1.0,1,2,2,4,8,0xb2d66086
1511153.7,7.0,7,4,4,3,11,0x3b9ad351d
30681.37,3.0,47,2,4,2,8,0xb2d8fc5fd
12459.45,1.0,12,2,2,3,7,0xb2d5c884
230010.54,4.0,18,3,4,2,9,0xb2d466ddd
21274.0,1.0,1,2,2,4,8,0xb2d347a8
30881.98,2.0,38,2,3,2,7,0xb2d61b09d
182187.54,3.0,6,3,4,3,10,0xb2d1a37d
901950.75,5.0,19,4,4,2,10,0xb2d47627d
134572.08,3.0,0,3,4,4,11,0xb2d103f7d
35179.08,3.0,83,2,4,1,7,0xb2d56ba2
1020.35,1.0,65,1,2,2,5,0xb2d76aba
250088.02,2.0,4,3,3,4,10,0xb2d9306e
2779.38,1.0,135,1,2,1,4,0xb2d07073d
3223753.35,9.0,18,4,4,2,10,0xb2d0c90a
354211.25,66.0,1,4,4,4,12,0xb2d16027
1200094.29,4.0,164,4,4,1,9,0xb2d1476b
9329.95,1.0,92,2,2,1,5,0xb2d22fcad
224955.72,1.0,21,3,2,2,7,0xb2d3eb43
15158.95,1.0,15,2,2,3,7,0xb2d94a40d
30095.64,2.0,55,2,3,2,7,0xb2d9c25b
71.07,4.0,3,1,4,4,9,0xb2d64c44
15579.54,2.0,0,2,3,4,9,0xb2d6b2f8
710005.63,6.0,13,4,4,3,11,0xb2d7c82b
201424.04,2.0,69,3,3,1,7,0xb2d992bd
2086.41,1.0,92,1,2,1,4,0xb2d373ec
19945.94,1.0,0,2,2,4,8,0xb2d6bb8ad
850018.76,4.0,4,4,4,4,12,0xb2d9eeb4
921228.82,7.0,9,4,4,3,11,0xb2d6a368d
412.54,1.0,0,1,2,4,7,0xb2d7912e
64201.24,3.0,42,3,4,2,9,0xb2d6103ad
307.51,2.0,20,1,3,2,6,0xb2d0c96bd
1806513.66,4.0,4,4,4,4,12,0xb2d118f7
5163.18,1.0,4,2,2,4,8,0xb2d16d09
180186.1,1.0,9,3,2,3,8,0xb2d6e099d
445.72,1.0,2,1,2,4,7,0xb2d89368
2154.53,1.0,0,1,2,4,7,0xb2d6b181d
22743.27,1.0,11,2,2,3,7,0xb2d4fde9d
383910.51,5.0,38,4,4,2,10,0xb2d0e007
34.08,2.0,101,1,3,1,5,0xb2d0b574d
130608.53,5.0,26,3,4,2,9,0xb2d578dfd
105741.48,2.0,193,3,3,1,7,0xb2d22509d
268.63,1.0,25,1,2,2,5,0x3b9b4935d
47.5,1.0,2,1,2,4,7,0xb2d34fecd
81015.49,2.0,123,3,3,1,7,0xb2d6b291
1323.3,1.0,170,1,2,1,4,0xb2d33154
25.94,1.0,34,1,2,2,5,0xb2d2a25e
9.81,1.0,54,1,2,2,5,0xb2d965a6
210000.53,3.0,14,3,4,3,10,0xb2d6300bd
104.99,2.0,73,1,3,1,5,0xb2d1857e
2153003.62,3.0,27,4,4,2,10,0xb2d94905d
250060.73,3.0,10,3,4,3,10,0xb2d60d03d
5873.3,1.0,3,2,2,4,8,0xb2d2e771d
40.84,1.0,11,1,2,3,6,0xb2d6a2bcd
3000000.84,3.0,1,4,4,4,12,0xb2d5da42d
2510127.49,9.0,77,4,4,1,9,0xb2d0a9e4d
457201.84,2.0,52,4,3,2,9,0xb2d14dd8
390405.13,3.0,0,4,4,4,12,0xb2d1fdc4
325008.18,3.0,24,4,4,2,10,0xb2d8fbbb
365793.21,10.0,1,4,4,4,12,0xb2d63817d
265078.25,4.0,189,3,4,1,8,0xb2d070d7d
70094.57,2.0,196,3,3,1,7,0xb2d50508d
19.73,1.0,4,1,2,4,7,0xb2d3e5bf
60040.52,2.0,108,3,3,1,7,0xb2d1f302d
1672.06,1.0,1,1,2,4,7,0xb2d34824
150066.93,2.0,263,3,3,1,7,0xb2d24be8
100265.3,2.0,60,3,3,2,8,0xb2d2fe50
484401.87,7.0,1,4,4,4,12,0xb2d1a0a2d
50341.01,2.0,34,2,3,2,7,0xb2d0afccd
74133.83,8.0,9,3,4,3,10,0x3b9af590
740010.24,15.0,8,4,4,3,11,0xb2d6a26ed
87.28,1.0,19,1,2,2,5,0xb2d3070b
3583.44,1.0,16,2,2,2,6,0xb2d21b19
350405.76,3.0,108,4,4,1,9,0xb2d6a10ad
3805.75,1.0,0,2,2,4,8,0xb2d824d7d
210462.63,1.0,7,3,2,3,8,0xb2d2e38ad
407108.47,2.0,36,4,3,2,9,0xb2d6da0a
5800329.59,5.0,21,4,4,2,10,0xb2d1e757d
390.9,1.0,25,1,2,2,5,0xb2d292e0
72.86,1.0,10,1,2,3,6,0xb2d5c1e0
2611651.59,6.0,14,4,4,3,11,0xb2d35c49d
48432.31,1.0,20,2,2,2,6,0xb2d77f4f
34.66,1.0,65,1,2,2,5,0xb2d164d3d
206596.87,4.0,1,3,4,4,11,0xb2d13267
20.19,1.0,25,1,2,2,5,0xb2d9a634
5422.65,2.0,1,2,3,4,9,0x3b9af2c2
330000.0,25.0,1,4,4,4,12,0xb2d4f290d
64896.58,2.0,45,3,3,2,8,0xb2d38d68d
551.7,1.0,99,1,2,1,4,0xb2d41956
8741.73,1.0,2,2,2,4,8,0xb2d20827d
505236.75,1.0,64,4,2,2,8,0xb2d63ee1
2002.82,1.0,6,1,2,3,6,0xb2d75b13
220000.0,2.0,31,3,3,2,8,0xb2da0958
470143.71,4.0,4,4,4,4,12,0xb2d6ef74
14333.08,1.0,1,2,2,4,8,0xb2d6f9c0d
1127.28,1.0,92,1,2,1,4,0xb2d5279a
18399.33,2.0,0,2,3,4,9,0xb2d2f8a5
10262.32,1.0,6,2,2,3,7,0xb2d7472c
1271.72,1.0,0,1,2,4,7,0xb2d6830c
12.22,1.0,24,1,2,2,5,0xb2d8dd07
700000.0,4.0,1,4,4,4,12,0xb2d9bd33
818.44,1.0,26,1,2,2,5,0xb2d09593d
216021.38,4.0,18,3,4,2,9,0xb2d09925d
18739.82,1.0,6,2,2,3,7,0xb2d6895ad
100669.96,3.0,27,3,4,2,9,0xb2d63eed
122.66,1.0,28,1,2,2,5,0xb2d3d3e6
55950.59,1.0,10,3,2,3,8,0xb2d33bbbd
89187.28,2.0,32,3,3,2,8,0xb2d579afd
1071.51,1.0,92,1,2,1,4,0xb2d2eaa6
16026.75,1.0,14,2,2,3,7,0xb2d6a196
511472.2,9.0,0,4,4,4,12,0xb2d2d4e2d
923.4,1.0,0,1,2,4,7,0xb2d296b8
996.28,1.0,6,1,2,3,6,0xb2d1a580d
1000177.5,1.0,1,4,2,4,10,0xb2d8fb6c
1960831.81,11.0,0,4,4,4,12,0xb2d4cec5d
317221.01,4.0,8,4,4,3,11,0xb2d4ebcbd
16000.17,2.0,133,2,3,1,6,0xb2d9236dd
10.16,1.0,69,1,2,1,4,0xb2d62fa5d
1133375.46,4.0,26,4,4,2,10,0xb2d43e98d
4.07,1.0,23,1,2,2,5,0xb2d5c70b
10213.29,1.0,184,2,2,1,5,0xb2d55d31d
161327.48,4.0,8,3,4,3,10,0xb2d5b285d
3.2,1.0,56,1,2,2,5,0xb2d4ec47d
334919.1,5.0,0,4,4,4,12,0xb2d6c6dbd
608342.59,2.0,0,4,3,4,11,0xb2d5b9ab
5026.2,1.0,21,2,2,2,6,0xb2d314fc
637006.34,10.0,7,4,4,3,11,0xb2d2d14e
19524.8,1.0,69,2,2,1,5,0xb2d310d5
89.43,1.0,4,1,2,4,7,0xb2d5b31a
51881.54,2.0,102,2,3,1,6,0xb2d5c735
50002.64,2.0,20,2,3,2,7,0xb2d92a8f
320.58,1.0,74,1,2,1,4,0xb2d2c98a
170620.23,4.0,0,3,4,4,11,0xb2d2b9a3
105145.25,4.0,2,3,4,4,11,0xb2d90759d
1019.86,1.0,184,1,2,1,4,0xb2d40cbd
27.44,1.0,9,1,2,3,6,0xb2d4163ad
475.92,1.0,20,1,2,2,5,0xb2d5da79d
1737.05,1.0,9,1,2,3,6,0xb2d6447cd
2729.73,1.0,9,1,2,3,6,0xb2d84443
15153.51,1.0,41,2,2,2,6,0xb2d8db8ed
204390.51,3.0,20,3,4,2,9,0xb2d60c21
82004.07,2.0,101,3,3,1,7,0xb2d1f280
200263.39,5.0,21,3,4,2,9,0xb2d593e5d
1016.82,1.0,184,1,2,1,4,0x3b9aee6fd
501432.0,3.0,15,4,4,3,11,0xb2d60451
200087.47,2.0,53,3,3,2,8,0xb2d772b8d
1041.21,1.0,24,1,2,2,5,0xb2d6d821
26.52,1.0,24,1,2,2,5,0xb2d8c371
300153.35,2.0,31,4,3,2,9,0xb2d57588d
100001.06,2.0,0,3,3,4,10,0xb2d9f0a0
40025.13,2.0,181,2,3,1,6,0xb2d5e70d
220152.89,3.0,0,3,4,4,11,0xb2d3f504
1591953.03,4.0,3,4,4,4,12,0xb2d43a33d
50043.33,2.0,70,2,3,1,6,0xb2d42560
1285320.32,12.0,0,4,4,4,12,0xb2d24112d
8.43,1.0,1,1,2,4,7,0xb2d09d81
3655281.87,6.0,14,4,4,3,11,0xb2d17c52
7681.73,1.0,14,2,2,3,7,0xb2d2141ad
100667.87,2.0,8,3,3,3,9,0xb2d6a12c
412084.58,11.0,18,4,4,2,10,0xb2d108e3d
1305007.38,16.0,20,4,4,2,10,0xb2d1794c
1341.83,1.0,0,1,2,4,7,0xb2d6940f
222190.51,3.0,79,3,4,1,8,0xb2d5a61b
230000.0,2.0,0,3,3,4,10,0xb2da6bb8
230039.29,5.0,47,3,4,2,9,0xb2d1ffb4
16014.39,1.0,9,2,2,3,7,0xb2d93643
482472.12,3.0,30,4,4,2,10,0xb2d2601cd
21.28,2.0,46,1,3,2,6,0x3b9af104
402126.73,3.0,22,4,4,2,10,0xb2d7efc6d
20139.13,1.0,143,2,2,1,5,0xb2d5896e
8738.9,1.0,2,2,2,4,8,0xb2d965b2
1040.23,1.0,18,1,2,2,5,0xb2d1188d
10267.49,1.0,6,2,2,3,7,0xb2d2b3a3d
80164.06,4.0,25,3,4,2,9,0xb2d9a287
1231.54,1.0,184,1,2,1,4,0xb2d427de
855014.57,14.0,0,4,4,4,12,0xb2d12847
82841.73,1.0,4,3,2,4,9,0xb2d62dcbd
20714.87,1.0,49,2,2,2,6,0xb2d68b98
266122.1,11.0,0,3,4,4,11,0xb2d47e76
2481.24,1.0,21,1,2,2,5,0xb2d1ea6e
50094.46,2.0,132,2,3,1,6,0xb2d657d5d
182350.72,3.0,108,3,4,1,8,0xb2d16c40
438052.35,5.0,9,4,4,3,11,0xb2d8f9cfd
899841.74,17.0,8,4,4,3,11,0xb2d35327
9.4,1.0,61,1,2,2,5,0xb2d31e0a
654403.03,2.0,102,4,3,1,8,0x3b9b3a0ed
1734.79,1.0,149,1,2,1,4,0xb2d8e1acd
500000.08,2.0,10,4,3,3,10,0xb2d9a830
611171.55,3.0,18,4,4,2,10,0xb2d622af
5438.04,1.0,0,2,2,4,8,0xb2d6ed95d
500000.0,2.0,9,4,3,3,10,0xb2d9d7bb
360072.44,3.0,66,4,4,2,10,0xb2d1799d
501835.57,3.0,35,4,4,2,10,0xb2d6a9bd
600156.94,6.0,26,4,4,2,10,0xb2d1c1de
1370330.41,3.0,8,4,4,3,11,0xb2d24e01
753010.1,6.0,9,4,4,3,11,0xb2d1ff81
10066.77,1.0,8,2,2,3,7,0xb2d6c2e5
696376.67,4.0,10,4,4,3,11,0xb2d27900
10811.87,1.0,37,2,2,2,6,0xb2d32285
126958.31,3.0,11,3,4,3,10,0xb2d3adbe
1039.02,2.0,21,1,3,2,6,0x3b9b1713d
203038.33,6.0,41,3,4,2,9,0xb2d44b12
652849.88,6.0,0,4,4,4,12,0xb2d188c3d
181094.25,4.0,0,3,4,4,11,0xb2d2a41d
143326.75,4.0,34,3,4,2,9,0xb2d6a679d
358816.27,7.0,1,4,4,4,12,0x3b9b10a0
39.85,1.0,67,1,2,1,4,0xb2d0a3be
2134.64,1.0,10,1,2,3,6,0xb2d9e1c6
5052798.59,5.0,6,4,4,3,11,0xb2d5498cd
221519.17,2.0,9,3,3,3,9,0xb2d39e5cd
0.76,1.0,82,1,2,1,4,0xb2d6b7f6
201083.32,2.0,1,3,3,4,10,0xb2d0c638d
1067815.16,6.0,19,4,4,2,10,0xb2d3669e
5175.53,1.0,17,2,2,2,6,0xb2d2582dd
7997.7,1.0,0,2,2,4,8,0xb2d88d9bd
3629.37,2.0,53,2,3,2,7,0xb2d27710d
430000.0,4.0,1,4,4,4,12,0xb2da5180
2482389.26,5.0,14,4,4,3,11,0xb2d29466d
0.64,1.0,111,1,2,1,4,0xb2d63b93
401465.08,3.0,5,4,4,3,11,0xb2d8d019
7673.46,2.0,2,2,3,4,9,0x3b9b0fbdd
22026.23,2.0,3,2,3,4,9,0xb2d9fa14
151.57,2.0,46,1,3,2,6,0xb2d9961c
11388.4,1.0,18,2,2,2,6,0xb2d1effa
333821.79,2.0,76,4,3,1,8,0xb2d6aa4f
284.49,1.0,4,1,2,4,7,0xb2d4eb7cd
5.85,1.0,83,1,2,1,4,0xb2d6e6dbd
729613.37,3.0,0,4,4,4,12,0xb2d58357
211487.83,4.0,293,3,4,1,8,0xb2d06ffd
160200.0,8.0,2,3,4,4,11,0xb2d59ce5d
151504.81,2.0,10,3,3,3,9,0xb2d95d81d
1010020.65,6.0,12,4,4,3,11,0xb2d62210
586.45,2.0,12,1,3,3,7,0xb2d2000d
3915.01,1.0,83,2,2,1,5,0xb2d40f26
214483.46,2.0,0,3,3,4,10,0xb2d62745d
1760000.75,8.0,4,4,4,4,12,0xb2d1964c
85145.64,1.0,104,3,2,1,6,0xb2d2d866d
1577273.31,1.0,80,4,2,1,7,0xb2d3bc0c
70207.39,3.0,18,3,4,2,9,0xb2d07fe6d
4600.12,2.0,0,2,3,4,9,0x3b9b4847
7.1,2.0,7,1,3,3,7,0x3b9b2c70
380039.01,4.0,6,4,4,3,11,0xb2d1809ed
6.45,1.0,32,1,2,2,5,0xb2d51dda
40000.84,2.0,59,2,3,2,7,0xb2d8fce5
420058.61,5.0,14,4,4,3,11,0xb2d1d989
1903.79,1.0,7,1,2,3,6,0xb2d97cbe
810084.72,3.0,10,4,4,3,11,0xb2d6123ed
31226.12,1.0,26,2,2,2,6,0xb2d6a401d
3740.98,1.0,15,2,2,3,7,0xb2d48bd5
5452598.47,6.0,0,4,4,4,12,0x3b9b1259
91013.71,4.0,32,3,4,2,9,0xb2d9e7ea
420177.02,5.0,2,4,4,4,12,0xb2d0b54ad
447045.71,3.0,157,4,4,1,9,0xb2d0e9e4d
300053.57,3.0,14,3,4,3,10,0xb2d2fb76d
100100.08,2.0,30,3,3,2,8,0xb2da042b
29310.11,2.0,5,2,3,3,8,0xb2d08d37
150002.58,2.0,38,3,3,2,8,0xb2d92b78
500001.23,3.0,2,4,4,4,12,0xb2d90d57d
500000.0,1.0,0,4,2,4,10,0xb2da2966
11225.73,1.0,0,2,2,4,8,0xb2d30c69
296.3,2.0,1,1,3,4,8,0xb2d5f116
16037.28,1.0,14,2,2,3,7,0xb2d37c7f
2281.03,2.0,184,1,3,1,5,0xb2d0791dd
1977.21,1.0,9,1,2,3,6,0xb2d33b1f
1708.16,1.0,5,1,2,3,6,0x3b9b30d7
6371.45,1.0,12,2,2,3,7,0xb2d8e43fd
90001.48,2.0,95,3,3,1,7,0xb2d975b3d
1000038.75,4.0,8,4,4,3,11,0xb2d1d4c4d
6000.0,1.0,7,2,2,3,7,0xb2d2cfbdd
1.08,1.0,27,1,2,2,5,0xb2d6d945
190508.32,3.0,1,3,4,4,11,0xb2d94010d
59.53,1.0,3,1,2,4,7,0xb2d5ee80
1220625.25,8.0,39,4,4,2,10,0xb2d08a36d
465555.2,11.0,0,4,4,4,12,0xb2d625c3d
3300878.4,7.0,0,4,4,4,12,0xb2d08313
270059.06,2.0,4,3,3,4,10,0xb2d9fc56
1019525.99,2.0,1,4,3,4,11,0xb2d6442b
601073.35,3.0,3,4,4,4,12,0xb2d6875cd
37003.99,3.0,1,2,4,4,10,0xb2d94d19
372548.62,3.0,94,4,4,1,9,0xb2d16d68
2042669.78,2.0,40,4,3,2,9,0xb2d6a57bd
12332.37,1.0,8,2,2,3,7,0xb2d0d9ee
30001.69,3.0,94,2,4,1,7,0xb2d64ab8
190010.03,2.0,98,3,3,1,7,0xb2d966b2
6282.13,1.0,92,2,2,1,5,0xb2d11a0dd
1480.96,1.0,92,1,2,1,4,0xb2d2c78a
100909.09,1.0,92,3,2,1,6,0xb2d069e3d
300227.12,5.0,45,4,4,2,10,0xb2d4cc51d
861931.3,6.0,8,4,4,3,11,0xb2d367e0
2205.46,1.0,0,1,2,4,7,0xb2d79284
538223.84,3.0,18,4,4,2,10,0xb2d0fb98d
201421.14,2.0,15,3,3,3,9,0xb2d8df6e
146584.74,1.0,242,3,2,1,6,0xb2d23a6ed
0.21,1.0,60,1,2,2,5,0xb2d8fa30
409.34,1.0,1,1,2,4,7,0xb2d6e7b3
201434.6,2.0,50,3,3,2,8,0xb2d23538d
7796.91,4.0,0,2,4,4,10,0xb2d06815
50000.53,2.0,18,2,3,2,7,0xb2d95786
51314.31,1.0,0,2,2,4,8,0xb2d91c30
100068.02,2.0,24,3,3,2,8,0xb2d2c2fbd
918.62,1.0,16,1,2,2,5,0xb2d2d430d
8000.0,2.0,2,2,3,4,9,0xb2d0886cd
27.86,1.0,38,1,2,2,5,0xb2d5cf62d
445913.58,5.0,10,4,4,3,11,0xb2d5eab3
240252.87,6.0,18,3,4,2,9,0xb2d653df
9906.92,11.0,3,2,4,4,10,0xb2d47e76d
50026.74,2.0,213,2,3,1,6,0xb2d5ad43
492000.0,4.0,1,4,4,4,12,0xb2d0d348
202132.16,2.0,111,3,3,1,7,0xb2d94860
50159.64,1.0,0,2,2,4,8,0xb2d3b2aa
3314.65,1.0,9,2,2,3,7,0xb2d69f5f
40.37,2.0,42,1,3,2,6,0xb2d34b21
500000.0,3.0,0,4,4,4,12,0xb2da6b8a
59.62,1.0,8,1,2,3,6,0xb2d2e0f9
45273.42,2.0,143,2,3,1,6,0xb2d6202cd
262926.41,4.0,0,3,4,4,11,0xb2d3f19e
66392.96,3.0,39,3,4,2,9,0xb2d20a59
2085.74,1.0,92,1,2,1,4,0xb2d0b917
7441.59,1.0,26,2,2,2,6,0xb2d4081ed
50009.7,2.0,12,2,3,3,8,0xb2d3c470d
70332.47,1.0,62,3,2,2,7,0xb2d11b0cd
6.1,1.0,28,1,2,2,5,0xb2d57973
52514.37,2.0,208,3,3,1,7,0xb2d3cc72d
16152.61,1.0,3,2,2,4,8,0xb2d4e563d
30.64,1.0,0,1,2,4,7,0xb2d20ade
270369.39,4.0,18,3,4,2,9,0xb2d3d3cad
60628.48,1.0,4,3,2,4,9,0xb2d15076d
2639.94,1.0,5,1,2,3,6,0xb2d37613d
40072.93,2.0,18,2,3,2,7,0xb2d61bf0d
500050.68,3.0,0,4,4,4,12,0xb2d623a3
201421.06,2.0,71,3,3,1,7,0xb2d9a5ed
31092.92,1.0,24,2,2,2,6,0xb2d3c43fd
105079.4,5.0,6,3,4,3,10,0xb2d58a69
5315.51,1.0,11,2,2,3,7,0xb2d9aacc
202.4,1.0,52,1,2,2,5,0xb2d5c97cd
1147037.98,10.0,25,4,4,2,10,0xb2d682fa
1026.89,1.0,184,1,2,1,4,0xb2d0ea9f
353534.63,6.0,5,4,4,3,11,0xb2d61616d
420741.84,3.0,29,4,4,2,10,0xb2d915fb
505189.03,7.0,8,4,4,3,11,0xb2d0ef37
230834.17,2.0,38,3,3,2,8,0xb2d8d506d
500033.03,2.0,13,4,3,3,10,0xb2d6db27d
750129.36,4.0,4,4,4,4,12,0xb2d509c9
300062.6,2.0,1,3,3,4,10,0xb2d748f4
1916.94,1.0,10,1,2,3,6,0xb2d2865f
150009.57,2.0,210,3,3,1,7,0xb2d565cf
5.87,1.0,46,1,2,2,5,0xb2d6dd59
535488.9,2.0,6,4,3,3,10,0xb2d3e06f
191952.07,4.0,28,3,4,2,9,0xb2d591abd
24166.9,1.0,0,2,2,4,8,0xb2d6a7b9d
30047.19,2.0,27,2,3,2,7,0xb2d6f6ac
0.55,2.0,3,1,3,4,8,0xb2d969a2d
200710.43,2.0,41,3,3,2,8,0xb2d9ebd2
11.74,1.0,13,1,2,3,6,0xb2d33474d
393238.64,3.0,21,4,4,2,10,0xb2d22c2ad
13391.85,1.0,184,2,2,1,5,0x3b9b196a
9647.01,1.0,92,2,2,1,5,0xb2d3123d
11.0,1.0,11,1,2,3,6,0xb2d1a1b3
11.75,1.0,6,1,2,3,6,0xb2d681ce
516719.23,3.0,8,4,4,3,11,0xb2d5c635d
10069.34,1.0,92,2,2,1,5,0xb2d385fad
2640.03,1.0,0,1,2,4,7,0xb2d8d600
978800.74,8.0,1,4,4,4,12,0xb2d0630cd
2951.89,1.0,92,2,2,1,5,0xb2d1fcbbd
565952.98,3.0,136,4,4,1,9,0xb2d3f36ed
5894.9,1.0,92,2,2,1,5,0xb2d0b90ad
30000.0,1.0,3,2,2,4,8,0xb2d91454
508945.97,10.0,0,4,4,4,12,0x3b9b2549
2.17,8.0,140,1,4,1,6,0xb2d3831e
1313.18,1.0,214,1,2,1,4,0xb2d649a0d
184742.33,3.0,40,3,4,2,9,0xb2d23c5bd
121193.11,5.0,4,3,4,4,11,0xb2d3b8f6d
375096.13,3.0,20,4,4,2,10,0xb2d5733ed
418.16,1.0,60,1,2,2,5,0xb2d60683d
2816.53,1.0,22,1,2,2,5,0xb2d71842
107213.91,1.0,92,3,2,1,6,0xb2d11a0cd
200068.09,2.0,19,3,3,2,8,0xb2d93da0d
10061.73,1.0,92,2,2,1,5,0xb2d2eec5d
600694.13,5.0,11,4,4,3,11,0xb2d8cdb4d
240000.0,2.0,7,3,3,3,9,0xb2da4e67
602173.88,3.0,40,4,4,2,10,0xb2d78c04d
651972.5,5.0,0,4,4,4,12,0xb2d6a4f9d
1117.4,1.0,92,1,2,1,4,0xb2d0d00fd
170104.79,3.0,13,3,4,3,10,0xb2d20210
185358.37,4.0,55,3,4,2,9,0xb2d0e34ad
2011.87,1.0,92,1,2,1,4,0xb2d12be6d
200268.16,2.0,2,3,3,4,10,0xb2d94e49
150000.42,3.0,0,3,4,4,11,0xb2d8edfdd
688484.07,5.0,102,4,4,1,9,0xb2d1b0ccd
381168.53,5.0,3,4,4,4,12,0xb2d10f9f
2033.85,1.0,3,1,2,4,7,0xb2d4fc28
2509718.27,6.0,6,4,4,3,11,0xb2d17e6b
9743.25,1.0,92,2,2,1,5,0xb2d5a868
200000.33,2.0,2,3,3,4,10,0xb2da20d7
30104.86,2.0,3,2,3,4,9,0xb2d91441
264008.44,10.0,4,3,4,4,11,0xb2d4d07d
1140713.71,4.0,8,4,4,3,11,0xb2d95099d
1098139.58,2.0,0,4,3,4,11,0xb2d2bd84d
220102.9,2.0,13,3,3,3,9,0xb2d68e90
1465.24,1.0,7,1,2,3,6,0xb2d64be6
891.14,1.0,4,1,2,4,7,0xb2d6bcc7d
50419.68,1.0,1,2,2,4,8,0xb2d62493d
9.61,1.0,131,1,2,1,4,0xb2d102f8d
646028.07,6.0,10,4,4,3,11,0xb2d3d59d
70005.96,3.0,5,3,4,3,10,0xb2d930a3d
18683.91,1.0,15,2,2,3,7,0xb2d959c6
141158.74,1.0,223,3,2,1,6,0xb2d1de94d
19880.43,1.0,4,2,2,4,8,0xb2d323ddd
106780.65,3.0,4,3,4,4,11,0xb2d4f9cbd
1006.69,1.0,92,1,2,1,4,0xb2d3dbb0
1000022.08,2.0,60,4,3,2,9,0xb2d63763
302115.64,2.0,235,4,3,1,8,0xb2d68230
393.45,1.0,35,1,2,2,5,0xb2d27f2e
650000.87,11.0,0,4,4,4,12,0xb2d1bc1c
202222.37,2.0,81,3,3,1,7,0xb2d2e14fd
885103.9,2.0,139,4,3,1,8,0xb2d19255d
140210.63,5.0,1,3,4,4,11,0xb2d0844fd
250854.98,2.0,18,3,3,2,8,0xb2d5abbe
0.0,1.0,7,1,2,3,6,0xb2d6ad89
175089.53,8.0,0,3,4,4,11,0xb2d08bd4d
1002664.22,5.0,6,4,4,3,11,0xb2d814d4d
320098.09,6.0,6,4,4,3,11,0xb2d1129a
40886.24,2.0,0,2,3,4,9,0xb2d1197fd
12871.7,1.0,4,2,2,4,8,0xb2d6a70dd
100036.66,2.0,14,3,3,3,9,0xb2d1a678d
203641.76,2.0,180,3,3,1,7,0xb2d58cc4
1454016.04,7.0,49,4,4,2,10,0xb2d24eb9d
1433.62,1.0,17,1,2,2,5,0xb2d908a5
412604.93,3.0,7,4,4,3,11,0xb2d5bdf7
200109.26,2.0,19,3,3,2,8,0xb2d58140
772294.17,5.0,11,4,4,3,11,0xb2d44dbd
8965.19,1.0,14,2,2,3,7,0xb2d1f054
210006.69,2.0,8,3,3,3,9,0xb2da4371
1100000.55,6.0,2,4,4,4,12,0xb2d5d6d9d
420013.67,3.0,14,4,4,3,11,0xb2d3cc36d
316023.07,6.0,0,4,4,4,12,0xb2d2b4bbd
2092.8,1.0,5,1,2,3,6,0xb2d3aaaad
38788.54,1.0,3,2,2,4,8,0xb2d31d2fd
201421.35,2.0,90,3,3,1,7,0xb2d8c757d
55083.49,1.0,2,3,2,4,9,0xb2d2d990
7120.44,1.0,0,2,2,4,8,0xb2d824fb
1017772.17,2.0,135,4,3,1,8,0xb2d8e6d2d
7508.48,2.0,184,2,3,1,6,0xb2d17800d
497740.8,1.0,0,4,2,4,10,0xb2d3451ad
224412.35,3.0,5,3,4,3,10,0xb2d1aa5c
477000.0,10.0,6,4,4,3,11,0xb2d40fdad
39.98,1.0,53,1,2,2,5,0xb2d56376
476105.8,6.0,8,4,4,3,11,0xb2d33d6ed
38.64,1.0,49,1,2,2,5,0xb2d1f83a
171225.59,5.0,0,3,4,4,11,0xb2d22bca
7352.34,1.0,22,2,2,2,6,0xb2d907edd
2754197.25,18.0,1,4,4,4,12,0xb2d1ca23d
160638.15,2.0,199,3,3,1,7,0xb2d5c5e6d
44045.11,42.0,0,2,4,4,10,0xb2d110ca
8002.79,1.0,43,2,2,2,6,0xb2d992d4
2293.75,1.0,184,1,2,1,4,0xb2d22e82d
36.85,1.0,112,1,2,1,4,0xb2d8f117d
4969.22,1.0,25,2,2,2,6,0xb2d599c5
1741.19,1.0,184,1,2,1,4,0xb2d60c54d
131628.37,4.0,31,3,4,2,9,0xb2d5a098d
595.04,1.0,7,1,2,3,6,0xb2d300e7d
8739.27,1.0,9,2,2,3,7,0xb2d57b0e
259563.33,4.0,136,3,4,1,8,0xb2d17206
302566.39,2.0,4,4,3,4,11,0xb2d42bf3d
281087.05,2.0,8,3,3,3,9,0xb2d5bd1e
1299023.61,7.0,5,4,4,3,11,0xb2d3bc51d
270039.88,5.0,66,3,4,2,9,0xb2d3c096d
1314.41,1.0,92,1,2,1,4,0xb2d19404
84536.97,3.0,18,3,4,2,9,0xb2d3f3bb
7409.73,1.0,5,2,2,3,7,0xb2d69ac7d
20.97,1.0,6,1,2,3,6,0xb2d3b38b
172259.0,4.0,3,3,4,4,11,0xb2d2d56bd
3.57,1.0,1,1,2,4,7,0xb2d5ef90
4825.33,1.0,195,2,2,1,5,0xb2d4682ad
97043.51,3.0,137,3,4,1,8,0xb2d48ff5d
815167.46,6.0,60,4,4,2,10,0x3b9b437d
250765.78,3.0,41,3,4,2,9,0xb2d35123d
296.27,1.0,2,1,2,4,7,0xb2d20c9a
8580.33,1.0,49,2,2,2,6,0xb2d37c99
200000.0,2.0,6,3,3,3,9,0xb2da4f20
42552.01,1.0,19,2,2,2,6,0xb2d56a02
410040.04,2.0,7,4,3,3,10,0xb2d161abd
200100.01,2.0,0,3,3,4,10,0xb2da34ad
330033.31,5.0,164,4,4,1,9,0xb2d1739f
518035.8,3.0,139,4,4,1,9,0xb2d1b621
700014.78,2.0,11,4,3,3,10,0xb2da4277
200008.06,3.0,35,3,4,2,9,0xb2d1c345
246.88,1.0,0,1,2,4,7,0xb2d99f53
516.63,2.0,25,1,3,2,6,0xb2d8f70f
6769.1,1.0,95,2,2,1,5,0xb2d183c1d
55775.94,2.0,110,3,3,1,7,0xb2d235cd
500052.16,2.0,18,4,3,2,9,0xb2d8cccdd
303.13,1.0,16,1,2,2,5,0xb2d2c0b2
809341.98,4.0,16,4,4,2,10,0xb2d3b6aa
1565.77,1.0,18,1,2,2,5,0xb2d2054f
27.51,1.0,15,1,2,3,6,0xb2d8d53ad
155448.92,1.0,5,3,2,3,8,0xb2d61f8b
25545.19,2.0,11,2,3,3,8,0xb2d4ce27
202418.22,2.0,55,3,3,2,8,0xb2d63ea0
2266.34,1.0,184,1,2,1,4,0x3b9b37ac
3636.59,1.0,21,2,2,2,6,0xb2d5e19a
197027.95,2.0,228,3,3,1,7,0xb2d43da2d
333046.28,1.0,2,4,2,4,10,0xb2d96207d
18668.33,1.0,20,2,2,2,6,0xb2d48bef
322470.97,5.0,42,4,4,2,10,0xb2d5cef9d
21.6,2.0,44,1,3,2,6,0xb2d2ec1f
50.88,1.0,13,1,2,3,6,0xb2d6919a
2968.5,1.0,33,2,2,2,6,0xb2d647d6
92086.98,2.0,38,3,3,2,8,0xb2d550ed
50018.11,2.0,55,2,3,2,7,0xb2d5e7bdd
18063.54,1.0,1,2,2,4,8,0xb2d224fa
2609.29,1.0,0,1,2,4,7,0xb2d4f334
1051.65,1.0,0,1,2,4,7,0xb2d4ee27
26039.32,2.0,8,2,3,3,8,0xb2d6027cd
50981.99,2.0,83,2,3,1,6,0xb2d64a55d
1400106.14,3.0,39,4,4,2,10,0xb2d57091d
3650.46,1.0,12,2,2,3,7,0xb2d906d4d
161.86,1.0,17,1,2,2,5,0xb2d38b9b
8987.51,1.0,92,2,2,1,5,0xb2d4dd24d
2297735.57,2.0,74,4,3,1,8,0xb2d19249d
9569.21,3.0,74,2,4,1,7,0xb2d6f109
1294.25,1.0,92,1,2,1,4,0xb2d2f0f9d
76473.17,3.0,184,3,4,1,8,0x3b9b157e
300003.17,2.0,18,3,3,2,8,0xb2d9b021
80001.69,2.0,18,3,3,2,8,0xb2d9555cd
1692.21,1.0,184,1,2,1,4,0xb2d2cdc4d
1350.47,1.0,19,1,2,2,5,0xb2d2a76d
244136.8,3.0,5,3,4,3,10,0xb2d5ee5cd
150620.62,2.0,83,3,3,1,7,0xb2d441ee
822740.01,1.0,184,4,2,1,7,0xb2d13f25d
160019.15,7.0,0,3,4,4,11,0xb2d1a9e1d
696282.66,13.0,0,4,4,4,12,0x3b9b124bd
42.75,1.0,63,1,2,2,5,0xb2d0d019
52894.11,2.0,174,3,3,1,7,0xb2d45c7ed
2796.51,1.0,0,1,2,4,7,0xb2d6a305
102533.44,3.0,92,3,4,1,8,0xb2d609d7d
2.86,1.0,44,1,2,2,5,0xb2d9b48d
1030600.37,3.0,54,4,4,2,10,0xb2d5ad21
118956.47,1.0,13,3,2,3,8,0xb2d30fd5d
5199.76,1.0,21,2,2,2,6,0xb2d7583bd
100002.64,2.0,47,3,3,2,8,0xb2d78651d
85.63,1.0,29,1,2,2,5,0xb2d6c63ed
2253171.34,13.0,6,4,4,3,11,0xb2d0754f
100001.59,2.0,39,3,3,2,8,0xb2d9eed6
500000.0,2.0,8,4,3,3,10,0xb2d2d684d
124058.7,4.0,67,3,4,1,8,0xb2d6b72cd
3127.83,1.0,7,2,2,3,7,0xb2d32c31
1063.25,1.0,209,1,2,1,4,0xb2d5e75dd
6371.85,1.0,0,2,2,4,8,0xb2d97785
762.7,1.0,25,1,2,2,5,0xb2d749e3
360726.48,2.0,4,4,3,4,11,0xb2d252e0d
50003.98,2.0,66,2,3,2,7,0xb2d5e5bd
13226.49,1.0,184,2,2,1,5,0xb2d21f7bd
7412.56,1.0,4,2,2,4,8,0xb2d94886d
8244.62,4.0,31,2,4,2,8,0x3b9b1353
396177.61,6.0,80,4,4,1,9,0xb2d07ccbd
46.32,2.0,35,1,3,2,6,0xb2d9a9a1
184292.37,2.0,0,3,3,4,10,0xb2d1a37dd
0.0,1.0,6,1,2,3,6,0xb2d98bf5
390001.69,7.0,77,4,4,1,9,0xb2d198a5d
1133.18,1.0,4,1,2,4,7,0xb2d52c44d
10060.97,1.0,173,2,2,1,5,0xb2d45b28
813719.32,2.0,1,4,3,4,11,0xb2d219a2
61.64,1.0,30,1,2,2,5,0xb2d263d8d
282313.55,4.0,9,3,4,3,10,0xb2d0da0bd
50073.89,2.0,116,2,3,1,6,0x3b9b406a
433777.7,7.0,0,4,4,4,12,0x3b9af26bd
549729.03,5.0,12,4,4,3,11,0xb2d102a6d
6053.27,3.0,92,2,4,1,7,0xb2d094a4d
113369.02,3.0,74,3,4,1,8,0xb2d17237d
103313.98,1.0,7,3,2,3,8,0xb2d5bdcf
699.04,1.0,1,1,2,4,7,0xb2d974da
480015.83,3.0,186,4,4,1,9,0xb2d117e1
24846.71,1.0,18,2,2,2,6,0xb2d8e22ed
2721.25,1.0,15,1,2,3,6,0xb2d25213
320055.9,5.0,136,4,4,1,9,0xb2d211e1d
0.0,1.0,0,1,2,4,7,0xb2d5b080
85894.65,3.0,0,3,4,4,11,0xb2d17434d
889.02,1.0,79,1,2,1,4,0xb2d68922d
400486.04,4.0,21,4,4,2,10,0xb2d19b2cd
65.9,1.0,4,1,2,4,7,0xb2d52c0bd
32027.34,1.0,184,2,2,1,5,0xb2d607a8
3180.31,1.0,15,2,2,3,7,0xb2d2f894
100549.13,1.0,71,3,2,1,6,0xb2d42fccd
40315.97,3.0,27,2,4,2,8,0xb2d36693
0.0,1.0,6,1,2,3,6,0xb2d68e22
16211.1,1.0,27,2,2,2,6,0xb2d8c539d
318786.28,2.0,92,4,3,1,8,0xb2d39b32d
220915.32,1.0,8,3,2,3,8,0xb2d9b344
2035.56,1.0,0,1,2,4,7,0xb2d3907e
350000.0,2.0,1,4,3,4,11,0xb2d97923d
45177.29,1.0,184,2,2,1,5,0xb2d45e4fd
240634.31,4.0,83,3,4,1,8,0xb2d12b7f
900783.15,4.0,4,4,4,4,12,0xb2d5c71d
77.14,2.0,64,1,3,2,6,0xb2d149a0
11311.4,2.0,0,2,3,4,9,0xb2d08580
21.8,1.0,23,1,2,2,5,0xb2d5a5cad
110837.98,2.0,143,3,3,1,7,0xb2d2978cd
441059.72,14.0,16,4,4,2,10,0xb2d1ff86
185.7,1.0,28,1,2,2,5,0xb2d9a9cd
87530.22,3.0,221,3,4,1,8,0xb2d2271bd
236001.46,2.0,6,3,3,3,9,0xb2d650c3d
81322.12,1.0,0,3,2,4,9,0xb2d68e9b
2002.75,1.0,62,1,2,2,5,0xb2d91543d
21156.02,1.0,0,2,2,4,8,0xb2d6b7e5d
3020.96,1.0,12,2,2,3,7,0xb2d56553d
219660.27,4.0,45,3,4,2,9,0xb2d296acd
2677.38,3.0,184,1,4,1,6,0x3b9b15a0
5.85,1.0,77,1,2,1,4,0xb2d62f99
753.3,1.0,25,1,2,2,5,0xb2d1ff2a
59079.43,2.0,70,3,3,1,7,0x3b9b4828d
630903.68,7.0,14,4,4,3,11,0xb2d3a10f
338015.1,5.0,1,4,4,4,12,0xb2d6c08b
1094.26,1.0,7,1,2,3,6,0xb2d47064d
400280.53,3.0,0,4,4,4,12,0xb2d2d66dd
1590.97,1.0,184,1,2,1,4,0xb2d52963d
26.76,1.0,50,1,2,2,5,0xb2d976f0d
249859.29,2.0,1,3,3,4,10,0xb2d43d9d
9834.04,1.0,184,2,2,1,5,0xb2d24d22
170104.3,3.0,4,3,4,4,11,0xb2d140b6d
462009.93,10.0,53,4,4,2,10,0xb2d6199ed
2390.69,1.0,7,1,2,3,6,0xb2d351f9
5357.79,1.0,5,2,2,3,7,0xb2d473b1d
2601.48,1.0,63,1,2,2,5,0xb2d8f968d
30001.74,3.0,41,2,4,2,8,0xb2d8018bd
688215.06,2.0,13,4,3,3,10,0xb2d06d50
200713.27,2.0,39,3,3,2,8,0xb2d65c7bd
714.13,1.0,27,1,2,2,5,0xb2d6c080
100134.15,2.0,6,3,3,3,9,0xb2d1f97cd
300525.71,2.0,4,4,3,4,11,0xb2d6d8ead
13689.74,1.0,184,2,2,1,5,0xb2d3e93a
6.33,1.0,53,1,2,2,5,0xb2d5f47d
64000.0,4.0,1,3,4,4,11,0xb2d1c439
108.03,1.0,8,1,2,3,6,0xb2d34654
200004.22,2.0,24,3,3,2,8,0xb2d947d1d
51002.54,2.0,162,2,3,1,6,0xb2d09c9cd
45330.98,4.0,26,2,4,2,8,0xb2d5748a
442446.52,6.0,0,4,4,4,12,0xb2d3d3fa
132860.65,3.0,66,3,4,2,9,0xb2d26b6d
400106.7,2.0,23,4,3,2,9,0xb2d57953
68974.59,1.0,10,3,2,3,8,0xb2d91511
1184581.94,5.0,1,4,4,4,12,0xb2d22c30d
57632.1,13.0,5,3,4,3,10,0x3b9b40ead
155.41,1.0,21,1,2,2,5,0xb2d1d464
200000.0,2.0,29,3,3,2,8,0xb2da0c3e
33482.24,2.0,31,2,3,2,7,0xb2d60f1dd
470003.97,4.0,41,4,4,2,10,0xb2d82422d
250000.53,3.0,13,3,4,3,10,0xb2d958c4d
250.0,1.0,0,1,2,4,7,0xb2d3c0a8
51997.91,1.0,137,2,2,1,5,0xb2d54f3ed
360.51,1.0,60,1,2,2,5,0xb2d6485ad
500076.05,2.0,26,4,3,2,9,0xb2d9cb5d
1036002.97,5.0,14,4,4,3,11,0xb2d10f25d
0.21,1.0,6,1,2,3,6,0xb2d65830
267762.94,2.0,160,3,3,1,7,0xb2d29688
0.0,1.0,0,1,2,4,7,0xb2d2886ad
2.23,1.0,38,1,2,2,5,0xb2d37668
4748.84,1.0,0,2,2,4,8,0xb2d67ef1
8604.95,1.0,0,2,2,4,8,0xb2d91f03
60001.26,2.0,0,3,3,4,10,0xb2d22f82
40001.89,3.0,31,2,4,2,8,0xb2d5a5cb
52030.52,2.0,125,2,3,1,6,0xb2d55cf0d
2780.38,1.0,16,1,2,2,5,0xb2d65b41d
23.74,1.0,9,1,2,3,6,0xb2d934dc
1882.12,1.0,61,1,2,2,5,0xb2d230b9d
73652.33,2.0,5,3,3,3,9,0x3b9b1a4e
80002.64,2.0,92,3,3,1,7,0xb2d97a74d
82002.25,4.0,45,3,4,2,9,0xb2d6e63e
448272.3,3.0,0,4,4,4,12,0xb2d5c1cd
54.0,1.0,0,1,2,4,7,0xb2d906a5
180000.09,2.0,83,3,3,1,7,0xb2d5db98d
5531.11,1.0,5,2,2,3,7,0xb2d7091f
415006.03,3.0,22,4,4,2,10,0xb2d1554c
410150.81,5.0,34,4,4,2,10,0xb2d2b4b7
400082.76,4.0,31,4,4,2,10,0xb2d3c5fb
450041.82,3.0,168,4,4,1,9,0xb2d6fda7
9010.12,1.0,7,2,2,3,7,0xb2d5604dd
10000.32,2.0,206,2,3,1,6,0xb2d68bf8d
797448.08,1.0,0,4,2,4,10,0xb2d4d52d
733806.7,2.0,28,4,3,2,9,0xb2d30b1ad
1219.76,1.0,92,1,2,1,4,0xb2d42dfbd
1182.25,1.0,19,1,2,2,5,0xb2d24d03
332997.85,1.0,34,4,2,2,8,0xb2d92b5e
1000.9,1.0,94,1,2,1,4,0xb2d85bfe
5725.54,1.0,292,2,2,1,5,0xb2d39b9d
11057.85,1.0,0,2,2,4,8,0xb2d5ff94
15002.02,1.0,5,2,2,3,7,0xb2d2f5e7
101.47,1.0,0,1,2,4,7,0xb2d6c196
202834.97,2.0,18,3,3,2,8,0xb2d57e91
534998.03,1.0,48,4,2,2,8,0xb2d3a089d
80847.79,4.0,18,3,4,2,9,0xb2d1e665
151515.49,4.0,6,3,4,3,10,0xb2d64b7bd
396155.16,5.0,4,4,4,4,12,0xb2d62304d
202052.16,2.0,18,3,3,2,8,0xb2d564a6
4015.5,1.0,101,2,2,1,5,0xb2d2b633
560026.61,5.0,0,4,4,4,12,0xb2d96401d
280724.55,4.0,53,3,4,2,9,0xb2d3e1f6
550208.05,3.0,9,4,4,3,11,0xb2d5d3e1d
350459.74,2.0,10,4,3,3,10,0xb2d59022
200024.13,2.0,16,3,3,2,8,0xb2d6c673d
23199.68,1.0,0,2,2,4,8,0xb2d2e6cb
4417.0,1.0,1,2,2,4,8,0xb2d57766
385.45,1.0,10,1,2,3,6,0xb2d48892
72397.85,2.0,108,3,3,1,7,0xb2d58135d
1720000.0,7.0,3,4,4,4,12,0xb2d0ec8f
200000.0,2.0,11,3,3,3,9,0xb2da38c4
70913.63,5.0,1,3,4,4,11,0xb2d08087
160154.16,4.0,108,3,4,1,8,0xb2d5a96b
10099.15,2.0,3,2,3,4,9,0xb2d90acad
40900.53,2.0,2,2,3,4,9,0xb2d2fb3a
1364.43,1.0,0,1,2,4,7,0xb2d476c7
0.12,3.0,15,1,4,3,8,0xb2d8ec83
83.66,1.0,10,1,2,3,6,0xb2d3b1d7d
799074.52,4.0,83,4,4,1,9,0xb2d17ae2
1701.47,1.0,19,1,2,2,5,0xb2d388ac
1129.45,1.0,8,1,2,3,6,0xb2d34e0e
21652.82,7.0,12,2,4,3,9,0xb2d8fb9b
492139.39,4.0,66,4,4,2,10,0xb2d4a5cf
351243.24,2.0,41,4,3,2,9,0xb2d9ef3c
360052.99,2.0,192,4,3,1,8,0xb2d52724
5078.94,1.0,177,2,2,1,5,0xb2d6d5c5d
155085.11,3.0,25,3,4,2,9,0xb2d5efa5d
402.63,1.0,77,1,2,1,4,0xb2d25be3d
271926.59,1.0,8,3,2,3,8,0xb2d38c29
778.53,1.0,0,1,2,4,7,0xb2d558db
2000581.5,1.0,0,4,2,4,10,0xb2d8c81dd
301.47,1.0,35,1,2,2,5,0xb2d9dbd1
70087.79,2.0,70,3,3,1,7,0xb2d32ccb
836395.96,3.0,18,4,4,2,10,0xb2d3a5e9
50531.13,2.0,263,2,3,1,6,0xb2d5e43dd
120061.4,2.0,51,3,3,2,8,0xb2d8f19ed
200004.22,2.0,18,3,3,2,8,0xb2da2aff
12164.52,1.0,81,2,2,1,5,0xb2d6bd66d
676263.59,1.0,1,4,2,4,10,0xb2d12e13d
123.67,1.0,74,1,2,1,4,0xb2d8cea9
700065.0,3.0,18,4,4,2,10,0xb2d6e85dd
2.05,1.0,77,1,2,1,4,0xb2d820abd
100229.54,4.0,48,3,4,2,9,0xb2d6221ed
30260.8,2.0,0,2,3,4,9,0xb2d6b6b5
71433.37,6.0,0,3,4,4,11,0xb2d0da59
21793.01,1.0,92,2,2,1,5,0xb2d539f2d
61330.92,1.0,31,3,2,2,7,0xb2d6bbf8
330051.24,2.0,6,4,3,3,10,0xb2d1b1afd
211.81,1.0,9,1,2,3,6,0xb2d407eb
18008.89,2.0,259,2,3,1,6,0xb2d5f852d
2015040.69,6.0,46,4,4,2,10,0xb2d3d3b4d
16481.24,2.0,12,2,3,3,8,0x3b9b4a39
100.0,1.0,5,1,2,3,6,0xb2d9413b
866.58,1.0,25,1,2,2,5,0xb2d294d8
20000.42,2.0,53,2,3,2,7,0xb2d9a9b4
8214.22,1.0,92,2,2,1,5,0xb2d288ecd
51166.72,1.0,1,2,2,4,8,0xb2d3a8ff
10259.51,1.0,40,2,2,2,6,0xb2d5a64ed
178729.35,7.0,3,3,4,4,11,0xb2d30ca7
250000.0,2.0,0,3,3,4,10,0xb2da6b20
4.42,1.0,10,1,2,3,6,0xb2d18bc2d
1346054.89,7.0,0,4,4,4,12,0xb2d0bb5d
1479.61,1.0,101,1,2,1,4,0xb2d5b3d3d
190248.36,2.0,24,3,3,2,8,0xb2d5e8fd
7221.78,1.0,19,2,2,2,6,0xb2d68ec0
2063.2,1.0,184,1,2,1,4,0xb2d2cdedd
1002773.69,2.0,176,4,3,1,8,0xb2d33448
35018.92,2.0,4,2,3,4,9,0xb2d5da40
5503.29,1.0,20,2,2,2,6,0xb2d68ecb
480081.59,2.0,34,4,3,2,9,0xb2d46837d
1040.35,1.0,124,1,2,1,4,0xb2d19ffcd
415985.77,4.0,21,4,4,2,10,0xb2d45d0ad
4269.55,1.0,3,2,2,4,8,0xb2d27c8bd
155504.93,3.0,92,3,4,1,8,0xb2d4363dd
78.4,1.0,13,1,2,3,6,0xb2d60188
200000.84,2.0,6,3,3,3,9,0xb2d8eefd
20003.47,2.0,31,2,3,2,7,0xb2d52f13d
2212.69,1.0,18,1,2,2,5,0xb2d6e5a7d
827.7,1.0,83,1,2,1,4,0xb2d56421d
8.33,1.0,11,1,2,3,6,0xb2d8d665
231582.28,2.0,0,3,3,4,10,0xb2d5ba83d
262822.4,2.0,32,3,3,2,8,0xb2d58da4d
5500000.0,2.0,26,4,3,2,9,0xb2da131c
11383.09,1.0,0,2,2,4,8,0xb2d6e7b5
101950.58,2.0,0,3,3,4,10,0xb2d6ef28
86189.59,1.0,103,3,2,1,6,0xb2d11187
4636.02,1.0,18,2,2,2,6,0xb2d5090fd
2888.14,1.0,10,2,2,3,7,0xb2d6a555
65.04,1.0,6,1,2,3,6,0xb2d43d23
1015.58,1.0,92,1,2,1,4,0xb2d0f3ca
351891.38,2.0,62,4,3,2,9,0xb2d08876
213041.71,1.0,287,3,2,1,6,0xb2d3b5a9d
157.91,1.0,74,1,2,1,4,0xb2d6e628
50255.84,2.0,16,2,3,2,7,0xb2d0909ad
205704.68,5.0,8,3,4,3,10,0xb2d64b60d
232297.22,4.0,13,3,4,3,10,0xb2d1a306
600157.18,3.0,3,4,4,4,12,0xb2d62870d
710887.75,4.0,0,4,4,4,12,0xb2d6d73ed
4860.08,2.0,0,2,3,4,9,0xb2d20f94
60507.36,1.0,9,3,2,3,8,0xb2d34aed
426.67,1.0,0,1,2,4,7,0xb2d315af
24.68,1.0,184,1,2,1,4,0xb2d3527ed
3564.39,1.0,53,2,2,2,6,0xb2d63201
470000.0,3.0,13,4,4,3,11,0xb2d94563
5005.43,1.0,113,2,2,1,5,0xb2d90074d
202.24,1.0,6,1,2,3,6,0xb2d34131
10418.0,1.0,92,2,2,1,5,0x3b9b0f22d
747166.66,3.0,1,4,4,4,12,0xb2d5ea40d
5220.12,1.0,92,2,2,1,5,0xb2d2331ed
0.0,1.0,7,1,2,3,6,0xb2d54e4b
86596.42,6.0,1,3,4,4,11,0xb2d56631
1014.97,1.0,92,1,2,1,4,0xb2d12240
270.41,1.0,53,1,2,2,5,0xb2d57e56
70002.22,2.0,31,3,3,2,8,0xb2d93211d
150000.0,2.0,0,3,3,4,10,0xb2d97fe6d
34.9,1.0,10,1,2,3,6,0xb2d1f83ad
9564.49,1.0,77,2,2,1,5,0xb2d2c3b0
24770.95,2.0,6,2,3,3,8,0xb2d5d2ccd
2100.12,1.0,1,1,2,4,7,0xb2d8cee4
230000.0,2.0,14,3,3,3,9,0xb2d95f5f
1662.42,1.0,92,1,2,1,4,0xb2d0771ad
6125.02,1.0,15,2,2,3,7,0xb2d26390
8347.69,1.0,1,2,2,4,8,0xb2d6c4ced
900001.21,4.0,1,4,4,4,12,0xb2d9ef23
5012.86,1.0,13,2,2,3,7,0xb2d90fe7
810.95,1.0,13,1,2,3,6,0xb2d5f1e2d
10571.44,1.0,10,2,2,3,7,0xb2d92054
805062.69,6.0,4,4,4,4,12,0xb2d972b3d
697.64,2.0,5,1,3,3,7,0xb2d2552ad
103611.77,3.0,217,3,4,1,8,0xb2d3bcd5d
290003.06,2.0,24,3,3,2,8,0xb2d94a5d
0.0,1.0,3,1,2,4,7,0xb2d398b8
6065.37,1.0,184,2,2,1,5,0xb2d29802d
302131.74,2.0,16,4,3,2,9,0xb2d8de67
6.08,1.0,13,1,2,3,6,0xb2d280ced
65452.73,2.0,153,3,3,1,7,0xb2d680f7d
54712.71,1.0,2,3,2,4,9,0xb2d34a38d
1360.64,1.0,184,1,2,1,4,0xb2d14f26d
10001.78,2.0,101,2,3,1,6,0xb2d68bcb
600000.0,2.0,25,4,3,2,9,0xb2da1a7f
80004.67,2.0,217,3,3,1,7,0xb2d451bd
3353.63,1.0,1,2,2,4,8,0xb2d6b7fed
2398.0,1.0,0,1,2,4,7,0xb2d561a9
1216.63,1.0,3,1,2,4,7,0xb2d24385
1072.54,1.0,184,1,2,1,4,0xb2d2eaa6d
138023.43,2.0,1,3,3,4,10,0xb2d4c1a7d
1.23,1.0,88,1,2,1,4,0xb2d326ddd
83166.11,3.0,0,3,4,4,11,0xb2d7775a
50000.0,2.0,9,2,3,3,8,0xb2d263e6
270060.37,3.0,1,3,4,4,11,0xb2d0a4a6d
5829.35,1.0,32,2,2,2,6,0xb2d9d3fd
4441.31,1.0,13,2,2,3,7,0xb2d8da25d
150003.17,2.0,73,3,3,1,7,0xb2d8e33c
3137.02,1.0,92,2,2,1,5,0xb2d58a65
61012.17,4.0,1,3,4,4,11,0xb2d580a8
50000.0,2.0,0,2,3,4,9,0xb2d97cd5d
448353.95,9.0,6,4,4,3,11,0xb2d24f3f
60219.26,5.0,39,3,4,2,9,0xb2d4e9a7d
91280.48,1.0,13,3,2,3,8,0xb2d2d915d
232.74,1.0,0,1,2,4,7,0xb2d551c4
117634.09,3.0,11,3,4,3,10,0xb2d6b77f
18018.3,5.0,0,2,4,4,10,0x3b9af40ad
83608.32,1.0,0,3,2,4,9,0xb2d52b8dd
23972878.83,4.0,1,4,4,4,12,0xb2d9347a
42.76,1.0,32,1,2,2,5,0xb2d65cd0d
14636.72,1.0,25,2,2,2,6,0xb2d6c2c8
596.47,1.0,4,1,2,4,7,0xb2d10f11
2010615.93,11.0,4,4,4,4,12,0xb2d22064d
200000.46,2.0,0,3,3,4,10,0xb2d8fda8
199415.62,1.0,1,3,2,4,9,0xb2d926ae
468591.99,3.0,24,4,4,2,10,0xb2d56321d
403568.95,4.0,14,4,4,3,11,0xb2d23b30d
3007.11,1.0,14,2,2,3,7,0xb2d632fdd
3322.43,1.0,1,2,2,4,8,0xb2d912de
1569.86,9.0,0,1,4,4,9,0xb2d09d8b
24.84,1.0,184,1,2,1,4,0xb2d3a6e4
20126.79,6.0,196,2,4,1,7,0xb2d1276ed
58.03,2.0,104,1,3,1,5,0xb2d227e1
5652.13,1.0,10,2,2,3,7,0xb2d608a2
201062.5,2.0,118,3,3,1,7,0xb2d6a8eb
1229.8,1.0,92,1,2,1,4,0xb2d12233d
269.67,2.0,12,1,3,3,7,0xb2d3c2a6d
51151.96,1.0,184,2,2,1,5,0xb2d32f67
330206.68,4.0,109,4,4,1,9,0xb2d6366ad
112948.56,2.0,90,3,3,1,7,0xb2d28b89d
1.17,1.0,20,1,2,2,5,0xb2d68c09
140000.0,3.0,0,3,4,4,11,0xb2d553a5d
257529.69,4.0,2,3,4,4,11,0xb2d0d299
3198.01,1.0,0,2,2,4,8,0xb2d50e71
523032.27,3.0,67,4,4,1,9,0xb2d63639d
93622.54,1.0,92,3,2,1,6,0xb2d1ad30d
2591000.0,10.0,4,4,4,4,12,0xb2d0f54f
57091.94,1.0,0,3,2,4,9,0xb2d5e5b5
537.8,1.0,2,1,2,4,7,0xb2d559f7
10.26,3.0,46,1,4,2,7,0xb2d29ee5
500000.0,2.0,18,4,3,2,9,0xb2d95a40d
1810.46,1.0,92,1,2,1,4,0xb2d3bff4d
278778.8,3.0,3,3,4,4,11,0xb2d61f05d
325235.17,2.0,14,4,3,3,10,0xb2d3eb43d
389.3,1.0,116,1,2,1,4,0xb2d53373
587.84,1.0,0,1,2,4,7,0xb2d33db0
1735242.85,10.0,0,4,4,4,12,0xb2d5c894d
290541.07,2.0,1,3,3,4,10,0xb2d56114d
215.46,1.0,0,1,2,4,7,0xb2d6962b
9631.16,1.0,92,2,2,1,5,0xb2d29162d
49000.52,2.0,27,2,3,2,7,0xb2d942d5
10008.44,1.0,90,2,2,1,5,0xb2d97db4
553658.63,11.0,0,4,4,4,12,0xb2d0b463
135369.39,1.0,22,3,2,2,7,0xb2d1f79ad
500000.0,2.0,1,4,3,4,11,0xb2da6778
1.91,1.0,18,1,2,2,5,0xb2d5f9a7
19748.44,1.0,6,2,2,3,7,0xb2d814e9d
100008.65,2.0,92,3,3,1,7,0xb2d56cb2
221533.22,2.0,18,3,3,2,8,0xb2d3b6a7
10182.7,1.0,15,2,2,3,7,0xb2d1f054d
70074.25,3.0,6,3,4,3,10,0xb2d5eb28d
918552.69,3.0,6,4,4,3,11,0xb2d11a19
2.73,1.0,14,1,2,3,6,0xb2d9de18
169175.01,18.0,0,3,4,4,11,0x3b9b4856
54.76,1.0,20,1,2,2,5,0xb2d25b76d
1460.52,1.0,89,1,2,1,4,0xb2d5a1b9
171003.31,5.0,25,3,4,2,9,0xb2d193b6d
745472.21,3.0,6,4,4,3,11,0x3b9b1240
740024.44,4.0,144,4,4,1,9,0xb2d366e8
250100.19,5.0,0,3,4,4,11,0xb2d51295
200038.71,2.0,83,3,3,1,7,0xb2d27270
300003.26,2.0,14,3,3,3,9,0xb2d19d07
1335.92,1.0,20,1,2,2,5,0xb2d22d83
105009.41,2.0,4,3,3,4,10,0xb2d6eab3
8162.69,1.0,92,2,2,1,5,0xb2d35b9cd
3002770.68,3.0,0,4,4,4,12,0xb2d5ec0d
38953.69,1.0,18,2,2,2,6,0xb2d995d0
1256.57,1.0,0,1,2,4,7,0xb2d92b35
7805.81,1.0,13,2,2,3,7,0xb2d8da2ad
151704.76,3.0,0,3,4,4,11,0xb2d6d31cd
1594.67,1.0,92,1,2,1,4,0xb2d256a8
350082.09,3.0,4,4,4,4,12,0xb2d30b61
51020.02,3.0,0,2,4,4,10,0xb2d09c4e
302694.35,7.0,11,4,4,3,11,0xb2d23a49d
7606.55,1.0,6,2,2,3,7,0xb2d2fce8
899.07,1.0,26,1,2,2,5,0xb2d2b1cc
2117.01,1.0,26,1,2,2,5,0xb2d3f58b
516412.52,12.0,3,4,4,4,12,0xb2d619aad
30424.88,1.0,14,2,2,3,7,0xb2d55144d
10000.21,2.0,18,2,3,2,7,0xb2da29d3
300077.78,3.0,69,3,4,1,8,0xb2d5ab45
751.41,1.0,5,1,2,3,6,0xb2d24fbed
900000.66,5.0,0,4,4,4,12,0xb2d087f3d
200710.42,2.0,40,3,3,2,8,0xb2d92631d
107.69,3.0,0,1,4,4,9,0x3b9b0ff7
264292.12,2.0,25,3,3,2,8,0xb2d1a52a
752030.27,16.0,0,4,4,4,12,0xb2d11ed3d
90001.75,2.0,70,3,3,1,7,0xb2d9a604
2002.78,1.0,37,1,2,2,5,0xb2d1774d
4721.08,1.0,0,2,2,4,8,0xb2d68cee
400000.42,3.0,1,4,4,4,12,0xb2d5fe5ed
100003.17,2.0,27,3,3,2,8,0xb2d93fff
60016.8,3.0,4,3,4,4,11,0xb2d579a5
52427.73,1.0,3,3,2,4,9,0xb2d8c44a
1370.59,1.0,92,1,2,1,4,0xb2d0fd09d
360011.34,11.0,0,4,4,4,12,0x3b9af1b4d
250026.99,2.0,0,3,3,4,10,0xb2d992a0
245737.58,7.0,14,3,4,3,10,0x3b9b2435
8718.12,1.0,0,2,2,4,8,0xb2d627a1
3495.81,1.0,17,2,2,2,6,0xb2d2b866
20329.07,2.0,228,2,3,1,6,0xb2d63483d
380099.63,2.0,13,4,3,3,10,0xb2d9a3cd
4518.79,1.0,9,2,2,3,7,0xb2d3985a
1244.29,1.0,7,1,2,3,6,0xb2d9237a
311988.3,1.0,10,4,2,3,9,0xb2d6f87b
800062.97,9.0,45,4,4,2,10,0x3b9b49d2d
500031.66,7.0,10,4,4,3,11,0xb2d550dcd
3079736.69,5.0,0,4,4,4,12,0x3b9b1846d
110004.19,5.0,20,3,4,2,9,0xb2d3c5d4d
60008.76,2.0,35,3,3,2,8,0xb2d2cbe9
200000.84,2.0,14,3,3,3,9,0xb2d8e10bd
1104.7,1.0,1,1,2,4,7,0xb2d33237d
51015.17,2.0,132,2,3,1,6,0xb2d63355d
61484.4,3.0,3,3,4,4,11,0xb2d532afd
631543.68,3.0,6,4,4,3,11,0xb2d5de8ad
2.45,1.0,60,1,2,2,5,0xb2d69fc7
2295.43,1.0,15,1,2,3,6,0xb2d3bb89
101008.37,3.0,49,3,4,2,9,0xb2d4e779d
33005.24,2.0,76,2,3,1,6,0xb2d28794
0.0,1.0,0,1,2,4,7,0xb2da575e
269.8,1.0,0,1,2,4,7,0xb2d2b320d
5668.51,2.0,184,2,3,1,6,0xb2d3a59a
111765.47,2.0,228,3,3,1,7,0xb2d554df
500797.72,4.0,28,4,4,2,10,0xb2d694cdd
40004.1,2.0,80,2,3,1,6,0xb2d5fb16
61.79,1.0,93,1,2,1,4,0xb2d61f61d
890.29,1.0,6,1,2,3,6,0xb2d9038b
8.06,1.0,43,1,2,2,5,0xb2d16959
100042.48,2.0,6,3,3,3,9,0xb2d4009e
2450.95,1.0,11,1,2,3,6,0xb2d341fad
3128.35,1.0,2,2,2,4,8,0xb2d22b1b
539.52,1.0,67,1,2,1,4,0xb2d5ae33d
6.77,1.0,59,1,2,2,5,0xb2d622db
13065.0,1.0,6,2,2,3,7,0xb2d2b7bc
653021.53,10.0,2,4,4,4,12,0xb2d0f846
5177554.64,1.0,0,4,2,4,10,0xb2d2bc56
4525.37,1.0,184,2,2,1,5,0xb2d1cb33d
30.17,1.0,18,1,2,2,5,0xb2d69e31
2138119.7,25.0,0,4,4,4,12,0xb2d3980f
5310.92,1.0,4,2,2,4,8,0xb2d62a2c
200000.0,2.0,12,3,3,3,9,0xb2d9639a
303488.17,2.0,4,4,3,4,11,0xb2d958a1d
140502.08,3.0,122,3,4,1,8,0xb2d5f3fcd
216048.67,6.0,66,3,4,2,9,0xb2d448fc
154012.18,2.0,53,3,3,2,8,0xb2d5c215
20000.21,2.0,98,2,3,1,6,0xb2d96fff
1664.88,1.0,5,1,2,3,6,0xb2d3e47e
1092.66,1.0,92,1,2,1,4,0xb2d339bb
25000.27,3.0,48,2,4,2,8,0xb2d27335
17232.04,1.0,15,2,2,3,7,0xb2d67defd
260027.6,5.0,21,3,4,2,9,0xb2d5b54c
71545.8,1.0,92,3,2,1,6,0xb2d47d94d
120004.24,5.0,25,3,4,2,9,0xb2d193c8d
421423.07,4.0,25,4,4,2,10,0xb2d5b3cdd
129013.66,2.0,52,3,3,2,8,0xb2d6d4f4d
416849.38,2.0,169,4,3,1,8,0xb2d12cc6d
32.17,1.0,10,1,2,3,6,0xb2d41dabd
1486.21,1.0,27,1,2,2,5,0xb2d93a44d
1256335.85,7.0,5,4,4,3,11,0xb2d3c673d
543894.48,6.0,98,4,4,1,9,0xb2d14560d
61.59,1.0,0,1,2,4,7,0xb2d65e37
504550.54,2.0,33,4,3,2,9,0xb2d57c69d
150078.6,2.0,10,3,3,3,9,0xb2d6aa2ad
195732.97,4.0,0,3,4,4,11,0xb2d3ecd8d
7039771.43,3.0,33,4,4,2,10,0xb2d35d01
87367.06,4.0,0,3,4,4,11,0xb2d6457ad
80030.27,2.0,149,3,3,1,7,0xb2d6baad
55.1,1.0,27,1,2,2,5,0xb2d938df
800888.96,4.0,101,4,4,1,9,0xb2d1c01fd
4091.5,1.0,27,2,2,2,6,0xb2d6b6e9
10175.61,2.0,185,2,3,1,6,0xb2d5db39d
44417.51,1.0,92,2,2,1,5,0xb2d28c4dd
542265.4,5.0,11,4,4,3,11,0xb2d9041cd
171.88,1.0,5,1,2,3,6,0xb2d2f357
10164.37,2.0,136,2,3,1,6,0xb2d62fa6
8322.25,1.0,0,2,2,4,8,0xb2d2abe7
202363.88,2.0,82,3,3,1,7,0xb2d87976
220712.89,1.0,10,3,2,3,8,0xb2d2b947
251431.53,3.0,28,3,4,2,9,0xb2d142af
300005.1,3.0,28,3,4,2,9,0xb2d50b94d
1747.31,1.0,92,1,2,1,4,0xb2d2e3f0
12.25,1.0,18,1,2,2,5,0xb2d1feb9
52.22,1.0,61,1,2,2,5,0xb2d96177d
631200.77,14.0,1,4,4,4,12,0xb2d0c608
70000.0,2.0,3,3,3,4,10,0xb2d5bbb0d
320057.02,2.0,12,4,3,3,10,0xb2d6f8bfd
2125.75,1.0,4,1,2,4,7,0xb2d1758f
100003.77,3.0,188,3,4,1,8,0xb2d37fe1
90037.79,4.0,19,3,4,2,9,0xb2d69a61d
124.46,1.0,35,1,2,2,5,0xb2d5e3ab
200147.03,1.0,1,3,2,4,9,0xb2d969c5
50493.26,2.0,10,2,3,3,8,0xb2d5d125d
2516.69,1.0,92,1,2,1,4,0xb2d2eb9dd
344.96,1.0,27,1,2,2,5,0xb2d6b5f4d
37626.95,1.0,20,2,2,2,6,0xb2d4f348
634000.0,2.0,0,4,3,4,11,0xb2d97e5bd
222367.94,3.0,23,3,4,2,9,0xb2d29f64
2582316.87,4.0,0,4,4,4,12,0xb2d2b694d
111333.86,3.0,74,3,4,1,8,0xb2d09ad2
103664.13,3.0,193,3,4,1,8,0xb2d158c1
4841.07,1.0,3,2,2,4,8,0xb2d6d0bdd
790001.67,8.0,10,4,4,3,11,0xb2d59c5bd
360832.43,4.0,11,4,4,3,11,0xb2d5b993d
1000000.5,8.0,18,4,4,2,10,0xb2d8d5ddd
1772.99,1.0,25,1,2,2,5,0xb2d3d3cb
9791.41,1.0,0,2,2,4,8,0xb2d6f396d
101045.27,2.0,52,3,3,2,8,0xb2d24986
180757.35,2.0,108,3,3,1,7,0xb2d41a67
1000008.44,3.0,23,4,4,2,10,0xb2d6e3de
18861.11,1.0,3,2,2,4,8,0xb2d8d8c7d
776.11,1.0,8,1,2,3,6,0xb2d6c81f
2058.58,1.0,184,1,2,1,4,0xb2d1d1f1d
18932.25,1.0,5,2,2,3,7,0xb2d69961
15143.67,1.0,92,2,2,1,5,0xb2d385bfd
6692.19,1.0,0,2,2,4,8,0xb2d4f970
2535.83,1.0,9,1,2,3,6,0xb2d6cf8f
60005.7,2.0,60,3,3,2,8,0xb2d96da6d
250016.06,2.0,11,3,3,3,9,0xb2d6c003
301298.05,2.0,15,4,3,3,10,0xb2d2590b
0.0,1.0,0,1,2,4,7,0xb2d31ed4
4159.1,1.0,184,2,2,1,5,0x3b9accb7d
50046.78,2.0,31,2,3,2,7,0xb2d265d5
98000.0,3.0,6,3,4,3,10,0xb2d317e2d
32517.15,2.0,4,2,3,4,9,0x3b9b0fcb
458.28,1.0,0,1,2,4,7,0xb2d4fe81
76025.87,2.0,41,3,3,2,8,0xb2d5c307d
50591.42,1.0,92,2,2,1,5,0xb2d3e931d
204945.94,2.0,101,3,3,1,7,0xb2d6a74fd
91059.66,2.0,33,3,3,2,8,0xb2d2a098d
44040.0,1.0,1,2,2,4,8,0xb2d0f3d2d
563.26,1.0,1,1,2,4,7,0xb2d6e7a8
10263.66,1.0,18,2,2,2,6,0xb2d5ebf8
51018.98,2.0,39,2,3,2,7,0xb2d43469d
250035.58,3.0,23,3,4,2,9,0xb2d119dfd
210007.35,4.0,53,3,4,2,9,0xb2d44239d
1129.08,1.0,20,1,2,2,5,0xb2d2fd88
23.36,1.0,101,1,2,1,4,0xb2d649d7d
500003.0,2.0,6,4,3,3,10,0xb2d6b503
620002.87,5.0,20,4,4,2,10,0xb2d564a2
300043.48,7.0,0,3,4,4,11,0xb2d5b6fad
3731.01,1.0,12,2,2,3,7,0xb2d36cb6d
22896.39,1.0,184,2,2,1,5,0xb2d290e3
174284.06,4.0,10,3,4,3,10,0xb2d1f6be
10000.21,2.0,8,2,3,3,8,0xb2da467c
340020.7,3.0,83,4,4,1,9,0xb2d1e5c8d
6573.75,3.0,13,2,4,3,9,0x3b9af115
3549.25,1.0,9,2,2,3,7,0xb2d559f2
30003.48,1.0,21,2,2,2,6,0xb2da1659
120010.88,2.0,203,3,3,1,7,0xb2d52e52
20338.27,2.0,34,2,3,2,7,0xb2d6b9e1d
494014.03,4.0,38,4,4,2,10,0xb2d313e1
527040.1,13.0,0,4,4,4,12,0xb2d24d92d
53626.82,2.0,98,3,3,1,7,0xb2d57847d
5777.56,1.0,5,2,2,3,7,0xb2d549e7
5506.56,1.0,92,2,2,1,5,0xb2d20dd2d
169940.13,2.0,4,3,3,4,10,0xb2d11f8bd
269628.75,6.0,0,3,4,4,11,0xb2d171fc
37.16,1.0,11,1,2,3,6,0xb2d67dd6
291.03,3.0,14,1,4,3,8,0xb2d97b87
1007932.39,4.0,18,4,4,2,10,0xb2d42b05
30969.45,1.0,14,2,2,3,7,0xb2d6a382d
30002.23,2.0,97,2,3,1,6,0xb2d63a1c
0.07,1.0,1,1,2,4,7,0xb2d17f32
303648.71,3.0,139,4,4,1,9,0xb2d1b488d
2629.65,1.0,1,1,2,4,7,0xb2d176ebd
319.81,1.0,2,1,2,4,7,0xb2d6a736d
350043.23,2.0,16,4,3,2,9,0xb2d9e493
2778.84,1.0,184,1,2,1,4,0xb2d30dadd
505189.99,3.0,0,4,4,4,12,0xb2d3b1de
43185.94,1.0,2,2,2,4,8,0xb2d06c16d
50001.6,2.0,98,2,3,1,6,0xb2d58906
205049.72,6.0,3,3,4,4,11,0xb2d1078ed
80022.03,3.0,136,3,4,1,8,0xb2d633c3d
190315.53,4.0,83,3,4,1,8,0xb2d55a1a
163726.83,3.0,20,3,4,2,9,0xb2d55eb0d
296008.91,6.0,0,3,4,4,11,0xb2d07c6dd
168205.34,2.0,3,3,3,4,10,0xb2da1470
1026.66,1.0,92,1,2,1,4,0xb2d17647d
3010090.0,4.0,2,4,4,4,12,0xb2d276c5d
34970.01,1.0,8,2,2,3,7,0xb2d30213
41.99,1.0,0,1,2,4,7,0xb2d8c51dd
28923.59,2.0,0,2,3,4,9,0xb2d46ffad
31.37,1.0,54,1,2,2,5,0xb2d285f3
2399125.95,16.0,0,4,4,4,12,0x3b9adcc6
446367.93,4.0,13,4,4,3,11,0xb2d24c37d
145000.0,5.0,7,3,4,3,10,0xb2d62b93d
1006.32,1.0,306,1,2,1,4,0xb2d31d80d
2405.3,1.0,6,1,2,3,6,0xb2d376d4
496152.64,15.0,1,4,4,4,12,0xb2d4f40a
643.63,1.0,13,1,2,3,6,0xb2d69658d
132039.69,3.0,11,3,4,3,10,0xb2d57bcf
372012.12,8.0,0,4,4,4,12,0xb2d5f6bdd
4764.53,1.0,0,2,2,4,8,0xb2d55815d
30793.72,2.0,41,2,3,2,7,0xb2d4b50bd
248586.44,3.0,0,3,4,4,11,0xb2d1256cd
1847.55,1.0,0,1,2,4,7,0xb2d985f5
100001.27,2.0,67,3,3,1,7,0xb2d85a56d
200053.2,3.0,105,3,4,1,8,0xb2d11932
600711.28,4.0,0,4,4,4,12,0xb2d6da28
40000.0,2.0,0,2,3,4,9,0xb2d97cf9
2945.88,1.0,9,2,2,3,7,0xb2d21d4d
683156.11,1.0,0,4,2,4,10,0xb2d2e181
690786.64,1.0,10,4,2,3,9,0xb2d20a21
10.66,1.0,64,1,2,2,5,0xb2d23bb8d
50001.58,2.0,53,2,3,2,7,0xb2d9cb56
5.02,1.0,52,1,2,2,5,0xb2d696b0d
722.13,1.0,1,1,2,4,7,0xb2d3d83ed
198265.73,6.0,1,3,4,4,11,0xb2d5ac60
5187.68,1.0,184,2,2,1,5,0xb2d5ed7e
98.66,1.0,15,1,2,3,6,0xb2d60a39
834906.05,4.0,24,4,4,2,10,0x3b9b3dcad
54586.04,1.0,1,3,2,4,9,0xb2d4f685
590052.18,2.0,0,4,3,4,11,0xb2d192a4
50005.88,2.0,133,2,3,1,6,0xb2d56f26d
9.71,1.0,39,1,2,2,5,0xb2d8f233d
220000.0,2.0,7,3,3,3,9,0xb2da539b
423135.77,5.0,6,4,4,3,11,0xb2d3c547
1.68,1.0,0,1,2,4,7,0xb2d717ac
8915.35,1.0,32,2,2,2,6,0xb2d2a68bd
3.38,1.0,34,1,2,2,5,0xb2d908c4
342008.84,3.0,18,4,4,2,10,0xb2d475d7
610718.56,3.0,18,4,4,2,10,0xb2d29100d
734052.09,11.0,0,4,4,4,12,0xb2d30745d
86087.8,2.0,5,3,3,3,9,0xb2d111b3d
9751.89,1.0,17,2,2,2,6,0xb2d1c452
266990.83,3.0,0,3,4,4,11,0xb2d1560dd
30974.99,1.0,8,2,2,3,7,0xb2d6a932d
1565.96,1.0,78,1,2,1,4,0xb2d27d7bd
913846.01,5.0,67,4,4,1,9,0xb2d48dab
7375.64,1.0,98,2,2,1,5,0xb2d57ab7d
110002.32,2.0,52,3,3,2,8,0xb2d9082cd
952052.6,5.0,55,4,4,2,10,0xb2d16ebcd
104499.52,3.0,18,3,4,2,9,0xb2d4fe38
27278.67,5.0,0,2,4,4,10,0xb2d21106
313054.75,4.0,24,4,4,2,10,0xb2d6caecd
190030.38,3.0,28,3,4,2,9,0xb2d57381
97457.35,5.0,38,3,4,2,9,0xb2d47428d
143510.92,3.0,2,3,4,4,11,0xb2d35284
400721.53,3.0,28,4,4,2,10,0xb2da02ff
160403.16,7.0,11,3,4,3,10,0xb2d6081dd
418608.72,4.0,41,4,4,2,10,0xb2d420c1d
149014.55,4.0,1,3,4,4,11,0xb2d93bdad
50008.51,2.0,139,2,3,1,6,0xb2d6298a
1746.12,1.0,7,1,2,3,6,0xb2d3c83c
158232.73,2.0,92,3,3,1,7,0xb2d23122
957006.36,6.0,3,4,4,4,12,0xb2d53628d
9506.34,1.0,43,2,2,2,6,0xb2d24a99
286702.13,3.0,4,3,4,4,11,0xb2d2445f
1814123.58,3.0,189,4,4,1,9,0xb2d319f8d
120004.59,3.0,77,3,4,1,8,0xb2d66576d
76.81,1.0,6,1,2,3,6,0xb2d5cfb0d
52.39,1.0,57,1,2,2,5,0xb2d8f6e8d
3000000.0,2.0,8,4,3,3,10,0xb2d5dda0
10513.44,1.0,20,2,2,2,6,0xb2d9143bd
300009.5,2.0,80,3,3,1,7,0xb2d98b38
342764.34,4.0,36,4,4,2,10,0xb2d528e6
495591.58,4.0,34,4,4,2,10,0xb2d53edc
500002.21,2.0,19,4,3,2,9,0xb2d422e2d
6768.14,1.0,2,2,2,4,8,0xb2d6b7c4d
100102.87,3.0,182,3,4,1,8,0xb2d771ead
4152.17,1.0,4,2,2,4,8,0xb2d48b4dd
1009.96,1.0,92,1,2,1,4,0xb2d2962a
359968.87,9.0,3,4,4,4,12,0xb2d064b2
50047.74,1.0,27,2,2,2,6,0xb2d35694
7.39,1.0,6,1,2,3,6,0xb2d601fe
400004.95,4.0,70,4,4,1,9,0xb2d0f551
225816.49,1.0,1,3,2,4,9,0xb2d92205
846003.13,8.0,67,4,4,1,9,0x3b9b241dd
32809.83,1.0,1,2,2,4,8,0xb2d81276d
500000.12,2.0,17,4,3,2,9,0xb2d7af25d
10022.71,2.0,4,2,3,4,9,0xb2d6a4d0d
173707.18,2.0,11,3,3,3,9,0xb2d103e1d
98002.12,2.0,48,3,3,2,8,0xb2d3e61a
2.14,1.0,49,1,2,2,5,0xb2d51b0a
289625.79,9.0,0,3,4,4,11,0x3b9b4637d
50145.76,2.0,38,2,3,2,7,0xb2d6298ad
78.73,1.0,21,1,2,2,5,0xb2d21aeed
50874.5,3.0,0,2,4,4,10,0xb2d0b396d
3510.7,1.0,16,2,2,2,6,0xb2d2bfb3
20010.39,3.0,68,2,4,1,7,0xb2d39cad
912885.28,4.0,6,4,4,3,11,0xb2d68057
507483.04,3.0,204,4,4,1,9,0xb2d6f60d
350061.43,2.0,8,4,3,3,10,0xb2d58ba1d
200000.0,2.0,20,3,3,2,8,0xb2d953d2d
367578.98,2.0,9,4,3,3,10,0xb2d623c9d
390052.3,4.0,53,4,4,2,10,0xb2d07abb
281111.56,2.0,9,3,3,3,9,0xb2d5bd1ed
24312.58,1.0,80,2,2,1,5,0xb2d8c958d
137027.04,1.0,3,3,2,4,9,0xb2d7fcb4
1500042.6,3.0,77,4,4,1,9,0xb2d63345d
12036.12,2.0,32,2,3,2,7,0xb2d6e280d
200373.85,4.0,1,3,4,4,11,0xb2d08041
403925.94,4.0,7,4,4,3,11,0xb2d429ef
3405831.04,9.0,6,4,4,3,11,0xb2d7fbdbd
400000.0,3.0,4,4,4,4,12,0xb2d946b7
121000.98,8.0,28,3,4,2,9,0xb2d3bb95
129.1,1.0,284,1,2,1,4,0xb2d4e302d
4003.81,1.0,92,2,2,1,5,0xb2d511aa
61.49,1.0,0,1,2,4,7,0xb2d953ff
2206.92,1.0,5,1,2,3,6,0xb2d2d6b0
1120044.45,9.0,25,4,4,2,10,0xb2d6592ed
45005.58,3.0,0,2,4,4,10,0xb2d2d64d
41000.43,2.0,69,2,3,1,6,0xb2d8eb0d
17.94,1.0,11,1,2,3,6,0xb2d9482f
320000.46,2.0,8,4,3,3,10,0xb2d92f46d
150448.66,3.0,3,3,4,4,11,0xb2d23193
723000.0,16.0,7,4,4,3,11,0xb2d217b6
1005.29,1.0,184,1,2,1,4,0xb2d51090d
3090.8,1.0,92,2,2,1,5,0xb2d24fd6d
62452.78,2.0,6,3,3,3,9,0xb2d1de85
5402.69,1.0,7,2,2,3,7,0xb2d9c34c
115936.07,3.0,95,3,4,1,8,0xb2d2dd56
34941.79,1.0,0,2,2,4,8,0xb2d22400
41.49,1.0,10,1,2,3,6,0xb2d98a64
150000.0,2.0,3,3,3,4,10,0xb2d684fe
40001.26,3.0,154,2,4,1,7,0xb2d8d63c
5366.46,1.0,10,2,2,3,7,0xb2d37437d
8123.6,2.0,92,2,3,1,6,0xb2d5c238
159951.36,4.0,25,3,4,2,9,0xb2d7437ad
92622.59,1.0,3,3,2,4,9,0xb2d6553b
25043.93,1.0,13,2,2,3,7,0xb2d28419
823.31,1.0,27,1,2,2,5,0xb2d6cb38d
26.34,5.0,88,1,4,1,6,0xb2d08aa4
150837.82,5.0,11,3,4,3,10,0xb2d6033ad
60102.13,3.0,45,3,4,2,9,0xb2d8f24b
444407.34,4.0,3,4,4,4,12,0xb2d0ef03
102036.72,1.0,12,3,2,3,8,0xb2d5c46c
79.42,1.0,7,1,2,3,6,0xb2d8c854
2199.08,1.0,69,1,2,1,4,0xb2d9aaf2
83027.5,2.0,196,3,3,1,7,0xb2d580f4
170734.62,2.0,0,3,3,4,10,0xb2d5a662
4568.74,1.0,7,2,2,3,7,0xb2d2f26ad
206395.63,2.0,0,3,3,4,10,0xb2d483e5
1048.41,1.0,214,1,2,1,4,0xb2d51ba7d
100042.91,2.0,66,3,3,2,8,0xb2d539c5d
200710.42,2.0,32,3,3,2,8,0xb2d93bac
1217099.52,3.0,174,4,4,1,9,0xb2d35672
260016.0,2.0,6,3,3,3,9,0xb2d630bbd
39.13,1.0,19,1,2,2,5,0xb2d9cc0a
930002.5,15.0,3,4,4,4,12,0xb2d15255d
2448.39,1.0,92,1,2,1,4,0xb2d42701d
51379.29,2.0,39,2,3,2,7,0xb2d5300cd
13.4,1.0,43,1,2,2,5,0xb2d908e0
262009.75,4.0,18,3,4,2,9,0xb2d60b78d
97.51,1.0,38,1,2,2,5,0xb2d29f68
80305.33,6.0,13,3,4,3,10,0xb2d6e4a1d
456.65,1.0,19,1,2,2,5,0xb2d93d93d
1001.59,1.0,161,1,2,1,4,0xb2d8ee84
4609.94,1.0,25,2,2,2,6,0xb2d69697
130009.37,5.0,83,3,4,1,8,0xb2d5b3b7d
311639.85,3.0,74,4,4,1,9,0xb2d472fa
40278.17,1.0,184,2,2,1,5,0xb2d43057
51052.26,4.0,56,2,4,2,8,0xb2d30a99
1017930.46,2.0,97,4,3,1,8,0xb2d5f351d
200000.68,2.0,6,3,3,3,9,0xb2d92a61d
435000.0,15.0,0,4,4,4,12,0xb2d2edbf
60004.4,3.0,18,3,4,2,9,0xb2d39390
131046.6,4.0,18,3,4,2,9,0xb2d57a7ed
6019.49,1.0,92,2,2,1,5,0xb2d1c13fd
623000.0,3.0,0,4,4,4,12,0xb2d99543
1298.87,1.0,5,1,2,3,6,0xb2d96586
1420006.34,4.0,26,4,4,2,10,0xb2d92ec0
200000.61,2.0,8,3,3,3,9,0xb2d8cb96
554546.48,1.0,12,4,2,3,9,0xb2d504ccd
5259.16,1.0,17,2,2,2,6,0xb2d276b0
1.03,1.0,26,1,2,2,5,0xb2d9bf1f
374970.68,3.0,33,4,4,2,10,0xb2d3aba8d
30463.63,2.0,11,2,3,3,8,0xb2d56558
56207.12,2.0,180,3,3,1,7,0xb2d2a30fd
6589.84,1.0,11,2,2,3,7,0xb2d912e7
22859.35,1.0,31,2,2,2,6,0xb2d77f5ad
1000046.4,2.0,0,4,3,4,11,0xb2d14a13
14228.45,1.0,3,2,2,4,8,0xb2d6a1d0d
90021.91,2.0,95,3,3,1,7,0xb2d65196
50000.23,2.0,82,2,3,1,6,0xb2d3acbad
120000.53,5.0,10,3,4,3,10,0xb2d51e7d
500000.0,2.0,15,4,3,3,10,0xb2da376d
60.8,1.0,46,1,2,2,5,0xb2d97728
321034.21,2.0,14,4,3,3,10,0xb2d5f14cd
52000.67,3.0,69,2,4,1,7,0xb2d23e56
90014.27,2.0,67,3,3,1,7,0xb2d20226
563.58,1.0,9,1,2,3,6,0xb2d21d65
9.5,1.0,18,1,2,2,5,0xb2d976bc
110937.49,4.0,1,3,4,4,11,0xb2d1c423
384822.34,2.0,63,4,3,2,9,0xb2d61236d
2805348.5,19.0,0,4,4,4,12,0xb2d2cab2d
459694.86,5.0,6,4,4,3,11,0xb2d0e1f5
2942.56,2.0,0,2,3,4,9,0xb2d16e9bd
5372.65,1.0,92,2,2,1,5,0xb2d2b081d
1460747.17,9.0,18,4,4,2,10,0xb2d67f09
830973.8,5.0,1,4,4,4,12,0xb2d6ff89d
500082.61,3.0,11,4,4,3,11,0xb2d15376
84604.47,2.0,67,3,3,1,7,0xb2d2c842
1072042.14,4.0,116,4,4,1,9,0xb2d2954fd
210867.17,1.0,67,3,2,1,6,0xb2d1f4e9d
453212.09,2.0,23,4,3,2,9,0xb2d8cdab
125666.87,3.0,0,3,4,4,11,0xb2d55259
458961.47,7.0,49,4,4,2,10,0xb2d4fc8fd
10001.35,2.0,199,2,3,1,6,0xb2d5cf72
7000.82,2.0,35,2,3,2,7,0xb2d1c4a3d
380100.09,2.0,25,4,3,2,9,0xb2d98526
4344.71,1.0,4,2,2,4,8,0xb2d6bff2d
8966.14,1.0,12,2,2,3,7,0xb2d5e78f
85660.73,2.0,5,3,3,3,9,0x3b9b30be
422600.1,9.0,29,4,4,2,10,0xb2d11282
400035.51,3.0,1,4,4,4,12,0xb2d1ecc2
60000.63,2.0,18,3,3,2,8,0xb2d1fcdf
537018.84,3.0,125,4,4,1,9,0xb2d3b55fd
560.5,1.0,26,1,2,2,5,0xb2d6e419
203795.73,2.0,7,3,3,3,9,0xb2d0cc87
3097.01,1.0,176,2,2,1,5,0xb2d29787
30.99,1.0,33,1,2,2,5,0xb2d2337ed
4952.71,1.0,3,2,2,4,8,0xb2d7929e
296.91,1.0,8,1,2,3,6,0xb2d39febd
0.17,1.0,63,1,2,2,5,0xb2d64ac9
1917.39,1.0,184,1,2,1,4,0xb2d38a8b
3886.77,1.0,0,2,2,4,8,0xb2d57a5b
50000.0,2.0,0,2,3,4,9,0xb2d97dcf
250049.37,2.0,0,3,3,4,10,0xb2d17450d
200710.95,2.0,25,3,3,2,8,0xb2d8d7c6
500000.0,2.0,1,4,3,4,11,0xb2d9788a
530235.35,10.0,5,4,4,3,11,0xb2d3c60e
2317.58,1.0,0,1,2,4,7,0xb2d44407d
151152.94,2.0,18,3,3,2,8,0xb2d0baf0d
3.04,2.0,28,1,3,2,6,0xb2d9bf1b
202482.26,7.0,1,3,4,4,11,0xb2d4915f
527918.56,6.0,34,4,4,2,10,0xb2d230f8d
68.77,1.0,8,1,2,3,6,0xb2d41659d
450263.83,5.0,0,4,4,4,12,0xb2d54deed
58010.05,3.0,12,3,4,3,10,0xb2d39c96
200799.05,2.0,27,3,3,2,8,0xb2d0d0d0
204.65,1.0,11,1,2,3,6,0xb2d65ecd
50812.01,2.0,28,2,3,2,7,0xb2d936ee
0.0,1.0,20,1,2,2,5,0xb2d8e954
12.68,1.0,7,1,2,3,6,0xb2d4dc10
5473.63,1.0,184,2,2,1,5,0xb2d33168d
438446.81,2.0,181,4,3,1,8,0xb2d3b0ab
850190.53,4.0,103,4,4,1,9,0xb2d26349d
103663.49,3.0,101,3,4,1,8,0xb2d158c1d
261.79,1.0,82,1,2,1,4,0xb2d8f0f1d
190007.73,4.0,20,3,4,2,9,0xb2d5f93f
52410.48,2.0,97,3,3,1,7,0xb2d5174ad
22297.11,1.0,92,2,2,1,5,0xb2d1da32
400090.03,2.0,14,4,3,3,10,0xb2d1daa9
13759.46,1.0,6,2,2,3,7,0xb2d40915d
40028.55,4.0,4,2,4,4,10,0xb2d56847d
2028.84,1.0,0,1,2,4,7,0xb2d8de9fd
92025.28,2.0,92,3,3,1,7,0xb2d0c437d
1468.83,13.0,0,1,4,4,9,0xb2d0a297d
1052.87,1.0,0,1,2,4,7,0xb2d62c7ad
992426.52,6.0,39,4,4,2,10,0xb2d104c4
17890.73,1.0,9,2,2,3,7,0xb2d5f0f1
350021.01,4.0,10,4,4,3,11,0xb2d67ddfd
102007.0,2.0,200,3,3,1,7,0xb2d5ee68d
3218.48,1.0,38,2,2,2,6,0xb2d6342b
395780.23,5.0,30,4,4,2,10,0xb2d20637d
73.19,2.0,27,1,3,2,6,0xb2d064c5d
9840.04,1.0,92,2,2,1,5,0x3b9b1a10d
6439.02,3.0,184,2,4,1,7,0xb2d2c904
40001.79,2.0,231,2,3,1,6,0xb2d6eb6f
555.09,1.0,13,1,2,3,6,0xb2d1f8b7d
24924.46,1.0,19,2,2,2,6,0xb2d2fc8cd
91300.8,3.0,1,3,4,4,11,0xb2d60261
203554.79,2.0,174,3,3,1,7,0xb2d8d4a8d
16104.08,1.0,0,2,2,4,8,0xb2d6bd39
453261.57,4.0,2,4,4,4,12,0xb2d10836
206419.19,2.0,132,3,3,1,7,0xb2d46569d
53576.2,2.0,47,3,3,2,8,0xb2d3be44d
1352.58,1.0,184,1,2,1,4,0xb2d29fc4d
19744.81,1.0,140,2,2,1,5,0xb2d3f46fd
100000.0,2.0,0,3,3,4,10,0xb2d97c57d
33624.49,2.0,125,2,3,1,6,0xb2d61e31d
1779.08,1.0,10,1,2,3,6,0xb2d94e80
20416.24,2.0,3,2,3,4,9,0xb2d40bf3
2438.52,1.0,12,1,2,3,6,0xb2d5cfac
47563.51,1.0,167,2,2,1,5,0xb2d6c1de
177.3,1.0,82,1,2,1,4,0xb2d2ecdad
566985.32,4.0,33,4,4,2,10,0xb2d0f1fb
0.0,1.0,113,1,2,1,4,0xb2d30874
960000.62,4.0,4,4,4,4,12,0xb2d21256
988.56,1.0,9,1,2,3,6,0xb2d6deb4
820179.56,2.0,97,4,3,1,8,0xb2d13b1c
1905632.7,4.0,9,4,4,3,11,0xb2d41b98
272869.5,3.0,80,3,4,1,8,0xb2d1848e
5698.85,1.0,10,2,2,3,7,0xb2d32b62d
770021.72,8.0,0,4,4,4,12,0xb2d5a997
3572060.92,20.0,4,4,4,4,12,0xb2d2c395
180023.72,6.0,5,3,4,3,10,0xb2d39df7d
100000.0,1.0,4,3,2,4,9,0xb2da61be
330017.42,2.0,35,4,3,2,9,0xb2d95c7b
89.78,1.0,66,1,2,2,5,0xb2d29b79
200096.0,2.0,1,3,3,4,10,0xb2da5788
40000.84,2.0,172,2,3,1,6,0xb2d8d592d
40000.66,3.0,24,2,4,2,8,0xb2d88007d
5872.4,1.0,10,2,2,3,7,0xb2d408b9d
2.32,1.0,56,1,2,2,5,0xb2d9655f
1340.64,1.0,11,1,2,3,6,0xb2d2f110d
2015.96,1.0,12,1,2,3,6,0xb2d67dfb
22011.94,1.0,76,2,2,1,5,0xb2d7f14ed
1518.44,1.0,9,1,2,3,6,0xb2d3298fd
105455.31,2.0,27,3,3,2,8,0xb2d46f31d
25033.35,1.0,135,2,2,1,5,0xb2d3c42e
110473.94,4.0,17,3,4,2,9,0xb2d42259
67.17,1.0,28,1,2,2,5,0xb2d6c40d
55047.14,2.0,42,3,3,2,8,0xb2d45487d
20089.92,2.0,31,2,3,2,7,0xb2d22c3a
20091.53,2.0,0,2,3,4,9,0xb2d6530ed
213966.02,1.0,1,3,2,4,9,0xb2d8df70
200700.0,2.0,7,3,3,3,9,0xb2d1cac0
213760.57,2.0,9,3,3,3,9,0xb2d3a5ae
1.58,1.0,26,1,2,2,5,0xb2da0c2d
1739.14,1.0,92,1,2,1,4,0xb2d1a4f6
1000031.67,2.0,24,4,3,2,9,0xb2d944a9
256736.62,1.0,0,3,2,4,9,0xb2d4addad
50000.0,2.0,6,2,3,3,8,0xb2d6ba26d
543213.64,4.0,10,4,4,3,11,0xb2d4f6d0d
900005.49,2.0,1,4,3,4,11,0xb2d979ddd
30061.64,1.0,1,2,2,4,8,0xb2d1b5d7
105128.6,7.0,0,3,4,4,11,0xb2d50502d
800000.16,8.0,0,4,4,4,12,0xb2d417b4d
98.16,1.0,70,1,2,1,4,0xb2d63880
106.49,1.0,111,1,2,1,4,0xb2d48a0d
1.59,2.0,0,1,3,4,8,0xb2d540af
89062.21,2.0,118,3,3,1,7,0xb2d19e11d
200004.22,2.0,39,3,3,2,8,0xb2d9efa2
500.01,1.0,12,1,2,3,6,0xb2d55b4b
1243263.4,4.0,0,4,4,4,12,0xb2d1dae7
47583.45,1.0,6,2,2,3,7,0xb2d2b0b7
437485.17,3.0,116,4,4,1,9,0xb2d10aaf
1724449.95,4.0,10,4,4,3,11,0xb2d1a310d
190006.02,2.0,66,3,3,2,8,0xb2d8e6f0d
400004.22,2.0,196,4,3,1,8,0xb2d78f1a
44379.11,2.0,9,2,3,3,8,0xb2d94a46
110330.04,4.0,1,3,4,4,11,0xb2d40a5b
30572.24,1.0,0,2,2,4,8,0xb2d6c48bd
28000.3,2.0,21,2,3,2,7,0xb2da204f
10014.37,2.0,10,2,3,3,8,0xb2d6e1b2d
5168.6,1.0,92,2,2,1,5,0xb2d26fb5
171359.75,4.0,0,3,4,4,11,0xb2d60e83d
242001.5,11.0,0,3,4,4,11,0xb2d3cc3f
2149.83,3.0,0,1,4,4,9,0x3b9af115d
345227.25,2.0,154,4,3,1,8,0xb2d0e713
871716.0,3.0,3,4,4,4,12,0xb2d91c56d
25648.21,1.0,11,2,2,3,7,0xb2d5ce24d
11946.13,1.0,7,2,2,3,7,0xb2d1f05f
101011.89,2.0,56,3,3,2,8,0xb2d24bb9d
20000.63,2.0,60,2,3,2,7,0xb2d9b8e0
401526.43,2.0,46,4,3,2,9,0xb2d6f176d
224248.5,2.0,118,3,3,1,7,0xb2d12a87d
528248.1,4.0,6,4,4,3,11,0xb2d0e600
91749.3,3.0,0,3,4,4,11,0xb2d3d9e2d
35002.49,2.0,62,2,3,2,7,0xb2d8e695d
5.47,1.0,80,1,2,1,4,0xb2d5cc9b
200021.78,2.0,26,3,3,2,8,0xb2d5fe23d
24307.32,1.0,2,2,2,4,8,0xb2d6f345d
745.49,1.0,16,1,2,2,5,0xb2d29623
1060.58,1.0,124,1,2,1,4,0xb2d65163d
220003.21,2.0,6,3,3,3,9,0xb2d53796
74.25,1.0,70,1,2,1,4,0xb2d37a3bd
502137.96,3.0,92,4,4,1,9,0xb2d57609
47278.89,1.0,4,2,2,4,8,0xb2d2e199d
126.84,1.0,25,1,2,2,5,0xb2d15e9c
8.12,1.0,70,1,2,1,4,0xb2d55c6d
200000.0,2.0,4,3,3,4,10,0xb2da618a
490936.37,11.0,3,4,4,4,12,0xb2d4116dd
61366.14,1.0,2,3,2,4,9,0xb2d29887d
53778.91,2.0,90,3,3,1,7,0xb2d3a35d
188.67,1.0,5,1,2,3,6,0xb2d4c10bd
220021.63,1.0,0,3,2,4,9,0xb2d0fb74
16617.93,1.0,61,2,2,2,6,0xb2d8c37e
302113.61,2.0,143,4,3,1,8,0xb2d68230d
95.29,1.0,4,1,2,4,7,0xb2d9696a
1046.46,1.0,0,1,2,4,7,0xb2d426d5d
1143.42,1.0,92,1,2,1,4,0xb2d09de4d
277508.77,1.0,0,3,2,4,9,0xb2d9aebf
4760.21,1.0,0,2,2,4,8,0xb2d60a42d
120003.8,2.0,18,3,3,2,8,0xb2da2668
2746.96,1.0,23,1,2,2,5,0xb2d1d893d
1814.84,1.0,92,1,2,1,4,0xb2d2670d
2539.5,1.0,4,1,2,4,7,0xb2d30cbad
200000.0,2.0,7,3,3,3,9,0xb2d92f6a
4845.46,2.0,1,2,3,4,9,0x3b9b3deed
1194607.36,7.0,0,4,4,4,12,0xb2d1a41ed
64.04,1.0,0,1,2,4,7,0xb2d62dd4
36579.74,1.0,92,2,2,1,5,0x3b9b3f1a
319460.3,3.0,1,4,4,4,12,0xb2d652fad
4759.39,2.0,35,2,3,2,7,0xb2d9de74
1173000.0,1.0,0,4,2,4,10,0xb2da257c
2079.44,1.0,84,1,2,1,4,0xb2d079cdd
22177.56,1.0,19,2,2,2,6,0xb2d953a0
1000000.0,2.0,3,4,3,4,11,0xb2d93550d
2050294.71,5.0,10,4,4,3,11,0xb2d5769d
140704.54,1.0,92,3,2,1,6,0xb2d28017
35888.97,1.0,1,2,2,4,8,0xb2d6cc9c
4.85,1.0,0,1,2,4,7,0xb2d90c49
461032.39,2.0,38,4,3,2,9,0xb2d6dd7cd
90054243.35,5.0,3,4,4,4,12,0xb2d40a9f
280713.76,3.0,31,3,4,2,9,0xb2d6fecf
2.52,2.0,88,1,3,1,5,0xb2d56460
50134.64,2.0,32,2,3,2,7,0xb2d5d167
304712.46,3.0,11,4,4,3,11,0xb2d1e327d
108936.38,2.0,3,3,3,4,10,0xb2d1d3a2
92.44,1.0,157,1,2,1,4,0xb2d43735d
83003.75,4.0,92,3,4,1,8,0xb2d29585
5056.16,1.0,25,2,2,2,6,0xb2d5efb6d
426352.0,5.0,20,4,4,2,10,0xb2d50b5bd
200026.37,2.0,1,3,3,4,10,0xb2da046e
3925.7,1.0,184,2,2,1,5,0x3b9adc71d
1800028.58,10.0,0,4,4,4,12,0x3b9b1085
413139.95,2.0,97,4,3,1,8,0xb2d650a0
21.83,1.0,53,1,2,2,5,0xb2d2f7ab
26722.87,1.0,0,2,2,4,8,0xb2d18857d
3191.61,1.0,4,2,2,4,8,0xb2d3435dd
51256.07,1.0,47,2,2,2,6,0xb2d696e5
100252.97,2.0,1,3,3,4,10,0xb2d5cecad
1180000.0,15.0,7,4,4,3,11,0xb2d237d6d
50108.62,1.0,0,2,2,4,8,0xb2d5f5bf
50022.71,2.0,77,2,3,1,6,0xb2d26d19
9022.31,1.0,0,2,2,4,8,0xb2d6501d
7662.98,1.0,4,2,2,4,8,0xb2d3fcb9
85000.0,3.0,5,3,4,3,10,0xb2d2adc1
50000.53,2.0,92,2,3,1,6,0xb2d6400f
50005.29,2.0,98,2,3,1,6,0xb2d30f58d
2075.14,5.0,0,1,4,4,9,0x3b9b482bd
4457.82,2.0,145,2,3,1,6,0xb2d0b7c6
605114.08,2.0,76,4,3,1,8,0xb2d189aad
250051.32,5.0,63,3,4,2,9,0xb2d4ea29
249.77,1.0,56,1,2,2,5,0xb2d4149e
86114.04,5.0,1,3,4,4,11,0xb2d28e86d
731521.42,8.0,5,4,4,3,11,0xb2d1e8ab
700000.0,2.0,7,4,3,3,10,0xb2d92d6e
1641.49,1.0,0,1,2,4,7,0xb2d599ba
2.53,1.0,4,1,2,4,7,0xb2d26cc1
350011.2,4.0,10,4,4,3,11,0xb2d57b67
460021.01,2.0,14,4,3,3,10,0xb2d688a8d
78084.37,4.0,102,3,4,1,8,0xb2d596fbd
50408.16,2.0,116,2,3,1,6,0xb2d6aca1d
10.97,1.0,51,1,2,2,5,0xb2d3a364
243141.22,3.0,130,3,4,1,8,0x3b9b24f8
569193.88,2.0,5,4,3,3,10,0xb2d19414d
100008.62,2.0,139,3,3,1,7,0xb2d4b33ad
438652.39,2.0,82,4,3,1,8,0xb2d1b0abd
300009.12,3.0,10,3,4,3,10,0xb2d5d4a4d
51768.82,1.0,92,2,2,1,5,0xb2d4d888d
2550071.12,5.0,25,4,4,2,10,0xb2d9034c
400101.66,3.0,18,4,4,2,10,0xb2d0b44ad
173049.53,3.0,56,3,4,2,9,0xb2d129e3d
106709.2,2.0,18,3,3,2,8,0xb2d32488d
12400.76,1.0,10,2,2,3,7,0xb2d4ea34
3713.46,1.0,1,2,2,4,8,0xb2d79055d
595980.45,4.0,15,4,4,3,11,0xb2d0bf95d
57.65,1.0,10,1,2,3,6,0xb2d65c0fd
101004.02,2.0,101,3,3,1,7,0xb2d64a62d
300041.11,2.0,11,3,3,3,9,0xb2d4e13f
140367.06,5.0,35,3,4,2,9,0xb2d36637
392009.93,7.0,6,4,4,3,11,0xb2d93146d
9960.06,1.0,0,2,2,4,8,0xb2d69618d
1331041.66,10.0,34,4,4,2,10,0xb2d1eeeb
150099.83,1.0,0,3,2,4,9,0xb2d2529ed
6000.76,1.0,22,2,2,2,6,0xb2d92f05
199.1,1.0,65,1,2,2,5,0xb2d42397
143349.68,2.0,153,3,3,1,7,0xb2d41554
179715.33,2.0,8,3,3,3,9,0xb2d5cc49
31914.0,1.0,1,2,2,4,8,0xb2d2829dd
411.54,1.0,12,1,2,3,6,0xb2d17a6c
4009.47,1.0,19,2,2,2,6,0xb2d53503
1187.5,1.0,92,1,2,1,4,0xb2d21790d
2508.19,12.0,0,1,4,4,9,0xb2d21060
4845.41,1.0,2,2,2,4,8,0xb2d6e476
1124645.23,4.0,19,4,4,2,10,0xb2d10b00d
407.74,1.0,17,1,2,2,5,0xb2d2d30ed
130000.0,1.0,0,3,2,4,9,0xb2d9270cd
1000005.03,6.0,11,4,4,3,11,0xb2d5e35d
1188.88,1.0,155,1,2,1,4,0xb2d590c5d
2.06,1.0,18,1,2,2,5,0xb2da2cad
220043.83,7.0,93,3,4,1,8,0xb2d20b8bd
11107.79,2.0,60,2,3,2,7,0xb2d10706d
1910173.79,4.0,6,4,4,3,11,0xb2d6b0de
154604.84,3.0,118,3,4,1,8,0xb2d3823dd
10517.31,1.0,0,2,2,4,8,0xb2d9834a
966567.9,6.0,0,4,4,4,12,0xb2d5d06ad
1002.67,1.0,9,1,2,3,6,0xb2d60a4ad
257013.28,3.0,70,3,4,1,8,0xb2d19705
1.09,1.0,56,1,2,2,5,0xb2d4d342
200494.58,2.0,56,3,3,2,8,0xb2d19a1ad
400000.0,2.0,26,4,3,2,9,0xb2da159c
20073.18,2.0,55,2,3,2,7,0xb2d8f045d
400142.16,2.0,6,4,3,3,10,0xb2d99bf1
50850.52,1.0,92,2,2,1,5,0xb2d4e862
762047.71,6.0,45,4,4,2,10,0xb2d8d4d0d
390065.33,9.0,46,4,4,2,10,0xb2d07114d
1017770.45,2.0,124,4,3,1,8,0xb2d8fb2cd
377607.83,5.0,52,4,4,2,10,0xb2d1b164d
1900.73,3.0,92,1,4,1,6,0xb2d08857
16254.33,1.0,14,2,2,3,7,0xb2d5d7ffd
2097.08,1.0,0,1,2,4,7,0xb2d5c58ad
134.04,1.0,25,1,2,2,5,0xb2d229ce
101117.93,6.0,24,3,4,2,9,0xb2d18e0a
250003.06,3.0,8,3,4,3,10,0xb2d9f22c
0.27,1.0,5,1,2,3,6,0xb2d8d278
604992.97,7.0,27,4,4,2,10,0xb2d56274d
390058.41,7.0,6,4,4,3,11,0xb2d5d07d
68.54,1.0,203,1,2,1,4,0xb2d5a7a2
1645207.06,2.0,12,4,3,3,10,0x3b9b4962
300099.19,2.0,15,3,3,3,9,0xb2d6a9f5
101079.44,1.0,184,3,2,1,6,0xb2d2b96dd
500055.07,2.0,19,4,3,2,9,0xb2d9e2b9
9621.06,1.0,184,2,2,1,5,0xb2d15971d
601036.54,7.0,11,4,4,3,11,0xb2d94d60d
200754.09,2.0,25,3,3,2,8,0xb2d6c6e6
193.22,1.0,45,1,2,2,5,0xb2d6b84ad
23968.47,19.0,5,2,4,3,9,0x3b9b3c86
376.72,1.0,70,1,2,1,4,0xb2d58ac8d
251002.13,3.0,6,3,4,3,10,0xb2da48b7
322.67,1.0,2,1,2,4,7,0xb2d85985
212321.69,7.0,1,3,4,4,11,0x3b9af15bd
40488.65,1.0,208,2,2,1,5,0xb2d69a86d
20817.24,1.0,3,2,2,4,8,0xb2d43def
3022.92,1.0,1,2,2,4,8,0xb2d8cfb3
2400000.0,2.0,92,4,3,1,8,0xb2d56e35d
30000.32,2.0,168,2,3,1,6,0xb2d8dda9
2848.29,1.0,76,1,2,1,4,0xb2d68c4e
30000.32,2.0,221,2,3,1,6,0xb2d7074d
649296.53,6.0,5,4,4,3,11,0xb2d3b6a4d
101642.09,19.0,0,3,4,4,11,0xb2d0e13ad
2697.17,1.0,5,1,2,3,6,0xb2d94befd
49.72,1.0,38,1,2,2,5,0xb2d803f9
25980.54,1.0,5,2,2,3,7,0xb2d6c4a3d
41422.28,1.0,134,2,2,1,5,0xb2d2ae9b
2369029.34,1.0,1,4,2,4,10,0xb2d2afd2d
4.39,1.0,13,1,2,3,6,0xb2d1bc87
82136.81,2.0,144,3,3,1,7,0xb2d59fbbd
5899.91,1.0,31,2,2,2,6,0xb2d42095
1795.31,1.0,164,1,2,1,4,0xb2d1ebe5d
770020.34,6.0,67,4,4,1,9,0xb2d3c72ad
99.56,1.0,34,1,2,2,5,0xb2d56d8fd
54010.44,5.0,2,3,4,4,11,0xb2d43e2dd
260008.24,2.0,108,3,3,1,7,0xb2d78ef4d
7512.53,1.0,92,2,2,1,5,0xb2d176b5
1080129.72,3.0,34,4,4,2,10,0xb2d64428
62.78,1.0,13,1,2,3,6,0xb2d6493c
161098.7,5.0,11,3,4,3,10,0xb2d27363
20006.34,4.0,59,2,4,2,8,0x3b9b26eb
700022.17,2.0,32,4,3,2,9,0xb2d9fc54
10042.24,1.0,0,2,2,4,8,0xb2d6a3d5
70000.53,3.0,6,3,4,3,10,0xb2d958b1
142.89,1.0,39,1,2,2,5,0xb2d65c60
96.72,1.0,10,1,2,3,6,0xb2d4572d
6895.17,2.0,92,2,3,1,6,0xb2d254d7d
410738.26,8.0,0,4,4,4,12,0xb2d225cd
211258.42,6.0,47,3,4,2,9,0x3b9b29af
1.69,1.0,12,1,2,3,6,0xb2d5737d
1132.23,1.0,4,1,2,4,7,0xb2d2b75ad
253634.52,6.0,4,3,4,4,11,0xb2d0aaf8
1067607.58,6.0,40,4,4,2,10,0xb2d4f555
8318.36,1.0,0,2,2,4,8,0xb2d906a3
70000.0,1.0,184,3,2,1,6,0xb2d274b1
271665.08,1.0,0,3,2,4,9,0xb2d4aa8dd
207045.6,7.0,32,3,4,2,9,0xb2d5dd77
184284.55,4.0,6,3,4,3,10,0xb2d16f6f
13012.21,2.0,76,2,3,1,6,0xb2d2b392d
5558.39,1.0,92,2,2,1,5,0x3b9b22f3d
303492.4,2.0,122,4,3,1,8,0xb2d65d41
60023.7,2.0,113,3,3,1,7,0xb2d1edd8
400.54,1.0,10,1,2,3,6,0xb2d59e5ad
600017.04,2.0,185,4,3,1,8,0xb2d7ef70
707.63,1.0,4,1,2,4,7,0xb2d3152ad
307.55,2.0,13,1,3,3,7,0xb2d5edd2
353880.99,3.0,0,4,4,4,12,0xb2d17e15d
204977.37,2.0,125,3,3,1,7,0xb2d7642ad
1354.65,1.0,1,1,2,4,7,0xb2d47279
7843.61,1.0,9,2,2,3,7,0xb2d44b6cd
3172.71,1.0,213,2,2,1,5,0xb2d298d8d
3.17,1.0,18,1,2,2,5,0xb2d95880
4396.72,1.0,26,2,2,2,6,0xb2d1f5a7d
102542.16,3.0,0,3,4,4,11,0xb2d55ecf
94.21,1.0,122,1,2,1,4,0xb2d412ac
170200.06,5.0,4,3,4,4,11,0xb2d3a47cd
175012.06,5.0,11,3,4,3,10,0xb2d633fe
170351.49,4.0,47,3,4,2,9,0xb2d25d45
100024.01,2.0,67,3,3,1,7,0xb2d39625
50001.58,2.0,66,2,3,2,7,0xb2d8ece9d
99.44,1.0,54,1,2,2,5,0xb2d3344d
404760.34,4.0,32,4,4,2,10,0xb2d2ad43d
50000.0,3.0,0,2,4,4,10,0xb2d1a2c2
40.6,1.0,18,1,2,2,5,0xb2d13807d
61534.59,5.0,26,3,4,2,9,0xb2d09174
16379.13,1.0,0,2,2,4,8,0xb2d405c2d
339.84,1.0,35,1,2,2,5,0xb2d36cbe
500000.5,2.0,5,4,3,3,10,0xb2d9570bd
19.23,1.0,157,1,2,1,4,0xb2d6d0c4d
1401568.8,14.0,6,4,4,3,11,0xb2d60e4b
0.0,1.0,7,1,2,3,6,0xb2d47600
34527.53,1.0,184,2,2,1,5,0xb2d3f966
100001.06,4.0,133,3,4,1,8,0xb2d8dd37d
268.87,1.0,29,1,2,2,5,0xb2d9b351
15733.19,1.0,14,2,2,3,7,0xb2d69fca
52003.98,2.0,75,2,3,1,6,0xb2d4bcf9
225278.66,2.0,3,3,3,4,10,0xb2d50155d
0.67,1.0,19,1,2,2,5,0xb2d70177
7007.23,1.0,19,2,2,2,6,0xb2d53cb5d
0.47,1.0,8,1,2,3,6,0xb2d105c0
35387.06,2.0,0,2,3,4,9,0xb2d925edd
194.86,1.0,47,1,2,2,5,0xb2d6aaf7
100056.59,2.0,21,3,3,2,8,0xb2d3eb00d
150007.92,3.0,97,3,4,1,8,0xb2d91f72d
250964.59,2.0,19,3,3,2,8,0xb2d790f8
2187.96,1.0,7,1,2,3,6,0xb2d229aed
432051.82,8.0,0,4,4,4,12,0x3b9b3e07d
26376.59,1.0,4,2,2,4,8,0xb2d35b4c
1025.9,1.0,92,1,2,1,4,0xb2d0ea9fd
33298.9,1.0,0,2,2,4,8,0xb2d17ce4
83.14,1.0,10,1,2,3,6,0xb2d438c8
7009.63,3.0,20,2,4,2,8,0xb2d6e240
576113.19,5.0,3,4,4,4,12,0xb2d14622
523427.38,5.0,56,4,4,2,10,0xb2d48b58d
90102.87,2.0,31,3,3,2,8,0xb2d935acd
4041.27,1.0,160,2,2,1,5,0xb2d60d50d
200000.0,2.0,0,3,3,4,10,0xb2d946b7d
70.11,1.0,0,1,2,4,7,0xb2d9305fd
275691.11,4.0,24,3,4,2,9,0xb2d6bb14d
294272.15,2.0,126,3,3,1,7,0xb2d6adb8d
188.93,2.0,21,1,3,2,6,0xb2d6b319
100000.0,2.0,3,3,3,4,10,0xb2d651d0
112730.67,2.0,118,3,3,1,7,0xb2d10582d
3499.17,1.0,32,2,2,2,6,0xb2d60427
443.57,1.0,1,1,2,4,7,0xb2d1c343d
2075.05,1.0,10,1,2,3,6,0xb2d8fd5e
1231.32,1.0,92,1,2,1,4,0xb2d29d99d
820.66,1.0,18,1,2,2,5,0xb2d3430fd
2.56,1.0,21,1,2,2,5,0xb2d6f2cd
240799.63,3.0,15,3,4,3,10,0xb2d8f36fd
19.49,1.0,3,1,2,4,7,0xb2d2ee1bd
50017.19,4.0,80,2,4,1,7,0xb2d7d4f4d
5076048.27,16.0,3,4,4,4,12,0xb2d193efd
3623.76,1.0,199,2,2,1,5,0xb2d5d4a5d
900059.55,8.0,23,4,4,2,10,0xb2d11d3ed
25224.25,1.0,11,2,2,3,7,0xb2d6bd4c
1.31,1.0,12,1,2,3,6,0xb2d2ce67
469.43,1.0,184,1,2,1,4,0xb2d42333d
3682.97,1.0,0,2,2,4,8,0xb2d2b7b7
797798.65,5.0,5,4,4,3,11,0xb2d93266d
6298.37,1.0,5,2,2,3,7,0xb2d607a1
3335.62,1.0,184,2,2,1,5,0xb2d0ac54d
1458.63,1.0,0,1,2,4,7,0xb2d1d7e8
50000.53,2.0,45,2,3,2,7,0xb2d593c7d
47.64,1.0,5,1,2,3,6,0xb2d2f4e0
4121.13,1.0,18,2,2,2,6,0xb2d9872e
1206228.52,9.0,45,4,4,2,10,0xb2d1796c
312012.34,7.0,60,4,4,2,10,0xb2d45c54
20101.34,1.0,15,2,2,3,7,0xb2d4879dd
1313.05,1.0,11,1,2,3,6,0xb2d5aec6d
23646.48,2.0,0,2,3,4,9,0xb2d0f376
200000.0,2.0,27,3,3,2,8,0xb2da110c
54400.0,1.0,1,3,2,4,9,0xb2da4b7b
29.28,1.0,14,1,2,3,6,0xb2d571bd
36152.25,2.0,64,2,3,2,7,0xb2d61f0e
253058.12,2.0,0,3,3,4,10,0xb2d5625c
51403.7,2.0,186,2,3,1,6,0xb2d879a9d
60273.72,1.0,0,3,2,4,9,0xb2d53f6ad
3667.92,1.0,1,2,2,4,8,0xb2d7664d
10000.11,2.0,92,2,3,1,6,0xb2d63e88
40079.68,1.0,0,2,2,4,8,0xb2d8c845d
996087.11,4.0,5,4,4,3,11,0xb2d3e261
504012.95,4.0,39,4,4,2,10,0xb2d313e1d
815.66,1.0,0,1,2,4,7,0xb2d979c4
6348.52,1.0,92,2,2,1,5,0x3b9b17c5
48158.75,1.0,13,2,2,3,7,0xb2d31fb1d
172977.2,2.0,28,3,3,2,8,0xb2d6af00d
106004.48,2.0,49,3,3,2,8,0xb2d9d3f0
210116.11,3.0,53,3,4,2,9,0xb2d0f5b5
3467.12,1.0,8,2,2,3,7,0xb2d51e81d
40002.51,2.0,46,2,3,2,7,0xb2d49d51
590002.77,4.0,6,4,4,3,11,0xb2d1dd0fd
50001.58,2.0,92,2,3,1,6,0xb2d97ccfd
94.96,1.0,0,1,2,4,7,0xb2d64f6a
220.54,2.0,47,1,3,2,6,0xb2d07716
98005.17,2.0,48,3,3,2,8,0xb2d9d2a0
10041.76,1.0,35,2,2,2,6,0xb2d58f9e
1750063.96,4.0,47,4,4,2,10,0xb2d61711d
2313.35,1.0,0,1,2,4,7,0xb2d4e221
446000.0,4.0,6,4,4,3,11,0xb2d4f5dcd
10000.32,2.0,39,2,3,2,7,0xb2d9eae7
12.34,1.0,23,1,2,2,5,0xb2d2e94f
3643.06,2.0,1,2,3,4,9,0x3b9af2a3
3350.02,1.0,10,2,2,3,7,0xb2d376bb
38.8,1.0,0,1,2,4,7,0xb2d77f2bd
406646.31,2.0,11,4,3,3,10,0xb2d9da04
50076.04,2.0,80,2,3,1,6,0xb2d62daf
5666.7,1.0,10,2,2,3,7,0xb2d9c94e
408542.53,2.0,209,4,3,1,8,0xb2d68981d
6650.79,1.0,4,2,2,4,8,0xb2d9612d
9253.74,1.0,1,2,2,4,8,0xb2d80227
300849.84,5.0,13,4,4,3,11,0xb2d59b43d
787431.76,3.0,95,4,4,1,9,0xb2d10543d
31.22,1.0,55,1,2,2,5,0xb2d7825a
0.0,1.0,5,1,2,3,6,0xb2d53147
90102.33,3.0,39,3,4,2,9,0xb2d95d2c
66024.79,2.0,92,3,3,1,7,0xb2d34929
826796.47,2.0,0,4,3,4,11,0xb2d20087d
785.65,1.0,28,1,2,2,5,0xb2d8f40b
307000.49,2.0,21,4,3,2,9,0xb2d9d41f
270000.0,5.0,0,3,4,4,11,0xb2d1948c
186046.46,4.0,6,3,4,3,10,0xb2d5f233d
2592794.65,19.0,0,4,4,4,12,0xb2d17c76
125130.22,2.0,132,3,3,1,7,0xb2d4fe58
30000.63,2.0,87,2,3,1,6,0xb2d8c814
1200055.17,7.0,18,4,4,2,10,0xb2d60098
257.66,1.0,56,1,2,2,5,0xb2d9720e
50005.24,2.0,166,2,3,1,6,0xb2d13eee
1858.03,1.0,184,1,2,1,4,0xb2d32a30
15958.56,1.0,260,2,2,1,5,0xb2d3c877
69.73,1.0,69,1,2,1,4,0xb2d98480
3516.44,1.0,33,2,2,2,6,0xb2d29662
12454.13,1.0,0,2,2,4,8,0xb2d8c37ed
150007.6,3.0,6,3,4,3,10,0xb2d4717e
2093.21,1.0,22,1,2,2,5,0xb2d9214b
4002.07,1.0,36,2,2,2,6,0xb2d8064b
75925.16,1.0,10,3,2,3,8,0xb2d5ea22d
558.44,1.0,21,1,2,2,5,0xb2d1376c
2993.54,1.0,0,2,2,4,8,0xb2d435d4
10568.47,9.0,117,2,4,1,7,0x3b9b22f8
149000.0,3.0,1,3,4,4,11,0xb2d592c9
251015.76,3.0,90,3,4,1,8,0xb2d556fed
67430.0,5.0,0,3,4,4,11,0x3b9b463c
485186.77,5.0,1,4,4,4,12,0xb2d0d2d7d
10005.03,3.0,25,2,4,2,8,0xb2d57abe
330800.0,1.0,0,4,2,4,10,0xb2da0029
100003.17,2.0,77,3,3,1,7,0xb2d992ad
253696.66,4.0,55,3,4,2,9,0xb2d24874
75940.4,1.0,0,3,2,4,9,0xb2d91829
7245.95,1.0,5,2,2,3,7,0xb2d5d5d4
50000.53,2.0,41,2,3,2,7,0xb2d92200d
83189.5,2.0,39,3,3,2,8,0xb2d43a40
12682.25,1.0,15,2,2,3,7,0xb2d8f93dd
306182.7,2.0,104,4,3,1,8,0xb2d251ddd
202131.55,2.0,16,3,3,2,8,0xb2d8d92b
61.55,1.0,0,1,2,4,7,0xb2d623e9
30303.9,2.0,11,2,3,3,8,0xb2d69d08d
25465.16,1.0,232,2,2,1,5,0xb2d63824
64000.2,2.0,60,3,3,2,8,0xb2d642f0
10058.79,1.0,28,2,2,2,6,0xb2d6c81cd
1061.62,1.0,92,1,2,1,4,0xb2d24d12d
158.43,2.0,1,1,3,4,8,0xb2d0a1ebd
37974.73,1.0,0,2,2,4,8,0xb2d5510c
200304.02,3.0,25,3,4,2,9,0xb2d1f17dd
200008.44,2.0,60,3,3,2,8,0xb2d9b5f0
682416.74,4.0,21,4,4,2,10,0xb2d98ddc
601779.23,3.0,38,4,4,2,10,0xb2d9038d
50000.53,2.0,210,2,3,1,6,0xb2d78259
12408.61,2.0,34,2,3,2,7,0xb2d31600d
51141.87,2.0,110,2,3,1,6,0xb2d61c6e
191131.32,2.0,0,3,3,4,10,0xb2d91023
307000.0,7.0,5,4,4,3,11,0xb2d46822d
1703.23,1.0,190,1,2,1,4,0xb2d78c7fd
2623.83,1.0,15,1,2,3,6,0xb2d90f1ad
60002.27,2.0,20,3,3,2,8,0xb2d1c86c
30621.37,3.0,4,2,4,4,10,0xb2d68437d
10101.01,2.0,34,2,3,2,7,0xb2d9f539
907941.56,5.0,5,4,4,3,11,0xb2d16d52d
121874.97,1.0,1,3,2,4,9,0xb2d12090
751069.23,2.0,53,4,3,2,9,0xb2d625d1
8981.0,1.0,0,2,2,4,8,0xb2d935b8
198167.3,3.0,0,3,4,4,11,0xb2d331fad
58.41,1.0,75,1,2,1,4,0xb2d6b3c4
1.48,1.0,18,1,2,2,5,0xb2d68e2f
94.28,1.0,54,1,2,2,5,0xb2d2f36a
300118.26,2.0,235,4,3,1,8,0xb2d19d06d
335137.1,5.0,4,4,4,4,12,0xb2d3a3f4d
7859.05,1.0,184,2,2,1,5,0xb2d19c21
1.71,2.0,0,1,3,4,8,0xb2d4f511d
610087.01,8.0,24,4,4,2,10,0xb2d5756b
300000.0,2.0,62,3,3,2,8,0xb2d9bc2c
260071.3,3.0,38,3,4,2,9,0xb2d5e6a3
130015.31,2.0,24,3,3,2,8,0xb2d5d1cfd
500040.26,4.0,16,4,4,2,10,0xb2d6ed00
2377.37,1.0,9,1,2,3,6,0xb2d35305d
7348.46,1.0,127,2,2,1,5,0xb2d90d14d
155153.57,2.0,0,3,3,4,10,0xb2d45b04
10000.21,2.0,92,2,3,1,6,0xb2d67cbed
34764.07,6.0,1,2,4,4,10,0xb2d5f1ad
191857.83,1.0,1,3,2,4,9,0xb2d391c9d
3102.58,1.0,21,2,2,2,6,0xb2d94851
85086.71,4.0,228,3,4,1,8,0xb2d4bd03d
721128.88,18.0,11,4,4,3,11,0xb2d1038ed
1100049.47,12.0,0,4,4,4,12,0xb2d297b4
38170.14,5.0,3,2,4,4,10,0x3b9b46abd
52136.11,2.0,125,2,3,1,6,0xb2d176dad
1336.76,1.0,1,1,2,4,7,0xb2d36973
193896.34,2.0,4,3,3,4,10,0xb2d98071d
535069.17,3.0,189,4,4,1,9,0xb2d58ab5d
520134.07,6.0,1,4,4,4,12,0xb2d40674d
5503.01,1.0,92,2,2,1,5,0xb2d33672
110355.14,5.0,118,3,4,1,8,0xb2d632c9
0.0,1.0,1,1,2,4,7,0xb2d27b42
756614.96,5.0,0,4,4,4,12,0xb2d077c2d
651494.18,4.0,48,4,4,2,10,0xb2d3cc71
8074.88,1.0,92,2,2,1,5,0xb2d2c67bd
73427.95,2.0,139,3,3,1,7,0xb2d50277d
999.61,2.0,184,1,3,1,5,0xb2d2a06d
25335.49,1.0,0,2,2,4,8,0xb2d9435cd
14.41,1.0,167,1,2,1,4,0x3b9b493c
111.19,1.0,27,1,2,2,5,0xb2d43a9dd
1245269.91,6.0,25,4,4,2,10,0xb2d9070ed
12851.88,2.0,172,2,3,1,6,0xb2d38c39d
90110.29,1.0,6,3,2,3,8,0xb2d60708
182303.83,1.0,5,3,2,3,8,0xb2d60950
51008.51,2.0,2,2,3,4,9,0xb2d35a3dd
10970.36,1.0,184,2,2,1,5,0x3b9b2436
1670805.88,8.0,63,4,4,2,10,0xb2d44337d
0.0,1.0,0,1,2,4,7,0xb2da2d06
1066.04,1.0,4,1,2,4,7,0xb2d34810
11610.76,1.0,25,2,2,2,6,0xb2d1d590d
2783.3,1.0,5,1,2,3,6,0xb2d68c0e
221.67,1.0,56,1,2,2,5,0xb2d8f2cb
204289.92,2.0,0,3,3,4,10,0xb2d78dd2d
49039.47,3.0,34,2,4,2,8,0xb2d468fb
12.82,1.0,66,1,2,2,5,0xb2d6e3dd
10115.11,2.0,45,2,3,2,7,0xb2d5ec4ad
5989.98,1.0,184,2,2,1,5,0xb2d389a4d
342221.34,2.0,11,4,3,3,10,0xb2d58f81
200000.0,2.0,12,3,3,3,9,0xb2d8e47a
183.72,1.0,67,1,2,1,4,0xb2d8dc36
12071.21,1.0,3,2,2,4,8,0xb2d53068d
330004.38,3.0,19,4,4,2,10,0xb2d3b725d
100203.35,4.0,5,3,4,3,10,0xb2d5aa3dd
250439.62,4.0,0,3,4,4,11,0xb2d5ecf9
3888.88,1.0,4,2,2,4,8,0xb2d32589d
1013379.8,9.0,0,4,4,4,12,0x3b9b3d2f
31555.78,1.0,78,2,2,1,5,0xb2d37697d
670000.0,3.0,0,4,4,4,12,0xb2d60d37
582091.51,7.0,6,4,4,3,11,0xb2d328f2d
160341.86,5.0,11,3,4,3,10,0xb2d581f0
200710.43,2.0,42,3,3,2,8,0xb2d9eb18
30040.0,1.0,0,2,2,4,8,0xb2d64d6ed
354280.15,1.0,10,4,2,3,9,0xb2d42a7bd
60002.51,3.0,41,3,4,2,9,0xb2d90702d
143187.18,2.0,9,3,3,3,9,0xb2d34e95
271192.02,8.0,0,3,4,4,11,0xb2d242f0
570012.17,2.0,8,4,3,3,10,0xb2d4067a
900114.99,2.0,3,4,3,4,11,0xb2d31bcfd
15001.88,2.0,28,2,3,2,7,0xb2d2bd8cd
232016.17,4.0,0,3,4,4,11,0xb2d090d8d
2190839.23,8.0,5,4,4,3,11,0xb2d5f575
48.85,1.0,40,1,2,2,5,0xb2d37d06
705660.9,11.0,0,4,4,4,12,0xb2d58823
50297.83,2.0,52,2,3,2,7,0xb2d6327cd
15276.67,1.0,161,2,2,1,5,0xb2d4902ed
70067.75,2.0,206,3,3,1,7,0xb2d5c000d
515078.88,3.0,4,4,4,4,12,0xb2d51725
266179.16,4.0,1,3,4,4,11,0xb2d2d21cd
293036.36,3.0,8,3,4,3,10,0x3b9b3cd1
126002.71,3.0,249,3,4,1,8,0x3b9b2d2d
178271.8,4.0,17,3,4,2,9,0xb2d5fc34d
14048.72,1.0,75,2,2,1,5,0xb2d5f66f
110069.49,2.0,174,3,3,1,7,0xb2d46dffd
3489.27,1.0,186,2,2,1,5,0xb2d53b33d
400004.36,2.0,12,4,3,3,10,0xb2d6488a
1.06,1.0,81,1,2,1,4,0xb2d8d2a5
444019.38,3.0,102,4,4,1,9,0xb2d52fee
4588.76,1.0,18,2,2,2,6,0xb2d1e50fd
630053.48,2.0,27,4,3,2,9,0xb2d58e65
3.22,1.0,9,1,2,3,6,0xb2d2b0d4
1090.18,1.0,6,1,2,3,6,0xb2d1dda8d
27894.83,1.0,2,2,2,4,8,0xb2d2898ad
290353.75,2.0,15,3,3,3,9,0xb2d3a5e9d
951205.72,4.0,83,4,4,1,9,0xb2d06b32d
100001.06,2.0,92,3,3,1,7,0xb2d641f1
15880.31,2.0,38,2,3,2,7,0xb2d5d0a0d
917.61,1.0,14,1,2,3,6,0xb2d648f0d
535604.82,4.0,46,4,4,2,10,0xb2d3f324
155743.51,3.0,1,3,4,4,11,0xb2d16082d
470022.85,5.0,0,4,4,4,12,0xb2d242b0
645013.84,4.0,13,4,4,3,11,0xb2d4850c
70085.04,2.0,3,3,3,4,10,0xb2d0f79c
680038.87,4.0,31,4,4,2,10,0xb2d1a627
7659.86,1.0,297,2,2,1,5,0xb2d6380ed
242452.6,10.0,0,3,4,4,11,0x3b9b185e
8980.03,1.0,5,2,2,3,7,0xb2d69b2c
153000.54,2.0,3,3,3,4,10,0xb2d59a56
138.31,1.0,0,1,2,4,7,0xb2d36947d
336.76,1.0,10,1,2,3,6,0xb2d8e533
1334046.3,14.0,1,4,4,4,12,0xb2d17c0d
13467.47,1.0,0,2,2,4,8,0xb2d3ac39d
300047.54,6.0,6,3,4,3,10,0xb2d9efee
975.25,1.0,3,1,2,4,7,0xb2d6d211
36604.96,1.0,1,2,2,4,8,0xb2d17562
100004.71,2.0,116,3,3,1,7,0xb2d4cdf9d
10115.05,1.0,0,2,2,4,8,0xb2d0b4c4
4224.43,1.0,5,2,2,3,7,0xb2d1f9b9
1787.57,1.0,25,1,2,2,5,0xb2d2d472
54.27,1.0,3,1,2,4,7,0xb2d6c61e
43198.68,4.0,1,2,4,4,10,0x3b9ae624
760133.23,5.0,21,4,4,2,10,0xb2d65a3cd
3357.85,1.0,123,2,2,1,5,0xb2d37a84
2000000.0,3.0,3,4,4,4,12,0xb2d9791b
3003.65,1.0,10,2,2,3,7,0xb2d4436c
380011.75,4.0,122,4,4,1,9,0xb2d07abbd
143549.9,2.0,94,3,3,1,7,0xb2d39447
4743.21,1.0,0,2,2,4,8,0xb2d6bf49d
20885.82,2.0,6,2,3,3,8,0xb2d5c394
132878.58,4.0,10,3,4,3,10,0xb2d352c3d
48929.92,1.0,6,2,2,3,7,0xb2d60951
250031.39,3.0,62,3,4,2,9,0xb2d3f6dad
180044.22,3.0,196,3,4,1,8,0xb2d57e5a
642.64,1.0,0,1,2,4,7,0xb2d5d4b0
5933.23,1.0,2,2,2,4,8,0xb2d5cfc1d
62348.61,2.0,59,3,3,2,8,0xb2d1ebdbd
111.12,1.0,41,1,2,2,5,0xb2d6ec45d
1406559.96,8.0,3,4,4,4,12,0xb2d6453d
20002.28,2.0,199,2,3,1,6,0xb2d5cdfad
630932.2,3.0,10,4,4,3,11,0xb2d41280d
50584.7,2.0,104,2,3,1,6,0xb2d68ae7
400098.6,2.0,32,4,3,2,9,0xb2d43568
0.09,1.0,1,1,2,4,7,0xb2d5c88dd
537056.15,6.0,0,4,4,4,12,0xb2d31773
10014.19,5.0,17,2,4,2,8,0x3b9b0fe0d
10449.99,1.0,13,2,2,3,7,0xb2d6c438d
103733.96,2.0,129,3,3,1,7,0xb2d12a81d
1401529.05,5.0,3,4,4,4,12,0xb2d6fbd2d
1017.5,1.0,92,1,2,1,4,0xb2d192e5d
12198.04,1.0,2,2,2,4,8,0xb2d6bd34
54.75,1.0,0,1,2,4,7,0xb2d9018d
337.22,1.0,69,1,2,1,4,0xb2d64a04d
330.55,1.0,139,1,2,1,4,0xb2d5e0bf
1070217.97,7.0,80,4,4,1,9,0xb2d1bb7f
2812.75,1.0,11,1,2,3,6,0xb2d3d5d6
365005.45,2.0,0,4,3,4,11,0xb2d94ab3
632585.97,14.0,11,4,4,3,11,0xb2d60b85d
24017.46,1.0,16,2,2,2,6,0xb2d427f0
80030.24,2.0,57,3,3,2,8,0xb2d6baadd
5232.33,1.0,63,2,2,2,6,0xb2d388f2d
40000.42,2.0,77,2,3,1,6,0xb2d99531
12559.47,2.0,0,2,3,4,9,0xb2d2f68dd
106351.11,2.0,239,3,3,1,7,0xb2d3f75cd
291534.8,5.0,18,3,4,2,9,0xb2d35a44d
300000.0,2.0,6,3,3,3,9,0xb2da5930
19.74,1.0,2,1,2,4,7,0xb2d8ef0f
80000.84,2.0,48,3,3,2,8,0xb2d913d5
2927.18,1.0,22,2,2,2,6,0xb2d2e28b
50108.39,2.0,48,2,3,2,7,0xb2d9072dd
12920.52,1.0,73,2,2,1,5,0xb2d60530
506008.42,4.0,11,4,4,3,11,0xb2d16798d
202407.75,3.0,21,3,4,2,9,0xb2d06c14
14899.46,2.0,20,2,3,2,7,0xb2d0695b
153006.49,2.0,21,3,3,2,8,0xb2d28894
140000.0,1.0,0,3,2,4,9,0xb2da0c81
17489.49,1.0,7,2,2,3,7,0xb2d6bb69
230000.0,2.0,6,3,3,3,9,0xb2d92fb5
16025.87,1.0,4,2,2,4,8,0xb2d5793dd
216.71,1.0,32,1,2,2,5,0xb2d694ef
330008.66,4.0,0,4,4,4,12,0xb2d90b17d
51.31,1.0,1,1,2,4,7,0xb2d80550
45001.9,3.0,59,2,4,2,8,0xb2d20795
204266.89,2.0,23,3,3,2,8,0xb2d692c7d
4.06,1.0,21,1,2,2,5,0xb2d587f0
2019.17,3.0,1,1,4,4,9,0xb2d21215
6122.95,1.0,184,2,2,1,5,0xb2d087c8d
3047713.91,4.0,4,4,4,4,12,0xb2d11329
18.79,1.0,46,1,2,2,5,0xb2d9196d
1123.76,1.0,0,1,2,4,7,0xb2d78658
207016.31,2.0,59,3,3,2,8,0xb2d56168
90.59,1.0,8,1,2,3,6,0xb2d1fb09
2016575.18,7.0,32,4,4,2,10,0xb2d5b6cb
26577.81,1.0,6,2,2,3,7,0xb2d25940
38.0,1.0,51,1,2,2,5,0xb2d9a689
15120.64,1.0,92,2,2,1,5,0xb2d5c2f4d
50566.03,1.0,6,2,2,3,7,0xb2d5ada8d
412000.0,12.0,0,4,4,4,12,0xb2d0984c
8.3,1.0,6,1,2,3,6,0xb2d39c71
2004.99,1.0,46,1,2,2,5,0xb2d5f6c0
600123.76,7.0,13,4,4,3,11,0xb2d636da
1200549.56,3.0,62,4,4,2,10,0xb2d5e08f
734.51,1.0,75,1,2,1,4,0xb2d5d9f3d
322.12,1.0,10,1,2,3,6,0xb2d7f7cc
30008.41,2.0,20,2,3,2,7,0xb2d08875
123912.24,1.0,0,3,2,4,9,0xb2d5abfdd
1027.44,1.0,5,1,2,3,6,0xb2d6f5a7
40045.56,2.0,172,2,3,1,6,0xb2d6b68cd
679000.0,2.0,0,4,3,4,11,0xb2d92fbfd
2981510.98,17.0,0,4,4,4,12,0x3b9adcc6d
0.0,2.0,9,1,3,3,7,0xb2d1c39a
231703.63,7.0,0,3,4,4,11,0xb2d330a3
744.56,1.0,82,1,2,1,4,0xb2d41ccfd
200796.42,2.0,4,3,3,4,10,0xb2d6f5cf
0.0,2.0,7,1,3,3,7,0xb2d2c412
6.54,1.0,19,1,2,2,5,0xb2d3ea24
502144.24,3.0,11,4,4,3,11,0xb2d9aca2
350110.73,6.0,11,4,4,3,11,0xb2d9bb57
1596.69,1.0,0,1,2,4,7,0xb2d68c67d
620000.0,3.0,101,4,4,1,9,0xb2d274f2d
15545.56,2.0,123,2,3,1,6,0xb2d5aad7d
202750.07,2.0,0,3,3,4,10,0xb2d61cc1d
300031.37,2.0,6,3,3,3,9,0xb2d8dd9c
498790.21,8.0,0,4,4,4,12,0xb2d20af3d
110565.93,3.0,83,3,4,1,8,0xb2d44d11
50450.41,1.0,184,2,2,1,5,0xb2d3290ed
1431390.0,8.0,1,4,4,4,12,0x3b9b0e2d
844001.45,7.0,1,4,4,4,12,0xb2d4bdafd
30780.94,2.0,172,2,3,1,6,0xb2d6106d
450045.88,2.0,110,4,3,1,8,0xb2d505f6
104837.64,2.0,206,3,3,1,7,0xb2d425e0d
105405.41,5.0,221,3,4,1,8,0x3b9b2ca8d
1489.35,2.0,82,1,3,1,5,0xb2d144d8d
97406.08,2.0,1,3,3,4,10,0xb2d8e06b
4632.91,1.0,10,2,2,3,7,0xb2d8db50d
5441.88,1.0,10,2,2,3,7,0xb2d1c116
213.67,1.0,20,1,2,2,5,0xb2d2ea73d
400002.11,2.0,0,4,3,4,11,0xb2d9876a
225016.61,5.0,8,3,4,3,10,0x3b9b2435d
1050757.12,10.0,4,4,4,4,12,0xb2d3bf29d
266003.18,6.0,99,3,4,1,8,0xb2d0ae1c
7305.4,2.0,92,2,3,1,6,0x3b9b2661d
405.6,1.0,10,1,2,3,6,0xb2d38597
8.93,1.0,20,1,2,2,5,0xb2d60412
438894.14,6.0,94,4,4,1,9,0xb2d2bba0
239419.16,3.0,0,3,4,4,11,0xb2d0d8b5d
10198.13,1.0,4,2,2,4,8,0xb2d69b3ad
50001.06,2.0,38,2,3,2,7,0xb2d9280c
4.46,1.0,13,1,2,3,6,0xb2d250dfd
32247.48,1.0,274,2,2,1,5,0xb2d1a54c
14954.99,1.0,12,2,2,3,7,0xb2d69ad8
377762.81,6.0,0,4,4,4,12,0xb2d114e6d
27.45,1.0,7,1,2,3,6,0xb2da14ab
1558.44,1.0,92,1,2,1,4,0xb2d1013b
2003.43,1.0,1,1,2,4,7,0xb2d25e29d
40755.21,2.0,206,2,3,1,6,0xb2d32feed
1250031.81,4.0,111,4,4,1,9,0xb2d557f5
2638.3,1.0,30,1,2,2,5,0xb2d258e7d
9906.5,1.0,210,2,2,1,5,0xb2d1f343d
113009.33,4.0,14,3,4,3,10,0xb2d23f5f
103177.5,1.0,3,3,2,4,9,0xb2d630ee
80706.3,2.0,102,3,3,1,7,0xb2d1187ed
2034.3,1.0,1,1,2,4,7,0xb2d8f490
1090.42,1.0,0,1,2,4,7,0xb2d52990d
1861650.09,6.0,12,4,4,3,11,0xb2d2c838d
1865.46,1.0,12,1,2,3,6,0xb2d2c241
436.29,1.0,112,1,2,1,4,0xb2d65998d
510002.45,6.0,0,4,4,4,12,0xb2d55138
100000.0,2.0,6,3,3,3,9,0xb2d5d774d
8569.7,1.0,2,2,2,4,8,0xb2d95aeb
218.82,7.0,0,1,4,4,9,0x3b9b37ad
65452.98,1.0,15,3,2,3,8,0xb2d4f8d9
200017.39,2.0,1,3,3,4,10,0xb2d9e8a0
20070.41,1.0,2,2,2,4,8,0xb2d473f8
21448.34,1.0,145,2,2,1,5,0xb2d1bd30d
10826.83,1.0,0,2,2,4,8,0xb2d62d35d
24.86,1.0,4,1,2,4,7,0xb2d29219d
60015.67,2.0,181,3,3,1,7,0xb2d5d383
574020.03,6.0,11,4,4,3,11,0xb2d61494d
0.97,1.0,9,1,2,3,6,0xb2d4e9aa
200079.77,2.0,1,3,3,4,10,0xb2d9da0e
9869.25,1.0,0,2,2,4,8,0xb2d6bb55
2557.35,1.0,92,1,2,1,4,0xb2d54af3
20000.21,2.0,8,2,3,3,8,0xb2da357d
941948.92,3.0,76,4,4,1,9,0xb2d29110d
1221.58,1.0,92,1,2,1,4,0xb2d2eb17
429.02,2.0,29,1,3,2,6,0xb2d9b3dc
1584.42,1.0,184,1,2,1,4,0x3b9b3669
200002.11,2.0,41,3,3,2,8,0xb2d921f4d
243884.18,2.0,35,3,3,2,8,0xb2d10311d
40000.64,3.0,45,2,4,2,8,0xb2d8df8fd
1692.8,1.0,184,1,2,1,4,0xb2d0b910
1507.56,1.0,9,1,2,3,6,0xb2d31940d
10587.14,1.0,154,2,2,1,5,0xb2d6536fd
400003.08,4.0,18,4,4,2,10,0xb2d5e7fcd
33377.44,1.0,9,2,2,3,7,0xb2d2b0b7d
300048.26,2.0,0,3,3,4,10,0xb2d8d3d1
117039.95,3.0,0,3,4,4,11,0xb2d18ae1
400015.3,10.0,25,4,4,2,10,0xb2d5fd5e
242942.9,3.0,95,3,4,1,8,0x3b9b2a91
19943.06,1.0,0,2,2,4,8,0xb2d78d47
250006.86,3.0,18,3,4,2,9,0xb2d944b4d
3946.85,1.0,184,2,2,1,5,0xb2d3ffccd
526735.45,2.0,194,4,3,1,8,0xb2d16ecad
16011.71,1.0,0,2,2,4,8,0xb2d50b23d
0.56,1.0,12,1,2,3,6,0xb2d6adad
142.14,1.0,8,1,2,3,6,0xb2d78d2c
17.93,1.0,60,1,2,2,5,0xb2d6b52cd
700879.46,3.0,5,4,4,3,11,0xb2d35135
419314.37,1.0,3,4,2,4,10,0xb2d4ac0d
125846.05,3.0,3,3,4,4,11,0xb2d20175d
60968.03,1.0,10,3,2,3,8,0xb2d4d371
202132.11,2.0,108,3,3,1,7,0xb2d7c41bd
1.54,1.0,166,1,2,1,4,0xb2d61267
8521.05,1.0,0,2,2,4,8,0xb2d6b376d
222474.72,6.0,4,3,4,4,11,0xb2d11044
690.38,1.0,15,1,2,3,6,0xb2d30f85d
82010.58,2.0,46,3,3,2,8,0xb2d58cc9d
1.28,1.0,13,1,2,3,6,0xb2d2fb40
1334974.52,15.0,29,4,4,2,10,0xb2d50f1cd
743000.81,9.0,3,4,4,4,12,0xb2d5a207d
3698664.2,11.0,0,4,4,4,12,0x3b9b418b
462285.38,4.0,55,4,4,2,10,0xb2d1b25dd
10166.39,1.0,184,2,2,1,5,0xb2d23f2bd
5695000.0,11.0,0,4,4,4,12,0xb2d0885b
16490.04,1.0,23,2,2,2,6,0xb2d275a8d
0.14,2.0,76,1,3,1,5,0xb2d4b65ed
770377.58,3.0,5,4,4,3,11,0xb2d91293
512422.88,4.0,1,4,4,4,12,0xb2d5162ed
100002.11,2.0,10,3,3,3,9,0xb2d0fc59
201423.44,2.0,35,3,3,2,8,0xb2d95d35
0.0,1.0,0,1,2,4,7,0xb2d9afbc
503107.89,3.0,53,4,4,2,10,0xb2d7a73ad
317286.17,5.0,0,4,4,4,12,0xb2d0e65c
0.21,1.0,71,1,2,1,4,0xb2d603d1
66674.35,2.0,228,3,3,1,7,0xb2d28a8a
532.24,2.0,12,1,3,3,7,0x3b9b2b04d
600000.15,4.0,5,4,4,3,11,0xb2d267fd
400280.55,2.0,176,4,3,1,8,0xb2d62d92
3874923.49,28.0,0,4,4,4,12,0xb2d29c55d
438723.45,4.0,38,4,4,2,10,0xb2d8d758d
2054.75,1.0,92,1,2,1,4,0xb2d283c5d
0.0,1.0,0,1,2,4,7,0xb2d38c6e
10.13,1.0,16,1,2,2,5,0xb2d2cd5bd
9952.53,1.0,9,2,2,3,7,0xb2d7635f
1616.34,1.0,101,1,2,1,4,0xb2d15d0dd
5487.19,1.0,6,2,2,3,7,0xb2d29d91d
106855.27,3.0,10,3,4,3,10,0xb2d41671d
200000.0,2.0,7,3,3,3,9,0xb2d6d043d
72124.87,1.0,17,3,2,2,7,0x3b9b3b14d
238.01,1.0,84,1,2,1,4,0xb2d7bd07
509719.64,4.0,193,4,4,1,9,0xb2d12c80d
26072.69,2.0,0,2,3,4,9,0xb2d0a7cfd
47007.81,1.0,3,2,2,4,8,0xb2d9acca
212285.39,2.0,83,3,3,1,7,0xb2d9361bd
10000.11,2.0,41,2,3,2,7,0xb2d92222
217561.78,5.0,154,3,4,1,8,0xb2d1390bd
20000.0,2.0,4,2,3,4,9,0xb2da4a7f
34.14,1.0,8,1,2,3,6,0xb2d7f67a
4534.29,1.0,9,2,2,3,7,0xb2d40062
5577.27,1.0,227,2,2,1,5,0xb2d39ee2
830104.75,17.0,0,4,4,4,12,0xb2d238efd
2511.34,1.0,1,1,2,4,7,0xb2d67d70
488543.85,3.0,101,4,4,1,9,0xb2d40cc6d
18097.04,1.0,3,2,2,4,8,0xb2d34bbd
60000.63,2.0,95,3,3,1,7,0xb2d97ab9d
510665.25,2.0,197,4,3,1,8,0xb2d7ec72d
315222.43,4.0,11,4,4,3,11,0xb2d90d11
18426.63,2.0,0,2,3,4,9,0x3b9af2b7
2979.81,1.0,1,2,2,4,8,0xb2d239d1
42.92,1.0,16,1,2,2,5,0xb2d6a7e5
485796.06,3.0,11,4,4,3,11,0xb2d209b1
270049.96,2.0,256,3,3,1,7,0xb2d50381d
15190.47,1.0,92,2,2,1,5,0xb2d41580
213.14,1.0,8,1,2,3,6,0xb2d24eee
302131.6,2.0,9,4,3,3,10,0xb2d8e9ebd
50001.56,2.0,25,2,3,2,7,0xb2da11ce
788407.01,5.0,10,4,4,3,11,0x3b9b3998
387.2,1.0,0,1,2,4,7,0xb2d8d2d2
10091.21,1.0,3,2,2,4,8,0xb2d6d2f5
100000.58,2.0,37,3,3,2,8,0xb2d61423
303084.04,2.0,76,4,3,1,8,0xb2d2cd37
89972.29,6.0,0,3,4,4,11,0x3b9b18c7d
108372.24,1.0,251,3,2,1,6,0xb2d0dd2fd
48989.59,1.0,18,2,2,2,6,0xb2d1c9c7
421150.12,6.0,1,4,4,4,12,0xb2d8a5b9d
253508.52,4.0,181,3,4,1,8,0xb2d520d9
29080.22,2.0,0,2,3,4,9,0xb2d1922e
103646.22,2.0,73,3,3,1,7,0xb2d58477d
84217.63,2.0,24,3,3,2,8,0xb2d69380
135.78,8.0,60,1,4,2,7,0xb2d24b79d
362.22,1.0,18,1,2,2,5,0xb2d1d599
3635.82,1.0,287,2,2,1,5,0xb2d4c93c
5035.43,1.0,0,2,2,4,8,0xb2d1f6dbd
4449657.21,3.0,50,4,4,2,10,0xb2d26610
1118.19,1.0,184,1,2,1,4,0xb2d355cad
5014.9,1.0,292,2,2,1,5,0xb2d698a6
1950000.16,8.0,7,4,4,3,11,0xb2d14a02d
1232593.27,3.0,14,4,4,3,11,0xb2d9815ad
9769.98,1.0,0,2,2,4,8,0xb2d0d7bf
222.96,1.0,23,1,2,2,5,0xb2d1ce42d
91790.52,4.0,11,3,4,3,10,0xb2d569f9d
36.46,1.0,70,1,2,1,4,0xb2d5fafa
5347.63,1.0,184,2,2,1,5,0x3b9b2dda
20125.72,6.0,0,2,4,4,10,0xb2d06bf6
179526.59,3.0,136,3,4,1,8,0xb2d196f9d
41.07,1.0,36,1,2,2,5,0xb2d3fd48
190041.44,4.0,4,3,4,4,11,0xb2d621ced
2000264.63,3.0,87,4,4,1,9,0xb2d88af5d
900113.63,4.0,10,4,4,3,11,0xb2d12228
1542328.7,2.0,0,4,3,4,11,0x3b9b2f97
5989.62,1.0,15,2,2,3,7,0xb2d27b65
3.4,1.0,18,1,2,2,5,0xb2d6db5c
265101.41,4.0,0,3,4,4,11,0xb2d70148
470058.22,5.0,1,4,4,4,12,0xb2d089e6
6610.1,1.0,54,2,2,2,6,0xb2d382f1
12.27,4.0,41,1,4,2,7,0xb2d22f3ad
160005.07,2.0,123,3,3,1,7,0xb2d93571d
400978.25,1.0,119,4,2,1,7,0xb2d4091cd
1047.31,1.0,92,1,2,1,4,0x3b9b308dd
1490105.27,12.0,6,4,4,3,11,0xb2d3e52c
2588.71,4.0,105,1,4,1,6,0xb2d6ef8ad
44384.75,1.0,0,2,2,4,8,0xb2d58cae
155016.16,10.0,13,3,4,3,10,0xb2d40f61
88779.23,6.0,184,3,4,1,8,0xb2d077d0d
231076.0,4.0,14,3,4,3,10,0xb2d16409
134165.74,2.0,92,3,3,1,7,0xb2d0a6e5
2191077.44,12.0,41,4,4,2,10,0xb2d56226
3.49,1.0,131,1,2,1,4,0xb2d59083
578034.57,9.0,21,4,4,2,10,0xb2d1db14d
205689.42,2.0,34,3,3,2,8,0xb2d650cf
500000.0,2.0,7,4,3,3,10,0xb2d5a9d2d
17390.69,1.0,9,2,2,3,7,0xb2d248d8
235405.57,5.0,11,3,4,3,10,0xb2d4d984d
200004.65,5.0,6,3,4,3,10,0xb2d8debed
10686.78,1.0,184,2,2,1,5,0xb2d0f67ad
150004.23,4.0,80,3,4,1,8,0xb2d63ebb
10000.11,2.0,10,2,3,3,8,0xb2d96700
10681.4,2.0,4,2,3,4,9,0xb2d1f6c8
313084.96,5.0,28,4,4,2,10,0xb2d0a948d
41.86,1.0,0,1,2,4,7,0xb2d8daa3d
3880346.61,8.0,38,4,4,2,10,0xb2d50d2ad
396623.31,2.0,0,4,3,4,11,0xb2d8f79e
2642.4,1.0,1,1,2,4,7,0xb2d25113d
270010.03,5.0,27,3,4,2,9,0xb2d9b0f3
219456.62,5.0,62,3,4,2,9,0xb2d61954
6371.64,1.0,11,2,2,3,7,0xb2d36727
2517.19,1.0,184,1,2,1,4,0xb2d41cc1
300088.34,2.0,27,3,3,2,8,0xb2d410d2d
31.68,1.0,0,1,2,4,7,0xb2d755fa
830209.85,2.0,47,4,3,2,9,0xb2d6be01d
40.51,1.0,26,1,2,2,5,0xb2d31dc3
40002.65,2.0,154,2,3,1,6,0xb2d63315d
120748.19,1.0,0,3,2,4,9,0xb2d36b73
295.1,1.0,49,1,2,2,5,0xb2d37c4a
186683.98,8.0,4,3,4,4,11,0xb2d51899d
23.86,1.0,48,1,2,2,5,0xb2d8c481
150007.96,4.0,35,3,4,2,9,0xb2d6bf1c
710.27,2.0,1,1,3,4,8,0xb2d8e68a
236069.71,11.0,4,3,4,4,11,0x3b9b185ed
13908.3,1.0,11,2,2,3,7,0xb2d93608
2952.34,1.0,14,2,2,3,7,0xb2d2a1c1
2216.02,1.0,10,1,2,3,6,0xb2d2eaa7
100022.12,2.0,18,3,3,2,8,0xb2d2db41d
304000.64,2.0,0,4,3,4,11,0xb2d3929bd
410027.34,2.0,19,4,3,2,9,0xb2d6a05f
23921.72,1.0,5,2,2,3,7,0xb2d6894d
11.12,1.0,57,1,2,2,5,0xb2d287c1d
434.98,1.0,2,1,2,4,7,0xb2d2bc02
276032.54,4.0,3,3,4,4,11,0xb2d26ebad
250000.0,2.0,28,3,3,2,8,0xb2da0e59
448307.76,2.0,9,4,3,3,10,0xb2d6a566d
150000.0,1.0,0,3,2,4,9,0xb2da6bc8
209825.94,4.0,52,3,4,2,9,0xb2d2d030d
7587.78,1.0,27,2,2,2,6,0xb2d2a6de
9561.03,1.0,10,2,2,3,7,0xb2d6f26ad
270011.8,5.0,5,3,4,3,10,0xb2d2e82bd
160109.85,4.0,38,3,4,2,9,0x3b9b44f2
209.55,1.0,0,1,2,4,7,0xb2d77fb2
209237.44,2.0,2,3,3,4,10,0xb2da4ed3
12861.09,1.0,16,2,2,2,6,0xb2d6d9f3d
12534.01,1.0,7,2,2,3,7,0xb2d649fbd
817.55,1.0,1,1,2,4,7,0xb2d3f874
20084.11,2.0,266,2,3,1,6,0xb2d5cb7bd
200000.0,2.0,24,3,3,2,8,0xb2d94d1e
100054.02,2.0,243,3,3,1,7,0xb2d44789
15.73,1.0,67,1,2,1,4,0xb2d7bff2
2008.44,1.0,24,1,2,2,5,0xb2d6d12dd
17994.54,1.0,2,2,2,4,8,0xb2d33953
354878.8,2.0,14,4,3,3,10,0xb2d2bd52
50002.11,2.0,14,2,3,3,8,0xb2d9df7f
3065.17,1.0,14,2,2,3,7,0xb2d17a00
6719.5,1.0,11,2,2,3,7,0xb2d2ebba
200000.0,2.0,1,3,3,4,10,0xb2d97fd8d
200029.97,2.0,15,3,3,3,9,0xb2d95435
281401.94,2.0,140,3,3,1,7,0xb2d17029d
711025.76,4.0,4,4,4,4,12,0xb2d58146
678.39,1.0,80,1,2,1,4,0xb2d3b58c
681880.28,4.0,0,4,4,4,12,0xb2d64a4ad
17335.87,1.0,17,2,2,2,6,0xb2d2189fd
21104.06,1.0,11,2,2,3,7,0xb2d91cb5
624.18,1.0,0,1,2,4,7,0xb2d77f11
73281.59,3.0,48,3,4,2,9,0xb2d4f4ebd
327241.94,2.0,103,4,3,1,8,0xb2d138a2d
6314.09,1.0,10,2,2,3,7,0xb2d2fb3d
43059.96,2.0,7,2,3,3,8,0xb2d0740ed
2464.95,1.0,184,1,2,1,4,0x3b9b2eddd
87.91,1.0,7,1,2,3,6,0xb2d959df
581623.55,3.0,0,4,4,4,12,0xb2d333b4d
30896.26,1.0,92,2,2,1,5,0xb2d16db4
572.15,1.0,0,1,2,4,7,0xb2d95001
125237.31,4.0,6,3,4,3,10,0xb2d6e069d
681.27,1.0,65,1,2,2,5,0xb2d24f02
127048.7,2.0,3,3,3,4,10,0xb2d26775d
0.0,1.0,8,1,2,3,6,0xb2d836e4
170044.16,4.0,87,3,4,1,8,0xb2d1a49bd
60137.14,2.0,8,3,3,3,9,0xb2d420e5d
260068.71,2.0,19,3,3,2,8,0xb2d95559d
20366.74,2.0,188,2,3,1,6,0xb2d5c25e
614248.58,2.0,0,4,3,4,11,0xb2d0d961
271140.65,3.0,6,3,4,3,10,0xb2d5b3b0d
1440322.93,13.0,0,4,4,4,12,0xb2d0e2dcd
66646.15,1.0,15,3,2,3,8,0xb2d25a8b
78.5,1.0,0,1,2,4,7,0xb2d5581a
440000.79,5.0,6,4,4,3,11,0xb2d0dd0ad
3073.98,1.0,120,2,2,1,5,0xb2d1e952
46001.52,3.0,103,2,4,1,7,0xb2d5f202
152072.63,3.0,20,3,4,2,9,0xb2d196ba
1932.11,1.0,75,1,2,1,4,0xb2d1720cd
551642.93,6.0,0,4,4,4,12,0xb2d10e3bd
1254279.85,8.0,42,4,4,2,10,0xb2d3a457d
50005.81,1.0,21,2,2,2,6,0xb2da28ae
6397.34,1.0,5,2,2,3,7,0xb2d587e8
310138.28,3.0,11,4,4,3,11,0xb2d65b6cd
742.45,1.0,32,1,2,2,5,0xb2d4f4d0d
300000.0,2.0,14,3,3,3,9,0xb2da3c3e
11967.5,1.0,215,2,2,1,5,0xb2d24e35d
660046.26,4.0,18,4,4,2,10,0xb2d5c323d
9.06,2.0,80,1,3,1,5,0xb2d140d7d
45945.03,1.0,0,2,2,4,8,0xb2d6b500d
15000.36,2.0,67,2,3,1,6,0xb2d986f4
1198.39,1.0,0,1,2,4,7,0xb2d54bc7
36803.36,1.0,19,2,2,2,6,0xb2d1d71f
320000.72,3.0,24,4,4,2,10,0xb2d7869dd
520617.38,2.0,0,4,3,4,11,0xb2d5e395
42.57,1.0,10,1,2,3,6,0xb2d6ce38
1650076.5,6.0,83,4,4,1,9,0xb2d703eed
8475.78,2.0,6,2,3,3,8,0xb2d0ae91d
220094.23,3.0,14,3,4,3,10,0xb2d6048bd
83.43,1.0,19,1,2,2,5,0xb2d11158
692.14,1.0,0,1,2,4,7,0xb2d2edf5
338.05,1.0,0,1,2,4,7,0xb2d78c87
30001.59,2.0,67,2,3,1,6,0xb2d66618d
160002.08,3.0,4,3,4,4,11,0xb2d2f153d
850000.0,9.0,4,4,4,4,12,0xb2d6073b
448010.6,6.0,4,4,4,4,12,0xb2d0b007d
366.19,1.0,14,1,2,3,6,0xb2d8ea9a
100000.0,4.0,4,3,4,4,11,0xb2da58b0
73003.87,1.0,9,3,2,3,8,0xb2d6a3a3
287141.72,1.0,10,3,2,3,8,0xb2d5b4f1
273124.7,2.0,5,3,3,3,9,0xb2d13d10d
1413.73,1.0,184,1,2,1,4,0xb2d2d1bd
9077.57,1.0,7,2,2,3,7,0xb2da3c1f
600026.23,13.0,25,4,4,2,10,0xb2d19656d
2047.57,3.0,4,1,4,4,9,0xb2d78813d
805019.06,8.0,6,4,4,3,11,0xb2d11815d
50018.34,2.0,74,2,3,1,6,0xb2d36f3a
20783.2,1.0,75,2,2,1,5,0xb2d633d9d
4092.83,1.0,184,2,2,1,5,0xb2d252f1d
9720.97,1.0,0,2,2,4,8,0xb2d15dc5d
155679.43,1.0,267,3,2,1,6,0xb2d51b1fd
0.23,2.0,54,1,3,2,6,0xb2d2d0d9d
1090095.96,9.0,41,4,4,2,10,0xb2d2c549d
289203.06,2.0,9,3,3,3,9,0xb2d2e028d
953.65,1.0,12,1,2,3,6,0xb2d7f426
600020.84,3.0,13,4,4,3,11,0xb2d91fc6d
92.48,1.0,3,1,2,4,7,0xb2d5d2cad
157001.63,4.0,21,3,4,2,9,0xb2d25633d
414055.48,7.0,38,4,4,2,10,0xb2d4dee3d
150004.11,2.0,19,3,3,2,8,0xb2d645aa
1178182.34,8.0,7,4,4,3,11,0xb2d61400d
11.33,1.0,11,1,2,3,6,0xb2d9c917
5372.56,1.0,184,2,2,1,5,0xb2d25f56d
5753.19,1.0,0,2,2,4,8,0xb2d16d09d
5789.89,1.0,71,2,2,1,5,0xb2d2d5e4
15657.65,3.0,0,2,4,4,10,0x3b9b45d7
25931.62,1.0,184,2,2,1,5,0xb2d27dd0
101025.2,4.0,105,3,4,1,8,0xb2d5fde3d
100003.06,2.0,45,3,3,2,8,0xb2d6b0ef
1090038.63,6.0,27,4,4,2,10,0xb2d5ad20
1461491.31,5.0,9,4,4,3,11,0xb2d38127d
26518.54,1.0,6,2,2,3,7,0xb2d606f4
500004.0,8.0,20,4,4,2,10,0xb2d631f0d
170004.11,4.0,6,3,4,3,10,0xb2d8ecaed
500058.41,2.0,52,4,3,2,9,0xb2d6d6c8
95377.21,2.0,158,3,3,1,7,0xb2d1dda0d
352079.58,2.0,4,4,3,4,11,0xb2d62067d
104949.52,2.0,147,3,3,1,7,0xb2d52a0a
1202.58,1.0,1,1,2,4,7,0xb2d43aeb
1692.28,1.0,7,1,2,3,6,0xb2d2eb26
200573.25,4.0,1,3,4,4,11,0xb2d63bb7d
590339.21,4.0,0,4,4,4,12,0xb2d3a663d
552933.64,15.0,0,4,4,4,12,0xb2d20fabd
569336.31,9.0,0,4,4,4,12,0x3b9b46bad
797684.88,3.0,1,4,4,4,12,0xb2d3553e
172414.13,3.0,4,3,4,4,11,0xb2d14725d
0.11,1.0,33,1,2,2,5,0xb2d92690d
786306.44,4.0,11,4,4,3,11,0xb2d42a2e
103522.88,2.0,0,3,3,4,10,0xb2d80e04
6.91,1.0,92,1,2,1,4,0xb2d28e68d
0.26,1.0,1,1,2,4,7,0xb2d63293
140011.76,2.0,92,3,3,1,7,0xb2d4e93a
1300850.85,2.0,56,4,3,2,9,0xb2d4047dd
44.2,1.0,7,1,2,3,6,0xb2d62852
318.42,1.0,29,1,2,2,5,0xb2d416a6d
62344.11,3.0,4,3,4,4,11,0xb2d57f34d
6598.76,1.0,193,2,2,1,5,0xb2d382f1d
500060.65,2.0,3,4,3,4,11,0xb2d6795a
90637.7,2.0,25,3,3,2,8,0xb2d5c651
301695.19,4.0,32,4,4,2,10,0xb2d5da45d
59951.25,1.0,184,3,2,1,6,0xb2d18d9fd
1.48,1.0,66,1,2,2,5,0xb2d36900
200041.75,2.0,19,3,3,2,8,0xb2d6e59e
100001.06,2.0,63,3,3,2,8,0xb2d9b5f1
12.12,1.0,59,1,2,2,5,0xb2d994fb
13129.17,1.0,155,2,2,1,5,0xb2d7bec0
2095.39,1.0,184,1,2,1,4,0xb2d500f6d
8899.25,1.0,10,2,2,3,7,0xb2d6f15a
50020.23,2.0,136,2,3,1,6,0xb2d6339cd
2224.4,1.0,11,1,2,3,6,0xb2d41f54d
62507.47,1.0,10,3,2,3,8,0xb2d91d2a
0.0,1.0,5,1,2,3,6,0xb2d9c485
82.7,1.0,7,1,2,3,6,0xb2d80500
2.33,1.0,7,1,2,3,6,0xb2d90823
1203543.09,9.0,0,4,4,4,12,0xb2d10718d
3881.46,1.0,40,2,2,2,6,0xb2d7aefe
11014.07,1.0,141,2,2,1,5,0xb2d70017d
0.76,1.0,110,1,2,1,4,0xb2d2f39b
50638.12,1.0,92,2,2,1,5,0xb2d1d899
25587.96,1.0,13,2,2,3,7,0xb2d2a7b9d
1672.76,1.0,107,1,2,1,4,0xb2d2ff7fd
4479.15,1.0,73,2,2,1,5,0xb2d6ef78
1155.2,1.0,92,1,2,1,4,0xb2d0f557d
80000.85,3.0,18,3,4,2,9,0xb2d59132d
500032.4,2.0,10,4,3,3,10,0xb2d6fbf5
2954.14,1.0,0,2,2,4,8,0xb2d242cdd
5352.67,1.0,0,2,2,4,8,0xb2d931ec
1421125.9,4.0,27,4,4,2,10,0xb2d92ec0d
284000.0,5.0,0,3,4,4,11,0xb2d451dcd
350000.32,2.0,3,4,3,4,11,0xb2d281e2d
60440.37,4.0,12,3,4,3,10,0xb2d61983d
20723.72,1.0,15,2,2,3,7,0xb2d9460c
45711.41,6.0,0,2,4,4,10,0x3b9af0e2d
810.66,1.0,8,1,2,3,6,0xb2d8da14d
1036732.83,8.0,18,4,4,2,10,0xb2d1a874d
122899.42,2.0,228,3,3,1,7,0xb2d170ecd
12.08,1.0,9,1,2,3,6,0xb2d8c8e1d
9.34,9.0,18,1,4,2,7,0xb2d22f4cd
41996.06,1.0,29,2,2,2,6,0xb2d5c8efd
101926.59,2.0,6,3,3,3,9,0xb2d6a56b
3626.84,1.0,32,2,2,2,6,0xb2d9d431
3513.28,1.0,184,2,2,1,5,0xb2d3a97bd
101003.04,3.0,132,3,4,1,8,0xb2d54e0ad
1818.17,1.0,19,1,2,2,5,0xb2d870c0d
673453.32,4.0,24,4,4,2,10,0xb2d124f4d
303789.01,1.0,0,4,2,4,10,0xb2d249a0d
37185.85,1.0,20,2,2,2,6,0xb2d0bfded
240852.5,2.0,32,3,3,2,8,0xb2da05f2
50586.97,2.0,214,2,3,1,6,0xb2d63bf9
200710.42,2.0,29,3,3,2,8,0xb2d6d01b
576.2,1.0,48,1,2,2,5,0xb2d621ef
3744.42,1.0,0,2,2,4,8,0xb2d55822d
314.91,1.0,21,1,2,2,5,0xb2d26f3d
290013.31,2.0,136,3,3,1,7,0xb2d63791
15914.82,1.0,5,2,2,3,7,0xb2d60a02d
40001.98,2.0,92,2,3,1,6,0xb2d5e5ab
8532.98,1.0,20,2,2,2,6,0xb2d349b7d
330000.01,2.0,5,4,3,3,10,0xb2d5ff1e
210.49,1.0,2,1,2,4,7,0xb2d9a3f2
331887.83,2.0,1,4,3,4,11,0xb2d7910f
429.63,1.0,35,1,2,2,5,0xb2d60530d
734.19,2.0,0,1,3,4,8,0x3b9b337a
2.2,1.0,27,1,2,2,5,0xb2d5c1ecd
3020.91,1.0,184,2,2,1,5,0xb2d30a6ed
466.57,1.0,11,1,2,3,6,0xb2d6ce49d
1023992.19,6.0,26,4,4,2,10,0xb2d311b9d
1502.39,1.0,161,1,2,1,4,0xb2d8ee88d
578010.28,6.0,5,4,4,3,11,0xb2d5fbe6d
180000.0,14.0,4,3,4,4,11,0xb2d210e4
301014.69,3.0,10,4,4,3,11,0xb2d964bd
674.19,1.0,0,1,2,4,7,0xb2d1d3b2
220089.17,3.0,48,3,4,2,9,0xb2d0d299d
17.62,1.0,4,1,2,4,7,0xb2d2fb1d
301006.35,2.0,80,4,3,1,8,0xb2d308dcd
67.92,1.0,9,1,2,3,6,0xb2d209d3
1177.29,1.0,210,1,2,1,4,0xb2d20b89d
452078.11,4.0,0,4,4,4,12,0xb2d1a2b1d
2060224.35,6.0,0,4,4,4,12,0x3b9b0fdc
320286.2,3.0,24,4,4,2,10,0xb2d5b44cd
10017.0,1.0,0,2,2,4,8,0xb2d6a75b
220035.9,2.0,1,3,3,4,10,0xb2da4673
13601.15,1.0,0,2,2,4,8,0xb2d9131d
40027.14,2.0,69,2,3,1,6,0xb2d62c3a
0.0,1.0,6,1,2,3,6,0xb2d62397
5897.97,1.0,3,2,2,4,8,0xb2d62874d
2800.68,1.0,0,1,2,4,7,0xb2d9186ad
4032.54,1.0,13,2,2,3,7,0xb2d9d359
2031594.13,1.0,94,4,2,1,7,0xb2d3e697
220060.79,2.0,92,3,3,1,7,0xb2d10e77
7478.06,1.0,92,2,2,1,5,0xb2d40566d
30011.28,2.0,18,2,3,2,7,0xb2d60f74
106397.28,2.0,4,3,3,4,10,0xb2d697abd
20000.42,2.0,39,2,3,2,7,0xb2d9f075
867617.78,8.0,0,4,4,4,12,0xb2d101ddd
76.39,1.0,4,1,2,4,7,0xb2d3d3b7
53833.81,1.0,0,3,2,4,9,0xb2d3ec1bd
16.16,1.0,13,1,2,3,6,0xb2d6bd2d
25001.06,1.0,12,2,2,3,7,0xb2d9d754
2979604.01,3.0,21,4,4,2,10,0xb2d20c9ed
20.63,1.0,60,1,2,2,5,0xb2d3f613d
5345.3,1.0,18,2,2,2,6,0xb2d6c07dd
10001422.3,2.0,78,4,3,1,8,0xb2d23b0f
0.0,1.0,1,1,2,4,7,0xb2d5389d
302133.05,3.0,43,4,4,2,10,0xb2d7f3dfd
1972.49,3.0,0,1,4,4,9,0xb2d0d5c1
110090.36,2.0,6,3,3,3,9,0xb2d2d238
300163.2,2.0,0,4,3,4,11,0xb2d9690e
250000.0,2.0,4,3,3,4,10,0xb2da541c
117555.41,2.0,32,3,3,2,8,0xb2d169b7d
242627.85,10.0,0,3,4,4,11,0xb2d0a5c0d
50003.17,2.0,41,2,3,2,7,0xb2d1e5d0
11.56,1.0,1,1,2,4,7,0xb2d3608a
250005.89,3.0,77,3,4,1,8,0xb2d0a93b
61009.26,3.0,57,3,4,2,9,0xb2d17123d
1.77,1.0,65,1,2,2,5,0xb2d30019
19907347.76,13.0,0,4,4,4,12,0xb2d3e260d
10056.95,2.0,32,2,3,2,7,0xb2d6d4c6d
27342.55,3.0,0,2,4,4,10,0xb2d5ef5ed
366009.09,14.0,3,4,4,4,12,0xb2d1fb57d
58.02,1.0,33,1,2,2,5,0xb2d390f8d
681088.72,3.0,0,4,4,4,12,0xb2d3d380d
96.0,1.0,78,1,2,1,4,0xb2d34992d
793452.64,5.0,0,4,4,4,12,0xb2d10830
220060.6,3.0,7,3,4,3,10,0xb2d94b91d
11963.71,1.0,16,2,2,2,6,0xb2d2af9a
18.36,1.0,62,1,2,2,5,0xb2d51f39
490820.98,5.0,0,4,4,4,12,0x3b9b4599
1616.33,3.0,92,1,4,1,6,0x3b9b2a5cd
0.98,1.0,0,1,2,4,7,0xb2d51ea8d
850066.56,4.0,48,4,4,2,10,0xb2d5f83bd
501833.09,2.0,18,4,3,2,9,0xb2d78e68d
684.6,1.0,1,1,2,4,7,0xb2d6fed0
131883.29,1.0,1,3,2,4,9,0xb2d0dbf7
894.06,1.0,8,1,2,3,6,0xb2d6c68e
490008.86,2.0,12,4,3,3,10,0xb2d3be98
417.07,1.0,0,1,2,4,7,0xb2d6b8ca
1.31,1.0,2,1,2,4,7,0xb2d951d4d
71.11,1.0,0,1,2,4,7,0xb2d8d732
27.62,1.0,7,1,2,3,6,0xb2d636d2d
122916.75,5.0,6,3,4,3,10,0x3b9b4370d
246.22,1.0,13,1,2,3,6,0xb2d13633
957.39,1.0,20,1,2,2,5,0xb2d2a76dd
490090.13,5.0,25,4,4,2,10,0xb2d93795
38465.37,1.0,0,2,2,4,8,0xb2d5af11
152.15,1.0,58,1,2,2,5,0xb2d967c9
51477.52,3.0,9,2,4,3,9,0x3b9b4577d
800008.95,8.0,10,4,4,3,11,0xb2d41029d
100608.23,2.0,52,3,3,2,8,0xb2d6d2b8d
150007.4,4.0,3,3,4,4,11,0xb2d5bf21d
9224.81,1.0,0,2,2,4,8,0xb2d29536
450000.0,6.0,3,4,4,4,12,0xb2d5c05a
580016.47,3.0,35,4,4,2,10,0xb2d9cd47
130085.71,3.0,126,3,4,1,8,0xb2d5785bd
475204.23,6.0,18,4,4,2,10,0xb2d5ab9fd
10569.83,1.0,0,2,2,4,8,0xb2d0f461d
140001.48,2.0,83,3,3,1,7,0xb2d94fcb
19.55,1.0,39,1,2,2,5,0xb2d3100a
21.08,1.0,17,1,2,2,5,0xb2d2747c
1751976.49,6.0,15,4,4,3,11,0xb2d16e81d
3300000.0,10.0,4,4,4,4,12,0xb2d8c38c
254864.09,7.0,8,3,4,3,10,0xb2d6a35dd
170314.18,3.0,69,3,4,1,8,0xb2d55a1ad
487.72,3.0,1,1,4,4,9,0xb2d5f400
182016.51,4.0,132,3,4,1,8,0xb2d569acd
500000.0,2.0,25,4,3,2,9,0xb2d9a2c0
535074.04,2.0,0,4,3,4,11,0xb2d31ccbd
882930.19,1.0,0,4,2,4,10,0xb2d3534d
1158075.86,7.0,4,4,4,4,12,0xb2d68add
2797.03,1.0,0,1,2,4,7,0xb2d210c6d
512004.35,4.0,18,4,4,2,10,0xb2d9ffaf
10990.86,1.0,11,2,2,3,7,0xb2d52ef3
58001.86,4.0,18,3,4,2,9,0xb2d08a57
1100000.49,5.0,0,4,4,4,12,0xb2d0f61d
81382.06,2.0,165,3,3,1,7,0xb2d4d0eed
2002.26,1.0,116,1,2,1,4,0xb2d783db
30000.95,2.0,77,2,3,1,6,0xb2d992e9
215635.06,1.0,57,3,2,2,7,0xb2d5971a
379235.56,4.0,4,4,4,4,12,0xb2d694e8d
204977.51,2.0,4,3,3,4,10,0xb2d6857d
2082.83,1.0,127,1,2,1,4,0xb2d2747bd
80005.02,2.0,19,3,3,2,8,0xb2d4971dd
4.8,1.0,71,1,2,1,4,0xb2d6bbb9
4197.23,1.0,30,2,2,2,6,0xb2d37fe0d
1600053.57,5.0,11,4,4,3,11,0xb2d60782
61875.11,1.0,1,3,2,4,9,0xb2d65027d
2621.09,2.0,92,1,3,1,5,0xb2d08897
5988.84,1.0,5,2,2,3,7,0xb2d0fd9e
96.58,1.0,14,1,2,3,6,0xb2d91834
3210.92,3.0,150,2,4,1,7,0xb2d50b6dd
1332.57,1.0,1,1,2,4,7,0xb2d30f08d
612028.37,13.0,0,4,4,4,12,0xb2d4b42d
200710.85,2.0,30,3,3,2,8,0xb2d9c052
113027.4,2.0,4,3,3,4,10,0xb2d9bdc0
500142.77,2.0,13,4,3,3,10,0xb2d6448bd
304.85,2.0,0,1,3,4,8,0xb2d49006d
487286.75,3.0,71,4,4,1,9,0xb2d2932cd
39010.12,2.0,172,2,3,1,6,0xb2d58f71
12.99,1.0,12,1,2,3,6,0xb2d25298
92011.82,1.0,3,3,2,4,9,0xb2d39101d
40001.27,2.0,24,2,3,2,7,0xb2d94582
147005.3,2.0,67,3,3,1,7,0xb2d41ea0
8421.25,1.0,11,2,2,3,7,0xb2d697ddd
250818.3,2.0,0,3,3,4,10,0xb2d600bf
94.0,1.0,74,1,2,1,4,0xb2d370e0d
9809.37,1.0,21,2,2,2,6,0xb2d4571a
101668.85,2.0,0,3,3,4,10,0xb2d69c9ed
5587.64,1.0,9,2,2,3,7,0xb2d320b6d
0.0,1.0,16,1,2,2,5,0xb2d65d81
4160.22,1.0,0,2,2,4,8,0xb2d50928d
2.78,2.0,1,1,3,4,8,0xb2d19360d
3720039.27,2.0,27,4,3,2,9,0xb2d94127d
183744.43,3.0,80,3,4,1,8,0xb2d43c14d
14775.85,1.0,2,2,2,4,8,0xb2d92996d
1100000.0,2.0,7,4,3,3,10,0xb2d9698dd
252879.61,2.0,0,3,3,4,10,0xb2d1d1cdd
633.77,1.0,15,1,2,3,6,0xb2d96ad5
7701.35,7.0,46,2,4,2,8,0xb2d43932
50016.57,2.0,131,2,3,1,6,0xb2d62557
166574.58,2.0,13,3,3,3,9,0xb2d97141
535.57,1.0,1,1,2,4,7,0xb2d68eba
450000.0,5.0,6,4,4,3,11,0xb2d6eca5d
8988.46,1.0,0,2,2,4,8,0xb2d315afd
93.68,1.0,1,1,2,4,7,0xb2d74365
6775.24,1.0,123,2,2,1,5,0xb2d212af
564256.17,4.0,1,4,4,4,12,0xb2d8a6e9
13904.34,1.0,0,2,2,4,8,0xb2d6b619d
24014.67,2.0,62,2,3,2,7,0xb2d47ca4d
4387.96,3.0,33,2,4,2,8,0x3b9b0fac
52.73,1.0,6,1,2,3,6,0xb2d37c9f
2148.69,1.0,18,1,2,2,5,0xb2d0acc2d
210116.02,3.0,21,3,4,2,9,0xb2d611a5d
1830007.02,18.0,0,4,4,4,12,0xb2d217b6d
20009.43,2.0,77,2,3,1,6,0xb2d97d90
2.47,1.0,5,1,2,3,6,0xb2d69c3e
800402.47,3.0,35,4,4,2,10,0xb2d54f3b
2821222.07,4.0,35,4,4,2,10,0xb2d6db95d
432088.27,4.0,0,4,4,4,12,0xb2d95a6cd
100004.36,3.0,11,3,4,3,10,0xb2d68636
10098.29,1.0,92,2,2,1,5,0xb2d29a99d
15257.35,1.0,4,2,2,4,8,0xb2d6fa48
50002.2,2.0,68,2,3,1,6,0xb2d40d7ed
1554.41,1.0,7,1,2,3,6,0xb2d27882d
965434.21,5.0,4,4,4,4,12,0xb2d23221
1131.1,1.0,184,1,2,1,4,0xb2d1ec40
10878.03,1.0,1,2,2,4,8,0xb2d5222fd
9341.61,1.0,10,2,2,3,7,0xb2d6efc8
19675.94,1.0,6,2,2,3,7,0xb2d68f3ad
903.74,1.0,25,1,2,2,5,0xb2d1818cd
200010.56,2.0,42,3,3,2,8,0xb2d9e0ba
635.36,2.0,32,1,3,2,6,0xb2d289d5d
2914.28,1.0,0,2,2,4,8,0xb2d2a894d
376079.15,12.0,2,4,4,4,12,0xb2d12a23d
8903.8,1.0,10,2,2,3,7,0xb2d2a9f7
107194.15,1.0,111,3,2,1,6,0xb2d2b382
360021.97,21.0,5,4,4,3,11,0xb2d1701b
4.78,1.0,74,1,2,1,4,0xb2d64213
99519.93,9.0,108,3,4,1,8,0xb2d40b46d
125.03,1.0,1,1,2,4,7,0xb2d37668d
1193.84,1.0,18,1,2,2,5,0xb2d1bc97
83191.44,4.0,0,3,4,4,11,0xb2d0d9cfd
4998.08,1.0,21,2,2,2,6,0xb2d965e5
2981.27,1.0,0,2,2,4,8,0xb2d3f6c4
1888.88,1.0,92,1,2,1,4,0xb2d0e0e9d
20000.42,2.0,53,2,3,2,7,0xb2d56cf8
65031.48,3.0,4,3,4,4,11,0xb2d5fa90d
1003.02,1.0,0,1,2,4,7,0xb2d4cb4fd
646.35,1.0,0,1,2,4,7,0xb2d8d89e
210011.22,3.0,45,3,4,2,9,0xb2d3d627d
19.96,1.0,19,1,2,2,5,0xb2d3ed8f
95132.05,1.0,0,3,2,4,9,0xb2d1d656
1006.81,1.0,184,1,2,1,4,0xb2d40da0
203080.26,3.0,83,3,4,1,8,0xb2d59652
195100.74,4.0,130,3,4,1,8,0xb2d259b7d
500570.84,7.0,19,4,4,2,10,0xb2d52b5bd
52327.86,2.0,63,3,3,2,8,0xb2d5849fd
556051.15,12.0,0,4,4,4,12,0xb2d456fd
258599.99,3.0,14,3,4,3,10,0xb2d5c230
201653.41,2.0,55,3,3,2,8,0xb2d5a682
12445.73,1.0,11,2,2,3,7,0xb2d49700d
198171.8,4.0,4,3,4,4,11,0xb2d2730c
567582.73,4.0,40,4,4,2,10,0xb2d4f144d
407109.67,2.0,22,4,3,2,9,0xb2d6bda4d
122587.48,3.0,6,3,4,3,10,0xb2d62a37d
50042.92,2.0,196,2,3,1,6,0xb2d58b6bd
3008.01,1.0,9,2,2,3,7,0xb2d919f0
177868.47,2.0,3,3,3,4,10,0x3b9b2d44d
430001.0,3.0,0,4,4,4,12,0xb2da1ab2
150009.56,2.0,118,3,3,1,7,0xb2d565cfd
245017.06,3.0,53,3,4,2,9,0xb2d6499e
5510.4,1.0,0,2,2,4,8,0xb2d58e5c
736426.7,5.0,26,4,4,2,10,0xb2d6c9ce
50002.11,2.0,11,2,3,3,8,0xb2d9cc6d
19.55,1.0,61,1,2,2,5,0xb2d22c78
1045047.6,4.0,0,4,4,4,12,0xb2d10f1fd
447.15,1.0,33,1,2,2,5,0xb2d56bc0d
51667.8,1.0,10,2,2,3,7,0xb2d397ccd
201421.24,2.0,23,3,3,2,8,0xb2d98a9f
60.56,1.0,18,1,2,2,5,0xb2d62740
380000.0,2.0,25,4,3,2,9,0xb2d94bdb
135106.72,3.0,67,3,4,1,8,0xb2d26b6dd
370074.17,4.0,66,4,4,2,10,0xb2d29fe4d
10706.4,1.0,8,2,2,3,7,0xb2da3aad
149226.79,4.0,0,3,4,4,11,0xb2d6a2e7d
5320.83,1.0,0,2,2,4,8,0xb2d6074f
31.16,1.0,41,1,2,2,5,0xb2d3ba25
145666.89,7.0,15,3,4,3,10,0xb2d52bbf
100293.16,3.0,0,3,4,4,11,0xb2d4299d
30000.32,2.0,77,2,3,1,6,0xb2d996aa
53162.57,1.0,5,3,2,3,8,0xb2d3fbce
34576.33,5.0,0,2,4,4,10,0xb2d095d7d
10091.93,1.0,0,2,2,4,8,0xb2d3829cd
30544.05,2.0,199,2,3,1,6,0xb2d5d3a5d
12.66,1.0,27,1,2,2,5,0xb2d9ec8e
380609.96,10.0,0,4,4,4,12,0xb2d06d70
70706.34,4.0,6,3,4,3,10,0xb2d7abbe
123028.62,4.0,6,3,4,3,10,0xb2d1abb8d
2217.06,1.0,9,1,2,3,6,0xb2d8d102
40493.15,1.0,92,2,2,1,5,0xb2d489d7d
100154.37,2.0,83,3,3,1,7,0xb2d64993d
20000.26,2.0,31,2,3,2,7,0xb2d93960d
1132.03,1.0,0,1,2,4,7,0xb2d6e8c9
70000.85,2.0,0,3,3,4,10,0xb2d5a198
2272.44,1.0,3,1,2,4,7,0xb2d4701f
4.23,1.0,47,1,2,2,5,0xb2d9d157
500076.04,2.0,8,4,3,3,10,0xb2d9f749
100005.62,2.0,147,3,3,1,7,0xb2d5c77b
3509.09,1.0,92,2,2,1,5,0xb2d40668d
1117.42,1.0,184,1,2,1,4,0xb2d1ba65
152291.27,4.0,25,3,4,2,9,0xb2d64782d
864848.12,10.0,0,4,4,4,12,0xb2d0667fd
0.44,1.0,2,1,2,4,7,0xb2d921c3
1748.47,1.0,238,1,2,1,4,0xb2d626cad
1873.43,1.0,168,1,2,1,4,0xb2d2e657
5528.69,1.0,202,2,2,1,5,0xb2d4a5f2
43.8,1.0,10,1,2,3,6,0xb2d9ab3e
15.84,1.0,71,1,2,1,4,0xb2d4ee5ad
111.15,1.0,6,1,2,3,6,0xb2d29451d
586016.63,4.0,80,4,4,1,9,0xb2d6c816d
1001086.41,9.0,56,4,4,2,10,0xb2d249f0
70044.95,2.0,6,3,3,3,9,0xb2d4914a
111407.15,1.0,3,3,2,4,9,0xb2d2e61b
200002.89,2.0,26,3,3,2,8,0xb2d6b1eb
250009.06,5.0,0,3,4,4,11,0xb2d644dc
1541.23,1.0,19,1,2,2,5,0xb2d58ecc
1505713.22,4.0,7,4,4,3,11,0xb2d6e81c
13242.07,1.0,4,2,2,4,8,0xb2d606f4d
56797.68,2.0,125,3,3,1,7,0xb2d1760dd
700022.05,3.0,1,4,4,4,12,0xb2d2e749
107021.03,2.0,8,3,3,3,9,0xb2d645a5d
95089.45,4.0,15,3,4,3,10,0x3b9b3cb9
250940.91,2.0,22,3,3,2,8,0xb2d6b94ed
157763.45,1.0,184,3,2,1,6,0xb2d4527ad
100097.92,3.0,55,3,4,2,9,0xb2d54e46
4140.67,1.0,22,2,2,2,6,0xb2d25da0
196082.18,5.0,3,3,4,4,11,0xb2d10b4c
708710.77,6.0,0,4,4,4,12,0xb2d0b42cd
130001.37,2.0,221,3,3,1,7,0xb2d7072d
1000490.85,7.0,1,4,4,4,12,0xb2d8fd3ed
518905.07,5.0,73,4,4,1,9,0xb2d0f967d
40815950.28,3.0,1,4,4,4,12,0xb2d55c92d
10191.98,1.0,184,2,2,1,5,0xb2d2f456d
220000.72,3.0,0,3,4,4,11,0xb2d70148d
200741.76,2.0,29,3,3,2,8,0xb2d94094
125.03,1.0,5,1,2,3,6,0xb2d1e870
886949.37,5.0,0,4,4,4,12,0xb2d068c0d
168304.56,1.0,1,3,2,4,9,0xb2d48b3ad
474137.01,5.0,6,4,4,3,11,0xb2d588fed
2.73,1.0,76,1,2,1,4,0x3b9b25bed
4383.46,1.0,90,2,2,1,5,0xb2d23d28d
505329.87,3.0,34,4,4,2,10,0xb2d7f2d4d
174970.37,5.0,0,3,4,4,11,0xb2d47d45d
401735.45,3.0,28,4,4,2,10,0xb2d12499
205780.36,2.0,128,3,3,1,7,0xb2d3d3a6d
273436.67,3.0,136,3,4,1,8,0xb2d62891d
4003.41,1.0,92,2,2,1,5,0xb2d3bbb4
721458.2,9.0,6,4,4,3,11,0xb2d10f76
98.1,1.0,0,1,2,4,7,0xb2d21388
114.7,1.0,46,1,2,2,5,0xb2d70973d
156594.75,3.0,98,3,4,1,8,0xb2d1c136d
60002.63,2.0,14,3,3,3,9,0xb2d8eb56d
200012.44,3.0,73,3,4,1,8,0xb2d4f98b
16906.74,1.0,21,2,2,2,6,0xb2da076c
20614.41,1.0,10,2,2,3,7,0xb2d571c1d
200074.37,2.0,70,3,3,1,7,0xb2d972b8d
1165004.94,4.0,2,4,4,4,12,0xb2d2778f
452577.84,6.0,11,4,4,3,11,0xb2d15146
3914.02,1.0,38,2,2,2,6,0xb2d5d193
457.59,1.0,4,1,2,4,7,0xb2d8e316d
126969.66,1.0,92,3,2,1,6,0xb2d1d7b1
1548.95,1.0,110,1,2,1,4,0xb2d1c1fb
430001.27,3.0,4,4,4,4,12,0xb2da1d45
1848.82,1.0,3,1,2,4,7,0xb2d15adb
1644809.18,3.0,0,4,4,4,12,0xb2d195aad
50001.58,2.0,53,2,3,2,7,0xb2d9cb52
7244.36,1.0,0,2,2,4,8,0xb2d57624
168800.44,2.0,90,3,3,1,7,0xb2d0f30ad
3.17,1.0,67,1,2,1,4,0xb2d9ab1d
12757.93,1.0,8,2,2,3,7,0xb2d79172
501.17,1.0,5,1,2,3,6,0xb2d0ee55d
4763.8,5.0,184,2,4,1,7,0xb2d0af8cd
273540.17,2.0,6,3,3,3,9,0xb2d344fad
177889.35,3.0,108,3,4,1,8,0x3b9b37c0
582574.05,5.0,59,4,4,2,10,0xb2d07d71d
222184.8,4.0,4,3,4,4,11,0xb2d6a9f4d
770009.28,5.0,11,4,4,3,11,0xb2d58b59
2671.04,1.0,8,1,2,3,6,0xb2d2ac35
307112.35,5.0,46,4,4,2,10,0xb2d4413a
748.09,1.0,10,1,2,3,6,0xb2d9e039
3820.03,2.0,1,2,3,4,9,0xb2d3c2d3d
389035.12,2.0,49,4,3,2,9,0xb2d65d41d
0.4,1.0,76,1,2,1,4,0xb2d62315
920486.59,5.0,1,4,4,4,12,0xb2d26c4c
1431632.97,4.0,0,4,4,4,12,0xb2d5115e
290.67,1.0,15,1,2,3,6,0xb2d54c32d
537111.85,2.0,202,4,3,1,8,0xb2d112d7
420016.0,3.0,34,4,4,2,10,0xb2d6b6e8
401428.99,3.0,29,4,4,2,10,0xb2d5c0cdd
15345.88,1.0,4,2,2,4,8,0xb2d5ea75
36.28,1.0,84,1,2,1,4,0xb2d93b2fd
356021.17,4.0,49,4,4,2,10,0xb2d60a01d
1008.24,1.0,35,1,2,2,5,0xb2d6d9d9
453555.04,3.0,16,4,4,2,10,0xb2d699db
131625.73,4.0,11,3,4,3,10,0xb2d615a8d
240303.16,3.0,11,3,4,3,10,0xb2d1d5a7
8000.73,1.0,2,2,2,4,8,0xb2d936f8
2196.43,1.0,92,1,2,1,4,0xb2d42bc9
1409.37,1.0,92,1,2,1,4,0xb2d221ced
490595.38,1.0,2,4,2,4,10,0xb2d2e928d
151648.53,1.0,8,3,2,3,8,0xb2d1450dd
103.59,1.0,5,1,2,3,6,0xb2d9e4a4
1065.45,1.0,184,1,2,1,4,0xb2d32e9d
1940.34,1.0,0,1,2,4,7,0xb2d6ab61
193376.1,10.0,0,3,4,4,11,0x3b9af214d
540009.73,11.0,0,4,4,4,12,0xb2d1947ed
76953688.77,2.0,4,4,3,4,11,0xb2d4e92cd
303453.67,4.0,0,4,4,4,12,0xb2d69af4
44265.91,1.0,28,2,2,2,6,0xb2d3200a
143.0,1.0,77,1,2,1,4,0xb2d2ec0a
200006.33,2.0,34,3,3,2,8,0xb2d93172d
50001.06,2.0,11,2,3,3,8,0xb2da3f85
7308.46,1.0,0,2,2,4,8,0xb2d6e4b6d
3787.33,2.0,184,2,3,1,6,0xb2d5637dd
98315.6,1.0,92,3,2,1,6,0xb2d3620b
2485.25,1.0,92,1,2,1,4,0xb2d3f0acd
270320.79,1.0,11,3,2,3,8,0xb2da264a
419638.87,5.0,0,4,4,4,12,0xb2d0f4ed
400004.6,3.0,6,4,4,3,11,0xb2d1b669d
34494.4,1.0,92,2,2,1,5,0xb2d3f966d
10010.76,2.0,41,2,3,2,7,0xb2d9e74b
500159.01,2.0,60,4,3,2,9,0xb2d61091d
1406000.0,5.0,5,4,4,3,11,0xb2d6055b
10002.06,1.0,95,2,2,1,5,0xb2d284e1d
6.66,1.0,116,1,2,1,4,0xb2d782e9
83.55,1.0,22,1,2,2,5,0xb2d59bbb
551.94,1.0,60,1,2,2,5,0xb2d49f46d
292813.21,2.0,66,3,3,2,8,0xb2d117b4d
995144.73,2.0,24,4,3,2,9,0xb2d2042b
409005.11,10.0,55,4,4,2,10,0xb2d526afd
50651.04,2.0,48,2,3,2,7,0xb2d313ccd
236703.52,3.0,110,3,4,1,8,0xb2d2db47d
654204.1,4.0,46,4,4,2,10,0xb2d41131
2492049.71,8.0,39,4,4,2,10,0xb2d5f575d
5130433.4,4.0,4,4,4,4,12,0xb2d1a087
110398.59,3.0,129,3,4,1,8,0xb2d65111
379310.32,5.0,1,4,4,4,12,0xb2d553dbd
0.0,1.0,0,1,2,4,7,0xb2d281ca
556774.49,3.0,74,4,4,1,9,0xb2d62f78d
70061.46,2.0,4,3,3,4,10,0xb2d5d1f2
59.9,2.0,0,1,3,4,8,0xb2d0b4ddd
350000.0,2.0,17,4,3,2,9,0xb2d98c62
500004.34,2.0,0,4,3,4,11,0xb2d93f51d
453864.84,1.0,300,4,2,1,7,0xb2d201a8d
103.49,1.0,26,1,2,2,5,0xb2d91c35
75609.6,4.0,80,3,4,1,8,0xb2d592d8d
1537.01,1.0,92,1,2,1,4,0xb2d418ced
64825.11,1.0,10,3,2,3,8,0xb2d50604
543352.07,5.0,47,4,4,2,10,0xb2d25067d
61938.72,1.0,0,3,2,4,9,0xb2d35149
445.04,1.0,0,1,2,4,7,0xb2d48d9b
8038.34,1.0,92,2,2,1,5,0xb2d2daadd
450081.4,5.0,11,4,4,3,11,0xb2d07db5d
54935.6,2.0,1,3,3,4,10,0xb2d923d7
820257.24,6.0,1,4,4,4,12,0xb2d3a548
2740.21,1.0,0,1,2,4,7,0xb2d8672b
1486.23,1.0,5,1,2,3,6,0xb2d2cd7bd
7248.73,1.0,0,2,2,4,8,0xb2d294dc
250003.11,3.0,21,3,4,2,9,0xb2d3a544d
13217.81,1.0,8,2,2,3,7,0xb2d2335a
300003.17,2.0,53,3,3,2,8,0xb2d9d0e3
12762.77,1.0,14,2,2,3,7,0xb2d43267d
500010.65,2.0,14,4,3,3,10,0xb2d5ab92
150001.44,3.0,80,3,4,1,8,0xb2d1f8b0
672012.96,12.0,31,4,4,2,10,0xb2d1bc7fd
1196.08,1.0,184,1,2,1,4,0xb2d1b976d
254836.49,9.0,0,3,4,4,11,0xb2d0d864d
1315.54,1.0,3,1,2,4,7,0xb2da004f
19514.84,1.0,2,2,2,4,8,0xb2d5f1ab
237.43,1.0,10,1,2,3,6,0xb2d23384
260001.9,3.0,90,3,4,1,8,0xb2d6efe2
40.84,2.0,38,1,3,2,6,0xb2d06fef
524982.21,5.0,21,4,4,2,10,0xb2d395ddd
405.41,1.0,3,1,2,4,7,0xb2d1b55d
22277.38,1.0,0,2,2,4,8,0xb2d5546d
220241.56,4.0,60,3,4,2,9,0xb2d3a597d
501840.33,2.0,32,4,3,2,9,0xb2d652d5
599.59,1.0,0,1,2,4,7,0xb2d5f8afd
112688.67,7.0,12,3,4,3,10,0x3b9adb75
2344239.99,5.0,33,4,4,2,10,0xb2d76960
2313.33,1.0,92,1,2,1,4,0xb2d40f74d
467325.0,10.0,9,4,4,3,11,0x3b9b2549d
0.0,13.0,81,1,4,1,6,0xb2d6e418
500201.18,2.0,67,4,3,1,8,0xb2d64329
200000.0,2.0,4,3,3,4,10,0xb2d97950
140006.27,3.0,164,3,4,1,8,0x3b9b3e3bd
207826.67,2.0,126,3,3,1,7,0xb2d651d7d
60.63,1.0,20,1,2,2,5,0xb2d68d18
20.89,1.0,4,1,2,4,7,0xb2d654b1
300000.0,2.0,12,3,3,3,9,0xb2d95e2a
626.83,1.0,0,1,2,4,7,0xb2d36ae4
65244.18,2.0,8,3,3,3,9,0xb2d55c33
1517082.49,6.0,9,4,4,3,11,0xb2d200c2d
389281.06,8.0,0,4,4,4,12,0xb2d5093a
101710.94,2.0,0,3,3,4,10,0xb2d41100
201816.8,2.0,81,3,3,1,7,0xb2d3d6cdd
1441939.22,7.0,0,4,4,4,12,0xb2d17498
1043.52,2.0,92,1,3,1,5,0x3b9b1975d
504190.53,3.0,80,4,4,1,9,0xb2d596b1d
59000.0,5.0,8,3,4,3,10,0xb2d06440d
105380.77,2.0,0,3,3,4,10,0xb2d4ff64d
426754.57,5.0,2,4,4,4,12,0xb2d3623cd
213001.38,6.0,42,3,4,2,9,0xb2d22a59
2334.41,1.0,92,1,2,1,4,0xb2d245f6
1634.37,1.0,0,1,2,4,7,0xb2d55e88
83027.47,2.0,104,3,3,1,7,0xb2d580f4d
20357.34,1.0,27,2,2,2,6,0xb2d43543
501074.61,3.0,39,4,4,2,10,0xb2d9ec96
108327.33,3.0,0,3,4,4,11,0xb2d21823d
100107.64,2.0,90,3,3,1,7,0xb2d3219ad
150006.05,4.0,80,3,4,1,8,0xb2d669b0d
250199.57,2.0,164,3,3,1,7,0xb2d2801d
200000.0,2.0,21,3,3,2,8,0xb2d950a8d
24.24,1.0,201,1,2,1,4,0xb2d3a63e
265277.58,7.0,1,3,4,4,11,0xb2d31371d
2.75,1.0,101,1,2,1,4,0xb2d50ce3
301065.66,2.0,43,4,3,2,9,0xb2d9e584
25906.74,1.0,92,2,2,1,5,0xb2d27dd0d
1011.16,1.0,92,1,2,1,4,0xb2d24a88
29980.53,2.0,0,2,3,4,9,0xb2d51e72d
309009.68,7.0,10,4,4,3,11,0xb2d8c67b
6758.35,1.0,9,2,2,3,7,0xb2d13c70
30000.0,2.0,6,2,3,3,8,0xb2d96ec6d
6.33,1.0,76,1,2,1,4,0xb2d71719
1.13,1.0,15,1,2,3,6,0xb2d2451ed
2384.38,1.0,158,1,2,1,4,0xb2d1605ad
3156.98,1.0,0,2,2,4,8,0xb2d613c2
441788.46,4.0,56,4,4,2,10,0xb2d1b1e6
300002.67,2.0,25,3,3,2,8,0xb2d5d7fb
61.83,1.0,11,1,2,3,6,0xb2d2ea16
2781000.06,39.0,0,4,4,4,12,0xb2d21edbd
12.63,1.0,116,1,2,1,4,0xb2d78408d
91071.51,2.0,59,3,3,2,8,0xb2d4907b
4961.52,1.0,36,2,2,2,6,0xb2d9f066
13593.93,1.0,21,2,2,2,6,0xb2d74becd
10250.1,2.0,6,2,3,3,8,0xb2d62fcbd
180085.74,2.0,46,3,3,2,8,0xb2d175da
128.77,1.0,10,1,2,3,6,0xb2d308bb
4089388.04,24.0,1,4,4,4,12,0x3b9b1801d
38621.62,1.0,0,2,2,4,8,0xb2d904af
37.52,1.0,53,1,2,2,5,0xb2d5b9c2d
480.28,1.0,27,1,2,2,5,0xb2d9fc89
2247672.81,1.0,6,4,2,3,9,0xb2d24660
50203.11,2.0,202,2,3,1,6,0xb2d253fa
571549.83,13.0,3,4,4,4,12,0x3b9af62cd
1764.96,1.0,16,1,2,2,5,0xb2d240c1d
92.65,1.0,5,1,2,3,6,0xb2d308ebd
10146.98,1.0,13,2,2,3,7,0xb2d48befd
10027.36,1.0,7,2,2,3,7,0xb2d6a831
33920.57,1.0,0,2,2,4,8,0xb2d07443d
816111.38,12.0,19,4,4,2,10,0x3b9b3a64d
227046.99,6.0,0,3,4,4,11,0xb2d2598dd
7216.04,1.0,0,2,2,4,8,0xb2d69131
1384.84,1.0,12,1,2,3,6,0xb2d68739d
509164.01,1.0,0,4,2,4,10,0xb2d132fcd
1692.72,1.0,11,1,2,3,6,0xb2d64ea9
5.81,1.0,40,1,2,2,5,0xb2d61ebb
113559.09,2.0,111,3,3,1,7,0xb2d2b93ed
375770.78,3.0,25,4,4,2,10,0xb2d3bd17d
163173.44,2.0,184,3,3,1,7,0xb2d10921
144028.14,2.0,63,3,3,2,8,0xb2d67e86d
1021.69,1.0,184,1,2,1,4,0xb2d2a678
556.1,1.0,35,1,2,2,5,0xb2d245ca
101877.37,2.0,0,3,3,4,10,0xb2d07766
760086.91,6.0,18,4,4,2,10,0xb2d14ffd
26015.59,2.0,52,2,3,2,7,0xb2d6d3f7d
281969.5,1.0,18,3,2,2,7,0xb2d21e69d
344008.28,6.0,19,4,4,2,10,0x3b9b3c0ad
200710.42,2.0,33,3,3,2,8,0xb2d9393e
5305.67,1.0,184,2,2,1,5,0xb2d1f88ed
2.53,1.0,101,1,2,1,4,0xb2d0bf87
200610.46,2.0,1,3,3,4,10,0xb2d91e59d
249351.27,3.0,5,3,4,3,10,0xb2d5f98a
40278.64,2.0,0,2,3,4,9,0xb2d5deb7d
1066324.93,24.0,0,4,4,4,12,0xb2d25393
378623.05,3.0,60,4,4,2,10,0xb2d1c247d
5456.61,1.0,1,2,2,4,8,0xb2d912dc
5417.9,1.0,14,2,2,3,7,0xb2d319b1
250022.43,5.0,11,3,4,3,10,0xb2d6fecb
2395.11,1.0,218,1,2,1,4,0xb2d5e667d
1347.4,1.0,1,1,2,4,7,0xb2d68a01d
0.09,1.0,92,1,2,1,4,0xb2d3c734d
6060.19,1.0,92,2,2,1,5,0xb2d28e99d
308892.37,4.0,76,4,4,1,9,0xb2d24134d
530072.07,6.0,27,4,4,2,10,0xb2d273e9d
308.38,1.0,11,1,2,3,6,0xb2d6d280d
80004.36,2.0,18,3,3,2,8,0xb2d56408d
532000.36,5.0,6,4,4,3,11,0xb2d68dc3
593982.93,15.0,11,4,4,3,11,0xb2d2538ed
753.87,6.0,48,1,4,2,7,0xb2d2d2f2d
507926.56,2.0,0,4,3,4,11,0xb2d33229d
99010.59,5.0,32,3,4,2,9,0xb2d5ec59d
84992.62,7.0,0,3,4,4,11,0xb2d54c42d
10004.43,2.0,108,2,3,1,6,0xb2d5b9c3
222762.34,5.0,8,3,4,3,10,0xb2d59423
200000.0,2.0,3,3,3,4,10,0xb2d915fbd
2100011.14,8.0,10,4,4,3,11,0xb2d60782d
280006.23,5.0,0,3,4,4,11,0xb2d21b51d
808.86,1.0,23,1,2,2,5,0xb2d60bb4
47216.7,2.0,8,2,3,3,8,0xb2d34820
20006.34,1.0,7,2,2,3,7,0xb2d93fffd
8508.31,1.0,0,2,2,4,8,0xb2d0f93d
3955.55,1.0,10,2,2,3,7,0xb2d8cabb
360012.38,3.0,73,4,4,1,9,0xb2d6149c
68.18,1.0,12,1,2,3,6,0xb2d960b2
9512.47,1.0,0,2,2,4,8,0xb2d55471
1003604.17,2.0,30,4,3,2,9,0xb2d8fd6e
44.04,1.0,2,1,2,4,7,0xb2d340e4
10331.14,1.0,92,2,2,1,5,0xb2d27ae4
6388.16,1.0,3,2,2,4,8,0xb2d36727d
1.13,1.0,16,1,2,2,5,0xb2d70625
191106.27,4.0,14,3,4,3,10,0xb2d563d6
49.45,1.0,40,1,2,2,5,0xb2d5dcee
135326.58,2.0,25,3,3,2,8,0xb2d0e1e6d
272.59,1.0,12,1,2,3,6,0xb2d5c090
450196.95,3.0,13,4,4,3,11,0xb2d8e1c1d
20350.58,2.0,38,2,3,2,7,0xb2d6cc5ed
155256.24,2.0,83,3,3,1,7,0xb2d6223f
0.77,1.0,71,1,2,1,4,0xb2d632db
296430.59,1.0,286,3,2,1,6,0xb2d5ea98d
51494.21,2.0,175,2,3,1,6,0xb2d29851d
15333.91,1.0,20,2,2,2,6,0xb2d2e886
3255.67,3.0,92,2,4,1,7,0xb2d10ed3d
25.86,1.0,10,1,2,3,6,0xb2d90365
464.44,1.0,84,1,2,1,4,0xb2d325b1d
4466.21,1.0,7,2,2,3,7,0xb2d6b93d
1140.45,1.0,92,1,2,1,4,0xb2d15962
1309890.79,5.0,13,4,4,3,11,0xb2d53b50
2495.26,2.0,119,1,3,1,5,0xb2d509df
2024.27,1.0,184,1,2,1,4,0xb2d24b87d
37949.97,1.0,6,2,2,3,7,0xb2d82306d
2483.01,1.0,14,1,2,3,6,0xb2d7918cd
300014.1,2.0,74,3,3,1,7,0xb2d6a8d8d
1533.19,1.0,2,1,2,4,7,0xb2d78899d
1000130.69,2.0,140,4,3,1,8,0xb2d1de03
60004.58,2.0,32,3,3,2,8,0xb2d46fb2
38.25,1.0,83,1,2,1,4,0xb2d6dc27d
320000.0,7.0,5,4,4,3,11,0xb2d1948cd
206.18,1.0,37,1,2,2,5,0xb2d8d401
12.98,1.0,25,1,2,2,5,0xb2d91533
385045.44,27.0,3,4,4,4,12,0xb2d26a02
9.37,1.0,20,1,2,2,5,0xb2d1b3a0d
130009.08,2.0,168,3,3,1,7,0xb2d2ee52
123061.3,3.0,3,3,4,4,11,0xb2d457e7
0.63,1.0,26,1,2,2,5,0xb2da0c33
321717.27,2.0,172,4,3,1,8,0xb2d231bdd
105788.32,1.0,4,3,2,4,9,0xb2d51ffd
455.34,1.0,6,1,2,3,6,0xb2d8c9ee
100008.25,2.0,9,3,3,3,9,0xb2da17b2
0.05,1.0,81,1,2,1,4,0xb2d6bf85
4912.53,1.0,126,2,2,1,5,0xb2d295e3d
603193.91,3.0,15,4,4,3,11,0xb2d2b6ff
330003.03,3.0,123,4,4,1,9,0xb2d4b337d
330002.08,3.0,24,4,4,2,10,0xb2d1090dd
32.96,1.0,28,1,2,2,5,0xb2d93f1a
30542.54,1.0,6,2,2,3,7,0xb2d25bb8
1684.7,1.0,92,1,2,1,4,0xb2d27f8cd
3.94,1.0,84,1,2,1,4,0xb2d64f4e
1.21,1.0,9,1,2,3,6,0xb2d9dac3
240715.29,3.0,14,3,4,3,10,0xb2d22511
1111061.96,19.0,0,4,4,4,12,0xb2d0d59f
107730.03,3.0,2,3,4,4,11,0x3b9b30a5
70030.22,3.0,82,3,4,1,8,0xb2d6b43e
56045.56,2.0,6,3,3,3,9,0xb2d6a160d
639456.21,7.0,0,4,4,4,12,0xb2d4a401
69459.82,2.0,20,3,3,2,8,0xb2d12ae4
140003.8,3.0,27,3,4,2,9,0xb2d8e76a
32737.82,2.0,101,2,3,1,6,0xb2d5749fd
605838.24,6.0,110,4,4,1,9,0xb2d2de40
160001.22,7.0,0,3,4,4,11,0xb2d5a6cad
13680.88,6.0,184,2,4,1,7,0x3b9b33cbd
200.96,1.0,8,1,2,3,6,0xb2d3ad2c
10000.11,2.0,62,2,3,2,7,0xb2d8f7b9
765250.44,11.0,11,4,4,3,11,0xb2d0668e
575781.41,11.0,1,4,4,4,12,0xb2d41767d
515219.21,2.0,194,4,3,1,8,0xb2d06a4ed
120000.0,2.0,4,3,3,4,10,0xb2d96e65d
512443.94,2.0,221,4,3,1,8,0xb2d71845d
50001.06,2.0,53,2,3,2,7,0xb2d9cc71
4809.53,1.0,4,2,2,4,8,0xb2d59753
600000.0,3.0,6,4,4,3,11,0xb2d56eedd
400220.32,3.0,0,4,4,4,12,0xb2d614ac
6697.68,1.0,0,2,2,4,8,0xb2d91318
300302.48,4.0,52,4,4,2,10,0xb2d1c266d
2020.97,1.0,9,1,2,3,6,0xb2d34ceed
500059.73,2.0,22,4,3,2,9,0xb2d60442
1721.01,1.0,28,1,2,2,5,0xb2d30219
10181.36,2.0,199,2,3,1,6,0xb2d5d407d
90007.06,2.0,27,3,3,2,8,0xb2d5e72a
661177.87,10.0,4,4,4,4,12,0xb2d58823d
1200100.02,3.0,7,4,4,3,11,0xb2d93ed3d
509384.32,2.0,129,4,3,1,8,0xb2d8f1a9
10017.66,2.0,14,2,3,3,8,0xb2d92c69d
310003.79,2.0,6,4,3,3,10,0xb2d97377d
12000.0,2.0,6,2,3,3,8,0xb2da5118
77.56,1.0,35,1,2,2,5,0xb2d95d9cd
11.08,1.0,35,1,2,2,5,0xb2d89fa9
264455.84,2.0,0,3,3,4,10,0xb2d6da06
161.54,3.0,35,1,4,2,7,0xb2d2f235
4886.97,1.0,82,2,2,1,5,0xb2d96feb
5014.46,1.0,21,2,2,2,6,0xb2d642a3
6.33,1.0,19,1,2,2,5,0xb2d95055d
410010.03,3.0,12,4,4,3,11,0xb2d6bbcd
36.17,1.0,0,1,2,4,7,0xb2d57002
10000.43,2.0,46,2,3,2,7,0xb2d9122c
250043.01,2.0,164,3,3,1,7,0xb2d15258
251707.22,2.0,29,3,3,2,8,0xb2d5def0d
145006.84,3.0,20,3,4,2,9,0x3b9b2ae7d
16.89,2.0,81,1,3,1,5,0xb2d478ded
50001.06,2.0,110,2,3,1,6,0xb2d89f87d
500034.2,2.0,0,4,3,4,11,0xb2d0cfe9d
130058.52,5.0,24,3,4,2,9,0xb2d25261
221808.36,5.0,3,3,4,4,11,0xb2d23ba0d
253405.85,2.0,0,3,3,4,10,0xb2d52dbed
3526.09,1.0,209,2,2,1,5,0xb2d2b467d
2200687.1,2.0,18,4,3,2,9,0xb2d3af4dd
239000.57,3.0,45,3,4,2,9,0xb2d1baf0d
387082.92,6.0,47,4,4,2,10,0xb2d5e7b3d
10072.0,1.0,184,2,2,1,5,0xb2d362e2
700007.39,2.0,49,4,3,2,9,0xb2d9d27d
251006.72,3.0,26,3,4,2,9,0xb2d8db51
2197.09,1.0,167,1,2,1,4,0xb2d64f2cd
490021.51,3.0,3,4,4,4,12,0xb2d12dacd
941784.71,6.0,175,4,4,1,9,0xb2d1f996
51014.98,2.0,95,2,3,1,6,0xb2d601dfd
5211.09,1.0,15,2,2,3,7,0xb2d9c49a
106815.16,1.0,1,3,2,4,9,0xb2d26892d
34.09,1.0,14,1,2,3,6,0x3b9b32f2d
830320.87,4.0,5,4,4,3,11,0xb2d1aed7d
719.65,1.0,17,1,2,2,5,0xb2d06cc5
0.0,2.0,1,1,3,4,8,0xb2da08f0
680177.99,6.0,0,4,4,4,12,0xb2d363c0d
1015771.36,4.0,6,4,4,3,11,0xb2d41673
468560.77,8.0,48,4,4,2,10,0xb2d30290d
14300.97,1.0,1,2,2,4,8,0xb2d6a7a4
1.5,1.0,49,1,2,2,5,0xb2d6d2d8
4698.06,1.0,1,2,2,4,8,0xb2d2ba2bd
633709.2,4.0,0,4,4,4,12,0xb2d49604
500000.0,2.0,0,4,3,4,11,0xb2da6746
499.38,1.0,5,1,2,3,6,0xb2d271f0
300259.84,2.0,111,4,3,1,8,0xb2d0e79ed
10607.92,1.0,89,2,2,1,5,0xb2d39fabd
200710.42,2.0,35,3,3,2,8,0xb2d9fc63
26121.34,1.0,145,2,2,1,5,0xb2d10179
609244.36,4.0,42,4,4,2,10,0xb2d62bce
15000.0,2.0,0,2,3,4,9,0xb2d60c27
37230.59,1.0,0,2,2,4,8,0xb2d7c835
1988793.01,4.0,67,4,4,1,9,0xb2d1b951d
80020.29,2.0,168,3,3,1,7,0xb2d769ffd
50886.96,2.0,206,2,3,1,6,0xb2d5c651d
1240.18,1.0,0,1,2,4,7,0xb2d77f18d
677415.83,8.0,0,4,4,4,12,0xb2d32383d
51850.81,2.0,52,2,3,2,7,0xb2d5c51cd
127019.35,3.0,76,3,4,1,8,0xb2d24d5d
1893909.36,9.0,25,4,4,2,10,0xb2d4bdc0
710074.31,7.0,26,4,4,2,10,0xb2d4600a
4010.07,1.0,5,2,2,3,7,0xb2d4ec2f
24373.19,1.0,0,2,2,4,8,0xb2d5302a
208544.85,3.0,105,3,4,1,8,0xb2d61c01
260083.01,2.0,20,3,3,2,8,0xb2d56faf
18555.43,1.0,8,2,2,3,7,0xb2d8d626d
9.9,1.0,1,1,2,4,7,0xb2d1a784d
100001.06,2.0,76,3,3,1,7,0xb2d8de26
76543.87,1.0,4,3,2,4,9,0xb2d60708d
50315.54,2.0,151,2,3,1,6,0x3b9b4974d
104.32,1.0,46,1,2,2,5,0xb2d93b1e
22330.52,1.0,92,2,2,1,5,0x3b9b17afd
100003.65,2.0,80,3,3,1,7,0xb2d8a0bcd
27117.07,1.0,0,2,2,4,8,0xb2d70152d
80071.95,3.0,108,3,4,1,8,0xb2d5df1ed
500000.0,2.0,18,4,3,2,9,0xb2d9d0fe
10000.21,2.0,38,2,3,2,7,0xb2d92830d
920596.05,3.0,11,4,4,3,11,0x3b9b343fd
7946.37,1.0,184,2,2,1,5,0xb2d1ae19
400083.46,2.0,13,4,3,3,10,0xb2d6f6f4
71054.98,3.0,66,3,4,2,9,0xb2d19f0dd
23960.0,1.0,5,2,2,3,7,0xb2d6075a
3167.78,1.0,10,2,2,3,7,0xb2d0c2b3
1880.32,1.0,0,1,2,4,7,0xb2d58768
15532.25,1.0,4,2,2,4,8,0xb2d6a2dc
151167.86,3.0,193,3,4,1,8,0xb2d54abbd
10.1,1.0,11,1,2,3,6,0xb2d9301f
17643.67,1.0,22,2,2,2,6,0xb2d2b51f
299008.0,2.0,0,3,3,4,10,0xb2d981f0
481002.63,6.0,1,4,4,4,12,0xb2d3a2b2
2278.71,2.0,92,1,3,1,5,0xb2d1d874d
1800520.0,1.0,0,4,2,4,10,0xb2d96f32
470000.92,3.0,12,4,4,3,11,0xb2d6fa6f
619262.88,9.0,35,4,4,2,10,0xb2d60ee9d
200040.31,2.0,63,3,3,2,8,0xb2d2b337d
15824.29,1.0,0,2,2,4,8,0xb2d6b132d
20038.67,2.0,25,2,3,2,7,0xb2d5ed98
43496.28,1.0,0,2,2,4,8,0xb2d42965
86009.22,2.0,157,3,3,1,7,0xb2d1645e
100182.82,3.0,73,3,4,1,8,0xb2d5d435
114744.59,4.0,25,3,4,2,9,0xb2d515ffd
37.35,1.0,14,1,2,3,6,0xb2d8cd55
400262.64,4.0,2,4,4,4,12,0xb2d1ee4f
151190.71,2.0,132,3,3,1,7,0xb2d69514
209252.84,2.0,97,3,3,1,7,0xb2d5f7f3
772738.93,5.0,4,4,4,4,12,0xb2d57ab0
105025.28,1.0,10,3,2,3,8,0xb2d947d4
586306.85,4.0,31,4,4,2,10,0xb2d0c21dd
4189.86,1.0,10,2,2,3,7,0xb2d07fd6d
0.0,2.0,77,1,3,1,5,0xb2d9482cd
100794.43,1.0,184,3,2,1,6,0xb2d368b2d
200710.57,3.0,55,3,4,2,9,0xb2d685f8
457703.15,7.0,14,4,4,3,11,0xb2d2a02ed
1136.92,2.0,92,1,3,1,5,0x3b9b26a9
4002.27,1.0,19,2,2,2,6,0xb2d6b6bad
50938.7,1.0,0,2,2,4,8,0xb2d6d6bcd
1674.21,2.0,92,1,3,1,5,0xb2d6585d
220036.76,8.0,4,3,4,4,11,0xb2d5d6abd
100003.17,3.0,80,3,4,1,8,0xb2d6468cd
323.8,1.0,4,1,2,4,7,0xb2d2426dd
12230.52,1.0,0,2,2,4,8,0xb2d29986
541172.48,3.0,22,4,4,2,10,0xb2d9c261
300152.97,2.0,123,4,3,1,8,0xb2d5baacd
1609.84,1.0,5,1,2,3,6,0xb2d21d3fd
274085.66,4.0,14,3,4,3,10,0x3b9b4367d
1391.6,1.0,92,1,2,1,4,0xb2d1ef6e
236009.97,3.0,161,3,4,1,8,0xb2d8e673d
1.13,2.0,75,1,3,1,5,0xb2d477c5
6769.11,4.0,60,2,4,2,8,0xb2d8e7fed
203479.57,1.0,0,3,2,4,9,0xb2d90dc4
28882.41,1.0,0,2,2,4,8,0xb2d8167c
31026.19,1.0,11,2,2,3,7,0xb2d5a651d
60.81,1.0,29,1,2,2,5,0xb2d9b333
503385.83,2.0,4,4,3,4,11,0xb2d55f8e
501776.04,2.0,34,4,3,2,9,0xb2d935b9d
190000.0,2.0,0,3,3,4,10,0xb2d480efd
23991.45,1.0,18,2,2,2,6,0xb2d37f2cd
1000042.26,2.0,182,4,3,1,8,0xb2d89fd1d
63513.3,1.0,9,3,2,3,8,0xb2d3ec07
50480.02,1.0,92,2,2,1,5,0xb2d2a6b3d
200710.47,2.0,47,3,3,2,8,0xb2d9e24e
1207026.19,20.0,6,4,4,3,11,0xb2d6277ad
10034.44,2.0,0,2,3,4,9,0xb2d68a7f
994640.37,5.0,121,4,4,1,9,0xb2d15fa8d
153.54,1.0,9,1,2,3,6,0xb2d8ff3e
1.08,1.0,57,1,2,2,5,0xb2d42711
372037.82,3.0,6,4,4,3,11,0xb2d4ac89
160012.58,7.0,19,3,4,2,9,0xb2d63b8cd
108836.45,1.0,7,3,2,3,8,0xb2d31d98d
101931.26,1.0,56,3,2,2,7,0xb2d18461
5406.93,1.0,3,2,2,4,8,0xb2d4df24
10353.71,1.0,4,2,2,4,8,0xb2d5b74cd
410044.93,2.0,5,4,3,3,10,0xb2d8d811d
358591.86,1.0,0,4,2,4,10,0xb2d19f3b
600000.59,9.0,12,4,4,3,11,0xb2d1519f
15068.37,1.0,0,2,2,4,8,0xb2d9296f
200000.0,2.0,18,3,3,2,8,0xb2da2ec8
1420040.16,9.0,0,4,4,4,12,0xb2d12023d
2914.3,1.0,184,2,2,1,5,0xb2d26430
646894.19,1.0,2,4,2,4,10,0xb2d3f835d
16013.92,2.0,16,2,3,2,7,0xb2d56a4fd
200075.33,2.0,15,3,3,3,9,0xb2d6f472
2553.71,1.0,10,1,2,3,6,0xb2d9cf36
15672.62,1.0,2,2,2,4,8,0xb2d0d228d
1004949.93,10.0,0,4,4,4,12,0x3b9af17fd
535031.08,5.0,87,4,4,1,9,0xb2d24e91d
519248.63,2.0,199,4,3,1,8,0xb2d45511d
18003.0,1.0,1,2,2,4,8,0xb2d2c149
15403.15,3.0,0,2,4,4,10,0xb2d130dcd
50202.64,2.0,6,2,3,3,8,0xb2d33d58d
221011.22,2.0,3,3,3,4,10,0xb2d5b89ad
145082.39,4.0,20,3,4,2,9,0xb2d9252d
807.71,1.0,3,1,2,4,7,0xb2d58c1e
11068.13,2.0,92,2,3,1,6,0xb2d28507d
6984.55,1.0,0,2,2,4,8,0xb2d6a1cb
450000.0,3.0,21,4,4,2,10,0xb2d94e24d
198598.4,1.0,184,3,2,1,6,0xb2d263a3d
80000.0,2.0,16,3,3,2,8,0xb2d55102d
1239.92,1.0,184,1,2,1,4,0xb2d18d02
20020.52,2.0,204,2,3,1,6,0xb2d4ad65
1220128.99,2.0,14,4,3,3,10,0xb2d109dc
143293.29,3.0,21,3,4,2,9,0xb2d102e6d
92333.05,5.0,3,3,4,4,11,0xb2d687bad
7471.35,1.0,29,2,2,2,6,0xb2d9291b
70977.21,6.0,0,3,4,4,11,0x3b9ae835
12959.44,1.0,10,2,2,3,7,0xb2d2b619d
190116.65,5.0,7,3,4,3,10,0x3b9b18d8d
121212.56,6.0,3,3,4,4,11,0xb2d4b32fd
50000.33,1.0,0,2,2,4,8,0xb2d61b96
51430.1,2.0,0,2,3,4,9,0xb2d2b016d
90000.95,2.0,21,3,3,2,8,0xb2da1fed
510053.22,3.0,7,4,4,3,11,0xb2d06922
256048.91,3.0,0,3,4,4,11,0xb2d32f03d
200720.85,2.0,9,3,3,3,9,0xb2d8ea6fd
0.0,1.0,7,1,2,3,6,0xb2d3484a
8.4,1.0,39,1,2,2,5,0xb2d78477
5093.17,1.0,9,2,2,3,7,0xb2d90ebe
4056.14,1.0,92,2,2,1,5,0xb2d25bced
60654.17,3.0,3,3,4,4,11,0xb2d52c87
1733.37,2.0,92,1,3,1,5,0x3b9b42f9d
6.02,1.0,74,1,2,1,4,0xb2d8dd8ad
240007.29,4.0,18,3,4,2,9,0xb2d90e2ed
551006.38,3.0,14,4,4,3,11,0xb2d6f8a6d
55.69,1.0,10,1,2,3,6,0xb2d5304b
200006.34,2.0,6,3,3,3,9,0xb2da2701
11.34,3.0,0,1,4,4,9,0xb2d0b39dd
3020.05,1.0,7,2,2,3,7,0xb2d93d4f
131.07,1.0,3,1,2,4,7,0xb2d6c243
500004.14,3.0,18,4,4,2,10,0xb2d68c80d
40001.16,2.0,39,2,3,2,7,0xb2d8c4abd
300062.75,2.0,13,3,3,3,9,0xb2d6487b
11000.12,2.0,60,2,3,2,7,0xb2d9c050
50000.0,2.0,1,2,3,4,9,0xb2da6119
340076.78,5.0,24,4,4,2,10,0xb2d63dd9d
20007.41,2.0,16,2,3,2,7,0xb2d6dbc5d
4216.95,1.0,24,2,2,2,6,0xb2d2caa6
3237.45,1.0,14,2,2,3,7,0xb2d64770
10.34,1.0,32,1,2,2,5,0xb2d5858e
1105.63,1.0,102,1,2,1,4,0xb2d13323
3555.6,1.0,1,2,2,4,8,0xb2d5d2df
100037.37,2.0,92,3,3,1,7,0x3b9b470dd
768252.67,2.0,74,4,3,1,8,0xb2d24226d
5436.74,1.0,3,2,2,4,8,0xb2d6bb76
20.33,1.0,24,1,2,2,5,0xb2d2d001d
210006.96,3.0,53,3,4,2,9,0xb2d9b0cf
100000.0,6.0,8,3,4,3,10,0xb2d18199d
560244.46,3.0,2,4,4,4,12,0xb2da0bca
722.02,1.0,0,1,2,4,7,0xb2d2f75e
52429.72,2.0,263,3,3,1,7,0xb2d39d1bd
31886.68,1.0,21,2,2,2,6,0xb2d0e434
60005.04,3.0,8,3,4,3,10,0xb2d5abf4d
285976.67,8.0,0,3,4,4,11,0xb2d6d7d9
150247.88,3.0,0,3,4,4,11,0xb2d184a4
1790.87,1.0,184,1,2,1,4,0xb2d403b0d
460094.2,4.0,8,4,4,3,11,0xb2d16d0dd
259604.84,3.0,32,3,4,2,9,0xb2d565c1
1209201.22,5.0,14,4,4,3,11,0xb2d42947d
200720.84,2.0,30,3,3,2,8,0xb2d966fc
2266.57,1.0,6,1,2,3,6,0xb2d91c94
782570.46,11.0,1,4,4,4,12,0xb2d069c1d
401825.41,5.0,6,4,4,3,11,0xb2d433b4d
43030.06,1.0,184,2,2,1,5,0xb2d5e836d
841.99,1.0,1,1,2,4,7,0xb2d6f002
431821.25,3.0,97,4,4,1,9,0xb2d081e4d
365945.46,11.0,3,4,4,4,12,0x3b9b1a36d
1070045.23,2.0,122,4,3,1,8,0xb2d13aaed
1794.42,1.0,124,1,2,1,4,0xb2d21da9d
500006.14,2.0,15,4,3,3,10,0xb2d86c20
90053.88,1.0,7,3,2,3,8,0xb2d2e944d
401897.15,6.0,0,4,4,4,12,0xb2d63c9ad
834391.52,3.0,1,4,4,4,12,0xb2d378b2d
240067.08,3.0,126,3,4,1,8,0xb2d24aa3d
12821.72,1.0,2,2,2,4,8,0xb2d25f21d
442.31,1.0,10,1,2,3,6,0xb2d62d9b
401870.28,2.0,4,4,3,4,11,0xb2d1002b
500000.0,2.0,13,4,3,3,10,0xb2da4137
100015.55,2.0,178,3,3,1,7,0xb2d1ad3a
5051.5,1.0,92,2,2,1,5,0xb2d2bf38d
40001.26,3.0,62,2,4,2,8,0xb2d8d63cd
2254.08,1.0,184,1,2,1,4,0xb2d15be1d
500821.68,2.0,200,4,3,1,8,0xb2d3af33d
2065917.01,6.0,217,4,4,1,9,0xb2d1a9a5d
13192.46,1.0,0,2,2,4,8,0xb2d6a509d
214730.01,2.0,11,3,3,3,9,0xb2d18f48d
38612.91,1.0,184,2,2,1,5,0xb2d4ee13d
359098.44,3.0,41,4,4,2,10,0xb2d1c8dbd
400007.39,2.0,13,4,3,3,10,0xb2d6c832
601078.37,3.0,42,4,4,2,10,0xb2d9dea0
111379.11,2.0,59,3,3,2,8,0xb2d2dc24
2542157.92,7.0,3,4,4,4,12,0xb2d08313d
222345.43,2.0,23,3,3,2,8,0xb2d951e2
600235.63,5.0,0,4,4,4,12,0xb2d2d0ab
179558.67,7.0,10,3,4,3,10,0xb2d2bb8bd
2173.79,1.0,60,1,2,2,5,0xb2d8d102d
585181.05,5.0,7,4,4,3,11,0xb2d1ca4ed
14413.73,1.0,0,2,2,4,8,0xb2d59c8b
105547.48,2.0,76,3,3,1,7,0xb2d0d91a
717.94,1.0,65,1,2,2,5,0xb2d51232d
4135.01,1.0,184,2,2,1,5,0xb2d300c9
151064.71,3.0,12,3,4,3,10,0xb2d62cd6d
530540.02,7.0,0,4,4,4,12,0xb2d06729d
490010.85,4.0,11,4,4,3,11,0xb2d3e99b
1241.01,1.0,9,1,2,3,6,0xb2d49f52
401379.1,4.0,1,4,4,4,12,0xb2d55bced
2994703.92,1.0,0,4,2,4,10,0xb2d3f1ec
2003.5,1.0,0,1,2,4,7,0xb2d3622ad
100462.75,1.0,4,3,2,4,9,0xb2d62983d
347.63,1.0,184,1,2,1,4,0xb2d249f2
364325.88,3.0,32,4,4,2,10,0xb2d22e7dd
15.86,1.0,0,1,2,4,7,0xb2d20ee0d
351261.36,54.0,0,4,4,4,12,0xb2d224da
5663.29,1.0,0,2,2,4,8,0xb2d2f98cd
129364.43,2.0,199,3,3,1,7,0xb2d3eaabd
516.37,1.0,32,1,2,2,5,0xb2d2db3d
183.23,1.0,67,1,2,1,4,0xb2d2f6de
12778.23,1.0,0,2,2,4,8,0xb2d906cad
41145.52,4.0,14,2,4,3,9,0xb2d53045d
400000.52,3.0,9,4,4,3,11,0xb2d60296
81380.46,1.0,10,3,2,3,8,0xb2d3e839
2062.98,1.0,3,1,2,4,7,0xb2d357e8d
1752105.5,5.0,5,4,4,3,11,0xb2d2695cd
8280.87,1.0,92,2,2,1,5,0xb2d32843d
7628.51,1.0,29,2,2,2,6,0xb2d939b8
400008.96,3.0,28,4,4,2,10,0xb2d8c6d2
2132.19,1.0,1,1,2,4,7,0xb2d44a51d
428000.0,4.0,4,4,4,4,12,0xb2d1a2d3
10079.07,2.0,28,2,3,2,7,0xb2da065f
529028.7,3.0,11,4,4,3,11,0xb2d659c1
1380109.21,11.0,11,4,4,3,11,0xb2d3f5ae
4925.57,1.0,14,2,2,3,7,0xb2d8caf2
19.56,1.0,28,1,2,2,5,0xb2d92ca2
407211.28,3.0,41,4,4,2,10,0xb2d12202
1026693.51,4.0,95,4,4,1,9,0xb2d64bc9d
4.69,1.0,61,1,2,2,5,0xb2d23f6a
4947.34,1.0,10,2,2,3,7,0xb2d251dfd
18964.8,1.0,1,2,2,4,8,0xb2d6cd63
408.56,1.0,31,1,2,2,5,0xb2d6fbfc
133448.76,2.0,0,3,3,4,10,0x3b9b25d0
560085.1,3.0,8,4,4,3,11,0xb2d147add
0.56,1.0,66,1,2,2,5,0xb2d5b06bd
10000.42,2.0,27,2,3,2,7,0xb2d93e7f
278.22,1.0,31,1,2,2,5,0xb2d483c1
450067.67,6.0,0,4,4,4,12,0xb2d0a52dd
36599.95,2.0,0,2,3,4,9,0xb2d0694fd
200006.01,2.0,1,3,3,4,10,0xb2d6db5d
130.66,1.0,45,1,2,2,5,0xb2d85757d
250199.76,2.0,256,3,3,1,7,0xb2d2801dd
64.69,1.0,6,1,2,3,6,0xb2d3106d
60041.5,2.0,182,3,3,1,7,0xb2d5f56ad
103.17,1.0,21,1,2,2,5,0xb2d30629
4504.05,1.0,92,2,2,1,5,0xb2d11312
107.12,1.0,92,1,2,1,4,0xb2d32723d
500043.4,3.0,14,4,4,3,11,0xb2d8f1d1
3005813.23,5.0,1,4,4,4,12,0xb2d92d5ed
766470.64,25.0,0,4,4,4,12,0x3b9af0ead
1150000.0,11.0,1,4,4,4,12,0xb2d3dc28d
2.64,1.0,70,1,2,1,4,0xb2d992db
151751.04,2.0,0,3,3,4,10,0xb2d1f9acd
31239.71,1.0,4,2,2,4,8,0xb2d1f7e0
395057.98,2.0,235,4,3,1,8,0xb2d58bbad
1429.07,1.0,92,1,2,1,4,0xb2d23d6e
601883.88,3.0,25,4,4,2,10,0xb2d6dd2e
430000.0,1.0,1,4,2,4,10,0xb2da669e
180133.13,4.0,60,3,4,2,9,0xb2d135d7d
381177.82,1.0,92,4,2,1,7,0xb2d393ded
2900.76,1.0,0,2,2,4,8,0xb2d41517d
6749.94,1.0,3,2,2,4,8,0xb2d7c835d
157249.5,2.0,174,3,3,1,7,0xb2d153edd
1000000.96,4.0,3,4,4,4,12,0xb2d5f137
505330.04,2.0,76,4,3,1,8,0xb2d9606cd
295.1,1.0,2,1,2,4,7,0xb2d2fe02
2264.17,1.0,92,1,2,1,4,0x3b9b37acd
220000.0,2.0,0,3,3,4,10,0xb2d97e15d
700060.58,3.0,42,4,4,2,10,0xb2d6d6c8d
325719.05,2.0,172,4,3,1,8,0xb2d6362ad
500005.35,2.0,0,4,3,4,11,0xb2d921d9d
71048.3,1.0,1,3,2,4,9,0xb2d129d4d
500052.75,2.0,17,4,3,2,9,0xb2d97ed1
15009.17,2.0,133,2,3,1,6,0xb2d92313d
470025.86,3.0,6,4,4,3,11,0x3b9b31f7d
375080.68,17.0,1,4,4,4,12,0xb2d638cfd
490016.27,6.0,7,4,4,3,11,0xb2d1067e
150881.5,4.0,1,3,4,4,11,0xb2d0d9f6
140017.38,2.0,112,3,3,1,7,0xb2d57328
6565.44,1.0,16,2,2,2,6,0xb2d1cea0
425619.49,5.0,2,4,4,4,12,0x3b9b2819
111386.28,2.0,73,3,3,1,7,0xb2d6bbc5d
30000001.0,2.0,20,4,3,2,9,0xb2d907e0
20000.21,2.0,73,2,3,1,6,0xb2d8e43bd
972.44,1.0,3,1,2,4,7,0xb2d6277c
202278.92,1.0,0,3,2,4,9,0xb2d92d16d
1372.22,1.0,4,1,2,4,7,0xb2d95a9d
42.08,1.0,80,1,2,1,4,0xb2d2f02a
58476.22,1.0,12,3,2,3,8,0xb2d3aa8bd
9054.43,1.0,0,2,2,4,8,0xb2d6bf2ad
374389.44,5.0,69,4,4,1,9,0xb2d4002cd
70006.05,2.0,27,3,3,2,8,0xb2d56eb1
7401.32,1.0,21,2,2,2,6,0xb2d6d273d
180078.43,1.0,7,3,2,3,8,0xb2d64f4c
15936.87,1.0,22,2,2,2,6,0xb2d3b393
501776.23,2.0,50,4,3,2,9,0xb2d9d732
1600066.88,5.0,20,4,4,2,10,0xb2d526f2d
3924.5,1.0,184,2,2,1,5,0xb2d60c2dd
52140.09,2.0,0,2,3,4,9,0xb2d3d4ff
9.88,1.0,11,1,2,3,6,0xb2d3ef5b
512603.84,7.0,20,4,4,2,10,0xb2d683d9d
3010.73,1.0,92,2,2,1,5,0xb2d27c5ed
200025.38,2.0,5,3,3,3,9,0xb2d8ea6e
278014.13,3.0,253,3,4,1,8,0xb2d436b0d
12461.13,1.0,184,2,2,1,5,0xb2d45723
3218.08,1.0,1,2,2,4,8,0xb2d5c266
649460.21,5.0,4,4,4,4,12,0xb2d0bbedd
330486.02,9.0,2,4,4,4,12,0xb2d55aef
1002492.99,5.0,15,4,4,3,11,0xb2d686fb
260540.37,6.0,0,3,4,4,11,0xb2d5f096
101.73,2.0,0,1,3,4,8,0xb2d98385
132100.72,6.0,2,3,4,4,11,0xb2d5ab01
341342.42,2.0,1,4,3,4,11,0xb2d323ffd
70000.0,2.0,0,3,3,4,10,0xb2d429d5
510656.86,7.0,28,4,4,2,10,0xb2d78241d
1058.59,1.0,4,1,2,4,7,0xb2d58cf2
4686.88,1.0,51,2,2,2,6,0xb2d4b402d
27963.5,1.0,0,2,2,4,8,0xb2d3a33b
44.47,1.0,5,1,2,3,6,0xb2d6ed7a
240003.21,2.0,41,3,3,2,8,0xb2d4ff65
280004.44,2.0,60,3,3,2,8,0xb2d8c384d
577449.99,7.0,1,4,4,4,12,0xb2d5abd4d
111937.0,1.0,7,3,2,3,8,0xb2d60bf5d
9333.48,1.0,99,2,2,1,5,0xb2d2ae7d
60043.22,2.0,92,3,3,1,7,0xb2d16c3c
1114387.97,2.0,192,4,3,1,8,0xb2d1e90ed
2313.68,1.0,184,1,2,1,4,0xb2d274efd
570024.69,2.0,23,4,3,2,9,0xb2d9d411
50254.65,1.0,14,2,2,3,7,0xb2d6a06d
142003.03,6.0,0,3,4,4,11,0xb2d90f5dd
400000.84,3.0,5,4,4,3,11,0xb2d9fc1f
95779.48,7.0,5,3,4,3,10,0xb2d30509
1812.17,1.0,184,1,2,1,4,0xb2d3ffbfd
600008.0,3.0,3,4,4,4,12,0xb2d25eca
2833.55,1.0,21,1,2,2,5,0xb2d1b12ad
50004.23,2.0,12,2,3,3,8,0xb2d79009
200000.0,2.0,7,3,3,3,9,0xb2d96eecd
8002.11,1.0,34,2,2,2,6,0xb2d9374cd
11534.88,1.0,168,2,2,1,5,0xb2d6018d
200716.85,2.0,1,3,3,4,10,0xb2d9c03d
1524.11,1.0,5,1,2,3,6,0xb2d9115f
158052.52,5.0,0,3,4,4,11,0xb2d0e5d9
125404.62,1.0,39,3,2,2,7,0xb2d2e4ecd
123521.77,2.0,11,3,3,3,9,0xb2d41eeed
293523.33,4.0,3,3,4,4,11,0xb2d5583ad
10300.9,2.0,116,2,3,1,6,0xb2d5a849
220051.16,6.0,2,3,4,4,11,0xb2d57c8cd
170004.86,4.0,38,3,4,2,9,0xb2d8e182
7489.76,1.0,92,2,2,1,5,0xb2d3b259d
37300.7,3.0,3,2,4,4,10,0xb2da3e36
1.9,1.0,20,1,2,2,5,0xb2d6a158d
130003.74,4.0,90,3,4,1,8,0xb2d68677d
50016.0,2.0,214,2,3,1,6,0xb2d765bad
8095.32,1.0,18,2,2,2,6,0xb2d705df
402501.45,3.0,228,4,4,1,9,0xb2d1baf9d
100008.16,3.0,95,3,4,1,8,0xb2d5512b
8420.01,2.0,92,2,3,1,6,0xb2d0ded6d
107474.71,3.0,200,3,4,1,8,0xb2d38a2cd
618768.62,4.0,4,4,4,4,12,0xb2d6210b
606171.88,4.0,63,4,4,2,10,0xb2d0d225
227050.66,2.0,125,3,3,1,7,0xb2d686fed
25258.96,2.0,266,2,3,1,6,0xb2d51694d
9670.26,1.0,17,2,2,2,6,0xb2d2f619
54204.16,1.0,0,3,2,4,9,0xb2d52659d
1031000.0,9.0,0,4,4,4,12,0xb2d29857
75883.42,1.0,6,3,2,3,8,0xb2d4d371d
65467.89,2.0,41,3,3,2,8,0xb2d65c49
4937142.78,2.0,2,4,3,4,11,0xb2d93afcd
401420.87,3.0,30,4,4,2,10,0xb2d9bd34
92508.34,1.0,33,3,2,2,7,0xb2d3f4e2d
1847.61,1.0,9,1,2,3,6,0xb2d96b0e
1168916.36,4.0,25,4,4,2,10,0xb2d06aead
15063.03,2.0,67,2,3,1,6,0xb2d11eec
5033.49,1.0,184,2,2,1,5,0xb2d430fc
30368.16,1.0,10,2,2,3,7,0xb2d5d148d
100080.24,3.0,47,3,4,2,9,0xb2d64ae2d
590057.68,7.0,17,4,4,2,10,0xb2d24786d
18590.5,1.0,19,2,2,2,6,0xb2d6f0e8
5861.3,1.0,8,2,2,3,7,0xb2d547ed
23056.83,1.0,0,2,2,4,8,0xb2d2b29f
155.11,1.0,24,1,2,2,5,0xb2d6ab56
41.82,1.0,89,1,2,1,4,0xb2d29f08
51146.01,1.0,138,2,2,1,5,0xb2d2b3d4d
68616.53,6.0,0,3,4,4,11,0x3b9af26e
56.89,1.0,22,1,2,2,5,0xb2d5358cd
301244.62,3.0,4,4,4,4,12,0xb2d19b3fd
1136.95,1.0,92,1,2,1,4,0xb2d2e1b6
174746.78,2.0,18,3,3,2,8,0xb2d14397d
3858347.94,16.0,58,4,4,2,10,0xb2d629b9d
51672.6,2.0,3,2,3,4,9,0xb2d2a877
4479.6,5.0,184,2,4,1,7,0xb2d33589d
1006.7,1.0,184,1,2,1,4,0xb2d33a2ed
647637.78,8.0,0,4,4,4,12,0xb2d0831ed
931800.28,7.0,83,4,4,1,9,0x3b9b336dd
70006.59,4.0,24,3,4,2,9,0xb2d62a89
731817.66,5.0,20,4,4,2,10,0xb2d294d1
9552.67,1.0,0,2,2,4,8,0xb2d2b19a
165096.52,1.0,192,3,2,1,6,0xb2d62c11d
121961.67,5.0,4,3,4,4,11,0xb2d5325ad
2074.58,1.0,40,1,2,2,5,0xb2d55fcad
261903.31,5.0,41,3,4,2,9,0xb2d4f367d
100790.93,2.0,139,3,3,1,7,0xb2d17eced
81031.22,2.0,214,3,3,1,7,0xb2d6699bd
267244.4,4.0,27,3,4,2,9,0xb2d2b2c3d
111946.29,5.0,0,3,4,4,11,0x3b9af2cfd
400073.27,3.0,17,4,4,2,10,0xb2d6e8c2d
4038.99,1.0,92,2,2,1,5,0xb2d28277d
601295.53,4.0,6,4,4,3,11,0xb2d68889
60776.01,2.0,0,3,3,4,10,0xb2d22cd1
5855742.65,2.0,6,4,3,3,10,0xb2d4cc4cd
31095.79,1.0,99,2,2,1,5,0xb2d60be7
500053.85,3.0,14,4,4,3,11,0xb2d55f86
500034.08,3.0,8,4,4,3,11,0xb2d5a1cdd
5584.75,2.0,92,2,3,1,6,0xb2d09347d
400013.88,5.0,48,4,4,2,10,0x3b9b2e30
1338110.84,6.0,1,4,4,4,12,0xb2d16071
293938.65,3.0,23,3,4,2,9,0xb2d5d1e3d
362000.0,3.0,18,4,4,2,10,0xb2d95685
1387.02,1.0,141,1,2,1,4,0xb2d81cfa
81725.67,1.0,3,3,2,4,9,0xb2d419ca
300043.34,2.0,2,3,3,4,10,0xb2d94258d
1317092.57,6.0,0,4,4,4,12,0xb2d56583d
40277.48,2.0,259,2,3,1,6,0xb2d65a95
300792.38,17.0,13,4,4,3,11,0xb2d18534
5026.66,1.0,10,2,2,3,7,0xb2d94047
10.87,1.0,27,1,2,2,5,0xb2d914a8d
5050.36,1.0,0,2,2,4,8,0xb2d23310d
2875.47,1.0,1,1,2,4,7,0xb2d6cc48
120209.93,7.0,11,3,4,3,10,0xb2d0a390
43721.05,8.0,0,2,4,4,10,0x3b9ae61bd
500944.58,2.0,3,4,3,4,11,0xb2d787fdd
560000.0,7.0,7,4,4,3,11,0xb2d1408bd
113757.0,4.0,181,3,4,1,8,0xb2d1d9e6d
320013.82,6.0,13,4,4,3,11,0xb2d2da23d
1210.63,1.0,92,1,2,1,4,0xb2d28a32d
258332.61,2.0,17,3,3,2,8,0xb2d65a3ad
14.78,1.0,68,1,2,1,4,0xb2d8e4dd
490047.89,3.0,41,4,4,2,10,0xb2d5856d
327.37,1.0,9,1,2,3,6,0xb2d2648f
4270.25,1.0,9,2,2,3,7,0xb2d33a7e
1045.77,1.0,1,1,2,4,7,0xb2d3b1c1d
10202.13,1.0,184,2,2,1,5,0xb2d52ba3d
12639.96,1.0,65,2,2,2,6,0xb2d4ff16
45.85,1.0,0,1,2,4,7,0xb2d6b387d
2052229.7,3.0,56,4,4,2,10,0xb2d09beed
109756.77,2.0,19,3,3,2,8,0xb2d231a0
1265.39,1.0,1,1,2,4,7,0xb2d34839d
309.6,1.0,15,1,2,3,6,0xb2d26a37
14655.39,1.0,7,2,2,3,7,0xb2d3f3ee
101741.38,2.0,107,3,3,1,7,0xb2d5ffd1
212497.43,2.0,10,3,3,3,9,0xb2d4cc3fd
78502.73,1.0,268,3,2,1,6,0xb2d396a1d
1715569.99,6.0,12,4,4,3,11,0xb2d716add
27.37,1.0,24,1,2,2,5,0xb2d7857fd
3001.68,1.0,62,2,2,2,6,0xb2d8f401
4388.87,1.0,18,2,2,2,6,0xb2d29c83d
4613.84,1.0,92,2,2,1,5,0xb2d2d4ffd
1087.36,1.0,101,1,2,1,4,0xb2d25636
10039.21,1.0,150,2,2,1,5,0xb2d4a9c8d
82430.8,1.0,90,3,2,1,6,0xb2d1c688d
374.01,2.0,20,1,3,2,6,0xb2d31061d
53227.98,1.0,4,3,2,4,9,0xb2d5df5b
10318.59,2.0,0,2,3,4,9,0xb2d210bfd
300806.75,3.0,103,4,4,1,9,0xb2d1751bd
600000.67,4.0,1,4,4,4,12,0xb2d3d8d9
1060213.18,7.0,0,4,4,4,12,0x3b9af277d
1017.57,1.0,92,1,2,1,4,0xb2d5e9d2d
30004.49,2.0,108,2,3,1,6,0xb2d5a681
340797.22,3.0,27,4,4,2,10,0xb2d109b6d
800372.47,5.0,10,4,4,3,11,0xb2d1dc92d
601449.56,3.0,1,4,4,4,12,0xb2d5515c
100000.42,4.0,4,3,4,4,11,0xb2da40eb
10000.74,2.0,11,2,3,3,8,0xb2d95bd5
160006.78,2.0,92,3,3,1,7,0xb2d665a6d
150003.59,9.0,4,3,4,4,11,0xb2d56e8bd
529167.43,5.0,4,4,4,4,12,0xb2d8cd3ed
222276.29,4.0,46,3,4,2,9,0xb2d64a25d
1500098.74,8.0,0,4,4,4,12,0xb2d5f5e0d
302722.11,4.0,10,4,4,3,11,0xb2d60971d
607313.15,2.0,92,4,3,1,8,0xb2d2577a
4627.14,1.0,0,2,2,4,8,0xb2d112d7d
533168.58,6.0,11,4,4,3,11,0xb2d10bc8d
2169.58,1.0,10,1,2,3,6,0xb2d2fc94
6000.39,1.0,1,2,2,4,8,0xb2d319b1d
400047.29,3.0,24,4,4,2,10,0xb2d579bed
3096.57,2.0,12,2,3,3,8,0xb2d21b7d
4137.38,1.0,0,2,2,4,8,0xb2d5302fd
12089.04,1.0,15,2,2,3,7,0xb2d6d570
101642.37,2.0,136,3,3,1,7,0xb2d62f46d
4.09,1.0,112,1,2,1,4,0xb2d5f1b0
250000.0,2.0,10,3,3,3,9,0xb2d968dfd
106411.38,3.0,101,3,4,1,8,0xb2d444d7
1778.09,1.0,10,1,2,3,6,0xb2d68a2d
10.11,1.0,17,1,2,2,5,0xb2d8d315
1204287.62,2.0,37,4,3,2,9,0xb2d6f9d9
3279.97,1.0,184,2,2,1,5,0x3b9ad26e
876112.6,7.0,4,4,4,4,12,0xb2d5a977d
644396.05,5.0,1,4,4,4,12,0xb2d2d229
299870.45,4.0,2,3,4,4,11,0xb2d5b8a4
2054.65,1.0,45,1,2,2,5,0xb2d6ea6c
1067.49,1.0,92,1,2,1,4,0xb2d0cac3d
113538.4,1.0,0,3,2,4,9,0xb2d37ba1d
500000.0,3.0,6,4,4,3,11,0xb2d98610
213431.55,3.0,28,3,4,2,9,0xb2d6029bd
20592.49,1.0,12,2,2,3,7,0xb2d2e834
160086.36,4.0,0,3,4,4,11,0xb2d31cfdd
989102.12,3.0,22,4,4,2,10,0xb2d6189ed
172120.83,2.0,1,3,3,4,10,0xb2d5fe70
3.17,1.0,49,1,2,2,5,0xb2d90f3c
1015.15,1.0,60,1,2,2,5,0xb2d97d3c
6593.34,1.0,92,2,2,1,5,0xb2d3081ad
332.87,1.0,9,1,2,3,6,0xb2d2d7d0d
14.49,2.0,0,1,3,4,8,0xb2d0680b
2317.42,1.0,10,1,2,3,6,0xb2d21303
358409.16,8.0,0,4,4,4,12,0xb2d17e9e
1214.92,1.0,1,1,2,4,7,0xb2d6a03c
205716.51,4.0,1,3,4,4,11,0xb2d451bc
2000000.0,3.0,0,4,4,4,12,0xb2d2b8f1d
27738.73,1.0,184,2,2,1,5,0xb2d30f22d
24596.65,1.0,92,2,2,1,5,0x3b9b25a2d
274002.76,5.0,0,3,4,4,11,0xb2d3be06
40005.41,2.0,49,2,3,2,7,0xb2d5957ad
700053.63,8.0,4,4,4,4,12,0xb2d660f5
106002.93,2.0,31,3,3,2,8,0xb2d3875fd
60020.99,2.0,228,3,3,1,7,0xb2d5d0db
18.32,1.0,0,1,2,4,7,0xb2d94dd8d
0.11,3.0,0,1,4,4,9,0xb2da568b
659848.48,9.0,0,4,4,4,12,0xb2d11f75d
1007105.02,2.0,64,4,3,2,9,0xb2d9b45b
100096.91,2.0,87,3,3,1,7,0xb2d16fbe
50005.69,3.0,11,2,4,3,9,0xb2d0f495d
659104.57,4.0,4,4,4,4,12,0xb2d3fe63d
464.72,2.0,222,1,3,1,5,0xb2d176fad
256966.32,4.0,3,3,4,4,11,0xb2d5fc4ad
16166.58,1.0,10,2,2,3,7,0xb2d23ec2
242006.49,5.0,0,3,4,4,11,0xb2d5264dd
117.34,1.0,71,1,2,1,4,0xb2d91c30d
180820.97,3.0,0,3,4,4,11,0xb2d3ef0ed
1283067.75,2.0,98,4,3,1,8,0xb2d9671fd
12874.28,1.0,10,2,2,3,7,0xb2d31df9d
220000.0,2.0,4,3,3,4,10,0xb2da6455
832989.91,2.0,235,4,3,1,8,0xb2d1f7a2d
0.49,1.0,1,1,2,4,7,0xb2d8cea3
50806.35,4.0,0,2,4,4,10,0xb2d51eaf
113522.23,2.0,18,3,3,2,8,0xb2d501b0d
400002.11,3.0,29,4,4,2,10,0xb2d9faa8
8688.92,1.0,10,2,2,3,7,0xb2d6a519d
500303.97,3.0,98,4,4,1,9,0xb2d8fc64
7.01,1.0,57,1,2,2,5,0xb2d68659
401487.1,3.0,22,4,4,2,10,0xb2d6c4ec
751.45,1.0,31,1,2,2,5,0xb2d2db12
163022.27,2.0,13,3,3,3,9,0xb2d23bc8
400025.1,2.0,12,4,3,3,10,0xb2d69f50
165239.55,1.0,14,3,2,3,8,0xb2d304d3d
1400051.71,1.0,11,4,2,3,9,0xb2d2c607d
3389.74,1.0,0,2,2,4,8,0xb2d579e7
632.74,1.0,0,1,2,4,7,0xb2d446d6d
1863.46,1.0,10,1,2,3,6,0xb2d5640f
7.3,1.0,20,1,2,2,5,0xb2d5bfa9d
72491.4,2.0,70,3,3,1,7,0xb2d645e7
233050.37,12.0,3,3,4,4,11,0xb2d3866d
1265261.18,9.0,0,4,4,4,12,0x3b9b46b1d
54204.74,2.0,136,3,3,1,7,0xb2d2e9fcd
3632.26,1.0,5,2,2,3,7,0xb2d42d13d
2859608.31,6.0,0,4,4,4,12,0xb2d42df7d
110155.21,5.0,31,3,4,2,9,0xb2d5efa6d
8162.07,1.0,13,2,2,3,7,0xb2da2fc0
89.74,1.0,66,1,2,2,5,0xb2d5707ed
290294.43,2.0,35,3,3,2,8,0xb2d22c82d
80008.48,2.0,27,3,3,2,8,0xb2d6c7bb
3674.91,1.0,0,2,2,4,8,0xb2d6f6b8
346869.86,1.0,32,4,2,2,8,0xb2d6033bd
851448.98,7.0,31,4,4,2,10,0xb2d42db7d
30000.32,2.0,14,2,3,3,8,0xb2da35f9
100028.28,2.0,33,3,3,2,8,0xb2d31089
20164.73,1.0,14,2,2,3,7,0xb2d787b5d
1125066.44,9.0,11,4,4,3,11,0xb2d09270d
221155.69,2.0,125,3,3,1,7,0xb2d5babd
100047.83,2.0,101,3,3,1,7,0xb2d38482d
884203.57,4.0,11,4,4,3,11,0xb2d0fb0c
101603.75,2.0,5,3,3,3,9,0xb2d34779d
300065.63,2.0,7,3,3,3,9,0xb2d91422d
400747.48,3.0,35,4,4,2,10,0xb2d4c7fad
210877.24,2.0,44,3,3,2,8,0xb2d26ff8
1426.49,1.0,92,1,2,1,4,0xb2d34d28
130362.69,4.0,5,3,4,3,10,0xb2d36637d
446.32,1.0,6,1,2,3,6,0xb2d91e65
40000.03,2.0,1,2,3,4,9,0xb2da6108
153409.3,3.0,10,3,4,3,10,0xb2d58b4bd
11068.66,1.0,92,2,2,1,5,0xb2d1d092
602363.98,7.0,5,4,4,3,11,0xb2d253b4
10825.31,1.0,10,2,2,3,7,0xb2d7825ad
100465.17,1.0,76,3,2,1,6,0xb2d78a55d
242189.67,6.0,21,3,4,2,9,0xb2d2730dd
10001.49,2.0,13,2,3,3,8,0xb2d90c52d
410202.94,4.0,2,4,4,4,12,0xb2d21abbd
934616.98,6.0,0,4,4,4,12,0xb2d41011d
453759.63,6.0,0,4,4,4,12,0xb2d5a29c
100024.12,3.0,69,3,4,1,8,0xb2d19eb0
615.45,1.0,0,1,2,4,7,0xb2d2105ed
350081.97,3.0,3,4,4,4,12,0xb2d62984
500022.17,3.0,27,4,4,2,10,0xb2da07bb
1567.26,1.0,10,1,2,3,6,0xb2d40e35
1676.38,1.0,87,1,2,1,4,0xb2d5d972
5730.64,1.0,10,2,2,3,7,0xb2d4f20c
639332.68,7.0,105,4,4,1,9,0x3b9b3ee6d
70002.96,2.0,70,3,3,1,7,0xb2d9a2d0
332090.17,2.0,10,4,3,3,10,0xb2d30ff5
300000.0,2.0,13,3,3,3,9,0xb2da402c
2855.34,1.0,10,1,2,3,6,0xb2d6ec5e
149.36,1.0,69,1,2,1,4,0xb2d2c286
200000.0,2.0,20,3,3,2,8,0xb2d952cd
607.32,1.0,0,1,2,4,7,0xb2d306f1d
153846.42,3.0,166,3,4,1,8,0xb2d5fae2
8303.93,1.0,10,2,2,3,7,0xb2d947f0
39138.18,1.0,0,2,2,4,8,0xb2d625c9d
400002.05,3.0,12,4,4,3,11,0xb2d1b6d6d
156398.18,3.0,74,3,4,1,8,0xb2d504fdd
7159.21,1.0,7,2,2,3,7,0xb2d1ac3e
155165.18,2.0,92,3,3,1,7,0xb2d45b04d
1008.08,2.0,92,1,3,1,5,0xb2d14703
350015.49,3.0,18,4,4,2,10,0xb2d406cf
33513.02,1.0,11,2,2,3,7,0xb2d9761e
3757.0,1.0,184,2,2,1,5,0xb2d3dc7d
1153.2,1.0,0,1,2,4,7,0xb2d3405c
1002672.45,2.0,37,4,3,2,9,0xb2d4eab7d
24.9,2.0,0,1,3,4,8,0x3b9b31bc
366.63,1.0,2,1,2,4,7,0xb2d977a8
26829.07,1.0,126,2,2,1,5,0xb2d48ffdd
60152.0,4.0,4,3,4,4,11,0xb2d680b9d
223.26,1.0,29,1,2,2,5,0xb2d39bfb
201462.66,5.0,12,3,4,3,10,0xb2d09f71
36958.62,1.0,0,2,2,4,8,0xb2d947d8d
50417.38,2.0,182,2,3,1,6,0xb2d691edd
34950.98,1.0,0,2,2,4,8,0xb2d42b42d
372628.94,2.0,70,4,3,1,8,0xb2d9a683
603942.79,6.0,0,4,4,4,12,0xb2d19f62
680039.13,4.0,1,4,4,4,12,0xb2d4a710d
200860.44,5.0,0,3,4,4,11,0xb2d06c14d
201793.22,5.0,14,3,4,3,10,0xb2d0a388
73004.8,6.0,74,3,4,1,8,0xb2d823b4d
519051.84,8.0,73,4,4,1,9,0xb2d4142cd
4298.16,1.0,15,2,2,3,7,0xb2d6a033
4530118.02,3.0,0,4,4,4,12,0xb2d40181d
70009.93,2.0,25,3,3,2,8,0xb2d5296dd
937.85,1.0,0,1,2,4,7,0xb2d58d23
500000.0,2.0,28,4,3,2,9,0xb2d9f3bb
345735.9,3.0,143,4,4,1,9,0xb2d1a0bdd
10854.75,1.0,184,2,2,1,5,0x3b9ae037
885.99,1.0,2,1,2,4,7,0xb2d30c52d
11226.24,1.0,10,2,2,3,7,0xb2d29fc1
8284.08,2.0,92,2,3,1,6,0x3b9b0f3d
500000.3,3.0,20,4,4,2,10,0xb2d69294d
116474.29,1.0,28,3,2,2,7,0xb2d8d9c0
20413.14,1.0,215,2,2,1,5,0xb2d3aa6ed
3450006.68,9.0,4,4,4,4,12,0xb2d8e74bd
251991.52,2.0,214,3,3,1,7,0xb2d6a170
91.69,1.0,145,1,2,1,4,0xb2d67e72d
213868.33,6.0,0,3,4,4,11,0xb2d0b3c4
1350.67,2.0,92,1,3,1,5,0xb2d0aa9cd
29.31,1.0,18,1,2,2,5,0xb2d22356d
123270.04,2.0,118,3,3,1,7,0xb2d3d217d
40225.09,2.0,122,2,3,1,6,0xb2d5bdc5d
61137.06,1.0,1,3,2,4,9,0xb2d3c0d1
263487.19,4.0,76,3,4,1,8,0xb2d08995
40001.24,4.0,11,2,4,3,9,0xb2d9efb0
203497.79,2.0,143,3,3,1,7,0xb2d60d97d
0.0,1.0,75,1,2,1,4,0xb2d396b4d
143350.02,2.0,245,3,3,1,7,0xb2d41554d
550093.47,2.0,4,4,3,4,11,0xb2d1fcd4d
5877.07,1.0,92,2,2,1,5,0xb2d42a09d
107068.83,2.0,3,3,3,4,10,0xb2d4cb9fd
450004.75,3.0,42,4,4,2,10,0xb2d96b2e
100021.21,2.0,224,3,3,1,7,0xb2d550f5d
642399.78,3.0,11,4,4,3,11,0xb2d35069d
1647.83,1.0,300,1,2,1,4,0xb2d185da
221122.86,6.0,0,3,4,4,11,0xb2d94d14
555978.74,6.0,0,4,4,4,12,0xb2d50f19d
7351.79,1.0,2,2,2,4,8,0xb2d36932
26793.58,1.0,0,2,2,4,8,0xb2d8e429
316073.02,1.0,0,4,2,4,10,0xb2d92541d
295171.44,3.0,3,3,4,4,11,0xb2d2faffd
271408.1,14.0,0,3,4,4,11,0x3b9b4700
964.68,1.0,8,1,2,3,6,0xb2d2c972
100003.13,3.0,245,3,4,1,8,0xb2d602b3
109795.65,2.0,31,3,3,2,8,0xb2d6d5e1
368.29,1.0,0,1,2,4,7,0xb2d6ed74
90726.66,1.0,82,3,2,1,6,0xb2d5a077
10000.88,2.0,54,2,3,2,7,0xb2d65df7
200098.24,5.0,10,3,4,3,10,0xb2d5be92
94.62,1.0,0,1,2,4,7,0xb2d6cbd5
8151.42,2.0,0,2,3,4,9,0xb2d1192e
404.62,1.0,52,1,2,2,5,0xb2d37c89
500018.12,4.0,27,4,4,2,10,0xb2d94790d
10431.96,1.0,194,2,2,1,5,0xb2d3bc2f
50038.14,2.0,142,2,3,1,6,0xb2d60f24d
517761.53,12.0,2,4,4,4,12,0xb2d6811f
2268.88,1.0,11,1,2,3,6,0xb2d6bd60d
870075.39,5.0,6,4,4,3,11,0xb2d443cdd
374952.52,7.0,0,4,4,4,12,0xb2d1c974d
46.26,1.0,17,1,2,2,5,0xb2d42052
426354.03,4.0,34,4,4,2,10,0xb2d122be
650043.65,7.0,70,4,4,1,9,0xb2d179c8
36913.47,1.0,92,2,2,1,5,0xb2d6c579
20366.36,1.0,9,2,2,3,7,0xb2d936a9
1151420.92,7.0,21,4,4,2,10,0xb2d07ba9d
208.94,1.0,9,1,2,3,6,0xb2d30c8cd
259332.7,3.0,130,3,4,1,8,0xb2d58cafd
53205.23,1.0,1,3,2,4,9,0xb2d7c383d
153003.77,2.0,95,3,3,1,7,0xb2d59a56d
15006.52,2.0,45,2,3,2,7,0xb2d4eca0d
51880.69,2.0,10,2,3,3,8,0xb2d5c735d
830027.22,14.0,6,4,4,3,11,0xb2d630f6
3004.71,1.0,10,2,2,3,7,0xb2d8dc1a
5178.09,1.0,9,2,2,3,7,0xb2d44959
70015.01,3.0,29,3,4,2,9,0xb2d08b8b
349.57,1.0,116,1,2,1,4,0xb2d07b66
719109.14,5.0,3,4,4,4,12,0xb2d5911e
400002.81,3.0,5,4,4,3,11,0xb2d8e982
4436.3,1.0,0,2,2,4,8,0xb2d586db
2244.19,1.0,3,1,2,4,7,0xb2d5d5af
30010.89,2.0,185,2,3,1,6,0xb2d55e5c
1100026.8,5.0,10,4,4,3,11,0xb2d1a0eed
107349.22,1.0,3,3,2,4,9,0xb2d0c1bad
1330207.55,18.0,0,4,4,4,12,0xb2d1be8b
2961.05,1.0,2,2,2,4,8,0xb2d200c1d
153030.3,3.0,111,3,4,1,8,0x3b9b3864d
2913.42,1.0,47,2,2,2,6,0xb2d8d2ced
18873.67,1.0,97,2,2,1,5,0xb2d6c4efd
50001.98,2.0,4,2,3,4,9,0xb2d1f8d9d
150100.28,1.0,0,3,2,4,9,0xb2d1e330d
473083.91,2.0,74,4,3,1,8,0xb2d25248d
50651.86,2.0,6,2,3,3,8,0xb2d44dc5d
11690.79,1.0,141,2,2,1,5,0xb2d37bfdd
1000032.14,2.0,94,4,3,1,8,0xb2d174af
2041.37,1.0,13,1,2,3,6,0xb2d6a1d2d
20000.64,3.0,192,2,4,1,7,0xb2d645a7d
36012189.32,37.0,0,4,4,4,12,0xb2d239a8
2028.96,1.0,21,1,2,2,5,0xb2d223aa
2.11,1.0,75,1,2,1,4,0xb2d655e9d
100031.23,2.0,60,3,3,2,8,0xb2d585cd
350009.12,3.0,117,4,4,1,9,0xb2d4e99d
290.27,1.0,5,1,2,3,6,0xb2d6556d
25107.34,1.0,10,2,2,3,7,0xb2d346f0d
79.0,1.0,17,1,2,2,5,0xb2d2de8f
2895.14,1.0,0,2,2,4,8,0xb2d6a9b4
240000.09,2.0,12,3,3,3,9,0xb2d66a43
1406.51,1.0,184,1,2,1,4,0xb2d28a9cd
1200000.0,1.0,0,4,2,4,10,0xb2d9606bd
15.24,1.0,22,1,2,2,5,0xb2d53504
1.18,1.0,13,1,2,3,6,0xb2da134f
4162.85,6.0,92,2,4,1,7,0xb2d089a4
88.04,1.0,2,1,2,4,7,0xb2d27c1ed
179067.47,2.0,89,3,3,1,7,0xb2d40f5bd
0.21,1.0,161,1,2,1,4,0xb2d5d0f6d
100000.0,2.0,7,3,3,3,9,0xb2da4f06
5040.19,1.0,5,2,2,3,7,0xb2d2206d
317.12,1.0,56,1,2,2,5,0xb2d8e46ed
24.37,1.0,11,1,2,3,6,0xb2d266fa
3499.51,1.0,4,2,2,4,8,0xb2d2d11b
7291.82,1.0,184,2,2,1,5,0xb2d29ad9d
175018.69,6.0,0,3,4,4,11,0xb2d5c979d
210000.0,2.0,1,3,3,4,10,0xb2d977a1d
3096634.01,11.0,0,4,4,4,12,0xb2d06bebd
30000.85,4.0,59,2,4,2,8,0xb2d859a2
81843.52,3.0,0,3,4,4,11,0xb2d605c4
5649.02,1.0,10,2,2,3,7,0xb2d8c66cd
806448.57,7.0,22,4,4,2,10,0x3b9b2873
16578.93,1.0,1,2,2,4,8,0xb2d2aaf6
119174.43,4.0,25,3,4,2,9,0xb2d56d0bd
300697.68,5.0,10,4,4,3,11,0xb2d24e3c
200761.95,2.0,23,3,3,2,8,0xb2d23e20
180019.81,3.0,18,3,4,2,9,0xb2d59eb0d
1429.4,1.0,60,1,2,2,5,0xb2d6b383d
493021.06,6.0,69,4,4,1,9,0xb2d5ee81
690.25,1.0,10,1,2,3,6,0xb2d214b4
100042.32,2.0,77,3,3,1,7,0xb2d5c566
630991.41,7.0,25,4,4,2,10,0xb2d3497fd
1174.49,1.0,92,1,2,1,4,0xb2d36898
1350639.26,5.0,0,4,4,4,12,0xb2d12581
200001.81,2.0,7,3,3,3,9,0xb2d8efced
476942.26,4.0,67,4,4,1,9,0xb2d253c3d
350012.56,3.0,31,4,4,2,10,0xb2d92d82d
496228.67,4.0,12,4,4,3,11,0xb2d60a2c
51029.82,2.0,0,2,3,4,9,0xb2d592c7
3205.68,1.0,10,2,2,3,7,0xb2d41074
88.86,1.0,35,1,2,2,5,0xb2d23635
1363.4,1.0,11,1,2,3,6,0xb2d3a009d
607195.1,4.0,0,4,4,4,12,0xb2d3b357
1010082.3,4.0,3,4,4,4,12,0xb2d3f47e
530032.08,4.0,14,4,4,3,11,0xb2d90dfd
396000.32,6.0,95,4,4,1,9,0xb2d1b870
8702.41,12.0,194,2,4,1,7,0xb2d1b021d
316006.96,6.0,80,4,4,1,9,0xb2d3fc54
100072.74,2.0,168,3,3,1,7,0xb2d2c4ad
490001.89,2.0,3,4,3,4,11,0xb2d386e3
50002.26,2.0,9,2,3,3,8,0xb2d56585d
260007.05,4.0,80,3,4,1,8,0xb2d127a2d
603153.98,6.0,57,4,4,2,10,0xb2d4ea1cd
108902.1,3.0,147,3,4,1,8,0xb2d1a125d
22.26,16.0,19,1,4,2,7,0xb2d93977
551004.23,3.0,19,4,4,2,10,0xb2d6fdb0
1194552.89,3.0,15,4,4,3,11,0xb2d7924fd
280000.0,2.0,0,3,3,4,10,0xb2d9847cd
8930.69,2.0,18,2,3,2,7,0xb2d80f23
40009.64,2.0,112,2,3,1,6,0xb2d5bb0e
15721.02,1.0,41,2,2,2,6,0xb2d08f6c
8.76,1.0,6,1,2,3,6,0xb2d92ecad
204299.85,2.0,231,3,3,1,7,0xb2d5df6d
203547.19,3.0,0,3,4,4,11,0xb2d102e4d
59197.12,1.0,5,3,2,3,8,0xb2d69370
72625.87,3.0,1,3,4,4,11,0xb2d776a4d
354057.13,4.0,1,4,4,4,12,0x3b9b1843
450165.04,5.0,11,4,4,3,11,0xb2d5c1cbd
600025.69,4.0,8,4,4,3,11,0xb2d4d036d
1.81,1.0,24,1,2,2,5,0xb2d290e4d
30000.63,2.0,139,2,3,1,6,0xb2d91239
1.55,1.0,3,1,2,4,7,0xb2d5fdf2d
2103.36,1.0,76,1,2,1,4,0xb2d68dde
750008.46,8.0,53,4,4,2,10,0xb2d21d3e
480001.34,4.0,3,4,4,4,12,0xb2d63cb2
82247.29,3.0,0,3,4,4,11,0xb2d621f3
53827.15,1.0,125,3,2,1,6,0xb2d1d8c0
3200283.91,2.0,200,4,3,1,8,0xb2d48078d
0.0,1.0,1,1,2,4,7,0xb2d6559e
9571.51,1.0,5,2,2,3,7,0xb2d6c672d
950349.89,1.0,0,4,2,4,10,0xb2d63b3fd
2923.52,1.0,273,2,2,1,5,0xb2d634bdd
700000.0,2.0,4,4,3,4,11,0xb2da614c
70086.31,1.0,8,3,2,3,8,0xb2d6a98cd
2172.81,2.0,92,1,3,1,5,0xb2d0cc29d
16240.82,1.0,179,2,2,1,5,0xb2d1d6a9
807247.35,6.0,32,4,4,2,10,0xb2d1529ed
33553.49,1.0,0,2,2,4,8,0xb2d21334d
20001.81,2.0,104,2,3,1,6,0xb2d2ace6d
250000.0,2.0,6,3,3,3,9,0xb2da51a8
1.1,1.0,13,1,2,3,6,0xb2d282b8
11050.02,1.0,28,2,2,2,6,0xb2d678ddd
201418.99,2.0,2,3,3,4,10,0xb2d9c125
7.09,1.0,84,1,2,1,4,0xb2d57b84
414110.97,7.0,0,4,4,4,12,0xb2d61864d
160007.49,3.0,56,3,4,2,9,0xb2d92ef6d
101816.84,3.0,0,3,4,4,11,0xb2d62117
73321.33,6.0,1,3,4,4,11,0xb2d41834d
1035.27,1.0,92,1,2,1,4,0xb2d1da81d
3.49,1.0,32,1,2,2,5,0xb2d209d1
120037.26,3.0,184,3,4,1,8,0xb2d3ce7f
383.9,2.0,191,1,3,1,5,0xb2d0db35
500012.07,2.0,0,4,3,4,11,0xb2d21668
220078.36,2.0,60,3,3,2,8,0xb2d6b76d
293810.84,1.0,4,3,2,4,9,0xb2d422ef
204266.41,2.0,203,3,3,1,7,0xb2d5b189d
587812.7,5.0,70,4,4,1,9,0xb2d0ebb1d
1373.19,1.0,136,1,2,1,4,0xb2d62d77d
60022.41,4.0,13,3,4,3,10,0xb2d62216
502017.04,6.0,1,4,4,4,12,0xb2d56325d
281607.69,2.0,48,3,3,2,8,0xb2d44625
194107.13,5.0,8,3,4,3,10,0xb2d41392d
1662.62,1.0,125,1,2,1,4,0xb2d483a8
1285533.51,13.0,9,4,4,3,11,0xb2d09452
813.72,1.0,89,1,2,1,4,0xb2d793cf
11155.44,1.0,13,2,2,3,7,0xb2d90540
348.37,1.0,0,1,2,4,7,0xb2d8de7bd
29642.73,1.0,4,2,2,4,8,0xb2d6ba99d
8649.22,1.0,2,2,2,4,8,0xb2d24df5d
1550024.32,6.0,24,4,4,2,10,0xb2d1c41fd
51067.89,2.0,4,2,3,4,9,0xb2d618c6d
0.0,1.0,1,1,2,4,7,0xb2d988f4
300184.26,3.0,12,4,4,3,11,0xb2d9eb88
31.95,1.0,2,1,2,4,7,0xb2d25508
363373.2,1.0,4,4,2,4,10,0xb2d3ca8a
376563.98,3.0,20,4,4,2,10,0xb2d416cfd
113.28,1.0,50,1,2,2,5,0xb2d25b89d
500008.88,2.0,15,4,3,3,10,0xb2d6c7ae
100002.33,3.0,18,3,4,2,9,0xb2d8f82cd
50001.06,2.0,38,2,3,2,7,0xb2d928b4
464.71,1.0,24,1,2,2,5,0xb2d8cfc8d
6.33,1.0,47,1,2,2,5,0xb2d90d92
47083.42,1.0,3,2,2,4,8,0xb2d5cef5
684174.72,5.0,28,4,4,2,10,0xb2d62698d
1112.34,1.0,56,1,2,2,5,0xb2d0ff9f
108987.61,2.0,11,3,3,3,9,0xb2da302d
211009.31,4.0,41,3,4,2,9,0xb2d1ebffd
1101515.59,4.0,80,4,4,1,9,0xb2d117fcd
5015735.13,12.0,0,4,4,4,12,0xb2d5578dd
32984.91,1.0,1,2,2,4,8,0xb2d3471f
100003.17,2.0,92,3,3,1,7,0xb2d64408
417920.19,3.0,57,4,4,2,10,0xb2d4773e
0.74,2.0,7,1,3,3,7,0xb2d1fe33
200040.85,2.0,17,3,3,2,8,0xb2d1a8b1
9.1,1.0,0,1,2,4,7,0xb2d386ac
7.48,1.0,21,1,2,2,5,0xb2d2d80f
4816.96,1.0,10,2,2,3,7,0xb2d6a91cd
4047.27,1.0,10,2,2,3,7,0xb2d9b30e
66000.7,4.0,6,3,4,3,10,0xb2d10735
1210000.0,15.0,1,4,4,4,12,0xb2d419c2
322003.32,5.0,27,4,4,2,10,0xb2d32441
100478.94,2.0,4,3,3,4,10,0xb2d51411d
236287.85,3.0,0,3,4,4,11,0xb2d141d8
82955.58,2.0,4,3,3,4,10,0xb2d43717d
212230.38,3.0,1,3,4,4,11,0x3b9b2558
401483.97,2.0,32,4,3,2,9,0xb2d93798
28620.2,1.0,0,2,2,4,8,0xb2d5710e
307655.37,2.0,20,4,3,2,9,0xb2d3afddd
10010.12,2.0,73,2,3,1,6,0xb2d8e32e
31066.6,1.0,7,2,2,3,7,0xb2d60be7d
50911.66,2.0,66,2,3,2,7,0xb2d65a81d
3.04,1.0,29,1,2,2,5,0xb2d64601d
12500.06,1.0,0,2,2,4,8,0xb2d96515
30000.63,2.0,25,2,3,2,7,0xb2da12b6
100217.84,2.0,60,3,3,2,8,0xb2d4685ed
541089.94,5.0,63,4,4,2,10,0xb2d0723d
3434000.99,24.0,0,4,4,4,12,0xb2d4f122d
5429.26,1.0,92,2,2,1,5,0xb2d3ab42d
1232034.19,9.0,6,4,4,3,11,0xb2d23fe4d
0.0,1.0,1,1,2,4,7,0xb2d3e8da
35003.28,2.0,19,2,3,2,7,0xb2d53367d
44404.58,2.0,163,2,3,1,6,0xb2d63b11
362.91,1.0,5,1,2,3,6,0xb2d52e21
688215.27,2.0,105,4,3,1,8,0xb2d06d50d
10263.6,1.0,2,2,2,4,8,0xb2d6cf06d
178.45,1.0,1,1,2,4,7,0xb2d55c2f
9878.59,1.0,4,2,2,4,8,0xb2d4d324d
25282.14,1.0,14,2,2,3,7,0xb2d30826
1805.28,2.0,217,1,3,1,5,0xb2d517edd
3615.81,1.0,18,2,2,2,6,0xb2d5d598
3153.23,1.0,32,2,2,2,6,0xb2d9a413
2040009.89,18.0,0,4,4,4,12,0xb2d37fead
36228.71,1.0,4,2,2,4,8,0xb2d1b2b6d
262095.8,2.0,129,3,3,1,7,0xb2d5c202d
295691.39,4.0,28,3,4,2,9,0xb2d6babf
936621.76,5.0,16,4,4,2,10,0xb2d2b9e6
8.77,1.0,53,1,2,2,5,0xb2d25c18
200005.29,3.0,175,3,4,1,8,0xb2d8cc52d
12262.73,2.0,209,2,3,1,6,0xb2d16e55d
273412.56,4.0,53,3,4,2,9,0xb2d14ca2
4.84,1.0,48,1,2,2,5,0xb2d3139c
150502.14,3.0,27,3,4,2,9,0xb2d595fcd
226258.35,2.0,34,3,3,2,8,0xb2d651d3d
83.6,1.0,36,1,2,2,5,0xb2d5925a
5118.82,1.0,92,2,2,1,5,0xb2d1790ed
400000.0,2.0,18,4,3,2,9,0xb2d9b70d
631099.15,6.0,0,4,4,4,12,0xb2d12f16d
46614.14,1.0,47,2,2,2,6,0xb2d3a36e
496309.42,7.0,1,4,4,4,12,0xb2d61c0a
100008.55,3.0,21,3,4,2,9,0xb2d2ad90
36130.05,1.0,1,2,2,4,8,0xb2d68ea8
50002.37,2.0,3,2,3,4,9,0xb2d3ad9f
983.09,1.0,74,1,2,1,4,0xb2d38890d
200837.24,2.0,0,3,3,4,10,0xb2d60f63d
213.62,1.0,0,1,2,4,7,0xb2d69e93d
392605.65,6.0,67,4,4,1,9,0xb2d0abf2d
323095.7,4.0,0,4,4,4,12,0xb2d54883d
220399.85,4.0,5,3,4,3,10,0xb2d0677dd
3.71,1.0,2,1,2,4,7,0xb2d31e8b
500006.28,2.0,28,4,3,2,9,0xb2da0895
3261.47,1.0,16,2,2,2,6,0xb2d912d7
2265.93,1.0,25,1,2,2,5,0xb2d16a2d
500008.8,8.0,31,4,4,2,10,0xb2d3e9c7d
11.09,1.0,11,1,2,3,6,0xb2d17831
9157.88,1.0,92,2,2,1,5,0xb2d3ee2fd
1025.74,1.0,9,1,2,3,6,0xb2d5c011
216139.0,3.0,9,3,4,3,10,0xb2d0f450
2979018.43,6.0,76,4,4,1,9,0x3b9b3a88
130065.45,4.0,39,3,4,2,9,0xb2d5a116
151061.46,3.0,4,3,4,4,11,0xb2d57a3e
470034.62,4.0,153,4,4,1,9,0xb2d12b9ad
218076.4,2.0,14,3,3,3,9,0xb2d6c8d6d
400002.87,1.0,0,4,2,4,10,0xb2d3942b
6.33,1.0,12,1,2,3,6,0xb2d31fec
205.7,1.0,10,1,2,3,6,0xb2d2ee85d
1302.83,1.0,92,1,2,1,4,0xb2d395fd
500000.0,2.0,27,4,3,2,9,0xb2d90317
20847.93,1.0,35,2,2,2,6,0xb2d6053bd
101.75,1.0,13,1,2,3,6,0xb2d6c059d
178003.76,2.0,46,3,3,2,8,0xb2d9de9c
80010.7,3.0,21,3,4,2,9,0xb2d6a7c7d
3002.24,1.0,0,2,2,4,8,0xb2d6b5c3
202773.97,2.0,10,3,3,3,9,0xb2d61971
3342.82,1.0,9,2,2,3,7,0xb2d3726bd
3497.1,1.0,0,2,2,4,8,0xb2d7c093d
70.75,1.0,21,1,2,2,5,0xb2d94d41d
10001.03,2.0,20,2,3,2,7,0xb2d62749d
320003.41,4.0,11,4,4,3,11,0xb2d5ef8ad
109.33,1.0,10,1,2,3,6,0xb2d1c252
536.63,1.0,0,1,2,4,7,0xb2d7f2b1
523519.75,2.0,116,4,3,1,8,0xb2d5fe1b
19.56,1.0,81,1,2,1,4,0xb2d4d051d
1016.18,1.0,184,1,2,1,4,0xb2d10ca6d
4.43,1.0,26,1,2,2,5,0xb2d9df69
5061.64,1.0,184,2,2,1,5,0xb2d2be6cd
388832.69,3.0,129,4,4,1,9,0xb2d1af5bd
1200200.14,1.0,0,4,2,4,10,0xb2d6f718
200010.1,3.0,14,3,4,3,10,0xb2d0c7e7
30.36,1.0,83,1,2,1,4,0xb2d780aa
2536.95,1.0,92,1,2,1,4,0xb2d46045d
1442.98,1.0,139,1,2,1,4,0xb2d09283d
180000.25,2.0,1,3,3,4,10,0xb2d6acdc
10287.69,2.0,70,2,3,1,6,0xb2d65e8f
700000.0,5.0,7,4,4,3,11,0xb2d30d85
8953.05,1.0,184,2,2,1,5,0x3b9b26b9
5.38,1.0,63,1,2,2,5,0xb2d366a3d
80010.46,2.0,1,3,3,4,10,0xb2d59b52
78626.84,4.0,2,3,4,4,11,0x3b9b18d9
150106.59,3.0,116,3,4,1,8,0xb2d206f2d
343.36,1.0,9,1,2,3,6,0xb2d61731
1605.16,1.0,4,1,2,4,7,0xb2d75bf5
46046.6,4.0,32,2,4,2,8,0xb2d1c503
93003.09,1.0,0,3,2,4,9,0xb2d4f348d
545477.11,1.0,82,4,2,1,7,0xb2d55bda
323855.07,4.0,18,4,4,2,10,0xb2d26d2cd
19000000.0,6.0,7,4,4,3,11,0xb2d673ca
206042.21,1.0,3,3,2,4,9,0xb2d5f02a
5.59,1.0,62,1,2,2,5,0xb2d125d5
40.61,1.0,62,1,2,2,5,0xb2d982d2
15050.92,1.0,4,2,2,4,8,0xb2d1aa8fd
160003.38,2.0,73,3,3,1,7,0xb2d8e0fc
65.52,1.0,70,1,2,1,4,0xb2d138bad
1221.17,40.0,59,1,4,2,7,0xb2d25ed4
60034.65,3.0,2,3,4,4,11,0xb2d87e7c
19.63,1.0,12,1,2,3,6,0xb2da3a47
20210.75,2.0,80,2,3,1,6,0xb2d3e44e
31320.93,1.0,46,2,2,2,6,0xb2d16302
206785.73,1.0,9,3,2,3,8,0xb2d703ce
51305.56,2.0,3,2,3,4,9,0xb2d5cfb7d
50704.57,1.0,103,2,2,1,5,0xb2d587fdd
1032.08,2.0,92,1,3,1,5,0xb2d2738c
5927.85,1.0,0,2,2,4,8,0xb2d599d4d
210462.79,6.0,76,3,4,1,8,0xb2d6610ad
3065.6,1.0,9,2,2,3,7,0xb2d45ba7
101114.57,2.0,5,3,3,3,9,0xb2d3a8b1d
0.46,1.0,6,1,2,3,6,0xb2d24335
1.82,1.0,2,1,2,4,7,0xb2d10763
5041.59,1.0,92,2,2,1,5,0xb2d2f1a7
9539.71,1.0,92,2,2,1,5,0xb2d1f56e
1051.64,1.0,92,1,2,1,4,0xb2d137dc
1587.19,1.0,0,1,2,4,7,0xb2d5d3c2
150004.75,2.0,94,3,3,1,7,0xb2d86d9e
546.0,1.0,0,1,2,4,7,0xb2d6e390
700000.0,3.0,6,4,4,3,11,0xb2d96ec3d
80.28,4.0,8,1,4,3,8,0x3b9b2869
30000.32,3.0,39,2,4,2,8,0xb2d9e080
5010.09,1.0,200,2,2,1,5,0xb2d698a6d
31222.01,3.0,145,2,4,1,7,0xb2d285dcd
1625.03,1.0,116,1,2,1,4,0xb2d2f825d
915261.33,3.0,25,4,4,2,10,0xb2d7573ed
41052.48,1.0,5,2,2,3,7,0xb2d63901d
878.73,1.0,11,1,2,3,6,0xb2d2fb3dd
123459.65,1.0,0,3,2,4,9,0xb2d14f69
9592.13,1.0,180,2,2,1,5,0xb2d141fa
255006.78,3.0,60,3,4,2,9,0xb2d5bd11d
130007.07,4.0,42,3,4,2,9,0xb2d9ac35
256789.14,2.0,35,3,3,2,8,0xb2d6e29dd
20069.98,2.0,90,2,3,1,6,0xb2d60c4cd
55012.73,2.0,67,3,3,1,7,0xb2d56ba2d
60100.03,2.0,143,3,3,1,7,0xb2d294c5
7771.77,1.0,0,2,2,4,8,0xb2d5ec60
90478.79,1.0,21,3,2,2,7,0xb2d3717bd
1067.57,1.0,95,1,2,1,4,0xb2d62aad
0.0,1.0,8,1,2,3,6,0xb2d2f8e9
0.09,1.0,15,1,2,3,6,0xb2d2e30ed
600000.0,2.0,24,4,3,2,9,0xb2d94ec0
200000.0,2.0,18,3,3,2,8,0xb2da35ce
250000.02,2.0,13,3,3,3,9,0xb2d9e832
204532.32,5.0,30,3,4,2,9,0x3b9adb82
500066.74,3.0,10,4,4,3,11,0xb2d55f86d
408631.78,2.0,182,4,3,1,8,0xb2d85702d
600027.4,3.0,9,4,4,3,11,0xb2d6fd6dd
157178.47,4.0,7,3,4,3,10,0xb2d0c139
231042.88,2.0,11,3,3,3,9,0xb2d6269d
304268.27,2.0,143,4,3,1,8,0xb2d5b73dd
45.38,2.0,55,1,3,2,6,0xb2d1697e
309753.4,4.0,30,4,4,2,10,0xb2d32491
2060.46,1.0,1,1,2,4,7,0xb2d5e463
200023.41,2.0,9,3,3,3,9,0xb2d6a15f
779672.86,13.0,0,4,4,4,12,0xb2d35319
430369.6,3.0,13,4,4,3,11,0xb2d6453b
300000.0,2.0,1,3,3,4,10,0xb2da3171
217718.6,4.0,0,3,4,4,11,0xb2d2c4afd
86.88,1.0,1,1,2,4,7,0xb2d51f25d
5199.55,1.0,147,2,2,1,5,0xb2d2d058d
22628.8,1.0,8,2,2,3,7,0xb2d6f22ad
20024.41,2.0,125,2,3,1,6,0xb2d59886d
0.0,1.0,31,1,2,2,5,0xb2d53dab
181.96,2.0,20,1,3,2,6,0xb2d9692fd
140066.47,3.0,80,3,4,1,8,0xb2d245aed
182454.82,2.0,6,3,3,3,9,0x3b9b4809
6039.89,1.0,0,2,2,4,8,0xb2d8c36ad
164271.01,3.0,3,3,4,4,11,0xb2d55e2d
477760.94,3.0,127,4,4,1,9,0xb2d5795cd
89.72,1.0,60,1,2,2,5,0xb2d9c12e
19404.64,1.0,10,2,2,3,7,0xb2d3ff87d
170067.95,9.0,4,3,4,4,11,0xb2d7900b
50526.34,1.0,11,2,2,3,7,0xb2d953a8
103083.44,2.0,11,3,3,3,9,0xb2d369c4
127947.03,3.0,3,3,4,4,11,0xb2d4f5db
210044.13,3.0,24,3,4,2,9,0xb2d4f5a7d
4226.35,1.0,10,2,2,3,7,0xb2d40d9d
6800.26,1.0,2,2,2,4,8,0xb2d50be2
2230.07,1.0,12,1,2,3,6,0xb2d54fd4
1634.95,1.0,0,1,2,4,7,0xb2d8d858
14394.32,1.0,92,2,2,1,5,0xb2d16686d
393460.87,5.0,0,4,4,4,12,0xb2d07851d
2550.16,1.0,92,1,2,1,4,0xb2d30ee7d
2019.79,1.0,9,1,2,3,6,0xb2d3c695d
2357.27,1.0,184,1,2,1,4,0xb2d1fa56d
18.14,1.0,84,1,2,1,4,0xb2d220aed
187.91,1.0,6,1,2,3,6,0xb2d3290f
26180.04,1.0,0,2,2,4,8,0xb2d68c72
875124.86,8.0,36,4,4,2,10,0xb2d4c8d5d
350006.84,2.0,7,4,3,3,10,0xb2d9ab3c
9185.76,1.0,184,2,2,1,5,0xb2d180c3d
106176.64,4.0,47,3,4,2,9,0xb2d6062fd
6690.35,2.0,92,2,3,1,6,0xb2d17c65d
413705.36,3.0,21,4,4,2,10,0x3b9b42dd
0.0,1.0,1,1,2,4,7,0xb2d91d6fd
2668.96,1.0,0,1,2,4,7,0xb2d80227d
299.46,1.0,43,1,2,2,5,0xb2d697aa
1228083.68,4.0,53,4,4,2,10,0x3b9b3ebed
91630.55,1.0,0,3,2,4,9,0xb2d14934
1891.44,1.0,92,1,2,1,4,0xb2d51995
1206.26,1.0,6,1,2,3,6,0xb2d417ea
4689.56,1.0,12,2,2,3,7,0xb2d2931c
1011.12,1.0,92,1,2,1,4,0xb2d4211cd
4.07,1.0,22,1,2,2,5,0xb2d36a63
2150000.38,5.0,5,4,4,3,11,0xb2d0c851d
20413.74,3.0,27,2,4,2,8,0xb2d5ea91d
183339.33,2.0,80,3,3,1,7,0xb2d68665d
211505.21,3.0,118,3,4,1,8,0xb2d437fb
6343.47,1.0,10,2,2,3,7,0xb2d646ffd
500000.0,3.0,7,4,4,3,11,0xb2d78807
500067.0,1.0,1,4,2,4,10,0xb2d981e8d
34.05,2.0,98,1,3,1,5,0x3b9b2facd
31.49,1.0,10,1,2,3,6,0xb2d94c0b
100001.88,3.0,74,3,4,1,8,0xb2d5908f
200000.0,2.0,26,3,3,2,8,0xb2d9477f
131876.7,78.0,0,3,4,4,11,0x3b9b3f4fd
73169.98,1.0,10,3,2,3,8,0xb2d3b354
81096.08,3.0,41,3,4,2,9,0xb2d624ea
203554.83,2.0,114,3,3,1,7,0xb2d8d18b
421441.06,4.0,49,4,4,2,10,0xb2d654d9
108003.89,7.0,8,3,4,3,10,0xb2d61698d
856000.0,11.0,3,4,4,4,12,0xb2d90de3d
307.01,1.0,23,1,2,2,5,0xb2d3c15ad
500076.27,2.0,10,4,3,3,10,0xb2d9a498
1950.99,5.0,0,1,4,4,9,0xb2d0672fd
1010.6,1.0,2,1,2,4,7,0xb2d94987
200052.3,2.0,10,3,3,3,9,0xb2d6c6d2
143370.35,3.0,116,3,4,1,8,0xb2d538fdd
486247.66,3.0,39,4,4,2,10,0xb2d55c22
20101.06,2.0,0,2,3,4,9,0xb2d60a0ed
10189.51,1.0,188,2,2,1,5,0xb2d5e941
400043.88,8.0,36,4,4,2,10,0xb2d605f7
530406.81,3.0,0,4,4,4,12,0xb2d0fb63d
2706.55,1.0,92,1,2,1,4,0xb2d25612d
55001.16,2.0,259,3,3,1,7,0xb2d5b0c4
50001.06,2.0,18,2,3,2,7,0xb2d95473
1100051.14,5.0,9,4,4,3,11,0xb2d65d58
148.1,1.0,8,1,2,3,6,0xb2d329a9
53.97,1.0,1,1,2,4,7,0xb2d2e2f1
306084.25,2.0,29,4,3,2,9,0xb2d3e261d
50001.58,2.0,38,2,3,2,7,0xb2d9252dd
3149.01,1.0,9,2,2,3,7,0xb2d65bd0
964510.16,18.0,8,4,4,3,11,0xb2d19f4f
60116.67,1.0,99,3,2,1,6,0xb2d6287ad
3946.96,1.0,1,2,2,4,8,0xb2d6c07f
598000.55,4.0,9,4,4,3,11,0xb2d11396
5003.06,1.0,67,2,2,1,5,0xb2d8f1a6d
500011.07,3.0,18,4,4,2,10,0xb2d8d867
1717.67,1.0,22,1,2,2,5,0xb2d215a9
163.46,1.0,22,1,2,2,5,0xb2d6d3ee
300000.0,2.0,9,3,3,3,9,0xb2d8e80bd
34739.5,1.0,0,2,2,4,8,0xb2d28b1ed
12416.12,1.0,4,2,2,4,8,0xb2d424d4d
5211.02,1.0,9,2,2,3,7,0xb2da0d53
42.35,1.0,64,1,2,2,5,0xb2d5d2e3
907.43,1.0,8,1,2,3,6,0xb2d21ee8
2035.63,1.0,2,1,2,4,7,0xb2d6b6ae
1348912.4,7.0,4,4,4,4,12,0xb2d30780d
1.29,1.0,13,1,2,3,6,0xb2d2ce67d
1170.17,1.0,14,1,2,3,6,0xb2d36b2ad
1486.67,1.0,188,1,2,1,4,0xb2d26612d
922.52,2.0,0,1,3,4,8,0xb2d0e04e
3677.5,1.0,34,2,2,2,6,0xb2d23c43
1249.47,2.0,184,1,3,1,5,0xb2d0ef90d
812000.0,9.0,1,4,4,4,12,0xb2d159b0d
340029.33,6.0,27,4,4,2,10,0xb2d5bc4b
32074.08,1.0,20,2,2,2,6,0xb2d1a737
9.26,1.0,82,1,2,1,4,0xb2d42c3fd
960339.56,4.0,0,4,4,4,12,0xb2d16a92d
2247.98,1.0,10,1,2,3,6,0xb2d8db6f
400090.53,4.0,2,4,4,4,12,0xb2d1ee87
2.7,1.0,32,1,2,2,5,0xb2d68469
2410000.57,13.0,7,4,4,3,11,0xb2d5965b
9262.95,1.0,17,2,2,2,6,0xb2d535a1d
202998.69,2.0,126,3,3,1,7,0xb2d615a1
683.4,1.0,3,1,2,4,7,0xb2d2595e
102.31,1.0,2,1,2,4,7,0xb2d642e1
1093.71,1.0,184,1,2,1,4,0xb2d339bbd
34.72,1.0,7,1,2,3,6,0xb2d2da10d
1029.79,1.0,184,1,2,1,4,0xb2d403eed
66005.21,2.0,47,3,3,2,8,0xb2d635f3d
101.63,1.0,26,1,2,2,5,0xb2d59e4e
3703.21,1.0,14,2,2,3,7,0xb2d802e6d
4261.62,1.0,11,2,2,3,7,0xb2d3f731d
103887.99,1.0,3,3,2,4,9,0xb2d41139
88264.55,3.0,159,3,4,1,8,0xb2d5a27bd
15736.71,1.0,2,2,2,4,8,0xb2d0c84ed
679.97,1.0,0,1,2,4,7,0xb2d3eb38
39.97,1.0,11,1,2,3,6,0xb2d93628
13.3,1.0,54,1,2,2,5,0xb2d8fa04d
197037.69,7.0,20,3,4,2,9,0x3b9b305d
200030.87,2.0,12,3,3,3,9,0xb2d591a1d
1957400.95,6.0,8,4,4,3,11,0xb2d3a334d
791036.37,4.0,0,4,4,4,12,0xb2d3cb97d
1177.86,1.0,92,1,2,1,4,0xb2d2e0b0
300045.37,3.0,60,3,4,2,9,0xb2d5ab45d
68.3,2.0,64,1,3,2,6,0xb2d7ae6b
200040.88,4.0,6,3,4,3,10,0xb2d681e6
50666.04,1.0,1,2,2,4,8,0xb2d8c4ea
20001.56,2.0,40,2,3,2,7,0xb2d91370
18801.09,1.0,0,2,2,4,8,0xb2d54ec0d
458.92,2.0,0,1,3,4,8,0x3b9af23b
900116.55,6.0,11,4,4,3,11,0xb2d12df7d
2000026.05,2.0,9,4,3,3,10,0xb2d68ffd
50000.0,2.0,4,2,3,4,9,0xb2d9fd66
6459.54,1.0,92,2,2,1,5,0xb2d33f22d
731052.58,3.0,25,4,4,2,10,0xb2da0126
74.49,1.0,77,1,2,1,4,0xb2d8ce26
300006.33,2.0,21,3,3,2,8,0xb2d94fe3
330.74,4.0,0,1,4,4,9,0x3b9b3d1c
6764.1,1.0,20,2,2,2,6,0xb2d88176
141.73,1.0,0,1,2,4,7,0xb2d3f92c
35557.42,2.0,48,2,3,2,7,0xb2d5ccd1d
600000.0,3.0,5,4,4,3,11,0xb2d9a571
17439.13,1.0,0,2,2,4,8,0xb2d34159
200008.0,4.0,0,3,4,4,11,0xb2d5e47a
50005.35,2.0,108,2,3,1,6,0xb2d3f2c9d
56117.94,1.0,35,3,2,2,7,0xb2d2a1f1d
11122.46,1.0,3,2,2,4,8,0xb2d2e60d
12499.74,1.0,8,2,2,3,7,0xb2d95e89d
7993.33,1.0,6,2,2,3,7,0xb2d94858
27356.2,1.0,90,2,2,1,5,0xb2d4ead9d
203825.69,2.0,31,3,3,2,8,0xb2d62b4cd
53066.92,4.0,3,3,4,4,11,0xb2d5b7b1
1346006.96,11.0,8,4,4,3,11,0xb2d682fad
50002.95,2.0,14,2,3,3,8,0xb2d20098
660003.52,3.0,11,4,4,3,11,0xb2d65c41
5226.55,1.0,1,2,2,4,8,0xb2d6b1e6d
13649.78,1.0,4,2,2,4,8,0xb2d0d838
165.27,1.0,5,1,2,3,6,0xb2d3372a
58312.76,5.0,184,3,4,1,8,0xb2d1a6bad
70001.48,2.0,8,3,3,3,9,0xb2da485d
71273.31,2.0,2,3,3,4,10,0xb2d5aea9
440013.65,2.0,94,4,3,1,8,0xb2d88c18
126052.01,2.0,25,3,3,2,8,0xb2d5c47ad
0.0,1.0,2,1,2,4,7,0xb2d77fd5
10137.61,1.0,92,2,2,1,5,0xb2d5e55fd
0.37,1.0,267,1,2,1,4,0xb2d393a3d
192757.88,5.0,25,3,4,2,9,0xb2d3b356
83444.3,1.0,10,3,2,3,8,0xb2d8e02f
434015.99,4.0,3,4,4,4,12,0xb2d3a550
2247.94,1.0,184,1,2,1,4,0xb2d0cfb0d
3223.02,1.0,13,2,2,3,7,0xb2d1f48c
15776.31,1.0,0,2,2,4,8,0xb2d2984d
39.54,1.0,11,1,2,3,6,0xb2d8379e
201.16,1.0,42,1,2,2,5,0xb2d62557d
10200.83,2.0,0,2,3,4,9,0xb2d4eb83
26378.24,1.0,43,2,2,2,6,0xb2d2b4ded
6823322.81,3.0,14,4,4,3,11,0xb2d11d79d
2581.43,1.0,0,1,2,4,7,0xb2d9b2cd
460.82,1.0,7,1,2,3,6,0xb2d496e0d
113035.0,2.0,7,3,3,3,9,0xb2d249bcd
30001.79,4.0,18,2,4,2,8,0xb2d65744d
15163.24,2.0,209,2,3,1,6,0xb2d57cdad
60734.38,2.0,49,3,3,2,8,0xb2d1a5ac
101310.63,2.0,39,3,3,2,8,0xb2d59b17
87.08,1.0,46,1,2,2,5,0xb2d90b02
87.7,1.0,5,1,2,3,6,0xb2d3e833
1096.4,1.0,0,1,2,4,7,0xb2d5d5c9d
4811878.46,4.0,3,4,4,4,12,0xb2d534a8d
5805.9,2.0,184,2,3,1,6,0xb2d08ef3
43327.3,4.0,1,2,4,4,10,0xb2d2112dd
308070.3,4.0,41,4,4,2,10,0xb2d1372b
10000.11,1.0,10,2,2,3,7,0xb2d96ac6
712144.76,1.0,0,4,2,4,10,0xb2d6d949d
233002.46,2.0,92,3,3,1,7,0xb2d646f0
400148.11,2.0,35,4,3,2,9,0xb2d63524d
14323.9,1.0,184,2,2,1,5,0xb2d1e84fd
180783.04,1.0,0,3,2,4,9,0xb2d135a8d
474.45,1.0,92,1,2,1,4,0xb2d29fa7
28.07,1.0,39,1,2,2,5,0xb2d9a5da
5.59,1.0,1,1,2,4,7,0xb2d35819
1800.18,1.0,20,1,2,2,5,0xb2d6b5c3d
837150.04,7.0,4,4,4,4,12,0xb2d0735cd
127243.1,2.0,133,3,3,1,7,0xb2d2528bd
211591.21,3.0,10,3,4,3,10,0xb2d7bf57d
150004.75,2.0,38,3,3,2,8,0xb2d92585d
337003.29,4.0,60,4,4,2,10,0xb2d410cd
50010.03,2.0,19,2,3,2,7,0xb2d77277
13385.15,2.0,1,2,3,4,9,0xb2d4a334d
1932685.27,8.0,0,4,4,4,12,0xb2d1298fd
130008.89,4.0,20,3,4,2,9,0xb2d54f17
212549.29,2.0,52,3,3,2,8,0xb2d6cfc9
0.0,3.0,1,1,4,4,9,0xb2d94847
231.91,1.0,13,1,2,3,6,0xb2d9df0b
203554.57,2.0,107,3,3,1,7,0xb2d8df6ed
8554.78,1.0,0,2,2,4,8,0xb2d6ac98
10.56,1.0,64,1,2,2,5,0xb2d57dac
300009.83,3.0,10,3,4,3,10,0xb2d5137ad
277604.79,4.0,10,3,4,3,10,0xb2d528e6d
18918.49,2.0,7,2,3,3,8,0xb2d0a54fd
103020.36,1.0,0,3,2,4,9,0xb2d0e723d
61040.56,1.0,0,3,2,4,9,0xb2d41b3a
70003.21,2.0,89,3,3,1,7,0xb2d17a87
52770.4,5.0,28,3,4,2,9,0xb2d5f1ecd
172005.34,6.0,0,3,4,4,11,0xb2d2eccb
212.65,1.0,75,1,2,1,4,0xb2d63da8
602846.8,5.0,1,4,4,4,12,0xb2d27740d
50006.25,2.0,108,2,3,1,6,0xb2d23e6d
135.89,1.0,28,1,2,2,5,0xb2d18d2a
308160.07,5.0,0,4,4,4,12,0x3b9b1a44d
300069.39,2.0,4,3,3,4,10,0xb2d8fc8d
210472.77,4.0,53,3,4,2,9,0xb2d3ccd5d
2531.32,1.0,66,1,2,2,5,0xb2d1cca4
415077.25,1.0,3,4,2,4,10,0xb2d4a9a8d
28.3,1.0,8,1,2,3,6,0xb2d266ea
530004.02,3.0,18,4,4,2,10,0xb2d21172d
39157.05,2.0,0,2,3,4,9,0xb2d3e440d
112000.27,3.0,3,3,4,4,11,0xb2d388c1
875.57,1.0,81,1,2,1,4,0xb2d97bd6d
150105.12,3.0,25,3,4,2,9,0xb2d65422d
197.45,1.0,13,1,2,3,6,0xb2d30c1c
10054.48,1.0,92,2,2,1,5,0xb2d562bf
2874.26,2.0,92,1,3,1,5,0xb2d23f9cd
702.56,1.0,54,1,2,2,5,0xb2d4082a
40058.77,2.0,245,2,3,1,6,0xb2d61e77d
905577.02,10.0,42,4,4,2,10,0xb2d3d3cfd
4210.8,1.0,0,2,2,4,8,0xb2d35320
600019.97,2.0,80,4,3,1,8,0xb2d6b6c3d
322287.91,4.0,1,4,4,4,12,0xb2d5dd88
3735.83,1.0,9,2,2,3,7,0xb2d202c0
14942.51,1.0,10,2,2,3,7,0xb2d43503
637826.17,3.0,2,4,4,4,12,0xb2d242fc
1732963.59,3.0,67,4,4,1,9,0xb2d0da8ed
7603.35,1.0,29,2,2,2,6,0xb2d92d38
12800.13,1.0,2,2,2,4,8,0xb2d6af1a
101049.52,1.0,158,3,2,1,6,0xb2d27cf7d
277052.79,7.0,34,3,4,2,9,0xb2d5265a
415.84,1.0,1,1,2,4,7,0xb2d6d391
3899.51,1.0,10,2,2,3,7,0xb2d6e2af
50000.53,2.0,63,2,3,2,7,0xb2d9b682
10.42,1.0,62,1,2,2,5,0xb2d2f165
50000.57,3.0,68,2,4,1,7,0xb2d181d4
209307.97,4.0,201,3,4,1,8,0xb2d06ffdd
303919.72,5.0,69,4,4,1,9,0xb2d194dd
3857.14,1.0,1,2,2,4,8,0xb2d5d23bd
10084.13,1.0,92,2,2,1,5,0xb2d1b6c0d
8203.12,1.0,20,2,2,2,6,0xb2d60a9e
51.56,1.0,64,1,2,2,5,0xb2d390a2d
8.19,1.0,1,1,2,4,7,0xb2d83d82
200000.0,2.0,8,3,3,3,9,0xb2da4ef4
298116.25,1.0,92,3,2,1,6,0xb2d3f7b9
787.65,1.0,4,1,2,4,7,0xb2d68fdfd
70004.3,4.0,1,3,4,4,11,0xb2d08b93
236024.45,2.0,101,3,3,1,7,0xb2d4ac66d
27106.19,1.0,92,2,2,1,5,0xb2d5834c
203017.87,3.0,17,3,4,2,9,0xb2d93018
1009598.94,2.0,18,4,3,2,9,0xb2d0fda9d
710015.23,3.0,83,4,4,1,9,0xb2d62708d
5.04,1.0,54,1,2,2,5,0xb2d23666
6728.78,1.0,25,2,2,2,6,0xb2d30486d
22274.1,1.0,92,2,2,1,5,0xb2d34d68d
1214420.39,1.0,13,4,2,3,9,0xb2d300ba
260076.6,8.0,10,3,4,3,10,0xb2d075a7
56935.38,2.0,186,3,3,1,7,0xb2d14927d
6163.15,1.0,298,2,2,1,5,0xb2d61f49d
1650038.04,4.0,59,4,4,2,10,0xb2d645f6d
4694.58,1.0,20,2,2,2,6,0xb2d1b8b1d
101792.08,2.0,49,3,3,2,8,0xb2d645bc
17008.36,1.0,0,2,2,4,8,0xb2d6b579
1.06,1.0,104,1,2,1,4,0xb2d95e76d
377100.67,5.0,0,4,4,4,12,0xb2d417ca
470010.78,6.0,6,4,4,3,11,0xb2d5bae8
7.95,3.0,29,1,4,2,7,0xb2d2fa01
7005.54,1.0,84,2,2,1,5,0xb2d62c6a
4822.91,1.0,76,2,2,1,5,0xb2d62706d
150012.49,3.0,0,3,4,4,11,0xb2d911f1d
1089.88,2.0,0,1,3,4,8,0xb2d18eb0d
44028.19,2.0,23,2,3,2,7,0xb2d8ffdbd
248987.62,5.0,95,3,4,1,8,0xb2d0dfda
6270.65,1.0,184,2,2,1,5,0xb2d3fd0ad
5807.25,1.0,92,2,2,1,5,0xb2d27d24d
1083.23,1.0,184,1,2,1,4,0xb2d254d6d
7.86,1.0,196,1,2,1,4,0xb2d11c3dd
300210.35,1.0,0,4,2,4,10,0xb2d1fa7ad
1154.62,1.0,23,1,2,2,5,0xb2d2044cd
100185.82,4.0,3,3,4,4,11,0xb2d5effed
14.89,1.0,3,1,2,4,7,0xb2d62cb8d
2.29,1.0,52,1,2,2,5,0xb2d9d18f
120002.66,2.0,10,3,3,3,9,0xb2d1fab9d
7543.39,1.0,17,2,2,2,6,0xb2d174f2
16473.84,1.0,11,2,2,3,7,0xb2d967e4
21783.14,1.0,10,2,2,3,7,0xb2d36d99
8534.67,1.0,14,2,2,3,7,0xb2d177c2d
2.65,1.0,45,1,2,2,5,0xb2d6e01a
116.22,1.0,10,1,2,3,6,0xb2d42d81
175466.59,7.0,4,3,4,4,11,0xb2d112c8d
1441.19,1.0,16,1,2,2,5,0xb2d6ca56
50000.53,2.0,18,2,3,2,7,0xb2da2ac7
25647.15,2.0,67,2,3,1,6,0xb2d6920dd
400226.15,11.0,70,4,4,1,9,0xb2d1d8e5
919.16,1.0,10,1,2,3,6,0xb2d78ed1
107562.85,3.0,80,3,4,1,8,0xb2d30079d
1500000.0,2.0,8,4,3,3,10,0xb2d134a0
560000.0,10.0,1,4,4,4,12,0xb2d32d46d
13000.8,2.0,39,2,3,2,7,0xb2d992cc
160324.1,5.0,12,3,4,3,10,0xb2d07050d
301780.47,1.0,1,4,2,4,10,0xb2d3b964
13067.97,1.0,15,2,2,3,7,0xb2da05b7
200711.54,2.0,33,3,3,2,8,0xb2d6f092
4185.88,1.0,1,2,2,4,8,0xb2d6ccf8
2262.79,1.0,27,1,2,2,5,0xb2d3e611
12.43,1.0,36,1,2,2,5,0xb2d6b0efd
202147.33,2.0,93,3,3,1,7,0xb2d6db5dd
12313.17,1.0,0,2,2,4,8,0xb2da07ad
1100025.35,6.0,10,4,4,3,11,0xb2d40d42d
400002.44,2.0,12,4,3,3,10,0xb2d95b75
50717.35,2.0,6,2,3,3,8,0xb2d5b0ec
111032.46,3.0,200,3,4,1,8,0xb2d5604ad
808105.96,6.0,0,4,4,4,12,0xb2d44ce2d
485064.95,8.0,1,4,4,4,12,0xb2d28a75
270012.16,6.0,67,3,4,1,8,0xb2d09ab8d
500005.29,2.0,147,4,3,1,8,0xb2d903ded
100339.34,2.0,30,3,3,2,8,0xb2d25d45d
69.37,1.0,0,1,2,4,7,0xb2d1a567d
900711.32,5.0,8,4,4,3,11,0xb2d9aa7f
228242.88,1.0,92,3,2,1,6,0x3b9b18b5d
15162.61,1.0,184,2,2,1,5,0xb2d285a9
929.88,1.0,9,1,2,3,6,0xb2d47ecf
10290.09,1.0,7,2,2,3,7,0xb2d61d70
111.49,1.0,1,1,2,4,7,0xb2d2f75ed
14.25,1.0,53,1,2,2,5,0xb2d8c902
155213.63,5.0,18,3,4,2,9,0xb2d9052ed
184829.03,3.0,129,3,4,1,8,0xb2d59de2d
2787.61,1.0,28,1,2,2,5,0xb2d6808e
2996.16,1.0,92,2,2,1,5,0xb2d2abb3d
632.7,1.0,45,1,2,2,5,0xb2d1e69f
0.22,1.0,4,1,2,4,7,0xb2d418d3
0.0,6.0,4,1,4,4,9,0xb2d2d0ae
230007.12,7.0,55,3,4,2,9,0xb2d53ad4d
177036.25,4.0,4,3,4,4,11,0xb2d2490dd
20084.86,1.0,0,2,2,4,8,0xb2d9282ed
100313.99,6.0,11,3,4,3,10,0xb2d592bcd
63.33,1.0,32,1,2,2,5,0xb2d9e12f
37522.73,2.0,0,2,3,4,9,0xb2d0d62d
100199.52,3.0,64,3,4,2,9,0xb2d18a72
2094467.79,8.0,102,4,4,1,9,0xb2d395f6d
262.47,1.0,60,1,2,2,5,0xb2d3092b
7138.76,1.0,0,2,2,4,8,0xb2d5fb7bd
127658.82,5.0,0,3,4,4,11,0x3b9b254a
160007.82,4.0,10,3,4,3,10,0xb2d4151cd
7012.28,1.0,14,2,2,3,7,0xb2d9696b
22057.62,1.0,92,2,2,1,5,0xb2d654c1
10.02,1.0,14,1,2,3,6,0xb2d9654a
1580.22,1.0,0,1,2,4,7,0xb2d5ecf0
31001.72,3.0,0,2,4,4,10,0xb2d06c99d
203007.34,4.0,40,3,4,2,9,0xb2d4cd9bd
530075.31,3.0,101,4,4,1,9,0xb2d5fa94d
3411.61,1.0,3,2,2,4,8,0xb2d6e891d
2847860.28,4.0,13,4,4,3,11,0xb2d4369cd
83006.25,5.0,0,3,4,4,11,0xb2d2283ed
15037.17,1.0,121,2,2,1,5,0xb2d6edc7d
339007.26,2.0,6,4,3,3,10,0xb2d68af1d
2000010.58,6.0,6,4,4,3,11,0xb2d60805d
3939979.1,34.0,10,4,4,3,11,0xb2d09ed9
8456.96,1.0,203,2,2,1,5,0xb2d437f9
252389.13,3.0,179,3,4,1,8,0xb2d3abe4d
19001.8,2.0,126,2,3,1,6,0xb2d5c310d
5110.55,1.0,17,2,2,2,6,0xb2d3453e
240500.47,3.0,18,3,4,2,9,0xb2da2eac
7409.02,1.0,1,2,2,4,8,0xb2d47300
287512.74,10.0,0,3,4,4,11,0xb2d06831
279192.04,3.0,7,3,4,3,10,0xb2d85a97
206402.89,2.0,85,3,3,1,7,0xb2d69321
520311.56,3.0,0,4,4,4,12,0xb2d4f53dd
110001.16,3.0,10,3,4,3,10,0xb2d91cbfd
310460.2,4.0,172,4,4,1,9,0xb2d514e3
208.86,1.0,21,1,2,2,5,0xb2d14e3a
110004.16,3.0,11,3,4,3,10,0xb2d9557d
7154.11,1.0,13,2,2,3,7,0xb2d399ac
0.0,1.0,205,1,2,1,4,0xb2d30874d
200197.23,2.0,4,3,3,4,10,0xb2da3251
264.73,1.0,50,1,2,2,5,0xb2d9354e
52477.51,1.0,95,3,2,1,6,0xb2d8c44ad
4182.83,1.0,14,2,2,3,7,0xb2d1cf70
12978.97,1.0,10,2,2,3,7,0xb2d5d5b4
59.11,1.0,56,1,2,2,5,0xb2d9adc3
50.67,1.0,44,1,2,2,5,0xb2d8e4d2
288867.56,2.0,4,3,3,4,10,0xb2d40ebb
1841658.31,17.0,0,4,4,4,12,0x3b9adea1d
9960.57,1.0,0,2,2,4,8,0xb2d1d55c
500021.11,2.0,90,4,3,1,8,0xb2d8a820d
5287.94,1.0,48,2,2,2,6,0xb2d30d58
54202.95,3.0,139,3,4,1,8,0xb2d1b2a4d
5026.06,1.0,92,2,2,1,5,0xb2d5fbdcd
409280.55,3.0,120,4,4,1,9,0xb2d76898d
10670.18,1.0,10,2,2,3,7,0xb2d6e878d
396371.17,1.0,8,4,2,3,9,0xb2d9996b
28.47,1.0,112,1,2,1,4,0xb2d57aabd
700015.62,16.0,10,4,4,3,11,0xb2d452f8
100013.33,2.0,49,3,3,2,8,0xb2d1fb08d
1359552.12,8.0,0,4,4,4,12,0xb2d69606
47.5,1.0,6,1,2,3,6,0xb2d39c34
26.97,1.0,31,1,2,2,5,0xb2d3f4b7
11671.01,1.0,184,2,2,1,5,0xb2d3f102d
41098.76,3.0,171,2,4,1,7,0xb2d5f7f2
120587.43,3.0,80,3,4,1,8,0xb2d6b169
400581.5,4.0,6,4,4,3,11,0xb2d4c95d
300000.0,2.0,4,3,3,4,10,0xb2d97947d
500928.61,3.0,21,4,4,2,10,0xb2d90f75d
0.34,1.0,0,1,2,4,7,0xb2d60485
19.74,1.0,66,1,2,2,5,0xb2d51e24
40034.42,2.0,10,2,3,3,8,0xb2d14526d
534943.94,4.0,56,4,4,2,10,0xb2d3339ed
866953.16,1.0,4,4,2,4,10,0xb2d2f430
20.81,2.0,32,1,3,2,6,0xb2d6afa2d
510716.46,10.0,3,4,4,4,12,0xb2d58671
990138.91,5.0,55,4,4,2,10,0xb2d1f9d8
402.98,1.0,0,1,2,4,7,0xb2d53032
204089.96,2.0,13,3,3,3,9,0xb2d3fa0cd
12487.24,1.0,189,2,2,1,5,0xb2d430fed
110505.46,4.0,4,3,4,4,11,0xb2d42259d
110199.75,2.0,167,3,3,1,7,0xb2d160bad
23838.17,1.0,0,2,2,4,8,0xb2d5cbaa
90001.58,3.0,4,3,4,4,11,0xb2d9b8d8
100004.22,2.0,69,3,3,1,7,0xb2d8e8bb
41001.52,2.0,67,2,3,1,6,0xb2d53c2f
184899.54,2.0,0,3,3,4,10,0xb2d26d19d
130002.93,5.0,25,3,4,2,9,0xb2d815ecd
661.62,1.0,110,1,2,1,4,0xb2d913cad
0.0,1.0,31,1,2,2,5,0xb2d27d70
2819.37,1.0,92,1,2,1,4,0xb2d2b40e
1721.44,1.0,92,1,2,1,4,0xb2d2be4e
12626.76,1.0,21,2,2,2,6,0xb2d4da8c
4499.04,1.0,3,2,2,4,8,0xb2d9bf2d
250000.02,2.0,6,3,3,3,9,0xb2d9fb35
645029.44,15.0,6,4,4,3,11,0xb2d547e7d
41000.01,2.0,33,2,3,2,7,0xb2d44434d
251820.99,2.0,19,3,3,2,8,0xb2d65989d
25654.64,1.0,5,2,2,3,7,0xb2d6c46d
2.85,1.0,105,1,2,1,4,0xb2d95bbd
5608.15,1.0,0,2,2,4,8,0xb2d22f5e
17.31,1.0,12,1,2,3,6,0xb2d5c076
1333.9,1.0,92,1,2,1,4,0x3b9af5a2d
600000.0,9.0,0,4,4,4,12,0xb2d200d0d
22.88,1.0,9,1,2,3,6,0xb2d1d9d6
644027.8,9.0,83,4,4,1,9,0xb2d10358
306083.39,2.0,32,4,3,2,9,0xb2d9361a
395203.21,9.0,16,4,4,2,10,0x3b9b29afd
826.54,1.0,10,1,2,3,6,0xb2d53013
320017.19,2.0,168,4,3,1,8,0xb2d253f8
220004.86,3.0,73,3,4,1,8,0xb2d787d3
358160.11,2.0,0,4,3,4,11,0xb2d9fa88
60190.04,3.0,1,3,4,4,11,0xb2d9b9fe
113385.8,2.0,92,3,3,1,7,0xb2d1a2da
4663.07,1.0,0,2,2,4,8,0xb2d62e42
4045.55,1.0,0,2,2,4,8,0xb2d68567d
5009.63,1.0,0,2,2,4,8,0xb2d6a1ddd
673574.36,2.0,11,4,3,3,10,0xb2d4cebf
10035.57,2.0,25,2,3,2,7,0xb2d57095
0.0,1.0,1,1,2,4,7,0xb2d24f70d
400000.95,2.0,6,4,3,3,10,0xb2d953a9d
202746.41,4.0,3,3,4,4,11,0xb2d0d8cad
483856.65,78.0,0,4,4,4,12,0x3b9ad591d
1325155.92,12.0,6,4,4,3,11,0xb2d32d41
101184.75,1.0,15,3,2,3,8,0xb2d68508d
10466.56,1.0,0,2,2,4,8,0xb2d2b5d0
200340.76,3.0,167,3,4,1,8,0xb2d127f0
688019.6,7.0,14,4,4,3,11,0xb2d1b32cd
157870.21,4.0,26,3,4,2,9,0xb2d29211
1600.09,1.0,199,1,2,1,4,0xb2d411e1d
10039.34,1.0,0,2,2,4,8,0xb2d2a4a6d
511890.97,3.0,23,4,4,2,10,0xb2d5e08b
500079.3,5.0,52,4,4,2,10,0xb2d4f960
976.12,1.0,5,1,2,3,6,0xb2d4b6d5d
52.63,1.0,0,1,2,4,7,0xb2d680fad
832881.64,3.0,67,4,4,1,9,0xb2d39351d
2094.65,1.0,10,1,2,3,6,0xb2d31e3bd
909831.09,9.0,6,4,4,3,11,0xb2d7c13e
68343.34,2.0,64,3,3,2,8,0xb2d1b898
7334.68,1.0,0,2,2,4,8,0xb2d39c18d
885.82,1.0,2,1,2,4,7,0xb2d6bb2a
8295.78,1.0,123,2,2,1,5,0xb2d38697
51.22,1.0,8,1,2,3,6,0xb2d3396c
401818.92,3.0,1,4,4,4,12,0xb2d413c8
30219.58,1.0,184,2,2,1,5,0xb2d436c1d
470112.73,11.0,1,4,4,4,12,0xb2d25bdbd
1104.3,1.0,184,1,2,1,4,0x3b9b3602d
279000.01,5.0,6,3,4,3,10,0xb2d580cad
50002.81,2.0,214,2,3,1,6,0xb2d6a49f
41373.73,1.0,0,2,2,4,8,0xb2d5aa55
250410.67,3.0,0,3,4,4,11,0xb2d648edd
136090.6,2.0,45,3,3,2,8,0xb2d40f9fd
50068.29,1.0,51,2,2,2,6,0xb2d8df6c
271760.09,5.0,48,3,4,2,9,0xb2d5769ad
1.31,1.0,48,1,2,2,5,0xb2d644e2
11501.54,1.0,19,2,2,2,6,0xb2d925ec
18.08,1.0,212,1,2,1,4,0xb2d298f9d
60005.31,2.0,0,3,3,4,10,0xb2d61880
9860.0,1.0,255,2,2,1,5,0xb2d3dc32d
51097.79,3.0,24,2,4,2,8,0xb2d62b8cd
16.87,1.0,0,1,2,4,7,0xb2d75ac4
1205908.46,5.0,27,4,4,2,10,0xb2d697b6d
434621.55,2.0,35,4,3,2,9,0xb2d1d58cd
210012.07,3.0,85,3,4,1,8,0xb2d53259
32393.31,1.0,59,2,2,2,6,0xb2d2fa7bd
12.99,1.0,67,1,2,1,4,0xb2d283e5d
720040.76,5.0,1,4,4,4,12,0xb2d14c9a
10000.42,2.0,14,2,3,3,8,0xb2da3326
1627751.97,12.0,0,4,4,4,12,0x3b9b1016d
2.87,1.0,92,1,2,1,4,0xb2d288b4d
469.44,9.0,98,1,4,1,6,0xb2d11eb0d
2859.96,1.0,10,1,2,3,6,0xb2d6912b
2479.82,2.0,92,1,3,1,5,0x3b9b12b3
285228.55,5.0,62,3,4,2,9,0xb2d207c9d
622205.76,2.0,29,4,3,2,9,0xb2d90006d
43.53,1.0,14,1,2,3,6,0xb2d60dd2
6353.8,1.0,0,2,2,4,8,0xb2d6b5b6d
2124942.33,8.0,69,4,4,1,9,0xb2d4aa4b
58080.77,4.0,27,3,4,2,9,0xb2d64a0ed
103899.32,2.0,168,3,3,1,7,0xb2d1af18
103008.62,2.0,31,3,3,2,8,0xb2d5a96a
29462.39,1.0,14,2,2,3,7,0xb2d32c01d
30324.77,1.0,5,2,2,3,7,0xb2d3f5d1d
100005.3,2.0,196,3,3,1,7,0xb2d7a753d
50000.53,2.0,14,2,3,3,8,0xb2da395c
147476.42,2.0,161,3,3,1,7,0xb2d0805cd
98.37,1.0,0,1,2,4,7,0xb2d55a84d
550000.0,4.0,9,4,4,3,11,0xb2d10e1d
20000.63,2.0,10,2,3,3,8,0xb2d95fcb
204008.24,6.0,0,3,4,4,11,0xb2d56f1bd
3.58,1.0,5,1,2,3,6,0xb2d531a7
3929.25,1.0,4,2,2,4,8,0xb2d1ea40
350001.06,3.0,5,4,4,3,11,0xb2d629fcd
7400510.84,3.0,18,4,4,2,10,0xb2d49188
404860.75,4.0,133,4,4,1,9,0xb2d6242fd
101017.23,2.0,39,3,3,2,8,0xb2d6b11dd
20097.25,1.0,30,2,2,2,6,0xb2d2af9c
45002.36,3.0,56,2,4,2,8,0xb2d98c1a
100822.79,2.0,122,3,3,1,7,0xb2d64811
1001.01,1.0,105,1,2,1,4,0xb2d7edc5d
3.24,1.0,39,1,2,2,5,0xb2d635a9d
1427559.4,3.0,4,4,4,4,12,0x3b9b3571d
3040736.67,18.0,4,4,4,4,12,0xb2d586acd
80000.0,2.0,0,3,3,4,10,0xb2d8f9d0d
60.49,1.0,14,1,2,3,6,0xb2d9e7f5
64124.61,1.0,0,3,2,4,9,0xb2d36341
41.46,1.0,28,1,2,2,5,0xb2d171ec
778.63,1.0,0,1,2,4,7,0xb2d503c8
42040.31,2.0,80,2,3,1,6,0xb2d5f10ad
54124.89,2.0,34,3,3,2,8,0xb2d0e91b
63291.06,1.0,1,3,2,4,9,0xb2d98c06
110026.9,3.0,27,3,4,2,9,0xb2d14c7f
10000.13,4.0,28,2,4,2,8,0xb2d10299
161.43,1.0,37,1,2,2,5,0xb2d4ac3ed
36.28,1.0,3,1,2,4,7,0xb2d33667
81810.55,3.0,48,3,4,2,9,0xb2d5f770
4504.11,1.0,13,2,2,3,7,0xb2d9e12d
25021.18,1.0,12,2,2,3,7,0xb2d174f7
19889.41,4.0,0,2,4,4,10,0xb2d1ffc3
44648.39,1.0,2,2,2,4,8,0xb2d42ce3d
4650071.81,4.0,144,4,4,1,9,0xb2d56bd4
7153.11,2.0,184,2,3,1,6,0xb2d35e6cd
400000.0,2.0,6,4,3,3,10,0xb2da5286
5792.06,2.0,1,2,3,4,9,0xb2d210cad
400001.0,3.0,1,4,4,4,12,0xb2d8a568d
8.53,1.0,11,1,2,3,6,0xb2d13633d
51288.93,1.0,0,2,2,4,8,0xb2d5a5e9d
1527018.02,8.0,27,4,4,2,10,0x3b9b350b
1427.17,1.0,10,1,2,3,6,0xb2d91c1b
1000832.93,2.0,32,4,3,2,9,0xb2d47da6
991896.07,2.0,1,4,3,4,11,0xb2d11334d
4803.77,1.0,10,2,2,3,7,0xb2d52945
1692.86,1.0,91,1,2,1,4,0xb2d64a10d
3386.07,1.0,2,2,2,4,8,0xb2d97ed5
28196.12,1.0,12,2,2,3,7,0xb2d1f489
4351.91,1.0,10,2,2,3,7,0xb2d6b77dd
3677.07,1.0,184,2,2,1,5,0xb2d08152
173011.58,2.0,39,3,3,2,8,0xb2d6de8ed
100000.75,4.0,0,3,4,4,11,0xb2d425d0d
0.01,1.0,6,1,2,3,6,0xb2d21baf
9203.04,1.0,10,2,2,3,7,0xb2d53dd9d
200049.37,2.0,0,3,3,4,10,0xb2d10e34
5145012.83,18.0,0,4,4,4,12,0xb2d51cf5
1757.12,1.0,9,1,2,3,6,0xb2d41222
2021323.38,2.0,90,4,3,1,8,0xb2d9453cd
20000.42,2.0,80,2,3,1,6,0xb2d5fa87
2.53,1.0,76,1,2,1,4,0xb2d9540b
220655.36,1.0,50,3,2,2,7,0xb2d53b95d
414466.68,1.0,92,4,2,1,7,0xb2d25be2
500061.61,3.0,6,4,4,3,11,0xb2d68a79d
77025.2,2.0,6,3,3,3,9,0xb2d0e5be
150270.69,3.0,14,3,4,3,10,0xb2d5ab72d
221016.33,2.0,32,3,3,2,8,0xb2d5bf8c
30133.96,1.0,184,2,2,1,5,0xb2d356c0d
5003.87,1.0,5,2,2,3,7,0xb2d682bcd
760449.73,4.0,0,4,4,4,12,0xb2d3900dd
453292.35,2.0,72,4,3,1,8,0xb2d6f483d
10171.74,2.0,228,2,3,1,6,0xb2d62c9ed
104044.84,2.0,4,3,3,4,10,0xb2d3657a
94568.43,2.0,10,3,3,3,9,0xb2d95d09
67461.42,3.0,1,3,4,4,11,0xb2d2b375d
12296.65,1.0,11,2,2,3,7,0xb2d9659ed
24230.91,1.0,1,2,2,4,8,0xb2d9e96e
200212.0,2.0,298,3,3,1,7,0xb2d5527fd
1037574.23,5.0,1,4,4,4,12,0xb2d3cf71d
85.5,1.0,41,1,2,2,5,0xb2d39048
89201.13,1.0,4,3,2,4,9,0xb2d30fac
1850000.0,15.0,1,4,4,4,12,0xb2d244f0d
20029.87,2.0,1,2,3,4,9,0xb2d6c2c2
12604.71,1.0,0,2,2,4,8,0xb2d1f9d3d
39.34,1.0,0,1,2,4,7,0xb2d2f6afd
510018.03,2.0,25,4,3,2,9,0xb2d241a8d
200005.05,2.0,64,3,3,2,8,0xb2d8d5edd
500000.0,2.0,10,4,3,3,10,0xb2d92442
85226.32,2.0,2,3,3,4,10,0xb2d298a0
2357.91,1.0,2,1,2,4,7,0xb2d98b26
12.34,1.0,26,1,2,2,5,0xb2d69b2ad
393001.87,4.0,25,4,4,2,10,0xb2d0ea35d
566400.74,5.0,0,4,4,4,12,0xb2d8f8f9d
50059.99,2.0,14,2,3,3,8,0xb2d31931d
7308.01,1.0,9,2,2,3,7,0xb2d217d7d
9611.46,1.0,8,2,2,3,7,0xb2d34814
3417.34,1.0,1,2,2,4,8,0xb2d42c73
12862.79,1.0,0,2,2,4,8,0xb2d3097cd
120488.51,1.0,9,3,2,3,8,0xb2d8dbd7d
59.19,1.0,0,1,2,4,7,0xb2d31164
610056.54,7.0,5,4,4,3,11,0xb2d06514d
10000000.0,2.0,3,4,3,4,11,0xb2d69308d
290413.43,2.0,108,3,3,1,7,0xb2d1193cd
100001.06,2.0,24,3,3,2,8,0xb2d94a60d
20000.47,2.0,8,2,3,3,8,0xb2da281f
662886.22,3.0,0,4,4,4,12,0xb2d6428a
12496.63,1.0,21,2,2,2,6,0xb2d967ec
415767.77,14.0,11,4,4,3,11,0xb2d0df7ad
86252.91,1.0,49,3,2,2,7,0xb2d37ca9d
1142902.84,6.0,11,4,4,3,11,0xb2d5dd10d
282841.85,3.0,55,3,4,2,9,0x3b9b2b32d
2130.12,1.0,92,1,2,1,4,0xb2d34187
80012.33,3.0,179,3,4,1,8,0xb2d0e4ea
2503352.28,1.0,136,4,2,1,7,0xb2d6f93cd
50.4,1.0,184,1,2,1,4,0xb2d28862
1028.3,1.0,92,1,2,1,4,0xb2d25dc9d
653901.49,3.0,61,4,4,2,10,0xb2d32ae1
247027.88,4.0,11,3,4,3,10,0xb2d1c4be
200002.52,2.0,26,3,3,2,8,0xb2d78771
563013.78,6.0,25,4,4,2,10,0xb2d41bd2
3044.75,1.0,150,2,2,1,5,0xb2d69e2fd
223766.65,3.0,1,3,4,4,11,0xb2d3f561d
179195.01,3.0,12,3,4,3,10,0xb2d280a7d
82696.38,2.0,0,3,3,4,10,0xb2d4dcb0d
1003716.12,3.0,23,4,4,2,10,0xb2d1faf0
403410.69,2.0,73,4,3,1,8,0xb2d5a5fb
1328163.58,2.0,0,4,3,4,11,0xb2d40f35
51047.3,2.0,221,2,3,1,6,0xb2d6262dd
2.28,1.0,61,1,2,2,5,0xb2d53d69
266002.81,2.0,55,3,3,2,8,0xb2d10695d
490047.15,3.0,38,4,4,2,10,0xb2d1be27
102794.74,2.0,3,3,3,4,10,0xb2d5192dd
6010.56,1.0,55,2,2,2,6,0xb2d516ec
241533.31,5.0,33,3,4,2,9,0xb2d1e761
27159.09,1.0,4,2,2,4,8,0xb2d5054dd
3975.35,1.0,11,2,2,3,7,0xb2d1d61ed
170440.17,1.0,92,3,2,1,6,0xb2d3a183d
1191.55,1.0,7,1,2,3,6,0xb2d2520dd
3979.54,1.0,7,2,2,3,7,0xb2d8ebf9
2879.87,1.0,4,1,2,4,7,0xb2d2bc39d
2979.35,1.0,0,2,2,4,8,0xb2d4f6bfd
15149.67,1.0,92,2,2,1,5,0xb2d29089
1000483.33,1.0,0,4,2,4,10,0xb2d9dd45
202369.44,3.0,0,3,4,4,11,0xb2d5e8d6d
500006.21,5.0,11,4,4,3,11,0xb2d55138d
3826.31,1.0,2,2,2,4,8,0xb2d1ebca
183886.11,3.0,0,3,4,4,11,0x3b9b48f4
310000.47,3.0,1,4,4,4,12,0xb2d603fe
1021.24,1.0,92,1,2,1,4,0x3b9b3866d
1800025.34,3.0,3,4,4,4,12,0xb2d922afd
10.08,1.0,21,1,2,2,5,0xb2d09599
230089.51,4.0,20,3,4,2,9,0xb2d29ecbd
12936.5,1.0,92,2,2,1,5,0xb2d3046ed
116051.36,2.0,147,3,3,1,7,0xb2d5baa3
12142.0,1.0,0,2,2,4,8,0xb2d8f732d
4204.46,1.0,21,2,2,2,6,0xb2d5ae0ad
721610.53,3.0,137,4,4,1,9,0xb2d13ebfd
6.28,2.0,69,1,3,1,5,0x3b9b41c0d
152568.03,3.0,34,3,4,2,9,0xb2d13d56d
410080.13,10.0,0,4,4,4,12,0xb2d9b157
1863.69,1.0,92,1,2,1,4,0xb2d262dfd
240005.57,6.0,63,3,4,2,9,0xb2d58cf9
10014.21,1.0,53,2,2,2,6,0xb2d36f3ad
100.05,2.0,8,1,3,3,7,0xb2d5e6b7
0.93,1.0,92,1,2,1,4,0xb2d16e13d
52.69,1.0,4,1,2,4,7,0xb2d1ec26
261578.02,2.0,62,3,3,2,8,0xb2d98dc9
1158858.35,4.0,29,4,4,2,10,0xb2d280a9d
206781.82,1.0,0,3,2,4,9,0xb2d5611ed
101753.07,2.0,18,3,3,2,8,0xb2d41605
420568.83,3.0,100,4,4,1,9,0xb2d0bc69d
4271.23,1.0,97,2,2,1,5,0xb2d4f154
16753.13,1.0,10,2,2,3,7,0xb2d5d113d
405685.76,3.0,96,4,4,1,9,0xb2d936b7d
2028.66,1.0,92,1,2,1,4,0xb2d0b6b4d
131.64,2.0,73,1,3,1,5,0xb2d41dac
1337.97,1.0,92,1,2,1,4,0xb2d3c522
4496.23,1.0,5,2,2,3,7,0xb2d13a24
2279.61,1.0,146,1,2,1,4,0xb2d261f5d
103.9,1.0,11,1,2,3,6,0xb2d8f5e6
200773.72,2.0,32,3,3,2,8,0xb2d91594d
311305.86,3.0,47,4,4,2,10,0xb2d1ae61
30029.17,2.0,11,2,3,3,8,0xb2d18059d
341036.36,6.0,1,4,4,4,12,0xb2d0840cd
9026.34,2.0,144,2,3,1,6,0x3b9b4046
2511.71,2.0,184,1,3,1,5,0xb2d10169d
200387.23,2.0,181,3,3,1,7,0xb2d42627d
0.0,1.0,2,1,2,4,7,0xb2d0e547
200028.63,3.0,53,3,4,2,9,0xb2d510bbd
10310.77,1.0,75,2,2,1,5,0xb2d5ae94d
148988.33,2.0,6,3,3,3,9,0xb2d62169d
477786.82,4.0,27,4,4,2,10,0xb2d6d3c8d
106237.24,9.0,0,3,4,4,11,0xb2d1493d
250011.72,4.0,83,3,4,1,8,0xb2d631ae
1277.09,1.0,92,1,2,1,4,0xb2d25599
1427.86,1.0,184,1,2,1,4,0xb2d34d28d
12166.58,1.0,38,2,2,2,6,0xb2d17959
54.06,1.0,1,1,2,4,7,0xb2d2b617d
14.3,1.0,67,1,2,1,4,0xb2d3c34e
746548.36,27.0,1,4,4,4,12,0xb2d5c26dd
503100.93,1.0,92,4,2,1,7,0xb2d405cc
119.83,1.0,0,1,2,4,7,0xb2d3aafe
3.92,1.0,62,1,2,2,5,0x3b9b34fb
10001.85,2.0,0,2,3,4,9,0xb2d5e9d5d
604262.95,2.0,60,4,3,2,9,0xb2d9c238
20156.76,1.0,184,2,2,1,5,0xb2d1bf6bd
30000.32,2.0,55,2,3,2,7,0xb2d903b8d
145045.55,4.0,0,3,4,4,11,0xb2d92368d
577.62,1.0,55,1,2,2,5,0xb2d5b31ad
13543.6,1.0,0,2,2,4,8,0xb2d2f77d
260774.25,4.0,18,3,4,2,9,0xb2d410a5
308028.26,3.0,8,4,4,3,11,0x3b9b100a
1934.3,1.0,7,1,2,3,6,0xb2d1a396d
80903.12,1.0,20,3,2,2,7,0xb2d78246d
50001.53,2.0,10,2,3,3,8,0xb2d2494dd
250088.02,2.0,6,3,3,3,9,0xb2d91ceed
1951.08,2.0,0,1,3,4,8,0xb2d064ce
2646.75,1.0,184,1,2,1,4,0xb2d11830d
1332.66,1.0,92,1,2,1,4,0xb2d2e88a
8297.46,1.0,0,2,2,4,8,0xb2d92f3c
401422.77,3.0,31,4,4,2,10,0xb2d2a89cd
262023.14,14.0,0,3,4,4,11,0xb2d35ce1d
10000.21,2.0,110,2,3,1,6,0xb2d63dc4d
40000956.13,3.0,196,4,4,1,9,0xb2d4aa67
0.42,1.0,22,1,2,2,5,0xb2d538c5d
1000000.0,2.0,4,4,3,4,11,0xb2da0131
62879.53,5.0,0,3,4,4,11,0x3b9b183ed
93302.9,1.0,0,3,2,4,9,0xb2d0a0e4
500000.0,2.0,3,4,3,4,11,0xb2d745d5
1561.8,1.0,18,1,2,2,5,0xb2d2989ad
160090.0,3.0,2,3,4,4,11,0xb2d5be0b
497.94,2.0,11,1,3,3,7,0xb2d2818a
87110.31,2.0,4,3,3,4,10,0xb2d9434cd
70050.42,2.0,41,3,3,2,8,0xb2d6e17ad
12.25,1.0,108,1,2,1,4,0xb2d683eb
1.41,1.0,69,1,2,1,4,0xb2d345e7
6981.62,1.0,25,2,2,2,6,0xb2d25c0c
300000.0,2.0,4,3,3,4,10,0xb2da64b2
31.61,1.0,9,1,2,3,6,0xb2d8d4f2
11216.89,2.0,0,2,3,4,9,0xb2d09e09
1408.31,1.0,0,1,2,4,7,0xb2d58285
250004.86,8.0,6,3,4,3,10,0xb2d36b24d
2257.06,1.0,0,1,2,4,7,0xb2d4ce23d
510007.3,9.0,53,4,4,2,10,0xb2d39282
3338.26,1.0,2,2,2,4,8,0xb2d2835f
1321.62,1.0,4,1,2,4,7,0xb2d5717c
1779.48,1.0,104,1,2,1,4,0xb2d61a64d
5005.22,1.0,0,2,2,4,8,0xb2d579f7
658468.91,4.0,83,4,4,1,9,0xb2d13f1bd
3906.64,1.0,50,2,2,2,6,0xb2d6c05bd
3249.77,1.0,184,2,2,1,5,0xb2d47380
15046.91,1.0,92,2,2,1,5,0xb2d59044d
680014.39,2.0,94,4,3,1,8,0xb2d0ba23d
156206.73,4.0,0,3,4,4,11,0xb2d4299dd
346010.44,5.0,0,4,4,4,12,0xb2d6272b
212549.82,2.0,144,3,3,1,7,0xb2d6cfc9d
511495.51,3.0,0,4,4,4,12,0xb2d68ada
495073.98,5.0,22,4,4,2,10,0xb2d29dca
326404.33,3.0,4,4,4,4,12,0xb2d60477
2963.43,1.0,0,2,2,4,8,0xb2d67eb3
2122085.72,9.0,6,4,4,3,11,0xb2d23e12d
2536.13,1.0,9,1,2,3,6,0xb2d6ee16
822068.45,5.0,17,4,4,2,10,0xb2d172f0
148050.24,7.0,6,3,4,3,10,0x3b9af2b2
30001.26,2.0,67,2,3,1,6,0xb2d8e82c
82.15,1.0,9,1,2,3,6,0xb2d3023c
200010.42,2.0,0,3,3,4,10,0xb2d93cecd
2784.3,1.0,0,1,2,4,7,0xb2d6656b
500000.28,9.0,4,4,4,4,12,0xb2d10484d
1111.43,1.0,8,1,2,3,6,0xb2d2adb1
50407.99,1.0,28,2,2,2,6,0xb2d1c717
55734.3,2.0,256,3,3,1,7,0xb2d142b8
1193657.41,6.0,12,4,4,3,11,0xb2d47898
205.61,3.0,4,1,4,4,9,0xb2d64592d
143.79,1.0,19,1,2,2,5,0xb2d21120
503197.78,3.0,29,4,4,2,10,0xb2d97e23
230014.15,3.0,123,3,4,1,8,0xb2d633f4d
77192.66,2.0,98,3,3,1,7,0xb2d2076fd
0.0,2.0,41,1,3,2,6,0xb2d5d0d9
10353.82,4.0,92,2,4,1,7,0x3b9af20c
523022.08,2.0,60,4,3,2,9,0xb2d9b667
4367.7,1.0,1,2,2,4,8,0xb2d1cbb4
2500608.17,4.0,53,4,4,2,10,0xb2d6b859d
304214.57,3.0,3,4,4,4,12,0xb2d6de7ed
566.24,2.0,75,1,3,1,5,0x3b9b33d4d
7687.44,1.0,13,2,2,3,7,0xb2d6b7e1
50001.31,2.0,172,2,3,1,6,0xb2d18f2c
60002.26,2.0,39,3,3,2,8,0xb2d4421a
585774.19,4.0,81,4,4,1,9,0xb2d4c7e6d
240000.0,3.0,3,3,4,4,11,0xb2d972be
5231.46,1.0,1,2,2,4,8,0xb2d4f271
87452.51,1.0,3,3,2,4,9,0xb2d0f161d
2089889.01,8.0,18,4,4,2,10,0xb2d530b4d
200020.88,2.0,8,3,3,3,9,0xb2d9a117
481.13,1.0,15,1,2,3,6,0xb2d41046
80022.55,3.0,12,3,4,3,10,0xb2d0d5e3
353.09,1.0,13,1,2,3,6,0xb2d584d2
2261.03,1.0,20,1,2,2,5,0xb2d32be7
10213.05,1.0,184,2,2,1,5,0xb2d2c0aad
3454.36,1.0,5,2,2,3,7,0xb2d90465
418931.5,12.0,0,4,4,4,12,0xb2d339c9d
1821.86,1.0,5,1,2,3,6,0xb2d197a3
327014.51,5.0,4,4,4,4,12,0xb2d58cd3d
460422.27,10.0,4,4,4,4,12,0xb2d455bb
0.0,1.0,0,1,2,4,7,0xb2d42489d
70228.57,1.0,84,3,2,1,6,0xb2d5f6eed
80.93,1.0,20,1,2,2,5,0xb2d6b6d4
10055.98,1.0,92,2,2,1,5,0xb2d3fe0a
10002.09,1.0,4,2,2,4,8,0xb2d5e67ad
1467.56,1.0,18,1,2,2,5,0xb2d59b50d
182999.0,1.0,5,3,2,3,8,0xb2d9539bd
12610.8,1.0,16,2,2,2,6,0xb2d5b661d
537924.13,5.0,3,4,4,4,12,0xb2d4eb0ed
8932.04,1.0,10,2,2,3,7,0xb2d4dcd5
314013.65,4.0,26,4,4,2,10,0xb2d11a2cd
313.76,1.0,20,1,2,2,5,0xb2d6fa21
15.61,1.0,52,1,2,2,5,0xb2d9914d
282558.56,3.0,0,3,4,4,11,0xb2d28089d
368000.0,14.0,2,4,4,4,12,0xb2d2f68cd
2925002.81,10.0,0,4,4,4,12,0xb2d6ef81
6703.14,1.0,0,2,2,4,8,0xb2d6e965
70625.13,3.0,6,3,4,3,10,0xb2d2954ad
34975.59,1.0,1,2,2,4,8,0xb2d6bfd2
407109.38,2.0,111,4,3,1,8,0xb2d8db56d
53059.87,2.0,74,3,3,1,7,0xb2d58750d
50000.0,1.0,5,2,2,3,7,0xb2d97311d
500028.23,2.0,14,4,3,3,10,0xb2d9610dd
9.5,1.0,23,1,2,2,5,0xb2d5893bd
7807.49,1.0,14,2,2,3,7,0xb2d6bcab
80010.57,3.0,18,3,4,2,9,0xb2d1d4b9d
500028.2,3.0,5,4,4,3,11,0xb2d86846d
3561171.93,9.0,10,4,4,3,11,0x3b9b132ad
200000.0,2.0,1,3,3,4,10,0xb2da67cb
9459.29,1.0,92,2,2,1,5,0x3b9b2c3ed
12931.7,1.0,1,2,2,4,8,0xb2d944a9d
33421.47,1.0,3,2,2,4,8,0xb2da1163
20874.5,2.0,42,2,3,2,7,0xb2d5eb83d
50001.58,2.0,87,2,3,1,6,0xb2d8c7a4
5356.55,1.0,0,2,2,4,8,0xb2d6a171
5.14,1.0,15,1,2,3,6,0xb2d612a8
566592.3,3.0,11,4,4,3,11,0xb2d26bb4d
80125.76,3.0,11,3,4,3,10,0xb2d463a8d
354112.02,3.0,3,4,4,4,12,0xb2d88fe8
3.42,1.0,110,1,2,1,4,0xb2d42425d
311306.15,3.0,139,4,4,1,9,0xb2d1ae61d
50097.54,2.0,35,2,3,2,7,0xb2d41a67d
19.71,1.0,13,1,2,3,6,0xb2d1bb14
7.18,1.0,48,1,2,2,5,0xb2d97417
10000.21,2.0,94,2,3,1,6,0xb2d87bed
2119.64,1.0,184,1,2,1,4,0xb2d17f9f
221155.54,2.0,33,3,3,2,8,0xb2d5babdd
300082.47,2.0,20,3,3,2,8,0xb2d6941ed
50002.11,2.0,217,2,3,1,6,0xb2d715e6
177494.69,5.0,8,3,4,3,10,0xb2d0675bd
5060118.79,1.0,0,4,2,4,10,0xb2d45806
64892.73,1.0,19,3,2,2,7,0xb2d46aea
11880.31,1.0,12,2,2,3,7,0xb2d2e848
13005.54,2.0,74,2,3,1,6,0xb2d5b51ad
2723.33,1.0,0,1,2,4,7,0xb2d6575cd
3988140.31,37.0,1,4,4,4,12,0xb2d108ac
600000.66,4.0,1,4,4,4,12,0xb2d5e914d
1304269.21,7.0,92,4,4,1,9,0xb2d1923ed
300131.29,2.0,16,4,3,2,9,0xb2d9995b
5539.52,4.0,0,2,4,4,10,0xb2d092a1d
1158.12,1.0,184,1,2,1,4,0xb2d1c073d
170094.5,8.0,20,3,4,2,9,0xb2d4d128
170010.59,2.0,217,3,3,1,7,0xb2d18153d
10.61,1.0,31,1,2,2,5,0xb2d6b9b8
1.26,1.0,2,1,2,4,7,0xb2d15db8d
517000.0,11.0,4,4,4,4,12,0xb2d3c66ed
1435540.29,6.0,49,4,4,2,10,0xb2d7f4c0d
1020.28,1.0,92,1,2,1,4,0xb2d31983d
644012.8,5.0,5,4,4,3,11,0xb2d64849d
1302037.01,6.0,83,4,4,1,9,0xb2d53c86d
1134.33,1.0,1,1,2,4,7,0xb2d20852d
130002.64,3.0,6,3,4,3,10,0xb2d9e610
100004.22,2.0,231,3,3,1,7,0xb2d6ed06
50782.74,1.0,47,2,2,2,6,0xb2d58062
1902.56,3.0,184,1,4,1,6,0xb2d08857d
29.35,1.0,2,1,2,4,7,0xb2d14b2d
301065.74,2.0,50,4,3,2,9,0xb2d9d62d
460001.92,2.0,19,4,3,2,9,0xb2d9946c
53535.83,1.0,21,3,2,2,7,0xb2d34de9d
3.32,1.0,83,1,2,1,4,0xb2d23149
1601.82,1.0,101,1,2,1,4,0xb2d8c89d
500003.22,4.0,14,4,4,3,11,0xb2d2cb8ed
462022.25,3.0,21,4,4,2,10,0xb2d68dd3d
16029.89,2.0,39,2,3,2,7,0xb2d0ef57d
500000.24,3.0,5,4,4,3,11,0xb2d9fae6
10660.75,1.0,0,2,2,4,8,0xb2d88d10
100010.58,3.0,59,3,4,2,9,0xb2d0706cd
4646.73,1.0,184,2,2,1,5,0xb2d4517a
91.08,1.0,5,1,2,3,6,0xb2d3c611
1493.49,1.0,0,1,2,4,7,0xb2d22920
74.27,1.0,0,1,2,4,7,0xb2d2fdb2d
110001.16,3.0,92,3,4,1,8,0xb2d98171d
2328585.91,11.0,0,4,4,4,12,0xb2d286b5
38.98,1.0,19,1,2,2,5,0xb2d691a2d
8840.13,1.0,29,2,2,2,6,0xb2d91c2a
527.2,2.0,6,1,3,3,7,0xb2d3a367
51547.68,2.0,0,2,3,4,9,0xb2d64d05d
891215.33,1.0,0,4,2,4,10,0xb2d31e19
55003.85,2.0,53,3,3,2,8,0xb2d9a7e6
11559.94,1.0,184,2,2,1,5,0xb2d24978d
210008.87,2.0,49,3,3,2,8,0xb2d9d40e
102121.77,1.0,5,3,2,3,8,0xb2d5ce86d
203990.88,2.0,80,3,3,1,7,0xb2d46393
15413.2,1.0,0,2,2,4,8,0xb2d439de
4827.33,1.0,50,2,2,2,6,0xb2d8f84a
1804.22,1.0,17,1,2,2,5,0xb2d64cc4
100005.28,2.0,13,3,3,3,9,0xb2d95a71d
119597.53,3.0,3,3,4,4,11,0xb2d2751dd
12655.53,2.0,74,2,3,1,6,0xb2d5c6eed
1008.26,2.0,184,1,3,1,5,0xb2d38501d
771.18,2.0,47,1,3,2,6,0xb2d3a285
2589.07,1.0,92,1,2,1,4,0xb2d4ce80
60102.79,2.0,56,3,3,2,8,0xb2d57e20
65001.37,2.0,53,3,3,2,8,0xb2d9cd13
24075.8,5.0,13,2,4,3,9,0xb2d1a04ed
239622.56,3.0,6,3,4,3,10,0xb2d26284d
890028.24,2.0,256,4,3,1,8,0xb2d6c7bfd
51285.92,1.0,0,2,2,4,8,0xb2d201d8
290731.88,3.0,1,3,4,4,11,0xb2d15998d
10002.34,2.0,66,2,3,2,7,0xb2d5fea0
343012.51,3.0,14,4,4,3,11,0xb2d5ce0ad
108505.24,2.0,259,3,3,1,7,0xb2d2d083
500108.82,2.0,9,4,3,3,10,0xb2d6c06dd
124038.07,2.0,0,3,3,4,10,0xb2d6b77fd
63485.2,2.0,80,3,3,1,7,0xb2d48911d
193534.24,4.0,73,3,4,1,8,0xb2d13de6
1004.75,1.0,7,1,2,3,6,0xb2d6ed89
300102.28,3.0,2,4,4,4,12,0xb2d60baa
18.2,2.0,11,1,3,3,7,0xb2d12f82
9212.91,1.0,0,2,2,4,8,0xb2d5b7b5
13.34,1.0,35,1,2,2,5,0xb2d3bb67
89.3,1.0,59,1,2,2,5,0xb2d2afea
87601.02,5.0,0,3,4,4,11,0xb2d06c8f
970001.13,15.0,21,4,4,2,10,0xb2d24edbd
40619.12,1.0,15,2,2,3,7,0xb2d8f29bd
1114031.68,5.0,8,4,4,3,11,0xb2d8ce83d
686.99,1.0,13,1,2,3,6,0xb2d2f7dbd
100003.17,2.0,221,3,3,1,7,0xb2d6fd01
31715.56,9.0,0,2,4,4,10,0xb2d0d473d
1730.5,2.0,0,1,3,4,8,0xb2d0d471
104950.43,2.0,239,3,3,1,7,0xb2d52a0ad
10074.78,2.0,185,2,3,1,6,0xb2d5e499d
5996.03,1.0,10,2,2,3,7,0xb2d548d2
200124.55,2.0,30,3,3,2,8,0xb2d20b25d
114.01,1.0,12,1,2,3,6,0xb2d60b5c
402850.88,3.0,50,4,4,2,10,0xb2d68268
5018.02,1.0,184,2,2,1,5,0xb2d4164b
102469.36,2.0,1,3,3,4,10,0xb2d5f09c
700010.56,3.0,4,4,4,4,12,0xb2da281a
500898.37,2.0,8,4,3,3,10,0xb2d17eca
366050.56,3.0,0,4,4,4,12,0xb2d526b8d
4807.66,1.0,11,2,2,3,7,0xb2d9d9b3
425659.49,5.0,0,4,4,4,12,0x3b9acd53
100000.0,2.0,5,3,3,3,9,0xb2d94129
15069.92,1.0,3,2,2,4,8,0xb2d18191
732965.64,2.0,28,4,3,2,9,0xb2d6dfaad
443.86,1.0,5,1,2,3,6,0xb2d2e871
17470.88,1.0,0,2,2,4,8,0xb2d6a09ed
614796.06,2.0,80,4,3,1,8,0xb2d8ce5fd
1135.24,1.0,92,1,2,1,4,0xb2d5f007
3.93,1.0,75,1,2,1,4,0xb2d243dc
882867.12,8.0,0,4,4,4,12,0x3b9af20fd
627108.68,3.0,95,4,4,1,9,0xb2d54f0a
1700888.3,4.0,8,4,4,3,11,0xb2d63cfed
1528.51,1.0,184,1,2,1,4,0xb2d32bea
37401.94,3.0,11,2,4,3,9,0xb2d6008ed
950077.26,3.0,18,4,4,2,10,0xb2d57346d
405998.47,3.0,112,4,4,1,9,0xb2d8c4a2d
210747.15,2.0,56,3,3,2,8,0xb2d900d8
20273.33,3.0,11,2,4,3,9,0xb2d64d3cd
502253.85,6.0,11,4,4,3,11,0xb2d39733d
300006.36,2.0,292,3,3,1,7,0xb2d695bbd
122.12,1.0,25,1,2,2,5,0xb2d28761
805.69,1.0,0,1,2,4,7,0xb2d76394
100949.23,2.0,108,3,3,1,7,0xb2d5a732
245098.93,5.0,12,3,4,3,10,0xb2d3f914d
154038.32,2.0,13,3,3,3,9,0xb2d0db96d
498116.04,4.0,28,4,4,2,10,0xb2d41514
42.83,1.0,10,1,2,3,6,0xb2d5d1b1
197593.05,5.0,0,3,4,4,11,0xb2d330a3d
36658.71,1.0,184,2,2,1,5,0xb2d4081cd
4718.16,1.0,76,2,2,1,5,0xb2d20df9d
14.17,1.0,36,1,2,2,5,0xb2d5d95ed
179.7,1.0,5,1,2,3,6,0xb2d57786
1616.43,1.0,8,1,2,3,6,0xb2d8f5d1
344850.37,2.0,70,4,3,1,8,0xb2d9a2f6
10058.77,2.0,66,2,3,2,7,0xb2d40ea6d
185329.54,3.0,48,3,4,2,9,0xb2d55f44d
110134.85,2.0,92,3,3,1,7,0xb2d29b79d
2036982.99,5.0,34,4,4,2,10,0xb2d6bfc8d
22120.43,1.0,0,2,2,4,8,0xb2d6aa4ed
6023.42,1.0,0,2,2,4,8,0xb2d6d5a0
112356.75,1.0,5,3,2,3,8,0xb2d23179d
839.52,1.0,1,1,2,4,7,0xb2d4faa2
13595.31,1.0,19,2,2,2,6,0xb2d2e886d
2379477.94,5.0,0,4,4,4,12,0xb2d195a3d
269888.96,5.0,0,3,4,4,11,0xb2d06a80d
57626.83,3.0,3,3,4,4,11,0xb2d234b9
120030.28,2.0,167,3,3,1,7,0xb2d659ecd
32.84,1.0,3,1,2,4,7,0xb2d108cd
2.47,1.0,13,1,2,3,6,0xb2da07e1
277759.85,3.0,11,3,4,3,10,0xb2d28f52
9068.07,4.0,2,2,4,4,10,0x3b9b4872
39.88,1.0,23,1,2,2,5,0xb2d13ca2d
1172691.04,3.0,5,4,4,3,11,0xb2d39fd7
501777.77,2.0,15,4,3,3,10,0xb2d8f0f8
11705.1,1.0,0,2,2,4,8,0xb2d6af57d
21848.47,1.0,41,2,2,2,6,0xb2d32aee
15.06,1.0,3,1,2,4,7,0xb2d3107fd
204416.85,4.0,92,3,4,1,8,0xb2d0ad9a
43885.93,5.0,6,2,4,3,9,0xb2d88104d
2198.55,1.0,6,1,2,3,6,0xb2d2399ad
164.12,1.0,12,1,2,3,6,0xb2d245a1d
200745.4,2.0,41,3,3,2,8,0xb2d430d6
6536.31,1.0,169,2,2,1,5,0xb2d1f7f0d
1000000.0,2.0,14,4,3,3,10,0xb2d95e64
206808.12,2.0,108,3,3,1,7,0xb2d14854
1119.03,1.0,184,1,2,1,4,0xb2d3e93fd
1039.32,1.0,20,1,2,2,5,0xb2d19dc5d
4534.14,1.0,9,2,2,3,7,0xb2d42009
2420.06,1.0,19,1,2,2,5,0xb2d4eaeb
2134.22,1.0,82,1,2,1,4,0xb2d54b46
0.53,1.0,112,1,2,1,4,0xb2d950afd
19021.54,1.0,8,2,2,3,7,0xb2d48070
20025.72,2.0,31,2,3,2,7,0xb2d5fc52
61003.13,1.0,155,3,2,1,6,0xb2d2dc22d
4222.44,1.0,0,2,2,4,8,0xb2d53026d
30411.11,2.0,13,2,3,3,8,0xb2d564bfd
6380.46,1.0,116,2,2,1,5,0xb2d1ca87
73768.39,2.0,3,3,3,4,10,0xb2d31199
13.3,1.0,68,1,2,1,4,0xb2d627c6
755994.85,4.0,125,4,4,1,9,0x3b9b3326d
21090.26,1.0,213,2,2,1,5,0xb2d3cf06d
166936.25,2.0,137,3,3,1,7,0xb2d40e54d
424179.69,4.0,0,4,4,4,12,0xb2d1a63dd
100033.11,2.0,113,3,3,1,7,0xb2d63d04d
7490.93,1.0,92,2,2,1,5,0xb2d0f003
326077.53,1.0,0,4,2,4,10,0xb2d4104a
66.47,1.0,8,1,2,3,6,0xb2d55fc5
1885.05,1.0,152,1,2,1,4,0xb2d5559dd
106636.99,3.0,8,3,4,3,10,0xb2d066e7
700032.09,4.0,18,4,4,2,10,0xb2d961e4d
61428.63,1.0,33,3,2,2,7,0xb2d1c83dd
227539.05,10.0,15,3,4,3,10,0xb2d26232d
3492.07,1.0,92,2,2,1,5,0xb2d2800cd
49011.18,3.0,10,2,4,3,9,0xb2d0d8e7d
410361.23,2.0,143,4,3,1,8,0xb2d440e7d
380106.71,3.0,42,4,4,2,10,0xb2d5b9abd
50000.0,2.0,0,2,3,4,9,0xb2d97e81
533151.38,2.0,189,4,3,1,8,0xb2d40a18d
1000015.85,3.0,23,4,4,2,10,0xb2d86d13d
17080.75,1.0,2,2,2,4,8,0xb2d6e8cbd
303439.25,1.0,4,4,2,4,10,0xb2d1bc8b
1300000.0,5.0,0,4,4,4,12,0xb2d99425
507018.44,2.0,17,4,3,2,9,0xb2d5cf5dd
2748.59,1.0,184,1,2,1,4,0xb2d10779d
30000.32,2.0,53,2,3,2,7,0xb2d9d171
0.0,1.0,7,1,2,3,6,0xb2d3a811
183752.87,2.0,22,3,3,2,8,0xb2d26bd2
3031.85,1.0,292,2,2,1,5,0xb2d4ea31
7.0,1.0,36,1,2,2,5,0xb2d58ea0
100975.63,2.0,95,3,3,1,7,0xb2d569e5
103947.03,2.0,3,3,3,4,10,0xb2d5a59c
850000.02,2.0,66,4,3,2,9,0xb2d0cd15
464126.95,7.0,55,4,4,2,10,0xb2d10b63
3630.49,1.0,10,2,2,3,7,0xb2d934fb
210027.33,5.0,4,3,4,4,11,0xb2d56acf
128006.01,2.0,70,3,3,1,7,0x3b9b31e9d
11550.92,1.0,25,2,2,2,6,0xb2d6c310
2100.33,1.0,184,1,2,1,4,0xb2d2141bd
257660.46,5.0,19,3,4,2,9,0xb2d1096cd
943151.49,4.0,6,4,4,3,11,0xb2d59760d
37755.12,1.0,7,2,2,3,7,0xb2d90040
700010.55,4.0,16,4,4,2,10,0xb2d956ebd
50003.69,2.0,11,2,3,3,8,0xb2d959f2d
5226.09,1.0,15,2,2,3,7,0xb2d35051
3803.38,1.0,3,2,2,4,8,0xb2d42958d
16.5,1.0,89,1,2,1,4,0xb2d58b30
545000.58,13.0,3,4,4,4,12,0xb2d172e7d
500078.9,2.0,6,4,3,3,10,0xb2d4417cd
240000.0,2.0,12,3,3,3,9,0xb2d78b4dd
7.26,1.0,19,1,2,2,5,0xb2d641be
575756.42,11.0,97,4,4,1,9,0xb2d5a959d
15769.69,1.0,14,2,2,3,7,0xb2d4f177
3020005.83,11.0,4,4,4,4,12,0xb2d6bc98d
209.63,1.0,16,1,2,2,5,0xb2d12494
2706.02,1.0,1,1,2,4,7,0xb2d6c28cd
1136.27,1.0,0,1,2,4,7,0xb2d625b4
1137.51,1.0,184,1,2,1,4,0xb2d4ba8fd
10086.39,2.0,55,2,3,2,7,0xb2d5a28c
205000.0,6.0,3,3,4,4,11,0xb2d38562
3290.4,1.0,0,2,2,4,8,0xb2d5be44
402849.21,2.0,15,4,3,3,10,0xb2d414d5
1160016.04,4.0,37,4,4,2,10,0xb2d8d835d
7335.58,1.0,2,2,2,4,8,0xb2d6a017
200000.01,2.0,12,3,3,3,9,0xb2d9ebce
900000.62,4.0,183,4,4,1,9,0xb2d6ef0d
1221.41,2.0,0,1,3,4,8,0xb2d0b7e5
1985897.55,1.0,8,4,2,3,9,0xb2d8a804d
594.64,1.0,0,1,2,4,7,0xb2d8f6c2
2.96,1.0,146,1,2,1,4,0xb2d907ded
200002.11,3.0,27,3,4,2,9,0xb2d16c48d
5697.57,1.0,26,2,2,2,6,0xb2d33198d
1218123.45,12.0,0,4,4,4,12,0xb2d3a48b
3004.67,1.0,0,2,2,4,8,0xb2d57766d
10014.89,1.0,140,2,2,1,5,0xb2d8f11bd
121424.64,5.0,18,3,4,2,9,0xb2d0a76fd
201531.1,2.0,3,3,3,4,10,0xb2d6d542d
981.84,1.0,9,1,2,3,6,0xb2d38bbed
1798772.11,26.0,0,4,4,4,12,0x3b9af2a5d
12694.59,1.0,4,2,2,4,8,0xb2d29fc1d
500014.63,4.0,31,4,4,2,10,0xb2d6206ad
100017.58,2.0,74,3,3,1,7,0xb2d193b5
4002.07,1.0,36,2,2,2,6,0xb2d8063c
300089.35,3.0,39,3,4,2,9,0xb2d638d0d
155666.16,1.0,0,3,2,4,9,0xb2d6554ed
934.54,1.0,0,1,2,4,7,0xb2d57a50d
50632.64,1.0,15,2,2,3,7,0xb2d315c3d
19567.92,1.0,35,2,2,2,6,0xb2d65b1e
424390.64,4.0,63,4,4,2,10,0xb2d31791d
2700225.69,7.0,39,4,4,2,10,0xb2d4969cd
200000.84,3.0,22,3,4,2,9,0xb2d988e4
4291.5,1.0,0,2,2,4,8,0xb2d4ce25
10004.26,2.0,36,2,3,2,7,0xb2d56d14
169993.64,13.0,0,3,4,4,11,0xb2d5b0d3d
17.18,1.0,55,1,2,2,5,0xb2d9173fd
65600.12,3.0,0,3,4,4,11,0xb2d11c38
250007.92,2.0,69,3,3,1,7,0xb2d8e5c0
4011.9,1.0,92,2,2,1,5,0xb2d0f6a6d
565.29,1.0,9,1,2,3,6,0xb2d4b687
51632.43,2.0,74,2,3,1,6,0xb2d35d39d
2453444.29,8.0,16,4,4,2,10,0xb2d10504
400000.0,3.0,3,4,4,4,12,0xb2d9541b
137141.71,6.0,5,3,4,3,10,0xb2d16f1fd
3475.41,1.0,184,2,2,1,5,0xb2d105d7d
35123.75,2.0,40,2,3,2,7,0xb2d6136d
16419.31,1.0,10,2,2,3,7,0xb2d419d7d
53443.77,2.0,49,3,3,2,8,0xb2d38ccbd
4067.05,1.0,9,2,2,3,7,0xb2d606dbd
27500.12,5.0,4,2,4,4,10,0xb2da1bdd
1784927.62,11.0,6,4,4,3,11,0xb2d67ed7d
12701287.9,3.0,18,4,4,2,10,0xb2d2ea7c
854010.32,6.0,13,4,4,3,11,0xb2d2e861d
20293.97,3.0,70,2,4,1,7,0xb2d62eafd
266937.8,2.0,6,3,3,3,9,0xb2d5fea3d
480157.64,5.0,4,4,4,4,12,0xb2d153f4d
20886.57,1.0,0,2,2,4,8,0xb2d11ae9d
7824.29,1.0,9,2,2,3,7,0xb2d2ebb9d
50091.84,2.0,11,2,3,3,8,0xb2d7ceaa
863.22,1.0,0,1,2,4,7,0xb2d502a6
28739.58,2.0,12,2,3,3,8,0xb2d17599d
911.53,1.0,0,1,2,4,7,0xb2d90de9
393161.19,4.0,4,4,4,4,12,0xb2d3a8e0d
3238796.76,1.0,0,4,2,4,10,0xb2d904fad
106436.23,5.0,74,3,4,1,8,0xb2d58361d
0.85,1.0,4,1,2,4,7,0xb2d168ab
5757.98,5.0,92,2,4,1,7,0xb2d2c56e
1210170.61,9.0,27,4,4,2,10,0xb2d26910
42016.87,1.0,4,2,2,4,8,0xb2d5c25ed
3314.74,1.0,102,2,2,1,5,0xb2d416f7
0.21,1.0,73,1,2,1,4,0xb2d5a784d
500085.93,2.0,14,4,3,3,10,0xb2d1be5dd
266577.17,9.0,47,3,4,2,9,0xb2d58121d
6509.77,1.0,124,2,2,1,5,0xb2d3bbf2
134.7,1.0,124,1,2,1,4,0xb2d1897bd
500021.13,2.0,139,4,3,1,8,0xb2d6ebaa
462172.34,3.0,5,4,4,3,11,0xb2d50361d
3384.0,1.0,3,2,2,4,8,0xb2d91577
1465.26,1.0,9,1,2,3,6,0xb2d304bc
80065.76,2.0,70,3,3,1,7,0xb2d8d2efd
8.15,1.0,19,1,2,2,5,0xb2d941e0
248006.22,9.0,11,3,4,3,10,0xb2d2145ed
1914001.25,17.0,0,4,4,4,12,0xb2d0fb9b
113000.0,5.0,6,3,4,3,10,0xb2d5b385d
38047.87,1.0,184,2,2,1,5,0xb2d2a84fd
891000.0,5.0,1,4,4,4,12,0xb2d5a722
283949.02,3.0,165,3,4,1,8,0xb2d10d40
800136.76,6.0,11,4,4,3,11,0xb2d10bae
248054.62,3.0,60,3,4,2,9,0xb2d3c3bbd
201062.56,2.0,210,3,3,1,7,0xb2d6a8ebd
285079.02,6.0,18,3,4,2,9,0xb2d57d15d
37327.7,1.0,0,2,2,4,8,0xb2d356d7
3.28,1.0,81,1,2,1,4,0xb2d4c80dd
903839.92,8.0,11,4,4,3,11,0xb2d14e00d
600012.69,2.0,92,4,3,1,8,0xb2d64143d
601083.78,4.0,11,4,4,3,11,0xb2d310e8d
151222.58,2.0,5,3,3,3,9,0xb2d0fd3ad
20950.47,1.0,99,2,2,1,5,0xb2d15ea4d
1028203.5,4.0,4,4,4,4,12,0xb2d1c242d
2239.7,1.0,0,1,2,4,7,0xb2d2e887d
1740.81,1.0,184,1,2,1,4,0xb2d1a4f6d
52456.78,3.0,32,3,4,2,9,0xb2d193be
460000.0,3.0,6,4,4,3,11,0xb2d9f8f4
12864.99,1.0,2,2,2,4,8,0x3b9af005
1800159.58,2.0,3,4,3,4,11,0xb2d97988
32.48,1.0,8,1,2,3,6,0xb2d685a4
110739.35,4.0,0,3,4,4,11,0xb2d286a7d
1052184.67,6.0,2,4,4,4,12,0xb2d59a7d
260050.49,4.0,67,3,4,1,8,0xb2d691d6
1034635.37,8.0,0,4,4,4,12,0xb2d313edd
3028.44,1.0,6,2,2,3,7,0xb2d5d9d4d
110916.73,3.0,70,3,4,1,8,0xb2d67d29
36076.47,2.0,42,2,3,2,7,0xb2d5eda0d
177283.63,3.0,32,3,4,2,9,0xb2d2381dd
51780.48,2.0,70,2,3,1,6,0xb2d63b34d
339113.47,4.0,66,4,4,2,10,0xb2d593dbd
47969.26,1.0,41,2,2,2,6,0xb2d657add
380082.45,6.0,3,4,4,4,12,0x3b9b47f6d
240002.8,2.0,21,3,3,2,8,0xb2d5f2c1d
76289.69,1.0,113,3,2,1,6,0xb2d37cec
150434.05,3.0,14,3,4,3,10,0xb2d6d0bed
202240.94,2.0,60,3,3,2,8,0xb2d686f7
2675.58,1.0,0,1,2,4,7,0xb2d37c92d
100203.06,2.0,139,3,3,1,7,0xb2d3ad7f
40087.22,5.0,6,2,4,3,9,0xb2d186d8d
50251.76,1.0,14,2,2,3,7,0xb2d3e18dd
4.2,1.0,5,1,2,3,6,0xb2d548afd
10514.42,1.0,20,2,2,2,6,0xb2d4cf0bd
10204.81,1.0,1,2,2,4,8,0xb2d2c8dcd
2744.52,1.0,4,1,2,4,7,0xb2d2e9afd
40001.48,3.0,181,2,4,1,7,0xb2d68e9bd
1655.13,1.0,123,1,2,1,4,0xb2d41bbcd
206520.36,2.0,79,3,3,1,7,0xb2d5d44ed
155323.04,4.0,29,3,4,2,9,0xb2d5e70ad
210004.07,3.0,21,3,4,2,9,0xb2d95e62
20230.3,1.0,13,2,2,3,7,0xb2d78cc1
25927.25,1.0,4,2,2,4,8,0xb2d5c73dd
214229.93,2.0,38,3,3,2,8,0xb2d40f59
50000.8,6.0,27,2,4,2,8,0xb2d6488bd
13025.25,1.0,2,2,2,4,8,0xb2d69249d
191153.78,2.0,0,3,3,4,10,0xb2d5ae8cd
81353.77,5.0,20,3,4,2,9,0xb2d5eeff
30002.22,2.0,11,2,3,3,8,0xb2d959a8d
541026.25,3.0,18,4,4,2,10,0xb2d321a1d
1.37,2.0,0,1,3,4,8,0xb2d96020d
140079.29,3.0,25,3,4,2,9,0xb2d5bd6a
348.57,1.0,7,1,2,3,6,0xb2d6d74c
7814.99,1.0,106,2,2,1,5,0xb2d6bcabd
4832.66,1.0,257,2,2,1,5,0xb2d6a8d9
100003.17,2.0,186,3,3,1,7,0xb2d8693ad
4021.14,1.0,46,2,2,2,6,0xb2d21cc1
500000.0,2.0,28,4,3,2,9,0xb2d6b503d
501778.01,2.0,32,4,3,2,9,0xb2d70054
104278.88,2.0,11,3,3,3,9,0xb2d3ccb7d
1002.41,1.0,238,1,2,1,4,0xb2d6c142d
52687.4,2.0,147,3,3,1,7,0xb2d43a10d
170214.26,6.0,0,3,4,4,11,0xb2d3b471
92536.07,3.0,21,3,4,2,9,0xb2d3f49d
6473.42,1.0,171,2,2,1,5,0xb2d0c321d
1729.63,1.0,2,1,2,4,7,0xb2d6b4f4d
6.69,1.0,11,1,2,3,6,0xb2d472f0
433132.58,4.0,27,4,4,2,10,0xb2d3eea8d
1474183.74,4.0,1,4,4,4,12,0xb2d35f58d
541718.99,1.0,92,4,2,1,7,0xb2d17754d
1017.13,1.0,184,1,2,1,4,0xb2d0cb2ed
96.83,1.0,3,1,2,4,7,0xb2d8ec24
842.31,1.0,0,1,2,4,7,0xb2d56a9d
323732.34,4.0,39,4,4,2,10,0xb2d67aa2d
13.06,1.0,42,1,2,2,5,0xb2d5ceb6
69827.28,2.0,15,3,3,3,9,0xb2d365a9d
600255.86,5.0,49,4,4,2,10,0xb2d25a12d
603709.1,4.0,0,4,4,4,12,0xb2d5b016d
4254277.04,7.0,0,4,4,4,12,0xb2d1fb52d
2529.11,1.0,1,1,2,4,7,0xb2d302fad
14.96,1.0,6,1,2,3,6,0xb2d623fa
300015.44,2.0,60,3,3,2,8,0xb2d56ad7d
505417.58,2.0,70,4,3,1,8,0xb2d6dd51
41127.24,1.0,20,2,2,2,6,0xb2d24a21d
420072.08,2.0,66,4,3,2,9,0xb2d60408
302247.44,5.0,54,4,4,2,10,0xb2d23a47d
220538.83,2.0,184,3,3,1,7,0xb2d22544
50001.99,2.0,151,2,3,1,6,0xb2d2c398
14.87,1.0,66,1,2,2,5,0xb2d2bd32
1876.25,1.0,288,1,2,1,4,0xb2d3272ed
3541.31,1.0,40,2,2,2,6,0xb2d63f20
2338.58,1.0,25,1,2,2,5,0xb2d6ddee
12498.93,1.0,8,2,2,3,7,0xb2d8e73ed
1008.06,1.0,184,1,2,1,4,0xb2d33a1fd
100000.0,1.0,4,3,2,4,9,0xb2da6320
121528.33,2.0,39,3,3,2,8,0xb2d5ee5ad
1882.35,1.0,184,1,2,1,4,0xb2d176a8d
468408.52,1.0,52,4,2,2,8,0xb2d1ca6fd
18738.18,1.0,4,2,2,4,8,0xb2d8150a
479931.6,21.0,0,4,4,4,12,0xb2d0a4ded
83065.93,1.0,70,3,2,1,6,0xb2d3eee2d
5.08,1.0,41,1,2,2,5,0xb2d35a4bd
404018.35,2.0,235,4,3,1,8,0xb2d12b3bd
503553.49,3.0,62,4,4,2,10,0xb2d9144c
134153.12,3.0,13,3,4,3,10,0xb2d0e5bed
100462.37,1.0,4,3,2,4,9,0xb2d627b5d
18.87,1.0,0,1,2,4,7,0xb2d70876
24.59,1.0,14,1,2,3,6,0xb2d5cf72d
50264.97,1.0,57,2,2,2,6,0xb2d97449d
363893.46,4.0,95,4,4,1,9,0xb2d6ac48d
140.61,1.0,9,1,2,3,6,0xb2d50470
8.86,1.0,32,1,2,2,5,0xb2d9313b
3977.09,1.0,92,2,2,1,5,0xb2d36395d
52301.56,1.0,210,3,2,1,6,0xb2d2343ad
4.98,1.0,80,1,2,1,4,0xb2d65957d
1046044.91,3.0,62,4,4,2,10,0xb2d3a909d
226025.07,2.0,0,3,3,4,10,0xb2d6b240
4091.33,1.0,92,2,2,1,5,0xb2d33503d
1665.28,1.0,92,1,2,1,4,0xb2d0dba1d
501776.04,2.0,32,4,3,2,9,0xb2da0751
400000.72,3.0,1,4,4,4,12,0xb2d91493d
111921.54,7.0,1,3,4,4,11,0xb2d59ee7d
158592.66,3.0,0,3,4,4,11,0xb2d5aeae
28310.31,1.0,76,2,2,1,5,0xb2d28ab9
18679.15,1.0,0,2,2,4,8,0xb2d6b46e
4935.56,1.0,0,2,2,4,8,0xb2d6ab8cd
306242.33,4.0,20,4,4,2,10,0xb2d305cdd
66.06,1.0,8,1,2,3,6,0xb2d2de41
170034.35,3.0,133,3,4,1,8,0xb2d56854d
443475.5,8.0,60,4,4,2,10,0xb2d153e5
257687.64,5.0,4,3,4,4,11,0xb2d32f12d
10000.11,2.0,14,2,3,3,8,0xb2da382e
570012.05,2.0,208,4,3,1,8,0xb2d782d3
47343.31,1.0,0,2,2,4,8,0xb2d38801d
913065.51,2.0,1,4,3,4,11,0xb2d17bced
7064.61,1.0,4,2,2,4,8,0xb2d19f65
13749.63,3.0,0,2,4,4,10,0xb2d09c85d
580273.27,2.0,52,4,3,2,9,0xb2d90489d
109847.6,1.0,11,3,2,3,8,0xb2d41f2c
53.75,1.0,47,1,2,2,5,0xb2d390f7
103832.96,2.0,5,3,3,3,9,0xb2d5a454d
8297.9,1.0,62,2,2,2,6,0xb2d1b0d5d
100002.64,3.0,32,3,4,2,9,0xb2d9c43d
2626.78,1.0,9,1,2,3,6,0xb2d28a39
10000.32,2.0,185,2,3,1,6,0xb2d6abf6d
288007.04,4.0,15,3,4,3,10,0xb2d55777
5752.53,2.0,92,2,3,1,6,0xb2d42b9cd
300006.33,2.0,18,3,3,2,8,0xb2da2bc0
353534.83,2.0,3,4,3,4,11,0xb2d67e8cd
21922.92,1.0,17,2,2,2,6,0xb2d2fba8
220029.43,2.0,0,3,3,4,10,0xb2da1f6f
4000849.88,1.0,0,4,2,4,10,0xb2d75579d
500109.03,3.0,108,4,4,1,9,0xb2d35f30
337533.78,2.0,92,4,3,1,8,0xb2d204ad
296666.57,2.0,83,3,3,1,7,0xb2d5250b
400002.42,2.0,53,4,3,2,9,0xb2d5a5fbd
4061.21,1.0,92,2,2,1,5,0xb2d0f934d
2400.37,1.0,12,1,2,3,6,0xb2d2abcdd
713001.78,1.0,0,4,2,4,10,0xb2d2227f
110.74,1.0,74,1,2,1,4,0xb2d3d9c5d
20860.56,1.0,21,2,2,2,6,0xb2d6b775d
200022.47,3.0,11,3,4,3,10,0xb2d65ccbd
117.6,1.0,78,1,2,1,4,0xb2d5a9d6
57.95,1.0,2,1,2,4,7,0xb2d5e402
450101.19,6.0,24,4,4,2,10,0xb2d41054
1460041.42,3.0,80,4,4,1,9,0xb2d2fba5d
1801.3,2.0,184,1,3,1,5,0xb2d22eaed
200009.86,2.0,6,3,3,3,9,0xb2d61a7bd
113092.62,2.0,6,3,3,3,9,0xb2d0db1ad
5031.38,1.0,92,2,2,1,5,0xb2d3eeb8d
3766.41,1.0,92,2,2,1,5,0xb2d3fb28d
500076.1,2.0,11,4,3,3,10,0xb2d6cd12
23743.67,2.0,0,2,3,4,9,0xb2d5511ad
253001.58,6.0,3,3,4,4,11,0xb2d2a473
16461.84,1.0,41,2,2,2,6,0xb2d0907dd
12182.19,1.0,0,2,2,4,8,0xb2d2b6ce
10193.55,1.0,189,2,2,1,5,0xb2d5e3cbd
40.57,1.0,23,1,2,2,5,0xb2d96cb5
266.45,1.0,0,1,2,4,7,0xb2d3c515
310015.81,3.0,13,4,4,3,11,0xb2d39c81d
10.98,1.0,12,1,2,3,6,0xb2d95e7c
765.21,1.0,22,1,2,2,5,0xb2d564bbd
5519.45,1.0,6,2,2,3,7,0xb2d53d69d
550017.42,2.0,74,4,3,1,8,0xb2d99874
200004.22,3.0,87,3,4,1,8,0xb2d8c801
21010.99,3.0,48,2,4,2,8,0xb2d5a85c
203091.68,2.0,144,3,3,1,7,0xb2d5e356d
1863.64,1.0,184,1,2,1,4,0xb2d0c673d
100001.06,2.0,32,3,3,2,8,0xb2da033b
8136.32,1.0,18,2,2,2,6,0xb2d979a7
4267.81,1.0,69,2,2,1,5,0xb2d22d2e
99063.52,9.0,6,3,4,3,10,0xb2d401bf
33363.97,1.0,61,2,2,2,6,0xb2d39495d
102292.58,2.0,116,3,3,1,7,0xb2d57198
70244.36,9.0,48,3,4,2,9,0x3b9b47aad
54028.19,1.0,0,3,2,4,9,0xb2d78bbcd
303431.42,3.0,3,4,4,4,12,0xb2d1bedbd
669494.29,4.0,68,4,4,1,9,0xb2d4355ad
0.0,2.0,10,1,3,3,7,0xb2d3d6c3d
21279.96,1.0,3,2,2,4,8,0xb2d2b7c3
411.32,1.0,1,1,2,4,7,0xb2d26bb9
5546.03,1.0,92,2,2,1,5,0xb2d34c3ad
5.06,1.0,212,1,2,1,4,0xb2d28f8dd
94.19,1.0,19,1,2,2,5,0xb2d60acc
605.69,1.0,67,1,2,1,4,0xb2d6c22d
200715.43,2.0,41,3,3,2,8,0xb2d9aed0
362850.76,8.0,19,4,4,2,10,0xb2d0da1f
476362.7,14.0,0,4,4,4,12,0x3b9b0e32
30647.72,2.0,62,2,3,2,7,0xb2d60979
19432.42,1.0,4,2,2,4,8,0xb2da07e3
107064.53,2.0,125,3,3,1,7,0xb2d1f871d
520090.63,8.0,0,4,4,4,12,0xb2d43566d
2650.15,1.0,92,1,2,1,4,0xb2d5e2e7
109007.58,3.0,70,3,4,1,8,0xb2d0ed1bd
128.87,1.0,26,1,2,2,5,0xb2d929ef
294499.84,3.0,98,3,4,1,8,0xb2d11840d
215000.16,3.0,46,3,4,2,9,0xb2d80269
135.35,1.0,17,1,2,2,5,0xb2d98cda
75201.58,3.0,6,3,4,3,10,0xb2da26e0
80022.88,2.0,165,3,3,1,7,0xb2d5d24e
8026.0,1.0,29,2,2,2,6,0xb2d5c8cb
6092.41,1.0,84,2,2,1,5,0xb2d3a58b
5.83,1.0,1,1,2,4,7,0xb2d8fec4d
5261.91,1.0,67,2,2,1,5,0xb2d24332d
446280.89,4.0,0,4,4,4,12,0xb2d2fdbad
526557.73,6.0,42,4,4,2,10,0xb2d082b4d
5601400.45,6.0,11,4,4,3,11,0xb2d65a77d
134005.27,5.0,26,3,4,2,9,0xb2d14a26d
811165.21,6.0,8,4,4,3,11,0xb2d1838bd
25.28,1.0,5,1,2,3,6,0xb2d6af41
474122.13,3.0,93,4,4,1,9,0x3b9b3c7d
449.81,1.0,0,1,2,4,7,0xb2d5847b
12450.54,1.0,7,2,2,3,7,0xb2d1f256d
260448.96,2.0,9,3,3,3,9,0xb2d9432e
1.31,1.0,28,1,2,2,5,0xb2d9ff80
22.14,1.0,53,1,2,2,5,0xb2d90393d
1200094.03,3.0,11,4,4,3,11,0xb2d69084d
25.33,1.0,60,1,2,2,5,0xb2d9a138
7975.3,1.0,92,2,2,1,5,0xb2d19112d
3715.22,1.0,0,2,2,4,8,0xb2d8eb76
1925.68,1.0,171,1,2,1,4,0xb2d2dbcb
204548.46,1.0,92,3,2,1,6,0xb2d2345c
503552.47,2.0,62,4,3,2,9,0xb2d9bc37
400000.0,2.0,25,4,3,2,9,0xb2d94ae4
77025.5,1.0,2,3,2,4,9,0xb2d85e82
1369191.7,3.0,78,4,4,1,9,0xb2d91c0ad
5538.97,1.0,19,2,2,2,6,0xb2d147d4
43438.18,1.0,5,2,2,3,7,0xb2d682d2d
10000.32,2.0,73,2,3,1,6,0xb2d5718f
515014.91,5.0,11,4,4,3,11,0xb2d0b4c3d
405107.03,2.0,101,4,3,1,8,0xb2d8eaa1d
0.0,1.0,9,1,2,3,6,0xb2d6f51d
207826.89,2.0,282,3,3,1,7,0xb2d647c4d
1670363.54,5.0,56,4,4,2,10,0xb2d22634d
5023.69,1.0,92,2,2,1,5,0xb2d4dacbd
665.86,1.0,14,1,2,3,6,0xb2d23f88
10097.76,1.0,0,2,2,4,8,0xb2d509ac
5050.08,2.0,1,2,3,4,9,0xb2d31a7c
290013.32,2.0,228,3,3,1,7,0xb2d637b7d
116005.63,6.0,13,3,4,3,10,0xb2d58a69d
500000.0,2.0,8,4,3,3,10,0xb2da4f8c
60000.0,2.0,3,3,3,4,10,0xb2d9e1c3
402841.99,2.0,63,4,3,2,9,0xb2d9bacf
1.05,1.0,13,1,2,3,6,0xb2d9b96c
200050.25,3.0,62,3,4,2,9,0xb2d6a88bd
1357320.6,16.0,27,4,4,2,10,0xb2d067afd
100001.06,2.0,63,3,3,2,8,0xb2d63588
74.4,1.0,5,1,2,3,6,0xb2d5910e
119.58,1.0,8,1,2,3,6,0xb2d50a52
0.0,3.0,8,1,4,3,8,0xb2d104b7
367839.92,1.0,3,4,2,4,10,0xb2d1c0ce
50001.07,2.0,6,2,3,3,8,0xb2da46c7
157689.87,2.0,66,3,3,2,8,0xb2d5c34dd
8276.94,1.0,14,2,2,3,7,0xb2d8caffd
609278.36,4.0,95,4,4,1,9,0xb2d24387
662993.67,3.0,98,4,4,1,9,0xb2d29fc2d
1537.55,1.0,6,1,2,3,6,0xb2d60aa3
3.74,2.0,21,1,3,2,6,0xb2d43118
24057.4,1.0,10,2,2,3,7,0xb2d929e0
0.0,1.0,7,1,2,3,6,0xb2d699c8d
310066.35,4.0,0,4,4,4,12,0xb2d62f60
864.63,1.0,0,1,2,4,7,0xb2d61e39d
317032.21,4.0,0,4,4,4,12,0xb2d2767ed
200710.54,2.0,56,3,3,2,8,0xb2d9c91f
0.42,1.0,92,1,2,1,4,0xb2d34659
500029.49,2.0,14,4,3,3,10,0xb2d78c2bd
918040.33,4.0,11,4,4,3,11,0xb2d69b11d
38577.42,1.0,4,2,2,4,8,0xb2d35279
5054.58,1.0,92,2,2,1,5,0xb2d285fdd
47.5,1.0,90,1,2,1,4,0xb2d78641
1500068.18,3.0,77,4,4,1,9,0xb2d1c1c6
395544.62,2.0,32,4,3,2,9,0xb2d71748d
82284.5,4.0,0,3,4,4,11,0xb2d0f4a1d
600007.72,3.0,26,4,4,2,10,0xb2d55710
51935.5,2.0,231,2,3,1,6,0xb2d5389f
15039.29,4.0,12,2,4,3,9,0xb2d25d6b
960768.92,8.0,1,4,4,4,12,0xb2d5995bd
931780.88,3.0,55,4,4,2,10,0xb2d903cbd
2.75,1.0,14,1,2,3,6,0xb2d2c4b7d
9374.04,1.0,0,2,2,4,8,0xb2d6f691
500012.67,3.0,1,4,4,4,12,0xb2d6e199
35.91,1.0,48,1,2,2,5,0xb2d0bf19
151.83,4.0,0,1,4,4,9,0x3b9b1353d
1270085.94,2.0,93,4,3,1,8,0xb2d5df8cd
70380.27,1.0,4,3,2,4,9,0xb2d24e3fd
18453.39,1.0,39,2,2,2,6,0xb2d308d9
1180446.07,5.0,55,4,4,2,10,0xb2d2e81dd
735855.69,5.0,35,4,4,2,10,0xb2d0ce33d
1011.09,1.0,184,1,2,1,4,0xb2d182ff
563483.98,5.0,2,4,4,4,12,0xb2d129ba
408069.49,4.0,0,4,4,4,12,0xb2d8c596d
200024.64,2.0,139,3,3,1,7,0xb2d6294bd
1058.78,1.0,9,1,2,3,6,0xb2d448dc
22695.8,1.0,4,2,2,4,8,0xb2d6b4e6d
88066.86,1.0,5,3,2,3,8,0xb2d21322
350844.32,4.0,12,4,4,3,11,0xb2d18449d
204561.27,2.0,32,3,3,2,8,0xb2d5f437d
14083.12,4.0,0,2,4,4,10,0x3b9af24dd
218141.93,2.0,78,3,3,1,7,0xb2d3fa6b
723.46,1.0,0,1,2,4,7,0xb2d53b28
10185.08,2.0,4,2,3,4,9,0xb2d5b6f2
3782.53,1.0,7,2,2,3,7,0xb2d2e879d
55170.39,3.0,11,3,4,3,10,0xb2d066c0d
0.63,2.0,25,1,3,2,6,0xb2d24c8a
10363.6,4.0,184,2,4,1,7,0x3b9af20cd
1815.73,1.0,6,1,2,3,6,0xb2d62d4b
505.44,1.0,126,1,2,1,4,0xb2d5bfdd
449.57,1.0,1,1,2,4,7,0xb2d50ad1
10000.11,2.0,105,2,3,1,6,0xb2d95e77d
50334.1,2.0,113,2,3,1,6,0xb2d1fea7
30000.32,2.0,35,2,3,2,7,0xb2d9f5ae
2228.0,1.0,16,1,2,2,5,0xb2d3a688
315709.92,3.0,181,4,4,1,9,0xb2d3f6d2d
40001.51,4.0,15,2,4,3,9,0xb2d31192
4850.56,1.0,11,2,2,3,7,0xb2d2e8f2
4450829.32,6.0,1,4,4,4,12,0xb2d9ae94
100007.62,2.0,80,3,3,1,7,0xb2d3c463
70042.16,2.0,92,3,3,1,7,0xb2d32ccbd
332215.26,3.0,38,4,4,2,10,0xb2d3d513d
1073.96,1.0,92,1,2,1,4,0xb2d304e9d
270.63,1.0,49,1,2,2,5,0xb2d9b1b5
50000.53,2.0,55,2,3,2,7,0xb2d903e5d
4000.87,1.0,14,2,2,3,7,0xb2d9d07c
463049.82,9.0,0,4,4,4,12,0xb2d07de5d
450028.5,2.0,0,4,3,4,11,0xb2d6812e
1169.77,1.0,0,1,2,4,7,0xb2d3b464
6903.72,1.0,4,2,2,4,8,0xb2d965e1
600007.31,2.0,0,4,3,4,11,0xb2d6886d
9823.2,1.0,4,2,2,4,8,0xb2d963e4
3.33,1.0,83,1,2,1,4,0xb2d5aa23
0.11,1.0,13,1,2,3,6,0xb2d6a30a
301131.27,2.0,30,4,3,2,9,0xb2d9c2ec
205826.14,2.0,0,3,3,4,10,0xb2d65246
1562.34,1.0,111,1,2,1,4,0xb2d5529b
5058.96,1.0,184,2,2,1,5,0xb2d29c84
214.36,1.0,81,1,2,1,4,0xb2d65029
275.11,1.0,51,1,2,2,5,0xb2d27351
1909.78,1.0,36,1,2,2,5,0xb2d6be66
5570.52,1.0,32,2,2,2,6,0xb2d5a235d
50000.59,5.0,2,2,4,4,10,0xb2d53040
9.29,1.0,27,1,2,2,5,0xb2d69db4d
2194.51,1.0,7,1,2,3,6,0xb2d98161
251149.35,2.0,6,3,3,3,9,0xb2d51e9ad
4800.68,1.0,95,2,2,1,5,0xb2d3b2d8d
6811.84,1.0,184,2,2,1,5,0xb2d21d02d
401177.69,3.0,0,4,4,4,12,0xb2d2a15e
121.32,1.0,2,1,2,4,7,0xb2d2ed6a
20660.58,2.0,18,2,3,2,7,0xb2d623d1
40003.15,3.0,1,2,4,4,10,0xb2d5e76e
200518.57,5.0,1,3,4,4,11,0xb2d0d9f6d
720603.01,6.0,0,4,4,4,12,0xb2d2cbd8
105588.88,2.0,63,3,3,2,8,0xb2d165a8
101590.01,2.0,62,3,3,2,8,0xb2d5ddc9d
8017.29,1.0,9,2,2,3,7,0xb2d5980e
153759.61,2.0,136,3,3,1,7,0xb2d234e0d
7111.47,1.0,92,2,2,1,5,0xb2d0db89d
401424.83,3.0,30,4,4,2,10,0xb2d68862
50952.44,2.0,101,2,3,1,6,0xb2d64aa9d
113810.58,3.0,164,3,4,1,8,0xb2d193fa
800029.98,2.0,34,4,3,2,9,0xb2d9bfec
517519.01,5.0,8,4,4,3,11,0xb2d54c13d
301066.56,2.0,54,4,3,2,9,0xb2d9cd30
160921.23,3.0,4,3,4,4,11,0x3b9b0e2ad
0.28,1.0,4,1,2,4,7,0xb2d2025b
293.66,2.0,92,1,3,1,5,0x3b9ad543
1002415.73,6.0,8,4,4,3,11,0xb2d1683a
5624.74,1.0,13,2,2,3,7,0xb2d31b3cd
4124.5,1.0,105,2,2,1,5,0xb2d67d92
0.0,1.0,7,1,2,3,6,0xb2d92f69d
461988.6,8.0,0,4,4,4,12,0xb2d63153
593850.42,6.0,70,4,4,1,9,0xb2d176c1d
789.45,1.0,1,1,2,4,7,0xb2d625b4d
53.17,1.0,7,1,2,3,6,0xb2d214ebd
12.95,1.0,45,1,2,2,5,0xb2d244f6d
200001.46,2.0,4,3,3,4,10,0xb2d618a2
22065.83,2.0,3,2,3,4,9,0xb2da25b7
450004.75,2.0,52,4,3,2,9,0xb2d90e80d
50212.85,2.0,184,2,3,1,6,0xb2d0aba7d
650000.43,7.0,6,4,4,3,11,0xb2d580e7
210000.77,3.0,21,3,4,2,9,0xb2d5da7d
910972.97,3.0,0,4,4,4,12,0xb2d15325d
1431.47,1.0,0,1,2,4,7,0xb2d5d812
2001456.66,1.0,39,4,2,2,8,0xb2d97467
70876.79,1.0,184,3,2,1,6,0xb2d240c4
1038863.97,8.0,35,4,4,2,10,0xb2d11368
2250096.37,2.0,74,4,3,1,8,0xb2d60bfed
1537009.42,30.0,0,4,4,4,12,0xb2d3a2c0d
20149.76,2.0,17,2,3,2,7,0xb2d5b26a
91651.08,1.0,0,3,2,4,9,0xb2d6294ad
407920.52,6.0,0,4,4,4,12,0xb2d075e7d
395376.13,3.0,0,4,4,4,12,0xb2d1a400d
22560.98,3.0,0,2,4,4,10,0xb2d066a2
234168.38,5.0,4,3,4,4,11,0xb2d50ab8d
5020.63,1.0,122,2,2,1,5,0xb2d4f2ca
30547.05,1.0,184,2,2,1,5,0xb2d1174ed
6060.44,1.0,92,2,2,1,5,0xb2d1303d
484.4,4.0,5,1,4,3,8,0xb2d36718d
234806.29,8.0,7,3,4,3,10,0xb2d45cc1
367.0,1.0,0,1,2,4,7,0xb2d19e3d
0.0,1.0,8,1,2,3,6,0xb2d4b9bb
3090407.82,5.0,0,4,4,4,12,0xb2d0f6f6d
1338.74,1.0,92,1,2,1,4,0xb2d0fc41
23403.82,2.0,0,2,3,4,9,0xb2d50902
130391.59,3.0,53,3,4,2,9,0xb2d55af4
900019.0,2.0,45,4,3,2,9,0xb2d91993d
998.76,1.0,0,1,2,4,7,0xb2d5d10b
200418.53,1.0,160,3,2,1,6,0xb2d28e4cd
103111.45,2.0,60,3,3,2,8,0xb2d5625cd
818668.71,5.0,18,4,4,2,10,0xb2d17934d
178653.36,4.0,41,3,4,2,9,0xb2d4fbffd
30582.53,2.0,94,2,3,1,6,0xb2d4a75c
6199.41,1.0,9,2,2,3,7,0xb2d8f8ba
1039.95,1.0,92,1,2,1,4,0xb2d2d805d
17208.44,1.0,170,2,2,1,5,0xb2d41dfb
475897.62,6.0,5,4,4,3,11,0xb2d3bbd1d
4.82,1.0,1,1,2,4,7,0xb2d78353d
2547.93,1.0,76,1,2,1,4,0xb2d8c775d
1310.51,2.0,92,1,3,1,5,0x3b9b22fcd
161700.1,6.0,0,3,4,4,11,0xb2d2da33d
4103.21,1.0,6,2,2,3,7,0xb2d62669
1149556.34,3.0,92,4,4,1,9,0xb2d1898e
446857.81,3.0,0,4,4,4,12,0xb2d5b829
62132.57,2.0,0,3,3,4,10,0xb2d62932
200010.56,2.0,28,3,3,2,8,0xb2da04a4
30003.55,2.0,83,2,3,1,6,0xb2d612a1
200062.48,2.0,2,3,3,4,10,0xb2d60000d
3458.3,1.0,225,2,2,1,5,0xb2d20629
1169.98,1.0,92,1,2,1,4,0xb2d20446
170000.63,5.0,14,3,4,3,10,0xb2d0d979
31111.54,1.0,11,2,2,3,7,0xb2d61404d
965.85,1.0,0,1,2,4,7,0xb2d6bde3
1445.02,1.0,0,1,2,4,7,0xb2d54f39
30000.32,2.0,196,2,3,1,6,0xb2d7bd92
200000.0,2.0,6,3,3,3,9,0xb2d950ba
1016.89,1.0,184,1,2,1,4,0xb2d0d0d3
53755.88,3.0,0,3,4,4,11,0x3b9b1851d
20013.47,3.0,6,2,4,3,9,0xb2d5b7b1d
350003.69,3.0,25,4,4,2,10,0xb2d96f04d
5.49,3.0,3,1,4,4,9,0xb2d95983d
9487.74,1.0,29,2,2,2,6,0xb2d938d4
268152.28,3.0,123,3,4,1,8,0xb2d52b52d
1357006.53,9.0,22,4,4,2,10,0xb2d27e11d
45.77,2.0,84,1,3,1,5,0xb2d2e6f7
1009.03,1.0,92,1,2,1,4,0xb2d51b46d
2021.73,1.0,67,1,2,1,4,0xb2d926bed
3724.11,1.0,92,2,2,1,5,0xb2d079b9
470004.96,2.0,18,4,3,2,9,0xb2d14c3fd
300000.0,2.0,7,3,3,3,9,0xb2d9702c
972009.3,3.0,12,4,4,3,11,0xb2d39ae5d
190037.38,4.0,14,3,4,3,10,0xb2d1a8f5d
100728.76,3.0,2,3,4,4,11,0x3b9b3c84d
610757.46,3.0,52,4,4,2,10,0xb2d4df14d
3.22,1.0,18,1,2,2,5,0xb2d62ed0
13.01,1.0,22,1,2,2,5,0xb2d28ff3d
2206.92,27.0,0,1,4,4,9,0xb2d0ed86
50057.54,2.0,122,2,3,1,6,0xb2d26d29
602093.99,10.0,11,4,4,3,11,0xb2d0ca09d
180168.69,2.0,104,3,3,1,7,0xb2d15367
4778.62,1.0,0,2,2,4,8,0xb2d2123c
600710.42,5.0,9,4,4,3,11,0xb2d6faf6
60135.88,2.0,95,3,3,1,7,0xb2d62612
4306.69,1.0,29,2,2,2,6,0xb2d92d14
1242037.7,11.0,0,4,4,4,12,0xb2d4f56ad
10000.32,2.0,22,2,3,2,7,0xb2d78e83d
2400.83,1.0,14,1,2,3,6,0xb2d8cc8ed
11.51,1.0,18,1,2,2,5,0xb2d8d806
1911.7,1.0,92,1,2,1,4,0xb2d1b9d6d
2001113.61,1.0,54,4,2,2,8,0xb2d43405
2031.39,1.0,5,1,2,3,6,0xb2d53809
608.1,1.0,4,1,2,4,7,0xb2d39d9b
300000.0,2.0,6,3,3,3,9,0xb2da2c28
583327.58,3.0,86,4,4,1,9,0xb2d4ac16
160055.87,3.0,0,3,4,4,11,0xb2d58813d
53.84,1.0,24,1,2,2,5,0xb2d8fe32
200000.0,2.0,8,3,3,3,9,0xb2d0d369
63.33,1.0,80,1,2,1,4,0xb2d2e950
28940.58,1.0,184,2,2,1,5,0x3b9ade5f
8803.34,1.0,45,2,2,2,6,0xb2d8de57
330022.31,10.0,42,4,4,2,10,0xb2d517c0
300140.94,2.0,62,4,3,2,9,0xb2d1a81cd
430015.15,4.0,0,4,4,4,12,0xb2d69b00
5166.78,1.0,23,2,2,2,6,0xb2d69199d
1806.86,1.0,92,1,2,1,4,0xb2d25204
9075.29,2.0,0,2,3,4,9,0x3b9af25cd
10366.1,2.0,92,2,3,1,6,0x3b9b33dfd
80039.13,3.0,9,3,4,3,10,0xb2d1d651
210438.81,6.0,1,3,4,4,11,0xb2d61e16
99561.81,1.0,13,3,2,3,8,0xb2d34828d
372516.4,2.0,159,4,3,1,8,0xb2d5ef94d
405059.73,8.0,133,4,4,1,9,0xb2d0f803d
5145.52,1.0,197,2,2,1,5,0xb2d21951d
86.77,1.0,19,1,2,2,5,0xb2d926aed
100087.96,8.0,19,3,4,2,9,0xb2d1bbec
204824.15,2.0,14,3,3,3,9,0xb2d68c68
35943.67,1.0,0,2,2,4,8,0xb2d0d9b2
16331.57,1.0,0,2,2,4,8,0xb2d34c27
2030000.0,7.0,5,4,4,3,11,0xb2d973dbd
75427.59,1.0,2,3,2,4,9,0xb2d20f08d
10.53,1.0,5,1,2,3,6,0xb2d1bde5
9074.6,1.0,10,2,2,3,7,0xb2d6efbd
1098.48,1.0,0,1,2,4,7,0xb2d6b9f4
21046.17,2.0,151,2,3,1,6,0xb2d5e074d
1536000.0,14.0,0,4,4,4,12,0xb2d23307d
1207793.32,3.0,1,4,4,4,12,0xb2d1476bd
1082005.93,7.0,5,4,4,3,11,0xb2d1527b
940391.37,14.0,16,4,4,2,10,0xb2d07295
391.86,1.0,10,1,2,3,6,0xb2d9c62c
201877.54,3.0,10,3,4,3,10,0xb2d2e57ad
3001020.34,2.0,0,4,3,4,11,0x3b9b23c5
590089.22,6.0,20,4,4,2,10,0xb2d62ce7
11145.46,1.0,0,2,2,4,8,0xb2d5725dd
92115.92,2.0,49,3,3,2,8,0xb2d4907bd
564383.39,5.0,18,4,4,2,10,0xb2d52b42d
34083.49,1.0,0,2,2,4,8,0xb2d3a6d8
2019.02,1.0,10,1,2,3,6,0xb2d30c45d
439141.08,6.0,62,4,4,2,10,0xb2d06ced
338003.57,2.0,31,4,3,2,9,0xb2d93dc1d
8176.29,1.0,4,2,2,4,8,0xb2d835e3
376178.77,3.0,56,4,4,2,10,0xb2d16d68d
15146.33,1.0,15,2,2,3,7,0xb2d2777ed
570067.6,6.0,10,4,4,3,11,0xb2d80de7
405025.05,3.0,86,4,4,1,9,0xb2d4028ed
40.82,1.0,79,1,2,1,4,0xb2d6c09dd
611018.31,5.0,18,4,4,2,10,0xb2d0ab6d
200052.34,2.0,4,3,3,4,10,0xb2d6d88b
0.0,4.0,2,1,4,4,9,0xb2d0d4d9d
3233.4,1.0,92,2,2,1,5,0xb2d2ef75d
203602.12,2.0,5,3,3,3,9,0xb2d109afd
6753.19,1.0,139,2,2,1,5,0xb2d28547d
4336.1,1.0,92,2,2,1,5,0xb2d2c605
311.64,1.0,22,1,2,2,5,0xb2d21a74
76402.32,1.0,2,3,2,4,9,0xb2d18065d
63027.82,3.0,0,3,4,4,11,0xb2d55a2ad
155537.32,2.0,0,3,3,4,10,0xb2d5d99bd
4.15,2.0,173,1,3,1,5,0x3b9b4221
100005.13,37.0,24,3,4,2,9,0xb2d16bc4
20298.38,2.0,3,2,3,4,9,0xb2d380d7d
21244.63,1.0,1,2,2,4,8,0xb2d33154d
80001.45,4.0,98,3,4,1,8,0xb2d32196
96799.3,5.0,11,3,4,3,10,0xb2d6b34f
60050.23,1.0,16,3,2,2,7,0xb2d441bf
210.08,1.0,83,1,2,1,4,0xb2d6f65f
1015.2,1.0,92,1,2,1,4,0xb2d0ed1c
277.41,1.0,84,1,2,1,4,0xb2d5874ad
3745.17,1.0,0,2,2,4,8,0xb2d31dd0
6207.33,1.0,25,2,2,2,6,0xb2d93b78
101289.43,1.0,0,3,2,4,9,0xb2d91706
102108.45,3.0,45,3,4,2,9,0xb2d120a1
12486.85,1.0,2,2,2,4,8,0xb2d2b440d
527849.55,1.0,0,4,2,4,10,0xb2d3100d
2.33,1.0,0,1,2,4,7,0xb2d6922bd
5006.55,1.0,21,2,2,2,6,0xb2d64181
617.13,4.0,0,1,4,4,9,0x3b9b0e31d
23002.19,1.0,14,2,2,3,7,0xb2d91436d
2.67,1.0,18,1,2,2,5,0xb2d193ea
216.04,1.0,21,1,2,2,5,0xb2d91fe3d
75011.25,6.0,5,3,4,3,10,0xb2d5a0ddd
8543.8,1.0,10,2,2,3,7,0xb2d8db48
223276.68,3.0,3,3,4,4,11,0xb2d1a026
50150.53,1.0,14,2,2,3,7,0xb2d91781d
118744.56,3.0,48,3,4,2,9,0xb2d09d27
13.3,1.0,77,1,2,1,4,0xb2d6c0d8
163858.67,4.0,60,3,4,2,9,0xb2d13506d
416022.39,3.0,216,4,4,1,9,0xb2d42629
196603.82,2.0,6,3,3,3,9,0xb2d2e5ef
26015.92,2.0,74,2,3,1,6,0xb2d5e471d
40037.16,1.0,98,2,2,1,5,0xb2d95301d
10.38,1.0,1,1,2,4,7,0xb2d623ff
13000.85,3.0,4,2,4,4,10,0x3b9b46c8d
500000.0,2.0,20,4,3,2,9,0xb2da2b7f
453197.84,2.0,23,4,3,2,9,0xb2d8cffe
2782.1,1.0,21,1,2,2,5,0xb2d2894a
7145.11,1.0,2,2,2,4,8,0xb2d19bcc
0.15,1.0,6,1,2,3,6,0xb2d78cd2d
13128.89,1.0,0,2,2,4,8,0xb2d0d721d
463006.8,4.0,1,4,4,4,12,0xb2d5cb63d
15523.01,1.0,200,2,2,1,5,0xb2d63e18d
5258.11,1.0,92,2,2,1,5,0xb2d1341cd
500000.0,2.0,8,4,3,3,10,0xb2da4f76
1001.16,1.0,120,1,2,1,4,0xb2d91a95
57868.09,2.0,1,3,3,4,10,0xb2d65952d
300011.77,3.0,201,3,4,1,8,0xb2d4c23cd
69019.88,2.0,92,3,3,1,7,0xb2d08b30
500008.8,3.0,143,4,4,1,9,0xb2d1d917
80001.16,3.0,70,3,4,1,8,0xb2d9a4b9
17684.73,1.0,10,2,2,3,7,0xb2d3f733d
100367.45,4.0,0,3,4,4,11,0xb2d68d3ed
65493.43,1.0,0,3,2,4,9,0xb2d22036d
514956.97,2.0,118,4,3,1,8,0xb2d3db97
7185.89,1.0,184,2,2,1,5,0xb2d1374dd
246896.77,1.0,10,3,2,3,8,0xb2da1115
2.95,1.0,18,1,2,2,5,0xb2d17cb1d
6373.36,1.0,10,2,2,3,7,0xb2d568e0
200045.12,2.0,18,3,3,2,8,0xb2d8518e
2817.53,1.0,10,1,2,3,6,0xb2d78372
370029.71,5.0,11,4,4,3,11,0xb2d23491
63001.5,6.0,18,3,4,2,9,0xb2d63caad
50001.58,2.0,32,2,3,2,7,0xb2d9fd1f
800029.59,4.0,19,4,4,2,10,0xb2d176f2d
10.39,1.0,88,1,2,1,4,0xb2d265fcd
32121.26,1.0,9,2,2,3,7,0xb2d23caed
0.05,2.0,54,1,3,2,6,0xb2d5ccb6d
550239.7,3.0,14,4,4,3,11,0xb2d1ae94d
303369.38,1.0,13,4,2,3,9,0xb2d78bba
5130.42,1.0,3,2,2,4,8,0xb2d91a89
6437.79,1.0,274,2,2,1,5,0xb2d2d07cd
0.01,1.0,68,1,2,1,4,0xb2d10210
51.84,1.0,6,1,2,3,6,0xb2d60f64d
1126.55,1.0,184,1,2,1,4,0xb2d631bed
22171.46,3.0,0,2,4,4,10,0xb2d09dd6
23489.0,1.0,179,2,2,1,5,0xb2d2dc7b
1152.51,1.0,1,1,2,4,7,0xb2d1aea7
6.2,1.0,81,1,2,1,4,0xb2d5d3d5
1153582.39,6.0,22,4,4,2,10,0xb2d0bb50d
98.69,1.0,75,1,2,1,4,0xb2d95821
238.61,5.0,26,1,4,2,7,0xb2d19f41d
150040.7,3.0,129,3,4,1,8,0xb2d4153b
6183.04,1.0,4,2,2,4,8,0xb2d6e00ed
30004.64,2.0,74,2,3,1,6,0xb2d6586fd
80001.69,2.0,136,3,3,1,7,0xb2d5fe7dd
12256.56,1.0,31,2,2,2,6,0xb2d6be7f
110005.91,3.0,42,3,4,2,9,0xb2d9900e
40017.46,3.0,76,2,4,1,7,0xb2d5c35ed
6662.7,1.0,198,2,2,1,5,0xb2d4fb1d
110000.0,2.0,3,3,3,4,10,0xb2d97a51d
818723.3,3.0,60,4,4,2,10,0xb2d955a8d
1492.21,2.0,208,1,3,1,5,0x3b9b32c1d
177510.0,4.0,2,3,4,4,11,0xb2d0fcb1d
1505.16,1.0,92,1,2,1,4,0xb2d19838d
55307.21,1.0,7,3,2,3,8,0xb2d8ddeed
3361.54,1.0,2,2,2,4,8,0xb2d1185f
1754000.17,15.0,0,4,4,4,12,0xb2d18e61
93.23,1.0,4,1,2,4,7,0xb2d25cd8d
27.55,1.0,9,1,2,3,6,0xb2d21700
11900376.83,2.0,38,4,3,2,9,0xb2d92681
50001.58,2.0,41,2,3,2,7,0xb2d92123
180004.68,4.0,35,3,4,2,9,0xb2d4ef26
3696.51,1.0,2,2,2,4,8,0xb2d9038a
40003.58,3.0,11,2,4,3,9,0xb2d6950c
1505.56,1.0,184,1,2,1,4,0xb2d5210c
900048.63,4.0,0,4,4,4,12,0xb2d63645d
246008.33,3.0,41,3,4,2,9,0xb2d6cc62d
200031.82,2.0,125,3,3,1,7,0xb2d189c6
832793.57,3.0,31,4,4,2,10,0xb2d609c9d
256336.31,7.0,1,3,4,4,11,0x3b9b45cdd
742.1,1.0,0,1,2,4,7,0xb2d6b550
20331.04,2.0,6,2,3,3,8,0xb2d60305d
140014.43,3.0,4,3,4,4,11,0xb2d5e4cf
958462.44,6.0,21,4,4,2,10,0xb2d7013fd
5433.61,1.0,3,2,2,4,8,0xb2d2c48fd
2.26,1.0,48,1,2,2,5,0xb2d987e3
7.17,1.0,60,1,2,2,5,0xb2d28ff0
301182.18,4.0,0,4,4,4,12,0xb2d51e9fd
200710.42,2.0,33,3,3,2,8,0xb2da0378
4371.89,1.0,52,2,2,2,6,0xb2d26684d
3399.62,1.0,3,2,2,4,8,0xb2d22b1bd
346.91,1.0,15,1,2,3,6,0xb2d2725a
82382.17,1.0,17,3,2,2,7,0xb2d4f6b2
4419.43,1.0,92,2,2,1,5,0xb2d262d0
6049.87,1.0,13,2,2,3,7,0xb2d38caf
69001.46,2.0,87,3,3,1,7,0xb2d288a3
200714.75,2.0,20,3,3,2,8,0xb2d904c5d
15431.62,1.0,127,2,2,1,5,0xb2d0d268
120510.18,6.0,0,3,4,4,11,0xb2d09174d
379005.98,13.0,5,4,4,3,11,0xb2d3099f
54.63,1.0,63,1,2,2,5,0xb2d58f15
76139.94,3.0,60,3,4,2,9,0xb2d0fab1d
602.81,3.0,0,1,4,4,9,0xb2d067e4d
370005.23,3.0,9,4,4,3,11,0xb2d2dbcd
16057.97,1.0,24,2,2,2,6,0xb2d79024
152028.93,3.0,8,3,4,3,10,0xb2d29b8e
0.48,1.0,47,1,2,2,5,0xb2d8f9fe
871775.71,3.0,1,4,4,4,12,0xb2d60e26
1057.22,1.0,64,1,2,2,5,0xb2d2fb5fd
42001.34,2.0,11,2,3,3,8,0xb2d406dd
68045.27,3.0,12,3,4,3,10,0xb2d43cfdd
100380.01,9.0,8,3,4,3,10,0xb2d59d61d
97.97,1.0,8,1,2,3,6,0xb2d4db78
120005.28,3.0,40,3,4,2,9,0xb2d91fbbd
814079.38,10.0,18,4,4,2,10,0xb2d40fcfd
107656.05,2.0,20,3,3,2,8,0xb2d166c1d
165157.36,4.0,6,3,4,3,10,0xb2d55e2dd
20273.79,1.0,92,2,2,1,5,0xb2d0dad8d
13554323.15,9.0,18,4,4,2,10,0xb2d0a1e9
4030.05,1.0,9,2,2,3,7,0xb2d43ad5
455084.06,5.0,1,4,4,4,12,0xb2d43a88d
2181179.26,3.0,0,4,4,4,12,0xb2d44c2b
602526.05,2.0,19,4,3,2,9,0xb2d9386ad
6139.54,1.0,169,2,2,1,5,0xb2d1de5cd
200006.34,3.0,6,3,4,3,10,0xb2d8de26d
500000.0,2.0,1,4,3,4,11,0xb2d97fedd
3.69,1.0,1,1,2,4,7,0xb2d12ba8
285479.56,3.0,5,3,4,3,10,0xb2d419c5
661861.46,3.0,6,4,4,3,11,0xb2d30997
289096.99,5.0,25,3,4,2,9,0xb2d18438d
200001.71,2.0,3,3,3,4,10,0xb2d90f56d
9512.28,1.0,9,2,2,3,7,0xb2d8b27bd
3583.66,1.0,19,2,2,2,6,0xb2d2929ad
81053.49,9.0,0,3,4,4,11,0x3b9b25b5
1487.63,2.0,184,1,3,1,5,0x3b9b258ad
8321.75,18.0,63,2,4,2,8,0xb2d204b7d
37183.03,1.0,20,2,2,2,6,0xb2d5897dd
352176.36,3.0,42,4,4,2,10,0xb2d3fb41d
200031.32,2.0,5,3,3,3,9,0xb2d81e73d
1147103.32,9.0,2,4,4,4,12,0xb2d14c02
1000000.0,4.0,0,4,4,4,12,0xb2d979f7d
98.56,1.0,24,1,2,2,5,0xb2d29e4f
924003.61,8.0,67,4,4,1,9,0xb2d5a4c9d
207008.11,5.0,18,3,4,2,9,0xb2d25bc1
1000000.0,1.0,0,4,2,4,10,0xb2da613f
992949.6,9.0,1,4,4,4,12,0xb2d3f459
334.81,1.0,72,1,2,1,4,0xb2d443bf
11567.49,1.0,39,2,2,2,6,0xb2d38019
132003.18,4.0,40,3,4,2,9,0xb2d1f430d
202128.08,2.0,80,3,3,1,7,0xb2d6096b
100012.65,2.0,39,3,3,2,8,0xb2d9c239
30039.78,1.0,41,2,2,2,6,0xb2d6e69bd
3625.29,1.0,210,2,2,1,5,0xb2d0b2b1d
1.02,1.0,10,1,2,3,6,0xb2d9a5df
293.17,1.0,21,1,2,2,5,0xb2d3aac7
400008.57,2.0,21,4,3,2,9,0xb2d9410dd
620833.49,7.0,52,4,4,2,10,0xb2d0a6e2d
7749.35,3.0,0,2,4,4,10,0xb2d210b8
1790.02,1.0,92,1,2,1,4,0xb2d0d68bd
1051.41,1.0,14,1,2,3,6,0xb2d8ff0ad
425059.95,7.0,45,4,4,2,10,0xb2d1e042
1175.62,1.0,184,1,2,1,4,0xb2d36898d
8472.56,1.0,0,2,2,4,8,0xb2d0cfcfd
18031.73,2.0,184,2,3,1,6,0x3b9b18fd
103413.1,1.0,0,3,2,4,9,0xb2d591e9
28.94,1.0,0,1,2,4,7,0xb2d41ce4
974048.74,3.0,1,4,4,4,12,0xb2d0d959
316436.67,3.0,40,4,4,2,10,0xb2d441d6
100081.85,4.0,63,3,4,2,9,0xb2d0c6fd
122134.61,2.0,73,3,3,1,7,0xb2d32af2
120089.63,5.0,0,3,4,4,11,0xb2d22536
170023.81,2.0,143,3,3,1,7,0xb2d4c092d
445.53,1.0,26,1,2,2,5,0xb2d6e959
300692.12,3.0,10,4,4,3,11,0xb2d2cbfbd
63.29,1.0,75,1,2,1,4,0xb2d607e6d
2121.25,1.0,0,1,2,4,7,0xb2d256d3d
280000.0,6.0,0,3,4,4,11,0xb2d15abd
35569.29,2.0,3,2,3,4,9,0xb2d5f367d
20005.13,2.0,179,2,3,1,6,0xb2d5f6ec
366.46,1.0,75,1,2,1,4,0xb2d4ec7a
1207694.7,5.0,0,4,4,4,12,0xb2d54b42
174.9,1.0,25,1,2,2,5,0xb2d1d5c9d
408249.06,6.0,20,4,4,2,10,0xb2d27fb3d
2004.29,1.0,4,1,2,4,7,0xb2d5f000d
13636.87,1.0,15,2,2,3,7,0xb2d24055
1155.56,1.0,184,1,2,1,4,0xb2d17f57d
61000.72,3.0,14,3,4,3,10,0xb2d0dda4
11172.36,1.0,0,2,2,4,8,0xb2d41df1
78.46,2.0,64,1,3,2,6,0xb2d23795d
100101.11,2.0,53,3,3,2,8,0xb2d9d0e4
505551.23,5.0,12,4,4,3,11,0xb2d37855d
411593.47,7.0,3,4,4,4,12,0xb2d5ea53
12144.92,1.0,2,2,2,4,8,0xb2d8ce86
1578042.61,16.0,0,4,4,4,12,0xb2d14e1fd
11.26,2.0,41,1,3,2,6,0xb2d07766d
50058.07,2.0,48,2,3,2,7,0xb2d346e0
10002.22,2.0,32,2,3,2,7,0xb2d8d9ec
237296.59,6.0,14,3,4,3,10,0xb2d5bce6d
4691.82,1.0,3,2,2,4,8,0xb2d4db68
51501.14,1.0,95,2,2,1,5,0xb2d6564ed
64001.67,5.0,3,3,4,4,11,0xb2d177ff
772345.14,7.0,3,4,4,4,12,0x3b9b4415d
72841.48,2.0,92,3,3,1,7,0xb2d44032d
307749.41,2.0,167,4,3,1,8,0xb2d0c5e3d
31091.45,2.0,27,2,3,2,7,0xb2d5f0fb
53193.98,1.0,1,3,2,4,9,0xb2d10cb0
309070.51,2.0,0,4,3,4,11,0xb2d11266
231421.16,3.0,0,3,4,4,11,0xb2d1a90e
200002.22,2.0,0,3,3,4,10,0xb2d93f3a
3027.86,1.0,7,2,2,3,7,0xb2d42b1e
2013.9,1.0,58,1,2,2,5,0xb2d56a81d
2820335.87,5.0,0,4,4,4,12,0xb2d6ed3dd
2013.67,1.0,184,1,2,1,4,0xb2d0d205d
1003.79,1.0,92,1,2,1,4,0xb2d24b81
3685.42,1.0,9,2,2,3,7,0xb2d3b139
771.78,1.0,0,1,2,4,7,0xb2d34d4e
463729.68,4.0,158,4,4,1,9,0xb2d21bdfd
11000.2,3.0,6,2,4,3,9,0xb2d60e4fd
810033.3,9.0,10,4,4,3,11,0xb2d630f6d
4775.17,1.0,132,2,2,1,5,0xb2d30287d
179.95,1.0,6,1,2,3,6,0xb2d33e0b
403086.67,5.0,27,4,4,2,10,0xb2d59652d
180260.81,1.0,11,3,2,3,8,0xb2d1bb93d
1.23,1.0,20,1,2,2,5,0xb2d8d0e1
564.16,1.0,21,1,2,2,5,0xb2d31e99
11105.59,1.0,14,2,2,3,7,0xb2d7f06fd
40049.55,3.0,164,2,4,1,7,0xb2d602cb
167423.03,4.0,80,3,4,1,8,0xb2d1bfcad
225375.44,3.0,83,3,4,1,8,0xb2d0e7cdd
410955.47,5.0,2,4,4,4,12,0xb2d93363
957000.56,7.0,2,4,4,4,12,0xb2d1f7fe
12003.85,1.0,18,2,2,2,6,0xb2d5d7a8
1222.14,1.0,92,1,2,1,4,0xb2d3b8f4d
242497.93,6.0,0,3,4,4,11,0xb2d38398d
320075.3,4.0,11,4,4,3,11,0xb2d30589d
1616.96,1.0,99,1,2,1,4,0xb2d2395c
20169.18,2.0,2,2,3,4,9,0xb2d16abcd
150003.17,2.0,18,3,3,2,8,0xb2da2bb1
56265.95,3.0,136,3,4,1,8,0xb2d53eca
1272446.69,8.0,19,4,4,2,10,0xb2d26adf
500052.13,2.0,20,4,3,2,9,0xb2d98a59
381902.07,2.0,92,4,3,1,8,0xb2d687ded
1737.32,1.0,0,1,2,4,7,0xb2d57f3b
200027.45,2.0,53,3,3,2,8,0xb2d95b78d
741.09,1.0,53,1,2,2,5,0xb2d3bd01d
226989.11,5.0,39,3,4,2,9,0xb2d0dcd0d
350015.8,2.0,18,4,3,2,9,0xb2d2047bd
661.46,1.0,12,1,2,3,6,0xb2d649d1d
1791.3,1.0,147,1,2,1,4,0xb2d12aa2d
100004.22,2.0,83,3,3,1,7,0xb2d8cea9d
4025.09,1.0,10,2,2,3,7,0xb2d952c4
10000.0,2.0,92,2,3,1,6,0xb2d622e3d
600005.0,2.0,14,4,3,3,10,0xb2d6f78ed
22700.96,2.0,0,2,3,4,9,0xb2d9919f
10606.51,1.0,0,2,2,4,8,0xb2d0d7d1d
1000474.11,2.0,139,4,3,1,8,0xb2d4a382d
313056.94,2.0,0,4,3,4,11,0xb2d5041fd
1747.66,1.0,95,1,2,1,4,0xb2d62fc9d
350000.0,2.0,22,4,3,2,9,0xb2da209f
250073.46,2.0,21,3,3,2,8,0xb2d59d13d
1325.24,2.0,92,1,3,1,5,0xb2d0b37cd
200710.43,2.0,42,3,3,2,8,0xb2d9eaa4
18.47,1.0,60,1,2,2,5,0xb2d60142d
500011.62,2.0,90,4,3,1,8,0xb2d89ed5
12036.87,2.0,94,2,3,1,6,0xb2d12fadd
25074.76,1.0,92,2,2,1,5,0xb2d6142c
200002.11,2.0,74,3,3,1,7,0xb2d99fa8
1065.3,1.0,191,1,2,1,4,0xb2d2d2eb
1389.08,2.0,92,1,3,1,5,0xb2d086e1d
3481.76,1.0,0,2,2,4,8,0xb2d8027e
68140.59,2.0,216,3,3,1,7,0xb2d1c10dd
32077.12,1.0,14,2,2,3,7,0xb2d941ad
503557.69,2.0,43,4,3,2,9,0xb2d62128
45247.06,1.0,5,2,2,3,7,0xb2d47390
606021.21,10.0,13,4,4,3,11,0xb2d12137d
65002.74,2.0,195,3,3,1,7,0xb2d69db1d
81817.04,3.0,179,3,4,1,8,0xb2d47e09d
330013.3,4.0,6,4,4,3,11,0xb2d9b74a
32434.4,1.0,0,2,2,4,8,0xb2d3490ed
4327.06,1.0,9,2,2,3,7,0xb2d2e4be
4406.0,1.0,1,2,2,4,8,0xb2d8ef7e
33208.5,1.0,19,2,2,2,6,0xb2d442b7
61.22,1.0,20,1,2,2,5,0xb2d683ad
1007.45,1.0,92,1,2,1,4,0xb2d37161d
500000.02,2.0,19,4,3,2,9,0xb2d8d757d
578005.05,4.0,0,4,4,4,12,0xb2d62a0dd
7524.73,1.0,280,2,2,1,5,0xb2d4140c
20000.21,2.0,21,2,3,2,7,0xb2da2065
123112.68,2.0,2,3,3,4,10,0xb2d913de
18.47,1.0,31,1,2,2,5,0xb2d96da2
53916.2,2.0,0,3,3,4,10,0xb2d3ce14
136.48,1.0,10,1,2,3,6,0xb2d9d745
5876.74,1.0,8,2,2,3,7,0xb2d34816
35.25,1.0,9,1,2,3,6,0xb2d7072e
292040.78,10.0,0,3,4,4,11,0xb2d3acd8d
5977.9,1.0,113,2,2,1,5,0xb2d37195
1223.68,1.0,132,1,2,1,4,0xb2d1f6f2
110005.7,3.0,27,3,4,2,9,0xb2da0717
620096.97,6.0,27,4,4,2,10,0xb2d5487a
8140.92,1.0,47,2,2,2,6,0xb2d2e9fa
363374.34,3.0,13,4,4,3,11,0xb2d06243
1430032.33,7.0,18,4,4,2,10,0xb2d20c03
61.86,1.0,41,1,2,2,5,0xb2d2bd98
12905.58,1.0,29,2,2,2,6,0xb2d6adef
166877.4,4.0,0,3,4,4,11,0xb2d1a3e6
1250023.22,4.0,6,4,4,3,11,0xb2d607a0d
80001.15,4.0,32,3,4,2,9,0xb2d92671
67107.85,1.0,0,3,2,4,9,0xb2d25ed6d
51270.79,2.0,108,2,3,1,6,0xb2d1a9efd
53018.12,2.0,74,3,3,1,7,0xb2d4019bd
1030.31,1.0,4,1,2,4,7,0xb2d4f69bd
27.77,1.0,250,1,2,1,4,0xb2d589a2d
51628.76,6.0,0,2,4,4,10,0xb2d28df1d
25187.16,1.0,0,2,2,4,8,0xb2d67ec0
31089.81,2.0,5,2,3,3,8,0xb2d61549d
200421.64,2.0,13,3,3,3,9,0xb2d8cb6bd
552.27,1.0,0,1,2,4,7,0xb2d1dac2d
51942.94,2.0,0,2,3,4,9,0xb2d12456
450139.03,5.0,6,4,4,3,11,0xb2d0705cd
5205493.57,5.0,3,4,4,4,12,0xb2d28743
14120.19,1.0,9,2,2,3,7,0xb2d3ae68d
1832635.06,4.0,27,4,4,2,10,0xb2d1453a
6763303.18,20.0,2,4,4,4,12,0x3b9ae3f0
26.92,1.0,96,1,2,1,4,0xb2d5be09d
327663.57,3.0,188,4,4,1,9,0xb2d16f8ad
36733.75,3.0,1,2,4,4,10,0xb2d6558ed
833570.64,7.0,0,4,4,4,12,0xb2d59939
0.15,1.0,0,1,2,4,7,0xb2d2e73a
180733.8,2.0,25,3,3,2,8,0xb2d3dc37d
203588.95,3.0,39,3,4,2,9,0xb2d1856a
300689.12,2.0,11,4,3,3,10,0xb2d559e5d
206970.68,1.0,1,3,2,4,9,0xb2d6ea83
83381.09,3.0,76,3,4,1,8,0xb2d49f85
399.18,1.0,12,1,2,3,6,0xb2d6e24c
266258.45,7.0,7,3,4,3,10,0xb2d32638
11352.38,1.0,7,2,2,3,7,0xb2d570de
1016.37,1.0,92,1,2,1,4,0xb2d232cd
2505.75,1.0,28,1,2,2,5,0xb2d9becc
9005.27,1.0,8,2,2,3,7,0xb2d6a1f2
602204.51,3.0,50,4,4,2,10,0xb2d27d9a
609758.91,9.0,11,4,4,3,11,0xb2d3a2b2d
11811.4,1.0,184,2,2,1,5,0xb2d285e3d
3507.92,1.0,6,2,2,3,7,0xb2d5a713d
139871.57,1.0,2,3,2,4,9,0xb2d6565b
160082.97,3.0,14,3,4,3,10,0xb2d65b00
10000.11,2.0,18,2,3,2,7,0xb2d940fed
1226330.68,7.0,61,4,4,2,10,0xb2d1df2d
279107.67,5.0,10,3,4,3,10,0xb2d0db90
2557.42,2.0,19,1,3,2,6,0xb2d1e823
10173.53,1.0,184,2,2,1,5,0xb2d1bddcd
1020104.67,7.0,6,4,4,3,11,0xb2d5755ad
1020.29,1.0,184,1,2,1,4,0xb2d07c24d
27888.14,1.0,0,2,2,4,8,0xb2d18070d
665176.0,3.0,10,4,4,3,11,0xb2d3eb5ad
301973.39,3.0,1,4,4,4,12,0xb2d26e16
2518.14,1.0,0,1,2,4,7,0xb2d9069d
16658.33,2.0,17,2,3,2,7,0xb2d80f23d
17175.15,1.0,8,2,2,3,7,0xb2d68cd6
100034.72,2.0,5,3,3,3,9,0xb2d610b5
2246.25,1.0,0,1,2,4,7,0xb2d2e668
20046.88,2.0,117,2,3,1,6,0xb2d658ee
200014.79,5.0,32,3,4,2,9,0xb2d410fad
205689.36,2.0,125,3,3,1,7,0xb2d6de9ad
3518.12,1.0,1,2,2,4,8,0xb2d351fb
497954.68,2.0,7,4,3,3,10,0xb2d6e9e3d
712.22,1.0,84,1,2,1,4,0x3b9aee9b
260008.24,3.0,35,3,4,2,9,0xb2d0803d
2048.99,2.0,176,1,3,1,5,0xb2d079bc
210077.8,3.0,47,3,4,2,9,0xb2d2d955d
367465.71,3.0,8,4,4,3,11,0xb2d17046d
1416.42,1.0,184,1,2,1,4,0xb2d25c9bd
10403.4,1.0,92,2,2,1,5,0xb2d28c6bd
96805.88,1.0,202,3,2,1,6,0xb2d2ed66d
1070.86,1.0,10,1,2,3,6,0xb2d9d875
234581.77,3.0,0,3,4,4,11,0xb2d1ea67d
32539.33,1.0,92,2,2,1,5,0xb2d2d9b5
10170.92,2.0,185,2,3,1,6,0xb2d5ea89d
154.76,1.0,48,1,2,2,5,0xb2d5714e
20045.12,2.0,31,2,3,2,7,0xb2d5f111d
922.85,1.0,10,1,2,3,6,0xb2d50f1b
30369.41,4.0,3,2,4,4,10,0xb2d5bbe4
250002.13,3.0,21,3,4,2,9,0xb2d90f48d
600150.0,3.0,1,4,4,4,12,0xb2d4f3f9
7104.55,1.0,6,2,2,3,7,0xb2d97cd1
80082.95,2.0,117,3,3,1,7,0xb2d518bcd
340182.5,2.0,56,4,3,2,9,0xb2d5a952
803643.24,5.0,6,4,4,3,11,0xb2d60960d
543.62,3.0,30,1,4,2,7,0xb2d184a4d
280000.0,2.0,3,3,3,4,10,0xb2d977de
70000.74,2.0,18,3,3,2,8,0xb2d9570a
249069.26,2.0,15,3,3,3,9,0xb2d996bb
150013.19,3.0,12,3,4,3,10,0xb2d8f49ed
6.25,1.0,8,1,2,3,6,0xb2d8c9c3d
428.94,1.0,1,1,2,4,7,0xb2d357b0
289.16,1.0,3,1,2,4,7,0xb2d9d10c
1262305.96,7.0,6,4,4,3,11,0xb2d323f1
331152.33,4.0,75,4,4,1,9,0xb2d0bd56
168873.39,4.0,80,3,4,1,8,0xb2d250eed
160082.71,2.0,49,3,3,2,8,0xb2d13934d
20101.38,2.0,13,2,3,3,8,0xb2d9fe28
7303.59,1.0,15,2,2,3,7,0xb2d959c1
52540.66,2.0,11,3,3,3,9,0xb2d5c1c4d
12.67,1.0,18,1,2,2,5,0xb2da2786
400051.36,2.0,0,4,3,4,11,0xb2d94adbd
1000003.75,15.0,6,4,4,3,11,0xb2d60c94
7221.73,1.0,13,2,2,3,7,0xb2d6c4dfd
1287046.98,7.0,7,4,4,3,11,0xb2d248f0d
218.51,18.0,18,1,4,2,7,0x3b9af113d
1762.16,1.0,0,1,2,4,7,0xb2d43cd6
800043.99,5.0,3,4,4,4,12,0xb2d0d965
381.82,1.0,9,1,2,3,6,0xb2d65b6dd
3052.65,1.0,92,2,2,1,5,0xb2d28068d
30044.4,2.0,209,2,3,1,6,0xb2d4101d
1001002.54,9.0,11,4,4,3,11,0xb2d168ca
1109430.59,8.0,0,4,4,4,12,0xb2d65618
2426.4,1.0,0,1,2,4,7,0xb2d912e6d
2576.5,1.0,11,1,2,3,6,0xb2d4b68ed
410814.07,3.0,4,4,4,4,12,0xb2d688b2
188.64,1.0,9,1,2,3,6,0xb2da2415
1400000.0,3.0,3,4,4,4,12,0xb2d8e310d
2205.94,1.0,23,1,2,2,5,0xb2d38c2a
150006.33,2.0,56,3,3,2,8,0xb2d9c41f
421.74,1.0,39,1,2,2,5,0xb2d28223d
2307.62,1.0,0,1,2,4,7,0xb2d6b108
50004.53,2.0,252,2,3,1,6,0xb2d2a5d6
11.72,1.0,1,1,2,4,7,0xb2d488ec
3863.74,1.0,3,2,2,4,8,0xb2d29013d
21127.65,1.0,11,2,2,3,7,0xb2d6ad2b
453653.0,81.0,2,4,4,4,12,0x3b9b12c8d
251012.71,3.0,53,3,4,2,9,0xb2d5f98ad
606057.21,3.0,13,4,4,3,11,0xb2d2b6ffd
2579.89,1.0,92,1,2,1,4,0xb2d16f6dd
2514.37,1.0,92,1,2,1,4,0xb2d42bc3
82049.31,8.0,3,3,4,4,11,0xb2d53035d
3690.58,1.0,184,2,2,1,5,0xb2d353c5d
50000.0,2.0,0,2,3,4,9,0xb2d6557dd
3583.58,1.0,92,2,2,1,5,0xb2d2f3d4d
600001.06,3.0,11,4,4,3,11,0xb2d9ed01
500200.0,3.0,0,4,4,4,12,0xb2da61e3
641.74,2.0,0,1,3,4,8,0xb2d08abad
4479.89,1.0,35,2,2,2,6,0xb2d3a0aed
56000.0,4.0,137,3,4,1,8,0xb2d65404
3742652.85,9.0,0,4,4,4,12,0x3b9b217bd
102609.88,1.0,5,3,2,3,8,0xb2d0d5e3d
231422.59,3.0,48,3,4,2,9,0xb2d9b609
900.0,1.0,4,1,2,4,7,0xb2d63f6e
500000.0,2.0,12,4,3,3,10,0xb2d96394
35254.65,3.0,0,2,4,4,10,0xb2d0f403
44059.63,2.0,33,2,3,2,7,0xb2d63df9
6760.21,1.0,92,2,2,1,5,0xb2d17422d
55469.78,2.0,0,3,3,4,10,0xb2d09234d
1154.77,1.0,56,1,2,2,5,0xb2d2e2ae
52514.29,2.0,4,3,3,4,10,0xb2d3f6dbd
375000.8,6.0,2,4,4,4,12,0xb2d1be44
200189.78,2.0,24,3,3,2,8,0xb2d5f054
300065.63,2.0,4,3,3,4,10,0xb2d9ff70
1063.38,4.0,92,1,4,1,6,0x3b9b35c1d
14376.25,1.0,25,2,2,2,6,0xb2d7c079
500000.28,2.0,26,4,3,2,9,0xb2d65cac
40000.83,1.0,2,2,2,4,8,0xb2d6f5afd
51306.77,3.0,21,2,4,2,8,0xb2d4cb67
1860819.17,2.0,184,4,3,1,8,0xb2d60385d
12.37,1.0,13,1,2,3,6,0xb2d784be
1613.47,3.0,92,1,4,1,6,0x3b9ad6ce
300012.96,3.0,18,3,4,2,9,0xb2d21f8f
233846.57,2.0,0,3,3,4,10,0xb2d4f9a0
38457.72,1.0,6,2,2,3,7,0xb2d0d07ad
301240.95,2.0,57,4,3,2,9,0xb2d6ea21
3597.99,1.0,4,2,2,4,8,0xb2d23147
242565.01,12.0,0,3,4,4,11,0xb2d0cee4
100001.06,2.0,42,3,3,2,8,0xb2d9e859
150069.97,3.0,8,3,4,3,10,0xb2d34376
3269.17,1.0,8,2,2,3,7,0xb2d50997
100005.65,2.0,70,3,3,1,7,0xb2d641f1d
5088.78,1.0,184,2,2,1,5,0xb2d0fba4
590891.17,7.0,3,4,4,4,12,0xb2d63cbc
30135.61,1.0,10,2,2,3,7,0xb2d5fcd4d
104236.55,1.0,3,3,2,4,9,0xb2d22d2ed
200000.0,2.0,14,3,3,3,9,0xb2da3d44
1.99,1.0,19,1,2,2,5,0xb2d2fdf5d
200012.69,2.0,209,3,3,1,7,0xb2d68631
500076.04,2.0,6,4,3,3,10,0xb2d9f3fd
3024.56,1.0,72,2,2,1,5,0xb2d1cdae
285912.43,7.0,0,3,4,4,11,0xb2d3adedd
4.79,1.0,11,1,2,3,6,0xb2d81186
100002.78,3.0,9,3,4,3,10,0xb2d17b64d
16181.92,1.0,0,2,2,4,8,0xb2d6cd97d
1471117.97,6.0,0,4,4,4,12,0xb2d3af88
221269.04,1.0,0,3,2,4,9,0xb2d44e3f
240857.01,2.0,49,3,3,2,8,0xb2d9c4c7
176.01,1.0,2,1,2,4,7,0xb2d32f6c
200710.42,2.0,36,3,3,2,8,0xb2d9fa4b
212130.63,3.0,66,3,4,2,9,0xb2d5b71ad
50006.03,3.0,105,2,4,1,7,0xb2d5c1e9d
5527.16,1.0,7,2,2,3,7,0xb2d2e73bd
10060.84,1.0,92,2,2,1,5,0xb2d297e7d
958832.21,6.0,8,4,4,3,11,0xb2d185cbd
220707.25,3.0,14,3,4,3,10,0xb2d343ef
55078.28,2.0,27,3,3,2,8,0xb2d6408cd
172453.39,5.0,13,3,4,3,10,0xb2d537a9
800013.22,4.0,1,4,4,4,12,0xb2d9bd86
57161.85,2.0,23,3,3,2,8,0xb2d1223fd
52763.2,3.0,10,3,4,3,10,0xb2d5d2a8
2250.33,1.0,10,1,2,3,6,0xb2d58cfbd
574522.68,5.0,0,4,4,4,12,0xb2d2529a
360231.51,2.0,45,4,3,2,9,0xb2d16a6dd
2256.38,1.0,101,1,2,1,4,0xb2d78285
1667.62,1.0,184,1,2,1,4,0xb2d1cca2d
120071.27,3.0,116,3,4,1,8,0xb2d45e2ad
4639506.4,8.0,18,4,4,2,10,0xb2d373cf
454204.15,3.0,116,4,4,1,9,0xb2d4527bd
24032.41,1.0,137,2,2,1,5,0xb2d91624d
170000.0,4.0,0,3,4,4,11,0xb2d36097
14.19,1.0,11,1,2,3,6,0xb2d944bd
101070.24,1.0,184,3,2,1,6,0xb2d24834
200006.35,2.0,92,3,3,1,7,0xb2d673fdd
230000.49,2.0,0,3,3,4,10,0xb2d16dca
300022.46,2.0,129,3,3,1,7,0xb2d694c1
404.93,1.0,1,1,2,4,7,0xb2d529f9
160564.91,3.0,139,3,4,1,8,0xb2d5bbdc
3667.58,1.0,10,2,2,3,7,0xb2d372fdd
22298.24,1.0,7,2,2,3,7,0xb2d8c8b8d
763231.15,5.0,3,4,4,4,12,0xb2d5d7ae
8014.06,1.0,0,2,2,4,8,0xb2d217a9
12107.76,1.0,27,2,2,2,6,0xb2d91a27
130009.89,4.0,108,3,4,1,8,0xb2d28284d
120154.07,1.0,8,3,2,3,8,0xb2d4cf1ad
10840.35,1.0,0,2,2,4,8,0xb2d212a5
726088.32,5.0,10,4,4,3,11,0xb2d2014b
500000.11,3.0,4,4,4,4,12,0xb2d96f5cd
15244.73,1.0,6,2,2,3,7,0xb2d1391f
3381.47,1.0,14,2,2,3,7,0xb2d342ef
120022.59,3.0,31,3,4,2,9,0xb2d12eebd
2000.0,3.0,10,1,4,3,8,0xb2d5dea6
11822.31,1.0,15,2,2,3,7,0xb2d2ad91d
220592.08,13.0,3,3,4,4,11,0xb2d10c23
1963.52,1.0,92,1,2,1,4,0xb2d13065
1030077.02,3.0,28,4,4,2,10,0xb2d6350ed
10000.53,1.0,4,2,2,4,8,0xb2d9ccc9
50020.83,2.0,27,2,3,2,7,0xb2d24881
0.0,1.0,10,1,2,3,6,0xb2d64e69
2303.52,2.0,92,1,3,1,5,0xb2d573d3d
1087455.89,3.0,10,4,4,3,11,0xb2d6293bd
360901.97,5.0,0,4,4,4,12,0xb2d3f23a
100002.86,1.0,1,3,2,4,9,0xb2d6bcc3
140036.68,4.0,6,3,4,3,10,0xb2d6128e
190003.25,5.0,6,3,4,3,10,0xb2d58cf9d
1095.06,1.0,0,1,2,4,7,0xb2d906bcd
1000023.95,3.0,21,4,4,2,10,0xb2d4792d
10134.31,1.0,7,2,2,3,7,0xb2d9b59f
201613.32,2.0,33,3,3,2,8,0xb2d39395
510665.59,2.0,79,4,3,1,8,0xb2d7c053
374520.82,2.0,3,4,3,4,11,0xb2d23daad
190987.29,13.0,0,3,4,4,11,0xb2d548a1
2733099.89,12.0,24,4,4,2,10,0xb2d575fcd
206002.32,2.0,5,3,3,3,9,0xb2d62876d
170668.12,4.0,34,3,4,2,9,0xb2d69af8d
123000.63,7.0,0,3,4,4,11,0xb2d1957fd
3611.88,1.0,9,2,2,3,7,0xb2d91f40
6936.87,1.0,5,2,2,3,7,0xb2d97e9c
610507.43,9.0,6,4,4,3,11,0xb2d50147d
50008.65,25.0,1,2,4,4,10,0xb2d1c8b1d
10.1,1.0,76,1,2,1,4,0xb2d576e4
1795.88,1.0,8,1,2,3,6,0xb2d28cc6
106678.94,2.0,193,3,3,1,7,0xb2d39a81d
118601.08,3.0,73,3,4,1,8,0x3b9b4553d
410000.42,3.0,6,4,4,3,11,0xb2d06702
300656.62,2.0,108,4,3,1,8,0xb2d6a396d
333.57,1.0,68,1,2,1,4,0xb2d4b129d
100098.44,3.0,110,3,4,1,8,0x3b9b35c4d
285093.61,3.0,0,3,4,4,11,0xb2d23e20d
5002.69,1.0,60,2,2,2,6,0xb2d85768d
120103.8,2.0,13,3,3,3,9,0xb2da0f7c
110252.5,2.0,92,3,3,1,7,0xb2d6431dd
50000.53,2.0,35,2,3,2,7,0xb2d9f9a1
210014.86,2.0,73,3,3,1,7,0xb2d5dcc9
162029.84,4.0,56,3,4,2,9,0xb2d1e04cd
4486.18,1.0,52,2,2,2,6,0xb2d595ac
450723.56,3.0,21,4,4,2,10,0xb2d8f51ad
290.77,1.0,3,1,2,4,7,0xb2d33193
1110042.49,5.0,0,4,4,4,12,0xb2d232ead
123812.32,2.0,19,3,3,2,8,0xb2d5a839d
42642.78,1.0,30,2,2,2,6,0xb2d14c98
460404.77,9.0,1,4,4,4,12,0xb2d24f3fd
1.06,1.0,6,1,2,3,6,0xb2d96903
20000.0,2.0,4,2,3,4,9,0xb2da5c2d
50002.11,2.0,63,2,3,2,7,0xb2d9b19f
21376.22,2.0,14,2,3,3,8,0xb2da2ea4
9837.72,1.0,231,2,2,1,5,0xb2d426a1d
33251.68,1.0,212,2,2,1,5,0xb2d24497d
1677966.04,14.0,4,4,4,4,12,0xb2d1531ad
237006.32,3.0,0,3,4,4,11,0xb2da0bc6
50696.24,1.0,54,2,2,2,6,0xb2d571bdd
99004.42,3.0,36,3,4,2,9,0xb2d58173d
28202.09,1.0,0,2,2,4,8,0xb2d44c21
2487.45,1.0,7,1,2,3,6,0xb2d754fc
1330.25,1.0,9,1,2,3,6,0xb2d5c3d2
93201.43,1.0,20,3,2,2,7,0xb2d16647d
910.36,1.0,24,1,2,2,5,0xb2d5a820
233152.08,2.0,0,3,3,4,10,0xb2d2b2efd
530018.59,2.0,18,4,3,2,9,0xb2d4e3c4d
43567.96,1.0,2,2,2,4,8,0xb2d29d16
7.22,1.0,4,1,2,4,7,0xb2d6bcb2
100001.61,2.0,18,3,3,2,8,0xb2d51e47
100039.65,2.0,31,3,3,2,8,0xb2d22df7
208.43,1.0,80,1,2,1,4,0xb2d51c9fd
100090.21,2.0,196,3,3,1,7,0xb2d2793cd
53239.32,2.0,132,3,3,1,7,0xb2d177fd
508886.81,2.0,19,4,3,2,9,0xb2d6c3efd
0.83,1.0,74,1,2,1,4,0xb2d5792fd
1000.0,3.0,111,1,4,1,6,0xb2d2b3a7
1243.75,1.0,92,1,2,1,4,0xb2d38552d
50002.11,2.0,49,2,3,2,7,0xb2d2ab74d
1050.32,1.0,184,1,2,1,4,0xb2d39724d
380100.49,2.0,5,4,3,3,10,0xb2d68556
1778312.88,5.0,17,4,4,2,10,0xb2d5806ed
2047.89,1.0,6,1,2,3,6,0xb2d6d247
15101.88,1.0,0,2,2,4,8,0xb2d54f47d
809343.39,4.0,17,4,4,2,10,0xb2d3b6aad
290135.4,2.0,0,3,3,4,10,0xb2d20822
714.6,1.0,0,1,2,4,7,0xb2d2f859
4907.07,1.0,184,2,2,1,5,0xb2d4cc8ad
39279.06,2.0,7,2,3,3,8,0x3b9b3839
670000.0,9.0,0,4,4,4,12,0xb2d10458
60016.62,3.0,53,3,4,2,9,0xb2d3bc9b
58657.81,1.0,232,3,2,1,6,0xb2d3c332d
59720.84,2.0,92,3,3,1,7,0xb2d10050d
557.9,1.0,0,1,2,4,7,0xb2d2e02ad
7240.0,1.0,19,2,2,2,6,0xb2d4cc86
111.89,1.0,82,1,2,1,4,0xb2d98382
250065.47,4.0,41,3,4,2,9,0xb2d6a04ed
58523.06,2.0,8,3,3,3,9,0xb2d0b321
40393.4,2.0,184,2,3,1,6,0xb2d12110
138067.85,1.0,2,3,2,4,9,0xb2d790c5d
200061.64,1.0,36,3,2,2,7,0xb2d8f8ddd
113.11,1.0,74,1,2,1,4,0xb2d41c2dd
290470.32,5.0,6,3,4,3,10,0xb2d5346bd
10181.58,2.0,206,2,3,1,6,0xb2d5c026
61450.95,2.0,175,3,3,1,7,0x3b9b47f1d
132199.13,7.0,18,3,4,2,9,0xb2d68478
2967.93,1.0,10,2,2,3,7,0xb2d27eb2
120006.33,2.0,56,3,3,2,8,0xb2d9bdcc
700001.78,3.0,15,4,4,3,11,0xb2d179eed
131165.92,2.0,13,3,3,3,9,0xb2d19e0cd
0.77,1.0,68,1,2,1,4,0xb2d63c89d
18060.06,1.0,99,2,2,1,5,0xb2d32665
50001.68,1.0,6,2,2,3,7,0xb2d6c706
856080.99,2.0,83,4,3,1,8,0xb2d0a49b
2218.23,1.0,32,1,2,2,5,0xb2d6446d
979.94,1.0,66,1,2,2,5,0xb2d5003b
11319.9,1.0,5,2,2,3,7,0xb2d32eec
600000.0,3.0,0,4,4,4,12,0xb2d97fdc
15517.77,1.0,4,2,2,4,8,0xb2d6eba7d
570024.18,4.0,18,4,4,2,10,0xb2d65b25d
200000.0,2.0,1,3,3,4,10,0xb2d9813f
800007.83,2.0,7,4,3,3,10,0xb2d5cdc8d
160359.88,3.0,27,3,4,2,9,0xb2d7f500d
0.0,1.0,92,1,2,1,4,0xb2d576ae
52018.05,2.0,87,2,3,1,6,0xb2d55d0ad
33518.92,1.0,92,2,2,1,5,0x3b9b195cd
80087.46,3.0,101,3,4,1,8,0xb2d5fe12d
5.89,1.0,35,1,2,2,5,0xb2d37848
252.95,2.0,0,1,3,4,8,0x3b9b18c8
580311.62,4.0,55,4,4,2,10,0xb2d8e364d
312780.09,3.0,74,4,4,1,9,0xb2d648afd
1187.58,1.0,2,1,2,4,7,0xb2d62d1b
500090.89,3.0,0,4,4,4,12,0xb2d78340d
444220.8,8.0,73,4,4,1,9,0xb2d3cee4d
20379.6,2.0,27,2,3,2,7,0xb2d62521d
1007114.04,2.0,60,4,3,2,9,0xb2d0d26c
52025.03,2.0,26,2,3,2,7,0xb2d0d83d
225968.39,3.0,21,3,4,2,9,0xb2d268aed
73213.15,2.0,168,3,3,1,7,0xb2d50e2dd
111.06,1.0,89,1,2,1,4,0xb2d59f55
120005.07,2.0,20,3,3,2,8,0xb2d94e30
81.77,2.0,29,1,3,2,6,0xb2d902cd
451.34,1.0,1,1,2,4,7,0xb2d6af12
1703.13,1.0,92,1,2,1,4,0xb2d2a9efd
1129.22,1.0,9,1,2,3,6,0xb2d78b0cd
1788.92,2.0,92,1,3,1,5,0x3b9b45a2d
578072.73,9.0,13,4,4,3,11,0xb2d598c3d
220000.0,2.0,15,3,3,3,9,0xb2da3a82
210916.35,8.0,0,3,4,4,11,0xb2d60e0dd
1822.51,1.0,184,1,2,1,4,0xb2d2a340
200710.42,2.0,29,3,3,2,8,0xb2d94094d
500076.12,2.0,13,4,3,3,10,0xb2d99cad
52666.76,1.0,6,3,2,3,8,0xb2d3569ed
10000.01,2.0,8,2,3,3,8,0xb2da4d32
12010.94,3.0,1,2,4,4,10,0xb2d102e7d
476.89,2.0,4,1,3,4,8,0xb2d56ba0
1006917.22,2.0,1,4,3,4,11,0xb2d356bf
573028.94,3.0,60,4,4,2,10,0xb2d23bdb
47832419.32,12.0,7,4,4,3,11,0x3b9aeb08
4.48,1.0,19,1,2,2,5,0xb2d94a89
330000.02,2.0,23,4,3,2,9,0xb2d6e62b
6477.89,1.0,104,2,2,1,5,0xb2d40cabd
1808943.23,3.0,10,4,4,3,11,0xb2d1c42b
288461.13,6.0,31,3,4,2,9,0xb2d41115
874968.89,4.0,25,4,4,2,10,0xb2d1214ed
310.78,1.0,10,1,2,3,6,0xb2d92131
301551.73,3.0,63,4,4,2,10,0xb2d681f9d
105000.0,3.0,0,3,4,4,11,0xb2d2314ad
7858325.78,21.0,0,4,4,4,12,0x3b9b0e1bd
280002.97,2.0,75,3,3,1,7,0xb2d11541d
101305.15,2.0,118,3,3,1,7,0xb2d29de4d
63.33,1.0,41,1,2,2,5,0xb2d91b4dd
623296.77,7.0,41,4,4,2,10,0xb2d3d838d
330003.21,2.0,1,4,3,4,11,0xb2d94972
50004.75,2.0,20,2,3,2,7,0xb2d94ef0
200005.8,2.0,45,3,3,2,8,0xb2d911f9d
8600.4,1.0,144,2,2,1,5,0xb2d19d14d
1803.86,1.0,128,1,2,1,4,0xb2d40abad
2034.33,1.0,0,1,2,4,7,0xb2d2f4bad
357373.15,4.0,41,4,4,2,10,0xb2d8a04b
15682.49,3.0,10,2,4,3,9,0xb2d2fd2c
120085.6,4.0,1,3,4,4,11,0xb2d1b8c3
6094.87,1.0,184,2,2,1,5,0xb2d5092e
570797.53,3.0,31,4,4,2,10,0xb2d3c10f
9478.33,1.0,4,2,2,4,8,0xb2d8223c
60748.99,3.0,0,3,4,4,11,0xb2d4eb83d
490229.68,4.0,2,4,4,4,12,0xb2d26b29d
200001.48,2.0,18,3,3,2,8,0xb2d9dd65
2773.3,1.0,92,1,2,1,4,0xb2d1be54d
300021.89,3.0,98,3,4,1,8,0xb2d17a80d
2135.57,1.0,92,1,2,1,4,0xb2d3169dd
50001.06,2.0,92,2,3,1,6,0xb2d645bcd
218675.26,3.0,1,3,4,4,11,0xb2d2a296d
427492.75,3.0,3,4,4,4,12,0xb2d1ab29d
728.98,1.0,9,1,2,3,6,0xb2d8fa75
300009.51,2.0,108,3,3,1,7,0xb2d78d8f
11748.42,1.0,12,2,2,3,7,0xb2d71869
79729.22,3.0,10,3,4,3,10,0xb2d57b68
200001.26,2.0,28,3,3,2,8,0xb2d94644d
520771.58,2.0,4,4,3,4,11,0xb2d069a1
1.61,1.0,15,1,2,3,6,0xb2d6bb15
111094.13,8.0,4,3,4,4,11,0xb2d418fc
347.71,1.0,7,1,2,3,6,0xb2d518d1d
888837.98,3.0,63,4,4,2,10,0xb2d589a9d
10000.35,2.0,6,2,3,3,8,0xb2da3bd3
1208.09,1.0,184,1,2,1,4,0xb2d2babdd
159168.97,2.0,0,3,3,4,10,0xb2d4e12ed
226406.22,2.0,0,3,3,4,10,0xb2d65495d
52145.33,1.0,6,2,2,3,7,0xb2d2c49a
281.18,1.0,16,1,2,2,5,0xb2d90ae1
2007109.94,2.0,28,4,3,2,9,0xb2d6ddc1d
352618.65,4.0,125,4,4,1,9,0xb2d60d51
0.19,1.0,41,1,2,2,5,0xb2d0710d
195.29,1.0,2,1,2,4,7,0xb2d6c2fc
379635.08,5.0,55,4,4,2,10,0xb2d622c1d
203554.75,2.0,19,3,3,2,8,0xb2d6c419d
6261.3,1.0,3,2,2,4,8,0xb2d91f4e
5050.42,1.0,92,2,2,1,5,0xb2d28807d
20093.6,1.0,0,2,2,4,8,0xb2d6b68ed
10.61,1.0,27,1,2,2,5,0xb2d684b7
4891.08,1.0,0,2,2,4,8,0xb2d6b69ad
225690.66,1.0,92,3,2,1,6,0xb2d5983a
40344.55,7.0,0,2,4,4,10,0x3b9af36f
297072.47,4.0,10,3,4,3,10,0xb2d4518dd
6052.14,1.0,0,2,2,4,8,0xb2d50b36
697.01,1.0,61,1,2,2,5,0xb2d8da53
1266062.67,4.0,1,4,4,4,12,0xb2d376cbd
203637.09,4.0,0,3,4,4,11,0xb2d61769d
5681.02,1.0,40,2,2,2,6,0xb2d63f3a
480087.75,4.0,0,4,4,4,12,0xb2d4d372
1193977.19,1.0,28,4,2,2,8,0xb2d34ae8d
10008.78,2.0,0,2,3,4,9,0xb2d52957
22.46,1.0,4,1,2,4,7,0xb2d10939
802845.39,2.0,12,4,3,3,10,0xb2d8e424
2652.7,1.0,184,1,2,1,4,0xb2d5e2e7d
200047.23,3.0,21,3,4,2,9,0xb2d80e04d
533405.38,1.0,0,4,2,4,10,0xb2d40c6cd
100103.24,2.0,80,3,3,1,7,0xb2d8d445d
501809.48,3.0,42,4,4,2,10,0xb2d6cbbf
89.81,1.0,38,1,2,2,5,0xb2d37cc4d
588.1,1.0,1,1,2,4,7,0xb2d4dc28
207115.94,2.0,91,3,3,1,7,0xb2d6580bd
6076.42,1.0,13,2,2,3,7,0xb2d9006dd
7249.94,1.0,41,2,2,2,6,0xb2d93705
200710.42,2.0,35,3,3,2,8,0xb2d9fd9c
69961.3,1.0,21,3,2,2,7,0xb2d23256d
253596.05,2.0,9,3,3,3,9,0xb2d41fc9
11734.54,1.0,92,2,2,1,5,0x3b9b2e81
5513.15,1.0,118,2,2,1,5,0xb2d29d57
537026.0,9.0,0,4,4,4,12,0x3b9b2882
53001.59,2.0,0,3,3,4,10,0xb2d0d84dd
325035.21,3.0,0,4,4,4,12,0xb2d80d61
3122.74,1.0,308,2,2,1,5,0xb2d27232d
1723.8,1.0,4,1,2,4,7,0xb2d9e235
11522.9,1.0,26,2,2,2,6,0xb2d4df11
48876.33,1.0,7,2,2,3,7,0xb2d62d36
42084.62,3.0,0,2,4,4,10,0xb2d51eb3d
130000.0,2.0,0,3,3,4,10,0xb2d981a3d
503131.06,3.0,22,4,4,2,10,0xb2d94228
462954.38,7.0,0,4,4,4,12,0x3b9af2b9
53136.09,2.0,0,3,3,4,10,0xb2d178d6d
138066.11,5.0,60,3,4,2,9,0xb2d2444d
330003.48,2.0,13,4,3,3,10,0xb2da3bf6
103555.37,1.0,7,3,2,3,8,0xb2d2820b
581103.5,3.0,96,4,4,1,9,0xb2d16fa6
20141.3,3.0,0,2,4,4,10,0xb2d5f374
4502.44,1.0,54,2,2,2,6,0xb2d80de1
244137.97,6.0,0,3,4,4,11,0xb2d34706
160020.01,3.0,3,3,4,4,11,0xb2d2d6c6
2372.77,1.0,92,1,2,1,4,0xb2d1c1dad
104.21,1.0,42,1,2,2,5,0xb2d5e058
215508.77,2.0,5,3,3,3,9,0xb2d1952ed
171274.3,3.0,4,3,4,4,11,0xb2d2b9a3d
61913.77,1.0,1,3,2,4,9,0xb2d6b478
430305.18,9.0,35,4,4,2,10,0xb2d0be3ed
605954.52,4.0,1,4,4,4,12,0xb2d33f49d
4813.69,1.0,19,2,2,2,6,0xb2d9de2a
50675.1,3.0,118,2,4,1,7,0xb2d5dde5d
600001.25,2.0,20,4,3,2,9,0xb2d8d74ed
12.97,1.0,5,1,2,3,6,0xb2d11ff9
153017.6,6.0,12,3,4,3,10,0xb2d690b3d
150014.59,2.0,55,3,3,2,8,0xb2d3c559
1037.47,1.0,92,1,2,1,4,0xb2d29dac
0.25,1.0,1,1,2,4,7,0xb2d3f1dad
25.02,1.0,76,1,2,1,4,0xb2d43671d
16717.4,2.0,0,2,3,4,9,0x3b9b46dd
10000.11,2.0,69,2,3,1,6,0xb2d85770d
280558.11,6.0,165,3,4,1,8,0xb2d2be18d
24172.88,1.0,21,2,2,2,6,0xb2d6b6d4d
0.18,1.0,33,1,2,2,5,0xb2d35946d
2902.88,1.0,92,2,2,1,5,0xb2d374d2
328000.0,7.0,1,4,4,4,12,0xb2d6a47f
90180.9,1.0,5,3,2,3,8,0xb2d2c800
224000.0,2.0,27,3,3,2,8,0xb2da1094
317.39,2.0,25,1,3,2,6,0xb2d814e4
130076.66,2.0,39,3,3,2,8,0xb2d57706
526071.92,4.0,8,4,4,3,11,0xb2d15727
195543.52,7.0,1,3,4,4,11,0xb2d5ee1f
52001.1,2.0,74,2,3,1,6,0xb2d1a359d
99.36,1.0,56,1,2,2,5,0xb2d98b55
201105.95,9.0,1,3,4,4,11,0x3b9b259bd
360590.38,5.0,4,4,4,4,12,0xb2d51149
102002.38,2.0,25,3,3,2,8,0xb2d569e3
200036.41,3.0,13,3,4,3,10,0xb2d759fdd
921795.83,15.0,28,4,4,2,10,0xb2d6c3df
5363.92,1.0,14,2,2,3,7,0xb2d9b47a
104375.83,3.0,32,3,4,2,9,0xb2d16a5c
202843.49,3.0,144,3,4,1,8,0xb2d6dcbb
50002.08,2.0,27,2,3,2,7,0xb2d60217
500052.64,2.0,13,4,3,3,10,0xb2d98f9c
467.61,1.0,0,1,2,4,7,0xb2d63caed
1187.16,1.0,67,1,2,1,4,0xb2d4f88b
181823.54,3.0,77,3,4,1,8,0xb2d0d1afd
1575093.09,3.0,21,4,4,2,10,0xb2d4a388
1388.75,1.0,0,1,2,4,7,0xb2d7ee14
187578.16,4.0,0,3,4,4,11,0xb2d24614d
229.16,1.0,3,1,2,4,7,0xb2d17914
16395.38,1.0,65,2,2,2,6,0xb2d5f890d
1200100.21,6.0,1,4,4,4,12,0xb2d68482
3550.02,1.0,92,2,2,1,5,0xb2d32c9dd
540065.71,2.0,129,4,3,1,8,0xb2d5583ed
3476.02,1.0,0,2,2,4,8,0xb2d8d117
207063.4,3.0,67,3,4,1,8,0xb2d2155b
2333.96,1.0,184,1,2,1,4,0xb2d2145ad
11667.74,1.0,0,2,2,4,8,0xb2d8f52b
428965.45,4.0,78,4,4,1,9,0xb2d41160
253329.33,2.0,21,3,3,2,8,0xb2d62bb6
469001.0,6.0,0,4,4,4,12,0xb2d31799d
626.11,1.0,0,1,2,4,7,0xb2d9199d
189.21,1.0,12,1,2,3,6,0xb2d8d0b4
662787.58,9.0,4,4,4,4,12,0xb2d1bfe2d
180200.0,2.0,4,3,3,4,10,0xb2da58b5
16877.88,1.0,9,2,2,3,7,0xb2d174f7d
157.88,1.0,17,1,2,2,5,0xb2d3732fd
248039.27,6.0,1,3,4,4,11,0xb2d64814
200004.22,2.0,11,3,3,3,9,0xb2da4379
247244.35,3.0,35,3,4,2,9,0xb2d3d265
113.58,2.0,2,1,3,4,8,0xb2d696afd
7005.93,1.0,8,2,2,3,7,0xb2d5f0c8d
1391.34,1.0,92,1,2,1,4,0xb2d272ecd
55100.6,2.0,24,3,3,2,8,0xb2d94b01
240000.21,2.0,5,3,3,3,9,0xb2d6d47dd
10586.86,1.0,5,2,2,3,7,0xb2d44689
58022.87,2.0,147,3,3,1,7,0xb2d17624d
19688.93,1.0,82,2,2,1,5,0x3b9ad1f4
0.21,1.0,13,1,2,3,6,0xb2d95d51d
812.64,1.0,10,1,2,3,6,0xb2d2ad9e
560.62,1.0,8,1,2,3,6,0xb2d4b687d
263826.5,1.0,92,3,2,1,6,0xb2d20c40
62.72,1.0,60,1,2,2,5,0xb2d5b5b1d
50001.06,2.0,32,2,3,2,7,0xb2da0028
12951.02,1.0,11,2,2,3,7,0xb2d6b90a
520044.41,3.0,10,4,4,3,11,0xb2d0a03ad
697516.8,2.0,49,4,3,2,9,0xb2d187ebd
11200.13,2.0,232,2,3,1,6,0xb2d6ee2f
40026.57,1.0,5,2,2,3,7,0xb2d54096d
100002.11,2.0,60,3,3,2,8,0xb2d9b993
612579.45,5.0,28,4,4,2,10,0xb2d32932d
8.12,2.0,94,1,3,1,5,0xb2d08836d
450007.39,3.0,10,4,4,3,11,0xb2d95e2ed
1449953.44,9.0,4,4,4,4,12,0xb2d0de34d
310203.16,3.0,77,4,4,1,9,0xb2d2faebd
2123.72,1.0,12,1,2,3,6,0xb2d9038f
468.67,1.0,2,1,2,4,7,0xb2d2f0bad
11863.32,1.0,16,2,2,2,6,0xb2d3129d
587.3,1.0,17,1,2,2,5,0xb2d1f6f9d
236026.0,4.0,18,3,4,2,9,0xb2d3c09ad
767.8,1.0,3,1,2,4,7,0xb2d33decd
3.3,1.0,18,1,2,2,5,0xb2d43c57
160039.3,2.0,92,3,3,1,7,0xb2d1b52fd
15050.93,1.0,34,2,2,2,6,0xb2d56a3f
260348.04,3.0,27,3,4,2,9,0xb2d5f3b4
1285.17,1.0,0,1,2,4,7,0xb2d34d6ad
58502.8,1.0,1,3,2,4,9,0xb2d46370
5000371.81,2.0,0,4,3,4,11,0xb2d277c0
20148.91,1.0,92,2,2,1,5,0xb2d22a67d
3223.43,1.0,92,2,2,1,5,0xb2d0c6d2d
200741.8,2.0,27,3,3,2,8,0xb2d5e94b
70222.08,1.0,127,3,2,1,6,0xb2d86bda
90009.83,4.0,39,3,4,2,9,0xb2d6895ed
369.97,1.0,37,1,2,2,5,0xb2d6af3c
527304.91,13.0,0,4,4,4,12,0xb2d17830
170038.23,3.0,1,3,4,4,11,0xb2d8e182d
1610114.13,5.0,6,4,4,3,11,0xb2d4a5a9
8434.56,1.0,28,2,2,2,6,0xb2d8eb8c
111013.28,6.0,15,3,4,3,10,0xb2d377cdd
23861.37,1.0,2,2,2,4,8,0xb2d31a6a
66.96,1.0,20,1,2,2,5,0x3b9b2e6d
866.81,1.0,4,1,2,4,7,0xb2d3efc0d
215201.25,4.0,24,3,4,2,9,0xb2d2959ed
600755.72,13.0,3,4,4,4,12,0xb2d13321
150006.66,4.0,14,3,4,3,10,0xb2d78250
2047.52,1.0,92,1,2,1,4,0xb2d0c4f7
38.98,1.0,98,1,2,1,4,0xb2d613b2d
327.38,1.0,20,1,2,2,5,0xb2d6e4cf
204977.54,2.0,5,3,3,3,9,0xb2d68232d
160003.17,3.0,24,3,4,2,9,0xb2d931f8d
9302.13,1.0,0,2,2,4,8,0xb2d31164d
14364.78,1.0,5,2,2,3,7,0xb2d2f548
11038.58,1.0,92,2,2,1,5,0xb2d5b169d
131333.78,2.0,4,3,3,4,10,0xb2d227fbd
1573.44,1.0,30,1,2,2,5,0xb2d6ee34d
5996.78,1.0,149,2,2,1,5,0xb2d2b66a
50.35,1.0,92,1,2,1,4,0xb2d28862d
2.3,1.0,48,1,2,2,5,0xb2d699ee
810023.45,19.0,13,4,4,3,11,0xb2d09892
1601.87,1.0,153,1,2,1,4,0xb2d1a7ddd
401560.31,2.0,13,4,3,3,10,0xb2d50264
50442.43,1.0,184,2,2,1,5,0xb2d3338a
693.65,1.0,18,1,2,2,5,0xb2d2d653
17725.83,1.0,9,2,2,3,7,0xb2d836b3d
3165.55,1.0,18,2,2,2,6,0xb2d27114
2299.89,1.0,52,1,2,2,5,0xb2d9058fd
202177.38,2.0,23,3,3,2,8,0xb2d8518ed
230073.1,3.0,4,3,4,4,11,0xb2d6e59ed
355067.1,3.0,4,4,4,4,12,0xb2d26791d
179262.13,1.0,39,3,2,2,7,0xb2d3ca52d
1483116.85,7.0,4,4,4,4,12,0xb2d2817d
32.74,1.0,24,1,2,2,5,0xb2d78636d
2578.4,1.0,92,1,2,1,4,0xb2d293b4
7822.46,1.0,10,2,2,3,7,0xb2d9b12c
7355.72,6.0,68,2,4,1,7,0xb2d20ac6d
1749689.93,4.0,188,4,4,1,9,0xb2d118f7d
38000.94,3.0,10,2,4,3,9,0xb2d6fe36
582013.63,5.0,60,4,4,2,10,0xb2d239e9d
305643.74,1.0,0,4,2,4,10,0xb2d298ed
1030000.25,3.0,2,4,4,4,12,0xb2d4a32f
110800.79,2.0,245,3,3,1,7,0xb2d3440dd
119867.19,1.0,1,3,2,4,9,0xb2d65cd2d
20000.42,2.0,206,2,3,1,6,0xb2d68dcc
473516.21,4.0,92,4,4,1,9,0xb2d10db7
8.47,1.0,16,1,2,2,5,0xb2d50b31
647.94,1.0,0,1,2,4,7,0xb2d8c4a6
601863.18,20.0,25,4,4,2,10,0xb2d3c7e6
40239.72,1.0,1,2,2,4,8,0xb2d32ba0d
302131.74,2.0,16,4,3,2,9,0xb2d8dcb1d
9459.36,1.0,13,2,2,3,7,0xb2d6c521
37.24,1.0,77,1,2,1,4,0xb2d705b2
14005.77,2.0,25,2,3,2,7,0xb2d96b8e
300003.17,2.0,39,3,3,2,8,0xb2d9f189
6859.77,1.0,10,2,2,3,7,0xb2d32f52
507119.43,2.0,134,4,3,1,8,0xb2d91fbe
7895.84,1.0,0,2,2,4,8,0xb2d2f2b9d
5018.27,1.0,92,2,2,1,5,0xb2d5f7aed
647598.65,7.0,0,4,4,4,12,0x3b9af259d
521454.72,2.0,92,4,3,1,8,0xb2d4e3f9d
83.05,1.0,64,1,2,2,5,0xb2d586a9d
163319.31,3.0,184,3,4,1,8,0xb2d09666d
500000.0,3.0,4,4,4,4,12,0xb2d68b59d
66.17,1.0,31,1,2,2,5,0xb2d958c1
2914.89,1.0,1,2,2,4,8,0xb2d979e0
105.02,1.0,16,1,2,2,5,0xb2d9eaa7
0.52,1.0,2,1,2,4,7,0xb2d792d4d
478092.42,4.0,104,4,4,1,9,0xb2d32972d
60005.66,5.0,7,3,4,3,10,0x3b9b2fa1d
1207746.39,2.0,6,4,3,3,10,0xb2d33e3dd
328.22,1.0,78,1,2,1,4,0xb2d8d293d
140002.75,4.0,6,3,4,3,10,0xb2d9b9df
7537.4,2.0,0,2,3,4,9,0xb2d06bbf
110177.53,3.0,6,3,4,3,10,0xb2d837a7
264079.92,1.0,184,3,2,1,6,0xb2d20c40d
4366.59,1.0,21,2,2,2,6,0xb2d2e774
10003.42,2.0,8,2,3,3,8,0xb2d92f7ed
0.35,1.0,5,1,2,3,6,0xb2d64b6c
200196.83,2.0,95,3,3,1,7,0xb2d6506f
4019.58,1.0,11,2,2,3,7,0xb2d6bbdad
18583.28,1.0,7,2,2,3,7,0xb2d60260d
357.89,1.0,32,1,2,2,5,0xb2d92e47d
21065.21,1.0,31,2,2,2,6,0xb2d56605d
37092.76,1.0,10,2,2,3,7,0xb2d9d489
55291.27,7.0,272,3,4,1,8,0xb2d26e59d
301065.76,2.0,22,4,3,2,9,0xb2d90f88d
1260.31,1.0,92,1,2,1,4,0xb2d15b54d
600000.0,2.0,20,4,3,2,9,0xb2da29cf
260177.0,4.0,27,3,4,2,9,0xb2d17bb9d
100023.37,2.0,123,3,3,1,7,0xb2d145ec
7571.26,1.0,0,2,2,4,8,0xb2d2b7b5d
20136.57,1.0,92,2,2,1,5,0xb2d36f9e
8986.61,1.0,184,2,2,1,5,0xb2d2af25d
7881.49,1.0,46,2,2,2,6,0xb2d2a917
19252.5,1.0,3,2,2,4,8,0xb2d52ca7d
55.62,1.0,0,1,2,4,7,0xb2d651e4
3384.12,1.0,8,2,2,3,7,0xb2d26c8ad
152013.34,4.0,10,3,4,3,10,0xb2d27078
1838.52,1.0,10,1,2,3,6,0xb2d27d34d
10000.11,2.0,39,2,3,2,7,0xb2d9f2f9
450153.71,11.0,4,4,4,4,12,0xb2da1e5e
310216.66,2.0,0,4,3,4,11,0xb2d1d223
240000.0,2.0,5,3,3,3,9,0xb2d964f8
28456.32,1.0,10,2,2,3,7,0xb2d46745
17193.4,1.0,1,2,2,4,8,0xb2d6cc9d
101768.85,1.0,12,3,2,3,8,0xb2d60141
10290.2,2.0,3,2,3,4,9,0xb2d64fabd
568022.48,4.0,73,4,4,1,9,0xb2d632e1d
3433.56,1.0,5,2,2,3,7,0xb2d241ac
33523.83,1.0,0,2,2,4,8,0xb2d6c256d
632000.32,5.0,0,4,4,4,12,0xb2d3c35dd
689.82,1.0,21,1,2,2,5,0xb2d57d0dd
900487.07,8.0,6,4,4,3,11,0xb2d11fcc
30.99,1.0,72,1,2,1,4,0xb2d17b1f
180263.11,5.0,18,3,4,2,9,0xb2d0a60c
40001.69,2.0,224,2,3,1,6,0xb2d6fa1a
384106.32,3.0,0,4,4,4,12,0xb2d6dec1d
210030.5,3.0,0,3,4,4,11,0xb2d57bd6d
500000.0,3.0,2,4,4,4,12,0xb2d9c638
50767.99,1.0,11,2,2,3,7,0xb2d2ebc8
50038.25,2.0,11,2,3,3,8,0xb2d5eadd
200000.0,2.0,1,3,3,4,10,0xb2d94a8bd
602407.98,2.0,7,4,3,3,10,0xb2d979dcd
950024.05,10.0,15,4,4,3,11,0xb2d3627bd
48.03,1.0,4,1,2,4,7,0xb2d8cb8d
130007.13,3.0,105,3,4,1,8,0xb2d8c4e2d
19637.44,1.0,15,2,2,3,7,0xb2d624d6d
102.04,1.0,18,1,2,2,5,0xb2d11448d
33753.64,1.0,110,2,2,1,5,0xb2d300da
598210.96,12.0,12,4,4,3,11,0xb2d0d484
167381.92,2.0,3,3,3,4,10,0xb2d1e6c6
220.77,1.0,0,1,2,4,7,0xb2d6c1b7d
140000.09,8.0,0,3,4,4,11,0xb2d23579
103572.6,2.0,10,3,3,3,9,0xb2d072f9
2070634.88,7.0,1,4,4,4,12,0xb2d27ffb
2410.51,1.0,81,1,2,1,4,0xb2d59ef8d
270000.0,1.0,5,3,2,3,8,0xb2d96cb5d
581.02,1.0,33,1,2,2,5,0xb2d42724d
210000.0,5.0,0,3,4,4,11,0xb2d8df86d
174048.53,3.0,95,3,4,1,8,0xb2d60e0ed
20002.62,3.0,39,2,4,2,8,0xb2d52015d
300003.17,2.0,55,3,3,2,8,0xb2d90377d
204345.59,3.0,0,3,4,4,11,0xb2d1be07d
140.77,1.0,2,1,2,4,7,0xb2d6f1de
180285.08,1.0,0,3,2,4,9,0xb2d61177
1213.22,1.0,10,1,2,3,6,0xb2d9794f
91441.7,1.0,25,3,2,2,7,0xb2d650f0
10.56,1.0,60,1,2,2,5,0xb2d9c024
3093.9,1.0,0,2,2,4,8,0xb2d570b3d
69968.97,3.0,6,3,4,3,10,0xb2d3b5e6d
1083.73,1.0,7,1,2,3,6,0xb2d97c83
81.13,1.0,5,1,2,3,6,0xb2d5f495
369035.47,2.0,117,4,3,1,8,0xb2d17929d
610732.32,9.0,3,4,4,4,12,0xb2d0db64d
218002.3,2.0,35,3,3,2,8,0xb2d9f94e
23504.96,1.0,49,2,2,2,6,0xb2d16006d
81498.59,3.0,185,3,4,1,8,0xb2d57cc6d
6936569.61,6.0,1,4,4,4,12,0xb2d5d97e
536770.31,4.0,1,4,4,4,12,0xb2d43b93d
873290.24,3.0,130,4,4,1,9,0xb2d3b149d
130000.74,2.0,2,3,3,4,10,0xb2d9789fd
4655934.81,9.0,0,4,4,4,12,0x3b9b3c4f
1002.46,1.0,92,1,2,1,4,0xb2d5b4b5
0.3,1.0,6,1,2,3,6,0xb2d5faf0
770004.62,5.0,94,4,4,1,9,0xb2d1b580
120103.86,4.0,0,3,4,4,11,0xb2d245bfd
483.71,1.0,0,1,2,4,7,0xb2d99b2e
200010.46,2.0,22,3,3,2,8,0xb2d9c49b
400073.76,9.0,0,4,4,4,12,0xb2d4b36dd
536477.21,5.0,18,4,4,2,10,0xb2d26724
3018.86,1.0,9,2,2,3,7,0xb2d187d4d
90.05,1.0,0,1,2,4,7,0xb2d32495
110705.42,3.0,12,3,4,3,10,0xb2d3b58f
1995.58,11.0,141,1,4,1,6,0xb2d18d1fd
322226.2,4.0,70,4,4,1,9,0xb2d63dced
30000.68,2.0,13,2,3,3,8,0xb2d63c8ad
125355.58,2.0,0,3,3,4,10,0xb2d102e0d
1035314.91,8.0,55,4,4,2,10,0xb2d5df33d
159731.64,1.0,5,3,2,3,8,0xb2d69b29d
301067.53,2.0,9,4,3,3,10,0xb2d92b76d
514793.23,3.0,52,4,4,2,10,0xb2d6d5f9d
1088011.16,16.0,3,4,4,4,12,0xb2d43493
0.19,1.0,9,1,2,3,6,0xb2d6e0f5
4962.23,1.0,1,2,2,4,8,0xb2d93e95
253050.56,3.0,32,3,4,2,9,0xb2d1a026d
18236.95,1.0,31,2,2,2,6,0xb2d23112d
60001.26,3.0,25,3,4,2,9,0xb2d9f0a2
40051.18,4.0,52,2,4,2,8,0xb2d57c79d
50000.53,2.0,97,2,3,1,6,0xb2d859a4
331273.01,9.0,2,4,4,4,12,0xb2d60d7cd
803453.21,5.0,48,4,4,2,10,0xb2d36079
59524.38,2.0,0,3,3,4,10,0xb2d177ccd
8087.76,1.0,0,2,2,4,8,0xb2d4e9f9
3001.55,1.0,100,2,2,1,5,0xb2d0f61b
506296.26,4.0,0,4,4,4,12,0xb2d38dc4d
107866.9,1.0,208,3,2,1,6,0xb2d201b2d
90000.0,2.0,3,3,3,4,10,0xb2d97240d
440000.0,3.0,18,4,4,2,10,0xb2d780c2d
17.43,1.0,0,1,2,4,7,0xb2d58f44
101122.0,3.0,0,3,4,4,11,0xb2da5716
625032.02,12.0,24,4,4,2,10,0xb2d35319d
15115.3,1.0,184,2,2,1,5,0xb2d5c588d
8634.71,1.0,1,2,2,4,8,0xb2d786a4d
6072.21,1.0,184,2,2,1,5,0xb2d0d2bfd
33.26,1.0,13,1,2,3,6,0xb2d3b6fb
272018.38,2.0,62,3,3,2,8,0xb2d9bd21
200724.1,2.0,44,3,3,2,8,0xb2d8d51f
185.12,1.0,10,1,2,3,6,0xb2d64a94
496.4,1.0,23,1,2,2,5,0xb2d28648d
44.29,1.0,43,1,2,2,5,0xb2d3ec07d
227208.85,3.0,55,3,4,2,9,0xb2d3abe6
267.27,1.0,9,1,2,3,6,0xb2d266fc
11258.18,1.0,14,2,2,3,7,0xb2d4c87b
187293.66,3.0,116,3,4,1,8,0xb2d40f07d
100189.61,1.0,0,3,2,4,9,0xb2d6b571d
200009.78,2.0,5,3,3,3,9,0xb2d27545
3.12,1.0,92,1,2,1,4,0xb2d59e81d
300017.98,8.0,13,3,4,3,10,0xb2d16e19d
150003.27,3.0,34,3,4,2,9,0xb2d8dcf8d
268020.75,4.0,0,3,4,4,11,0xb2d5d805
100747.2,4.0,98,3,4,1,8,0xb2d585b4d
1172675.59,2.0,82,4,3,1,8,0xb2d22d8f
6045.03,1.0,3,2,2,4,8,0xb2d8a676
4232.96,1.0,62,2,2,2,6,0xb2d5406ed
0.0,2.0,60,1,3,2,6,0xb2d8fa9e
896037.47,10.0,3,4,4,4,12,0x3b9b31c7
8367.34,1.0,0,2,2,4,8,0xb2d6097d
204266.55,2.0,23,3,3,2,8,0xb2d69321d
406613.28,3.0,0,4,4,4,12,0xb2d0c8ae
1287.27,1.0,14,1,2,3,6,0xb2d2b789d
50080.39,2.0,123,2,3,1,6,0x3b9b2587
258456.59,2.0,63,3,3,2,8,0xb2d0ab80
15214.44,1.0,0,2,2,4,8,0xb2d906d9d
155197.55,2.0,77,3,3,1,7,0xb2d12115
2249.8,1.0,1,1,2,4,7,0xb2d6a799d
61763.55,3.0,14,3,4,3,10,0xb2d594a1
180593.0,2.0,80,3,3,1,7,0xb2d992ef
164370.1,2.0,0,3,3,4,10,0xb2d457e7d
18.79,1.0,82,1,2,1,4,0xb2d5a944
17.46,1.0,45,1,2,2,5,0xb2d9ccd8
360078.78,8.0,3,4,4,4,12,0xb2d5b11ad
18693.55,1.0,0,2,2,4,8,0xb2d912ded
675514.18,8.0,0,4,4,4,12,0x3b9b18e4d
350175.18,3.0,13,4,4,3,11,0xb2d1a177
55002.32,2.0,235,3,3,1,7,0xb2d283f6d
355671.67,4.0,4,4,4,4,12,0xb2d62a82d
3.26,1.0,1,1,2,4,7,0xb2d3e94e
59017.36,4.0,18,3,4,2,9,0xb2d5ba38d
5128.17,1.0,0,2,2,4,8,0xb2d45736d
1031.04,1.0,92,1,2,1,4,0xb2d34536d
8.67,1.0,19,1,2,2,5,0xb2d1d373
30201.11,4.0,3,2,4,4,10,0xb2d1f14dd
1000312.89,2.0,21,4,3,2,9,0xb2d78c5cd
130127.11,6.0,0,3,4,4,11,0xb2d06b7c
13004.27,1.0,1,2,2,4,8,0xb2d0959ed
5.2,1.0,11,1,2,3,6,0xb2d28203
1073.18,1.0,13,1,2,3,6,0xb2d3c1f3
116.11,1.0,48,1,2,2,5,0xb2d8d017
136.16,1.0,57,1,2,2,5,0xb2d610bd
4.23,1.0,13,1,2,3,6,0xb2da1288
1002158.97,5.0,15,4,4,3,11,0xb2d4529dd
3249.39,1.0,3,2,2,4,8,0xb2d4d3bfd
23.91,1.0,7,1,2,3,6,0xb2d22289d
10212000.29,7.0,174,4,4,1,9,0xb2d2ec3cd
438080.57,3.0,31,4,4,2,10,0xb2d40f0ad
2.51,1.0,38,1,2,2,5,0xb2d56a7e
5413.08,1.0,10,2,2,3,7,0xb2d68c6cd
887.73,1.0,9,1,2,3,6,0xb2d348b2d
65627.33,3.0,70,3,4,1,8,0xb2d56371d
21873.05,5.0,13,2,4,3,9,0xb2d226e2
18.09,1.0,54,1,2,2,5,0xb2d34dd3
20764.38,1.0,9,2,2,3,7,0xb2d57ebbd
7391.6,1.0,5,2,2,3,7,0xb2d6a926d
100063.67,2.0,40,3,3,2,8,0xb2d0c4c7d
266548.38,2.0,221,3,3,1,7,0xb2d377bc
50686.85,2.0,0,2,3,4,9,0xb2d097be
50011.47,3.0,64,2,4,2,8,0xb2d8c597
170002.64,5.0,0,3,4,4,11,0xb2d66062
22.09,1.0,11,1,2,3,6,0xb2d790f7d
1234.51,1.0,184,1,2,1,4,0xb2d1504d
50000.0,2.0,0,2,3,4,9,0xb2d9801e
37206.38,1.0,306,2,2,1,5,0xb2d59dc4d
772159.72,7.0,34,4,4,2,10,0xb2d0faac
35.56,3.0,3,1,4,4,9,0xb2d83910
82362.35,1.0,10,3,2,3,8,0xb2d356f2d
8251.11,1.0,6,2,2,3,7,0xb2d9484e
0.0,1.0,6,1,2,3,6,0xb2d2516e
100002.11,2.0,27,3,3,2,8,0xb2d94087
5991793.7,41.0,3,4,4,4,12,0x3b9b3c6ed
30961.96,1.0,2,2,2,4,8,0xb2d50ab4
2251.17,1.0,1,1,2,4,7,0xb2d6374a
251681.38,3.0,13,3,4,3,10,0x3b9b2a50d
2500000.0,5.0,0,4,4,4,12,0xb2d3bbbed
55391.93,1.0,92,3,2,1,6,0xb2d3a292
5781.66,4.0,92,2,4,1,7,0x3b9b1c25
40013.84,2.0,83,2,3,1,6,0xb2d69423
24603.56,1.0,231,2,2,1,5,0xb2d1dc44d
1.01,1.0,67,1,2,1,4,0xb2d63e88d
40002.02,3.0,19,2,4,2,8,0xb2d65511d
10000.21,2.0,67,2,3,1,6,0xb2d97945
222566.58,1.0,10,3,2,3,8,0xb2d52eefd
30000.95,2.0,53,2,3,2,7,0xb2d9ca48
420575.97,2.0,102,4,3,1,8,0xb2d3ccfdd
184008.43,3.0,118,3,4,1,8,0xb2d59624d
800085.12,3.0,15,4,4,3,11,0xb2d5a614d
510007.01,3.0,17,4,4,2,10,0xb2d69ac8
300006.33,2.0,18,3,3,2,8,0xb2d952f5d
451598.67,3.0,22,4,4,2,10,0xb2d6eb00d
19102.26,1.0,12,2,2,3,7,0xb2d8e870
2089.07,1.0,89,1,2,1,4,0xb2d90d4b
211168.91,6.0,23,3,4,2,9,0xb2d56081d
2807104.42,3.0,0,4,4,4,12,0xb2d9e111
659.58,1.0,1,1,2,4,7,0xb2d214c4d
4500097.5,7.0,6,4,4,3,11,0xb2d8dcbb
12903.08,2.0,101,2,3,1,6,0xb2d08a38d
27.71,2.0,33,1,3,2,6,0xb2d408a8
5196.9,2.0,92,2,3,1,6,0xb2d31dc8
12.67,1.0,3,1,2,4,7,0xb2d159a5
191321.55,2.0,0,3,3,4,10,0xb2d2787dd
40318.58,2.0,0,2,3,4,9,0xb2d2111b
280929.63,17.0,0,3,4,4,11,0xb2d5bd80
2121.54,1.0,38,1,2,2,5,0xb2d40eb7
18460.12,1.0,7,2,2,3,7,0xb2d2d996
284265.08,3.0,6,3,4,3,10,0xb2d3bafd
10311.76,1.0,294,2,2,1,5,0xb2d5d21a
0.0,3.0,4,1,4,4,9,0xb2d24af1
150633.58,2.0,12,3,3,3,9,0xb2d20cbdd
275749.27,2.0,196,3,3,1,7,0xb2d14aa0d
620137.65,2.0,69,4,3,1,8,0xb2d5b358d
50030.33,4.0,13,2,4,3,9,0xb2d5fde9d
10799.17,4.0,13,2,4,3,9,0xb2d17ee5d
500028.28,2.0,11,4,3,3,10,0xb2d96316d
214160.87,1.0,0,3,2,4,9,0xb2d6469f
110001.16,2.0,217,3,3,1,7,0xb2d743b1
133600.6,4.0,0,3,4,4,11,0xb2d54e55d
10330.51,1.0,92,2,2,1,5,0xb2d1fb21d
501852.12,2.0,30,4,3,2,9,0xb2d9bc34
1715.75,2.0,92,1,3,1,5,0x3b9aee61d
458.83,1.0,3,1,2,4,7,0xb2d37c1fd
70.3,1.0,60,1,2,2,5,0xb2d8fbb5
469054.58,4.0,0,4,4,4,12,0xb2d2be1bd
117400.09,3.0,59,3,4,2,9,0xb2d09d27d
1496.59,1.0,0,1,2,4,7,0xb2d33464
291303.53,2.0,122,3,3,1,7,0xb2d16140d
17136.33,1.0,0,2,2,4,8,0xb2d3341e
1995.77,1.0,15,1,2,3,6,0xb2d4baedd
0.0,1.0,9,1,2,3,6,0xb2d0d994
10283.28,1.0,0,2,2,4,8,0xb2d699f3d
1360.24,1.0,1,1,2,4,7,0xb2d6d173
105659.19,2.0,92,3,3,1,7,0xb2d39a89d
491091.72,6.0,1,4,4,4,12,0xb2d5348fd
105001.11,4.0,110,3,4,1,8,0xb2d15077d
135011.61,2.0,165,3,3,1,7,0xb2d1bf27
479916.69,10.0,27,4,4,2,10,0xb2d32130d
13458.94,1.0,6,2,2,3,7,0xb2d74718
65095.99,3.0,3,3,4,4,11,0xb2d52e4c
592943.92,4.0,4,4,4,4,12,0xb2d5a180d
831.89,1.0,0,1,2,4,7,0xb2d12c36
13810773.41,3.0,7,4,4,3,11,0xb2d42d04
982229.08,9.0,6,4,4,3,11,0xb2d249f0d
850007.92,2.0,2,4,3,4,11,0xb2da3602
240007.28,3.0,66,3,4,2,9,0xb2d57eb8d
1173.87,1.0,69,1,2,1,4,0xb2d71786d
270393.14,3.0,113,3,4,1,8,0xb2d626d7
353704.08,1.0,6,4,2,3,9,0xb2d2ed35d
3.63,1.0,84,1,2,1,4,0xb2d60dbd
1028098.9,7.0,1,4,4,4,12,0xb2d3dc00
3361948.36,16.0,11,4,4,3,11,0xb2d24205
5.81,1.0,1,1,2,4,7,0xb2d93e85
687029.07,2.0,92,4,3,1,8,0xb2d63b83
61.33,1.0,9,1,2,3,6,0xb2d2d5e3d
26320.22,1.0,0,2,2,4,8,0xb2d274bf
104.16,1.0,21,1,2,2,5,0xb2d35bbc
7294.08,1.0,1,2,2,4,8,0xb2d60aafd
1404.26,1.0,0,1,2,4,7,0xb2d58ce3d
134951.06,2.0,0,3,3,4,10,0xb2d30702
262438.75,6.0,3,3,4,4,11,0xb2d6853b
50871.42,2.0,7,2,3,3,8,0xb2d63699
204265.72,2.0,96,3,3,1,7,0xb2d79013d
50598.93,1.0,55,2,2,2,6,0xb2d8faf3
50003.74,2.0,18,2,3,2,7,0xb2d63531d
51826.0,1.0,18,2,2,2,6,0xb2d08f7a
33442.7,1.0,92,2,2,1,5,0xb2d31c15d
125421.32,3.0,12,3,4,3,10,0xb2d0c2b0d
2028.69,1.0,0,1,2,4,7,0xb2d28123
3845.15,1.0,9,2,2,3,7,0xb2d6f468d
200011.42,2.0,1,3,3,4,10,0xb2d6e008
1869.63,2.0,298,1,3,1,5,0xb2d65052d
200000.02,1.0,8,3,2,3,8,0xb2d5c0e1
9.35,1.0,13,1,2,3,6,0xb2d8db48d
2014226.89,3.0,21,4,4,2,10,0xb2d915bed
245144.77,4.0,31,3,4,2,9,0xb2d53d18
3982.67,2.0,3,2,3,4,9,0xb2d07417d
1038.15,1.0,92,1,2,1,4,0xb2d29a18
503552.77,2.0,74,4,3,1,8,0xb2d8e477d
1138.88,2.0,184,1,3,1,5,0xb2d068c1d
50000.53,2.0,39,2,3,2,7,0xb2d9f1c6
135023.55,2.0,0,3,3,4,10,0xb2d4f61b
4237.26,2.0,92,2,3,1,6,0xb2d3b61fd
644382.76,7.0,0,4,4,4,12,0xb2d1710ed
3049.24,1.0,1,2,2,4,8,0xb2d29d96
4.62,1.0,11,1,2,3,6,0xb2d61135
638514.87,3.0,184,4,4,1,9,0x3b9ade4bd
834.48,1.0,9,1,2,3,6,0xb2d28cc6d
3609.69,1.0,47,2,2,2,6,0xb2d22091
2.11,1.0,67,1,2,1,4,0xb2d9a12b
640000.0,7.0,0,4,4,4,12,0xb2d1baf6
266989.86,3.0,151,3,4,1,8,0xb2d676acd
200000.01,2.0,5,3,3,3,9,0xb2d629ffd
360533.41,2.0,158,4,3,1,8,0xb2d395f1
185415.23,4.0,101,3,4,1,8,0xb2d5686b
328.05,1.0,16,1,2,2,5,0xb2d97d3a
7635.11,1.0,2,2,2,4,8,0xb2d23f7ed
200000.26,3.0,4,3,4,4,11,0xb2d54056d
200958.53,2.0,21,3,3,2,8,0xb2d62694
2.38,5.0,236,1,4,1,6,0xb2d22f3cd
5518.31,1.0,92,2,2,1,5,0xb2d306dbd
30047.58,4.0,9,2,4,3,9,0xb2d315b7
175.65,1.0,41,1,2,2,5,0xb2d8dfa0
1291.64,1.0,7,1,2,3,6,0xb2d5a822
172872.18,3.0,136,3,4,1,8,0xb2d10c4ed
510739.48,2.0,34,4,3,2,9,0xb2d0ea83d
14451.92,1.0,3,2,2,4,8,0xb2d99e69
20000.21,2.0,92,2,3,1,6,0xb2d645bfd
1200056.9,3.0,4,4,4,4,12,0xb2d9034cd
300022.22,2.0,6,3,3,3,9,0xb2da5ace
10285.54,1.0,20,2,2,2,6,0xb2d6f521
200000.0,2.0,3,3,3,4,10,0xb2da654f
230027.93,2.0,12,3,3,3,9,0xb2d6fa9b
1214.88,1.0,184,1,2,1,4,0xb2d4ec4c
4560.42,1.0,142,2,2,1,5,0xb2d34498d
122431.55,3.0,182,3,4,1,8,0xb2d23000d
5823.78,2.0,66,2,3,2,7,0xb2d5c7e6
31.99,1.0,18,1,2,2,5,0xb2d78a70
60941.31,3.0,0,3,4,4,11,0xb2d39f01d
138591.63,1.0,101,3,2,1,6,0xb2d42e2dd
300000.0,2.0,3,3,3,4,10,0xb2d97c5ed
1474.12,2.0,11,1,3,3,7,0xb2d5b513
10745.13,2.0,5,2,3,3,8,0xb2d69d39
64.92,1.0,7,1,2,3,6,0xb2d92833
595397.06,8.0,4,4,4,4,12,0xb2d26447d
20000.0,2.0,3,2,3,4,9,0xb2d97339d
1356.99,1.0,126,1,2,1,4,0xb2d6eb21
460000.0,1.0,5,4,2,3,9,0xb2d5d9ea
52.57,1.0,9,1,2,3,6,0xb2d4ffa6
4.38,1.0,39,1,2,2,5,0xb2d41071
480015.11,3.0,73,4,4,1,9,0xb2d4fd03d
607108.74,4.0,50,4,4,2,10,0xb2d80e5dd
430632.55,9.0,0,4,4,4,12,0xb2d455bbd
359963.8,2.0,126,4,3,1,8,0xb2d6d995d
240245.67,6.0,0,3,4,4,11,0xb2d1faeb
20000.0,2.0,3,2,3,4,9,0xb2d97922d
200000.0,2.0,6,3,3,3,9,0xb2d96e19
2154.1,1.0,205,1,2,1,4,0xb2d6479c
401211.31,3.0,8,4,4,3,11,0xb2d97ae4
585.03,1.0,1,1,2,4,7,0xb2d91bbd
62.49,1.0,7,1,2,3,6,0xb2d45dffd
80398.27,1.0,1,3,2,4,9,0xb2d31412
0.07,1.0,69,1,2,1,4,0xb2d48131
1064.37,1.0,184,1,2,1,4,0xb2d2cc5c
40001.05,3.0,11,2,4,3,9,0xb2d95fcbd
668902.94,4.0,107,4,4,1,9,0xb2d2be0dd
1522266.5,4.0,71,4,4,1,9,0xb2d2091c
600413.57,3.0,11,4,4,3,11,0xb2d9038dd
280011.89,6.0,19,3,4,2,9,0xb2d58a8cd
1005.53,1.0,1,1,2,4,7,0xb2d6c423
3520134.23,4.0,10,4,4,3,11,0xb2d54f78
104.19,1.0,0,1,2,4,7,0xb2d2110f
50003.86,2.0,70,2,3,1,6,0xb2d6ad17
15715.77,1.0,0,2,2,4,8,0xb2d308f4
10142.97,3.0,0,2,4,4,10,0xb2d30f8dd
31.93,1.0,27,1,2,2,5,0xb2d42501d
300003.17,2.0,14,3,3,3,9,0xb2da390e
10149.51,2.0,59,2,3,2,7,0xb2d39f99d
0.29,1.0,1,1,2,4,7,0xb2d5df6a
50000.53,2.0,85,2,3,1,6,0xb2d9801ed
680185.35,5.0,48,4,4,2,10,0xb2d48b3dd
279050.66,1.0,0,3,2,4,9,0xb2d3783fd
1351.87,2.0,4,1,3,4,8,0xb2d068a7d
84432.13,4.0,55,3,4,2,9,0xb2d64aabd
339586.0,3.0,125,4,4,1,9,0xb2d27ed1d
1520.86,1.0,0,1,2,4,7,0xb2d6546e
151966.08,3.0,1,3,4,4,11,0xb2d4f935d
400019.81,4.0,1,4,4,4,12,0xb2d379dfd
48863.71,4.0,1,2,4,4,10,0xb2d1c1dd
300000.0,2.0,28,3,3,2,8,0xb2d94228d
51354.27,1.0,9,2,2,3,7,0xb2d6b391
182061.85,2.0,66,3,3,2,8,0xb2d6bf11d
500016.85,8.0,5,4,4,3,11,0xb2d1ce75
650777.26,4.0,25,4,4,2,10,0xb2d604a8d
382212.08,9.0,0,4,4,4,12,0xb2d1d8e5d
1222.87,1.0,5,1,2,3,6,0xb2d250e1
408161.69,3.0,1,4,4,4,12,0xb2d25bea
1471418.37,6.0,1,4,4,4,12,0x3b9b49b6d
106252.19,2.0,67,3,3,1,7,0xb2d0d91ad
150111.83,2.0,129,3,3,1,7,0xb2d20d40
339000.8,6.0,0,4,4,4,12,0xb2d111ced
0.0,1.0,4,1,2,4,7,0xb2d55c1f
27163.62,1.0,7,2,2,3,7,0xb2d373f5d
518871.86,4.0,44,4,4,2,10,0xb2d16b4d
106684.8,9.0,5,3,4,3,10,0xb2d3ff81
10343.95,1.0,0,2,2,4,8,0xb2d47d73
1936.45,1.0,9,1,2,3,6,0xb2d90fce
293.1,1.0,33,1,2,2,5,0xb2d3a89fd
500079.24,2.0,22,4,3,2,9,0xb2d78cdad
11567.54,1.0,1,2,2,4,8,0xb2d30255d
5276.27,1.0,92,2,2,1,5,0xb2d33180d
6932.26,1.0,0,2,2,4,8,0xb2d3f384d
50044.41,1.0,9,2,2,3,7,0xb2d34534
85724.02,7.0,0,3,4,4,11,0xb2d53378d
54000.33,2.0,0,3,3,4,10,0xb2d5dbb6
108572.01,3.0,200,3,4,1,8,0xb2d0e65f
530299.44,4.0,94,4,4,1,9,0xb2d07bb9d
234139.99,2.0,31,3,3,2,8,0xb2d1792dd
30000.42,4.0,24,2,4,2,8,0xb2d8d866d
10000.42,1.0,12,2,2,3,7,0xb2d90540d
23.96,1.0,15,1,2,3,6,0xb2d2bb6d
1141.71,1.0,1,1,2,4,7,0xb2d26064
11424.08,1.0,0,2,2,4,8,0xb2d973e2
20.55,1.0,10,1,2,3,6,0xb2d62c06d
90000.42,3.0,4,3,4,4,11,0xb2d9cf5a
50002.11,2.0,55,2,3,2,7,0xb2d900f9
6713.79,1.0,0,2,2,4,8,0xb2d6e710d
91975.41,1.0,5,3,2,3,8,0xb2d83545d
70070.94,3.0,39,3,4,2,9,0xb2d56ce6
144213.62,2.0,132,3,3,1,7,0xb2d5871cd
30541.6,1.0,3,2,2,4,8,0xb2d3514d
100012.39,2.0,70,3,3,1,7,0xb2d2b499
1020196.01,4.0,14,4,4,3,11,0xb2d0aa61
91309.66,2.0,69,3,3,1,7,0xb2d28c16
14000.15,2.0,32,2,3,2,7,0xb2da0521
59841.52,1.0,0,3,2,4,9,0xb2d3c114
690007.62,6.0,18,4,4,2,10,0xb2d17191
3972.96,1.0,20,2,2,2,6,0xb2d7fe6fd
424001.93,11.0,18,4,4,2,10,0xb2d5d2cbd
249.2,1.0,15,1,2,3,6,0xb2d177bed
95.35,1.0,2,1,2,4,7,0xb2d55741d
1130.01,1.0,92,1,2,1,4,0xb2d1ec40d
500000.08,2.0,8,4,3,3,10,0xb2d9a406
2697.79,1.0,0,1,2,4,7,0xb2d55471d
350047.74,4.0,4,4,4,4,12,0xb2d578ebd
9.29,1.0,46,1,2,2,5,0xb2d214bcd
3760.93,1.0,169,2,2,1,5,0xb2d37667d
10094.61,2.0,137,2,3,1,6,0xb2d8d11bd
85940.59,2.0,67,3,3,1,7,0xb2d9ace4
12520.48,8.0,19,2,4,2,8,0xb2d30597d
4002.27,1.0,19,2,2,2,6,0xb2d6b716
5310.02,1.0,172,2,2,1,5,0xb2d698fcd
11050.6,1.0,68,2,2,1,5,0xb2d587b8d
300016.32,9.0,34,3,4,2,9,0xb2d5e376
60250.78,5.0,18,3,4,2,9,0xb2d5e755
300000.0,2.0,3,3,3,4,10,0xb2d93981
0.59,1.0,4,1,2,4,7,0xb2d5d9a2
4132.68,1.0,0,2,2,4,8,0xb2d6da70
3044.34,1.0,92,2,2,1,5,0xb2d13306d
70000.74,5.0,35,3,4,2,9,0xb2d23597
140050.06,4.0,4,3,4,4,11,0xb2d1934a
2455059.52,5.0,3,4,4,4,12,0xb2d309bdd
2257.26,1.0,184,1,2,1,4,0xb2d63e65d
2140115.68,3.0,53,4,4,2,10,0xb2d36023
70000.11,1.0,0,3,2,4,9,0xb2d91916d
257250.35,2.0,70,3,3,1,7,0xb2d19b51d
8466.08,1.0,32,2,2,2,6,0xb2d69f10d
3436581.02,11.0,0,4,4,4,12,0x3b9b0e5cd
406090.13,4.0,26,4,4,2,10,0xb2d562e1d
1665634.9,1.0,4,4,2,4,10,0xb2d4e002
500008.19,2.0,1,4,3,4,11,0xb2d9b138
13285.78,1.0,107,2,2,1,5,0xb2d1cfffd
930.01,1.0,11,1,2,3,6,0xb2d2088d
487.61,1.0,10,1,2,3,6,0xb2d58bc0
821449.95,6.0,10,4,4,3,11,0xb2d40f95d
2924.15,1.0,7,2,2,3,7,0xb2d3d639
5950.38,1.0,10,2,2,3,7,0xb2d2b4e2
405506.63,7.0,1,4,4,4,12,0xb2d4ed01
235.11,1.0,3,1,2,4,7,0xb2d2065dd
112027.15,2.0,59,3,3,2,8,0xb2d2d332d
4382376.41,31.0,0,4,4,4,12,0xb2d5e7a6
4.46,1.0,53,1,2,2,5,0xb2d59c97d
50564.61,2.0,34,2,3,2,7,0xb2d90ff7d
1113790.12,3.0,18,4,4,2,10,0xb2d3e14cd
822127.34,5.0,18,4,4,2,10,0xb2d172f0d
248011.72,3.0,94,3,4,1,8,0xb2d63df9d
115300.44,1.0,0,3,2,4,9,0xb2d69710
90602.77,3.0,5,3,4,3,10,0xb2d12b2fd
23993.92,1.0,0,2,2,4,8,0xb2d93a92d
170113.06,2.0,157,3,3,1,7,0xb2d5fbc1
130001.37,3.0,31,3,4,2,9,0xb2d8ebebd
65.6,1.0,17,1,2,2,5,0xb2d3a6ed
7.79,1.0,27,1,2,2,5,0xb2d9e09a
173649.04,3.0,3,3,4,4,11,0xb2d1a859d
9.08,1.0,0,1,2,4,7,0xb2d6a1cbd
100013.68,11.0,4,3,4,4,11,0xb2d3984b
437076.01,4.0,6,4,4,3,11,0xb2d78b65
10001.26,2.0,4,2,3,4,9,0xb2da46e8
984.02,1.0,0,1,2,4,7,0xb2d91b6b
3744.86,1.0,221,2,2,1,5,0xb2d55a08
50059.89,3.0,30,2,4,2,8,0xb2d06c47
131000.31,2.0,94,3,3,1,7,0xb2d15e0d
10186.56,1.0,92,2,2,1,5,0xb2d3141c
1607021.29,3.0,6,4,4,3,11,0xb2d5a446d
5057.34,1.0,92,2,2,1,5,0xb2d283ced
75952.19,2.0,188,3,3,1,7,0xb2d41486
2718.15,1.0,24,1,2,2,5,0xb2d2dc45
351629.89,4.0,4,4,4,4,12,0xb2d62a21
55000.81,2.0,73,3,3,1,7,0xb2d6b152
2023.09,1.0,184,1,2,1,4,0x3b9add31d
1529056.49,8.0,3,4,4,4,12,0xb2d5b28ed
5.88,1.0,22,1,2,2,5,0xb2d30ee1d
80005.0,2.0,231,3,3,1,7,0xb2d62b3b
235188.64,2.0,25,3,3,2,8,0xb2d0c4fe
93489.64,2.0,111,3,3,1,7,0xb2d24fb7d
340600.0,10.0,0,4,4,4,12,0xb2d54f17d
101619.82,1.0,10,3,2,3,8,0xb2d2d498d
3204333.95,120.0,0,4,4,4,12,0xb2d0f1b5d
101520.79,4.0,1,3,4,4,11,0xb2d63917d
1025.45,1.0,184,1,2,1,4,0xb2d39ddd
612.39,1.0,0,1,2,4,7,0xb2d930d8
10001.03,2.0,14,2,3,3,8,0xb2da2eb5
250023.76,3.0,47,3,4,2,9,0xb2d95880d
17228.94,1.0,18,2,2,2,6,0xb2d2b51fd
218000.65,4.0,20,3,4,2,9,0xb2d430d6d
0.21,1.0,44,1,2,2,5,0xb2d2c60a
459.26,1.0,10,1,2,3,6,0xb2d956bb
33965.01,1.0,10,2,2,3,7,0xb2d6f063
1429.54,1.0,64,1,2,2,5,0xb2d56600d
6296.54,1.0,4,2,2,4,8,0xb2d1a639
300345.93,4.0,151,4,4,1,9,0xb2d42859d
891.33,1.0,1,1,2,4,7,0xb2d3ab20
307.74,1.0,5,1,2,3,6,0xb2d90508
44174.76,1.0,0,2,2,4,8,0xb2d54f09
472100.86,5.0,11,4,4,3,11,0xb2d29801d
216868.27,2.0,22,3,3,2,8,0xb2d69304
5.3,1.0,12,1,2,3,6,0xb2d643fdd
300716.4,2.0,6,4,3,3,10,0xb2d56b9f
240961.64,3.0,27,3,4,2,9,0x3b9b0e26
96000100.08,2.0,32,4,3,2,9,0xb2d6aa96
4261.09,1.0,0,2,2,4,8,0xb2d68954d
88376.46,2.0,74,3,3,1,7,0xb2d5001a
786000.0,11.0,1,4,4,4,12,0xb2d67fecd
205473.03,2.0,22,3,3,2,8,0xb2d645a2d
10493.89,2.0,96,2,3,1,6,0xb2d2dce5d
6005.66,1.0,66,2,2,2,6,0xb2d665fc
649.6,1.0,0,1,2,4,7,0xb2d9031cd
100030.21,3.0,2,3,4,4,11,0xb2d57e70d
7310.86,1.0,70,2,2,1,5,0xb2d6848a
103808.33,1.0,14,3,2,3,8,0xb2d8e58c
400137.24,3.0,1,4,4,4,12,0xb2d6c1a9
200002.03,2.0,7,3,3,3,9,0xb2d6bf29
16542.17,1.0,4,2,2,4,8,0xb2d39205d
200710.46,2.0,16,3,3,2,8,0xb2d91da9d
14034.39,1.0,0,2,2,4,8,0xb2d6bfc9
50000.53,2.0,92,2,3,1,6,0xb2d64193
385800.91,2.0,24,4,3,2,9,0xb2d20dd0
6587.55,1.0,92,2,2,1,5,0x3b9b4392d
59385.37,3.0,0,3,4,4,11,0xb2d54e1dd
105845.28,1.0,4,3,2,4,9,0xb2d5d4c1
404927.83,3.0,5,4,4,3,11,0xb2d59c14d
220025.44,2.0,221,3,3,1,7,0xb2d4141fd
62301.59,2.0,94,3,3,1,7,0xb2d88000d
879026.14,2.0,1,4,3,4,11,0xb2d3c022d
87.58,1.0,9,1,2,3,6,0xb2d21a22
785.78,1.0,2,1,2,4,7,0xb2d6f61c
5632.29,1.0,184,2,2,1,5,0xb2d2b17fd
1008.65,2.0,92,1,3,1,5,0xb2d28ec6d
63600.0,5.0,0,3,4,4,11,0xb2d20b97d
186230.27,7.0,5,3,4,3,10,0x3b9b305dd
6744.74,1.0,12,2,2,3,7,0xb2d682f7d
388751.58,4.0,21,4,4,2,10,0x3b9b49e2d
95.44,1.0,41,1,2,2,5,0xb2d8d4e1d
282122.13,3.0,11,3,4,3,10,0xb2d53636d
84076.24,8.0,5,3,4,3,10,0xb2d0aa8ad
155003.74,13.0,0,3,4,4,11,0xb2d5639bd
3146.34,1.0,184,2,2,1,5,0xb2d0f69fd
1700157.12,3.0,35,4,4,2,10,0xb2d0de7dd
50502.76,2.0,92,2,3,1,6,0xb2d1fec5d
70876.33,1.0,6,3,2,3,8,0xb2d4c040d
82188.83,8.0,1,3,4,4,11,0x3b9b3d46
2001.56,1.0,27,1,2,2,5,0xb2d9a9e3
86456.2,4.0,1,3,4,4,11,0xb2d5eeffd
48999.44,1.0,0,2,2,4,8,0xb2d356d7d
500005.28,2.0,92,4,3,1,8,0xb2d8f1fd
1011.35,1.0,184,1,2,1,4,0xb2d45e8d
1008.47,1.0,92,1,2,1,4,0xb2d280efd
500194.23,4.0,1,4,4,4,12,0xb2d587c0d
1934.15,1.0,92,1,2,1,4,0xb2d2a89fd
60999.27,2.0,132,3,3,1,7,0xb2d622c8d
600872.3,3.0,8,4,4,3,11,0xb2d9ad8c
1001145.84,1.0,0,4,2,4,10,0xb2d4fafa
1333.94,1.0,184,1,2,1,4,0xb2d2e88ad
20.7,1.0,13,1,2,3,6,0xb2d6b934d
1.48,1.0,11,1,2,3,6,0xb2d3c5c5
592935.52,1.0,0,4,2,4,10,0xb2d5a712d
72.6,1.0,41,1,2,2,5,0xb2d9c5f8
300015.83,2.0,63,3,3,2,8,0xb2d9aff2
53434.63,2.0,210,3,3,1,7,0xb2d2340dd
20933.28,1.0,0,2,2,4,8,0xb2d60ebd
472.05,1.0,16,1,2,2,5,0xb2d6bf92
996.01,1.0,1,1,2,4,7,0xb2d91a48
20551.19,1.0,0,2,2,4,8,0xb2d37a37d
10000.32,2.0,39,2,3,2,7,0xb2d9eaf5
380051.26,8.0,18,4,4,2,10,0xb2d1b63bd
194405.97,1.0,12,3,2,3,8,0xb2d35efcd
200710.43,2.0,42,3,3,2,8,0xb2d92260d
1064.94,1.0,0,1,2,4,7,0xb2d3fe69
110007.66,2.0,193,3,3,1,7,0xb2d5042dd
500008.44,3.0,15,4,4,3,11,0xb2d9d8b3
32160.85,3.0,2,2,4,4,10,0xb2d33066
100289.67,2.0,149,3,3,1,7,0xb2d69089d
23288.05,1.0,0,2,2,4,8,0xb2d2ec83
63861.44,1.0,11,3,2,3,8,0xb2d69a6e
85.62,1.0,28,1,2,2,5,0xb2d34c08d
150001.58,2.0,48,3,3,2,8,0xb2d9daa3
670544.24,3.0,27,4,4,2,10,0xb2d1188dd
205739.38,1.0,1,3,2,4,9,0xb2d31097
422034.32,3.0,25,4,4,2,10,0xb2d14c9ad
90.23,1.0,67,1,2,1,4,0xb2d646f0d
496.98,1.0,17,1,2,2,5,0xb2d2ab1c
9887.66,1.0,92,2,2,1,5,0xb2d1b0b0d
3207.96,1.0,10,2,2,3,7,0xb2d94a22
2521.18,1.0,5,1,2,3,6,0xb2d510c6
101454.13,2.0,90,3,3,1,7,0xb2d62bc2d
282569.21,1.0,1,3,2,4,9,0xb2d26aed
1916.02,1.0,95,1,2,1,4,0xb2d615b9d
53779.66,2.0,182,3,3,1,7,0xb2d3a35dd
1242.53,2.0,184,1,3,1,5,0xb2d0e3c4
28658.87,1.0,12,2,2,3,7,0xb2d5f942d
0.0,1.0,8,1,2,3,6,0xb2d50a3a
407036.99,32.0,4,4,4,4,12,0xb2d0e277
100001.06,2.0,34,3,3,2,8,0xb2d9333c
130064.15,4.0,0,3,4,4,11,0xb2d14021
57.26,1.0,13,1,2,3,6,0xb2d3ef2e
100002.11,2.0,6,3,3,3,9,0xb2d966a8d
774.39,1.0,1,1,2,4,7,0xb2d6c90a
200008.46,2.0,92,3,3,1,7,0xb2d65b64d
65288.56,6.0,6,3,4,3,10,0xb2d69c68d
5182.7,1.0,92,2,2,1,5,0xb2d5ed7ed
2.55,1.0,33,1,2,2,5,0xb2d58dd8d
53990.32,2.0,98,3,3,1,7,0xb2d155b7d
487.67,1.0,9,1,2,3,6,0xb2d301f4d
571.75,1.0,0,1,2,4,7,0xb2d6b7fc
1596.21,1.0,1,1,2,4,7,0xb2d6ba23d
139.82,1.0,10,1,2,3,6,0xb2d9ff00
500052.17,2.0,19,4,3,2,9,0xb2d8d567
419015.61,5.0,49,4,4,2,10,0xb2d4140dd
400008.45,2.0,116,4,3,1,8,0xb2d93248d
420165.24,4.0,2,4,4,4,12,0xb2d6af7cd
130000.52,8.0,3,3,4,4,11,0xb2d1e340d
807995.97,31.0,10,4,4,3,11,0x3b9af141d
12.49,1.0,5,1,2,3,6,0xb2d995d9
722548.16,5.0,53,4,4,2,10,0xb2d2f881
7.89,1.0,49,1,2,2,5,0xb2d36ee1
3172464.0,8.0,1,4,4,4,12,0xb2d41837d
153865.02,4.0,10,3,4,3,10,0xb2d5f6da
281.67,2.0,60,1,3,2,6,0xb2d07c4c
1789.01,1.0,9,1,2,3,6,0xb2d907da
240928.15,5.0,0,3,4,4,11,0xb2d2a41dd
200425.0,2.0,1,3,3,4,10,0xb2d5a2cad
30965794.46,11.0,6,4,4,3,11,0x3b9aeb08d
80256.86,2.0,144,3,3,1,7,0xb2d4560d
23220.0,1.0,45,2,2,2,6,0xb2d6be42d
410008.71,9.0,12,4,4,3,11,0xb2d8dcae
0.0,2.0,60,1,3,2,6,0xb2d9be5d
225131.78,3.0,82,3,4,1,8,0xb2d53d18d
304.6,2.0,2,1,3,4,8,0x3b9b3db5
165.61,1.0,0,1,2,4,7,0xb2d93d66
16.89,3.0,84,1,4,1,6,0xb2d3774bd
2654.57,1.0,34,1,2,2,5,0xb2d90d75
51.29,1.0,0,1,2,4,7,0xb2d37424
7430.15,1.0,9,2,2,3,7,0xb2d62187
2418.15,1.0,0,1,2,4,7,0xb2d475a4d
444896.58,6.0,70,4,4,1,9,0xb2d3c853d
50469.75,2.0,101,2,3,1,6,0xb2d5f680
251423.63,3.0,55,3,4,2,9,0xb2d9c25a
2039863.45,22.0,8,4,4,3,11,0xb2d0c957d
952117.94,6.0,0,4,4,4,12,0xb2d13966d
50001.06,2.0,35,2,3,2,7,0xb2d9f8aa
100005.3,2.0,92,3,3,1,7,0xb2d63dafd
25371.87,1.0,0,2,2,4,8,0xb2d2f320
201003.47,6.0,8,3,4,3,10,0xb2d78a81
535000.0,4.0,1,4,4,4,12,0xb2d641ca
1050840.23,4.0,1,4,4,4,12,0xb2d5f363
535.54,1.0,57,1,2,2,5,0xb2d4db7cd
3295.8,1.0,184,2,2,1,5,0xb2d33c39d
3.01,1.0,51,1,2,2,5,0xb2d90869d
72300.76,2.0,18,3,3,2,8,0xb2d20927
507108.24,2.0,111,4,3,1,8,0xb2d910f2d
11731.59,1.0,6,2,2,3,7,0xb2d2c77a
1249.06,1.0,92,1,2,1,4,0xb2d2f3c6d
28.23,1.0,66,1,2,2,5,0xb2d21536
60586.17,7.0,5,3,4,3,10,0xb2d06480
150634.86,2.0,7,3,3,3,9,0xb2d212e6d
50000.0,2.0,92,2,3,1,6,0xb2d6061fd
700073.09,4.0,10,4,4,3,11,0xb2d22013
10008.59,2.0,59,2,3,2,7,0xb2d22734d
50014.58,2.0,10,2,3,3,8,0xb2d3d8ac
0.85,1.0,25,1,2,2,5,0xb2d98037
252254.14,3.0,1,3,4,4,11,0xb2d3386b
297000.0,2.0,15,3,3,3,9,0xb2da3843
5436.73,1.0,0,2,2,4,8,0xb2d87dbad
407110.41,3.0,85,4,4,1,9,0xb2d6e7d1d
210007.61,6.0,13,3,4,3,10,0xb2d8c93d
1620.05,1.0,21,1,2,2,5,0xb2d44e04
27.79,1.0,80,1,2,1,4,0xb2d97e33d
172173.24,5.0,42,3,4,2,9,0xb2d2b393d
24433.57,1.0,3,2,2,4,8,0xb2d31645
3619.62,1.0,184,2,2,1,5,0xb2d1f75dd
900061.81,2.0,111,4,3,1,8,0xb2d6e1f4
1067.28,1.0,151,1,2,1,4,0xb2d16fe2d
1200104.83,2.0,153,4,3,1,8,0xb2d07841
1746.37,1.0,0,1,2,4,7,0xb2d65441
18032.99,1.0,18,2,2,2,6,0xb2d101add
6865.11,1.0,3,2,2,4,8,0xb2d8eb99d
155014.54,2.0,17,3,3,2,8,0xb2da23b8
23862.09,1.0,6,2,2,3,7,0xb2d3ccc0d
10049.35,1.0,184,2,2,1,5,0xb2d1c2bed
175468.14,3.0,11,3,4,3,10,0xb2d5d3d9d
400000.0,2.0,21,4,3,2,9,0xb2da2687
500052.04,2.0,18,4,3,2,9,0xb2d9dea1
41307.92,1.0,1,2,2,4,8,0xb2d5b12b
222460.73,2.0,157,3,3,1,7,0xb2d1c8ee
718825.06,18.0,16,4,4,2,10,0x3b9b1274
1323.62,1.0,184,1,2,1,4,0xb2d2565bd
656.98,1.0,0,1,2,4,7,0xb2d6b5a3
10000.11,2.0,76,2,3,1,6,0xb2d8dcb8d
51224.75,2.0,66,2,3,2,7,0xb2d594a1d
22676.09,2.0,0,2,3,4,9,0xb2d47aa6
45571.26,2.0,32,2,3,2,7,0xb2d5f6d0
23643.03,2.0,0,2,3,4,9,0x3b9b29f5d
1530.79,1.0,12,1,2,3,6,0xb2d2e5d6d
2242.12,1.0,0,1,2,4,7,0xb2d65002d
27132.23,1.0,184,2,2,1,5,0xb2d5834cd
1248374.66,3.0,80,4,4,1,9,0xb2d1192fd
3020655.68,5.0,1,4,4,4,12,0xb2d12d35d
0.05,1.0,1,1,2,4,7,0xb2d1e5c3d
150007.28,3.0,10,3,4,3,10,0xb2d3a83bd
5001.43,2.0,184,2,3,1,6,0xb2d2974dd
240757.45,4.0,92,3,4,1,8,0xb2d181a9
800026.38,15.0,27,4,4,2,10,0xb2d3a697d
516266.01,3.0,47,4,4,2,10,0xb2d20782
616076.02,3.0,26,4,4,2,10,0xb2d2285dd
801.51,1.0,4,1,2,4,7,0xb2d87b82
3934440.26,7.0,3,4,4,4,12,0xb2d373cfd
2175.14,1.0,14,1,2,3,6,0xb2d152d2
4102198.3,4.0,20,4,4,2,10,0xb2d78b2f
0.0,1.0,0,1,2,4,7,0xb2d5d3f6
200713.06,2.0,36,3,3,2,8,0xb2d9ec0c
36880.9,1.0,0,2,2,4,8,0xb2d6c579d
672651.61,5.0,1,4,4,4,12,0xb2d52baa
1122457.25,5.0,6,4,4,3,11,0xb2d10e8c
500008.79,2.0,0,4,3,4,11,0xb2d69e5a
15175.17,1.0,27,2,2,2,6,0xb2d3a8f5d
80000.84,2.0,18,3,3,2,8,0xb2d95856
400113.28,16.0,6,4,4,3,11,0xb2d4eb48d
1790.2,1.0,9,1,2,3,6,0xb2d43a5d
130203.88,2.0,97,3,3,1,7,0xb2d438a9d
9.5,1.0,112,1,2,1,4,0xb2d256a9
2980.0,1.0,0,2,2,4,8,0xb2d4bcb8
160296.45,3.0,7,3,4,3,10,0xb2d6b959d
28683.49,1.0,0,2,2,4,8,0xb2d9210b
1200.98,1.0,2,1,2,4,7,0xb2d5dc62
401420.83,2.0,35,4,3,2,9,0xb2d9fad4
7542.47,1.0,182,2,2,1,5,0xb2d41d87d
5815.94,1.0,153,2,2,1,5,0xb2d5ea0ad
881192.61,7.0,91,4,4,1,9,0xb2d2f88f
1559.49,1.0,10,1,2,3,6,0xb2d20cf8
1601128.6,5.0,32,4,4,2,10,0xb2d10390d
411379.4,3.0,11,4,4,3,11,0xb2d5e52f
148834.46,2.0,24,3,3,2,8,0xb2d63a4dd
166723.99,1.0,21,3,2,2,7,0xb2d31066d
600014.28,3.0,17,4,4,2,10,0xb2d9d647
22231.71,1.0,0,2,2,4,8,0xb2d655b8d
300000.0,2.0,0,3,3,4,10,0xb2d18107
143756.74,1.0,8,3,2,3,8,0xb2d41ed7d
161005.1,2.0,123,3,3,1,7,0xb2d93582d
0.53,1.0,3,1,2,4,7,0xb2d951a2d
220003.8,5.0,7,3,4,3,10,0xb2d6a0cad
215315.81,3.0,108,3,4,1,8,0xb2d372aed
81001.71,2.0,73,3,3,1,7,0xb2d6b98b
10001.69,1.0,11,2,2,3,7,0xb2d9d558
208986.77,1.0,7,3,2,3,8,0xb2d5585b
50609.82,2.0,133,2,3,1,6,0xb2d6dfead
26848.23,1.0,13,2,2,3,7,0xb2d5fcd2
170004.53,5.0,0,3,4,4,11,0xb2d95200
4600.58,1.0,6,2,2,3,7,0xb2d60a4f
60043.62,2.0,101,3,3,1,7,0xb2d1b126
200715.39,2.0,30,3,3,2,8,0xb2d0cd07d
348.05,1.0,7,1,2,3,6,0xb2d6b794
936.46,1.0,77,1,2,1,4,0xb2d255c1d
600006.34,2.0,116,4,3,1,8,0xb2d94521
1140.19,1.0,2,1,2,4,7,0xb2d6ca22d
56906.08,1.0,5,3,2,3,8,0xb2d5388a
500127.17,2.0,18,4,3,2,9,0xb2d79090
9500488.02,2.0,8,4,3,3,10,0xb2d6dccdd
50861.44,2.0,33,2,3,2,7,0xb2d62c0bd
2754.92,1.0,4,1,2,4,7,0xb2d2b3a8
212.25,1.0,0,1,2,4,7,0xb2d62b44
2762.98,1.0,92,1,2,1,4,0xb2d1d775d
20.58,1.0,67,1,2,1,4,0xb2d9583f
2212762.76,18.0,0,4,4,4,12,0x3b9af30bd
31117.06,1.0,45,2,2,2,6,0xb2d0e434d
14188.75,2.0,47,2,3,2,7,0xb2d369ec
165059.35,4.0,0,3,4,4,11,0xb2d6536d
773066.28,10.0,1,4,4,4,12,0xb2d16054
520004.75,3.0,1,4,4,4,12,0xb2d945e3d
1860033.45,3.0,77,4,4,1,9,0xb2d23b87d
32354.0,1.0,184,2,2,1,5,0xb2d3375bd
26819.42,1.0,41,2,2,2,6,0xb2d7f0ccd
62624.0,1.0,92,3,2,1,6,0xb2d34920d
40000.42,2.0,217,2,3,1,6,0xb2d6f92f
145.38,1.0,6,1,2,3,6,0xb2d1ef44
1980112.0,20.0,0,4,4,4,12,0xb2d297b4d
307466.33,2.0,5,4,3,3,10,0xb2d683ed
610013.94,3.0,18,4,4,2,10,0xb2d8c833
1090.34,1.0,0,1,2,4,7,0xb2d3490bd
100029.3,2.0,164,3,3,1,7,0xb2d5210bd
1016.05,1.0,92,1,2,1,4,0xb2d1daac
7652.21,1.0,0,2,2,4,8,0xb2d6b079d
86817.11,26.0,182,3,4,1,8,0xb2d1538cd
301482.15,3.0,45,4,4,2,10,0xb2d6bb16d
50098.67,2.0,0,2,3,4,9,0xb2d41c91
7475.34,1.0,184,2,2,1,5,0xb2d30b9fd
32202818.4,2.0,48,4,3,2,9,0xb2d6dd60
2194165.17,10.0,27,4,4,2,10,0xb2d10d67d
110480.17,6.0,0,3,4,4,11,0xb2d1bf08d
584173.73,12.0,3,4,4,4,12,0xb2d4b157d
100043.16,2.0,33,3,3,2,8,0xb2d2885bd
274002.12,5.0,20,3,4,2,9,0xb2d438cfd
14359.85,1.0,22,2,2,2,6,0xb2d2ecce
2.9,1.0,41,1,2,2,5,0xb2d5a9de
100283.8,2.0,92,3,3,1,7,0xb2d3f33fd
6.86,1.0,83,1,2,1,4,0xb2d86db9
479718.48,9.0,10,4,4,3,11,0xb2d724c9d
774872.41,5.0,96,4,4,1,9,0xb2d57ab0d
28.43,1.0,10,1,2,3,6,0xb2d90fb7
8132.87,1.0,92,2,2,1,5,0x3b9b2eb5d
98003.66,3.0,19,3,4,2,9,0xb2d591acd
20159.1,1.0,8,2,2,3,7,0xb2d2175c
10724.93,1.0,184,2,2,1,5,0xb2d2c9e7d
0.02,1.0,42,1,2,2,5,0xb2d5933dd
328030.67,6.0,55,4,4,2,10,0xb2d607f2
153842.73,3.0,74,3,4,1,8,0xb2d5fae2d
5.85,2.0,3,1,3,4,8,0xb2d4e872
200098.01,2.0,18,3,3,2,8,0xb2da0b0e
3790.7,1.0,6,2,2,3,7,0xb2d79149
151140.26,1.0,97,3,2,1,6,0xb2d86ad3d
3353.78,1.0,22,2,2,2,6,0xb2d8d0a0
62.91,1.0,38,1,2,2,5,0xb2d62a01
1717.52,1.0,17,1,2,2,5,0xb2d1baac
1024333.04,5.0,35,4,4,2,10,0xb2d433dd
80885.93,1.0,184,3,2,1,6,0xb2d371b9
41388.48,3.0,11,2,4,3,9,0xb2d47f21d
1894.89,1.0,184,1,2,1,4,0xb2d25c25d
5.95,2.0,43,1,3,2,6,0xb2d6826bd
2007.65,1.0,69,1,2,1,4,0xb2d6d77f
500000.44,3.0,11,4,4,3,11,0xb2d6a529
1716.24,2.0,43,1,3,2,6,0xb2d1a44ad
7.1,1.0,198,1,2,1,4,0xb2d2b32f
98.54,1.0,5,1,2,3,6,0xb2d24a36
20080.42,1.0,92,2,2,1,5,0xb2d5b6ea
139103.92,4.0,1,3,4,4,11,0xb2d11f80
8625.28,3.0,0,2,4,4,10,0x3b9b17e7d
284267.58,3.0,27,3,4,2,9,0xb2d68b4b
1500031.41,6.0,67,4,4,1,9,0xb2d3c280
3042.06,1.0,12,2,2,3,7,0xb2d912dcd
3398.53,1.0,152,2,2,1,5,0xb2d61f57
308.88,1.0,0,1,2,4,7,0xb2d2e14cd
35151.97,1.0,0,2,2,4,8,0xb2d3e771
18102733.58,38.0,0,4,4,4,12,0x3b9b1257d
1011.53,5.0,184,1,4,1,6,0xb2d2de72
32.72,2.0,10,1,3,3,7,0xb2d8d189
666548.92,4.0,90,4,4,1,9,0xb2d2d34e
4070.43,3.0,25,2,4,2,8,0x3b9b14d3d
3428.43,1.0,71,2,2,1,5,0xb2d6f2eb
210395.05,1.0,10,3,2,3,8,0xb2d5b131
802372.65,5.0,53,4,4,2,10,0xb2d423ca
300013.62,4.0,13,3,4,3,10,0xb2d93f6fd
78217.4,2.0,2,3,3,4,10,0xb2d5c7a7
656.62,1.0,19,1,2,2,5,0xb2d8a21ed
426.49,1.0,45,1,2,2,5,0xb2d59458
601432.79,4.0,26,4,4,2,10,0xb2d785a1d
16946.35,1.0,0,2,2,4,8,0xb2d92c5c
840.71,1.0,101,1,2,1,4,0xb2d261e5d
4047.67,1.0,92,2,2,1,5,0xb2d370d5d
1937.25,1.0,89,1,2,1,4,0xb2d54ef5
2028.0,1.0,92,1,2,1,4,0xb2d408ded
1859.05,1.0,6,1,2,3,6,0xb2d3e86f
3497.76,1.0,0,2,2,4,8,0xb2d80f88
155973.82,1.0,3,3,2,4,9,0xb2d176cdd
30094.88,2.0,73,2,3,1,6,0xb2d3ae51
200004.62,4.0,55,3,4,2,9,0xb2d8eae0d
76.0,1.0,63,1,2,2,5,0xb2d8c9e5
20000.84,2.0,14,2,3,3,8,0xb2da33e1
2703.44,1.0,4,1,2,4,7,0xb2d9d8e2
300082.4,4.0,74,3,4,1,8,0xb2d6dfa2
593.7,1.0,10,1,2,3,6,0xb2d91521
225009.18,5.0,0,3,4,4,11,0xb2d630e2d
2085016.12,2.0,263,4,3,1,8,0x3b9adcc2
33004.99,1.0,25,2,2,2,6,0xb2d0a0c6
200729.75,2.0,39,3,3,2,8,0xb2d680b4d
24023.22,1.0,0,2,2,4,8,0xb2d32b14d
1135.0,1.0,92,1,2,1,4,0xb2d29b16d
30512.72,3.0,52,2,4,2,8,0xb2d59f97d
375669.89,2.0,209,4,3,1,8,0xb2d5641c
130012.43,3.0,39,3,4,2,9,0xb2d65814d
50089.9,4.0,102,2,4,1,7,0xb2d65e43
592545.46,3.0,31,4,4,2,10,0xb2d6a1db
7177.16,1.0,184,2,2,1,5,0xb2d1eff0d
114994.59,1.0,6,3,2,3,8,0xb2d67eda
600018.44,3.0,38,4,4,2,10,0xb2d1b518d
176.9,1.0,18,1,2,2,5,0xb2d2413ed
1502082.32,9.0,1,4,4,4,12,0xb2d5c932d
519299.77,2.0,0,4,3,4,11,0xb2d52afad
350067.18,8.0,74,4,4,1,9,0x3b9b4311d
8976.81,1.0,15,2,2,3,7,0xb2d70625d
131196.75,2.0,0,3,3,4,10,0xb2d06857d
500085.2,6.0,32,4,4,2,10,0xb2d2513ad
5.02,1.0,56,1,2,2,5,0xb2d2f7e1d
2013.66,1.0,184,1,2,1,4,0xb2d22d20d
206103.84,2.0,5,3,3,3,9,0xb2d54ac4d
831741.58,7.0,67,4,4,1,9,0xb2d06fd8d
2201.67,1.0,91,1,2,1,4,0xb2d68bbe
289.84,2.0,20,1,3,2,6,0xb2d1b570d
1786.85,4.0,16,1,4,2,7,0x3b9af204d
48370.05,3.0,0,2,4,4,10,0xb2d1ef08d
115271.15,2.0,60,3,3,2,8,0xb2d1d83ad
10057.16,2.0,108,2,3,1,6,0x3b9b246bd
6.13,1.0,9,1,2,3,6,0xb2d6bfbd
600000.0,2.0,4,4,3,4,11,0xb2da54ef
1056000.6,11.0,7,4,4,3,11,0xb2d26003
60003.74,3.0,28,3,4,2,9,0xb2d959e3
228.87,1.0,1,1,2,4,7,0xb2d22f0d
430000.0,3.0,10,4,4,3,11,0xb2d94453d
19744.64,1.0,1,2,2,4,8,0xb2d6bb13
302.14,1.0,10,1,2,3,6,0xb2d51927
50828.06,2.0,27,2,3,2,7,0xb2d1646ad
40963.34,1.0,23,2,2,2,6,0xb2d1cca6
1896.66,1.0,236,1,2,1,4,0xb2d6ad8fd
48522.25,3.0,0,2,4,4,10,0xb2d067fb
1317.08,1.0,82,1,2,1,4,0xb2d401fbd
525240.38,3.0,3,4,4,4,12,0xb2d28e01d
20000.26,2.0,67,2,3,1,6,0xb2d77710
10000.63,2.0,69,2,3,1,6,0xb2d9a18e
1.27,1.0,29,1,2,2,5,0xb2da0797
100071.88,2.0,187,3,3,1,7,0xb2d57aa1d
77129.13,4.0,6,3,4,3,10,0xb2d78a81d
162917.34,3.0,76,3,4,1,8,0xb2d295afd
20000.21,2.0,55,2,3,2,7,0xb2d90416
200711.06,3.0,52,3,4,2,9,0xb2d6dcbbd
230000.0,2.0,0,3,3,4,10,0xb2da4ad5
14.87,1.0,11,1,2,3,6,0xb2d96773
97007.15,4.0,67,3,4,1,8,0xb2d62e17
515112.36,2.0,196,4,3,1,8,0xb2d46858
452833.56,3.0,45,4,4,2,10,0xb2d19b6ad
14500.52,2.0,80,2,3,1,6,0xb2d9911c
2871.39,1.0,0,1,2,4,7,0xb2d56ac5
2113656.59,8.0,5,4,4,3,11,0xb2d4aa4bd
1480209.02,2.0,3,4,3,4,11,0xb2d2c603
5524.16,1.0,12,2,2,3,7,0xb2d914a6
100069.91,2.0,143,3,3,1,7,0xb2d3e703d
307466.25,2.0,4,4,3,4,11,0xb2d68646d
608.72,1.0,1,1,2,4,7,0xb2d64d3b
265.4,1.0,4,1,2,4,7,0xb2d63296
6156.98,1.0,13,2,2,3,7,0xb2d324d6d
55.99,1.0,40,1,2,2,5,0xb2d63f1bd
100008.9,1.0,6,3,2,3,8,0xb2d3dfe2d
1304.45,1.0,92,1,2,1,4,0xb2d3d460d
610000.55,4.0,3,4,4,4,12,0xb2d5fdbbd
0.0,1.0,184,1,2,1,4,0xb2d4110a
2004.83,1.0,1,1,2,4,7,0xb2d69630
141.13,1.0,1,1,2,4,7,0xb2d534fd
153448.4,1.0,10,3,2,3,8,0xb2da13c8
3190045.18,3.0,34,4,4,2,10,0xb2d3cccf
21045.15,1.0,141,2,2,1,5,0xb2d3ce72d
6773.06,1.0,29,2,2,2,6,0xb2d928df
5596649.61,52.0,25,4,4,2,10,0xb2d1ae82d
165.08,1.0,10,1,2,3,6,0xb2d3385ed
162954.26,4.0,10,3,4,3,10,0xb2d487c2d
100011.81,2.0,3,3,3,4,10,0xb2d1953a
75072.05,2.0,143,3,3,1,7,0xb2d24cb8
111630.75,6.0,3,3,4,4,11,0xb2d605d4
80001.69,2.0,18,3,3,2,8,0xb2da2c7d
270067.67,3.0,20,3,4,2,9,0xb2d8cf99d
428431.88,3.0,14,4,4,3,11,0xb2d87943d
10.34,1.0,30,1,2,2,5,0xb2d382cb
900019.32,2.0,25,4,3,2,9,0xb2d655e5
415495.83,4.0,33,4,4,2,10,0xb2d3b3cad
10087.0,1.0,92,2,2,1,5,0xb2d2a04c
19540.09,1.0,15,2,2,3,7,0xb2d4072bd
7270.75,1.0,11,2,2,3,7,0xb2d92a08
517771.16,2.0,0,4,3,4,11,0xb2d62147d
52531.03,1.0,28,3,2,2,7,0xb2d5bd2fd
210000.0,2.0,182,3,3,1,7,0xb2d6b3f1d
3037.04,1.0,1,2,2,4,8,0xb2d3ab18
100203.26,2.0,231,3,3,1,7,0xb2d3ad7fd
13408.91,85.0,0,2,4,4,10,0xb2d4a6f2d
594.78,1.0,0,1,2,4,7,0xb2d53047d
1000588.17,3.0,129,4,4,1,9,0xb2d36cfa
10.38,1.0,56,1,2,2,5,0xb2d9746ad
2579.61,1.0,260,1,2,1,4,0xb2d5ea8dd
2780102.55,3.0,20,4,4,2,10,0xb2d75a4dd
53696.96,2.0,136,3,3,1,7,0xb2d3c37ad
767394.05,10.0,4,4,4,4,12,0xb2d416dd
100530.05,3.0,88,3,4,1,8,0xb2d1d510d
8145.01,1.0,19,2,2,2,6,0xb2d1b533
350086.44,4.0,0,4,4,4,12,0xb2d587cc
9009.44,1.0,14,2,2,3,7,0xb2d32c0bd
400023.49,3.0,2,4,4,4,12,0xb2d94561d
143024.27,3.0,92,3,4,1,8,0xb2d36322d
400020.83,2.0,6,4,3,3,10,0xb2d92b72d
518303.13,2.0,83,4,3,1,8,0xb2d61d1a
4.61,1.0,18,1,2,2,5,0xb2d540d0d
91.35,1.0,1,1,2,4,7,0xb2d35456
130246.18,4.0,70,3,4,1,8,0x3b9b328fd
40000.84,2.0,31,2,3,2,7,0xb2d93835
6000.17,1.0,1,2,2,4,8,0xb2d906acd
180036.85,3.0,46,3,4,2,9,0xb2d24de9
5018.97,1.0,92,2,2,1,5,0xb2d59a2c
10591.64,1.0,92,2,2,1,5,0xb2d0e050
70271.14,2.0,184,3,3,1,7,0xb2d3db48d
632233.84,5.0,104,4,4,1,9,0xb2d1cff5d
8.39,1.0,13,1,2,3,6,0xb2d78532
605736.05,5.0,11,4,4,3,11,0xb2d5c49ad
500078.3,2.0,7,4,3,3,10,0xb2d8e507
117.51,1.0,8,1,2,3,6,0xb2d6fb00
10365.75,1.0,148,2,2,1,5,0xb2d6a73c
795341.19,9.0,14,4,4,3,11,0xb2d657fa
138.78,1.0,11,1,2,3,6,0xb2d32384
12.75,1.0,32,1,2,2,5,0xb2d56048d
500076.11,2.0,20,4,3,2,9,0xb2d98d81
723090.15,5.0,27,4,4,2,10,0xb2d68647d
422896.91,6.0,0,4,4,4,12,0xb2d179df
151100.39,4.0,143,3,4,1,8,0xb2d51fd2d
3.57,1.0,41,1,2,2,5,0xb2d59a27
304856.83,5.0,38,4,4,2,10,0x3b9b179e
450800.59,6.0,8,4,4,3,11,0xb2d867f6d
500006.33,2.0,15,4,3,3,10,0xb2d782e2
8255.2,1.0,7,2,2,3,7,0xb2d26698
59.82,1.0,23,1,2,2,5,0xb2d970ead
4.79,2.0,12,1,3,3,7,0xb2d06bc5d
659072.87,11.0,8,4,4,3,11,0xb2d1b797d
410019.77,3.0,7,4,4,3,11,0xb2d2390bd
77217.12,1.0,67,3,2,1,6,0xb2d4134d
53000.0,4.0,6,3,4,3,10,0xb2d0697c
22949.12,1.0,37,2,2,2,6,0xb2d5b9fed
770038.98,4.0,47,4,4,2,10,0xb2d289ebd
6978.39,1.0,0,2,2,4,8,0xb2d26584
100001.06,2.0,48,3,3,2,8,0xb2d911c7d
30061.71,2.0,97,2,3,1,6,0xb2d5cb44d
500027.76,2.0,129,4,3,1,8,0xb2d5f208d
5090.53,1.0,3,2,2,4,8,0xb2d9112ad
0.01,1.0,2,1,2,4,7,0xb2d21fa6d
32.96,1.0,1,1,2,4,7,0xb2d107ead
8607.38,1.0,0,2,2,4,8,0xb2d79124
8175.12,1.0,41,2,2,2,6,0xb2d6b56d
0.0,1.0,7,1,2,3,6,0xb2da40a8
3148.23,1.0,10,2,2,3,7,0xb2d52c65d
3364.81,1.0,7,2,2,3,7,0xb2d526d2d
1410029.13,2.0,61,4,3,2,9,0xb2d57bd1d
1174.94,1.0,10,1,2,3,6,0xb2d9c957
32.17,2.0,0,1,3,4,8,0xb2d0ac76
104030.18,2.0,26,3,3,2,8,0xb2d4a309
1000012.26,2.0,20,4,3,2,9,0xb2d98ad6
50538.73,2.0,111,2,3,1,6,0xb2d259ec
430220.53,5.0,4,4,4,4,12,0xb2d1774fd
487.42,2.0,1,1,3,4,8,0xb2d5ffec
303261.34,2.0,26,4,3,2,9,0xb2d94180d
35998.87,1.0,2,2,2,4,8,0xb2d1ca0cd
15599.5,1.0,0,2,2,4,8,0xb2d5523e
50000.53,2.0,175,2,3,1,6,0xb2d8d176d
6920.55,1.0,5,2,2,3,7,0xb2d2a917d
500000.13,2.0,23,4,3,2,9,0xb2d8e6d3
10.33,1.0,10,1,2,3,6,0xb2d68f13
723.4,1.0,0,1,2,4,7,0xb2d8ebed
83.69,4.0,5,1,4,3,8,0xb2d58a9fd
1085.52,1.0,92,1,2,1,4,0xb2d350edd
500100.0,3.0,12,4,4,3,11,0xb2d95d85d
475588.61,3.0,39,4,4,2,10,0xb2d0f817
4096.48,1.0,0,2,2,4,8,0xb2d8eb7c
60051.99,2.0,92,3,3,1,7,0xb2d2af63d
4836.46,1.0,19,2,2,2,6,0xb2d93d52d
6613.27,2.0,1,2,3,4,9,0xb2d209c6
40116.93,2.0,118,2,3,1,6,0xb2d5f082
21533.28,4.0,0,2,4,4,10,0xb2d064cdd
4657925.0,1.0,0,4,2,4,10,0xb2da308b
536.5,1.0,3,1,2,4,7,0xb2d2a161
16.7,1.0,21,1,2,2,5,0xb2d6980c
100000.0,2.0,6,3,3,3,9,0xb2d91a74d
5.43,1.0,92,1,2,1,4,0xb2d2930fd
45406.21,1.0,31,2,2,2,6,0xb2d395ef
1010561.26,7.0,0,4,4,4,12,0xb2d5debf
6274.49,1.0,7,2,2,3,7,0xb2d26793
910.31,1.0,2,1,2,4,7,0xb2d3503b
300080.01,2.0,22,3,3,2,8,0xb2da1b50
450009.38,8.0,0,4,4,4,12,0xb2d3bd3ad
3171.94,1.0,1,2,2,4,8,0xb2d68a74
2556.89,8.0,0,1,4,4,9,0x3b9b45bc
0.0,1.0,1,1,2,4,7,0xb2d2afc8
22097.42,1.0,4,2,2,4,8,0xb2d55ef5
52000.0,2.0,4,2,3,4,9,0xb2d51e5cd
5402.89,1.0,0,2,2,4,8,0xb2d97049
52309.56,1.0,1,3,2,4,9,0xb2d6c0ac
401421.48,3.0,5,4,4,3,11,0xb2d905ea
53702.46,2.0,62,3,3,2,8,0xb2d0e622d
2335.21,1.0,4,1,2,4,7,0xb2d1bf9cd
76230.19,1.0,6,3,2,3,8,0xb2d3fa1ad
628056.82,3.0,19,4,4,2,10,0xb2d40010d
184.28,1.0,12,1,2,3,6,0xb2d26f24
347.02,1.0,21,1,2,2,5,0xb2d6ca52
300016.62,6.0,38,3,4,2,9,0xb2d33d38d
1083.66,1.0,89,1,2,1,4,0xb2d56a17d
295.32,1.0,0,1,2,4,7,0xb2d38e69d
2073.32,1.0,92,1,2,1,4,0xb2d64b1f
1.21,1.0,1,1,2,4,7,0xb2d65384
200006.34,3.0,27,3,4,2,9,0xb2d782fdd
105059.07,2.0,1,3,3,4,10,0xb2d198b6d
257003.92,7.0,0,3,4,4,11,0xb2d59090d
250072.89,1.0,4,3,2,4,9,0xb2d16eebd
90003.33,5.0,11,3,4,3,10,0xb2d69afed
615612.96,3.0,0,4,4,4,12,0xb2d57ca2d
95001.19,6.0,49,3,4,2,9,0xb2d1798bd
1921000.0,5.0,4,4,4,4,12,0xb2d6055bd
33106.73,1.0,25,2,2,2,6,0xb2d8c966
12919.42,1.0,0,2,2,4,8,0xb2d78bf7d
419494.06,5.0,1,4,4,4,12,0xb2d58e16d
1844.28,1.0,2,1,2,4,7,0xb2d6ebe8
533050.12,4.0,4,4,4,4,12,0xb2d1209fd
2023.57,1.0,15,1,2,3,6,0xb2d5ae72
1294.7,1.0,0,1,2,4,7,0xb2d2e64cd
222.9,2.0,3,1,3,4,8,0xb2d2d4f4
359081.09,8.0,25,4,4,2,10,0xb2d78059
65.78,1.0,21,1,2,2,5,0xb2d5913f
430000.0,1.0,0,4,2,4,10,0xb2d92a0d
1320.92,1.0,0,1,2,4,7,0xb2d60a76
130054.74,2.0,1,3,3,4,10,0xb2d114b1d
620354.18,4.0,70,4,4,1,9,0x3b9b1c2bd
300078.8,2.0,230,3,3,1,7,0xb2d0d372d
75100.86,2.0,11,3,3,3,9,0xb2d2377cd
41877.47,2.0,1,2,3,4,9,0xb2d393e2d
1069.32,2.0,251,1,3,1,5,0xb2d6d495
4189.31,1.0,0,2,2,4,8,0xb2d9dd99
208384.39,2.0,15,3,3,3,9,0xb2d2cf7cd
5136.19,2.0,184,2,3,1,6,0xb2d1b0c2d
580006.12,2.0,34,4,3,2,9,0xb2d92ea9d
70.81,1.0,11,1,2,3,6,0xb2d269e1
620235.16,17.0,0,4,4,4,12,0xb2d55258d
190027.85,4.0,0,3,4,4,11,0xb2d5df9fd
0.03,1.0,60,1,2,2,5,0xb2d27f62d
140040.86,2.0,153,3,3,1,7,0xb2d51bc2
1332037.99,2.0,0,4,3,4,11,0xb2d6006ad
510445.82,4.0,14,4,4,3,11,0xb2d5f12ad
377847.88,5.0,3,4,4,4,12,0x3b9af199d
20000.2,2.0,0,2,3,4,9,0xb2d62b9ed
448.6,1.0,53,1,2,2,5,0xb2d65b56
3230.46,1.0,3,2,2,4,8,0xb2d081fa
123299.95,1.0,4,3,2,4,9,0xb2d27c32
301088.43,12.0,18,4,4,2,10,0xb2d0b39c
926.18,1.0,74,1,2,1,4,0xb2d3b6c2
1610193.08,7.0,0,4,4,4,12,0xb2d0f556d
501776.06,2.0,11,4,3,3,10,0xb2d8fa4ed
97.57,1.0,10,1,2,3,6,0xb2d9eb5d
357003.9,5.0,63,4,4,2,10,0xb2d3d22a
1010174.72,2.0,70,4,3,1,8,0xb2d654c4d
4016.54,1.0,45,2,2,2,6,0xb2d3aa3bd
49.39,1.0,22,1,2,2,5,0xb2d92bf1
37731.98,1.0,52,2,2,2,6,0xb2d4466dd
239439.7,5.0,3,3,4,4,11,0xb2d8dc96
117.92,1.0,20,1,2,2,5,0xb2d2f8d1d
3887.97,1.0,181,2,2,1,5,0xb2d364c6
12593.37,1.0,0,2,2,4,8,0xb2d6b186
29324.64,1.0,5,2,2,3,7,0xb2d36cbed
2142500.39,2.0,12,4,3,3,10,0xb2d38c29d
60006.52,2.0,80,3,3,1,7,0xb2d3a8d2d
5.28,1.0,32,1,2,2,5,0xb2d91943d
5243.85,1.0,92,2,2,1,5,0xb2d28bdbd
800001.09,5.0,13,4,4,3,11,0xb2d998fd
3982.28,3.0,17,2,4,2,8,0xb2d0b49e
676739.71,10.0,8,4,4,3,11,0xb2d63603d
303021.47,2.0,25,4,3,2,9,0xb2d1ba34d
6217.76,1.0,26,2,2,2,6,0xb2d0d389
101002.13,2.0,172,3,3,1,7,0xb2d652d2d
3358.66,1.0,0,2,2,4,8,0xb2d4cf23
302133.89,2.0,56,4,3,2,9,0xb2d9bda4
95560.97,1.0,16,3,2,2,7,0xb2d985a2
384742.79,5.0,7,4,4,3,11,0xb2d5ae17
1947.63,1.0,27,1,2,2,5,0xb2d4f639d
4726335.03,1.0,124,4,2,1,7,0xb2d6f16ed
2123.96,1.0,9,1,2,3,6,0xb2d6e119
8125.18,2.0,21,2,3,2,7,0x3b9b3bc8d
683328.75,6.0,6,4,4,3,11,0xb2d50df2d
600000.0,4.0,2,4,4,4,12,0xb2d6e3a5d
225587.97,2.0,214,3,3,1,7,0xb2d1b11e
241079.23,5.0,82,3,4,1,8,0xb2d4fcbfd
3.7,1.0,17,1,2,2,5,0xb2d59d50d
51490.48,2.0,39,2,3,2,7,0xb2d68ae7d
495000.0,1.0,1,4,2,4,10,0xb2da5fe8
51102.87,1.0,92,2,2,1,5,0xb2d32f67d
0.0,1.0,184,1,2,1,4,0xb2d4c7e8
70217.51,3.0,0,3,4,4,11,0xb2d4f0c5d
42962.27,1.0,0,2,2,4,8,0xb2d20aa4
489356.75,4.0,21,4,4,2,10,0xb2d45f66d
229.41,1.0,62,1,2,2,5,0xb2d2619ed
250000.03,4.0,4,3,4,4,11,0xb2d26821
20131.2,2.0,12,2,3,3,8,0xb2d6bfd7d
14238.31,1.0,10,2,2,3,7,0xb2d37024d
530958.1,4.0,32,4,4,2,10,0xb2d0e600d
2117.25,1.0,9,1,2,3,6,0xb2d91db3
2773111.54,11.0,108,4,4,1,9,0x3b9b26ec
1024.47,1.0,92,1,2,1,4,0xb2d39dddd
500076.2,2.0,17,4,3,2,9,0xb2d5d173
4112.65,4.0,0,2,4,4,10,0x3b9b46c2d
4100313.85,3.0,27,4,4,2,10,0xb2d1a087d
3042.66,1.0,212,2,2,1,5,0xb2d2ba1f
7464.24,1.0,13,2,2,3,7,0xb2d78eefd
634.76,1.0,18,1,2,2,5,0xb2d16e0d
975508.32,5.0,14,4,4,3,11,0xb2d294d1d
52.19,1.0,97,1,2,1,4,0xb2d2a880d
2011.81,1.0,0,1,2,4,7,0xb2d6f266d
6419.84,1.0,32,2,2,2,6,0xb2d9495c
154965.44,2.0,19,3,3,2,8,0xb2d41381d
464057.65,5.0,0,4,4,4,12,0xb2d6ebd1
6036.78,1.0,4,2,2,4,8,0xb2d91f3f
2.28,1.0,11,1,2,3,6,0xb2d9f04a
1730091.33,5.0,1,4,4,4,12,0xb2d63d38
90106.5,2.0,63,3,3,2,8,0xb2d99f64
833823.98,1.0,2,4,2,4,10,0xb2d6ea63
4013.71,1.0,144,2,2,1,5,0xb2d4cd7d
8565.97,1.0,14,2,2,3,7,0xb2d67ece
84.92,1.0,3,1,2,4,7,0xb2d3a57e
202.23,1.0,9,1,2,3,6,0xb2d316a0
1584.66,1.0,184,1,2,1,4,0xb2d1caa2d
50001.58,2.0,53,2,3,2,7,0xb2d99fb6
334.1,2.0,26,1,3,2,6,0xb2d9dc6b
323.59,1.0,0,1,2,4,7,0xb2d57ae1
2089.1,1.0,13,1,2,3,6,0xb2d2c4d4
17737.57,1.0,20,2,2,2,6,0xb2d271fcd
300065.71,2.0,14,3,3,3,9,0xb2d9d5a9
80008.45,3.0,53,3,4,2,9,0xb2d09c72
15347.03,1.0,38,2,2,2,6,0xb2d5f59c
20014.55,2.0,0,2,3,4,9,0xb2d12c83
452.78,3.0,37,1,4,2,7,0xb2d253a4d
307.45,1.0,47,1,2,2,5,0xb2d64a9fd
50394.02,1.0,92,2,2,1,5,0xb2d3338ad
50041.37,1.0,9,2,2,3,7,0xb2d06e61
30009.16,2.0,93,2,3,1,6,0xb2d5d66fd
431830.19,4.0,124,4,4,1,9,0xb2d1e724
1315660.11,3.0,34,4,4,2,10,0xb2d1643dd
2277.76,1.0,10,1,2,3,6,0xb2d8e7e2
50002.01,2.0,92,2,3,1,6,0xb2d55f6ed
425077.0,4.0,4,4,4,4,12,0xb2d60927d
20112.93,1.0,9,2,2,3,7,0xb2d69a28d
5493.68,1.0,10,2,2,3,7,0xb2d2be06
1500069.64,3.0,209,4,4,1,9,0xb2d1279ed
272.36,1.0,0,1,2,4,7,0xb2d9138bd
689.01,1.0,21,1,2,2,5,0xb2d96477
115011.89,6.0,6,3,4,3,10,0xb2d32b21d
39772.81,1.0,1,2,2,4,8,0xb2d29925
408936.29,9.0,0,4,4,4,12,0x3b9b180bd
17503.64,1.0,11,2,2,3,7,0xb2d65d92d
114.42,1.0,17,1,2,2,5,0xb2d3b1cb
314.03,2.0,13,1,3,3,7,0xb2d94a9bd
954000.0,8.0,8,4,4,3,11,0xb2d4657ad
325523.4,2.0,208,4,3,1,8,0xb2d30e4ed
3492.43,1.0,102,2,2,1,5,0xb2d65a8f
600057.67,4.0,8,4,4,3,11,0xb2d68ea4
580012.33,4.0,4,4,4,4,12,0xb2d78d8dd
978438.24,1.0,92,4,2,1,7,0xb2d1c6e4d
2.14,1.0,14,1,2,3,6,0xb2d8ca21
13542.63,1.0,5,2,2,3,7,0xb2d233f5d
73.1,1.0,0,1,2,4,7,0xb2d6d0a5d
79204.17,1.0,11,3,2,3,8,0xb2d419cad
62.35,1.0,31,1,2,2,5,0xb2d69b0c
60299.07,2.0,179,3,3,1,7,0xb2d5940b
45014.42,3.0,6,2,4,3,9,0xb2d70474d
1442.34,1.0,184,1,2,1,4,0xb2d5ba92d
684906.84,2.0,90,4,3,1,8,0xb2d4d329d
310690.53,2.0,7,4,3,3,10,0xb2d0c01fd
2836.2,1.0,0,1,2,4,7,0xb2d14613d
1423542.38,7.0,6,4,4,3,11,0xb2d09de3d
8324.81,1.0,21,2,2,2,6,0xb2d2c4b4d
3025.27,1.0,184,2,2,1,5,0xb2d35f82
524511.9,2.0,6,4,3,3,10,0xb2d32e8b
510806.53,1.0,0,4,2,4,10,0xb2d52c81
100016.66,2.0,63,3,3,2,8,0xb2d687a8
268988.03,3.0,0,3,4,4,11,0xb2d921b6d
52.15,1.0,10,1,2,3,6,0xb2d2c0ded
7906.67,1.0,20,2,2,2,6,0xb2d264c7
400000.01,4.0,1,4,4,4,12,0xb2d5c4c0
18.12,1.0,82,1,2,1,4,0xb2d1071ad
6836.71,1.0,0,2,2,4,8,0xb2d483f4d
2501.61,1.0,274,1,2,1,4,0xb2d3d816
842000.02,4.0,174,4,4,1,9,0xb2d0c82d
104119.55,3.0,3,3,4,4,11,0xb2d31903
468190.97,2.0,172,4,3,1,8,0xb2d38b2dd
480027.12,2.0,13,4,3,3,10,0xb2d6bbffd
50098.96,1.0,10,2,2,3,7,0xb2d9db2b
1515.42,1.0,21,1,2,2,5,0xb2d6dfb6d
20000.53,3.0,4,2,4,4,10,0xb2d93aafd
250002.12,3.0,102,3,4,1,8,0xb2d95126d
502.16,1.0,8,1,2,3,6,0xb2d93156
437127.55,10.0,0,4,4,4,12,0xb2d0bec8
6034.57,1.0,184,2,2,1,5,0xb2d5891f
1192.39,1.0,60,1,2,2,5,0xb2d40e10
883087.53,18.0,0,4,4,4,12,0xb2d5d3aed
10014.0,2.0,18,2,3,2,7,0xb2d18c6ad
260031.39,3.0,39,3,4,2,9,0xb2d593e7
350719.4,4.0,27,4,4,2,10,0xb2da0546
910100.19,5.0,11,4,4,3,11,0xb2d120e3d
51629.43,1.0,8,2,2,3,7,0xb2d6a3a5d
30005.6,2.0,77,2,3,1,6,0xb2d6584fd
4899.12,1.0,184,2,2,1,5,0xb2d395e0d
8582.77,1.0,1,2,2,4,8,0xb2d97b0f
240007.35,7.0,8,3,4,3,10,0xb2d38b8d
1226.81,1.0,210,1,2,1,4,0xb2d52ea2d
500535.1,1.0,0,4,2,4,10,0xb2d8cd60
1095257.16,2.0,27,4,3,2,9,0xb2d1e302d
2.8,1.0,67,1,2,1,4,0xb2d6c909d
60097.11,2.0,214,3,3,1,7,0xb2d65dff
400000.0,2.0,33,4,3,2,9,0xb2d93843
1000000.0,4.0,0,4,4,4,12,0xb2d6dc40
22412.97,1.0,69,2,2,1,5,0xb2d28a0bd
530278.35,2.0,111,4,3,1,8,0xb2d2198dd
200171.14,2.0,6,3,3,3,9,0xb2d5ee32d
321030.93,5.0,2,4,4,4,12,0xb2d57bb9d
951710.63,11.0,4,4,4,4,12,0xb2d5fa62
206047.73,6.0,11,3,4,3,10,0xb2d12a8a
630132.78,5.0,0,4,4,4,12,0xb2d53392
6821.25,1.0,0,2,2,4,8,0xb2d6b9a9
555258.22,4.0,0,4,4,4,12,0x3b9b4599d
1317.71,1.0,4,1,2,4,7,0xb2d30aa0
240073.88,2.0,14,3,3,3,9,0xb2d3b461
25105.85,1.0,9,2,2,3,7,0xb2d2690f
59281.7,1.0,24,3,2,2,7,0xb2d62849d
107906.02,3.0,92,3,4,1,8,0xb2d07239
10281.99,1.0,141,2,2,1,5,0xb2d1ecf7d
305856.26,5.0,10,4,4,3,11,0xb2d2ea08d
890061.63,7.0,66,4,4,2,10,0xb2d0e9f6d
697608.86,3.0,28,4,4,2,10,0xb2da06c5
1000066.5,1.0,0,4,2,4,10,0xb2d780e9d
328809.72,2.0,20,4,3,2,9,0x3b9af6d0d
911.02,1.0,21,1,2,2,5,0xb2d2e28bd
44.22,1.0,9,1,2,3,6,0xb2d68a7d
1100000.0,3.0,6,4,4,3,11,0xb2da4f77
366001.96,6.0,144,4,4,1,9,0x3b9b4200d
500000.0,2.0,6,4,3,3,10,0xb2da5ac3
0.74,1.0,6,1,2,3,6,0xb2d4c26b
7320.47,1.0,11,2,2,3,7,0xb2d30b8fd
333632.43,4.0,0,4,4,4,12,0xb2d57480d
60162.01,5.0,11,3,4,3,10,0xb2d2e992
100002.0,3.0,102,3,4,1,8,0xb2d3628a
205.21,1.0,3,1,2,4,7,0xb2d9454f
198.08,1.0,20,1,2,2,5,0xb2d22fdb
2306703.58,7.0,0,4,4,4,12,0xb2d134f7d
0.0,1.0,0,1,2,4,7,0xb2d51bbd
150058.64,5.0,3,3,4,4,11,0x3b9b47ebd
475028.89,4.0,59,4,4,2,10,0xb2d1cd17d
100003.3,3.0,11,3,4,3,10,0xb2d91c70
132082.73,2.0,199,3,3,1,7,0xb2d1fb33
3362.46,2.0,36,2,3,2,7,0xb2d34425
105442.94,2.0,129,3,3,1,7,0xb2d4e72f
354084.89,4.0,0,4,4,4,12,0xb2d09101d
1176.91,1.0,0,1,2,4,7,0xb2d3cae5d
273.27,1.0,10,1,2,3,6,0xb2d266fcd
800052.94,3.0,40,4,4,2,10,0xb2d4dc37d
1290036.15,6.0,27,4,4,2,10,0xb2d16b27
2304.77,1.0,0,1,2,4,7,0xb2d8eb6c
960064.12,4.0,8,4,4,3,11,0xb2d07af3
4186.55,1.0,92,2,2,1,5,0x3b9b33a3d
11135.04,4.0,53,2,4,2,8,0x3b9b33a7
335665.63,5.0,50,4,4,2,10,0xb2d460ddd
26.95,1.0,18,1,2,2,5,0xb2d5e185
3938.64,1.0,0,2,2,4,8,0xb2d34487d
130738.65,5.0,0,3,4,4,11,0xb2d30f67
2022.69,1.0,10,1,2,3,6,0xb2d366f8d
24000.51,2.0,80,2,3,1,6,0xb2d8d37bd
630879.2,9.0,6,4,4,3,11,0xb2d14a03d
10206135.03,3.0,17,4,4,2,10,0xb2d5baab
9644.17,1.0,184,2,2,1,5,0xb2d377b9d
84.86,1.0,4,1,2,4,7,0xb2d70854d
5658.4,1.0,91,2,2,1,5,0xb2d627f9d
7071.71,1.0,184,2,2,1,5,0xb2d2bbe8d
303198.45,2.0,88,4,3,1,8,0xb2d94a78d
1008.49,1.0,92,1,2,1,4,0xb2d2e843d
451312.48,7.0,0,4,4,4,12,0x3b9af18ad
40000.42,2.0,18,2,3,2,7,0xb2da3191
5484.62,1.0,92,2,2,1,5,0x3b9b2752
20002.75,1.0,11,2,2,3,7,0xb2da3b6e
2000.85,1.0,10,1,2,3,6,0xb2d8c612d
687537.11,3.0,32,4,4,2,10,0xb2d20513d
3545.45,1.0,11,2,2,3,7,0x3b9b3a5d
489021.63,4.0,1,4,4,4,12,0xb2d3c624d
99.42,2.0,52,1,3,2,6,0xb2d5282d
10475.44,1.0,4,2,2,4,8,0xb2d6b9bcd
5165.58,1.0,12,2,2,3,7,0xb2d34097d
1225033.68,4.0,0,4,4,4,12,0xb2d24af7
520001.31,3.0,0,4,4,4,12,0xb2d6fc64
956.14,1.0,7,1,2,3,6,0xb2d5f8dbd
330007.36,7.0,14,4,4,3,11,0xb2d07a63d
566473.57,7.0,4,4,4,4,12,0xb2d25692d
156001.82,4.0,21,3,4,2,9,0xb2d97681d
3.49,1.0,223,1,2,1,4,0xb2d59083d
303863.97,6.0,137,4,4,1,9,0xb2d5d083
27741.49,1.0,0,2,2,4,8,0xb2d1ddcb
234.27,1.0,11,1,2,3,6,0xb2d33430
13998.33,1.0,4,2,2,4,8,0xb2d6c1a4
51612.85,2.0,56,2,3,2,7,0xb2d6159ad
230843.34,2.0,41,3,3,2,8,0xb2d1ac1c
58058.44,10.0,6,3,4,3,10,0xb2d09646
40001.27,2.0,92,2,3,1,6,0xb2d665cbd
850.61,2.0,13,1,3,3,7,0xb2d5ca62d
500000.0,1.0,1,4,2,4,10,0xb2d966e9d
100003.4,2.0,18,3,3,2,8,0xb2d56eb1d
0.83,1.0,7,1,2,3,6,0xb2d8d9a6
3.22,1.0,49,1,2,2,5,0xb2d20f97
115157.22,3.0,5,3,4,3,10,0x3b9b0fcfd
50023.38,2.0,122,2,3,1,6,0xb2d0d130d
521066.47,3.0,31,4,4,2,10,0xb2d24888d
1328.31,1.0,56,1,2,2,5,0xb2d699cad
1174.71,1.0,184,1,2,1,4,0xb2d23002d
1409.73,1.0,92,1,2,1,4,0xb2d0fc44d
133005.64,3.0,83,3,4,1,8,0xb2d539d6d
200095.26,2.0,156,3,3,1,7,0xb2d5b32b
10085.41,2.0,9,2,3,3,8,0x3b9b1771
726219.39,13.0,0,4,4,4,12,0xb2d170ddd
2804.51,1.0,15,1,2,3,6,0xb2d6f08f
55211.85,3.0,1,3,4,4,11,0xb2d8e218d
82064.15,2.0,206,3,3,1,7,0xb2d2ceb1d
1751.64,1.0,232,1,2,1,4,0xb2d6275ad
51863.08,2.0,83,2,3,1,6,0xb2d4c893
581864.72,5.0,18,4,4,2,10,0xb2d23bb0d
606466.88,6.0,0,4,4,4,12,0xb2d3bd63
300233.18,2.0,157,4,3,1,8,0xb2d61352
9423.72,1.0,10,2,2,3,7,0xb2d61841d
1813.37,1.0,1,1,2,4,7,0xb2d4cc28
339641.72,4.0,27,4,4,2,10,0xb2d16ff0d
470041.5,6.0,0,4,4,4,12,0xb2d5bae8d
30000.32,2.0,41,2,3,2,7,0xb2d921bcd
102437.63,2.0,13,3,3,3,9,0xb2d503ced
850040.01,6.0,21,4,4,2,10,0xb2d0f37d
210862.61,3.0,13,3,4,3,10,0xb2d6486dd
457740.87,3.0,2,4,4,4,12,0xb2d06fa8
210027.08,2.0,32,3,3,2,8,0xb2d1b775d
1073.09,1.0,249,1,2,1,4,0xb2d199ac
155113.19,3.0,71,3,4,1,8,0xb2d503bbd
650023.59,3.0,80,4,4,1,9,0xb2d29ee9d
560939.21,2.0,100,4,3,1,8,0xb2d34975d
20623.12,3.0,0,2,4,4,10,0xb2d0681f
203554.53,2.0,167,3,3,1,7,0xb2d8e2f2
980.7,1.0,32,1,2,2,5,0xb2d2c0a8d
2370.59,1.0,184,1,2,1,4,0xb2d58a26d
120080.95,3.0,6,3,4,3,10,0xb2d61873d
74.74,1.0,0,1,2,4,7,0xb2d57c2fd
4750050.23,3.0,61,4,4,2,10,0xb2d80167d
1307.96,1.0,60,1,2,2,5,0xb2d67ccd
160.49,1.0,35,1,2,2,5,0xb2d685e2
211187.92,2.0,69,3,3,1,7,0xb2d283d7
6491.43,1.0,92,2,2,1,5,0x3b9b3030d
62008.77,2.0,70,3,3,1,7,0xb2d0ed5d
0.0,1.0,145,1,2,1,4,0xb2d6e77bd
4773.16,1.0,18,2,2,2,6,0xb2d9860a
31996.61,1.0,92,2,2,1,5,0xb2d607a8d
13576.16,1.0,21,2,2,2,6,0xb2d21eae
2257.43,1.0,184,1,2,1,4,0xb2d0e00dd
50786.98,1.0,184,2,2,1,5,0xb2d0b8a5d
82183.49,1.0,19,3,2,2,7,0xb2d33c00d
10030.77,2.0,80,2,3,1,6,0xb2d6c83f
4746.35,1.0,20,2,2,2,6,0xb2d60c59d
50078.57,3.0,85,2,4,1,7,0xb2d3d13ad
870155.18,4.0,87,4,4,1,9,0xb2d59badd
421026.5,2.0,32,4,3,2,9,0xb2d4ac0dd
270000.12,2.0,7,3,3,3,9,0xb2d9b17a
14989.68,1.0,2,2,2,4,8,0xb2d8da53d
2563.13,1.0,0,1,2,4,7,0xb2d6f913d
11.08,1.0,88,1,2,1,4,0xb2d280d0
57000.53,2.0,0,3,3,4,10,0xb2d78f29d
280047.05,5.0,77,3,4,1,8,0xb2d42c4ad
102801.82,2.0,53,3,3,2,8,0xb2d8f376
1157239.46,13.0,4,4,4,4,12,0xb2d1041a
31001.31,2.0,20,2,3,2,7,0xb2d940e8
3475.01,1.0,57,2,2,2,6,0xb2d78bbad
3991.5,1.0,184,2,2,1,5,0xb2d37744d
410067.59,5.0,11,4,4,3,11,0xb2d90d11d
143600.0,3.0,0,3,4,4,11,0xb2da4e9b
4.22,1.0,14,1,2,3,6,0xb2d2e779
200052.3,2.0,8,3,3,3,9,0xb2d8e798d
629185.85,6.0,41,4,4,2,10,0xb2d43654d
1674.32,1.0,14,1,2,3,6,0xb2d2073bd
52966.8,2.0,12,3,3,3,9,0xb2d4eb47d
271000.75,8.0,1,3,4,4,11,0xb2d3ef50d
623966.22,7.0,0,4,4,4,12,0xb2d2417fd
650.92,1.0,0,1,2,4,7,0xb2d1beb3
40004.33,2.0,27,2,3,2,7,0xb2d242ddd
6419.71,1.0,16,2,2,2,6,0xb2d6bb0d
1525.3,1.0,188,1,2,1,4,0xb2d6aaaf
2066.7,3.0,21,1,4,2,7,0x3b9b1ac5d
1017.8,1.0,92,1,2,1,4,0x3b9b48a6
112919.51,3.0,95,3,4,1,8,0xb2d622f1d
0.0,1.0,6,1,2,3,6,0xb2d8f4b4d
104.21,1.0,18,1,2,2,5,0xb2d6ecbfd
11119.3,1.0,263,2,2,1,5,0xb2d39ac7
11635.14,1.0,231,2,2,1,5,0xb2d353bbd
2.74,1.0,110,1,2,1,4,0xb2d956b8d
150188.36,3.0,101,3,4,1,8,0xb2d245e6d
20581.13,1.0,34,2,2,2,6,0xb2d63b96d
750054.11,5.0,0,4,4,4,12,0xb2d2a056d
49981.25,1.0,2,2,2,4,8,0xb2d24f96d
170014.68,3.0,153,3,4,1,8,0xb2d6a8a7d
20302.59,2.0,132,2,3,1,6,0xb2d5b3e5
63.87,1.0,0,1,2,4,7,0xb2d95a1e
736997.22,6.0,92,4,4,1,9,0xb2d109ff
6275.83,1.0,3,2,2,4,8,0xb2d37190
50000.53,2.0,181,2,3,1,6,0xb2d6b2d4d
12703.42,1.0,0,2,2,4,8,0xb2d2eb23d
70837.22,1.0,6,3,2,3,8,0xb2d37508
342857.16,8.0,11,4,4,3,11,0xb2d443a1d
734305.45,3.0,123,4,4,1,9,0xb2d11def
132924.86,2.0,256,3,3,1,7,0xb2d08912d
600067.51,1.0,3,4,2,4,10,0xb2d53069
367023.29,3.0,74,4,4,1,9,0xb2d29c4e
161.01,2.0,64,1,3,2,6,0xb2d95388
1006.09,1.0,184,1,2,1,4,0xb2d381c1d
10284.15,2.0,32,2,3,2,7,0xb2d2c50cd
1.01,1.0,19,1,2,2,5,0xb2d94631
2550122.17,4.0,1,4,4,4,12,0xb2d3a55f
101107.91,2.0,8,3,3,3,9,0xb2d16d2f
53.83,1.0,7,1,2,3,6,0xb2d4ba92
120002.79,8.0,12,3,4,3,10,0xb2d5f9c8
1360.19,2.0,92,1,3,1,5,0xb2d1317b
15748.69,1.0,1,2,2,4,8,0xb2d55c3b
60472.83,2.0,171,3,3,1,7,0xb2d5f838d
500000.0,4.0,4,4,4,4,12,0xb2d9794ed
5000288.3,1.0,0,4,2,4,10,0xb2d6aed3d
578.84,1.0,94,1,2,1,4,0xb2d2da01
10105.38,1.0,1,2,2,4,8,0xb2d42095d
4310.23,1.0,235,2,2,1,5,0xb2d6c594
961981.68,1.0,0,4,2,4,10,0xb2d9cc0b
214.7,1.0,23,1,2,2,5,0xb2d7bcf2
90234.05,2.0,10,3,3,3,9,0xb2d0d8f2d
72503.01,2.0,7,3,3,3,9,0xb2d9f190
1234.74,1.0,92,1,2,1,4,0xb2d07d47
450737.92,4.0,0,4,4,4,12,0xb2d1a45bd
51.8,1.0,1,1,2,4,7,0xb2d3b764d
3008.07,1.0,84,2,2,1,5,0xb2d643d5
501742.92,7.0,0,4,4,4,12,0xb2d19419d
416311.61,2.0,31,4,3,2,9,0xb2d106ddd
4190.0,1.0,162,2,2,1,5,0xb2d5ac65d
20211.79,1.0,184,2,2,1,5,0xb2d25c34d
100040.12,2.0,168,3,3,1,7,0xb2d3b2ce
545288.66,4.0,36,4,4,2,10,0xb2d5c369
0.0,1.0,6,1,2,3,6,0xb2d2cc21
317392.21,6.0,63,4,4,2,10,0xb2d2a689
549263.09,5.0,13,4,4,3,11,0xb2d37743
130014.17,2.0,2,3,3,4,10,0xb2d23885
30000.32,2.0,52,2,3,2,7,0xb2d90cc3d
234017.9,2.0,17,3,3,2,8,0xb2d2919fd
137.79,2.0,5,1,3,3,7,0xb2d3ff62d
98012.18,3.0,0,3,4,4,11,0xb2d85c80d
4.31,1.0,11,1,2,3,6,0xb2d83ac5
591347.41,4.0,139,4,4,1,9,0xb2d07a77d
411662.88,4.0,80,4,4,1,9,0xb2d8e0bcd
629.52,1.0,8,1,2,3,6,0xb2d2cb5ad
569226.03,6.0,11,4,4,3,11,0xb2d14e1d
54661.68,1.0,0,3,2,4,9,0xb2d4188dd
307351.8,5.0,74,4,4,1,9,0xb2d4f3d2
0.54,1.0,5,1,2,3,6,0xb2d604bc
25370.19,1.0,18,2,2,2,6,0xb2d8db43
699.52,1.0,8,1,2,3,6,0xb2d2ebc5
1431007.04,9.0,1,4,4,4,12,0xb2d2f24bd
5995.65,1.0,15,2,2,3,7,0xb2d70706d
602.32,1.0,0,1,2,4,7,0xb2d0ef36d
200000.0,2.0,18,3,3,2,8,0xb2da334f
500094.36,4.0,193,4,4,1,9,0xb2d43725
860185.25,7.0,32,4,4,2,10,0xb2d3827dd
5010.04,1.0,199,2,2,1,5,0xb2d64d2ed
0.07,1.0,1,1,2,4,7,0xb2d5c5bcd
25757.61,1.0,184,2,2,1,5,0xb2d15bfc
261517.91,3.0,1,3,4,4,11,0xb2d936ccd
18373.64,1.0,9,2,2,3,7,0xb2d5693bd
49.58,1.0,9,1,2,3,6,0xb2d5cf2d
11135.53,1.0,184,2,2,1,5,0xb2d37c8a
5.1,1.0,0,1,2,4,7,0xb2d2b668
300265.37,2.0,14,4,3,3,10,0xb2d912a0d
373779.93,5.0,25,4,4,2,10,0xb2d86ca0d
14.68,1.0,2,1,2,4,7,0xb2d567a0d
760065.29,9.0,0,4,4,4,12,0xb2d57072d
40000044.82,3.0,92,4,4,1,9,0xb2d362fe
111063.45,2.0,136,3,3,1,7,0xb2d5c470
743990.49,9.0,0,4,4,4,12,0x3b9b2711d
486528.72,5.0,1,4,4,4,12,0xb2d20690
104.11,1.0,1,1,2,4,7,0xb2d98dce
61904.66,3.0,11,3,4,3,10,0xb2d60868
111374.57,1.0,0,3,2,4,9,0xb2d2753a
300017.15,2.0,11,3,3,3,9,0xb2d4e13fd
127292.87,6.0,13,3,4,3,10,0xb2d6969e
1008.61,3.0,92,1,4,1,6,0x3b9af4f6d
479.06,1.0,13,1,2,3,6,0xb2d38069d
1637.87,1.0,92,1,2,1,4,0xb2d2a974d
50774.07,2.0,102,2,3,1,6,0xb2d40f71d
302805.42,2.0,4,4,3,4,11,0xb2d5abc0d
373177.98,2.0,235,4,3,1,8,0xb2d12025d
315854.98,10.0,24,4,4,2,10,0xb2d3cf57d
61819.09,2.0,0,3,3,4,10,0xb2d60868d
263005.06,5.0,6,3,4,3,10,0xb2d9ec85
140049.38,3.0,0,3,4,4,11,0xb2d23596d
167460.35,3.0,206,3,4,1,8,0x3b9b2e09d
10.34,1.0,133,1,2,1,4,0xb2d0d2ead
120004.06,2.0,83,3,3,1,7,0xb2d8ce78
135000.0,1.0,5,3,2,3,8,0xb2da5f79
500025.11,5.0,18,4,4,2,10,0xb2d0e46ad
1.22,1.0,83,1,2,1,4,0xb2d921b0
3125.89,1.0,13,2,2,3,7,0xb2d5980ed
180028.23,3.0,94,3,4,1,8,0xb2d13f3cd
700333.0,2.0,0,4,3,4,11,0xb2d98239d
1801.1,1.0,20,1,2,2,5,0xb2d6dd86d
301374.64,3.0,8,4,4,3,11,0xb2d15284
13348.16,1.0,14,2,2,3,7,0xb2d86c11d
1029.04,2.0,160,1,3,1,5,0xb2d45bbcd
460153.7,4.0,80,4,4,1,9,0xb2d23a76
200001.26,2.0,11,3,3,3,9,0xb2d96b90
202644.13,3.0,24,3,4,2,9,0xb2d35a4cd
5917.98,2.0,4,2,3,4,9,0x3b9b4616d
2121.82,1.0,92,1,2,1,4,0xb2d34d6bd
3523.28,1.0,92,2,2,1,5,0xb2d31721d
1302.21,5.0,8,1,4,3,8,0x3b9af1b3
201146.8,2.0,32,3,3,2,8,0xb2d509edd
4.89,1.0,1,1,2,4,7,0xb2d1998dd
3124.99,3.0,92,2,4,1,7,0xb2d39264d
9929.17,1.0,52,2,2,2,6,0xb2d21dc3
100001.06,2.0,45,3,3,2,8,0xb2d90a49d
523081.8,4.0,10,4,4,3,11,0xb2d35d24d
200000.0,2.0,4,3,3,4,10,0xb2d97288d
0.0,2.0,2,1,3,4,8,0x3b9b4712
727550.12,1.0,1,4,2,4,10,0xb2d650cdd
1300059.03,5.0,13,4,4,3,11,0xb2d6092fd
2481.89,1.0,0,1,2,4,7,0xb2d45bb9d
61000.0,2.0,0,3,3,4,10,0xb2d2ed13d
32207.43,1.0,4,2,2,4,8,0xb2d485c8d
630066.16,4.0,32,4,4,2,10,0xb2d58251d
778.29,1.0,11,1,2,3,6,0xb2d6ad9e
554277.05,13.0,0,4,4,4,12,0x3b9b1c00
41360.39,1.0,8,2,2,3,7,0xb2d2d313
303444.1,4.0,3,4,4,4,12,0xb2d55ebcd
891.91,1.0,4,1,2,4,7,0xb2d452ec
322.56,1.0,5,1,2,3,6,0xb2d3aab7
80.14,1.0,35,1,2,2,5,0xb2d92531
37364.9,1.0,13,2,2,3,7,0xb2d157f8d
2085.2,1.0,184,1,2,1,4,0xb2d30f83
475907.54,7.0,18,4,4,2,10,0xb2d411b1d
100092.34,3.0,20,3,4,2,9,0xb2d134c5d
699.78,1.0,0,1,2,4,7,0xb2d0f359
1904635.84,5.0,0,4,4,4,12,0xb2d6b1f9d
3343.33,2.0,1,2,3,4,9,0xb2d174f1
200751.95,2.0,24,3,3,2,8,0xb2d0ea48
0.42,1.0,11,1,2,3,6,0xb2da3ba2
533488.77,8.0,3,4,4,4,12,0xb2d2a29fd
200098.2,2.0,0,3,3,4,10,0xb2d16590
106354.01,1.0,0,3,2,4,9,0xb2d27c2dd
206003.11,3.0,80,3,4,1,8,0xb2d22c3dd
258338.56,3.0,8,3,4,3,10,0xb2d6e168d
98063.94,1.0,5,3,2,3,8,0xb2d6e578
200000.0,2.0,4,3,3,4,10,0xb2da6194
1684.56,1.0,184,1,2,1,4,0xb2d2a179d
9290.41,1.0,3,2,2,4,8,0xb2d3c369d
6076.42,1.0,13,2,2,3,7,0xb2d904bd
430170.54,3.0,7,4,4,3,11,0xb2d60c8dd
18.17,1.0,55,1,2,2,5,0xb2d2cdd3d
5866.66,1.0,11,2,2,3,7,0xb2d4173a
75115.9,1.0,18,3,2,2,7,0xb2d6bd0c
30001.82,3.0,42,2,4,2,8,0xb2d54f14d
8791.65,1.0,25,2,2,2,6,0xb2d9215c
214032.89,5.0,0,3,4,4,11,0xb2d627e1d
2428.86,1.0,184,1,2,1,4,0x3b9b22ed
61505.26,1.0,92,3,2,1,6,0xb2d40f6bd
11947.13,1.0,0,2,2,4,8,0xb2d128ee
8690.66,1.0,21,2,2,2,6,0xb2d264c7d
1268190.36,7.0,82,4,4,1,9,0xb2d637fcd
325116.13,6.0,19,4,4,2,10,0x3b9b1339d
5272.9,1.0,0,2,2,4,8,0xb2d171fed
10281.29,1.0,14,2,2,3,7,0xb2d8fd74
349054.19,4.0,1,4,4,4,12,0xb2d13b24
50001.58,2.0,235,2,3,1,6,0xb2d6e6a9
60005.7,2.0,83,3,3,1,7,0xb2d983fb
1409.27,1.0,16,1,2,2,5,0xb2d2f535
191867.02,3.0,2,3,4,4,11,0xb2d15ed4d
4798.61,1.0,229,2,2,1,5,0xb2d29c1f
500037.7,2.0,17,4,3,2,9,0xb2d16b24
296128.16,1.0,5,3,2,3,8,0xb2d6df3a
41138.19,1.0,11,2,2,3,7,0xb2d6f5bad
2430.71,1.0,3,1,2,4,7,0xb2d6bce0
3336.12,1.0,0,2,2,4,8,0xb2d8f3f5d
501406.23,3.0,12,4,4,3,11,0xb2d21b27
4885.7,1.0,146,2,2,1,5,0xb2d110c7
483071.62,5.0,3,4,4,4,12,0xb2d4f568
6929.51,1.0,92,2,2,1,5,0xb2d4419b
500010.42,3.0,4,4,4,4,12,0xb2d9fcae
1090.76,1.0,92,1,2,1,4,0xb2d35173
8935.41,1.0,6,2,2,3,7,0xb2d93470d
51487.09,2.0,25,2,3,2,7,0xb2d08c69d
301457.39,3.0,32,4,4,2,10,0xb2d695d1d
1007.88,1.0,220,1,2,1,4,0xb2d58143
206400.11,3.0,0,3,4,4,11,0xb2d909a1d
30000.0,2.0,12,2,3,3,8,0xb2d63815
211527.99,4.0,25,3,4,2,9,0xb2d16f6fd
200627.93,3.0,20,3,4,2,9,0xb2d1c39dd
10106.71,1.0,184,2,2,1,5,0xb2d202c6d
50002.11,2.0,35,2,3,2,7,0xb2d9f5e0
220000.0,2.0,7,3,3,3,9,0xb2d96e6a
534309.05,2.0,164,4,3,1,8,0xb2d2bbbad
50001.58,2.0,24,2,3,2,7,0xb2d946cc
1136.72,1.0,154,1,2,1,4,0xb2d16227d
56900.65,1.0,92,3,2,1,6,0xb2d33e0bd
722000.59,12.0,11,4,4,3,11,0xb2d52b75d
1580112.46,5.0,11,4,4,3,11,0xb2d251b0d
2828.22,1.0,237,1,2,1,4,0xb2d48c6cd
500000.08,2.0,11,4,3,3,10,0xb2d8e65f
29717.82,1.0,108,2,2,1,5,0xb2d1d302
14325.88,1.0,118,2,2,1,5,0xb2d325ed
308166.55,3.0,29,4,4,2,10,0xb2d39dd5d
1.32,1.0,13,1,2,3,6,0xb2d69f1a
822050.83,3.0,59,4,4,2,10,0xb2d0edcfd
1376321.42,1.0,5,4,2,3,9,0xb2d56161d
4981.03,1.0,0,2,2,4,8,0xb2d5e894
4626.31,1.0,0,2,2,4,8,0xb2d177fe
1004.98,1.0,184,1,2,1,4,0xb2d435add
4201.72,4.0,184,2,4,1,7,0xb2d3fa59d
2.8,1.0,20,1,2,2,5,0xb2d92037
7927.56,6.0,24,2,4,2,8,0xb2d3c4c0
7.85,1.0,50,1,2,2,5,0xb2d5a64c
3282.82,1.0,92,2,2,1,5,0xb2d14990d
210091.66,2.0,3,3,3,4,10,0xb2da3337
1326.8,1.0,17,1,2,2,5,0xb2d23a98d
383.98,1.0,9,1,2,3,6,0xb2d2fc8b
1545.48,1.0,5,1,2,3,6,0xb2d6c189
76552.02,2.0,101,3,3,1,7,0xb2d60174d
60057.63,1.0,92,3,2,1,6,0xb2d5ab34d
2092.98,1.0,14,1,2,3,6,0xb2d1d502
161897.54,4.0,186,3,4,1,8,0xb2d58f34d
100000.0,1.0,7,3,2,3,8,0xb2d96f83
10003.61,2.0,19,2,3,2,7,0xb2d64f74
288762.14,6.0,182,3,4,1,8,0x3b9b247e
150551.23,6.0,29,3,4,2,9,0xb2d4d128d
9899.11,2.0,184,2,3,1,6,0xb2d0aa21d
1420371.88,11.0,0,4,4,4,12,0xb2d0eec0d
582776.08,5.0,1,4,4,4,12,0xb2d30f9dd
316902.87,5.0,73,4,4,1,9,0xb2d17c30
155279.54,1.0,3,3,2,4,9,0xb2d5f14b
794049.84,3.0,30,4,4,2,10,0xb2d7eec3d
13001.44,2.0,139,2,3,1,6,0xb2d1b910
594.82,1.0,5,1,2,3,6,0xb2d92a3d
11824.87,1.0,114,2,2,1,5,0xb2d5a9e8
102410.56,2.0,0,3,3,4,10,0xb2d20aa4d
1321.15,1.0,184,1,2,1,4,0xb2d17bc7
500260.38,1.0,0,4,2,4,10,0xb2d8f024
810031.45,6.0,20,4,4,2,10,0xb2d96dd5d
242004.94,3.0,10,3,4,3,10,0xb2d44511d
1631.36,1.0,74,1,2,1,4,0xb2d12db1d
939000.51,14.0,4,4,4,4,12,0xb2d5fb2dd
86.56,1.0,26,1,2,2,5,0xb2d2be0fd
2810305.22,7.0,3,4,4,4,12,0xb2d42d3b
1949.82,1.0,115,1,2,1,4,0xb2d8e41cd
205741.79,2.0,63,3,3,2,8,0xb2d68631d
4157.28,2.0,28,2,3,2,7,0xb2d1205fd
3301.77,1.0,0,2,2,4,8,0xb2d3cd1fd
10474.99,2.0,48,2,3,2,7,0xb2d54ce6d
100001.06,2.0,10,3,3,3,9,0xb2d967d2
400046.01,3.0,9,4,4,3,11,0xb2d38bb1d
12913.61,1.0,15,2,2,3,7,0xb2d8cb32
1374.45,1.0,14,1,2,3,6,0xb2d2bae8d
100000.0,4.0,1,3,4,4,11,0xb2d62a35
85112.31,1.0,135,3,2,1,6,0xb2d51778d
1809073.14,3.0,1,4,4,4,12,0xb2d94978d
60153.57,1.0,155,3,2,1,6,0xb2d4201c
30001.84,2.0,206,2,3,1,6,0xb2d5b8e3
34551.61,1.0,8,2,2,3,7,0xb2d2ebc8d
30562.29,2.0,0,2,3,4,9,0xb2d5c33fd
529039.75,2.0,67,4,3,1,8,0xb2d339a8
217.13,1.0,8,1,2,3,6,0xb2d93aa1
58349.9,1.0,7,3,2,3,8,0xb2d42304
10600.62,2.0,19,2,3,2,7,0xb2d94d37
40049.56,1.0,21,2,2,2,6,0xb2d698fa
2970.33,1.0,41,2,2,2,6,0xb2d4863d
9885.02,1.0,0,2,2,4,8,0xb2d6f4e1
7.38,1.0,75,1,2,1,4,0xb2d97dd7
500030.05,1.0,0,4,2,4,10,0xb2d5dde8
150176.13,3.0,28,3,4,2,9,0xb2d43068
308.22,1.0,0,1,2,4,7,0xb2d46f47d
220000.0,2.0,11,3,3,3,9,0xb2da4d66
3199.99,1.0,103,2,2,1,5,0xb2d4db76
59.69,1.0,6,1,2,3,6,0xb2d0c356
300020.0,2.0,5,3,3,3,9,0xb2da3aa0
83743.87,2.0,0,3,3,4,10,0xb2d16070d
0.42,1.0,184,1,2,1,4,0xb2d2a742d
2659.69,1.0,19,1,2,2,5,0xb2d64ce2d
146.18,1.0,42,1,2,2,5,0xb2d5b96a
1041354.43,8.0,0,4,4,4,12,0xb2d0cc53d
605662.26,16.0,1,4,4,4,12,0xb2d1c8d2d
384114.94,2.0,109,4,3,1,8,0xb2d57858d
1521.84,1.0,311,1,2,1,4,0xb2d4004ad
101016.71,2.0,112,3,3,1,7,0xb2d6923a
260916.63,7.0,67,3,4,1,8,0xb2d6ea06d
510000.01,3.0,4,4,4,4,12,0xb2da01cc
100032.55,2.0,33,3,3,2,8,0xb2d61423d
40214.78,2.0,59,2,3,2,7,0xb2d27468
808709.0,16.0,1,4,4,4,12,0xb2d25a42
15.01,1.0,1,1,2,4,7,0xb2d1ac1cd
941269.29,5.0,26,4,4,2,10,0xb2d8d8e2d
99807.6,1.0,13,3,2,3,8,0xb2d18f63d
771128.86,4.0,217,4,4,1,9,0xb2d14201
244921.9,79.0,0,3,4,4,11,0xb2d06826
90000.0,5.0,6,3,4,3,10,0xb2d3e422
487626.88,4.0,21,4,4,2,10,0xb2d10124
3658.82,1.0,22,2,2,2,6,0xb2d1ef73d
5513.91,2.0,28,2,3,2,7,0x3b9b450b
2.9,1.0,41,1,2,2,5,0xb2d976f1
354269.73,3.0,0,4,4,4,12,0xb2d573bdd
464684.73,4.0,0,4,4,4,12,0xb2d27b7dd
1135.57,1.0,0,1,2,4,7,0xb2d99e16
1778.83,1.0,8,1,2,3,6,0xb2d65bd0d
0.22,1.0,1,1,2,4,7,0xb2d68c58
10114.17,1.0,31,2,2,2,6,0xb2d6ff72d
3690.66,1.0,1,2,2,4,8,0xb2d928a9
580066.93,4.0,11,4,4,3,11,0xb2d10adfd
50309.02,1.0,3,2,2,4,8,0xb2d11136d
200000.0,2.0,8,3,3,3,9,0xb2da4f30
882354.02,7.0,4,4,4,4,12,0xb2d5634cd
1605.49,1.0,184,1,2,1,4,0xb2d31230d
20000.63,2.0,27,2,3,2,7,0xb2d94056d
35.87,1.0,14,1,2,3,6,0xb2d951c1d
70000.0,2.0,10,3,3,3,9,0xb2d58613
4851.77,1.0,0,2,2,4,8,0xb2d6b62c
210000.03,5.0,2,3,4,4,11,0xb2d6fd74d
143648.19,4.0,20,3,4,2,9,0xb2d1290ed
5466.83,1.0,9,2,2,3,7,0xb2d371ded
202703.95,4.0,116,3,4,1,8,0xb2d626aed
2590938.86,11.0,11,4,4,3,11,0xb2d168ac
1029.95,1.0,10,1,2,3,6,0xb2d2a4f7
3080.22,2.0,17,2,3,2,7,0xb2d21d19
1016.17,1.0,184,1,2,1,4,0xb2d120bed
236.94,1.0,9,1,2,3,6,0xb2d23eabd
63560.66,1.0,12,3,2,3,8,0xb2d3ebe0d
1002996.27,5.0,70,4,4,1,9,0xb2d43c42
480049.45,3.0,14,4,4,3,11,0xb2d8d101d
9.94,27.0,26,1,4,2,7,0xb2d281a7d
770052.99,5.0,18,4,4,2,10,0xb2d5d7aed
82469.42,2.0,53,3,3,2,8,0xb2d26d29d
0.19,1.0,6,1,2,3,6,0xb2d5e9e2
111293.04,2.0,95,3,3,1,7,0xb2d5779dd
1088600.0,3.0,0,4,4,4,12,0xb2d1ec2fd
525368.42,1.0,16,4,2,2,8,0xb2d2b6ced
722358.34,1.0,59,4,2,2,8,0xb2d22c88
582330.22,2.0,0,4,3,4,11,0xb2d5f89d
1010.93,1.0,184,1,2,1,4,0xb2d2962ad
13366.35,1.0,0,2,2,4,8,0xb2d1ff9bd
1.54,1.0,74,1,2,1,4,0xb2d61267d
124.66,1.0,74,1,2,1,4,0xb2d8d71ad
14934.59,4.0,50,2,4,2,8,0xb2d49651d
4021.78,1.0,0,2,2,4,8,0xb2d5d964
15004.3,1.0,184,2,2,1,5,0xb2d06ff4
15101.83,1.0,0,2,2,4,8,0xb2d70457d
26288.39,1.0,0,2,2,4,8,0xb2d5a100
3642.59,1.0,22,2,2,2,6,0xb2d91cec
360972.83,6.0,0,4,4,4,12,0x3b9b0e58
200002.11,2.0,91,3,3,1,7,0xb2d8b568
312680.67,3.0,126,4,4,1,9,0xb2d23cc6d
436004.2,6.0,39,4,4,2,10,0xb2d0f6add
7749.57,1.0,2,2,2,4,8,0xb2d5b35cd
322.07,1.0,0,1,2,4,7,0xb2d9e5f8
1167277.34,6.0,16,4,4,2,10,0xb2d1683ad
9881.89,1.0,0,2,2,4,8,0xb2d1f578d
7.84,1.0,12,1,2,3,6,0xb2d8fa39d
4006.97,1.0,0,2,2,4,8,0xb2d7833ad
2801.17,1.0,0,1,2,4,7,0xb2d70083d
191294.58,5.0,0,3,4,4,11,0xb2d06772
400044.96,3.0,24,4,4,2,10,0xb2d18c34d
1310.5,2.0,262,1,3,1,5,0xb2d6a646
114289.59,3.0,18,3,4,2,9,0xb2d5925b
131466.73,2.0,53,3,3,2,8,0xb2d60fbe
53000.98,3.0,73,3,4,1,8,0xb2d19466d
7367.98,4.0,0,2,4,4,10,0xb2d0cb64d
47316.52,2.0,304,2,3,1,6,0xb2d56c54d
500000.0,3.0,0,4,4,4,12,0xb2d98cb5
6160.02,1.0,145,2,2,1,5,0xb2d2de33d
193442.94,2.0,108,3,3,1,7,0xb2d26f86d
4193.71,1.0,32,2,2,2,6,0xb2d529b2
400072.59,5.0,0,4,4,4,12,0xb2d40d16d
30846.45,2.0,38,2,3,2,7,0xb2d5e4a5d
52422.4,6.0,3,3,4,4,11,0x3b9b263f
450007.91,4.0,0,4,4,4,12,0xb2d95d7ad
38.45,1.0,50,1,2,2,5,0xb2d2c605d
2221.73,1.0,4,1,2,4,7,0xb2d2df59d
50001.58,2.0,11,2,3,3,8,0xb2da3c25
124256.58,8.0,10,3,4,3,10,0xb2d51b6ed
51635.8,2.0,76,2,3,1,6,0xb2d5bf8ad
7600.95,1.0,92,2,2,1,5,0xb2d238c4d
57.99,1.0,9,1,2,3,6,0xb2d4c83fd
9834.58,10.0,0,2,4,4,10,0x3b9af162
1683.09,1.0,92,1,2,1,4,0x3b9b2ff3
388656.47,6.0,20,4,4,2,10,0x3b9b102cd
7023198.99,3.0,36,4,4,2,10,0xb2d204b3
39458.11,1.0,1,2,2,4,8,0xb2d32719
2819.07,1.0,0,1,2,4,7,0xb2d68a8ad
55154.26,1.0,2,3,2,4,9,0xb2d21929
231002.44,3.0,38,3,4,2,9,0xb2d8e233d
11040.08,1.0,7,2,2,3,7,0xb2d0bcaf
277466.7,10.0,0,3,4,4,11,0xb2d55aefd
9385.37,1.0,1,2,2,4,8,0xb2d65408d
5972.22,1.0,1,2,2,4,8,0xb2d3e84ed
32054.95,3.0,95,2,4,1,7,0xb2d1b482
9.01,1.0,9,1,2,3,6,0xb2d8c391d
6501.12,1.0,3,2,2,4,8,0xb2d30f7f
410092.56,9.0,2,4,4,4,12,0xb2d5f6ca
30000.32,3.0,6,2,4,3,9,0xb2d459c4
0.25,1.0,63,1,2,2,5,0xb2d5d19e
300000.0,2.0,6,3,3,3,9,0xb2da525e
80003.38,2.0,196,3,3,1,7,0xb2d7ad03
482382.48,2.0,0,4,3,4,11,0xb2d17986
70488.34,2.0,0,3,3,4,10,0xb2d647c8
50477.0,3.0,7,2,4,3,9,0xb2d28f7cd
120478.08,6.0,0,3,4,4,11,0xb2d2bb67d
0.0,1.0,3,1,2,4,7,0xb2d2f3da
104041.39,2.0,104,3,3,1,7,0xb2d29502
13.73,1.0,56,1,2,2,5,0xb2d9b6fc
355425.61,3.0,53,4,4,2,10,0xb2d298abd
200001.68,2.0,6,3,3,3,9,0xb2d9257c
60089.46,2.0,1,3,3,4,10,0xb2d34ad0d
33789.52,1.0,92,2,2,1,5,0xb2d24c8c
20.33,2.0,63,1,3,2,6,0xb2d8f1d6
30001.27,2.0,206,2,3,1,6,0xb2d68b41
637.76,1.0,34,1,2,2,5,0xb2d5b1aed
100.76,1.0,17,1,2,2,5,0xb2d30226
100002.11,2.0,10,3,3,3,9,0xb2d9636e
420144.31,3.0,3,4,4,4,12,0xb2d42ca2
250009.08,4.0,77,3,4,1,8,0xb2d5ddc7d
800000.0,4.0,1,4,4,4,12,0xb2d61c3cd
3099.99,1.0,184,2,2,1,5,0xb2d08f8a
60100.55,3.0,0,3,4,4,11,0xb2d94856
144077.52,1.0,17,3,2,2,7,0xb2d930bad
41012.59,4.0,14,2,4,3,9,0xb2d5eb7c
153315.2,3.0,139,3,4,1,8,0xb2d0ee98d
70000.74,2.0,20,3,3,2,8,0xb2d952d8
100058.5,2.0,231,3,3,1,7,0xb2d58363d
172.6,1.0,5,1,2,3,6,0xb2d2caa6d
51141.73,2.0,18,2,3,2,7,0xb2d61c6ed
8977.08,1.0,0,2,2,4,8,0xb2d6bf17d
510001.93,12.0,41,4,4,2,10,0xb2d29fa8
200230.74,3.0,25,3,4,2,9,0xb2d1f8b0d
0.01,1.0,6,1,2,3,6,0xb2d93204
7023.6,1.0,10,2,2,3,7,0xb2d43ae0
100344.45,2.0,16,3,3,2,8,0xb2d288afd
300008.86,3.0,3,3,4,4,11,0xb2d8a4f3
200031.7,2.0,7,3,3,3,9,0xb2d94532d
170006.45,4.0,19,3,4,2,9,0xb2d91abad
8.34,1.0,74,1,2,1,4,0xb2d6a213d
54015.11,2.0,67,3,3,1,7,0xb2d5ab30d
643305.42,2.0,18,4,3,2,9,0xb2d12b21d
67008.22,2.0,101,3,3,1,7,0xb2d2aeaed
749.98,1.0,1,1,2,4,7,0xb2d24093
956.52,1.0,33,1,2,2,5,0xb2d37658
1199.84,1.0,0,1,2,4,7,0xb2d1b605
3.18,2.0,21,1,3,2,6,0x3b9b3d12
1133532.04,10.0,8,4,4,3,11,0xb2d13dd1
11026.42,1.0,13,2,2,3,7,0xb2d78d29
748.68,1.0,4,1,2,4,7,0xb2d8c848
510107.62,4.0,8,4,4,3,11,0xb2d90f6bd
160902.67,5.0,76,3,4,1,8,0xb2d24b31
1810332.68,2.0,165,4,3,1,8,0xb2d1266ad
266954.14,1.0,7,3,2,3,8,0xb2d15543d
1050044.41,2.0,209,4,3,1,8,0xb2d685a2d
383369.1,3.0,6,4,4,3,11,0x3b9b0e15d
27.28,1.0,7,1,2,3,6,0xb2d1b95b
938937.52,5.0,17,4,4,2,10,0xb2d2b9e6d
4335809.14,10.0,0,4,4,4,12,0x3b9b182b
504369.66,3.0,141,4,4,1,9,0xb2d609ca
3500001.0,4.0,0,4,4,4,12,0xb2da6921
100000.56,2.0,95,3,3,1,7,0xb2d60f01
939635.15,3.0,25,4,4,2,10,0xb2d335c6d
141906.78,7.0,11,3,4,3,10,0xb2d12a8ad
1.63,1.0,6,1,2,3,6,0xb2d6bd25
85.7,1.0,0,1,2,4,7,0xb2d93bd8
7582.67,3.0,184,2,4,1,7,0x3b9ade70d
39283.57,1.0,92,2,2,1,5,0xb2d28427d
10003.36,2.0,18,2,3,2,7,0xb2d5849e
1.93,1.0,13,1,2,3,6,0xb2d61846
415416.63,1.0,11,4,2,3,9,0xb2d6174dd
8148.74,1.0,139,2,2,1,5,0xb2d2e9fad
2416.49,2.0,0,1,3,4,8,0xb2d28ab6d
10104.98,2.0,7,2,3,3,8,0xb2d5dc3c
5934.18,1.0,122,2,2,1,5,0xb2d5abb7d
21470.5,1.0,0,2,2,4,8,0xb2d6aa81d
60003.27,3.0,47,3,4,2,9,0xb2d64988d
2936.89,1.0,15,2,2,3,7,0xb2d5d74a
32777.07,1.0,10,2,2,3,7,0xb2d6f8eb
534146.0,5.0,0,4,4,4,12,0xb2d14770d
815017.98,15.0,25,4,4,2,10,0xb2d3bc52d
3.55,1.0,32,1,2,2,5,0xb2d279cb
350004.17,4.0,1,4,4,4,12,0xb2d232ac
208415.84,5.0,0,3,4,4,11,0xb2d211b5d
751750.29,6.0,66,4,4,2,10,0xb2d3709a
43.97,1.0,28,1,2,2,5,0xb2d6b5e5
1045.24,1.0,120,1,2,1,4,0xb2d6d375
400000.0,10.0,0,4,4,4,12,0xb2d3cdf1
7046.31,4.0,95,2,4,1,7,0xb2d0c9bf
2215.41,1.0,17,1,2,2,5,0xb2d9e8bd
596.69,1.0,6,1,2,3,6,0xb2d8f50e
474.35,1.0,10,1,2,3,6,0xb2d3ebb7
10009.89,3.0,14,2,4,3,9,0xb2d63292d
1016604.06,2.0,0,4,3,4,11,0xb2d55387
1050050.86,3.0,4,4,4,4,12,0xb2d52f2b
87.71,1.0,15,1,2,3,6,0xb2d112fd
500015.83,2.0,92,4,3,1,8,0xb2d97d0ed
153130.64,4.0,18,3,4,2,9,0xb2d50f44
70305.62,1.0,0,3,2,4,9,0xb2d5afcb
2033.17,1.0,25,1,2,2,5,0xb2d2f111d
342010.35,15.0,3,4,4,4,12,0xb2d533b9
240283.48,3.0,13,3,4,3,10,0xb2d9bf4f
920019.42,2.0,7,4,3,3,10,0xb2d95cebd
9081.85,1.0,0,2,2,4,8,0xb2d3f888
275002.72,5.0,4,3,4,4,11,0xb2d3f668d
1.38,1.0,69,1,2,1,4,0xb2d2a874
1.39,1.0,9,1,2,3,6,0xb2d278fbd
24360.45,1.0,184,2,2,1,5,0xb2d3b3e6d
669032.61,3.0,6,4,4,3,11,0xb2d286fad
55649.42,2.0,171,3,3,1,7,0xb2d2e395d
1692053.44,14.0,0,4,4,4,12,0xb2d5992fd
0.21,1.0,10,1,2,3,6,0xb2d3a85fd
2087.74,1.0,184,1,2,1,4,0xb2d0b917d
500000.0,2.0,5,4,3,3,10,0xb2d86e26
9202.21,1.0,16,2,2,2,6,0xb2d32151
5.83,1.0,10,1,2,3,6,0xb2d631f1
2039.12,1.0,159,1,2,1,4,0xb2d6e53d
804.11,1.0,15,1,2,3,6,0xb2d5c8df
40099.73,1.0,92,2,2,1,5,0xb2d651e0d
50001.06,2.0,74,2,3,1,6,0xb2d99c58
7073.27,1.0,92,2,2,1,5,0xb2d111b4d
862015.14,4.0,0,4,4,4,12,0xb2d6403d
1.16,1.0,7,1,2,3,6,0xb2d63267
5000.02,1.0,0,2,2,4,8,0xb2d2aa85
629516.8,2.0,28,4,3,2,9,0xb2d51b0e
90001.48,3.0,32,3,4,2,9,0xb2d9280cd
473640.96,1.0,1,4,2,4,10,0xb2d97d17d
30514.1,2.0,139,2,3,1,6,0xb2d62956d
371120.02,3.0,8,4,4,3,11,0xb2d42c54
1394700.57,4.0,6,4,4,3,11,0xb2d267ec
500012.05,2.0,6,4,3,3,10,0xb2d86e26d
404025.85,4.0,17,4,4,2,10,0xb2d429efd
28.0,1.0,18,1,2,2,5,0xb2d27310
1805.84,1.0,184,1,2,1,4,0xb2d33ec8
40001.69,2.0,55,2,3,2,7,0xb2d900f5d
220000.0,2.0,15,3,3,3,9,0xb2da377c
1364.45,1.0,9,1,2,3,6,0xb2d4fcf7
73338.67,2.0,3,3,3,4,10,0xb2d56174d
3175.5,1.0,273,2,2,1,5,0xb2d5badbd
50367.42,3.0,0,2,4,4,10,0x3b9b45b3
4839.3,1.0,9,2,2,3,7,0xb2d6e7f3
201480.94,2.0,8,3,3,3,9,0xb2d9fd84
97.43,1.0,49,1,2,2,5,0xb2d21a0fd
195627.61,2.0,1,3,3,4,10,0xb2d69dd2d
585.33,1.0,17,1,2,2,5,0xb2d27d5b
1475427.49,7.0,18,4,4,2,10,0xb2d14355d
200042.7,4.0,29,3,4,2,9,0xb2d5b28bd
797702.77,5.0,25,4,4,2,10,0xb2d1d493d
400710.53,3.0,27,4,4,2,10,0xb2d656f8d
16307.4,1.0,92,2,2,1,5,0xb2d4fdff
103225.93,3.0,41,3,4,2,9,0xb2d16a5cd
40143.24,2.0,0,2,3,4,9,0xb2d6c37e
1212.43,1.0,125,1,2,1,4,0xb2d62bfed
1072.81,1.0,184,1,2,1,4,0xb2d36bbd
672.16,1.0,11,1,2,3,6,0xb2d6245e
2128290.2,17.0,0,4,4,4,12,0xb2d1471e
19.47,1.0,84,1,2,1,4,0xb2d7f5ad
446014.25,6.0,6,4,4,3,11,0xb2d1ef58d
66.49,1.0,7,1,2,3,6,0xb2d2b9aad
800515.06,2.0,70,4,3,1,8,0xb2d5613d
51955.33,1.0,0,2,2,4,8,0xb2da65ce
50009.74,2.0,97,2,3,1,6,0xb2d5fca1d
230.59,1.0,61,1,2,2,5,0xb2d6c83fd
8794.46,1.0,16,2,2,2,6,0xb2d6bd5a
185434.29,3.0,27,3,4,2,9,0xb2d29662d
20646.91,2.0,4,2,3,4,9,0xb2d07fdd
46100.99,2.0,31,2,3,2,7,0xb2d93881d
330.04,1.0,4,1,2,4,7,0xb2d2e60f
3002610.83,3.0,28,4,4,2,10,0xb2d57ad8
5621.12,1.0,15,2,2,3,7,0xb2d9b2ef
210025.64,4.0,4,3,4,4,11,0xb2d1d6aed
221158.32,3.0,0,3,4,4,11,0xb2d8e76ad
4774.02,1.0,17,2,2,2,6,0xb2d2759c
263019.68,7.0,1,3,4,4,11,0xb2d12c01d
392033.12,4.0,132,4,4,1,9,0xb2d609ead
200002.0,2.0,1,3,3,4,10,0xb2d92d04
17739.4,1.0,7,2,2,3,7,0xb2d2518d
25693.66,1.0,182,2,2,1,5,0xb2d37b53
1219526.34,24.0,4,4,4,4,12,0xb2d5c580
114615.14,2.0,259,3,3,1,7,0xb2d17144d
42838.65,1.0,0,2,2,4,8,0xb2d4d0dcd
62.46,1.0,19,1,2,2,5,0xb2d3b1d1
39663.17,1.0,5,2,2,3,7,0xb2d48fae
756.12,1.0,13,1,2,3,6,0xb2d8f717
1502.45,1.0,45,1,2,2,5,0xb2d31577d
30000.32,2.0,42,2,3,2,7,0xb2d9e94e
462111.32,4.0,44,4,4,2,10,0xb2d5c041
18366.34,1.0,4,2,2,4,8,0xb2d5c923
350000.0,3.0,4,4,4,4,12,0xb2d97c9c
1219.12,1.0,92,1,2,1,4,0xb2d0da1dd
14.19,1.0,9,1,2,3,6,0xb2d1c25b
501776.04,2.0,34,4,3,2,9,0xb2da0130
204979.86,2.0,133,3,3,1,7,0xb2d11817d
456456.09,3.0,17,4,4,2,10,0xb2d2c779d
1668107.01,8.0,28,4,4,2,10,0xb2d0ebce
20084.87,2.0,39,2,3,2,7,0xb2d64b79
565025.79,7.0,47,4,4,2,10,0xb2d0d6aed
743.3,1.0,3,1,2,4,7,0xb2d1d141
339067.17,1.0,45,4,2,2,8,0xb2d2ffaf
3302.09,1.0,1,2,2,4,8,0xb2d38cea
3700039.06,2.0,77,4,3,1,8,0xb2d995ed
99422.16,3.0,0,3,4,4,11,0xb2d55259d
512.08,1.0,26,1,2,2,5,0xb2d47f74
1113915.34,5.0,1,4,4,4,12,0xb2d152aad
324915.44,2.0,124,4,3,1,8,0xb2d2a115
6635.49,1.0,32,2,2,2,6,0xb2d4efd0d
180088.82,2.0,52,3,3,2,8,0xb2d6bbe3d
16260.2,1.0,92,2,2,1,5,0xb2d14033d
657051.96,8.0,6,4,4,3,11,0xb2d1ac03
265053.32,4.0,76,3,4,1,8,0xb2d62d27d
10001.43,2.0,7,2,3,3,8,0xb2d605f3d
100325.75,4.0,34,3,4,2,9,0x3b9b37b2d
1481.68,3.0,11,1,4,3,8,0xb2d23cbc
210532.17,2.0,29,3,3,2,8,0xb2d5f105d
163706.82,3.0,80,3,4,1,8,0xb2d5615d
15140.6,1.0,20,2,2,2,6,0xb2d216d6
1712.76,1.0,39,1,2,2,5,0xb2d1b1ef
30960.38,3.0,0,2,4,4,10,0x3b9af139
774594.7,4.0,20,4,4,2,10,0xb2d32a41
270002.9,4.0,6,3,4,3,10,0xb2da161e
50030.71,2.0,60,2,3,2,7,0xb2d6d17cd
75232.79,2.0,2,3,3,4,10,0xb2d367b1d
37.28,1.0,18,1,2,2,5,0xb2d24c60
42.53,2.0,2,1,3,4,8,0xb2d0c791
30303.19,2.0,43,2,3,2,7,0xb2d6a5d9d
4492.22,1.0,9,2,2,3,7,0xb2d292bdd
105757.93,1.0,138,3,2,1,6,0xb2d2478cd
13070.4,1.0,9,2,2,3,7,0xb2d6d58c
478388.4,5.0,32,4,4,2,10,0xb2d5e53cd
3028.63,1.0,184,2,2,1,5,0xb2d36063d
443891.48,5.0,41,4,4,2,10,0xb2d2234c
600162.59,3.0,10,4,4,3,11,0xb2d3e5d4
2530064.05,5.0,18,4,4,2,10,0xb2d5754bd
7326.36,1.0,4,2,2,4,8,0xb2d705ccd
150019.58,3.0,224,3,4,1,8,0xb2d2a608d
0.0,1.0,4,1,2,4,7,0xb2d15627
430009.91,2.0,61,4,3,2,9,0xb2d68bbcd
350000.0,1.0,0,4,2,4,10,0xb2da6c64
12.57,1.0,63,1,2,2,5,0xb2d783e2d
351565.91,2.0,18,4,3,2,9,0xb2d95b71
12221.93,1.0,1,2,2,4,8,0xb2d33518d
7101.6,1.0,184,2,2,1,5,0xb2d0c46f
501485.96,3.0,13,4,4,3,11,0xb2d60532d
3223.41,1.0,97,2,2,1,5,0xb2d39034d
100009.08,2.0,172,3,3,1,7,0xb2d8d787d
41855.75,1.0,18,2,2,2,6,0xb2d6c4bbd
469.14,1.0,11,1,2,3,6,0xb2d5fcecd
225049.32,2.0,1,3,3,4,10,0xb2d69fefd
1766.32,1.0,0,1,2,4,7,0xb2d39e88d
280002.11,1.0,3,3,2,4,9,0xb2d96a73d
4176511.7,2.0,4,4,3,4,11,0xb2d23c62
30000.63,2.0,10,2,3,3,8,0xb2d96312
426823.35,3.0,116,4,4,1,9,0xb2d26eaed
851796.66,5.0,6,4,4,3,11,0xb2d30e41
578306.68,7.0,4,4,4,4,12,0xb2d91e63d
7557.56,1.0,8,2,2,3,7,0xb2d95706
101.23,1.0,13,1,2,3,6,0xb2d6249e
4977.31,1.0,92,2,2,1,5,0xb2d25ce4d
200001.85,2.0,18,3,3,2,8,0xb2d9c25e
2170.86,1.0,0,1,2,4,7,0xb2d19f01
51631.18,1.0,306,2,2,1,5,0xb2d4e139d
200980.33,3.0,6,3,4,3,10,0xb2d2447ed
196001.41,4.0,3,3,4,4,11,0xb2d509dbd
10000.11,2.0,92,2,3,1,6,0xb2d5c314d
84095.63,1.0,77,3,2,1,6,0xb2d8db71d
301.16,1.0,39,1,2,2,5,0xb2d9a905
35089.22,1.0,202,2,2,1,5,0xb2d5bf78d
60019.9,2.0,32,3,3,2,8,0xb2d9fc30
81726.3,1.0,18,3,2,2,7,0xb2d2e296d
674156.51,3.0,74,4,4,1,9,0xb2d41964
815836.2,4.0,38,4,4,2,10,0xb2d6378b
2895.06,1.0,0,2,2,4,8,0xb2d35f11d
20386.08,1.0,82,2,2,1,5,0xb2d59b4b
102035.18,2.0,10,3,3,3,9,0xb2d57330
50159.63,2.0,175,2,3,1,6,0xb2d25ee8d
4348.94,1.0,0,2,2,4,8,0xb2d33b78d
4013.03,1.0,92,2,2,1,5,0x3b9af654d
162513.03,3.0,0,3,4,4,11,0xb2d075f5d
212115.34,4.0,26,3,4,2,9,0xb2d940eed
37750.29,1.0,14,2,2,3,7,0xb2d1c9c7d
501894.33,2.0,48,4,3,2,9,0xb2d5e367d
1519806.23,3.0,46,4,4,2,10,0xb2d69a21d
1400017.52,2.0,12,4,3,3,10,0xb2d80e7f
592.09,1.0,15,1,2,3,6,0xb2d38fbdd
9540.28,1.0,54,2,2,2,6,0xb2d7913bd
4015.02,1.0,184,2,2,1,5,0xb2d401d7d
670110.1,1.0,0,4,2,4,10,0xb2d29c73
298.42,1.0,0,1,2,4,7,0xb2d56cf4
2000000.0,2.0,4,4,3,4,11,0xb2d3fbced
602944.36,5.0,23,4,4,2,10,0xb2d0b453d
2766960.48,7.0,0,4,4,4,12,0xb2d0bb52d
160074.56,3.0,35,3,4,2,9,0xb2d92280d
428.62,1.0,8,1,2,3,6,0xb2d30efe
14166.04,1.0,2,2,2,4,8,0xb2d6a172d
201070.47,5.0,5,3,4,3,10,0xb2d78059d
406528.73,5.0,5,4,4,3,11,0xb2d2d1acd
30000.63,2.0,47,2,3,2,7,0xb2d91239d
1511.25,1.0,184,1,2,1,4,0xb2d3e646d
80808.41,2.0,1,3,3,4,10,0xb2d9e331
2969.55,2.0,184,2,3,1,6,0x3b9b40ffd
2000000.0,1.0,0,4,2,4,10,0xb2d90fbf
32808.55,1.0,0,2,2,4,8,0xb2d28c3dd
6535.93,1.0,6,2,2,3,7,0xb2d9a909
849.45,1.0,7,1,2,3,6,0xb2d2c972d
52.7,1.0,2,1,2,4,7,0xb2d974a1
10000.77,2.0,49,2,3,2,7,0xb2d9cadf
3633.05,1.0,258,2,2,1,5,0xb2d2b4d2d
982674.89,11.0,19,4,4,2,10,0xb2d56c17
500021.11,2.0,90,4,3,1,8,0xb2d89f9dd
293916.03,2.0,63,3,3,2,8,0xb2d20658
100010.82,2.0,108,3,3,1,7,0xb2d5706bd
3034.95,1.0,92,2,2,1,5,0xb2d40938
2950080.26,3.0,94,4,4,1,9,0xb2d7836ed
202578.6,2.0,15,3,3,3,9,0xb2d68f21d
5.34,1.0,28,1,2,2,5,0xb2d96761
2429.94,3.0,10,1,4,3,8,0xb2d2cfc2
470035.0,3.0,27,4,4,2,10,0xb2d2e3add
15687.24,1.0,32,2,2,2,6,0xb2d07ac7
132040.56,2.0,97,3,3,1,7,0xb2d2131b
29044.3,1.0,0,2,2,4,8,0xb2d775c1
3101.2,1.0,14,2,2,3,7,0xb2d7f11cd
7.4,1.0,10,1,2,3,6,0xb2d23a48
2324.22,1.0,0,1,2,4,7,0xb2d319cf
1124.38,1.0,0,1,2,4,7,0xb2d37173d
850129.28,5.0,0,4,4,4,12,0xb2d3c63e
125.13,1.0,1,1,2,4,7,0xb2d292e9
4754.39,1.0,92,2,2,1,5,0xb2d64bdd
8.8,1.0,6,1,2,3,6,0xb2d70166
1327.21,1.0,10,1,2,3,6,0xb2d97337
4910.32,1.0,0,2,2,4,8,0xb2d6b5aed
205067.88,4.0,4,3,4,4,11,0xb2d93ca0d
2469060.69,1.0,34,4,2,2,8,0xb2d2d9c0d
300931.02,2.0,125,4,3,1,8,0xb2d2a9d3d
5919.25,1.0,10,2,2,3,7,0xb2d51d2d
594828.91,5.0,108,4,4,1,9,0xb2d25107
80097.7,2.0,34,3,3,2,8,0xb2d43cddd
240015.01,13.0,8,3,4,3,10,0xb2d52029d
163260.14,3.0,0,3,4,4,11,0xb2d0f30bd
71247.0,1.0,0,3,2,4,9,0xb2d5ee3ad
30.45,1.0,8,1,2,3,6,0xb2da4a16
500010.23,3.0,32,4,4,2,10,0xb2d2380d
80089.11,2.0,105,3,3,1,7,0xb2d3e5fad
981.74,1.0,19,1,2,2,5,0xb2d9340e
200005.8,2.0,10,3,3,3,9,0xb2d0bc75d
44291.51,1.0,18,2,2,2,6,0xb2d6c482
1.52,1.0,7,1,2,3,6,0xb2d981fd
76.36,1.0,62,1,2,2,5,0xb2d627f7d
565837.98,1.0,6,4,2,3,9,0xb2d17de9d
20001.05,2.0,98,2,3,1,6,0xb2d966b7d
200006.33,2.0,11,3,3,3,9,0xb2da3e6f
5100.5,1.0,124,2,2,1,5,0xb2d11e8e
550022.13,5.0,70,4,4,1,9,0xb2d451b8
7.2,1.0,12,1,2,3,6,0xb2d6aeff
200000.0,2.0,0,3,3,4,10,0xb2d5d899
306.59,1.0,0,1,2,4,7,0xb2d6d9c4
18237.13,1.0,10,2,2,3,7,0xb2d1f81ad
1930000.0,4.0,0,4,4,4,12,0x3b9af0c5d
2.14,1.0,20,1,2,2,5,0xb2d6a6ec
500052.13,2.0,20,4,3,2,9,0xb2d98a35
3848.34,3.0,131,2,4,1,7,0xb2d68320
79872.74,4.0,0,3,4,4,11,0xb2d6570cd
352106.55,3.0,38,4,4,2,10,0xb2d23711d
376395.7,5.0,0,4,4,4,12,0x3b9b3359
536.37,1.0,5,1,2,3,6,0xb2d54f85
5.9,1.0,19,1,2,2,5,0xb2d6d045
515687.36,3.0,30,4,4,2,10,0xb2d347ab
813474.47,4.0,11,4,4,3,11,0xb2d8fc4bd
1153468.18,7.0,104,4,4,1,9,0xb2d1ab1cd
70074.51,3.0,136,3,4,1,8,0xb2d075ea
1030.77,1.0,10,1,2,3,6,0xb2d6102c
7649.6,1.0,9,2,2,3,7,0xb2d27666d
1244049.99,11.0,70,4,4,1,9,0xb2d4956bd
300100.01,2.0,18,4,3,2,9,0xb2d9568c
2200068.51,6.0,21,4,4,2,10,0xb2d0ff31
30000.32,2.0,45,2,3,2,7,0xb2d91b60d
58.63,1.0,62,1,2,2,5,0xb2d62603d
3732.26,1.0,9,2,2,3,7,0xb2d92812
12.7,1.0,30,1,2,2,5,0xb2d58a7b
48.69,1.0,12,1,2,3,6,0xb2d330c7
216200.0,2.0,87,3,3,1,7,0xb2d2a263d
0.0,1.0,9,1,2,3,6,0xb2d32cf6d
116.37,1.0,19,1,2,2,5,0xb2d6972e
529120.25,2.0,193,4,3,1,8,0xb2d580dcd
736212.79,1.0,92,4,2,1,7,0xb2d2dea7d
849336.36,6.0,0,4,4,4,12,0xb2d216e9d
510046.55,4.0,19,4,4,2,10,0xb2d6b31bd
72880.5,4.0,0,3,4,4,11,0xb2d61415d
67.23,1.0,10,1,2,3,6,0xb2d4b9dc
10684.82,2.0,92,2,3,1,6,0xb2d1c1a6
3008.48,1.0,92,2,2,1,5,0x3b9af629
126187.47,3.0,67,3,4,1,8,0xb2d38ed0d
33987.51,1.0,17,2,2,2,6,0xb2d69ec1d
620027.85,6.0,20,4,4,2,10,0xb2d6474e
200000.0,2.0,6,3,3,3,9,0xb2d92d9f
200045.07,2.0,82,3,3,1,7,0xb2d59eeed
2732.83,1.0,8,1,2,3,6,0xb2d2d3cd
9382.65,1.0,0,2,2,4,8,0xb2d6f5abd
500000.0,2.0,4,4,3,4,11,0xb2d97940
7428.12,1.0,5,2,2,3,7,0xb2d62654
8592.59,1.0,26,2,2,2,6,0xb2d20489
274798.25,2.0,160,3,3,1,7,0xb2d8f0eed
51707.67,2.0,11,2,3,3,8,0xb2d108fb
164116.61,2.0,235,3,3,1,7,0xb2d13953d
70001.59,4.0,1,3,4,4,11,0xb2d6372e
1000010.56,3.0,80,4,4,1,9,0xb2d8d38bd
1395.63,1.0,9,1,2,3,6,0xb2d3ac6b
152479.84,2.0,3,3,3,4,10,0xb2d5907cd
473059.37,9.0,5,4,4,3,11,0xb2d58103d
151292.0,2.0,69,3,3,1,7,0xb2d5d808d
789093.92,14.0,0,4,4,4,12,0xb2d25a42d
265088.89,4.0,157,3,4,1,8,0xb2d313d5
10003.8,1.0,45,2,2,2,6,0xb2d91f2bd
96118.73,1.0,5,3,2,3,8,0xb2d6cc25
14124.37,2.0,9,2,3,3,8,0xb2d9aba9
150021.49,3.0,104,3,4,1,8,0xb2d3c692d
2188558.52,11.0,0,4,4,4,12,0x3b9af1bc
260431.77,5.0,59,3,4,2,9,0xb2d0e8ded
220513.27,6.0,14,3,4,3,10,0xb2d4da6fd
4088.47,1.0,197,2,2,1,5,0xb2d29adad
26.52,1.0,12,1,2,3,6,0xb2d2cf9c
1780018.79,3.0,66,4,4,2,10,0xb2d8f2c0d
0.0,1.0,10,1,2,3,6,0xb2d3609ad
729.83,1.0,0,1,2,4,7,0xb2d69337d
1.37,1.0,32,1,2,2,5,0xb2d93845
31820.32,1.0,40,2,2,2,6,0xb2d3d21dd
140055.04,2.0,11,3,3,3,9,0xb2d41549d
800054.03,2.0,139,4,3,1,8,0xb2d42dddd
616.75,1.0,126,1,2,1,4,0xb2d6d476
3105.89,1.0,3,2,2,4,8,0xb2d71869d
400003.34,2.0,0,4,3,4,11,0xb2d63e81d
2007242.94,2.0,13,4,3,3,10,0xb2d97db7
11.83,1.0,60,1,2,2,5,0xb2d68918d
150002.43,4.0,14,3,4,3,10,0xb2d95e0f
1537900.39,5.0,1,4,4,4,12,0xb2d40258
301360.75,3.0,14,4,4,3,11,0xb2d12bb0d
752019.8,9.0,58,4,4,2,10,0xb2d500fcd
220783.51,2.0,0,3,3,4,10,0xb2d19eadd
1240174.81,15.0,13,4,4,3,11,0xb2d56c1ed
120600.78,2.0,9,3,3,3,9,0xb2d8e0add
541498.55,2.0,77,4,3,1,8,0xb2d40297d
164316.4,3.0,48,3,4,2,9,0xb2d62d75d
1816.58,1.0,184,1,2,1,4,0xb2d2670dd
402924.05,2.0,67,4,3,1,8,0xb2d50264d
12.67,1.0,60,1,2,2,5,0xb2d95484
2010.71,1.0,184,1,2,1,4,0xb2d32d74d
2680.49,1.0,92,1,2,1,4,0xb2d2c9d8d
1604.94,1.0,140,1,2,1,4,0xb2d17ea9d
1800.0,1.0,1,1,2,4,7,0xb2d32714
69473.01,1.0,0,3,2,4,9,0xb2d36a03
452.98,1.0,0,1,2,4,7,0xb2d26962
100559.78,1.0,0,3,2,4,9,0xb2d5f03b
2.71,1.0,54,1,2,2,5,0xb2d3d976d
2501372.22,1.0,61,4,2,2,8,0xb2d8e42c
284396.36,6.0,26,3,4,2,9,0xb2d55a49d
11190.22,1.0,11,2,2,3,7,0xb2d0bb2d
1820.49,1.0,20,1,2,2,5,0xb2d905e7
241233.09,6.0,0,3,4,4,11,0xb2d252f7d
41881.97,3.0,46,2,4,2,8,0xb2d90bafd
500006.04,2.0,27,4,3,2,9,0xb2d9c679
12713.28,1.0,7,2,2,3,7,0xb2d342e5
257618.5,6.0,134,3,4,1,8,0xb2d6038fd
320395.83,4.0,0,4,4,4,12,0xb2d94aaad
5284.9,1.0,74,2,2,1,5,0xb2d6c34fd
1217.28,1.0,8,1,2,3,6,0xb2d22b31d
1299.08,1.0,0,1,2,4,7,0xb2d64241d
1.05,1.0,48,1,2,2,5,0xb2d3139b
50001.06,2.0,95,2,3,1,6,0xb2d97881
17764.33,1.0,49,2,2,2,6,0xb2d38f92d
2560.4,2.0,180,1,3,1,5,0xb2d13670d
1.74,1.0,6,1,2,3,6,0xb2d1aa17
1868946.84,2.0,0,4,3,4,11,0xb2d56e7dd
72014.67,2.0,18,3,3,2,8,0xb2d32441d
42765.15,1.0,20,2,2,2,6,0xb2d6a119d
10118.09,1.0,92,2,2,1,5,0xb2d88fd6d
501776.1,2.0,43,4,3,2,9,0xb2d9e97e
3414.33,1.0,160,2,2,1,5,0xb2d4aae7d
1857.04,1.0,48,1,2,2,5,0xb2d5fff9d
8116.8,1.0,5,2,2,3,7,0xb2d39fde
304265.41,2.0,91,4,3,1,8,0xb2d9010bd
500000.28,2.0,15,4,3,3,10,0xb2d8dfadd
78.04,1.0,8,1,2,3,6,0xb2d2d46bd
570171.07,7.0,4,4,4,4,12,0x3b9adc01
1296185.19,6.0,0,4,4,4,12,0xb2d593fd
6187.63,2.0,10,2,3,3,8,0x3b9aed24
240000.0,2.0,18,3,3,2,8,0xb2d957d6d
1087.69,1.0,3,1,2,4,7,0xb2d2c988
1843.76,1.0,1,1,2,4,7,0xb2d2b2bf
10209.74,1.0,294,2,2,1,5,0xb2d5d5bb
450310.34,7.0,3,4,4,4,12,0xb2d8d995d
20000.21,2.0,56,2,3,2,7,0xb2d9c818
2802.72,1.0,0,1,2,4,7,0xb2d77f94
10378.72,2.0,62,2,3,2,7,0xb2d57afb
369711.74,5.0,7,4,4,3,11,0xb2d40fa4d
306511.46,2.0,2,4,3,4,11,0xb2d299ecd
490592.87,10.0,2,4,4,4,12,0x3b9b2e68
539353.79,2.0,122,4,3,1,8,0xb2d2c739d
13100.88,1.0,92,2,2,1,5,0xb2d26a2c
707160.23,4.0,22,4,4,2,10,0xb2d10c00
353568.14,2.0,0,4,3,4,11,0xb2d6dc94
188047.08,7.0,2,3,4,4,11,0xb2d5e5b3
70383.82,2.0,140,3,3,1,7,0xb2d6240fd
2822.08,1.0,184,1,2,1,4,0xb2d2b40ed
10697.51,1.0,92,2,2,1,5,0xb2d29b8f
20752.2,2.0,25,2,3,2,7,0xb2d64ac1d
122034.09,1.0,33,3,2,2,7,0xb2d1c036
200000.0,2.0,18,3,3,2,8,0xb2da3313
50984.56,5.0,66,2,4,2,8,0xb2d5b046
508626.13,4.0,3,4,4,4,12,0xb2d9b676
31401.12,2.0,11,2,3,3,8,0xb2d8e2edd
130000.0,2.0,6,3,3,3,9,0xb2d96ee5
46395.46,1.0,18,2,2,2,6,0xb2d6c26ed
52747.25,1.0,184,3,2,1,6,0xb2d140e3
400000.05,4.0,3,4,4,4,12,0xb2d62f1a
1037.07,1.0,92,1,2,1,4,0xb2d12ab2d
42.43,1.0,38,1,2,2,5,0xb2d3f120
1.57,1.0,23,1,2,2,5,0xb2d7fd32
0.78,1.0,184,1,2,1,4,0xb2d11f23d
23616.55,1.0,45,2,2,2,6,0xb2d6be3ed
1111.42,1.0,92,1,2,1,4,0xb2d1c404
191551.83,2.0,27,3,3,2,8,0xb2d282f0d
22999.99,9.0,4,2,4,4,10,0xb2d109ee
1586.56,1.0,46,1,2,2,5,0xb2d49030d
2452.3,1.0,3,1,2,4,7,0xb2d52a1e
1487.34,1.0,11,1,2,3,6,0xb2d1f5f9
70000.42,2.0,0,3,3,4,10,0xb2d953dbd
79514.32,3.0,19,3,4,2,9,0xb2d0ce9bd
200035.84,2.0,161,3,3,1,7,0xb2d4550b
13.45,6.0,24,1,4,2,7,0xb2d40e21
78.15,1.0,92,1,2,1,4,0xb2d372bed
25032.27,1.0,184,2,2,1,5,0xb2d2204ad
1610889.97,18.0,1,4,4,4,12,0xb2d38b54
494064.25,2.0,2,4,3,4,11,0xb2d96ac0d
50000.09,1.0,0,2,2,4,8,0xb2d3a8cdd
1005.87,1.0,0,1,2,4,7,0xb2d5bdeb
462201.22,2.0,3,4,3,4,11,0xb2d55591
173377.9,2.0,24,3,3,2,8,0xb2d11618d
60492.67,2.0,20,3,3,2,8,0xb2d61bab
4.13,2.0,0,1,3,4,8,0xb2d204e3d
475689.04,4.0,17,4,4,2,10,0xb2d699dbd
280029.47,6.0,0,3,4,4,11,0xb2d551bfd
2103.01,1.0,23,1,2,2,5,0xb2d30863d
200053.54,2.0,20,3,3,2,8,0xb2d3a8c7d
310030.77,19.0,3,4,4,4,12,0xb2d57a78
200014.91,2.0,101,3,3,1,7,0xb2d1c229d
1360011.75,8.0,3,4,4,4,12,0xb2d3ee03d
195423.99,3.0,0,3,4,4,11,0x3b9af109
3.15,1.0,8,1,2,3,6,0xb2d2631ad
10.93,1.0,13,1,2,3,6,0xb2d5cfd2d
51206.66,1.0,5,2,2,3,7,0xb2d2102ad
200002.11,2.0,83,3,3,1,7,0xb2d9858d
12955.27,1.0,18,2,2,2,6,0xb2d99639
400572.24,5.0,27,4,4,2,10,0xb2d8de1dd
0.0,1.0,1,1,2,4,7,0xb2d62ffb
34000.56,1.0,18,2,2,2,6,0xb2d5d75bd
156.64,2.0,22,1,3,2,6,0x3b9b178ad
1209941.68,10.0,10,4,4,3,11,0xb2d32d41d
52338.35,3.0,32,3,4,2,9,0xb2d6882a
30000.32,2.0,18,2,3,2,7,0xb2d9588dd
4244.65,1.0,0,2,2,4,8,0xb2d5c99d
119497.91,5.0,0,3,4,4,11,0xb2d41a75d
100012.55,2.0,31,3,3,2,8,0xb2d56a70
80000.06,3.0,0,3,4,4,11,0xb2d27b10d
160002.89,4.0,66,3,4,2,9,0xb2d0bf7cd
160001.69,2.0,74,3,3,1,7,0xb2d9a152
1935.21,1.0,92,1,2,1,4,0xb2d1c414d
200052.19,2.0,0,3,3,4,10,0xb2d8fd63d
551955.3,2.0,29,4,3,2,9,0xb2d8ff53
100085.3,2.0,97,3,3,1,7,0xb2d58b28d
1550000.77,5.0,0,4,4,4,12,0xb2d26688d
960017.74,8.0,0,4,4,4,12,0xb2d0cf38
332524.83,2.0,292,4,3,1,8,0xb2d3f27b
252925.99,3.0,0,3,4,4,11,0xb2d631aed
1838.79,1.0,6,1,2,3,6,0xb2d63a8e
587214.86,4.0,0,4,4,4,12,0xb2d11fcbd
140005.09,6.0,34,3,4,2,9,0xb2d3ccf1
431831.03,5.0,97,4,4,1,9,0xb2d0d177d
80001.37,3.0,31,3,4,2,9,0xb2d939f8d
564137.12,7.0,32,4,4,2,10,0xb2d5d10dd
13442.3,1.0,6,2,2,3,7,0xb2d60957
372530.9,3.0,32,4,4,2,10,0x3b9b3363
5016.45,1.0,2,2,2,4,8,0xb2d9647a
4.6,1.0,60,1,2,2,5,0xb2d9b7ea
600000.53,4.0,20,4,4,2,10,0xb2d5621fd
470369.51,3.0,0,4,4,4,12,0xb2d6ea77
2105.72,1.0,33,1,2,2,5,0xb2d6cc63d
1126399.8,4.0,6,4,4,3,11,0xb2d4f8c4d
619.98,1.0,9,1,2,3,6,0xb2d2fa81d
1656773.26,16.0,0,4,4,4,12,0x3b9ae3e9d
11863140.49,18.0,4,4,4,4,12,0xb2d92b4dd
191004.2,1.0,0,3,2,4,9,0xb2d950e4
0.74,1.0,34,1,2,2,5,0xb2d2c82cd
25.31,1.0,7,1,2,3,6,0xb2d30016
300138.42,8.0,24,4,4,2,10,0xb2d3c60ed
51.39,1.0,2,1,2,4,7,0xb2d5dbb9
503641.96,3.0,56,4,4,2,10,0xb2d6d3dd
452000.0,14.0,3,4,4,4,12,0xb2d40bf4d
6460161.83,6.0,52,4,4,2,10,0xb2d0c863d
3254223.78,15.0,0,4,4,4,12,0xb2d19ad9d
405.09,1.0,0,1,2,4,7,0xb2d6a042
11102.38,1.0,0,2,2,4,8,0xb2d2b5c4
1.64,1.0,32,1,2,2,5,0xb2d5ddad
40003.28,4.0,142,2,4,1,7,0xb2d6f4ac
856774.78,19.0,0,4,4,4,12,0xb2d067d3d
330008.79,2.0,13,4,3,3,10,0xb2d9995a
40.5,1.0,42,1,2,2,5,0xb2d242a6
5520.93,1.0,3,2,2,4,8,0xb2d5f20ed
20857.24,1.0,1,2,2,4,8,0xb2d6cc32
504514.46,8.0,0,4,4,4,12,0x3b9b2e2a
5508.3,1.0,184,2,2,1,5,0xb2d33672d
543.54,1.0,3,1,2,4,7,0xb2d340df
440117.11,3.0,13,4,4,3,11,0xb2d7bfb5
50001.46,2.0,37,2,3,2,7,0xb2d124c9d
260730.54,3.0,3,3,4,4,11,0xb2d9e29f
1015.6,1.0,19,1,2,2,5,0xb2d0df38d
400051.36,6.0,27,4,4,2,10,0x3b9b2599
2325986.97,2.0,77,4,3,1,8,0xb2d5f84cd
140000.0,1.0,6,3,2,3,8,0xb2d96dcbd
2453.58,1.0,63,1,2,2,5,0xb2d9aae1
517778.91,3.0,5,4,4,3,11,0xb2d2e1ae
313355.98,4.0,0,4,4,4,12,0xb2d08261d
170442.75,1.0,76,3,2,1,6,0xb2d8fb81d
250065.99,2.0,12,3,3,3,9,0xb2d6593c
48137.75,1.0,14,2,2,3,7,0xb2d319b5d
120001.27,2.0,94,3,3,1,7,0xb2d88f1bd
66385.78,1.0,27,3,2,2,7,0xb2d91d2ad
4624.22,5.0,184,2,4,1,7,0x3b9af418d
721510.2,6.0,13,4,4,3,11,0xb2d2b5b0d
611942.35,3.0,31,4,4,2,10,0xb2d56f84d
383.69,1.0,7,1,2,3,6,0xb2d8694d
37880.52,1.0,10,2,2,3,7,0xb2d3407a
6529.12,3.0,92,2,4,1,7,0xb2d171b6d
2170.17,1.0,92,1,2,1,4,0xb2d10317d
48850.63,1.0,11,2,2,3,7,0xb2d2b7c1
429128.52,3.0,0,4,4,4,12,0xb2d31446
30431.73,2.0,4,2,3,4,9,0xb2d59c8ed
206398.34,3.0,189,3,4,1,8,0xb2d2fb8f
95.79,1.0,53,1,2,2,5,0xb2d7af1a
10000.11,2.0,13,2,3,3,8,0xb2d95d42d
359060.17,4.0,90,4,4,1,9,0xb2d62ea1d
9982.44,1.0,85,2,2,1,5,0xb2d8cebcd
177182.97,1.0,9,3,2,3,8,0xb2d274c4
288340.58,3.0,8,3,4,3,10,0xb2d1043d
102210.5,2.0,101,3,3,1,7,0xb2d25198
634939.76,17.0,2,4,4,4,12,0xb2d4ed3fd
1504.49,1.0,293,1,2,1,4,0xb2d696bed
421515.33,3.0,28,4,4,2,10,0xb2d8fa38d
4159.43,2.0,0,2,3,4,9,0xb2d08c31
29848.62,1.0,186,2,2,1,5,0xb2d3ae8bd
543.96,1.0,59,1,2,2,5,0xb2d97b98
24483.53,1.0,9,2,2,3,7,0xb2d6c468d
2264.75,1.0,9,1,2,3,6,0xb2d4bb4c
132284.38,2.0,185,3,3,1,7,0xb2d5da68
28847.49,2.0,0,2,3,4,9,0xb2d09bd3d
110324.01,3.0,11,3,4,3,10,0xb2d1273e
11193.91,1.0,184,2,2,1,5,0xb2d53d0ed
1.58,1.0,46,1,2,2,5,0xb2d919d3d
5864.65,2.0,0,2,3,4,9,0x3b9b1865
9559.71,1.0,92,2,2,1,5,0xb2d37420
500021.15,2.0,231,4,3,1,8,0xb2d6ebaad
103236.51,1.0,14,3,2,3,8,0xb2d6a2f8d
4941.47,1.0,9,2,2,3,7,0xb2d8b14ed
810035.01,5.0,1,4,4,4,12,0xb2d64171d
1171.13,1.0,66,1,2,2,5,0xb2d24f31
83005.02,5.0,13,3,4,3,10,0xb2d6d32fd
37.95,1.0,0,1,2,4,7,0xb2d52955
108025.06,3.0,30,3,4,2,9,0xb2d4ac4e
8088.34,1.0,0,2,2,4,8,0xb2d0d7dbd
35.66,1.0,19,1,2,2,5,0xb2d37bf2
169.28,1.0,3,1,2,4,7,0xb2d9458c
123123.32,2.0,0,3,3,4,10,0x3b9af69a
301134.28,3.0,91,4,4,1,9,0xb2d5b005d
100002.11,2.0,60,3,3,2,8,0xb2d9bda8
151010.13,3.0,5,3,4,3,10,0xb2d1fc2c
964470.03,6.0,11,4,4,3,11,0xb2d51287d
17.06,1.0,7,1,2,3,6,0xb2d9549dd
70.33,1.0,11,1,2,3,6,0xb2d69c2a
706.6,1.0,0,1,2,4,7,0xb2d54fdad
1715.93,1.0,184,1,2,1,4,0xb2d2130bd
42.24,1.0,17,1,2,2,5,0xb2d5a1d0
2734.71,2.0,210,1,3,1,5,0xb2d0a2b2d
30011.83,3.0,98,2,4,1,7,0xb2d7774a
56190.75,2.0,53,3,3,2,8,0xb2d68f32d
10000.11,2.0,25,2,3,2,7,0xb2da168f
2448386.46,9.0,13,4,4,3,11,0xb2d1b7fbd
333783.62,5.0,20,4,4,2,10,0xb2d5dfa2d
2004.64,1.0,131,1,2,1,4,0xb2d2cbd7
670066.43,5.0,21,4,4,2,10,0x3b9b3d31d
53148.68,2.0,3,3,3,4,10,0xb2d4da02
732760.6,2.0,3,4,3,4,11,0xb2d3cac0d
380.16,1.0,8,1,2,3,6,0xb2d617c8
495254.59,7.0,1,4,4,4,12,0xb2d24449d
261.63,1.0,60,1,2,2,5,0xb2d6d0a0d
200001.33,2.0,12,3,3,3,9,0xb2d95caed
26950.85,1.0,0,2,2,4,8,0xb2d6bfa8d
374188.35,12.0,0,4,4,4,12,0xb2d209d4d
16.77,2.0,89,1,3,1,5,0xb2d1354d
520000.0,2.0,25,4,3,2,9,0xb2da1be6
754028.51,7.0,13,4,4,3,11,0xb2d219bd
522708.85,2.0,0,4,3,4,11,0xb2d5e395d
100484.53,1.0,0,3,2,4,9,0xb2d62181
1301.0,1.0,3,1,2,4,7,0xb2d85890
3616.63,1.0,54,2,2,2,6,0xb2d645fc
7.6,1.0,0,1,2,4,7,0xb2d3a17cd
103647.82,2.0,19,3,3,2,8,0xb2d495b0d
18488.85,1.0,11,2,2,3,7,0xb2d68645
212985.57,2.0,143,3,3,1,7,0xb2d6edc9d
165284.85,8.0,92,3,4,1,8,0xb2d4bdc3d
26811.92,1.0,184,2,2,1,5,0xb2d2e39e
203584.35,2.0,221,3,3,1,7,0xb2d5f9bfd
1084.59,1.0,1,1,2,4,7,0xb2d399bc
2983.06,1.0,184,2,2,1,5,0xb2d2498ad
180000.0,2.0,0,3,3,4,10,0xb2d0b6c8d
280994.74,2.0,55,3,3,2,8,0xb2d9cc37
3009.02,1.0,92,2,2,1,5,0xb2d58806
51481.58,1.0,216,2,2,1,5,0xb2d40710
607588.14,3.0,0,4,4,4,12,0xb2d69698d
220919.57,1.0,0,3,2,4,9,0xb2d2c083
15451.73,3.0,92,2,4,1,7,0xb2d172cf
100923.99,2.0,40,3,3,2,8,0xb2d2add5
7537.91,1.0,0,2,2,4,8,0xb2d4ce6fd
1321.03,1.0,32,1,2,2,5,0xb2d29d30
20001.06,2.0,92,2,3,1,6,0xb2d5f766d
500029.24,3.0,16,4,4,2,10,0xb2d63fcb
550709.66,1.0,4,4,2,4,10,0xb2d3b5f1d
68825.06,2.0,52,3,3,2,8,0xb2d6d4d7
132362.26,3.0,1,3,4,4,11,0xb2d5ab01d
150096.06,3.0,122,3,4,1,8,0xb2d60fe4
1200062.5,2.0,7,4,3,3,10,0xb2d92bf2d
750047.35,4.0,2,4,4,4,12,0xb2d88bfed
80093.04,4.0,3,3,4,4,11,0xb2d641bcd
41902.33,2.0,0,2,3,4,9,0xb2d58237d
212.7,1.0,4,1,2,4,7,0xb2d8d917d
4881.94,1.0,0,2,2,4,8,0xb2d5ca45d
2761.08,1.0,46,1,2,2,5,0xb2d915ea
60598.94,2.0,181,3,3,1,7,0xb2d6523f
500751.45,6.0,27,4,4,2,10,0xb2d57e0bd
41.55,1.0,5,1,2,3,6,0xb2d9bdc1
243587.87,8.0,63,3,4,2,9,0xb2d0d30d
165.37,6.0,1,1,4,4,9,0x3b9b0fa4
11964678.22,9.0,10,4,4,3,11,0xb2d41134d
472.29,1.0,0,1,2,4,7,0xb2d37d7f
1444.69,1.0,28,1,2,2,5,0xb2d200a4
501837.67,2.0,40,4,3,2,9,0xb2d4586b
140005.87,3.0,25,3,4,2,9,0xb2d5c589d
50327.13,1.0,34,2,2,2,6,0xb2d6dbe0
256.19,1.0,2,1,2,4,7,0xb2d535dd
400064.36,3.0,3,4,4,4,12,0xb2d2db5bd
1875.23,1.0,260,1,2,1,4,0xb2d2e657d
323698.94,4.0,6,4,4,3,11,0xb2d2360bd
715089.21,4.0,108,4,4,1,9,0xb2d2732e
210.74,1.0,20,1,2,2,5,0xb2d540b6
41036.26,3.0,56,2,4,2,8,0xb2d102d3
2369.82,1.0,0,1,2,4,7,0xb2d22bd3d
1841.32,1.0,11,1,2,3,6,0xb2d8c8de
250093.85,4.0,18,3,4,2,9,0xb2d21fa7
3208.87,5.0,184,2,4,1,7,0x3b9b135ed
0.27,1.0,12,1,2,3,6,0xb2d274a0
4620319.0,4.0,27,4,4,2,10,0xb2d2419cd
146001.95,7.0,0,3,4,4,11,0xb2d22abe
391.78,1.0,2,1,2,4,7,0xb2d69001
124008.95,4.0,20,3,4,2,9,0xb2d105fa
19678.0,1.0,92,2,2,1,5,0xb2d4fce7d
90367.54,4.0,11,3,4,3,10,0xb2d6cf63
263.46,1.0,19,1,2,2,5,0xb2d78a8d
1860.49,1.0,3,1,2,4,7,0xb2d5640fd
400150.23,3.0,6,4,4,3,11,0xb2d681ffd
519.15,14.0,131,1,4,1,6,0x3b9af18c
3943.5,1.0,0,2,2,4,8,0xb2d6d72cd
2100000.0,2.0,0,4,3,4,11,0xb2da6ba2
10034.46,1.0,184,2,2,1,5,0xb2d6527fd
251696.38,2.0,12,3,3,3,9,0xb2d51377d
20221.08,1.0,184,2,2,1,5,0xb2d28839
226038.43,15.0,3,3,4,4,11,0xb2d06860d
160036.85,3.0,179,3,4,1,8,0xb2d43144
40077.69,2.0,93,2,3,1,6,0xb2d3ec88
161.64,1.0,23,1,2,2,5,0xb2d443bbd
1020.88,1.0,184,1,2,1,4,0xb2d06d55
603735.86,4.0,110,4,4,1,9,0xb2d94100d
100004.22,2.0,55,3,3,2,8,0xb2d9015a
439006.12,6.0,1,4,4,4,12,0xb2d5792ad
552824.51,3.0,18,4,4,2,10,0xb2d9b96e
602.59,1.0,12,1,2,3,6,0xb2d642e4
20.86,1.0,74,1,2,1,4,0xb2d62b3f
1620363.24,5.0,4,4,4,4,12,0xb2d41035d
3.38,1.0,26,1,2,2,5,0xb2d17e67d
12153.62,1.0,16,2,2,2,6,0xb2d43bc6d
1057.47,1.0,92,1,2,1,4,0xb2d261ded
50000.0,2.0,6,2,3,3,8,0xb2d58906d
1458.31,1.0,1,1,2,4,7,0xb2d4dbbed
220000.0,2.0,13,3,3,3,9,0xb2d96025d
5211.69,1.0,184,2,2,1,5,0xb2d150bbd
1185.71,1.0,184,1,2,1,4,0xb2d3f4efd
1896.32,1.0,0,1,2,4,7,0xb2d5367c
100000.5,1.0,1,3,2,4,9,0xb2d35174d
200000.0,2.0,5,3,3,3,9,0xb2da5cfb
9.23,1.0,82,1,2,1,4,0xb2d96c7dd
0.0,1.0,160,1,2,1,4,0xb2d8e6b4
2968.44,1.0,92,2,2,1,5,0xb2d10291d
1.12,1.0,13,1,2,3,6,0xb2d35bb1d
203379.03,2.0,8,3,3,3,9,0xb2d4b2e1
1.27,1.0,16,1,2,2,5,0xb2d297d6
2802.76,1.0,99,1,2,1,4,0xb2d58617d
40525.13,1.0,10,2,2,3,7,0xb2d9450c
178596.68,1.0,8,3,2,3,8,0xb2d8d4ac
102211.05,2.0,13,3,3,3,9,0xb2d08a15
310.98,1.0,10,1,2,3,6,0xb2d2985b
323264.02,1.0,5,4,2,3,9,0xb2d5766c
2.11,1.0,67,1,2,1,4,0xb2d9aeb8
4070.17,1.0,19,2,2,2,6,0xb2d3cc60
5083.9,1.0,92,2,2,1,5,0xb2d0fba4d
592.75,1.0,49,1,2,2,5,0xb2d6c451d
204977.6,2.0,37,3,3,2,8,0xb2d6820ad
1304.07,1.0,55,1,2,2,5,0xb2d0a1ffd
95099.71,2.0,52,3,3,2,8,0xb2d3ac72d
780.15,1.0,0,1,2,4,7,0xb2d8cdedd
360150.37,4.0,3,4,4,4,12,0xb2d4439dd
130.09,1.0,13,1,2,3,6,0xb2d21e3ed
816.42,1.0,81,1,2,1,4,0xb2d2b4bd
600000.25,2.0,28,4,3,2,9,0xb2d902afd
4009295.64,1.0,230,4,2,1,7,0xb2d6f49f
1100000.0,2.0,11,4,3,3,10,0xb2da4ca2
242208.64,2.0,0,3,3,4,10,0xb2d274db
0.0,1.0,9,1,2,3,6,0xb2d2ffcb
2.11,1.0,29,1,2,2,5,0xb2d85e7b
451317.38,5.0,0,4,4,4,12,0xb2d55fc9
179810.95,4.0,189,3,4,1,8,0xb2d08511d
3739.04,3.0,92,2,4,1,7,0xb2d3ffbcd
273770.2,2.0,53,3,3,2,8,0xb2d3ae0bd
1001.96,1.0,195,1,2,1,4,0xb2d69e4ed
301102.7,2.0,3,4,3,4,11,0xb2d60cfbd
3417.17,1.0,15,2,2,3,7,0xb2d1f5a8
150185.57,2.0,32,3,3,2,8,0xb2d463f3
4386420.43,10.0,41,4,4,2,10,0xb2d1a70ed
850024.19,4.0,35,4,4,2,10,0xb2d0ebd6d
390349.8,3.0,133,4,4,1,9,0xb2d56fca
115866.32,3.0,11,3,4,3,10,0xb2d3a8d7d
101946.75,1.0,129,3,2,1,6,0xb2d147abd
305937.67,6.0,0,4,4,4,12,0xb2d2979e
200000.0,2.0,9,3,3,3,9,0xb2d9a635
150061.31,2.0,6,3,3,3,9,0xb2d6ac7dd
19.51,1.0,33,1,2,2,5,0xb2d8d050
1257231.2,6.0,10,4,4,3,11,0xb2d1bb59
600000.93,2.0,0,4,3,4,11,0xb2d1c78f
289425.85,2.0,228,3,3,1,7,0xb2d100a1d
100003.23,2.0,123,3,3,1,7,0xb2d1513d
648772.38,11.0,0,4,4,4,12,0xb2d29c1bd
7189.8,3.0,75,2,4,1,7,0x3b9b3fe8
551115.23,4.0,13,4,4,3,11,0x3b9b35c0d
60041.38,2.0,59,3,3,2,8,0xb2d1a5acd
150161.11,2.0,20,3,3,2,8,0xb2d9f048
9.07,1.0,72,1,2,1,4,0xb2d80e69d
1292.0,1.0,22,1,2,2,5,0xb2d9c198
10000.21,2.0,87,2,3,1,6,0xb2d8a85cd
660280.03,2.0,92,4,3,1,8,0xb2d5633cd
1400008.76,2.0,11,4,3,3,10,0xb2d80e7fd
400031.56,3.0,14,4,4,3,11,0xb2d95e40d
1791.68,1.0,10,1,2,3,6,0xb2d6c189d
268386.26,4.0,48,3,4,2,9,0xb2d22035d
5902.4,1.0,1,2,2,4,8,0xb2d6751cd
1990065.31,2.0,92,4,3,1,8,0xb2d4f5d3
100001.9,3.0,48,3,4,2,9,0xb2d6ff99d
482.76,1.0,10,1,2,3,6,0xb2d33402d
78469.88,2.0,63,3,3,2,8,0xb2d9a493
18658.17,1.0,3,2,2,4,8,0xb2d2b5d9d
151.92,1.0,34,1,2,2,5,0xb2d5521dd
1180863.9,13.0,0,4,4,4,12,0xb2d24f08d
665.8,1.0,89,1,2,1,4,0xb2d28a98
24348.8,1.0,1,2,2,4,8,0xb2d3fb2dd
43027.38,3.0,18,2,4,2,8,0xb2d32f2e
200054.68,6.0,4,3,4,4,11,0xb2d5a96bd
11540.14,1.0,190,2,2,1,5,0xb2d2ab52d
899463.5,6.0,1,4,4,4,12,0xb2d594fcd
9111.93,1.0,0,2,2,4,8,0xb2d0d7c9
616551.0,4.0,9,4,4,3,11,0xb2d6a732
17656.16,1.0,0,2,2,4,8,0xb2d319e0
5265.05,1.0,0,2,2,4,8,0xb2d36238
116870.41,3.0,1,3,4,4,11,0xb2d0dc24d
500125.4,2.0,181,4,3,1,8,0xb2d407f3
67.37,1.0,7,1,2,3,6,0xb2d21d48d
10945.01,2.0,6,2,3,3,8,0xb2d5ff94d
25134.39,1.0,1,2,2,4,8,0xb2d6ea12
125001.11,4.0,87,3,4,1,8,0xb2d55bded
581.7,6.0,6,1,4,3,8,0xb2d10e1fd
4100.35,2.0,92,2,3,1,6,0xb2d61a5cd
243.04,1.0,7,1,2,3,6,0xb2d42e30
1381.32,1.0,22,1,2,2,5,0xb2d476c4d
1749.31,1.0,108,1,2,1,4,0xb2d58be2
45124.59,3.0,6,2,4,3,9,0xb2d17b23d
350222.83,5.0,3,4,4,4,12,0xb2d10efbd
53.37,1.0,13,1,2,3,6,0xb2d2457fd
202007.5,2.0,0,3,3,4,10,0xb2d6c09a
2351.59,1.0,184,1,2,1,4,0xb2d3eb19
1716.45,2.0,92,1,3,1,5,0xb2d07447d
70694.81,3.0,60,3,4,2,9,0xb2d12c32
335475.41,3.0,56,4,4,2,10,0xb2d42196d
1089.55,1.0,14,1,2,3,6,0xb2d20185
200000.0,2.0,9,3,3,3,9,0xb2d9cfdb
714.32,1.0,7,1,2,3,6,0xb2d8d6ad
1027541.73,8.0,1,4,4,4,12,0x3b9b3d2fd
250000.95,3.0,6,3,4,3,10,0xb2d9604ad
6923.18,1.0,0,2,2,4,8,0xb2d4419bd
25.65,3.0,0,1,4,4,9,0xb2d3834ed
60585.45,2.0,25,3,3,2,8,0xb2d2a87dd
120501.48,8.0,83,3,4,1,8,0xb2d651b9
27.22,1.0,63,1,2,2,5,0xb2d85c7fd
200245.06,4.0,48,3,4,2,9,0x3b9b2e44d
308781.69,6.0,60,4,4,2,10,0xb2d46ddbd
850077.06,6.0,11,4,4,3,11,0xb2d69cded
500010.58,2.0,92,4,3,1,8,0xb2d656f7d
377828.05,3.0,87,4,4,1,9,0xb2d24c33d
1451331.29,10.0,1,4,4,4,12,0xb2d1e4aad
150044.16,5.0,4,3,4,4,11,0xb2d64545
270078.83,6.0,8,3,4,3,10,0xb2d91d76
1091.51,1.0,92,1,2,1,4,0xb2d31d0cd
51043.54,1.0,0,2,2,4,8,0xb2d16ec8d
1825123.52,8.0,47,4,4,2,10,0xb2d27ffbd
460065.89,2.0,19,4,3,2,9,0xb2d5be57d
394250.03,5.0,16,4,4,2,10,0xb2d69b27d
3234.51,1.0,0,2,2,4,8,0xb2d5c58f
3181.89,1.0,184,2,2,1,5,0xb2d285d5d
100043.56,3.0,95,3,4,1,8,0xb2d21965
2408.65,1.0,6,1,2,3,6,0xb2d27831d
405628.62,5.0,31,4,4,2,10,0x3b9b311c
308828.98,1.0,110,4,2,1,7,0xb2d50252d
417617.9,7.0,1,4,4,4,12,0xb2d0b355
388779.32,2.0,7,4,3,3,10,0x3b9b37cfd
0.0,2.0,6,1,3,3,7,0xb2d21314
85.91,1.0,21,1,2,2,5,0xb2d94242d
431454.76,9.0,3,4,4,4,12,0xb2d168ced
100003.17,2.0,49,3,3,2,8,0xb2d9d574
50002.11,2.0,231,2,3,1,6,0xb2d6ec78
2007.28,1.0,92,1,2,1,4,0xb2d27f2ed
390088.0,5.0,0,4,4,4,12,0xb2d56759d
400834.08,2.0,11,4,3,3,10,0xb2d2aa28d
40001.26,3.0,11,2,4,3,9,0xb2d95ca3
98163.02,2.0,18,3,3,2,8,0xb2d270c3
4525.99,1.0,0,2,2,4,8,0xb2d488ecd
10924.22,1.0,1,2,2,4,8,0xb2d8ce6ed
1126.13,1.0,38,1,2,2,5,0xb2d59c8f
100111.98,1.0,196,3,2,1,6,0xb2d6c609d
62456.66,2.0,10,3,3,3,9,0xb2d3eb62d
111856.19,3.0,27,3,4,2,9,0xb2d5c225d
385005.7,4.0,32,4,4,2,10,0xb2d094b3d
750015.31,3.0,5,4,4,3,11,0xb2d8ed04d
352003.72,2.0,76,4,3,1,8,0xb2d8de09
305095.19,3.0,200,4,4,1,9,0xb2d588fad
100051.85,3.0,1,3,4,4,11,0xb2d155c7d
250001.06,3.0,6,3,4,3,10,0xb2da4c96
111.63,1.0,0,1,2,4,7,0xb2d61b05
55853.4,3.0,18,3,4,2,9,0xb2d2a1f2d
1217.8,1.0,92,1,2,1,4,0xb2d26d5dd
11527.77,1.0,2,2,2,4,8,0xb2d1bc4fd
270016.61,5.0,24,3,4,2,9,0xb2d3a930
3176.77,1.0,168,2,2,1,5,0xb2d58727
700000.0,3.0,0,4,4,4,12,0xb2da0f56
1200073.26,4.0,0,4,4,4,12,0xb2d9e870
500000.0,2.0,11,4,3,3,10,0xb2d967b9d
261022.76,8.0,0,3,4,4,11,0xb2d5302cd
318.04,1.0,74,1,2,1,4,0xb2d212f5d
2097.4,1.0,4,1,2,4,7,0xb2d4fcf7d
501121.15,7.0,10,4,4,3,11,0xb2d1a9df
210004.22,5.0,38,3,4,2,9,0xb2d080eb
330031.45,4.0,77,4,4,1,9,0xb2d15d33d
1000000.73,3.0,0,4,4,4,12,0xb2d54987d
3004.92,1.0,92,2,2,1,5,0xb2d4f03ad
38139.16,4.0,54,2,4,2,8,0xb2d6eb90d
200254.11,4.0,1,3,4,4,11,0xb2d580dfd
4683.11,1.0,92,2,2,1,5,0xb2d61998d
102203.85,5.0,184,3,4,1,8,0x3b9b4911d
600316.69,4.0,11,4,4,3,11,0xb2d8d78a
89.73,1.0,6,1,2,3,6,0xb2d32039d
350098.03,2.0,3,4,3,4,11,0xb2da0345
2518.6,1.0,165,1,2,1,4,0xb2d591c4
30401.35,4.0,118,2,4,1,7,0x3b9b48f9
10165.93,1.0,4,2,2,4,8,0xb2d6aa12d
135079.57,2.0,6,3,3,3,9,0xb2d5990ed
533327.28,2.0,18,4,3,2,9,0xb2d35268d
453251.76,7.0,0,4,4,4,12,0xb2d49540d
150001.59,3.0,31,3,4,2,9,0xb2d9325b
1000000.97,2.0,8,4,3,3,10,0xb2d23cf7
200000.0,2.0,4,3,3,4,10,0xb2d93320d
96989.56,2.0,118,3,3,1,7,0xb2d3d67fd
293107.76,2.0,101,3,3,1,7,0xb2d6d152
604.1,1.0,4,1,2,4,7,0xb2d1c1d4
95.2,1.0,13,1,2,3,6,0xb2d90cd0
2921.3,1.0,92,2,2,1,5,0xb2d1f945
1158.92,1.0,298,1,2,1,4,0xb2d617efd
400000.0,3.0,3,4,4,4,12,0xb2d8915f
0.42,6.0,18,1,4,2,7,0xb2d5c615
978.54,1.0,0,1,2,4,7,0xb2d600dcd
148.03,1.0,157,1,2,1,4,0xb2d60d2cd
340014.18,3.0,90,4,4,1,9,0xb2d41a9fd
60002.43,6.0,80,3,4,1,8,0xb2d63460d
704262.39,3.0,5,4,4,3,11,0xb2d10790
140481.11,3.0,74,3,4,1,8,0xb2d369afd
20360.0,1.0,184,2,2,1,5,0x3b9ad6cbd
20009.08,2.0,171,2,3,1,6,0xb2d5fbecd
1010031.44,15.0,14,4,4,3,11,0xb2d11492d
1.3,1.0,47,1,2,2,5,0xb2d29794
500807.56,3.0,10,4,4,3,11,0xb2d6d01bd
150005.28,4.0,10,3,4,3,10,0xb2d8fe2fd
200034.11,2.0,10,3,3,3,9,0xb2d3f114
102456.1,1.0,0,3,2,4,9,0xb2d34313d
737.85,1.0,0,1,2,4,7,0xb2d1ab3d
258373.5,2.0,56,3,3,2,8,0xb2d5c566d
4149.4,2.0,5,2,3,3,8,0xb2d98d20
8178.3,1.0,6,2,2,3,7,0xb2d92881d
10062.33,1.0,92,2,2,1,5,0xb2d3504e
111.88,1.0,1,1,2,4,7,0xb2d1ab47
207627.52,2.0,2,3,3,4,10,0xb2d45358
18958.42,1.0,1,2,2,4,8,0xb2d1317ad
21835.24,1.0,15,2,2,3,7,0xb2d6476b
118317.46,7.0,1,3,4,4,11,0xb2d6824c
1457297.25,3.0,7,4,4,3,11,0xb2d921aed
23970.2,1.0,10,2,2,3,7,0xb2d62d39d
168000.0,2.0,6,3,3,3,9,0xb2d96e90d
10100.54,2.0,9,2,3,3,8,0xb2d958de
11956.43,1.0,14,2,2,3,7,0xb2d78cebd
200008.44,2.0,55,3,3,2,8,0xb2d59c51
21218.17,1.0,0,2,2,4,8,0xb2d0e641d
52647.2,2.0,13,3,3,3,9,0xb2d4be07d
9345.3,1.0,92,2,2,1,5,0xb2d4d62d
91277.78,1.0,2,3,2,4,9,0xb2d5b9aad
440098.04,4.0,19,4,4,2,10,0xb2d92188d
2062.8,1.0,41,1,2,2,5,0xb2d5943c
51515.37,1.0,81,2,2,1,5,0xb2d265d5d
3001.38,1.0,92,2,2,1,5,0xb2d11de3d
407009.73,6.0,4,4,4,4,12,0xb2d11431
479814.86,9.0,0,4,4,4,12,0xb2d2267cd
524864.8,7.0,7,4,4,3,11,0xb2d5aa4fd
215277.15,3.0,53,3,4,2,9,0xb2d1db5f
10121.54,3.0,184,2,4,1,7,0xb2d18361d
30257.85,8.0,4,2,4,4,10,0xb2d0b6b8
11905.52,1.0,34,2,2,2,6,0xb2d9ddcb
12199.02,2.0,118,2,3,1,6,0xb2d63715d
3523.42,1.0,0,2,2,4,8,0xb2d6b279d
500115.86,2.0,25,4,3,2,9,0xb2d6940bd
400207.4,6.0,1,4,4,4,12,0xb2d5c794d
10172.79,1.0,13,2,2,3,7,0xb2d63f7ad
128159.45,2.0,0,3,3,4,10,0xb2d8236c
40424.74,4.0,111,2,4,1,7,0xb2d557e7d
0.0,1.0,8,1,2,3,6,0xb2d32010d
150001.58,2.0,35,3,3,2,8,0xb2d9d863
12444.31,1.0,0,2,2,4,8,0xb2d27958d
1606196.13,5.0,0,4,4,4,12,0xb2d23ca4
20007.1,3.0,47,2,4,2,8,0xb2d5748d
17.63,1.0,31,1,2,2,5,0xb2d9f71c
14120.82,1.0,184,2,2,1,5,0xb2d2dd0bd
1315.68,1.0,126,1,2,1,4,0xb2d92781
200053.37,3.0,0,3,4,4,11,0xb2d8f0e1
40357.93,2.0,14,2,3,3,8,0xb2d24e45
84628.61,3.0,11,3,4,3,10,0xb2d11c74d
26962.6,1.0,10,2,2,3,7,0xb2d6508cd
1200048.35,8.0,18,4,4,2,10,0xb2d211f4
350014.77,3.0,49,4,4,2,10,0xb2d8f4b3d
393440.44,2.0,35,4,3,2,9,0xb2d0737dd
250000.57,4.0,8,3,4,3,10,0xb2d407edd
135011.6,2.0,73,3,3,1,7,0xb2d1bf27d
220000.03,4.0,4,3,4,4,11,0xb2d68438d
10.5,2.0,21,1,3,2,6,0xb2d653fad
140027.21,3.0,80,3,4,1,8,0xb2d69313
301857.16,4.0,3,4,4,4,12,0xb2d2377ad
100000.0,2.0,0,3,3,4,10,0xb2d92b22d
70699.54,1.0,14,3,2,3,8,0xb2d6853ed
280000.0,9.0,1,3,4,4,11,0xb2d53d1bd
1.89,1.0,88,1,2,1,4,0xb2d2064f
1494078.02,9.0,14,4,4,3,11,0xb2d288d0
500179.07,3.0,0,4,4,4,12,0xb2d9dd62
69500.0,1.0,5,3,2,3,8,0xb2d280e0d
110004.64,2.0,97,3,3,1,7,0xb2d63eddd
1000039.8,8.0,23,4,4,2,10,0xb2d51169
765453.52,5.0,101,4,4,1,9,0x3b9b3b77
178975.57,3.0,8,3,4,3,10,0xb2d38c8d
34597.4,2.0,9,2,3,3,8,0xb2da01e0
169552.69,3.0,39,3,4,2,9,0xb2d5edcdd
350000.0,3.0,1,4,4,4,12,0xb2d1e293d
5116.75,1.0,0,2,2,4,8,0xb2d700a2d
3594.22,1.0,1,2,2,4,8,0xb2d98a83
373727.97,4.0,3,4,4,4,12,0xb2d38a8c
1000053.14,2.0,4,4,3,4,11,0xb2d931fc
210071.1,3.0,101,3,4,1,8,0xb2d1a6ebd
4.23,1.0,60,1,2,2,5,0xb2d8d4c3
268124.88,4.0,25,3,4,2,9,0xb2d5875dd
160099.51,2.0,134,3,3,1,7,0xb2d1ff8e
8751.31,1.0,0,2,2,4,8,0xb2d2b614d
401421.67,2.0,29,4,3,2,9,0xb2d9c2e0
1024547.87,2.0,46,4,3,2,9,0xb2d6186ed
0.82,1.0,76,1,2,1,4,0xb2d5d4a6
155094.15,2.0,92,3,3,1,7,0xb2d2821fd
2003.83,1.0,92,1,2,1,4,0xb2d1c6ded
400007.12,3.0,13,4,4,3,11,0xb2d4e6f5d
20029.0,2.0,1,2,3,4,9,0xb2d94021
11182.43,1.0,6,2,2,3,7,0xb2d7928ed
7195.08,1.0,0,2,2,4,8,0xb2d79143
0.0,1.0,7,1,2,3,6,0xb2d9497ad
250620.34,2.0,50,3,3,2,8,0xb2d25690
336267.73,2.0,59,4,3,2,9,0xb2d22578d
52758.69,1.0,42,3,2,2,7,0xb2d3bf7a
468859.44,3.0,0,4,4,4,12,0xb2d0acedd
1247.28,1.0,92,1,2,1,4,0xb2d2036dd
1579.95,1.0,43,1,2,2,5,0xb2d9bc0a
284554.87,2.0,2,3,3,4,10,0xb2d6ec3b
150037.55,5.0,0,3,4,4,11,0xb2d49210
135.16,1.0,1,1,2,4,7,0xb2d60b7a
20661.34,1.0,1,2,2,4,8,0xb2d39cadd
160040.49,2.0,83,3,3,1,7,0xb2d618e0d
5716.81,1.0,184,2,2,1,5,0xb2d2de16d
70003.48,3.0,49,3,4,2,9,0xb2d99f9a
13958.72,1.0,21,2,2,2,6,0xb2d2f320d
975062.16,9.0,0,4,4,4,12,0xb2d1de9d
774.57,2.0,14,1,3,3,7,0xb2d5fdd6
17.45,1.0,21,1,2,2,5,0xb2d23cc4d
1000016.38,2.0,6,4,3,3,10,0xb2d6134f
21182.64,2.0,46,2,3,2,7,0xb2d0d0e0d
206270.24,6.0,0,3,4,4,11,0xb2d09655d
3361.08,1.0,215,2,2,1,5,0xb2d37a84d
1499.48,1.0,0,1,2,4,7,0xb2d55d3d
1360417.03,3.0,0,4,4,4,12,0xb2d5ce44
460.27,1.0,2,1,2,4,7,0xb2d3b601
1020034.5,6.0,0,4,4,4,12,0xb2d5bb97d
42.48,1.0,36,1,2,2,5,0xb2d6d9ead
13.97,1.0,11,1,2,3,6,0xb2d0dfd1
10100.64,1.0,16,2,2,2,6,0xb2da335d
2918.27,1.0,15,2,2,3,7,0xb2d8d4ded
1400.37,1.0,0,1,2,4,7,0xb2d3e4a9
19.08,1.0,1,1,2,4,7,0xb2d34527
78.72,1.0,1,1,2,4,7,0xb2d4364a
15309.28,1.0,1,2,2,4,8,0xb2d53da6
640147.23,6.0,22,4,4,2,10,0xb2d1bb9dd
5290.62,1.0,184,2,2,1,5,0xb2d12714d
407.44,1.0,9,1,2,3,6,0xb2d2f8db
528343.22,2.0,199,4,3,1,8,0xb2d57711d
121894.14,2.0,5,3,3,3,9,0xb2d0cd7dd
5066.35,1.0,184,2,2,1,5,0xb2d2aaab
21.63,1.0,27,1,2,2,5,0xb2d98eb2
2.56,1.0,111,1,2,1,4,0xb2d49358d
161208.9,8.0,0,3,4,4,11,0x3b9ad6b8
117117.55,3.0,1,3,4,4,11,0xb2d592cbd
5117.21,1.0,11,2,2,3,7,0xb2d4c059d
120001.37,2.0,3,3,3,4,10,0xb2d956a4
313.9,1.0,10,1,2,3,6,0xb2d3b603
400068.22,5.0,2,4,4,4,12,0xb2d6843c
10245.9,1.0,182,2,2,1,5,0xb2d0ad32
1706.12,1.0,9,1,2,3,6,0xb2d4a53f
600000.0,3.0,4,4,4,4,12,0xb2d60f41
1151096.16,6.0,0,4,4,4,12,0xb2d25b4bd
826068.59,2.0,0,4,3,4,11,0xb2d2c322
2.77,1.0,67,1,2,1,4,0xb2d41846
330095.5,2.0,12,4,3,3,10,0xb2d10a2c
28240.7,1.0,21,2,2,2,6,0xb2d60aa1
1688.15,1.0,5,1,2,3,6,0xb2d790d1
112213.82,2.0,10,3,3,3,9,0xb2d1346ad
1691127.47,6.0,8,4,4,3,11,0xb2d104cb
140041.09,3.0,8,3,4,3,10,0xb2d261d9d
96537.72,1.0,0,3,2,4,9,0xb2d36dd3
50597.46,2.0,154,2,3,1,6,0xb2d6c35ed
800628.29,7.0,15,4,4,3,11,0xb2d255b4d
32082.81,1.0,0,2,2,4,8,0xb2d6b746d
227618.5,3.0,0,3,4,4,11,0xb2d1b8c2
6258859.64,1.0,7,4,2,3,9,0xb2d37b3ad
2014222.76,5.0,68,4,4,1,9,0xb2d0b351
200085.35,2.0,1,3,3,4,10,0xb2d6e089
18016.8,1.0,27,2,2,2,6,0xb2d6b6c8d
456676.04,4.0,70,4,4,1,9,0xb2d0c42cd
464619.72,4.0,167,4,4,1,9,0xb2d426dd
300092.06,3.0,5,3,4,3,10,0xb2d65c31
24.26,3.0,3,1,4,4,9,0xb2d8c6b3
8393.11,1.0,3,2,2,4,8,0xb2d3455ed
53430.47,3.0,5,3,4,3,10,0x3b9b1804d
7995.24,1.0,5,2,2,3,7,0xb2d23ec9
1853.96,1.0,17,1,2,2,5,0xb2d8e53c
2151431.31,11.0,8,4,4,3,11,0xb2d4f521
40001.69,2.0,28,2,3,2,7,0xb2da0778
5253.19,1.0,8,2,2,3,7,0xb2d26a26
523011.71,4.0,11,4,4,3,11,0xb2d2e1aed
1220.48,1.0,61,1,2,2,5,0xb2d69235
2805.08,1.0,0,1,2,4,7,0xb2d39bfbd
1830.16,1.0,92,1,2,1,4,0xb2d19f6ad
2030.04,2.0,53,1,3,2,6,0xb2d8f4b7d
408563.63,3.0,2,4,4,4,12,0xb2d5f85ed
18.6,1.0,112,1,2,1,4,0xb2d94d44d
49.73,1.0,7,1,2,3,6,0xb2d2fcb0d
500000.0,2.0,4,4,3,4,11,0xb2d97b3dd
230000.0,3.0,63,3,4,2,9,0xb2d3fb84
109523.6,1.0,4,3,2,4,9,0xb2d282ba
93868.37,2.0,116,3,3,1,7,0xb2d4cb86
3809.7,2.0,184,2,3,1,6,0x3b9b29fed
1569119.27,3.0,29,4,4,2,10,0xb2d6a893d
410055.34,2.0,22,4,3,2,9,0xb2d70084d
480019.18,8.0,42,4,4,2,10,0xb2d18696d
338035.25,3.0,22,4,4,2,10,0xb2d4270fd
80000.84,2.0,83,3,3,1,7,0xb2d8d042d
100004.75,2.0,90,3,3,1,7,0xb2d87ff5d
440013.73,5.0,18,4,4,2,10,0xb2d186c5d
4843.12,1.0,9,2,2,3,7,0xb2d479a6d
6308.61,1.0,18,2,2,2,6,0xb2d31212d
2928.99,1.0,1,2,2,4,8,0xb2d59753d
558865.79,36.0,4,4,4,4,12,0xb2d0634dd
253008.56,4.0,122,3,4,1,8,0xb2d289a6d
50022.2,2.0,55,2,3,2,7,0xb2d5e0fed
204399.11,2.0,31,3,3,2,8,0xb2d34f78d
958297.66,4.0,59,4,4,2,10,0xb2d0722a
201431.58,2.0,5,3,3,3,9,0xb2d87976d
360262.76,3.0,45,4,4,2,10,0xb2d12a25
20008.23,2.0,66,2,3,2,7,0xb2d5d6e5d
5076.51,1.0,0,2,2,4,8,0xb2d2d6abd
150001.58,2.0,27,3,3,2,8,0xb2d94140
120511.06,2.0,27,3,3,2,8,0xb2d0dabc
500069.12,3.0,20,4,4,2,10,0xb2d68bd9
9413.83,1.0,2,2,2,4,8,0xb2d12ce3
779.64,1.0,37,1,2,2,5,0xb2d426b3
100007.66,2.0,139,3,3,1,7,0xb2d616c1d
285068.07,6.0,26,3,4,2,9,0xb2d4423dd
1131.31,1.0,22,1,2,2,5,0xb2d2007cd
219083.11,2.0,76,3,3,1,7,0xb2d2850cd
210048.92,2.0,41,3,3,2,8,0xb2d3b8a4
133489.58,4.0,8,3,4,3,10,0xb2d5a103
4575.18,4.0,92,2,4,1,7,0x3b9b37ead
120919.7,2.0,147,3,3,1,7,0xb2d3d94ed
314167.23,2.0,15,4,3,3,10,0xb2d56c20d
18.63,1.0,116,1,2,1,4,0xb2d21556d
210058.76,4.0,110,3,4,1,8,0xb2d67de2d
507107.76,3.0,134,4,4,1,9,0xb2d923f8
3300000.86,9.0,3,4,4,4,12,0x3b9acd0cd
3751.07,1.0,1,2,2,4,8,0xb2d4a246d
29.17,1.0,60,1,2,2,5,0xb2d9379a
2247.81,1.0,92,1,2,1,4,0x3b9b2477
276087.02,7.0,2,3,4,4,11,0xb2d97318d
300004.22,3.0,12,3,4,3,10,0xb2d7c6c0d
1024378.16,6.0,0,4,4,4,12,0xb2d59924d
500133.32,2.0,24,4,3,2,9,0xb2d6accdd
291.81,1.0,32,1,2,2,5,0xb2d5bf7c
7387.02,1.0,6,2,2,3,7,0xb2d38b35d
31.43,1.0,82,1,2,1,4,0xb2d133c1
48.65,1.0,4,1,2,4,7,0xb2d1d20dd
594.99,1.0,0,1,2,4,7,0x3b9b2f47
1670.36,1.0,30,1,2,2,5,0xb2d34669
2390102.99,3.0,97,4,4,1,9,0xb2d909ded
53.41,1.0,13,1,2,3,6,0xb2d3b7f2
233835.92,2.0,136,3,3,1,7,0xb2d5868bd
819.1,1.0,0,1,2,4,7,0xb2d0c444d
1183.4,4.0,184,1,4,1,6,0xb2d366e7d
609866.77,4.0,0,4,4,4,12,0xb2d6c18a
510695.42,2.0,6,4,3,3,10,0xb2d5e25b
80001.69,2.0,80,3,3,1,7,0xb2d8d517d
208243.86,2.0,108,3,3,1,7,0xb2d5d3b1d
160076.36,3.0,116,3,4,1,8,0xb2d569c8d
50001.58,2.0,18,2,3,2,7,0xb2d8b166
180754.06,5.0,45,3,4,2,9,0xb2d075cf
28.07,1.0,0,1,2,4,7,0xb2d6bd15
8438.4,1.0,6,2,2,3,7,0xb2d46dbbd
202129.73,2.0,26,3,3,2,8,0xb2d975e2
5166.93,1.0,0,2,2,4,8,0xb2d0ef98
1824.66,1.0,8,1,2,3,6,0xb2d69230d
300000.0,2.0,7,3,3,3,9,0xb2da54e3
6268.49,1.0,184,2,2,1,5,0xb2d283b7d
543093.16,7.0,6,4,4,3,11,0xb2d63d9cd
162.02,1.0,2,1,2,4,7,0xb2d42c99
837999.95,5.0,3,4,4,4,12,0xb2d10fb6d
400066.13,2.0,19,4,3,2,9,0xb2d1d988
10004.71,2.0,32,2,3,2,7,0xb2d9ff81
787.59,1.0,0,1,2,4,7,0xb2d33c95
119.08,2.0,13,1,3,3,7,0xb2d10ccfd
90029.03,2.0,63,3,3,2,8,0xb2d40c55d
6403.37,1.0,24,2,2,2,6,0xb2d62f3b
73637.95,2.0,118,3,3,1,7,0xb2d62d6e
302481.0,1.0,0,4,2,4,10,0xb2da54e0
637.24,1.0,10,1,2,3,6,0xb2d316ba
317178.23,2.0,0,4,3,4,11,0xb2d34ec9d
100905.87,3.0,164,3,4,1,8,0xb2d5bfd4d
1370.2,1.0,9,1,2,3,6,0xb2d1bc8dd
801808.97,4.0,13,4,4,3,11,0xb2d8ebe3
159.77,1.0,0,1,2,4,7,0xb2d6b346
57.69,1.0,1,1,2,4,7,0xb2d67ecc
20000.21,2.0,92,2,3,1,6,0xb2d97fd7
171.22,1.0,10,1,2,3,6,0xb2d2dcf3
692013.47,4.0,1,4,4,4,12,0xb2d58137
2047156.64,8.0,24,4,4,2,10,0xb2d2224b
39601.33,4.0,0,2,4,4,10,0xb2d0e2bdd
1850.97,1.0,92,1,2,1,4,0xb2d291bb
43.49,1.0,184,1,2,1,4,0xb2d2722ed
6275.22,2.0,0,2,3,4,9,0xb2d0ec09
7258.26,1.0,9,2,2,3,7,0xb2d31efa
500.31,1.0,0,1,2,4,7,0xb2d14903
500007.76,3.0,12,4,4,3,11,0xb2d7ecc0
4184.14,1.0,0,2,2,4,8,0xb2d261b0d
361.91,1.0,0,1,2,4,7,0xb2d1fa75
984816.23,8.0,13,4,4,3,11,0xb2d1bed7d
23.34,1.0,26,1,2,2,5,0xb2d46b4f
1073.22,1.0,3,1,2,4,7,0xb2d20648
3307.17,1.0,3,2,2,4,8,0xb2d558d5
901180.54,3.0,20,4,4,2,10,0xb2d3c9e9d
690026.04,8.0,42,4,4,2,10,0xb2d176f8d
238144.39,1.0,9,3,2,3,8,0xb2d5ab47
107.98,1.0,23,1,2,2,5,0xb2d1fa31d
5490000.0,26.0,1,4,4,4,12,0xb2d09368d
394506.9,6.0,0,4,4,4,12,0xb2d08489d
17466.03,1.0,21,2,2,2,6,0xb2d963c3
202315.12,2.0,13,3,3,3,9,0xb2d11b80d
40824.73,3.0,104,2,4,1,7,0xb2d56f95d
80097.69,2.0,0,3,3,4,10,0xb2d1a3a9d
210459.1,3.0,77,3,4,1,8,0xb2d3d4cbd
510.29,1.0,10,1,2,3,6,0xb2d690d1
801651.71,11.0,0,4,4,4,12,0x3b9af23f
56723.49,1.0,24,3,2,2,7,0xb2d13a48
150209.38,2.0,208,3,3,1,7,0xb2d46349d
100002.11,2.0,80,3,3,1,7,0xb2d8d543
92000.0,1.0,0,3,2,4,9,0xb2d97200
350000.0,2.0,12,4,3,3,10,0xb2d8e848
14149.99,1.0,10,2,2,3,7,0xb2d5cf77
520008.55,6.0,14,4,4,3,11,0xb2d62514
11900.17,1.0,11,2,2,3,7,0xb2d30ac2d
13379.0,1.0,92,2,2,1,5,0x3b9b196ad
39859.12,1.0,0,2,2,4,8,0xb2d43a62d
405285.74,2.0,18,4,3,2,9,0xb2d6533dd
97296.87,4.0,0,3,4,4,11,0x3b9b29dfd
1784.01,2.0,30,1,3,2,6,0xb2d86e89d
103413.37,1.0,1,3,2,4,9,0xb2d2f744
1771829.66,4.0,27,4,4,2,10,0xb2d93f2b
686519.97,3.0,118,4,4,1,9,0xb2d534fcd
8001.16,1.0,7,2,2,3,7,0xb2d9d042
11062.03,1.0,4,2,2,4,8,0xb2d6892c
200049.05,2.0,1,3,3,4,10,0xb2da26b9
536702.49,3.0,1,4,4,4,12,0xb2d40f29d
1842.69,1.0,12,1,2,3,6,0xb2d67d97
551895.77,5.0,21,4,4,2,10,0x3b9b124cd
77001.49,5.0,63,3,4,2,9,0xb2d10735d
115356.69,4.0,4,3,4,4,11,0x3b9b0fd2d
163540.06,3.0,108,3,4,1,8,0xb2d2d912
11399.92,1.0,9,2,2,3,7,0xb2d6b0c1
239.99,1.0,11,1,2,3,6,0xb2d560ae
918.29,1.0,9,1,2,3,6,0xb2d8ca52
12242.43,1.0,92,2,2,1,5,0xb2d0eabdd
501778.28,2.0,17,4,3,2,9,0xb2d912ee
406414.17,4.0,69,4,4,1,9,0xb2d483e5d
1502589.81,7.0,18,4,4,2,10,0xb2d22010d
187842.18,1.0,158,3,2,1,6,0xb2d3c4c7d
210469.73,2.0,153,3,3,1,7,0xb2d2ae31d
3070535.15,2.0,4,4,3,4,11,0xb2d14f90d
381114.68,3.0,0,4,4,4,12,0x3b9b29e3d
271479.54,3.0,49,3,4,2,9,0xb2d34d84d
0.0,1.0,8,1,2,3,6,0xb2d20e8e
540001.48,7.0,10,4,4,3,11,0xb2d080dad
9.12,1.0,41,1,2,2,5,0xb2d6c60d
705467.86,7.0,41,4,4,2,10,0xb2d23d73d
1113119.85,2.0,64,4,3,2,9,0xb2d31bd8d
880.4,1.0,231,1,2,1,4,0xb2d0b741
79.16,2.0,18,1,3,2,6,0xb2d78072
226299.08,3.0,13,3,4,3,10,0xb2d2be0b
30855.54,1.0,20,2,2,2,6,0xb2d9cba1
22196.46,1.0,0,2,2,4,8,0xb2d55271d
51853.39,2.0,95,2,3,1,6,0xb2d4da42d
1016373.4,2.0,136,4,3,1,8,0xb2d636e1d
47.68,1.0,9,1,2,3,6,0xb2d229a8d
34943.93,1.0,3,2,2,4,8,0xb2d91768d
536104.71,5.0,155,4,4,1,9,0xb2d5e56f
3444.21,1.0,0,2,2,4,8,0xb2d8da1bd
400.0,18.0,0,1,4,4,9,0x3b9b3ba4d
2170.28,1.0,0,1,2,4,7,0xb2d5f62f
11627.39,1.0,16,2,2,2,6,0xb2d2ecd7
655693.79,3.0,72,4,4,1,9,0xb2d44034
50009.73,2.0,104,2,3,1,6,0xb2d32dad
625000.0,1.0,0,4,2,4,10,0xb2da665a
130039.35,2.0,179,3,3,1,7,0xb2d06b2dd
101582.0,1.0,1,3,2,4,9,0xb2d610ead
206.81,1.0,24,1,2,2,5,0xb2d0e616d
4604.39,1.0,13,2,2,3,7,0xb2d5e48d
798.05,1.0,5,1,2,3,6,0xb2d2e462
100001.0,2.0,0,3,3,4,10,0xb2d97815d
496045.03,17.0,6,4,4,3,11,0x3b9b0e5ed
26526.03,1.0,0,2,2,4,8,0x3b9af506
182047.25,5.0,102,3,4,1,8,0xb2d085c6d
2046.26,1.0,92,1,2,1,4,0xb2d1dab2d
200030.68,3.0,32,3,4,2,9,0xb2d81638d
3874.29,1.0,153,2,2,1,5,0xb2d22313d
1098.76,1.0,0,1,2,4,7,0xb2d594a7
271641.44,3.0,165,3,4,1,8,0xb2d5c787d
1012.13,1.0,184,1,2,1,4,0xb2d24a88d
29627.66,1.0,78,2,2,1,5,0xb2d5ae07d
111244.17,1.0,10,3,2,3,8,0xb2d8de99
650831.63,6.0,26,4,4,2,10,0xb2d2270dd
96.25,1.0,34,1,2,2,5,0xb2d4d3a9
225083.53,5.0,4,3,4,4,11,0xb2d17d62d
49096.8,1.0,61,2,2,2,6,0xb2d63dd3d
583308.31,4.0,0,4,4,4,12,0xb2d0dd72d
70001.37,4.0,21,3,4,2,9,0xb2d8febed
1047587.53,6.0,1,4,4,4,12,0xb2d22979
165.46,1.0,9,1,2,3,6,0xb2d2390ed
11745.81,1.0,184,2,2,1,5,0x3b9b2e81d
285412.98,3.0,3,3,4,4,11,0xb2d456fad
12013150.36,116.0,0,4,4,4,12,0xb2d19f38
786.23,1.0,0,1,2,4,7,0xb2d6b999d
15.26,1.0,16,1,2,2,5,0xb2d43485d
39383.23,1.0,143,2,2,1,5,0xb2d3a8a0
508883.92,3.0,52,4,4,2,10,0xb2d8d2de
814620.0,1.0,0,4,2,4,10,0xb2d5809f
9974.79,1.0,184,2,2,1,5,0xb2d260e2d
25.12,5.0,10,1,4,3,8,0x3b9ae4f1d
893.38,6.0,47,1,4,2,7,0xb2d079f9
796.0,1.0,12,1,2,3,6,0xb2d221ef
400010.42,3.0,1,4,4,4,12,0xb2d92e83d
106500.64,2.0,9,3,3,3,9,0xb2d783d5d
985555.62,2.0,4,4,3,4,11,0xb2d403d3d
1014.47,1.0,92,1,2,1,4,0xb2d14eefd
80702.43,2.0,6,3,3,3,9,0xb2d9729f
854.15,1.0,0,1,2,4,7,0xb2d793f9
10000.32,2.0,25,2,3,2,7,0xb2d469b8
1220074.33,18.0,1,4,4,4,12,0xb2d28871
60680.16,2.0,3,3,3,4,10,0xb2d0d52cd
10142.22,1.0,184,2,2,1,5,0xb2d21df9d
102136.36,2.0,153,3,3,1,7,0xb2d622f3d
10179.97,1.0,128,2,2,1,5,0xb2d694edd
68.62,1.0,1,1,2,4,7,0xb2d614a6
30001686.37,2.0,1,4,3,4,11,0xb2d3a3b3
83.0,1.0,18,1,2,2,5,0xb2d6c4d8
15130.12,1.0,184,2,2,1,5,0xb2d35b3d
16222.53,1.0,0,2,2,4,8,0xb2d29f3a
1925046.97,4.0,13,4,4,3,11,0xb2d5bfe3d
9203.04,1.0,0,2,2,4,8,0xb2d65006
250016.08,5.0,1,3,4,4,11,0xb2d9b9d0
2068175.17,12.0,4,4,4,4,12,0xb2d249b3
400031.34,3.0,13,4,4,3,11,0xb2d78be0
212047.85,3.0,74,3,4,1,8,0xb2d5df37d
3028.94,1.0,200,2,2,1,5,0xb2d4ea31d
27109.22,1.0,13,2,2,3,7,0xb2d1d6c4
450003.72,3.0,0,4,4,4,12,0xb2d48f94d
200710.42,2.0,39,3,3,2,8,0xb2d9f58c
202001.72,6.0,29,3,4,2,9,0xb2d29ba7
200008.0,2.0,28,3,3,2,8,0xb2d9411e
2628.42,1.0,104,1,2,1,4,0xb2d48e97
4730240.0,2.0,0,4,3,4,11,0xb2d95fd7
15030.39,1.0,21,2,2,2,6,0xb2d4238c
810439.11,7.0,0,4,4,4,12,0xb2d2479d
39.13,1.0,30,1,2,2,5,0xb2d358fa
444706.33,3.0,78,4,4,1,9,0xb2d6f4cb
185887.83,2.0,57,3,3,2,8,0xb2d474c0
350237.61,5.0,2,4,4,4,12,0xb2d62f60d
280008.89,2.0,10,3,3,3,9,0xb2d523b0d
1367.45,2.0,10,1,3,3,7,0xb2d17fb8
130060.53,2.0,49,3,3,2,8,0xb2d1a44f
2740.14,1.0,2,1,2,4,7,0xb2d60a74d
5253.15,1.0,231,2,2,1,5,0xb2d5b53fd
234.39,1.0,10,1,2,3,6,0xb2d3e801
3715.0,1.0,184,2,2,1,5,0xb2d22d7ad
2083.2,1.0,92,1,2,1,4,0xb2d30f83d
10010.83,2.0,83,2,3,1,6,0xb2d6fa83d
1038680.37,8.0,34,4,4,2,10,0xb2d27883d
20037.05,1.0,29,2,2,2,6,0xb2d1453dd
384021.12,2.0,0,4,3,4,11,0xb2d96922
200035.22,5.0,38,3,4,2,9,0xb2d49652
528343.73,4.0,16,4,4,2,10,0xb2d24d38d
34503.04,1.0,14,2,2,3,7,0xb2d3a106
126324.45,3.0,168,3,4,1,8,0xb2d437ef
32.95,1.0,16,1,2,2,5,0xb2d6b985d
500000.0,2.0,13,4,3,3,10,0xb2d95a6e
10000.96,2.0,0,2,3,4,9,0xb2d5eaa4d
20128.77,1.0,28,2,2,2,6,0xb2d396d1
67.84,1.0,0,1,2,4,7,0xb2d1d89ed
280370.14,2.0,196,3,3,1,7,0xb2d4bcf1d
5401.31,1.0,184,2,2,1,5,0xb2d20157
10429.01,1.0,92,2,2,1,5,0xb2d2754f
11245.59,1.0,6,2,2,3,7,0xb2d38bea
80001.69,2.0,95,3,3,1,7,0xb2d975d5d
2087.34,1.0,8,1,2,3,6,0xb2d3980b
36452.28,1.0,25,2,2,2,6,0xb2d31373
175748.11,5.0,0,3,4,4,11,0x3b9b124dd
115137.22,2.0,34,3,3,2,8,0xb2d8d9c0d
95486.68,2.0,49,3,3,2,8,0xb2d4cb86d
900000.04,5.0,4,4,4,4,12,0xb2d5a462d
2452.86,1.0,0,1,2,4,7,0xb2d5d229d
41910.86,1.0,2,2,2,4,8,0xb2d906c6d
708870.18,1.0,4,4,2,4,10,0xb2d957e5d
200262.91,6.0,12,3,4,3,10,0xb2d39ccd
251659.46,2.0,76,3,3,1,7,0x3b9b24aa
3018.76,1.0,97,2,2,1,5,0xb2d6849ed
751239.21,7.0,0,4,4,4,12,0xb2d5d58a
100056.57,2.0,66,3,3,2,8,0xb2d5bd9ed
651509.28,18.0,0,4,4,4,12,0x3b9b18f7
260039.97,3.0,70,3,4,1,8,0xb2d4384d
530571.21,3.0,3,4,4,4,12,0xb2d684a4d
410449.3,3.0,6,4,4,3,11,0xb2d5bdf7d
2889.91,1.0,93,2,2,1,5,0xb2d8c82cd
20969.71,2.0,2,2,3,4,9,0xb2d94244
1568679.85,2.0,129,4,3,1,8,0x3b9b3882d
68.11,1.0,4,1,2,4,7,0xb2d5c565
1.0,1.0,0,1,2,4,7,0xb2d8ffb3
200129.16,3.0,48,3,4,2,9,0xb2d58411d
4517.28,1.0,51,2,2,2,6,0xb2d5f3ebd
336187.05,3.0,30,4,4,2,10,0xb2d48792d
505330.04,2.0,105,4,3,1,8,0xb2d9607c
0.0,1.0,5,1,2,3,6,0xb2d621f6
412.65,1.0,6,1,2,3,6,0xb2d6eaca
10000.16,2.0,25,2,3,2,7,0xb2da15b3
80544.66,2.0,0,3,3,4,10,0xb2d6ec54d
220038.28,3.0,14,3,4,3,10,0xb2d571af
65001.27,2.0,0,3,3,4,10,0xb2da0809
221.08,1.0,26,1,2,2,5,0xb2d39cd0d
551500.71,6.0,5,4,4,3,11,0xb2d657bcd
200000.0,2.0,20,3,3,2,8,0xb2d95435d
11674.06,1.0,184,2,2,1,5,0xb2d1caa4d
300037.43,4.0,31,3,4,2,9,0x3b9b1716
142925.81,4.0,1,3,4,4,11,0xb2d558abd
160090.87,3.0,45,3,4,2,9,0xb2d690c0d
1565.02,2.0,270,1,3,1,5,0xb2d358d2
40002.63,2.0,25,2,3,2,7,0xb2d12867d
10.0,1.0,0,1,2,4,7,0xb2d0d6ecd
260400.22,3.0,10,3,4,3,10,0xb2d5ccf0
6678.62,3.0,0,2,4,4,10,0xb2d0afd9
23440.39,1.0,2,2,2,4,8,0xb2d33ab3
2401.34,1.0,14,1,2,3,6,0xb2d8cac9d
100907.57,2.0,108,3,3,1,7,0xb2d6b215d
2561.36,1.0,1,1,2,4,7,0xb2d2fd66d
50009.71,2.0,111,2,3,1,6,0xb2d56a84d
7243.08,1.0,184,2,2,1,5,0x3b9b23ded
30880.81,2.0,82,2,3,1,6,0xb2d58cc5d
101616.0,3.0,21,3,4,2,9,0xb2d57347d
263123.27,3.0,8,3,4,3,10,0xb2d5ccf0d
4964508.79,1.0,13,4,2,3,9,0xb2d9de44
170.26,1.0,1,1,2,4,7,0x3b9b3219
635926.92,4.0,41,4,4,2,10,0xb2d1a96ad
213828.92,1.0,0,3,2,4,9,0xb2d3c777d
16371.79,1.0,84,2,2,1,5,0xb2d488e5d
204267.21,2.0,20,3,3,2,8,0xb2d5dc5dd
202729.8,2.0,209,3,3,1,7,0xb2d591f6d
700182.62,6.0,1,4,4,4,12,0xb2d14189
23.54,1.0,60,1,2,2,5,0xb2d6f8aed
470000.63,3.0,0,4,4,4,12,0xb2d52b45d
602.97,1.0,9,1,2,3,6,0xb2d35315
808.01,1.0,7,1,2,3,6,0xb2d2fbd8d
290064.44,6.0,83,3,4,1,8,0xb2d17975d
187478.4,4.0,0,3,4,4,11,0xb2d5da68d
31639.35,1.0,1,2,2,4,8,0xb2d6fc50
102387.15,2.0,14,3,3,3,9,0xb2d115c5
1600942.33,2.0,6,4,3,3,10,0xb2d7864f
941429.87,8.0,0,4,4,4,12,0xb2d58068d
144657.3,2.0,0,3,3,4,10,0xb2d212f3
698006.33,10.0,1,4,4,4,12,0xb2d0d04ad
292288.61,2.0,1,3,3,4,10,0xb2d4fc2b
1788.81,1.0,10,1,2,3,6,0xb2d7c8fc
204.51,1.0,25,1,2,2,5,0xb2d3c1ced
50001.06,2.0,245,2,3,1,6,0xb2d6db8f
396741.54,5.0,76,4,4,1,9,0xb2d59e04
290088.57,5.0,0,3,4,4,11,0xb2d0fd91
207.43,1.0,0,1,2,4,7,0xb2d2e176d
3.62,1.0,1,1,2,4,7,0xb2d1b007
8041.74,5.0,14,2,4,3,9,0xb2d0a059d
749887.22,10.0,11,4,4,3,11,0xb2d37880
1050024.55,3.0,91,4,4,1,9,0xb2d27805
222000.0,3.0,7,3,4,3,10,0xb2d19800
52682.82,1.0,0,3,2,4,9,0xb2d1912bd
53000.39,2.0,210,3,3,1,7,0xb2d42078d
289500.58,5.0,8,3,4,3,10,0xb2d13bbc
60044.25,6.0,70,3,4,1,8,0xb2d64083d
140030.66,2.0,11,3,3,3,9,0xb2d55eca
2580.88,1.0,184,1,2,1,4,0xb2d293b4d
10614.69,1.0,1,2,2,4,8,0xb2d629f8
659846.16,5.0,18,4,4,2,10,0xb2d5fcb1d
90.83,1.0,74,1,2,1,4,0xb2d60d57
401675.47,13.0,3,4,4,4,12,0xb2d5f285d
501778.07,2.0,20,4,3,2,9,0xb2d92523d
20.13,1.0,3,1,2,4,7,0xb2d36d49
82892.48,1.0,0,3,2,4,9,0xb2d2f908d
881193.12,7.0,1,4,4,4,12,0xb2d43a14d
2112.4,1.0,6,1,2,3,6,0xb2d8d619
55.76,1.0,51,1,2,2,5,0xb2d65cde
2880.58,1.0,22,1,2,2,5,0xb2d6d8bf
7956510.51,4.0,14,4,4,3,11,0xb2d15f44
502.19,1.0,81,1,2,1,4,0xb2d55c32
452854.1,12.0,0,4,4,4,12,0xb2d22bcad
200101.56,2.0,36,3,3,2,8,0xb2d83543
2.67,1.0,2,1,2,4,7,0xb2d4fbdc
11957.2,1.0,5,2,2,3,7,0xb2d31069d
600012.53,4.0,14,4,4,3,11,0xb2d91fe7d
150001.0,7.0,1,3,4,4,11,0xb2d91848d
1167.39,1.0,184,1,2,1,4,0xb2d087ced
50000.53,2.0,77,2,3,1,6,0xb2d9953a
5626.11,1.0,4,2,2,4,8,0xb2d7c6de
1357.24,1.0,22,1,2,2,5,0xb2d2c576d
795290.41,12.0,1,4,4,4,12,0xb2d3ae70d
200330.72,2.0,4,3,3,4,10,0xb2d23643
100053.82,2.0,77,3,3,1,7,0xb2d591c0d
319546.66,7.0,3,4,4,4,12,0xb2d57ed1
10314.78,1.0,59,2,2,2,6,0xb2d640c7
200012.1,3.0,203,3,4,1,8,0xb2d61c45
101223.1,1.0,95,3,2,1,6,0xb2d78f44d
501787.77,2.0,42,4,3,2,9,0xb2d91fbed
827212.31,5.0,126,4,4,1,9,0xb2d1ac7b
1452.5,1.0,183,1,2,1,4,0xb2d2a067
231058.37,5.0,1,3,4,4,11,0xb2d1fdbad
0.0,2.0,5,1,3,3,7,0xb2d2ea32d
20051.86,1.0,0,2,2,4,8,0xb2d2b2e5d
1361.0,1.0,0,1,2,4,7,0xb2d8e9f9
449020.13,4.0,67,4,4,1,9,0xb2d594ac
1612.88,1.0,0,1,2,4,7,0xb2d3e9d0
53.9,1.0,16,1,2,2,5,0xb2d6503f
91.82,1.0,2,1,2,4,7,0xb2d2f683
600145.8,2.0,11,4,3,3,10,0xb2d32513d
0.0,2.0,55,1,3,2,6,0xb2d4da57
4.62,1.0,59,1,2,2,5,0xb2d56bcb
108526.4,2.0,3,3,3,4,10,0xb2d526ead
15368.82,1.0,109,2,2,1,5,0xb2d5fd3ed
250242.44,4.0,20,3,4,2,9,0xb2d9e6c6
300022.97,4.0,14,3,4,3,10,0xb2d249ded
1848.6,1.0,125,1,2,1,4,0xb2d913cdd
201421.03,2.0,5,3,3,3,9,0xb2d8f58e
250002.64,2.0,53,3,3,2,8,0xb2d9cf11
10211.44,1.0,294,2,2,1,5,0xb2d5cdddd
2430.65,1.0,3,1,2,4,7,0xb2d4ce3bd
751751.97,6.0,158,4,4,1,9,0xb2d3709ad
891.8,2.0,1,1,3,4,8,0xb2d5ec0fd
200011.11,2.0,55,3,3,2,8,0xb2d6e23fd
12.46,1.0,3,1,2,4,7,0xb2d62957
438.03,1.0,0,1,2,4,7,0xb2d22f2dd
200000.0,2.0,10,3,3,3,9,0xb2d9b193
2400027.89,5.0,20,4,4,2,10,0xb2d550f6
2194.89,1.0,283,1,2,1,4,0xb2d27876
3001.78,1.0,154,2,2,1,5,0xb2d1aff4
26207.28,1.0,16,2,2,2,6,0xb2d5e36d
310069.87,4.0,3,4,4,4,12,0xb2d07968
3502.7,1.0,28,2,2,2,6,0xb2d2db5d
5981.72,1.0,92,2,2,1,5,0xb2d54bf9d
475.8,3.0,49,1,4,2,7,0xb2d2b9e3
10000.16,2.0,5,2,3,3,8,0xb2d94499d
1681.23,3.0,0,1,4,4,9,0xb2d0d96a
412.92,1.0,22,1,2,2,5,0xb2d10617
50008.35,2.0,4,2,3,4,9,0xb2d92ca2d
27.75,1.0,46,1,2,2,5,0xb2d6deddd
1188000.0,7.0,4,4,4,4,12,0xb2d07ecfd
2236.81,1.0,1,1,2,4,7,0xb2d8d117d
0.07,1.0,22,1,2,2,5,0xb2d58dbbd
70001.58,4.0,1,3,4,4,11,0xb2d961a8d
42157.89,1.0,1,2,2,4,8,0xb2d6c000
110156.34,4.0,95,3,4,1,8,0xb2d15edd
200006.33,2.0,53,3,3,2,8,0xb2d9cb36
50013.95,2.0,116,2,3,1,6,0xb2d5efcad
70007.91,2.0,92,3,3,1,7,0x3b9b3dbad
0.27,2.0,64,1,3,2,6,0xb2d27665d
7.71,1.0,28,1,2,2,5,0xb2d587d4d
554975.39,4.0,12,4,4,3,11,0xb2d6b1ef
100001.06,3.0,69,3,4,1,8,0xb2d1b289
2267.62,1.0,92,1,2,1,4,0xb2d4f349d
10463.31,1.0,0,2,2,4,8,0xb2d2af9ad
30090.98,1.0,92,2,2,1,5,0xb2d60c8fd
60001.27,2.0,74,3,3,1,7,0xb2d99e29
821.78,1.0,0,1,2,4,7,0xb2d30414d
420097.74,3.0,119,4,4,1,9,0x3b9b495ad
790123.64,6.0,0,4,4,4,12,0xb2d5fe42d
860009.06,4.0,0,4,4,4,12,0xb2d2ee09d
160121.32,3.0,69,3,4,1,8,0xb2d1efd2d
857425.93,4.0,0,4,4,4,12,0xb2d512c4d
543.15,1.0,3,1,2,4,7,0xb2d16e28
11.81,1.0,0,1,2,4,7,0xb2d989a0
346213.2,2.0,0,4,3,4,11,0xb2d3153a
78698.43,3.0,181,3,4,1,8,0xb2d1595c
1157.55,1.0,0,1,2,4,7,0xb2d5e36f
1131.35,2.0,184,1,3,1,5,0xb2d42d27d
233662.71,5.0,0,3,4,4,11,0xb2d5e060
29198.78,1.0,0,2,2,4,8,0xb2d40657
706467.03,3.0,4,4,4,4,12,0xb2d5fc1cd
0.4,1.0,7,1,2,3,6,0xb2d5375cd
328576.65,7.0,3,4,4,4,12,0xb2d956ed
5807.85,1.0,7,2,2,3,7,0xb2d398dd
5.28,1.0,77,1,2,1,4,0xb2d98da0
10123.29,1.0,27,2,2,2,6,0xb2d30ed6d
81961.71,3.0,168,3,4,1,8,0xb2d5cd33d
5296.71,1.0,15,2,2,3,7,0xb2d92099
11460.29,1.0,1,2,2,4,8,0xb2d2b40c
673.28,1.0,56,1,2,2,5,0xb2d6b166d
54365.35,6.0,0,3,4,4,11,0x3b9b18ebd
512725.31,3.0,35,4,4,2,10,0xb2d5ab26d
76002.18,4.0,16,3,4,2,9,0xb2d58066
100100.5,2.0,59,3,3,2,8,0xb2d5b276
3842.62,1.0,2,2,2,4,8,0xb2d0e4fb
15361.77,1.0,130,2,2,1,5,0xb2d5f59cd
768043.07,4.0,25,4,4,2,10,0xb2d530a0d
68825.85,2.0,144,3,3,1,7,0xb2d6d4d7d
10039.26,1.0,184,2,2,1,5,0xb2d2e2b5d
0.32,1.0,46,1,2,2,5,0xb2d9122cd
400052.86,2.0,104,4,3,1,8,0xb2d698b3d
300065.76,2.0,228,3,3,1,7,0xb2d3082ad
531069.98,4.0,29,4,4,2,10,0xb2d7767bd
156.9,1.0,6,1,2,3,6,0xb2d37260d
10096.69,1.0,184,2,2,1,5,0xb2d2a04cd
5324.93,1.0,10,2,2,3,7,0xb2d27368d
70404.84,3.0,1,3,4,4,11,0xb2d95d0c
50001.58,2.0,92,2,3,1,6,0xb2d97dcfd
10001.06,1.0,20,2,2,2,6,0xb2da2ae8
4575.43,1.0,19,2,2,2,6,0xb2d4ed48
130059.66,2.0,217,3,3,1,7,0xb2d138d6d
95.72,1.0,5,1,2,3,6,0xb2d35e8b
1420.8,1.0,4,1,2,4,7,0xb2d1b078d
7977.38,1.0,92,2,2,1,5,0xb2d31220
2993.28,1.0,92,2,2,1,5,0xb2d2dd27
4575.61,1.0,9,2,2,3,7,0xb2d5a2ccd
1185.88,1.0,46,1,2,2,5,0xb2d60099
100046.66,2.0,3,3,3,4,10,0xb2d28b37
10084.88,1.0,13,2,2,3,7,0xb2d982ce
635.35,1.0,104,1,2,1,4,0xb2d17726
49144.68,1.0,0,2,2,4,8,0xb2d69f88
665037.1,10.0,10,4,4,3,11,0xb2d2abaf
167427.29,2.0,12,3,3,3,9,0xb2d27d5d
582453.24,4.0,94,4,4,1,9,0xb2d0f9f8d
318269.66,4.0,37,4,4,2,10,0xb2d5cb77d
15266.91,23.0,0,2,4,4,10,0x3b9b3b03
401626.55,4.0,19,4,4,2,10,0xb2d57878d
97.15,3.0,34,1,4,2,7,0xb2d08e15d
350125.47,2.0,70,4,3,1,8,0xb2d3cc04d
56.23,1.0,8,1,2,3,6,0xb2d7865f
307072.79,4.0,7,4,4,3,11,0xb2d699d9d
4469.08,1.0,0,2,2,4,8,0xb2d43265
2713161.72,9.0,3,4,4,4,12,0xb2d213fd
31516.55,1.0,29,2,2,2,6,0xb2d6b592
14.56,4.0,0,1,4,4,9,0xb2d0afc5
3379.47,1.0,6,2,2,3,7,0xb2d282a6
37146.38,1.0,184,2,2,1,5,0xb2d0a21ad
1401.71,1.0,11,1,2,3,6,0xb2d68bed
490396.55,4.0,53,4,4,2,10,0xb2d10db7d
846161.23,4.0,1,4,4,4,12,0xb2d4ac55d
104004.07,1.0,0,3,2,4,9,0xb2d8c827
521836.33,3.0,34,4,4,2,10,0xb2d9de1f
20309.27,1.0,21,2,2,2,6,0xb2d98b0a
200197.73,4.0,52,3,4,2,9,0x3b9b3618d
84517.06,1.0,5,3,2,3,8,0xb2d62777d
2300345.24,3.0,6,4,4,3,11,0xb2d1b643d
17562.94,4.0,1,2,4,4,10,0x3b9af2b1
201000.0,2.0,8,3,3,3,9,0xb2d44b46
1104.85,1.0,9,1,2,3,6,0xb2d9037d
883.54,1.0,0,1,2,4,7,0xb2d35fd3
950343.43,4.0,27,4,4,2,10,0xb2d10004d
23835.24,1.0,8,2,2,3,7,0xb2d3fd40
1087.78,2.0,92,1,3,1,5,0x3b9ae272
1000.22,1.0,37,1,2,2,5,0xb2d26c79d
557206.03,5.0,206,4,4,1,9,0x3b9b2b8bd
11784.53,1.0,0,2,2,4,8,0xb2d6a1e8d
341931.63,4.0,66,4,4,2,10,0xb2d26533d
5.16,1.0,67,1,2,1,4,0xb2d14759d
1222004.65,4.0,3,4,4,4,12,0xb2d27b0d
825.27,1.0,3,1,2,4,7,0xb2d5547d
4277.56,1.0,94,2,2,1,5,0xb2d9773f
430885.48,4.0,13,4,4,3,11,0xb2d6a0c0
254053.3,3.0,10,3,4,3,10,0xb2d8f225d
507072.09,2.0,11,4,3,3,10,0xb2d6f56fd
100017.77,4.0,74,3,4,1,8,0xb2d4ebfed
1323865.96,3.0,0,4,4,4,12,0xb2d26802
0.0,2.0,1,1,3,4,8,0xb2da30d5
300000.11,2.0,14,3,3,3,9,0xb2d906fd
6424.19,1.0,4,2,2,4,8,0xb2d6e4ee
15355.61,1.0,0,2,2,4,8,0xb2d15245d
612595.34,6.0,0,4,4,4,12,0x3b9b4556
1018.78,1.0,184,1,2,1,4,0x3b9b48a6d
900615.96,2.0,112,4,3,1,8,0xb2d5fcda
700000.06,3.0,19,4,4,2,10,0xb2d65930
3524.17,1.0,92,2,2,1,5,0xb2d2be3ad
164.28,1.0,0,1,2,4,7,0xb2d54a94
181459.42,8.0,0,3,4,4,11,0xb2d62145d
44959.43,1.0,0,2,2,4,8,0xb2d50b3fd
7333.25,1.0,9,2,2,3,7,0xb2d3ab40
573208.32,5.0,13,4,4,3,11,0xb2d0d735
80000090.2,2.0,214,4,3,1,8,0xb2d37eb8d
501793.85,3.0,30,4,4,2,10,0xb2d93f30d
486018.87,6.0,3,4,4,4,12,0xb2d11b81d
13710.38,1.0,26,2,2,2,6,0xb2d2ea30d
4464.31,1.0,0,2,2,4,8,0xb2d5c88f
138202.39,1.0,11,3,2,3,8,0xb2d1879ed
120010.37,2.0,130,3,3,1,7,0xb2d62b3c
2222.83,1.0,2,1,2,4,7,0xb2d162cd
5006.81,1.0,0,2,2,4,8,0xb2d56218
16926.1,1.0,2,2,2,4,8,0xb2d75ac6
207.39,1.0,53,1,2,2,5,0xb2d200d1
492849.4,5.0,18,4,4,2,10,0xb2d916e0d
418902.02,4.0,36,4,4,2,10,0xb2d2e5b3d
123662.9,1.0,0,3,2,4,9,0xb2d41356d
3881556.89,37.0,0,4,4,4,12,0xb2d108acd
950006.46,4.0,0,4,4,4,12,0xb2d78dffd
12038.71,1.0,206,2,2,1,5,0xb2d0d600d
490.99,1.0,35,1,2,2,5,0xb2d56edc
500022.19,3.0,118,4,4,1,9,0xb2d93f5dd
800041.24,4.0,0,4,4,4,12,0xb2d5e0e7d
4462.59,1.0,0,2,2,4,8,0xb2d6bae6d
1225.22,2.0,184,1,3,1,5,0xb2d06a65d
126.53,1.0,26,1,2,2,5,0xb2d398ba
194.48,1.0,61,1,2,2,5,0xb2d63197d
3134.63,1.0,0,2,2,4,8,0xb2d306af
13463.4,1.0,4,2,2,4,8,0xb2d6aa1f
10088.31,2.0,37,2,3,2,7,0xb2d9a48b
1230867.25,6.0,36,4,4,2,10,0xb2d6f1c2d
401.99,1.0,10,1,2,3,6,0xb2d9a96e
25096.36,1.0,43,2,2,2,6,0xb2d6a7cb
300125.84,2.0,5,4,3,3,10,0xb2d17fe8
895.99,1.0,10,1,2,3,6,0xb2d8d596
11529.49,1.0,73,2,2,1,5,0xb2d50d9fd
19053.68,1.0,7,2,2,3,7,0xb2d78d3cd
66.79,1.0,16,1,2,2,5,0xb2d5c065
110388.9,2.0,75,3,3,1,7,0xb2d3a410
20775.91,2.0,231,2,3,1,6,0xb2d526c9
280796.09,1.0,65,3,2,2,7,0xb2d364cdd
997.41,1.0,9,1,2,3,6,0xb2d5cb35d
0.89,1.0,2,1,2,4,7,0xb2d632c7
10000.11,2.0,5,2,3,3,8,0xb2d96a89
1088.2,1.0,16,1,2,2,5,0xb2d20a0ad
20506.79,3.0,101,2,4,1,7,0xb2d5748dd
421.78,1.0,38,1,2,2,5,0xb2d63a97
67890.39,1.0,54,3,2,2,7,0xb2d320e7d
238000.0,2.0,134,3,3,1,7,0xb2d2a3d3d
1517.42,1.0,2,1,2,4,7,0xb2d35fe1
201590.73,2.0,16,3,3,2,8,0xb2d62443d
200001.27,2.0,11,3,3,3,9,0xb2d8c788d
23537.32,1.0,49,2,2,2,6,0xb2d3903ad
794112.71,7.0,80,4,4,1,9,0xb2d170ffd
6386.73,1.0,92,2,2,1,5,0xb2d45e3ed
301030.1,3.0,4,4,4,4,12,0xb2d1d9ebd
223329.2,1.0,108,3,2,1,6,0xb2d3396f
550000.0,3.0,1,4,4,4,12,0xb2da67b8
1102.92,1.0,109,1,2,1,4,0xb2d081cfd
328889.96,5.0,1,4,4,4,12,0xb2d6a8fc
26028.72,1.0,11,2,2,3,7,0xb2d27cedd
1000005.72,3.0,7,4,4,3,11,0xb2d6afd3d
91.03,1.0,60,1,2,2,5,0xb2d9170d
23821.29,1.0,0,2,2,4,8,0xb2d6ad22d
1950000.0,4.0,78,4,4,1,9,0xb2d6c805d
330026.24,4.0,39,4,4,2,10,0xb2d28036d
900009.5,3.0,21,4,4,2,10,0xb2da0a5d
1280068.14,3.0,112,4,4,1,9,0xb2d63299d
125678160.59,8.0,1,4,4,4,12,0xb2d1151ed
37079.36,1.0,2,2,2,4,8,0xb2d5298f
41232.9,2.0,200,2,3,1,6,0x3b9b3029d
40170.05,1.0,0,2,2,4,8,0xb2d9c124
50041.98,3.0,0,2,4,4,10,0xb2d60f57d
660003.28,3.0,6,4,4,3,11,0xb2d65c41d
485228.82,7.0,33,4,4,2,10,0xb2d7b119
4932.48,1.0,0,2,2,4,8,0xb2d5814d
53414.72,2.0,125,3,3,1,7,0xb2d3ede3d
520919.92,4.0,122,4,4,1,9,0xb2d124a0
550000.0,2.0,3,4,3,4,11,0xb2d96e81d
346001.24,8.0,5,4,4,3,11,0xb2d31197
1012231.99,7.0,11,4,4,3,11,0xb2d5523dd
0.65,1.0,170,1,2,1,4,0xb2d1bfc5
1809347.99,7.0,0,4,4,4,12,0xb2d200e4d
2904.8,1.0,3,2,2,4,8,0xb2d0f6c7d
300000.0,2.0,8,3,3,3,9,0xb2da4f1a
61042.78,2.0,116,3,3,1,7,0xb2d62b04d
2.57,1.0,10,1,2,3,6,0xb2d9aa60
50053.95,2.0,225,2,3,1,6,0xb2d45c3cd
30.51,1.0,10,1,2,3,6,0xb2d8fb51d
20688.53,3.0,0,2,4,4,10,0x3b9af18dd
934.85,1.0,9,1,2,3,6,0xb2d2f58c
160954.58,5.0,11,3,4,3,10,0xb2d21121d
167844.88,3.0,16,3,4,2,9,0xb2d19923d
103305.25,2.0,92,3,3,1,7,0xb2d4eb55
458.39,1.0,12,1,2,3,6,0xb2d343b3
96.71,1.0,0,1,2,4,7,0xb2d246f1d
31.02,1.0,70,1,2,1,4,0xb2d5e5c1
71.18,1.0,8,1,2,3,6,0xb2d3ef39
510005.06,3.0,14,4,4,3,11,0xb2d69ac8d
33758.9,1.0,12,2,2,3,7,0xb2d986bb
404264.7,2.0,91,4,3,1,8,0xb2d94084d
14.44,1.0,30,1,2,2,5,0xb2d57473
1564072.45,2.0,0,4,3,4,11,0xb2d63d56
258251.78,1.0,3,3,2,4,9,0xb2d28d29
16073.0,1.0,6,2,2,3,7,0xb2d28c31
1795.46,3.0,10,1,4,3,8,0x3b9add3f
100.92,1.0,37,1,2,2,5,0xb2d292df
1005.21,1.0,184,1,2,1,4,0xb2d54200d
380025.81,2.0,40,4,3,2,9,0xb2d7a9d1
365386.13,3.0,69,4,4,1,9,0xb2d10e03d
1016.38,2.0,2,1,3,4,8,0xb2d49591
487.58,1.0,9,1,2,3,6,0xb2d785f1d
2003727.44,2.0,35,4,3,2,9,0xb2d0d265
13115.31,16.0,19,2,4,2,8,0xb2d3a094
154099.24,6.0,27,3,4,2,9,0xb2d163d4d
1148000.0,22.0,1,4,4,4,12,0xb2d700a5d
6541.03,1.0,0,2,2,4,8,0xb2d6a67f
20000.0,2.0,102,2,3,1,6,0xb2d60002
1012858.69,3.0,203,4,4,1,9,0xb2d22ac4d
87175.08,3.0,0,3,4,4,11,0xb2d0d872
904086.99,4.0,11,4,4,3,11,0xb2d646c5d
33608.36,1.0,3,2,2,4,8,0xb2d537fed
2140473.49,11.0,1,4,4,4,12,0xb2d0ea70d
7027.03,1.0,0,2,2,4,8,0xb2d20fca
309729.47,28.0,0,4,4,4,12,0x3b9b17f4d
50001.06,2.0,80,2,3,1,6,0xb2d8d4ef
35252.07,1.0,70,2,2,1,5,0xb2d2b5c9d
555054.59,6.0,12,4,4,3,11,0xb2d3bce0d
9.16,2.0,88,1,3,1,5,0xb2d0a83e
85.89,1.0,6,1,2,3,6,0xb2d30986d
630000.0,2.0,8,4,3,3,10,0xb2d2c3d9d
615002.0,8.0,66,4,4,2,10,0xb2d26cfcd
87180.57,3.0,1,3,4,4,11,0xb2d6461dd
5548.34,1.0,16,2,2,2,6,0xb2d923b2
340681.23,6.0,24,4,4,2,10,0xb2d56563d
627241.56,2.0,56,4,3,2,9,0xb2d5d238d
864508.46,3.0,5,4,4,3,11,0xb2d14ed0d
6065.37,1.0,184,2,2,1,5,0xb2d297b0d
342768.08,3.0,23,4,4,2,10,0x3b9b3d6d
340036.11,19.0,11,4,4,3,11,0xb2d57a78d
3054.93,1.0,184,2,2,1,5,0xb2d30f18d
1416.21,1.0,184,1,2,1,4,0xb2d5bfb6d
1067.3,1.0,113,1,2,1,4,0xb2d187bad
141903.67,2.0,80,3,3,1,7,0xb2d98ab5
100002.74,3.0,46,3,4,2,9,0xb2d9ce22
2169063.7,2.0,14,4,3,3,10,0xb2d6effad
8142.42,1.0,0,2,2,4,8,0xb2d0d5c5d
27782.16,1.0,17,2,2,2,6,0xb2d5c7fd
10769.86,1.0,0,2,2,4,8,0xb2d8eb12d
7434.07,1.0,14,2,2,3,7,0xb2d8ca6dd
18017.12,1.0,14,2,2,3,7,0xb2d449cbd
71023.27,2.0,41,3,3,2,8,0xb2d271f4d
93.93,1.0,2,1,2,4,7,0xb2d6299c
300003.89,3.0,69,3,4,1,8,0xb2d111c4d
4334.72,1.0,92,2,2,1,5,0xb2d251e8d
379244.4,2.0,1,4,3,4,11,0xb2d11b47d
41928.42,1.0,10,2,2,3,7,0xb2d420c7
232.6,1.0,78,1,2,1,4,0xb2d110d0d
651833.63,3.0,27,4,4,2,10,0xb2d14620d
256004.94,3.0,3,3,4,4,11,0xb2d78153d
260355.02,2.0,14,3,3,3,9,0xb2d5c023
1.42,1.0,27,1,2,2,5,0xb2d8d16f
1.51,1.0,11,1,2,3,6,0xb2d2297d
8130.86,1.0,93,2,2,1,5,0xb2d52710d
20110.98,2.0,31,2,3,2,7,0xb2d580a9
400025.27,3.0,4,4,4,4,12,0xb2d8e982d
220.04,1.0,75,1,2,1,4,0xb2d695e0
433485.33,4.0,129,4,4,1,9,0xb2d3c962d
40001.27,2.0,263,2,3,1,6,0xb2d6be67
300078.03,2.0,97,3,3,1,7,0xb2d25ee0
50025.82,2.0,4,2,3,4,9,0xb2d4bdfcd
101319.77,1.0,0,3,2,4,9,0xb2d99ab8
4675.91,1.0,184,2,2,1,5,0xb2d40badd
43.5,1.0,60,1,2,2,5,0xb2d222fb
15109.32,2.0,4,2,3,4,9,0xb2d24715d
698454.34,4.0,74,4,4,1,9,0xb2d1ee2f
50000.97,2.0,4,2,3,4,9,0xb2d6aa1c
418.45,1.0,29,1,2,2,5,0xb2d930bf
1550000.8,2.0,1,4,3,4,11,0xb2d9f73e
200417.55,5.0,41,3,4,2,9,0xb2d62fbad
100015.88,2.0,83,3,3,1,7,0xb2d4b89c
343049.68,5.0,10,4,4,3,11,0xb2d3f20ed
64216.55,1.0,11,3,2,3,8,0xb2d39de1
52309.52,5.0,1,3,4,4,11,0xb2d06761d
17502.34,21.0,6,2,4,3,9,0x3b9ae3e4
0.0,1.0,8,1,2,3,6,0xb2d6575a
753085.47,5.0,0,4,4,4,12,0xb2d6357ad
213.57,1.0,9,1,2,3,6,0xb2d8b523
359177.72,2.0,60,4,3,2,9,0xb2d65c43d
200720.85,2.0,30,3,3,2,8,0xb2d9b812
5356.81,1.0,92,2,2,1,5,0xb2d2163d
6890.46,1.0,9,2,2,3,7,0xb2d26ae1
393.6,1.0,8,1,2,3,6,0xb2d4bcd4d
300001.11,2.0,0,3,3,4,10,0xb2d47dc7d
160270.8,2.0,101,3,3,1,7,0xb2d3f74dd
9228.84,1.0,0,2,2,4,8,0xb2d75444
150003.17,4.0,4,3,4,4,11,0xb2d6e0e8
283053.04,2.0,7,3,3,3,9,0xb2d1af49d
341997.67,3.0,34,4,4,2,10,0xb2d30b61d
2448.09,1.0,5,1,2,3,6,0xb2d2e80f
1002.46,1.0,92,1,2,1,4,0xb2d65571d
1.61,1.0,59,1,2,2,5,0xb2d512e1
20370.95,2.0,62,2,3,2,7,0xb2d5b821d
12449.17,1.0,92,2,2,1,5,0xb2d45723d
3010324.69,1.0,0,4,2,4,10,0xb2d640c7d
261850.82,2.0,57,3,3,2,8,0xb2d956f9
9362.52,1.0,184,2,2,1,5,0xb2d18161d
303860.26,6.0,45,4,4,2,10,0xb2d5d083d
50584.76,2.0,74,2,3,1,6,0xb2d67febd
4730.74,1.0,39,2,2,2,6,0xb2d2ce7cd
620180.38,16.0,1,4,4,4,12,0xb2d20615d
12666.88,1.0,12,2,2,3,7,0xb2d6bf91d
1343.29,1.0,6,1,2,3,6,0xb2d5e35f
3872.51,1.0,1,2,2,4,8,0xb2d43bfb
120009.63,4.0,14,3,4,3,10,0x3b9b1880
582142.22,6.0,36,4,4,2,10,0xb2d62513d
150000.0,1.0,0,3,2,4,9,0xb2d9aea6
317983.8,2.0,11,4,3,3,10,0xb2d2d90ed
1437767.65,2.0,14,4,3,3,10,0xb2d368d1d
4029.86,1.0,184,2,2,1,5,0xb2d3f334d
9.23,1.0,42,1,2,2,5,0xb2d94606
150336.46,3.0,172,3,4,1,8,0xb2d5579ad
884.12,1.0,5,1,2,3,6,0xb2d9038bd
620110.19,3.0,1,4,4,4,12,0xb2d50f4e
25013.86,1.0,0,2,2,4,8,0xb2d33a48
100094.51,2.0,228,3,3,1,7,0xb2d6180cd
9999.92,3.0,0,2,4,4,10,0xb2d067aed
333282.84,4.0,53,4,4,2,10,0xb2d07423
403198.93,3.0,98,4,4,1,9,0xb2d96fc4
260000.0,2.0,28,3,3,2,8,0xb2d940d9
20848.74,2.0,17,2,3,2,7,0xb2da2ff1
2868.2,1.0,137,1,2,1,4,0xb2d2db87d
515465.87,4.0,87,4,4,1,9,0xb2d365f6d
333335.54,3.0,119,4,4,1,9,0xb2d29618d
300224.93,2.0,132,4,3,1,8,0xb2d23ada
1160899.7,5.0,41,4,4,2,10,0xb2d43da6
44923.27,2.0,0,2,3,4,9,0xb2d0688e
500100.01,3.0,17,4,4,2,10,0xb2d959db
518034.81,3.0,47,4,4,2,10,0xb2d1b621d
305910.29,2.0,121,4,3,1,8,0xb2d64466d
14667.55,1.0,14,2,2,3,7,0xb2d2218d
26.06,1.0,11,1,2,3,6,0xb2d93e8e
300007.13,4.0,70,3,4,1,8,0xb2d185a8
429431.74,1.0,4,4,2,4,10,0xb2d5e1bad
31208.93,3.0,77,2,4,1,7,0xb2d891f9d
0.0,2.0,55,1,3,2,6,0xb2d5124c
1250094.38,4.0,18,4,4,2,10,0xb2d7ef60
800025.68,2.0,4,4,3,4,11,0xb2d85959
865004.88,8.0,11,4,4,3,11,0xb2d60ec5
24.95,1.0,32,1,2,2,5,0xb2d42372d
1981107.92,5.0,11,4,4,3,11,0xb2d2707dd
1314336.19,3.0,5,4,4,3,11,0xb2d2cbc1
20.08,1.0,53,1,2,2,5,0xb2d2aa97
150843.46,4.0,58,3,4,2,9,0xb2d61a25d
7025.16,1.0,92,2,2,1,5,0xb2d5b2c1d
62832.6,2.0,27,3,3,2,8,0xb2d395c6d
420412.3,1.0,102,4,2,1,7,0xb2d81062d
549783.72,11.0,0,4,4,4,12,0xb2d23960
105123.68,5.0,0,3,4,4,11,0xb2d0d258d
12.83,1.0,69,1,2,1,4,0xb2d2ad71
5001.75,1.0,6,2,2,3,7,0xb2d8f6ac
0.0,1.0,9,1,2,3,6,0xb2d5c011d
160190.91,3.0,4,3,4,4,11,0xb2d44d11d
446203.82,5.0,7,4,4,3,11,0xb2d0e9e2d
3265.23,1.0,184,2,2,1,5,0xb2d2c100d
56286.02,1.0,185,3,2,1,6,0xb2d10c1f
94762.63,2.0,7,3,3,3,9,0xb2d65c02
8377.34,1.0,63,2,2,2,6,0xb2d57dff
206689.67,2.0,13,3,3,3,9,0xb2d49657
1.3,1.0,13,1,2,3,6,0xb2d8d154
500000.0,2.0,26,4,3,2,9,0xb2da1489
40016.13,2.0,26,2,3,2,7,0xb2d7adf8
122618.31,4.0,8,3,4,3,10,0xb2d6a0b8d
393215.83,8.0,4,4,4,4,12,0xb2d10ace
207624.66,2.0,11,3,3,3,9,0xb2d56472
7404.4,1.0,4,2,2,4,8,0xb2d69f0b
1112.25,1.0,0,1,2,4,7,0xb2d2db2c
18090.92,1.0,0,2,2,4,8,0xb2d5e764d
102342.81,2.0,208,3,3,1,7,0xb2d57198d
3896.38,1.0,3,2,2,4,8,0xb2d06a84
22003.56,2.0,52,2,3,2,7,0xb2d187c5d
5012.51,1.0,22,2,2,2,6,0xb2d5915cd
446287.11,7.0,0,4,4,4,12,0x3b9b3e94
23.26,1.0,9,1,2,3,6,0xb2d2d9c7
100001.06,2.0,18,3,3,2,8,0xb2d957df
610.19,1.0,67,1,2,1,4,0xb2d595acd
236.48,1.0,2,1,2,4,7,0xb2d42a44
226610.9,34.0,17,3,4,2,9,0x3b9b0e16d
4788.75,1.0,2,2,2,4,8,0xb2d8d2dcd
200229.61,2.0,11,3,3,3,9,0xb2d5e504
1362.67,1.0,28,1,2,2,5,0xb2d56872
1270.13,1.0,5,1,2,3,6,0xb2d6a6a2
700886.16,4.0,6,4,4,3,11,0xb2d6eda0d
549094.56,3.0,3,4,4,4,12,0xb2d2d8ea
1077.24,1.0,3,1,2,4,7,0xb2d67eb3d
16481.62,1.0,1,2,2,4,8,0xb2d6b153
1758.85,1.0,0,1,2,4,7,0xb2d4a59ed
501784.38,2.0,29,4,3,2,9,0xb2d92629d
1055058.64,7.0,0,4,4,4,12,0xb2d65618d
1055.68,2.0,197,1,3,1,5,0xb2d415c1d
40283.17,1.0,19,2,2,2,6,0xb2d2227fd
1000329.12,2.0,0,4,3,4,11,0xb2da3597
1002263.12,2.0,70,4,3,1,8,0xb2d0b918
2242.11,1.0,180,1,2,1,4,0xb2d29231d
84534.16,1.0,10,3,2,3,8,0xb2d6447a
6608.6,1.0,105,2,2,1,5,0xb2d57f77d
7.04,1.0,75,1,2,1,4,0xb2d5f412d
72000.76,2.0,70,3,3,1,7,0xb2d9a73c
312202.53,2.0,30,4,3,2,9,0xb2d8eb71d
20094.68,1.0,5,2,2,3,7,0xb2d5516b
20255.19,1.0,70,2,2,1,5,0xb2d41007
448.64,1.0,6,1,2,3,6,0xb2d64f86
460114.69,5.0,18,4,4,2,10,0xb2d5cdf3d
59.37,2.0,6,1,3,3,7,0x3b9b1013d
3345895.66,23.0,14,4,4,3,11,0xb2d12047d
130009.56,3.0,129,3,4,1,8,0xb2d6427fd
40001.27,2.0,24,2,3,2,7,0xb2d944a1
195516.28,2.0,91,3,3,1,7,0xb2d561a8
10707.79,1.0,184,2,2,1,5,0xb2d29b8fd
457.02,1.0,10,1,2,3,6,0xb2d6c823d
200799.82,2.0,119,3,3,1,7,0xb2d0d0d0d
51241.84,5.0,0,2,4,4,10,0xb2d07863d
18905.67,1.0,18,2,2,2,6,0xb2d5d771
104932.37,2.0,96,3,3,1,7,0xb2d51e0b
1892.14,1.0,148,1,2,1,4,0xb2d11dae
4387.81,1.0,0,2,2,4,8,0xb2d3b032
7851.51,1.0,92,2,2,1,5,0xb2d19c21d
33646.78,1.0,3,2,2,4,8,0xb2d64582d
6111.94,1.0,192,2,2,1,5,0xb2d68068d
50015.26,1.0,29,2,2,2,6,0xb2d21039
898.35,1.0,0,1,2,4,7,0xb2d906afd
1051.3,1.0,125,1,2,1,4,0xb2d6cac8
14.8,1.0,25,1,2,2,5,0xb2d6a16d
50001.06,2.0,11,2,3,3,8,0xb2da3f81
355817.56,8.0,10,4,4,3,11,0xb2d6e619d
150044.32,3.0,0,3,4,4,11,0xb2d3e1f6d
361131.25,2.0,0,4,3,4,11,0xb2d65c4cd
155149.6,1.0,10,3,2,3,8,0xb2d6b417
229.72,1.0,13,1,2,3,6,0xb2d4e3f3
405569.7,4.0,87,4,4,1,9,0xb2d3844c
120318.3,3.0,11,3,4,3,10,0xb2d6ef11
10878.99,1.0,92,2,2,1,5,0xb2d08f6cd
550002.93,13.0,5,4,4,3,11,0x3b9ad799
93804.01,7.0,0,3,4,4,11,0xb2d548a1d
120024.69,8.0,3,3,4,4,11,0xb2d7900bd
70.88,1.0,41,1,2,2,5,0xb2d5a834
11.94,1.0,112,1,2,1,4,0xb2d8d05bd
131099.37,5.0,0,3,4,4,11,0xb2d61f79d
120011.16,9.0,0,3,4,4,11,0xb2d0c85e
181878.27,4.0,0,3,4,4,11,0xb2d49652d
513507.69,2.0,58,4,3,2,9,0xb2d1bb17d
7766.14,1.0,92,2,2,1,5,0xb2d38575d
10043.29,1.0,67,2,2,1,5,0xb2d7f22fd
26.39,1.0,33,1,2,2,5,0xb2d9f66c
533145.29,5.0,14,4,4,3,11,0xb2d5b556
143.6,1.0,11,1,2,3,6,0xb2d2ed38
48070.69,2.0,0,2,3,4,9,0xb2d06878d
581.01,1.0,13,1,2,3,6,0xb2d5b996d
11.72,1.0,67,1,2,1,4,0xb2d8d77dd
200345.51,2.0,21,3,3,2,8,0xb2d94001
589011.35,6.0,11,4,4,3,11,0xb2d85769d
221177.02,2.0,100,3,3,1,7,0xb2d350d2d
51887.28,1.0,3,2,2,4,8,0xb2d57e20d
543454.57,10.0,12,4,4,3,11,0x3b9b3ee7
493028.74,5.0,1,4,4,4,12,0xb2d9383d
45000666.59,2.0,73,4,3,1,8,0xb2d78bf0d
70006.22,3.0,0,3,4,4,11,0xb2d45d35d
4867.98,1.0,0,2,2,4,8,0xb2d4cb65d
50001.58,2.0,11,2,3,3,8,0xb2d58ee8
2445057.53,13.0,5,4,4,3,11,0xb2d422cb
1660529.94,7.0,0,4,4,4,12,0xb2d367e3d
6948.69,3.0,0,2,4,4,10,0xb2d06524d
10001.37,1.0,22,2,2,2,6,0xb2d918a1d
300009.5,2.0,10,3,3,3,9,0xb2d95e55
847010.01,5.0,0,4,4,4,12,0xb2d1c7e0
626.62,1.0,9,1,2,3,6,0xb2d52224d
0.43,1.0,75,1,2,1,4,0xb2d6eaffd
47345.38,2.0,224,2,3,1,6,0xb2d54e2cd
10936.61,1.0,0,2,2,4,8,0xb2d58bf7d
430000.84,3.0,7,4,4,3,11,0xb2d96729
163657.81,2.0,2,3,3,4,10,0xb2d34471d
151646.78,1.0,0,3,2,4,9,0xb2d420cf
436054.16,6.0,25,4,4,2,10,0xb2d33d6ad
6298.48,1.0,8,2,2,3,7,0xb2d9776c
244.63,1.0,67,1,2,1,4,0xb2d25bd2
383.93,2.0,283,1,3,1,5,0xb2d0db35d
0.0,1.0,0,1,2,4,7,0xb2d551ab
180030.06,3.0,208,3,4,1,8,0xb2d0873fd
60317.26,2.0,60,3,3,2,8,0xb2d57064d
250897.18,2.0,13,3,3,3,9,0xb2d97c60d
4588.86,2.0,4,2,3,4,9,0xb2d0cf19
203561.52,6.0,13,3,4,3,10,0xb2d8c68bd
134.31,1.0,286,1,2,1,4,0xb2d1df23d
106739.65,2.0,0,3,3,4,10,0xb2d3c08cd
23908.86,1.0,7,2,2,3,7,0xb2d2a2af
108.33,1.0,75,1,2,1,4,0xb2d4a5a9d
318870.15,6.0,18,4,4,2,10,0xb2d06477d
394475.03,18.0,0,4,4,4,12,0xb2d066abd
1093556.74,4.0,4,4,4,4,12,0xb2d92a5c
58370.98,3.0,184,3,4,1,8,0x3b9b2db8d
5521.73,1.0,237,2,2,1,5,0xb2d2437cd
507144.62,2.0,133,4,3,1,8,0xb2d91222d
1867.35,1.0,194,1,2,1,4,0xb2d2de9ed
9762.29,1.0,2,2,2,4,8,0xb2d2c74e
35.78,1.0,7,1,2,3,6,0xb2d36cf4d
655.94,1.0,11,1,2,3,6,0xb2d4f7cd
355453.65,5.0,131,4,4,1,9,0xb2d067d8
635081.2,5.0,0,4,4,4,12,0xb2d071ba
500063.62,4.0,8,4,4,3,11,0xb2d5a790d
40382.93,2.0,18,2,3,2,7,0xb2d68472
64168.8,2.0,231,3,3,1,7,0xb2d152f1d
241174.6,6.0,20,3,4,2,9,0xb2d6d876d
70.75,1.0,5,1,2,3,6,0xb2d21785d
8196.35,1.0,61,2,2,2,6,0xb2d6aa50d
72.43,1.0,0,1,2,4,7,0xb2d6bfabd
2203563.68,7.0,26,4,4,2,10,0xb2d9bd45
10000.45,2.0,35,2,3,2,7,0xb2d9f6be
135.79,1.0,1,1,2,4,7,0xb2d32fc1
82354.27,14.0,0,3,4,4,11,0xb2d067aad
39019.94,2.0,53,2,3,2,7,0xb2d24580
114690.95,2.0,136,3,3,1,7,0xb2d1d25ad
679211.74,9.0,25,4,4,2,10,0xb2d095ac
840933.49,28.0,0,4,4,4,12,0x3b9b0e2ed
301108.45,6.0,0,4,4,4,12,0xb2d33420
90018.17,2.0,3,3,3,4,10,0xb2d65196d
200042.08,2.0,2,3,3,4,10,0xb2d16987
50389.61,3.0,0,2,4,4,10,0xb2d210c9
23500.38,1.0,21,2,2,2,6,0xb2d964ca
274927.51,1.0,4,3,2,4,9,0xb2d1b9f8
9695.64,1.0,21,2,2,2,6,0xb2d607bfd
80002.53,2.0,25,3,3,2,8,0xb2da0e4e
50086.07,2.0,245,2,3,1,6,0xb2d287aad
12877.23,1.0,10,2,2,3,7,0xb2d53f0c
142463.07,2.0,6,3,3,3,9,0xb2d3136a
373199.62,5.0,1,4,4,4,12,0xb2d3b6ebd
148.85,1.0,57,1,2,2,5,0xb2d22ab1
8190098.0,4.0,18,4,4,2,10,0xb2d3cccfd
12244.8,3.0,2,2,4,4,10,0xb2d31411
325009.76,5.0,27,4,4,2,10,0xb2d10ebad
400000.0,3.0,15,4,4,3,11,0xb2da226a
100000.0,2.0,4,3,3,4,10,0xb2da5cc8
304.71,1.0,9,1,2,3,6,0xb2d8f635
300066.64,2.0,27,3,3,2,8,0xb2d104ffd
1414401.63,2.0,171,4,3,1,8,0xb2d2608d
13197.12,1.0,18,2,2,2,6,0xb2d3b3eed
1061038.34,2.0,0,4,3,4,11,0xb2d6214ed
88.49,1.0,4,1,2,4,7,0xb2d58c61
300000.0,2.0,201,3,3,1,7,0xb2d7a6ae
280110.42,4.0,16,3,4,2,9,0xb2d9fb5e
200000.0,2.0,7,3,3,3,9,0xb2da4910
3300898.84,7.0,8,4,4,3,11,0xb2d0948dd
425026.01,5.0,39,4,4,2,10,0xb2d576c7d
246.78,1.0,53,1,2,2,5,0xb2d3009d
1184.88,1.0,10,1,2,3,6,0xb2d315ced
100.0,1.0,4,1,2,4,7,0xb2d616ce
7586.43,1.0,0,2,2,4,8,0xb2da070d
100062.59,2.0,11,3,3,3,9,0xb2d64adb
61.49,1.0,8,1,2,3,6,0xb2d56330
7756.92,1.0,3,2,2,4,8,0xb2d40483d
9974.45,1.0,0,2,2,4,8,0xb2d31ab0
100411.04,2.0,36,3,3,2,8,0xb2d778c5
429696.12,3.0,4,4,4,4,12,0xb2d98d34
5.61,1.0,1,1,2,4,7,0xb2d90fe7d
30780.19,2.0,80,2,3,1,6,0xb2d6106dd
920000.0,9.0,0,4,4,4,12,0xb2d623fcd
5190.56,1.0,1,2,2,4,8,0xb2d41df1d
10064.32,2.0,123,2,3,1,6,0xb2d5e6a0d
48590.35,1.0,13,2,2,3,7,0xb2d56ddb
547.7,1.0,10,1,2,3,6,0xb2da17a8
295810.78,7.0,12,3,4,3,10,0xb2d1aaebd
286050.83,8.0,9,3,4,3,10,0xb2d16c8f
392114.03,3.0,0,4,4,4,12,0xb2d445db
693000.0,7.0,7,4,4,3,11,0xb2d24fcfd
500029.27,2.0,164,4,3,1,8,0xb2d3adc2d
750.86,1.0,8,1,2,3,6,0xb2d49621d
670900.81,6.0,4,4,4,4,12,0xb2d0c12dd
371789.99,1.0,34,4,2,2,8,0xb2d0d790d
16.91,1.0,46,1,2,2,5,0xb2d30d16d
230219.06,8.0,14,3,4,3,10,0xb2d4aacb
60000.0,2.0,7,3,3,3,9,0xb2da4e6f
194.6,3.0,31,1,4,2,7,0xb2d20dfbd
344011.66,6.0,69,4,4,1,9,0xb2d37910d
208128.15,2.0,87,3,3,1,7,0xb2d2bf84d
410000.01,6.0,1,4,4,4,12,0xb2d6dd12
33888.29,1.0,156,2,2,1,5,0xb2d587a8
1355.08,1.0,184,1,2,1,4,0xb2d379cc
200017.91,2.0,139,3,3,1,7,0xb2d61159d
60750.16,18.0,5,3,4,3,10,0xb2d45df2d
451006.07,3.0,4,4,4,4,12,0xb2d2e2a3d
1.9,1.0,89,1,2,1,4,0xb2d20b56d
16.37,1.0,28,1,2,2,5,0xb2d34eb2d
2061.23,1.0,4,1,2,4,7,0xb2d36ae4d
81014.52,2.0,31,3,3,2,8,0xb2d6b291d
757915.17,38.0,0,4,4,4,12,0xb2d4a6fd
50051.64,2.0,81,2,3,1,6,0xb2d96cf1d
523019.93,6.0,74,4,4,1,9,0xb2d26f63d
1534.79,1.0,0,1,2,4,7,0xb2d8f5af
5375.2,1.0,29,2,2,2,6,0xb2d928ea
55363.15,2.0,256,3,3,1,7,0xb2d247e7d
100004.22,2.0,49,3,3,2,8,0xb2d9cfc6
255019.16,9.0,0,3,4,4,11,0xb2d40ef2
80001.8,3.0,3,3,4,4,11,0xb2d934a5d
24648.35,9.0,2,2,4,4,10,0xb2d36fb1d
1007670.37,3.0,186,4,4,1,9,0xb2d1bf14d
526.2,1.0,9,1,2,3,6,0xb2d561ce
200025.5,3.0,5,3,4,3,10,0xb2d50292d
10.65,1.0,19,1,2,2,5,0xb2da1c9f
11205.69,1.0,8,2,2,3,7,0xb2d42225
71.33,1.0,0,1,2,4,7,0xb2d42e15
30165.39,1.0,10,2,2,3,7,0xb2d6ca57
504769.6,4.0,4,4,4,4,12,0xb2d1ccb7d
470033.79,4.0,21,4,4,2,10,0xb2d63aded
213416.35,2.0,94,3,3,1,7,0xb2d2ab9e
13586.92,1.0,0,2,2,4,8,0xb2d19824
5191267.54,16.0,0,4,4,4,12,0xb2d06f4b
1961.53,1.0,213,1,2,1,4,0xb2d57477d
80004.22,2.0,26,3,3,2,8,0xb2d93f9a
29.62,1.0,92,1,2,1,4,0xb2d33ed0d
201352.0,2.0,1,3,3,4,10,0xb2d0e390
15605.34,1.0,15,2,2,3,7,0xb2d8d30d
2436.52,1.0,92,1,2,1,4,0xb2d1d724d
6038942.22,9.0,1,4,4,4,12,0xb2d3a479d
782.29,1.0,55,1,2,2,5,0xb2d249e8d
18114.39,1.0,18,2,2,2,6,0xb2d995ca
1975.11,1.0,1,1,2,4,7,0xb2d1ea4d
291422.59,4.0,21,3,4,2,9,0xb2d9b617
1518.47,1.0,9,1,2,3,6,0xb2d43db8
420684.44,8.0,18,4,4,2,10,0xb2d16e5d
7635.87,1.0,21,2,2,2,6,0xb2d41ed8
299125.1,4.0,4,3,4,4,11,0xb2d62e0ad
1554.36,2.0,9,1,3,3,7,0x3b9b2c63
480000.0,4.0,0,4,4,4,12,0xb2d0d997d
2500145.76,2.0,127,4,3,1,8,0xb2d55237d
462992.12,2.0,60,4,3,2,9,0xb2d65dbbd
600611.15,3.0,20,4,4,2,10,0xb2d6384bd
2717.43,1.0,10,1,2,3,6,0xb2d3fe55
142.36,1.0,9,1,2,3,6,0xb2d2ebbad
500007.42,3.0,6,4,4,3,11,0xb2d94653
534.39,1.0,3,1,2,4,7,0xb2d17d8a
200000.0,2.0,19,3,3,2,8,0xb2da2a0f
1421027.78,2.0,0,4,3,4,11,0xb2d2409a
0.08,1.0,3,1,2,4,7,0xb2d07d39
98.53,1.0,10,1,2,3,6,0xb2d40947d
400073.81,3.0,14,4,4,3,11,0xb2d6c3ded
202145.65,2.0,116,3,3,1,7,0xb2d6b8f5
144935.73,1.0,9,3,2,3,8,0xb2d6f49ad
1260000.0,3.0,3,4,4,4,12,0xb2d973c4
9.36,6.0,39,1,4,2,7,0xb2d43e2fd
2593.01,1.0,3,1,2,4,7,0xb2d8d0e6d
568000.39,6.0,0,4,4,4,12,0xb2d0b439d
601091.84,4.0,35,4,4,2,10,0xb2d681f5d
19635.97,1.0,0,2,2,4,8,0xb2d5485dd
1265546.25,3.0,10,4,4,3,11,0xb2d0bc4b
6817.94,1.0,4,2,2,4,8,0xb2d83502
267010.46,14.0,1,3,4,4,11,0xb2d5f9c8d
2763.38,1.0,184,1,2,1,4,0xb2d395bbd
508047.19,3.0,2,4,4,4,12,0xb2d2276d
100029.66,3.0,4,3,4,4,11,0xb2d17c53
15.61,1.0,14,1,2,3,6,0xb2d17636d
275394.25,1.0,9,3,2,3,8,0xb2d2df57
1.27,1.0,30,1,2,2,5,0xb2d47ae8
210.51,1.0,28,1,2,2,5,0xb2d4095dd
2164.21,1.0,92,1,2,1,4,0xb2d38d76d
877619.3,7.0,0,4,4,4,12,0xb2d11fccd
34033.98,1.0,0,2,2,4,8,0xb2d4f893
235912.4,2.0,24,3,3,2,8,0xb2d198b7
50000.53,2.0,8,2,3,3,8,0xb2da4a96
662596.51,1.0,123,4,2,1,7,0xb2d772f5
5906.86,1.0,10,2,2,3,7,0xb2d98e54
1009.6,1.0,272,1,2,1,4,0xb2d5ce45
100003.17,2.0,80,3,3,1,7,0xb2d98945
7295.39,1.0,2,2,2,4,8,0xb2d1e832
1098.9,1.0,21,1,2,2,5,0xb2d129bd
11529.22,1.0,0,2,2,4,8,0xb2d62a1cd
2101.7,1.0,0,1,2,4,7,0xb2d50407d
30000.32,2.0,80,2,3,1,6,0xb2d8d75ed
100002.11,2.0,74,3,3,1,7,0xb2d99931
65.87,1.0,64,1,2,2,5,0xb2d966c1
1931.42,1.0,92,1,2,1,4,0xb2d34d7ad
4608.83,1.0,35,2,2,2,6,0xb2d932b7
16288.41,1.0,4,2,2,4,8,0xb2d39589
1449.06,1.0,35,1,2,2,5,0xb2d3e0cbd
413.89,1.0,10,1,2,3,6,0xb2d9604e
20000.43,3.0,80,2,4,1,7,0xb2d9221d
7047.32,1.0,0,2,2,4,8,0xb2d34c27d
482787.33,8.0,1,4,4,4,12,0xb2d0a675
50012.98,2.0,54,2,3,2,7,0xb2d579a5d
503014.97,5.0,53,4,4,2,10,0xb2d28750d
4050.0,1.0,60,2,2,2,6,0xb2d46e83
323660.42,2.0,43,4,3,2,9,0xb2d441c7d
3503.71,1.0,2,2,2,4,8,0xb2d388acd
30079.18,2.0,83,2,3,1,6,0xb2d2a5fbd
113.47,3.0,84,1,4,1,6,0xb2d8f0e1d
104310.89,5.0,21,3,4,2,9,0xb2d0ea8e
350011.08,2.0,4,4,3,4,11,0xb2d924f0
521842.55,4.0,4,4,4,4,12,0xb2d5db9c
1045.39,1.0,184,1,2,1,4,0xb2d1b1acd
140012.02,2.0,13,3,3,3,9,0xb2d3fb69
201421.2,2.0,19,3,3,2,8,0xb2d8db2c
190006.37,3.0,10,3,4,3,10,0xb2d56a1c
50003.43,2.0,129,2,3,1,6,0xb2d1b500d
127030.9,1.0,1,3,2,4,9,0xb2d91870
13566.09,1.0,1,2,2,4,8,0xb2d92552
101606.84,1.0,24,3,2,2,7,0xb2d1a812d
584.78,1.0,3,1,2,4,7,0xb2d69adfd
560108.0,2.0,129,4,3,1,8,0xb2d574c0
111970.15,4.0,175,3,4,1,8,0xb2d67ff2d
73.94,2.0,3,1,3,4,8,0xb2d60a3d
700092.59,2.0,2,4,3,4,11,0xb2d78d9ad
20060.22,1.0,92,2,2,1,5,0xb2d601e3d
200000.02,2.0,7,3,3,3,9,0xb2d92edad
0.02,1.0,0,1,2,4,7,0xb2d97ad5
700237.62,3.0,32,4,4,2,10,0xb2d61352d
82.29,2.0,28,1,3,2,6,0x3b9b355f
20006.89,2.0,228,2,3,1,6,0xb2d5481d
684005.93,5.0,1,4,4,4,12,0xb2d69430d
947.76,1.0,4,1,2,4,7,0xb2d1cf37d
511486.94,2.0,12,4,3,3,10,0xb2d1a6c9d
310472.58,2.0,23,4,3,2,9,0xb2d5bfffd
2026.12,1.0,28,1,2,2,5,0xb2d2f85cd
47.14,1.0,4,1,2,4,7,0xb2d6f4a7
10145.81,1.0,184,2,2,1,5,0xb2d5d977
4128.63,1.0,34,2,2,2,6,0xb2d37e18
10189.56,2.0,35,2,3,2,7,0xb2d5b9c3d
601520.26,2.0,0,4,3,4,11,0xb2d173ce
6743.63,2.0,244,2,3,1,6,0xb2d17e3bd
58255.88,2.0,231,3,3,1,7,0xb2d06c71d
150009.57,2.0,105,3,3,1,7,0xb2d236f1d
360006.32,3.0,10,4,4,3,11,0xb2d92855
12903.61,1.0,0,2,2,4,8,0xb2d43a83d
39532.71,1.0,6,2,2,3,7,0xb2d2de2b
500009.6,3.0,4,4,4,4,12,0xb2d1354dd
504281.28,3.0,112,4,4,1,9,0xb2d6f60dd
190010.16,4.0,6,3,4,3,10,0xb2d3c463d
0.0,1.0,10,1,2,3,6,0xb2d54addd
880000.0,3.0,8,4,4,3,11,0xb2d83b79d
35204.0,4.0,0,2,4,4,10,0xb2d42966d
101014.07,3.0,6,3,4,3,10,0xb2d5d082
380.72,1.0,48,1,2,2,5,0xb2d0fdf0
964.2,1.0,9,1,2,3,6,0xb2d2c833d
613622.53,4.0,57,4,4,2,10,0xb2d17d18
576734.03,7.0,11,4,4,3,11,0xb2d26a71d
1300053.44,4.0,82,4,4,1,9,0xb2d1db6cd
685000.58,6.0,0,4,4,4,12,0xb2d65443d
5200.03,1.0,0,2,2,4,8,0xb2d6bc93d
200000.0,2.0,19,3,3,2,8,0xb2d94860d
8452.79,1.0,184,2,2,1,5,0xb2d13eb8d
200066.62,2.0,129,3,3,1,7,0xb2d35d47
370003.7,3.0,12,4,4,3,11,0xb2d95b12d
1140394.72,5.0,76,4,4,1,9,0xb2d52e06d
42254.56,1.0,40,2,2,2,6,0xb2d11f78
150049.71,2.0,74,3,3,1,7,0xb2d41c3e
1107955.32,6.0,0,4,4,4,12,0xb2d41687d
501648.75,5.0,35,4,4,2,10,0xb2d40a97d
157702.71,7.0,0,3,4,4,11,0xb2d08ad9d
1785317.39,3.0,32,4,4,2,10,0xb2d10f24
412370.77,5.0,3,4,4,4,12,0xb2d10afcd
452755.06,3.0,5,4,4,3,11,0xb2da2038
318816.77,1.0,9,4,2,3,9,0xb2d5766cd
641446.39,1.0,6,4,2,3,9,0xb2d441ddd
23493.61,1.0,18,2,2,2,6,0xb2d6bfeb
33320.7,2.0,4,2,3,4,9,0xb2d555a1d
240000.33,2.0,1,3,3,4,10,0xb2d5fadad
0.94,1.0,1,1,2,4,7,0xb2d3108bd
2780.38,2.0,92,1,3,1,5,0xb2d0a43dd
130067.66,1.0,11,3,2,3,8,0xb2d91992d
15525.2,2.0,92,2,3,1,6,0xb2d39023d
16.49,1.0,9,1,2,3,6,0xb2d3d1b9d
10000.32,2.0,185,2,3,1,6,0xb2d6aab1d
50001.07,2.0,31,2,3,2,7,0xb2d684aa
491461.58,5.0,2,4,4,4,12,0xb2d5709b
1540088.8,4.0,38,4,4,2,10,0xb2d1c11bd
452011.67,6.0,4,4,4,4,12,0xb2da25cb
32521.61,1.0,2,2,2,4,8,0xb2d31cacd
15267.65,1.0,130,2,2,1,5,0xb2d6c1cd
10478.27,1.0,12,2,2,3,7,0xb2d15d34
440790.86,3.0,62,4,4,2,10,0xb2d2dfac
1513.32,1.0,184,1,2,1,4,0xb2d24d24d
786.53,1.0,13,1,2,3,6,0xb2d517cc
2064.12,1.0,148,1,2,1,4,0xb2d1fcd3
4007.26,1.0,184,2,2,1,5,0xb2d3bbb4d
357981.51,8.0,0,4,4,4,12,0xb2d2134dd
13.03,1.0,25,1,2,2,5,0xb2d55b15
69.84,1.0,82,1,2,1,4,0xb2d1fb92
11420.85,1.0,15,2,2,3,7,0xb2d99a7e
1400000.0,2.0,26,4,3,2,9,0xb2da1443
1275.5,1.0,1,1,2,4,7,0xb2d2fda6
250002.64,2.0,95,3,3,1,7,0xb2d97b73
204886.93,4.0,1,3,4,4,11,0x3b9b1860d
131033.98,2.0,217,3,3,1,7,0xb2d69e88
30000.74,3.0,42,2,4,2,8,0xb2d9a549
200001.68,2.0,25,3,3,2,8,0xb2d907ddd
1039.78,1.0,184,1,2,1,4,0xb2d273c0d
261.2,1.0,0,1,2,4,7,0xb2d68ee0d
354119.05,3.0,28,4,4,2,10,0xb2d88fe8d
315723.55,4.0,101,4,4,1,9,0xb2d1832f
108285.2,3.0,0,3,4,4,11,0xb2d8ec1bd
3545.86,3.0,13,2,4,3,9,0xb2d0c509
912.4,1.0,10,1,2,3,6,0xb2d412f4
609588.76,9.0,9,4,4,3,11,0xb2d25c00d
99736.3,1.0,10,3,2,3,8,0xb2d689aed
2100044.33,4.0,6,4,4,3,11,0xb2da4749
20001.71,2.0,25,2,3,2,7,0xb2d6624d
19.38,2.0,89,1,3,1,5,0xb2d63228
1132.6,1.0,10,1,2,3,6,0xb2d9d93c
7924.74,1.0,19,2,2,2,6,0xb2d68e57d
160076.93,5.0,1,3,4,4,11,0xb2d41ab3
50002.96,2.0,10,2,3,3,8,0xb2d90b8ed
2007.91,1.0,92,1,2,1,4,0xb2d33da6d
758549.49,11.0,27,4,4,2,10,0xb2d45874
19962179.33,4.0,62,4,4,2,10,0xb2d1932fd
1158.5,1.0,24,1,2,2,5,0xb2d6e759
795.1,1.0,9,1,2,3,6,0xb2d8d38fd
300030.09,3.0,11,3,4,3,10,0xb2d6eb2d
1000032.91,2.0,31,4,3,2,9,0xb2d359b4
260.93,1.0,111,1,2,1,4,0xb2d19b0b
68000.15,2.0,27,3,3,2,8,0xb2d58613d
1246.18,1.0,92,1,2,1,4,0xb2d260e4d
305.25,1.0,25,1,2,2,5,0xb2d8df6fd
349.28,1.0,30,1,2,2,5,0xb2d81d4b
222175.87,3.0,8,3,4,3,10,0xb2d6db2ad
851001.06,4.0,4,4,4,4,12,0xb2d9eebf
1443.59,1.0,9,1,2,3,6,0xb2d5a793d
6.98,1.0,112,1,2,1,4,0xb2d9489ad
2131.59,1.0,81,1,2,1,4,0xb2d3b9cad
89.1,1.0,6,1,2,3,6,0xb2d68a4a
251088.15,2.0,18,3,3,2,8,0xb2d64768d
30946.13,1.0,1,2,2,4,8,0xb2d2838ed
30000.0,2.0,6,2,3,3,8,0xb2d96e7bd
500000.08,2.0,15,4,3,3,10,0xb2d98734
922.76,1.0,0,1,2,4,7,0xb2d2c6ead
240001.22,1.0,1,3,2,4,9,0xb2d85b24
104000.0,4.0,2,3,4,4,11,0xb2d39c96d
31070.15,1.0,14,2,2,3,7,0xb2d53cdb
243.13,1.0,133,1,2,1,4,0xb2d42630d
80022.46,4.0,80,3,4,1,8,0xb2d58cdfd
22.85,1.0,9,1,2,3,6,0xb2d6f315
40109.08,1.0,14,2,2,3,7,0xb2d866d4
20358.3,2.0,92,2,3,1,6,0xb2d56ce6d
5944328.87,14.0,16,4,4,2,10,0xb2d4ec1fd
310038.74,1.0,1,4,2,4,10,0xb2d3ba8d
24397.7,1.0,14,2,2,3,7,0xb2d3a5b0d
0.0,1.0,7,1,2,3,6,0xb2d698eed
8414.12,1.0,49,2,2,2,6,0xb2d37c1b
330851.56,4.0,18,4,4,2,10,0xb2d39f98d
73317.76,3.0,0,3,4,4,11,0xb2d27e30d
324103.36,9.0,0,4,4,4,12,0xb2d06529d
2808.27,1.0,1,1,2,4,7,0xb2d41193
600000.0,1.0,0,4,2,4,10,0xb2d93585
50001.58,2.0,52,2,3,2,7,0xb2d78d8ed
600234.43,5.0,70,4,4,1,9,0xb2d25107d
2.53,1.0,0,1,2,4,7,0xb2d9c426
5.38,1.0,27,1,2,2,5,0xb2d1e041
305.03,1.0,10,1,2,3,6,0xb2d25f51d
515448.74,4.0,97,4,4,1,9,0xb2d106c4d
9575.98,2.0,66,2,3,2,7,0xb2d66b57
758001.64,15.0,26,4,4,2,10,0xb2d2e8ff
9924.84,1.0,92,2,2,1,5,0x3b9aebeed
200063.68,2.0,27,3,3,2,8,0xb2d5345e
16716.04,2.0,67,2,3,1,6,0xb2d12894
328.2,1.0,13,1,2,3,6,0xb2d8a9b3
20000.21,2.0,87,2,3,1,6,0xb2d8cc2fd
14.06,1.0,56,1,2,2,5,0xb2d6cd5fd
139368.87,2.0,18,3,3,2,8,0xb2d1fb33d
27925.35,1.0,184,2,2,1,5,0xb2d340e6d
19168.38,1.0,20,2,2,2,6,0xb2d080fb
164012.96,2.0,193,3,3,1,7,0xb2d1bba3d
200710.85,2.0,31,3,3,2,8,0xb2d8fa4bd
200011.79,2.0,1,3,3,4,10,0xb2d5faa3
1092543.7,3.0,4,4,4,4,12,0xb2d58ff9
33596.14,3.0,127,2,4,1,7,0x3b9b248b
160104.29,4.0,24,3,4,2,9,0xb2d439a6d
1012.34,1.0,184,1,2,1,4,0xb2d1234f
1009.55,1.0,92,1,2,1,4,0xb2d235bb
955038.3,4.0,24,4,4,2,10,0xb2d154e6d
201612.66,2.0,4,3,3,4,10,0xb2d6a867d
714.35,1.0,63,1,2,2,5,0xb2d2d216
42060.45,3.0,24,2,4,2,8,0xb2d6c996
1201.63,1.0,184,1,2,1,4,0xb2d1db58
7281.81,1.0,2,2,2,4,8,0xb2d6b53c
3994.15,1.0,10,2,2,3,7,0xb2d22f6dd
601692.24,3.0,2,4,4,4,12,0xb2d1207bd
1008.55,1.0,184,1,2,1,4,0xb2d44af2
19.21,1.0,69,1,2,1,4,0xb2d4a9b7
225575.21,10.0,0,3,4,4,11,0xb2d0a03fd
70112.39,1.0,1,3,2,4,9,0xb2d5b386
1042019.35,7.0,11,4,4,3,11,0xb2d5debfd
30007.93,1.0,92,2,2,1,5,0xb2d25c88d
39668.6,1.0,5,2,2,3,7,0xb2d6bb07d
2020.36,1.0,184,1,2,1,4,0xb2d3943cd
50014.57,2.0,45,2,3,2,7,0xb2d54dfcd
1053.07,1.0,43,1,2,2,5,0xb2d9dc2d
12419.47,1.0,206,2,2,1,5,0xb2d3ab30d
49994.16,1.0,6,2,2,3,7,0xb2d23e7dd
1087044.0,7.0,13,4,4,3,11,0xb2d16508d
16.05,1.0,50,1,2,2,5,0xb2d9c29f
1218.39,1.0,184,1,2,1,4,0xb2d30efad
919720.73,10.0,20,4,4,2,10,0xb2d59c80
1000000.0,2.0,17,4,3,2,9,0xb2d9e0ec
20147.7,1.0,92,2,2,1,5,0xb2d37113d
187005.3,3.0,35,3,4,2,9,0xb2d5686bd
280000.0,2.0,2,3,3,4,10,0xb2d97f67d
380000.92,9.0,0,4,4,4,12,0xb2d10f43
2.11,1.0,67,1,2,1,4,0xb2d9a7f5
320181.6,3.0,213,4,4,1,9,0xb2d250af
570003.42,9.0,0,4,4,4,12,0xb2d2d14ed
7.38,1.0,40,1,2,2,5,0xb2d6c395
95041.88,2.0,111,3,3,1,7,0xb2d1b3f6
54485.29,1.0,75,3,2,1,6,0xb2d3e9bc
100005.28,2.0,32,3,3,2,8,0xb2d651d0d
601739.94,4.0,18,4,4,2,10,0xb2d20632d
0.63,1.0,75,1,2,1,4,0xb2d996f1
351143.36,2.0,12,4,3,3,10,0xb2d6c6e5
14145.55,1.0,2,2,2,4,8,0xb2d78310d
20473.34,1.0,0,2,2,4,8,0xb2d97307
4.23,1.0,12,1,2,3,6,0xb2d9540c
517913.1,2.0,122,4,3,1,8,0xb2d16622d
9029.46,1.0,184,2,2,1,5,0xb2d0653dd
930014.36,11.0,0,4,4,4,12,0xb2d8c375
12864.35,1.0,184,2,2,1,5,0xb2d1e545d
250006.65,3.0,74,3,4,1,8,0xb2d96ae6
15164.22,1.0,184,2,2,1,5,0xb2d29089d
8.69,1.0,21,1,2,2,5,0xb2d68c70d
5104.27,1.0,0,2,2,4,8,0xb2d683a9
400100.08,1.0,5,4,2,3,9,0xb2d8d1e5d
1330001.95,4.0,1,4,4,4,12,0xb2d2478bd
20788.84,1.0,4,2,2,4,8,0xb2d65083d
626517.92,3.0,46,4,4,2,10,0xb2d6bb39
38.78,1.0,52,1,2,2,5,0xb2d6c457
563.74,1.0,0,1,2,4,7,0xb2d6baeb
420007.29,3.0,6,4,4,3,11,0xb2d782e9d
20284.6,2.0,164,2,3,1,6,0xb2d53dc5
196.14,1.0,20,1,2,2,5,0xb2d2fd91
9206.17,1.0,0,2,2,4,8,0xb2d5a7ecd
1167.65,1.0,7,1,2,3,6,0xb2d24e1ad
21948.27,1.0,0,2,2,4,8,0xb2d347a8d
6924.67,1.0,6,2,2,3,7,0xb2d2e257
810007.96,6.0,0,4,4,4,12,0xb2d3e530
1122.17,1.0,2,1,2,4,7,0xb2d602e5d
102087.32,3.0,21,3,4,2,9,0xb2d59606
15.93,1.0,48,1,2,2,5,0xb2d4fac2
203554.2,2.0,34,3,3,2,8,0xb2d6dc0d
98.17,1.0,13,1,2,3,6,0xb2d97bea
260711.84,4.0,9,3,4,3,10,0xb2d901c1
180118.23,2.0,108,3,3,1,7,0xb2d5e95dd
50033.23,2.0,0,2,3,4,9,0xb2da0630
240063.59,5.0,0,3,4,4,11,0xb2d5b334d
20091.66,3.0,0,2,4,4,10,0xb2d212b5d
115032.43,2.0,21,3,3,2,8,0xb2d52f19
50001.59,2.0,15,2,3,3,8,0xb2d9cc32
160005.07,4.0,55,3,4,2,9,0xb2d7acf6d
1003563.52,2.0,38,4,3,2,9,0xb2d6faedd
40001.48,4.0,0,2,4,4,10,0xb2d957fad
250000.02,2.0,14,3,3,3,9,0xb2d9201c
2524.57,1.0,20,1,2,2,5,0xb2d1e1be
25088.09,1.0,166,2,2,1,5,0xb2d6a162d
200000.0,2.0,3,3,3,4,10,0xb2da479e
115.8,1.0,71,1,2,1,4,0xb2d2db6e
610749.99,6.0,11,4,4,3,11,0xb2d8cf1d
422219.98,2.0,10,4,3,3,10,0xb2d209b1d
107493.4,2.0,214,3,3,1,7,0xb2d3a9fdd
333027.15,2.0,32,4,3,2,9,0xb2d250f0d
674970.84,6.0,4,4,4,4,12,0xb2d5f9cad
685032.18,5.0,0,4,4,4,12,0xb2d1dff9d
200731.58,2.0,23,3,3,2,8,0xb2d8c386d
65438.77,3.0,73,3,4,1,8,0xb2d27a15d
10206.86,1.0,151,2,2,1,5,0xb2d59e48
15804.16,1.0,93,2,2,1,5,0xb2d5cf03d
1.57,1.0,82,1,2,1,4,0xb2d8d386
53.43,1.0,4,1,2,4,7,0xb2d6be0b
50078.62,2.0,137,2,3,1,6,0xb2d54664d
777026.56,13.0,27,4,4,2,10,0xb2d9248ed
15811.85,1.0,21,2,2,2,6,0xb2d303ded
314.25,1.0,88,1,2,1,4,0xb2d789b8
751048.09,4.0,18,4,4,2,10,0xb2d21440
408073.87,3.0,66,4,4,2,10,0xb2d175c7d
604546.12,2.0,0,4,3,4,11,0xb2d69fdad
822758.01,5.0,97,4,4,1,9,0xb2d6d792d
283072.84,4.0,1,3,4,4,11,0xb2d204cd
129.7,2.0,67,1,3,1,5,0x3b9b2a15
5100087.74,7.0,18,4,4,2,10,0xb2d0bf73d
50000.0,1.0,0,2,2,4,8,0xb2da40e0
8052.94,1.0,14,2,2,3,7,0xb2d97cbc
200465.97,2.0,3,3,3,4,10,0xb2d4a257
2079.56,1.0,9,1,2,3,6,0xb2d8d1f9d
300023.23,2.0,90,3,3,1,7,0xb2d7fc9dd
415358.6,3.0,41,4,4,2,10,0xb2d9b582
602978.81,6.0,0,4,4,4,12,0xb2d1c024d
256689.34,3.0,83,3,4,1,8,0xb2d2ffde
88520.05,1.0,20,3,2,2,7,0xb2d5aca2d
160081.91,2.0,77,3,3,1,7,0xb2d61f8bd
10001.81,3.0,21,2,4,2,8,0xb2d3bf85
202888.98,5.0,55,3,4,2,9,0xb2d09f71d
2851.09,1.0,27,1,2,2,5,0xb2d46dcfd
10038.7,1.0,92,2,2,1,5,0xb2d57734
20273.84,2.0,69,2,3,1,6,0xb2d5f3ccd
6249.39,1.0,15,2,2,3,7,0xb2d9b407
41473.82,1.0,19,2,2,2,6,0xb2d5918ed
1011386.46,4.0,21,4,4,2,10,0xb2d5cec8d
1053.73,1.0,92,1,2,1,4,0xb2d151ddd
9438.41,1.0,184,2,2,1,5,0xb2d3b13ed
10121.98,2.0,139,2,3,1,6,0xb2d6d4aad
34530.02,1.0,9,2,2,3,7,0xb2d6b2a8d
105106.63,4.0,0,3,4,4,11,0xb2d3cf0fd
65.72,2.0,3,1,3,4,8,0xb2d8e74c
924140.16,4.0,8,4,4,3,11,0xb2d31104d
2.49,1.0,4,1,2,4,7,0xb2d11289
1678.35,1.0,92,1,2,1,4,0xb2d3a49fd
808668.2,7.0,17,4,4,2,10,0xb2d201df
3726.68,1.0,11,2,2,3,7,0xb2d39555
430062.16,7.0,32,4,4,2,10,0xb2d243f2d
5868.2,2.0,92,2,3,1,6,0xb2d0a699d
3140.03,1.0,184,2,2,1,5,0xb2d58a65d
76706.85,1.0,1,3,2,4,9,0xb2d43427
1852.98,1.0,10,1,2,3,6,0xb2d5227bd
2277.33,1.0,215,1,2,1,4,0xb2d42f63d
24873.91,1.0,0,2,2,4,8,0xb2d8c4cfd
510752.57,2.0,91,4,3,1,8,0xb2d901e8d
603695.64,7.0,4,4,4,4,12,0xb2d253b4d
100001.06,2.0,63,3,3,2,8,0xb2d9b7eb
1388007.19,14.0,2,4,4,4,12,0xb2d53d2b
100056.67,2.0,197,3,3,1,7,0xb2d469e7d
655063.68,4.0,1,4,4,4,12,0xb2d78bddd
94.79,1.0,16,1,2,2,5,0xb2d2a008
847.32,1.0,1,1,2,4,7,0xb2d2a86e
50093.43,2.0,192,2,3,1,6,0xb2d108fbd
1000052.09,2.0,23,4,3,2,9,0xb2d9d454
269495.35,3.0,189,3,4,1,8,0xb2d1083dd
85.96,1.0,65,1,2,2,5,0xb2d1eed8
600001.0,2.0,14,4,3,3,10,0xb2d908e0d
17.65,1.0,2,1,2,4,7,0xb2d39920
13908.25,1.0,184,2,2,1,5,0xb2d08eab
10110.76,1.0,184,2,2,1,5,0xb2d286e3
5081.56,1.0,184,2,2,1,5,0xb2d42822
172709.02,4.0,102,3,4,1,8,0xb2d4f91f
1.75,1.0,20,1,2,2,5,0xb2d6969f
300058.22,2.0,73,3,3,1,7,0xb2d06929
500018.94,24.0,26,4,4,2,10,0xb2d6268fd
177.71,1.0,0,1,2,4,7,0xb2d93abb
642805.85,8.0,6,4,4,3,11,0xb2d56437d
1000000.0,1.0,0,4,2,4,10,0xb2d8c46e
40.69,1.0,41,1,2,2,5,0xb2d13c0c
714.95,1.0,0,1,2,4,7,0xb2d8ca79
171205.88,1.0,4,3,2,4,9,0xb2d10f01
50025.24,2.0,41,2,3,2,7,0xb2d6e385d
147746.26,3.0,6,3,4,3,10,0xb2d072f9d
270031.37,4.0,2,3,4,4,11,0xb2d76358
1000043.7,5.0,0,4,4,4,12,0xb2d6294dd
7165.67,1.0,92,2,2,1,5,0xb2d2b1fdd
3276.82,1.0,92,2,2,1,5,0x3b9ad26ed
3.59,1.0,1,1,2,4,7,0xb2d784fcd
7278.1,1.0,97,2,2,1,5,0xb2d5ca2dd
2030330.0,8.0,0,4,4,4,12,0xb2d65857
16609.33,1.0,0,2,2,4,8,0xb2d59a23d
350075.54,2.0,1,4,3,4,11,0xb2d2920cd
19068.51,1.0,0,2,2,4,8,0xb2d6c168d
16091.22,1.0,4,2,2,4,8,0xb2d31336d
11860.7,1.0,22,2,2,2,6,0xb2d69201
29817.61,1.0,0,2,2,4,8,0xb2d56ce4
7465.34,1.0,0,2,2,4,8,0xb2d91edc
1280.77,1.0,92,1,2,1,4,0xb2d13313d
1386.55,1.0,12,1,2,3,6,0xb2d3893a
37714.78,1.0,1,2,2,4,8,0xb2d21c91
34.63,1.0,61,1,2,2,5,0xb2d2d9bb
2105.6,1.0,0,1,2,4,7,0xb2d396f8d
4.71,2.0,68,1,3,1,5,0xb2d10dbf
2177831.04,4.0,11,4,4,3,11,0xb2d24c9ad
77.86,1.0,38,1,2,2,5,0xb2d4c9e0
1226350.74,25.0,0,4,4,4,12,0x3b9b1833d
2392.33,1.0,5,1,2,3,6,0xb2d6b678
15008.0,2.0,4,2,3,4,9,0xb2d6249fd
2585551.83,8.0,0,4,4,4,12,0xb2d0e108d
800007.18,8.0,20,4,4,2,10,0x3b9b25dad
678169.87,3.0,5,4,4,3,11,0xb2d304e2d
2124.67,1.0,184,1,2,1,4,0xb2d24ec7d
1615.21,1.0,92,1,2,1,4,0xb2d1ace0
828162.85,7.0,0,4,4,4,12,0xb2d06943
330224.1,4.0,0,4,4,4,12,0xb2d0be43d
250007.92,2.0,52,3,3,2,8,0xb2d90909d
16804.57,1.0,21,2,2,2,6,0xb2da06bd
70059.6,2.0,0,3,3,4,10,0xb2da6257
540596.8,3.0,11,4,4,3,11,0xb2d926ead
305189.43,1.0,1,4,2,4,10,0xb2d71aca
493485.3,3.0,1,4,4,4,12,0xb2d36e1ad
87006.28,4.0,41,3,4,2,9,0xb2d655b6d
132403.61,3.0,53,3,4,2,9,0xb2d6935ad
200000.0,2.0,3,3,3,4,10,0xb2d97bbbd
610819.0,2.0,70,4,3,1,8,0xb2d1bec9d
5563.41,1.0,0,2,2,4,8,0xb2d6e868
400000.0,2.0,25,4,3,2,9,0xb2da1590
388776.47,16.0,0,4,4,4,12,0x3b9ae60d
25007427.84,7.0,125,4,4,1,9,0xb2d19a08d
3018.92,1.0,3,2,2,4,8,0xb2d2a987
686069.51,3.0,12,4,4,3,11,0xb2d1b613
228.94,1.0,13,1,2,3,6,0xb2d6b547
52476.05,1.0,22,3,2,2,7,0xb2d5b18b
6915.16,1.0,7,2,2,3,7,0xb2d43a30
350027.14,1.0,1,4,2,4,10,0xb2d30ff5d
0.0,1.0,5,1,2,3,6,0xb2d989e6
150947.24,4.0,1,3,4,4,11,0x3b9b3be3d
680000.0,5.0,4,4,4,4,12,0xb2d5e487
500005.06,2.0,20,4,3,2,9,0xb2d9d590
510005.77,3.0,90,4,4,1,9,0xb2d635c3
145154.48,3.0,92,3,4,1,8,0xb2d5b7ea
820284.39,4.0,55,4,4,2,10,0xb2d2c199
13.36,1.0,22,1,2,2,5,0xb2d996ca
50001.06,2.0,108,2,3,1,6,0xb2d6bbecd
1008.63,1.0,180,1,2,1,4,0xb2d5ce45d
401475.64,2.0,14,4,3,3,10,0xb2d6f6f4d
167.6,1.0,9,1,2,3,6,0xb2d35380d
21326.69,2.0,0,2,3,4,9,0xb2d54c85d
1032968.39,5.0,3,4,4,4,12,0xb2d12033
7589.04,1.0,5,2,2,3,7,0xb2d372f1d
50000.79,2.0,0,2,3,4,9,0xb2d62878
2015.35,1.0,184,1,2,1,4,0xb2d3d6cc
11511.9,2.0,4,2,3,4,9,0xb2d6ed02d
1103.92,1.0,92,1,2,1,4,0xb2d5af06d
500001.04,2.0,25,4,3,2,9,0xb2d90590d
201838.36,3.0,0,3,4,4,11,0xb2d40149d
304529.93,3.0,27,4,4,2,10,0xb2d1b044d
28738.47,1.0,1,2,2,4,8,0xb2d6e0ff
2563000.15,15.0,0,4,4,4,12,0xb2d611d2
188300.02,1.0,154,3,2,1,6,0xb2d42741
17334.57,1.0,0,2,2,4,8,0xb2d63854
1400509.29,2.0,92,4,3,1,8,0xb2d5b86ad
2020.22,1.0,92,1,2,1,4,0xb2d22eb0d
26183.45,1.0,5,2,2,3,7,0xb2d31d99
2830426.09,5.0,0,4,4,4,12,0xb2d42073d
4808.59,1.0,1,2,2,4,8,0xb2d4ed6ed
2001.0,1.0,1,1,2,4,7,0xb2d7048d
1190104.36,9.0,25,4,4,2,10,0xb2d2155fd
856103.77,3.0,175,4,4,1,9,0xb2d15bbfd
258001.97,2.0,34,3,3,2,8,0xb2d62f0ed
130001.37,2.0,34,3,3,2,8,0xb2d931e0
395720.7,3.0,28,4,4,2,10,0xb2d417e2
8579.95,1.0,61,2,2,2,6,0xb2d5bb14
81778.49,3.0,63,3,4,2,9,0xb2d4637dd
1309989.56,10.0,10,4,4,3,11,0xb2d1fe6bd
250021.18,3.0,27,3,4,2,9,0xb2d6d75ad
312009.71,24.0,41,4,4,2,10,0xb2d1bb10d
28825.86,1.0,13,2,2,3,7,0xb2d12375d
43.18,1.0,28,1,2,2,5,0xb2d938dd
1304826.13,4.0,39,4,4,2,10,0xb2d65655
100093.75,2.0,0,3,3,4,10,0xb2d38cb5d
130187.13,2.0,133,3,3,1,7,0xb2d92026d
681292.39,4.0,1,4,4,4,12,0xb2d45ab7
1000057.92,3.0,122,4,4,1,9,0xb2d21ed9d
262384.08,5.0,0,3,4,4,11,0xb2d2a038d
2636.21,1.0,9,1,2,3,6,0xb2d8dc0bd
500052.94,3.0,11,4,4,3,11,0xb2d8d9abd
103663.51,1.0,0,3,2,4,9,0xb2d60b9bd
500006.64,3.0,5,4,4,3,11,0xb2d5945c
227843.15,6.0,80,3,4,1,8,0xb2d072cfd
1171555.01,16.0,0,4,4,4,12,0x3b9ad21fd
1832.0,1.0,92,1,2,1,4,0xb2d2fe10d
9076.89,1.0,22,2,2,2,6,0xb2d36805d
115085.49,1.0,221,3,2,1,6,0xb2d24624d
1901530.5,16.0,3,4,4,4,12,0x3b9b0fa2
50028.13,2.0,18,2,3,2,7,0xb2d68bb4
348.73,1.0,4,1,2,4,7,0xb2d6ecf4d
10384.58,1.0,184,2,2,1,5,0xb2d2c78e
7168.74,1.0,14,2,2,3,7,0xb2d3b792
1000038.35,2.0,145,4,3,1,8,0xb2d43c09d
220000.0,2.0,12,3,3,3,9,0xb2d96424
4025.4,1.0,2,2,2,4,8,0xb2d998cc
7250.71,1.0,92,2,2,1,5,0xb2d2aeffd
100.59,1.0,24,1,2,2,5,0xb2d5b443d
606396.58,2.0,112,4,3,1,8,0xb2d78b51
60020.97,2.0,136,3,3,1,7,0xb2d5d0dbd
158833.86,2.0,25,3,3,2,8,0xb2d35b8ed
223305.29,6.0,3,3,4,4,11,0x3b9b4074
1150.93,1.0,184,1,2,1,4,0xb2d17c77
71014.2,2.0,13,3,3,3,9,0xb2d59552d
195.27,1.0,76,1,2,1,4,0xb2d31cee
13459.46,1.0,184,2,2,1,5,0xb2d16f78d
1007.64,1.0,0,1,2,4,7,0xb2d3d577
2493970.97,10.0,12,4,4,3,11,0xb2d5f4f5d
353731.32,2.0,83,4,3,1,8,0xb2d955c4
4905780.43,10.0,1,4,4,4,12,0xb2d5c290
3774.67,1.0,105,2,2,1,5,0xb2d20597d
372412.97,3.0,0,4,4,4,12,0xb2d33eefd
500010.56,2.0,25,4,3,2,9,0xb2da117f
9247.29,1.0,92,2,2,1,5,0xb2d1a0ead
34000.36,2.0,45,2,3,2,7,0xb2d91d25d
1.53,1.0,2,1,2,4,7,0xb2d354ee
24.91,1.0,7,1,2,3,6,0xb2d685b0d
928.78,1.0,4,1,2,4,7,0xb2d0d6a8d
450045.92,2.0,202,4,3,1,8,0xb2d505f6d
531505.92,4.0,27,4,4,2,10,0xb2d12213d
150.44,1.0,15,1,2,3,6,0xb2d35775
2547.79,1.0,8,1,2,3,6,0xb2d4114bd
0.0,1.0,3,1,2,4,7,0xb2d95ff2
1000010.0,2.0,4,4,3,4,11,0xb2d97a16d
460202.86,3.0,8,4,4,3,11,0xb2d60baad
126009.08,6.0,1,3,4,4,11,0xb2d1e71fd
305194.84,1.0,0,4,2,4,10,0xb2d91260d
6.04,1.0,17,1,2,2,5,0xb2d6c9d2d
435228.45,2.0,216,4,3,1,8,0xb2d4a5b8d
10141.73,1.0,92,2,2,1,5,0xb2d3cd1bd
7094.79,1.0,92,2,2,1,5,0xb2d0c46fd
501776.5,2.0,22,4,3,2,9,0xb2d6b347
10672.81,1.0,34,2,2,2,6,0xb2d600d7d
4446.29,1.0,79,2,2,1,5,0xb2d1f22a
105.02,1.0,9,1,2,3,6,0xb2d63936
1182590.38,14.0,24,4,4,2,10,0xb2d12d23d
517013.38,7.0,14,4,4,3,11,0xb2d31793d
280048.0,2.0,6,3,3,3,9,0xb2d9706e
2812649.19,4.0,31,4,4,2,10,0xb2d5ed83
130.97,1.0,5,1,2,3,6,0xb2d57067
158.99,1.0,9,1,2,3,6,0xb2d360a0d
216838.48,1.0,1,3,2,4,9,0xb2d42c5f
331349.15,1.0,0,4,2,4,10,0xb2d10377
228240.74,1.0,90,3,2,1,6,0xb2d406fc
225.28,1.0,6,1,2,3,6,0xb2d59a00
700617.91,4.0,10,4,4,3,11,0xb2d5abb8d
72.66,1.0,41,1,2,2,5,0xb2d5f679d
30.32,1.0,11,1,2,3,6,0xb2d18f18d
1401850.87,4.0,0,4,4,4,12,0xb2d2a711d
11189.74,2.0,0,2,3,4,9,0xb2d2fbcd
180088.44,5.0,1,3,4,4,11,0xb2d54ec3d
31335.05,1.0,3,2,2,4,8,0xb2d3955f
3593.28,1.0,19,2,2,2,6,0xb2d8eb75
100003.06,2.0,46,3,3,2,8,0xb2d9dacf
20002706.97,1.0,0,4,2,4,10,0xb2d40cf2d
515804.05,8.0,7,4,4,3,11,0xb2d22faad
712346.87,15.0,4,4,4,4,12,0xb2d51e52
1561.14,2.0,69,1,3,1,5,0xb2d071a5d
1816.06,1.0,9,1,2,3,6,0xb2d427a1
11814.51,1.0,7,2,2,3,7,0xb2d22cea
1014.91,1.0,92,1,2,1,4,0xb2d12850
138.94,2.0,9,1,3,3,7,0xb2d4ded4
6857.32,1.0,19,2,2,2,6,0xb2d22af7
8290038.58,3.0,247,4,4,1,9,0xb2d1e271d
6005.27,1.0,5,2,2,3,7,0xb2d6593a
600017.02,2.0,93,4,3,1,8,0xb2d7ef70d
200000.0,2.0,12,3,3,3,9,0xb2d964bdd
11259.45,1.0,0,2,2,4,8,0xb2d2fe06
869.05,1.0,28,1,2,2,5,0xb2d5cd06d
255258.08,2.0,53,3,3,2,8,0xb2d20b4dd
11123.38,1.0,13,2,2,3,7,0xb2d6ad5ad
1.12,1.0,35,1,2,2,5,0xb2d8e59b
63.72,1.0,25,1,2,2,5,0xb2d2b6d3
2178.86,1.0,0,1,2,4,7,0xb2d1c734
275.19,1.0,5,1,2,3,6,0xb2d1bb00
60821.23,1.0,92,3,2,1,6,0xb2d27e77d
600000.0,3.0,3,4,4,4,12,0xb2d59c52d
10393.8,2.0,184,2,3,1,6,0xb2d2a708
575096.93,4.0,18,4,4,2,10,0xb2d65bf1
1064.43,1.0,92,1,2,1,4,0xb2d32e9dd
1519167.65,3.0,108,4,4,1,9,0xb2d24c89d
99211.59,5.0,9,3,4,3,10,0x3b9b254ad
0.0,1.0,11,1,2,3,6,0xb2d430a3
3337.09,1.0,21,2,2,2,6,0xb2d37c0a
300031.28,2.0,7,3,3,3,9,0xb2d8ecc3d
357286.33,4.0,0,4,4,4,12,0xb2d1408ad
17.56,1.0,61,1,2,2,5,0xb2d47ec6d
50001.05,5.0,10,2,4,3,9,0xb2d9569cd
3804.41,3.0,92,2,4,1,7,0x3b9aefb0d
8617.53,1.0,10,2,2,3,7,0xb2d6f564d
1081.79,1.0,10,1,2,3,6,0xb2d27c66
1460.88,14.0,0,1,4,4,9,0x3b9b18e9
101.78,2.0,36,1,3,2,6,0xb2d13ac5
216000.0,1.0,0,3,2,4,9,0xb2d981c6d
56139.66,1.0,208,3,2,1,6,0xb2d3a686d
5663987.08,1.0,0,4,2,4,10,0xb2d170b9d
525.14,1.0,9,1,2,3,6,0xb2d3ec00d
101258.23,2.0,17,3,3,2,8,0xb2d2318dd
339.96,2.0,26,1,3,2,6,0xb2d4edb9
1060061.68,6.0,18,4,4,2,10,0xb2d8ef78d
1032.5,4.0,184,1,4,1,6,0xb2d254b9d
200843.85,2.0,28,3,3,2,8,0xb2d6860a
435068.78,17.0,6,4,4,3,11,0xb2d67cc4
250005.3,2.0,214,3,3,1,7,0xb2d76ab3d
10.4,1.0,8,1,2,3,6,0xb2d4199cd
60061.46,2.0,67,3,3,1,7,0xb2d4e96a
300009.5,3.0,27,3,4,2,9,0xb2d93f14d
20501.88,1.0,3,2,2,4,8,0xb2d3e694d
605554.43,3.0,77,4,4,1,9,0xb2d2e790
309469.45,4.0,20,4,4,2,10,0xb2d185a8d
3461033.47,6.0,8,4,4,3,11,0xb2d132b5d
5448.88,1.0,92,2,2,1,5,0xb2d36cad
5665.72,1.0,2,2,2,4,8,0xb2d7917dd
3260000.0,10.0,4,4,4,4,12,0xb2d59661d
20402.88,1.0,5,2,2,3,7,0xb2d22f04
81.77,1.0,9,1,2,3,6,0xb2d574df
500000.0,3.0,5,4,4,3,11,0xb2d92400
2.65,1.0,15,1,2,3,6,0xb2d8d4ee
21593.84,2.0,1,2,3,4,9,0xb2d0dd89d
100020.78,2.0,214,3,3,1,7,0xb2d61392d
160903.7,2.0,45,3,3,2,8,0xb2d913ded
1080000.0,35.0,0,4,4,4,12,0xb2d1ae57
50562.93,2.0,10,2,3,3,8,0xb2d2f6e0d
8146.8,1.0,3,2,2,4,8,0xb2d8023ed
300065.63,2.0,11,3,3,3,9,0xb2d9203b
44147.9,1.0,20,2,2,2,6,0xb2d6962f
0.92,1.0,0,1,2,4,7,0xb2d40e8d
396252.7,3.0,53,4,4,2,10,0xb2d200e2
20904.47,1.0,36,2,2,2,6,0xb2d43da9
536.68,1.0,0,1,2,4,7,0xb2d37355d
839699.93,9.0,0,4,4,4,12,0xb2d69a32d
540025.75,4.0,74,4,4,1,9,0xb2d6324d
100004.23,3.0,18,3,4,2,9,0xb2d9155fd
70015.88,1.0,0,3,2,4,9,0xb2d7f32cd
533706.74,3.0,0,4,4,4,12,0xb2d07f88
4542.0,1.0,187,2,2,1,5,0xb2d6e47f
150376.6,3.0,8,3,4,3,10,0xb2d62b95d
9.5,1.0,60,1,2,2,5,0xb2d93ef9
2068.15,1.0,6,1,2,3,6,0xb2d56568
28.97,2.0,18,1,3,2,6,0x3b9b48c9d
7590.82,1.0,29,2,2,2,6,0xb2d92cae
3822.17,1.0,1,2,2,4,8,0xb2d6c1b2d
85952.09,3.0,52,3,4,2,9,0xb2d2248bd
219832.07,3.0,32,3,4,2,9,0xb2d10589d
71442.78,3.0,1,3,4,4,11,0xb2d904a0
250007.2,5.0,95,3,4,1,8,0xb2d80506d
3934.94,1.0,8,2,2,3,7,0xb2d5657dd
9908.18,1.0,0,2,2,4,8,0xb2d6b608d
105130.35,2.0,105,3,3,1,7,0xb2d22dc2d
300847.69,4.0,6,4,4,3,11,0xb2d16cdb
10037.56,2.0,48,2,3,2,7,0xb2d53f64d
0.37,1.0,73,1,2,1,4,0xb2d29585d
746.39,1.0,7,1,2,3,6,0xb2d786b3
230034.98,2.0,1,3,3,4,10,0xb2d985b2
67.24,1.0,27,1,2,2,5,0xb2d9efb8
428696.3,11.0,0,4,4,4,12,0x3b9b0e3dd
1354.5,1.0,14,1,2,3,6,0xb2d2f894d
263.76,1.0,76,1,2,1,4,0xb2d63a97d
440000.0,19.0,0,4,4,4,12,0xb2d55128d
27.87,2.0,6,1,3,3,7,0xb2d45985
4680.6,1.0,11,2,2,3,7,0xb2d1a854d
910.68,1.0,14,1,2,3,6,0xb2d496b9d
230.68,1.0,0,1,2,4,7,0xb2d91970
283957.34,2.0,104,3,3,1,7,0xb2d61b50d
5819.45,1.0,122,2,2,1,5,0xb2d5e7ccd
15666.83,4.0,20,2,4,2,8,0xb2d27c63d
1224.07,1.0,9,1,2,3,6,0xb2d77f41
6413.92,1.0,1,2,2,4,8,0xb2d3e605
200000.0,2.0,3,3,3,4,10,0xb2d976d4d
1058311.87,1.0,185,4,2,1,7,0xb2d496b1d
5308.75,1.0,184,2,2,1,5,0xb2d3a2cad
270003.8,7.0,18,3,4,2,9,0xb2d9b132
38379.4,1.0,10,2,2,3,7,0xb2d8de29
305316.38,4.0,28,4,4,2,10,0xb2d107e0d
150082.21,3.0,4,3,4,4,11,0xb2d2f15b
300185.87,3.0,17,4,4,2,10,0xb2d57965d
562.13,1.0,9,1,2,3,6,0xb2d5a593d
4001.69,1.0,0,2,2,4,8,0xb2d6fd24d
2080.9,1.0,36,1,2,2,5,0xb2d3eca2
8149.37,2.0,184,2,3,1,6,0xb2d5c238d
1914.83,1.0,92,1,2,1,4,0xb2d2c465
1026080.5,4.0,0,4,4,4,12,0xb2d61b2ad
50012.92,2.0,94,2,3,1,6,0xb2d24544
17444.62,1.0,6,2,2,3,7,0xb2d7086dd
708008.62,3.0,73,4,4,1,9,0xb2d6af50d
42004.52,3.0,15,2,4,3,9,0xb2d7003a
780005.21,4.0,10,4,4,3,11,0xb2d1e607d
183.49,1.0,0,1,2,4,7,0xb2d210bcd
150008.66,4.0,18,3,4,2,9,0xb2d921a8d
51652.63,2.0,92,2,3,1,6,0xb2d4ec55d
1157.09,1.0,9,1,2,3,6,0xb2d680af
205499.35,1.0,286,3,2,1,6,0xb2d2fedbd
100001.06,2.0,209,3,3,1,7,0xb2d77837
33.11,1.0,1,1,2,4,7,0xb2d27d21d
1000018.28,6.0,11,4,4,3,11,0xb2d07d9e
63776.49,3.0,1,3,4,4,11,0xb2d4ff7a
16536.88,2.0,107,2,3,1,6,0xb2d083e0
8827.36,1.0,0,2,2,4,8,0xb2d39de7d
300016.96,2.0,199,3,3,1,7,0xb2d0e470d
239580.75,2.0,5,3,3,3,9,0xb2d0bbabd
360000.0,6.0,4,4,4,4,12,0xb2d5a506d
7923.69,1.0,0,2,2,4,8,0xb2d68c43
200000.0,2.0,6,3,3,3,9,0xb2d38c17
50010.86,2.0,49,2,3,2,7,0xb2d6e57c
55609.76,2.0,13,3,3,3,9,0xb2d408d7
10116.76,2.0,14,2,3,3,8,0xb2d9d0c8
216000.0,2.0,8,3,3,3,9,0xb2d19234
260054.62,4.0,3,3,4,4,11,0xb2d410e8
1757018.63,10.0,0,4,4,4,12,0xb2d13bd9d
143023.13,9.0,12,3,4,3,10,0xb2d13d27d
74820.69,1.0,24,3,2,2,7,0xb2d6230ed
3786.34,1.0,0,2,2,4,8,0xb2d6c175d
6773.48,1.0,14,2,2,3,7,0xb2d9b953
100003.17,2.0,25,3,3,2,8,0xb2da0d85
1000421.86,4.0,7,4,4,3,11,0xb2d92441d
50001.58,2.0,27,2,3,2,7,0xb2d94004
20000.21,2.0,42,2,3,2,7,0xb2d9e7c7
124.71,1.0,3,1,2,4,7,0xb2d68dca
515302.43,2.0,54,4,3,2,9,0xb2d6128cd
109286.55,3.0,184,3,4,1,8,0xb2d09065d
4002.62,1.0,72,2,2,1,5,0xb2d655cf
200090.74,2.0,203,3,3,1,7,0xb2d4f22f
50220.68,3.0,23,2,4,2,8,0xb2d25eb2d
30000.32,3.0,6,2,4,3,9,0xb2d95c22
270000.0,2.0,1,3,3,4,10,0xb2d98096d
4501.49,1.0,10,2,2,3,7,0xb2d9dae8
94.6,1.0,74,1,2,1,4,0xb2d57706d
51286.13,1.0,8,2,2,3,7,0xb2d6f277d
1000025.58,2.0,66,4,3,2,9,0xb2d243d3d
77436.03,1.0,13,3,2,3,8,0xb2d69370d
320722.2,3.0,18,4,4,2,10,0xb2d8fa79d
4569.0,1.0,7,2,2,3,7,0xb2d67dead
27667.25,3.0,0,2,4,4,10,0xb2d4d93ed
91323.89,4.0,10,3,4,3,10,0xb2d567dcd
51157.11,2.0,7,2,3,3,8,0xb2d65c66d
20198.28,1.0,92,2,2,1,5,0xb2d20c4bd
1005061.85,11.0,0,4,4,4,12,0xb2d50ad6
500000.12,2.0,6,4,3,3,10,0xb2d97629
30150.08,1.0,19,2,2,2,6,0xb2d4c0a6d
12592.38,1.0,0,2,2,4,8,0xb2d6c47ad
264887.1,4.0,13,3,4,3,10,0xb2d69d88d
309104.24,3.0,30,4,4,2,10,0xb2d33eda
405788.3,2.0,123,4,3,1,8,0xb2d558a9d
256078.37,4.0,55,3,4,2,9,0xb2d18d1cd
300010.56,3.0,41,3,4,2,9,0xb2d4cf3a
500000.04,2.0,13,4,3,3,10,0xb2d9e8fc
405042.67,4.0,6,4,4,3,11,0xb2d5c0edd
5522.77,1.0,184,2,2,1,5,0xb2d17637d
341038.07,9.0,25,4,4,2,10,0xb2d5d571d
460218.7,3.0,32,4,4,2,10,0xb2d6e5aad
450047.91,2.0,206,4,3,1,8,0xb2d647c3d
248.7,1.0,7,1,2,3,6,0xb2d3cad6d
711458.79,3.0,4,4,4,4,12,0xb2d1c169d
51628.75,2.0,11,2,3,3,8,0xb2d69ce4d
3049.2,1.0,12,2,2,3,7,0xb2d1f4c6d
890627.32,9.0,18,4,4,2,10,0xb2d3c235
350009.38,4.0,83,4,4,1,9,0xb2d43492d
1111776.27,3.0,0,4,4,4,12,0xb2d3c53f
501828.49,3.0,42,4,4,2,10,0xb2d95e2ad
294268.25,3.0,199,3,4,1,8,0xb2d697ded
1301537.86,10.0,9,4,4,3,11,0xb2d2cbb7
4206.37,1.0,0,2,2,4,8,0xb2d2ac12d
70272.17,3.0,73,3,4,1,8,0xb2d68887d
5061.58,1.0,18,2,2,2,6,0xb2d5ae52
1131.19,1.0,184,1,2,1,4,0xb2d24655
22487.07,1.0,0,2,2,4,8,0xb2d2f279d
437051.61,3.0,172,4,4,1,9,0xb2d20a2dd
2519.12,1.0,207,1,2,1,4,0xb2d34825d
3734.4,1.0,3,2,2,4,8,0xb2d0b62ed
13060.09,1.0,3,2,2,4,8,0xb2d29e06
2818.6,1.0,15,1,2,3,6,0xb2d267eb
30582.17,1.0,11,2,2,3,7,0xb2d9134dd
6387.16,1.0,5,2,2,3,7,0xb2d2da8f
200000.0,3.0,6,3,4,3,10,0xb2d9742a
125007.6,6.0,10,3,4,3,10,0xb2d1e95bd
1008.88,1.0,184,1,2,1,4,0xb2d3465bd
5369.28,1.0,0,2,2,4,8,0xb2d0fc02
4.26,1.0,8,1,2,3,6,0xb2d621f7d
373095.64,4.0,6,4,4,3,11,0xb2d15262
427164.22,3.0,143,4,4,1,9,0xb2d3a575
800249.16,2.0,21,4,3,2,9,0xb2d1faf0d
843012.6,7.0,0,4,4,4,12,0xb2d11c46
500072.19,3.0,3,4,4,4,12,0xb2d27d30
151.23,1.0,5,1,2,3,6,0xb2d5ad85
700029.59,2.0,139,4,3,1,8,0xb2d6eb7b
0.0,1.0,3,1,2,4,7,0xb2d5acc8
17356.18,1.0,0,2,2,4,8,0xb2d21264
1200007.6,10.0,25,4,4,2,10,0xb2d34b29d
829298.18,3.0,154,4,4,1,9,0xb2d43631d
50008.12,2.0,66,2,3,2,7,0xb2d6104e
2936.16,1.0,4,2,2,4,8,0xb2d365c1d
500413.48,2.0,0,4,3,4,11,0xb2d78664
12359.71,1.0,11,2,2,3,7,0xb2d5d3c1d
500060.8,3.0,0,4,4,4,12,0xb2d98f93
132.36,1.0,12,1,2,3,6,0xb2d9c32d
131.91,1.0,9,1,2,3,6,0xb2d4fafad
340051.28,5.0,200,4,4,1,9,0xb2d1ae88d
83.36,2.0,6,1,3,3,7,0xb2d09f53
355000.43,11.0,0,4,4,4,12,0xb2d3c64f
1.34,1.0,0,1,2,4,7,0xb2d5c9aa
941.23,1.0,10,1,2,3,6,0xb2d6ad62d
110000.0,2.0,1,3,3,4,10,0xb2d46eb7d
50001.13,2.0,27,2,3,2,7,0xb2d68442
720.92,1.0,75,1,2,1,4,0xb2d62affd
12962.13,2.0,6,2,3,3,8,0x3b9ae50d
342004.64,5.0,4,4,4,4,12,0xb2d1739fd
153278.26,2.0,5,3,3,3,9,0xb2d502c6
404385.09,9.0,1,4,4,4,12,0xb2d50d27d
100009.47,4.0,3,3,4,4,11,0xb2d359b8
240757.21,3.0,13,3,4,3,10,0xb2d7fc33d
57073.74,2.0,26,3,3,2,8,0xb2d24283d
273.38,1.0,15,1,2,3,6,0x3b9b328c
2.14,2.0,67,1,3,1,5,0xb2d318b2d
100014.89,2.0,204,3,3,1,7,0xb2d4f873d
371024.13,5.0,21,4,4,2,10,0xb2d07c85
77.86,1.0,0,1,2,4,7,0xb2d0bde7
400005.49,4.0,12,4,4,3,11,0xb2d92130d
530417.49,5.0,62,4,4,2,10,0xb2d41284d
1.62,1.0,29,1,2,2,5,0xb2d34c10
329254.55,1.0,14,4,2,3,9,0xb2d2cef3
545.13,1.0,2,1,2,4,7,0xb2d996da
1063.28,1.0,92,1,2,1,4,0xb2d59a44
194545.54,4.0,1,3,4,4,11,0xb2d5f6f8
673121.65,4.0,100,4,4,1,9,0xb2d65d3f
106735.98,2.0,14,3,3,3,9,0xb2d319c9d
103599.67,1.0,4,3,2,4,9,0xb2d630eed
350059.4,2.0,180,4,3,1,8,0xb2d16cd3
12011.7,2.0,27,2,3,2,7,0xb2d333a3d
4637.57,1.0,184,2,2,1,5,0xb2d20ef8d
532723.5,3.0,1,4,4,4,12,0xb2d58e49
170088.19,5.0,12,3,4,3,10,0xb2d2b854
5184.34,1.0,1,2,2,4,8,0xb2d24093d
1050000.39,6.0,1,4,4,4,12,0xb2d65889d
100000.98,2.0,1,3,3,4,10,0xb2d39d33
1263.23,1.0,184,1,2,1,4,0xb2d5ae38
8867.95,1.0,9,2,2,3,7,0xb2d4dcd5d
250000.0,2.0,5,3,3,3,9,0xb2da5a75
7090.8,1.0,176,2,2,1,5,0xb2d2d597
862139.62,1.0,11,4,2,3,9,0xb2d23489d
292542.51,4.0,80,3,4,1,8,0xb2d4d6e6d
255017.99,2.0,12,3,3,3,9,0xb2d957c5d
50053.86,2.0,197,2,3,1,6,0xb2d5726dd
1220843.59,9.0,0,4,4,4,12,0x3b9b124ad
1361452.32,9.0,9,4,4,3,11,0xb2d08609d
1002.43,1.0,92,1,2,1,4,0xb2d6586cd
22523.49,1.0,0,2,2,4,8,0xb2d3aaec
821757.48,2.0,35,4,3,2,9,0xb2d65168d
1499000.0,45.0,0,4,4,4,12,0xb2d1f99c
583511.02,4.0,0,4,4,4,12,0xb2d3ae06d
214821.11,3.0,4,3,4,4,11,0xb2d631ec
591171.44,7.0,116,4,4,1,9,0xb2d25ff2d
2028.69,1.0,184,1,2,1,4,0xb2d255e2d
22472.34,1.0,184,2,2,1,5,0xb2d215d0
284.45,1.0,74,1,2,1,4,0xb2d21651d
1195.79,1.0,23,1,2,2,5,0xb2d8c8a7d
3765.26,1.0,9,2,2,3,7,0xb2d753a7
4000000.0,5.0,0,4,4,4,12,0xb2d97a15d
464006.14,6.0,3,4,4,4,12,0xb2d56ff9
33831.21,1.0,19,2,2,2,6,0xb2d69b7c
110001.16,2.0,80,3,3,1,7,0xb2d98c6c
2968.18,1.0,19,2,2,2,6,0xb2d70871
55590.33,1.0,1,3,2,4,9,0xb2d5cef5d
42.41,1.0,20,1,2,2,5,0xb2d22e1f
380.13,1.0,10,1,2,3,6,0xb2d6ef29d
504000.0,8.0,4,4,4,4,12,0xb2d6a977
321444.84,8.0,0,4,4,4,12,0xb2d616dc
9.51,1.0,13,1,2,3,6,0xb2d26e68
53554.74,2.0,136,3,3,1,7,0xb2d38b22d
54522.61,2.0,110,3,3,1,7,0xb2d26a20
1929.66,1.0,0,1,2,4,7,0xb2d87fb4d
581.98,1.0,93,1,2,1,4,0xb2d64e6ad
25006.77,2.0,92,2,3,1,6,0xb2d5f2bdd
50124.48,2.0,56,2,3,2,7,0xb2d5b58b
252250.6,8.0,18,3,4,2,9,0xb2d5c546
300000.53,2.0,8,3,3,3,9,0xb2da4b22
50059.82,2.0,38,2,3,2,7,0xb2d550db
5355.7,1.0,1,2,2,4,8,0xb2d9d64f
33872.87,1.0,15,2,2,3,7,0xb2d8ee61
3873.29,2.0,92,2,3,1,6,0x3b9b3ff0
29977.25,1.0,3,2,2,4,8,0xb2d6ad0f
710.23,1.0,6,1,2,3,6,0xb2d38acb
60002.33,3.0,165,3,4,1,8,0xb2d620e5d
5346.31,2.0,21,2,3,2,7,0xb2d4f567
820903.0,1.0,25,4,2,2,8,0xb2d279e3d
3792.19,1.0,0,2,2,4,8,0xb2d1f4a0d
31877.96,3.0,0,2,4,4,10,0xb2d0b9f6
17887.03,1.0,63,2,2,2,6,0xb2d55862
111293.16,1.0,92,3,2,1,6,0xb2d1bcd7d
6237.03,2.0,0,2,3,4,9,0xb2d31860d
1085120.0,5.0,46,4,4,2,10,0xb2d1531fd
1810.58,1.0,176,1,2,1,4,0xb2d5d380
550461.41,17.0,4,4,4,4,12,0x3b9af247
1736.87,1.0,184,1,2,1,4,0xb2d3a57a
657.92,1.0,11,1,2,3,6,0xb2d4e240
152.09,1.0,10,1,2,3,6,0xb2d6b2f4
3857.97,1.0,0,2,2,4,8,0xb2d37d0e
1603.97,1.0,184,1,2,1,4,0xb2d1fb2dd
202195.97,2.0,27,3,3,2,8,0xb2d22a8ed
10000.32,2.0,35,2,3,2,7,0xb2d9f879
370016.39,3.0,139,4,4,1,9,0xb2d38649
0.51,1.0,27,1,2,2,5,0xb2d60a23
379944.68,7.0,3,4,4,4,12,0xb2d5fbb3
14369.01,1.0,21,2,2,2,6,0xb2d964fb
200206.35,3.0,12,3,4,3,10,0xb2d6309c
450643.24,3.0,5,4,4,3,11,0xb2d79136d
148.66,1.0,10,1,2,3,6,0xb2d33c0fd
382127.83,2.0,0,4,3,4,11,0xb2d65886d
320047.87,4.0,76,4,4,1,9,0xb2d23286d
200733.79,2.0,4,3,3,4,10,0xb2d9356f
500363.86,3.0,6,4,4,3,11,0xb2d6a962d
3203.82,1.0,122,2,2,1,5,0xb2d3727ad
7387.81,1.0,0,2,2,4,8,0xb2d6a9bb
10364.47,2.0,95,2,3,1,6,0xb2d6140dd
180146.22,3.0,139,3,4,1,8,0xb2d2c290d
1747.13,1.0,170,1,2,1,4,0xb2d3c5d7d
203449.57,2.0,22,3,3,2,8,0xb2d6e470d
400080.86,3.0,12,4,4,3,11,0xb2d2a8a7d
661.51,1.0,89,1,2,1,4,0xb2d39e83d
553254.29,5.0,87,4,4,1,9,0xb2d26c19d
20000.21,2.0,14,2,3,3,8,0xb2da3a4a
330153.49,6.0,0,4,4,4,12,0x3b9b46a9d
36365.72,2.0,18,2,3,2,7,0xb2d32739d
600003.98,3.0,0,4,4,4,12,0xb2d0a39cd
340011.87,8.0,25,4,4,2,10,0xb2d2478a
14.23,1.0,32,1,2,2,5,0xb2d3905f
20103.13,1.0,97,2,2,1,5,0xb2d2b40f
500605.51,13.0,0,4,4,4,12,0x3b9ae61ad
261453.1,3.0,78,3,4,1,8,0xb2d63556d
889.55,1.0,14,1,2,3,6,0xb2d5893a
1650.09,2.0,92,1,3,1,5,0x3b9adef0d
39.62,1.0,72,1,2,1,4,0xb2d39b72
21080.25,1.0,23,2,2,2,6,0xb2d5c90c
3006417.3,2.0,93,4,3,1,8,0xb2d40c8b
154620.95,3.0,0,3,4,4,11,0xb2d5576f
9040.64,1.0,23,2,2,2,6,0xb2d69bbbd
2290.81,1.0,14,1,2,3,6,0xb2d8c61fd
428956.29,14.0,3,4,4,4,12,0xb2d4ee01d
210051.84,3.0,80,3,4,1,8,0xb2d1d843
13.83,1.0,52,1,2,2,5,0xb2d95e1a
2528.69,1.0,184,1,2,1,4,0xb2d3be6bd
3.84,1.0,47,1,2,2,5,0xb2d60ed3d
108038.71,2.0,192,3,3,1,7,0xb2d0dfbad
13496.24,1.0,218,2,2,1,5,0xb2d632e2d
462.39,1.0,10,1,2,3,6,0xb2d627e5
320196.72,6.0,55,4,4,2,10,0xb2d6babe
198100.17,6.0,0,3,4,4,11,0xb2d5b3ebd
657.6,1.0,16,1,2,2,5,0xb2d5ec87
1191.03,1.0,184,1,2,1,4,0xb2d1d3d9d
200000.0,2.0,59,3,3,2,8,0xb2d90122
500000.04,2.0,16,4,3,2,9,0xb2d9c75e
2301400.89,5.0,47,4,4,2,10,0xb2d0f60d
600000.02,3.0,96,4,4,1,9,0xb2d4a59ad
0.23,1.0,3,1,2,4,7,0xb2d559f7d
115004.23,2.0,214,3,3,1,7,0xb2d22af0
3372259.1,28.0,0,4,4,4,12,0xb2d5ce1b
15001.89,2.0,12,2,3,3,8,0xb2d9b322
40454.33,2.0,95,2,3,1,6,0xb2d61f0f
626011.29,6.0,8,4,4,3,11,0x3b9b2e85
182705.58,2.0,0,3,3,4,10,0xb2d2224cd
451724.76,2.0,25,4,3,2,9,0xb2d89054d
35.21,1.0,0,1,2,4,7,0xb2d69f8c
1177.38,1.0,92,1,2,1,4,0xb2d105ffd
2777512.0,19.0,3,4,4,4,12,0xb2d07460d
10000.86,2.0,25,2,3,2,7,0xb2d63e82d
266547.85,2.0,129,3,3,1,7,0xb2d377bcd
101840.44,1.0,1,3,2,4,9,0xb2d33c5fd
165006.97,2.0,35,3,3,2,8,0xb2d9f514
500025.11,2.0,2,4,3,4,11,0xb2d3a55fd
3608152.44,8.0,23,4,4,2,10,0xb2d0f60dd
1962094.02,15.0,1,4,4,4,12,0x3b9b0fa2d
1008579.23,8.0,23,4,4,2,10,0xb2d61c41d
8363537.09,14.0,58,4,4,2,10,0x3b9acd5fd
3099.3,3.0,0,2,4,4,10,0xb2d240f1
3477.81,1.0,32,2,2,2,6,0xb2d9d31a
80249.79,1.0,10,3,2,3,8,0xb2d6ca7b
100849.01,2.0,157,3,3,1,7,0xb2d56f62
201421.16,2.0,18,3,3,2,8,0xb2d995fb
170240.22,3.0,1,3,4,4,11,0xb2d4393b
30009.76,3.0,6,2,4,3,9,0xb2d315b7d
501776.3,2.0,54,4,3,2,9,0xb2d9cf9a
1.28,1.0,14,1,2,3,6,0xb2da06ee
475.98,1.0,6,1,2,3,6,0xb2d2499fd
132.57,1.0,29,1,2,2,5,0xb2da02e7
101822.55,3.0,70,3,4,1,8,0xb2d58201d
100002.11,2.0,95,3,3,1,7,0xb2d680c2d
2507.76,1.0,299,1,2,1,4,0xb2d61205
301065.63,2.0,36,4,3,2,9,0xb2d9f01d
535963.02,7.0,23,4,4,2,10,0xb2d5a72f
3677.88,1.0,3,2,2,4,8,0xb2d5a99c
27549.06,1.0,17,2,2,2,6,0xb2d68e7a
10000.0,2.0,19,2,3,2,7,0xb2d956c7
556.38,1.0,2,1,2,4,7,0xb2d19961
460542.95,5.0,10,4,4,3,11,0xb2d1ab22d
564.58,2.0,67,1,3,1,5,0xb2d4e603
134686.51,2.0,60,3,3,2,8,0xb2d1c50ad
21.19,1.0,92,1,2,1,4,0xb2d4e840
1380606.08,8.0,0,4,4,4,12,0x3b9b18c4
220078.51,2.0,87,3,3,1,7,0xb2d63d0a
130650.64,3.0,1,3,4,4,11,0xb2d5f07b
56010.9,2.0,184,3,3,1,7,0xb2d21fe6d
91079.88,6.0,0,3,4,4,11,0xb2d182a3d
539859.17,2.0,3,4,3,4,11,0xb2d15e2bd
150034.19,2.0,132,3,3,1,7,0xb2d2ad3bd
220002.14,3.0,10,3,4,3,10,0xb2d59db5d
5648.07,1.0,21,2,2,2,6,0xb2d61ba5d
200006.34,1.0,0,3,2,4,9,0xb2d31fecd
1.87,1.0,11,1,2,3,6,0xb2d9103f
673584.15,7.0,39,4,4,2,10,0xb2d4954ed
200090.65,2.0,111,3,3,1,7,0xb2d4f22fd
200000.84,2.0,18,3,3,2,8,0xb2d8db07
10363.05,2.0,3,2,3,4,9,0xb2d62405d
998375.58,21.0,0,4,4,4,12,0xb2d069e5
1604.98,1.0,0,1,2,4,7,0xb2d5c4d7
3009.13,1.0,298,2,2,1,5,0xb2d692fc
25336.18,2.0,31,2,3,2,7,0xb2d40e62d
3965.83,2.0,8,2,3,3,8,0xb2d06be1d
200047.99,2.0,7,3,3,3,9,0xb2d57a77
2452.66,1.0,0,1,2,4,7,0xb2d4d3cd
106014.17,2.0,63,3,3,2,8,0xb2d2778bd
426.24,1.0,0,1,2,4,7,0xb2d19f72
100094.36,2.0,216,3,3,1,7,0xb2d50017
6202.03,1.0,40,2,2,2,6,0xb2d928e5d
455032.64,4.0,15,4,4,3,11,0xb2d9c00f
500000.0,1.0,1,4,2,4,10,0xb2d9dacd
420017.84,2.0,39,4,3,2,9,0xb2d62653d
14375.23,1.0,5,2,2,3,7,0xb2d6baf5d
303575.57,6.0,0,4,4,4,12,0xb2d64710
33.57,1.0,88,1,2,1,4,0xb2d89f13
869854.22,4.0,168,4,4,1,9,0xb2d110a3d
12000.51,2.0,98,2,3,1,6,0xb2d94ac3d
871.18,2.0,0,1,3,4,8,0xb2d0a767
195.0,1.0,6,1,2,3,6,0xb2d61437
30000.01,2.0,4,2,3,4,9,0xb2d4cda0d
427002.44,16.0,2,4,4,4,12,0xb2d2edbfd
169839.93,2.0,1,3,3,4,10,0xb2d0db9dd
202.48,1.0,0,1,2,4,7,0xb2d453ef
102.39,1.0,54,1,2,2,5,0xb2d29d87
1.33,1.0,25,1,2,2,5,0xb2d5fdf4
652.85,1.0,9,1,2,3,6,0xb2d39173d
869.18,1.0,1,1,2,4,7,0xb2d25c36
100396.26,3.0,18,3,4,2,9,0xb2d0f4ded
780117.51,6.0,21,4,4,2,10,0xb2d59a8ed
14955.47,3.0,105,2,4,1,7,0x3b9ad05fd
20039.27,1.0,55,2,2,2,6,0xb2d654a1d
376513.13,4.0,0,4,4,4,12,0xb2d2067d
180042.22,4.0,46,3,4,2,9,0xb2d2a5b3
436.44,1.0,54,1,2,2,5,0xb2d4f4ed
235274.53,6.0,1,3,4,4,11,0xb2d5031dd
100432.19,3.0,12,3,4,3,10,0xb2d2103cd
70017.1,2.0,78,3,3,1,7,0xb2d6350a
86140.43,1.0,9,3,2,3,8,0xb2d8f2c9
331257.35,1.0,0,4,2,4,10,0xb2d28735d
600008.91,4.0,83,4,4,1,9,0xb2d33576d
132844.06,2.0,184,3,3,1,7,0xb2d0f92ad
250065.29,2.0,18,3,3,2,8,0xb2d6a1dbd
48957.2,1.0,2,2,2,4,8,0xb2d39768d
65.87,1.0,77,1,2,1,4,0xb2d947ad
12084.89,1.0,309,2,2,1,5,0xb2d1d295d
4425.56,1.0,120,2,2,1,5,0xb2d3c424
4138.45,1.0,23,2,2,2,6,0xb2d365cbd
50058.13,2.0,140,2,3,1,6,0xb2d346e0d
13072.4,1.0,0,2,2,4,8,0xb2d390ddd
16936.56,1.0,280,2,2,1,5,0xb2d5c7b1d
501876.87,2.0,22,4,3,2,9,0xb2d8e989d
18966.15,1.0,0,2,2,4,8,0xb2d3292f
426826.81,4.0,16,4,4,2,10,0xb2d41160d
4166.08,2.0,0,2,3,4,9,0xb2d24447
40098.02,1.0,0,2,2,4,8,0xb2d2d72bd
819560.51,1.0,184,4,2,1,7,0xb2d2069dd
157386.96,2.0,0,3,3,4,10,0xb2d51ee0d
10723.43,1.0,0,2,2,4,8,0xb2d341cf
139.16,1.0,8,1,2,3,6,0xb2d67d2d
5049.29,1.0,92,2,2,1,5,0xb2d29fad
1294.36,1.0,92,1,2,1,4,0xb2d34d85
101008.14,2.0,52,3,3,2,8,0xb2d6c395d
4968.05,1.0,123,2,2,1,5,0xb2d31ccad
890119.94,5.0,21,4,4,2,10,0xb2d4b2e4
5022.23,1.0,19,2,2,2,6,0xb2d4b356d
3081683.09,3.0,6,4,4,3,11,0xb2d6e1c2d
296.88,2.0,67,1,3,1,5,0xb2d5040f
52881.56,1.0,23,3,2,2,7,0xb2d25f0e
4832.39,1.0,4,2,2,4,8,0xb2d4cb87
120056.37,3.0,60,3,4,2,9,0xb2d07961
304834.86,4.0,25,4,4,2,10,0xb2d154abd
200042.52,2.0,15,3,3,3,9,0xb2d913a3d
760069.87,2.0,31,4,3,2,9,0xb2d8daa2
1924.91,1.0,46,1,2,2,5,0xb2d30fbb
13482.27,1.0,10,2,2,3,7,0xb2d2b603
8.55,1.0,9,1,2,3,6,0xb2d6d003d
1317.25,1.0,5,1,2,3,6,0xb2d6bac7
300025.64,3.0,63,3,4,2,9,0xb2d1b289d
6097.76,1.0,19,2,2,2,6,0xb2d9db04
702922.97,3.0,49,4,4,2,10,0xb2d5960ad
427356.73,7.0,4,4,4,4,12,0xb2d16de3
499324.55,4.0,28,4,4,2,10,0xb2d29dcad
254588.24,3.0,76,3,4,1,8,0xb2d1ac68
800013.54,5.0,91,4,4,1,9,0xb2d27f6a
30314.96,3.0,3,2,4,4,10,0xb2d4393bd
4713.41,1.0,6,2,2,3,7,0xb2d755c4
160007.97,3.0,21,3,4,2,9,0xb2d6fab0
159273.52,8.0,0,3,4,4,11,0xb2d628fad
21142.56,1.0,87,2,2,1,5,0xb2d51fc1
153.74,1.0,9,1,2,3,6,0xb2d20cee
401421.05,2.0,55,4,3,2,9,0xb2d906efd
8784.29,1.0,10,2,2,3,7,0xb2d40953d
70588.67,3.0,70,3,4,1,8,0xb2d6659d
391972.29,2.0,8,4,3,3,10,0xb2d275a5d
103002.75,2.0,217,3,3,1,7,0xb2d3bce9d
300000.0,2.0,6,3,3,3,9,0xb2da5b1f
0.0,1.0,12,1,2,3,6,0xb2d69f34
30035.35,2.0,101,2,3,1,6,0xb2d688efd
1236.7,1.0,23,1,2,2,5,0xb2d69080
300000.06,2.0,6,3,3,3,9,0xb2d86b50d
26.39,1.0,56,1,2,2,5,0xb2d2eaf5
303197.8,2.0,4,4,3,4,11,0xb2d893f0
615558.16,3.0,9,4,4,3,11,0xb2d0d436
23895.93,4.0,0,2,4,4,10,0xb2d0bfd4
4229.73,1.0,105,2,2,1,5,0xb2d2ad5bd
301.03,1.0,22,1,2,2,5,0xb2d78701
350099.21,3.0,59,4,4,2,10,0xb2d6c6e5d
370003.91,2.0,55,4,3,2,9,0xb2d904fe
268639.37,1.0,1,3,2,4,9,0xb2d77f5bd
1.33,1.0,8,1,2,3,6,0xb2d94213
360000.0,2.0,3,4,3,4,11,0xb2d97c90
165115.38,1.0,11,3,2,3,8,0xb2d5ae6b
660090.86,6.0,9,4,4,3,11,0xb2d1b058
80290.45,3.0,245,3,4,1,8,0xb2d438b4d
16284.85,1.0,10,2,2,3,7,0xb2d5d725d
52328.74,2.0,13,3,3,3,9,0xb2d2cc1e
5320.32,1.0,1,2,2,4,8,0xb2d6d6a7
20182.19,2.0,195,2,3,1,6,0xb2d5cb4fd
101415.84,2.0,4,3,3,4,10,0xb2d62854
24.76,1.0,6,1,2,3,6,0xb2d3e652d
200000.0,2.0,0,3,3,4,10,0xb2d6d3a4d
881353.16,3.0,14,4,4,3,11,0xb2d89f17d
768915.0,7.0,8,4,4,3,11,0xb2d2368f
25.21,1.0,69,1,2,1,4,0xb2d9611d
3010.17,1.0,10,2,2,3,7,0xb2d6876b
1298.91,1.0,16,1,2,2,5,0xb2d6d601
250000.0,2.0,13,3,3,3,9,0xb2d95fec
5355.44,2.0,2,2,3,4,9,0xb2d06800
810305.87,3.0,24,4,4,2,10,0xb2d92d71d
52232.21,2.0,98,3,3,1,7,0xb2d176acd
5609.21,2.0,7,2,3,3,8,0xb2d68196
332146.07,4.0,13,4,4,3,11,0xb2d78176
100823.95,2.0,157,3,3,1,7,0xb2d48b52
25009.33,1.0,43,2,2,2,6,0xb2d3c42ed
700087.16,3.0,8,4,4,3,11,0xb2d8ecb3d
1057.5,1.0,92,1,2,1,4,0xb2d241da
23.85,1.0,184,1,2,1,4,0xb2d4de96d
1512.24,1.0,184,1,2,1,4,0xb2d395aad
103509.19,4.0,20,3,4,2,9,0xb2d556fcd
480064.81,4.0,18,4,4,2,10,0xb2d59749d
383434.18,6.0,0,4,4,4,12,0xb2d57704
541243.15,4.0,17,4,4,2,10,0xb2d4069fd
98038.78,3.0,3,3,4,4,11,0xb2d50865
50212.33,3.0,11,2,4,3,9,0xb2d8e30fd
130817.23,4.0,3,3,4,4,11,0xb2d20f8a
69.18,1.0,10,1,2,3,6,0xb2d2b2e3d
601784.16,4.0,21,4,4,2,10,0xb2d63ed9
41223.36,1.0,18,2,2,2,6,0xb2d37a1f
43899.78,1.0,11,2,2,3,7,0xb2d3389f
13021.45,1.0,20,2,2,2,6,0xb2d68eafd
200372.96,1.0,0,3,2,4,9,0xb2d559ebd
666.17,1.0,60,1,2,2,5,0xb2d5f376d
14.13,1.0,55,1,2,2,5,0xb2d28189d
4956.3,1.0,0,2,2,4,8,0xb2d38678d
1200001.11,3.0,10,4,4,3,11,0xb2d941b0d
602222.96,4.0,4,4,4,4,12,0xb2d55c8cd
714930.87,2.0,41,4,3,2,9,0xb2d6a5b0d
80978.92,2.0,228,3,3,1,7,0xb2d607d3d
300201.88,3.0,34,4,4,2,10,0xb2d5572e
627093.56,1.0,197,4,2,1,7,0xb2d594d6d
31.9,1.0,20,1,2,2,5,0xb2d2eea6d
2280.76,1.0,6,1,2,3,6,0xb2d1c739d
4267.9,1.0,20,2,2,2,6,0xb2d2c00b
9445.71,1.0,29,2,2,2,6,0xb2d6caf5
60101.33,3.0,40,3,4,2,9,0xb2d6fdfdd
11.96,1.0,29,1,2,2,5,0xb2d6e79b
351776.23,2.0,0,4,3,4,11,0xb2d9c46e
250009.45,3.0,73,3,4,1,8,0xb2d1a628d
200730.02,2.0,19,3,3,2,8,0xb2d59109
5549.08,1.0,0,2,2,4,8,0xb2d6b154
380093.91,3.0,1,4,4,4,12,0xb2d109f2
178005.97,5.0,28,3,4,2,9,0xb2d97424d
30000.63,2.0,39,2,3,2,7,0xb2d9f09e
200000.0,4.0,6,3,4,3,10,0xb2da58d4
0.93,1.0,1,1,2,4,7,0xb2d37695
326163.0,7.0,0,4,4,4,12,0xb2d61403d
6052.78,1.0,1,2,2,4,8,0xb2d19d37
0.21,1.0,184,1,2,1,4,0xb2d14a9fd
6009.57,1.0,13,2,2,3,7,0xb2d3ec37
86002.31,5.0,49,3,4,2,9,0xb2d8c597d
2582.14,1.0,2,1,2,4,7,0xb2d24385d
12209.69,2.0,179,2,3,1,6,0xb2d5eff4d
2082.05,1.0,92,1,2,1,4,0xb2d2986ed
8.31,21.0,53,1,4,2,7,0xb2d34e14
96.81,1.0,13,1,2,3,6,0xb2d60ab7d
20405.66,1.0,174,2,2,1,5,0xb2d59b4bd
80881.0,1.0,51,3,2,2,7,0xb2d0d329d
997.51,1.0,0,1,2,4,7,0xb2d40f6e
200001.26,2.0,6,3,3,3,9,0xb2d975aa
5576.29,1.0,32,2,2,2,6,0xb2d9d2dc
661938.8,6.0,22,4,4,2,10,0xb2d6c18ad
1500019.54,6.0,1,4,4,4,12,0xb2d3c1ded
330000.0,2.0,0,4,3,4,11,0xb2d0d40a
601572.98,6.0,18,4,4,2,10,0xb2d2de40d
2744.34,1.0,10,1,2,3,6,0xb2d2c61c
33490.46,1.0,29,2,2,2,6,0xb2d6d7df
50876.93,3.0,80,2,4,1,7,0xb2d5a5b6
271189.94,4.0,105,3,4,1,8,0xb2d63ecad
129406.44,8.0,4,3,4,4,11,0xb2d94d19d
3553.7,1.0,92,2,2,1,5,0xb2d44d18
400051.63,6.0,0,4,4,4,12,0xb2d1a0b1d
86082.37,5.0,0,3,4,4,11,0xb2d3fbe5
975349.0,1.0,1,4,2,4,10,0xb2d8e6f2d
300028.57,3.0,11,3,4,3,10,0xb2d17191d
70002.32,2.0,92,3,3,1,7,0xb2d6350ad
262046.73,5.0,60,3,4,2,9,0xb2d22481d
1632642.66,16.0,0,4,4,4,12,0x3b9b18f4
1882.81,1.0,184,1,2,1,4,0x3b9adf02d
259371.5,2.0,0,3,3,4,10,0xb2d78189
1110057.31,13.0,18,4,4,2,10,0xb2d136eed
20088.38,1.0,1,2,2,4,8,0xb2d230a5
200000.0,2.0,26,3,3,2,8,0xb2da1447
1755.14,1.0,92,1,2,1,4,0xb2d35ae9d
615190.42,4.0,4,4,4,4,12,0xb2d23631d
150022.57,4.0,38,3,4,2,9,0xb2d573ddd
1804.59,1.0,0,1,2,4,7,0xb2d3ef6f
48009.19,2.0,24,2,3,2,7,0xb2d295f5
60218.38,2.0,14,3,3,3,9,0xb2d60d1fd
30199.25,1.0,5,2,2,3,7,0xb2d67fa8d
200000.0,4.0,2,3,4,4,11,0xb2d0e390d
4280.76,1.0,6,2,2,3,7,0xb2d1f61a
574260.92,3.0,1,4,4,4,12,0xb2d3a00bd
13242.56,1.0,0,2,2,4,8,0xb2d290e8
11718.51,1.0,8,2,2,3,7,0xb2d8c8e4d
6026.89,1.0,7,2,2,3,7,0xb2d34abcd
5552.31,1.0,6,2,2,3,7,0xb2d21346d
60005.57,2.0,53,3,3,2,8,0xb2d62c3ad
2.0,1.0,41,1,2,2,5,0xb2d8d98c
150008.36,2.0,104,3,3,1,7,0xb2d645aad
554108.97,2.0,52,4,3,2,9,0xb2d2ef46
10110.56,2.0,60,2,3,2,7,0xb2d8d5a6
50708.04,1.0,92,2,2,1,5,0xb2d215e9d
1017.03,1.0,184,1,2,1,4,0xb2d1daacd
104634.41,2.0,0,3,3,4,10,0xb2d5b038
140722.68,5.0,39,3,4,2,9,0xb2d57cd0
16012.05,2.0,5,2,3,3,8,0xb2d58d37
41.17,1.0,11,1,2,3,6,0xb2d93759
4.29,1.0,18,1,2,2,5,0xb2d652e3
301875.81,2.0,17,4,3,2,9,0xb2d3b26ad
85020.06,2.0,168,3,3,1,7,0xb2d68dc4d
55560.22,3.0,0,3,4,4,11,0xb2d6fc19d
30969.14,1.0,16,2,2,2,6,0xb2d8e66bd
42.48,1.0,19,1,2,2,5,0xb2d24ad2
5.54,1.0,43,1,2,2,5,0xb2d6e50d
763.11,1.0,15,1,2,3,6,0xb2d4e753
7.93,1.0,1,1,2,4,7,0xb2d55ac6
517.75,1.0,1,1,2,4,7,0xb2d0d231
1458.98,1.0,4,1,2,4,7,0xb2d69442d
187921.32,4.0,4,3,4,4,11,0xb2d07eadd
509.76,1.0,28,1,2,2,5,0xb2d5a1b0d
638.43,1.0,5,1,2,3,6,0xb2d5cfc6
31.67,1.0,33,1,2,2,5,0xb2d8eee3
120007.28,2.0,208,3,3,1,7,0xb2d07b2bd
32793.57,1.0,0,2,2,4,8,0xb2d2b85b
10000.42,2.0,63,2,3,2,7,0xb2d9b2a6
3077.53,1.0,83,2,2,1,5,0xb2d6d51e
1650.5,1.0,9,1,2,3,6,0xb2d6f88f
30026.79,3.0,28,2,4,2,8,0xb2d5bcea
160988.92,3.0,25,3,4,2,9,0xb2d55bc4d
546895.21,7.0,33,4,4,2,10,0xb2d0bc9cd
7490.46,1.0,184,2,2,1,5,0xb2d24a54d
104167.28,2.0,25,3,3,2,8,0xb2d44974d
10000.0,2.0,22,2,3,2,7,0xb2da164a
342789.33,4.0,1,4,4,4,12,0xb2d59f36
5054.11,1.0,92,2,2,1,5,0xb2d29c84d
50000.11,1.0,0,2,2,4,8,0xb2d93672d
20.55,1.0,1,1,2,4,7,0xb2d75ac4d
52.86,1.0,82,1,2,1,4,0xb2d98251d
303198.25,2.0,111,4,3,1,8,0xb2d956ced
685000.0,19.0,6,4,4,3,11,0xb2d221d9d
1380.54,1.0,10,1,2,3,6,0xb2d299bdd
53480.26,2.0,74,3,3,1,7,0xb2d3f5b0d
15469.84,1.0,0,2,2,4,8,0xb2d2cd4dd
145024.9,2.0,75,3,3,1,7,0xb2d6126a
504.95,1.0,34,1,2,2,5,0xb2d5bfddd
450000.0,2.0,26,4,3,2,9,0xb2da1125
4502648.11,1.0,21,4,2,2,8,0xb2d9374fd
354.97,4.0,3,1,4,4,9,0xb2d0c868
203.51,1.0,34,1,2,2,5,0xb2d987b5
207114.51,2.0,133,3,3,1,7,0xb2d29704
31356.88,1.0,3,2,2,4,8,0xb2d34049d
1038.47,1.0,184,1,2,1,4,0xb2d29dacd
335343.39,6.0,1,4,4,4,12,0x3b9b3299
720528.84,4.0,55,4,4,2,10,0xb2d1c228d
464.69,1.0,34,1,2,2,5,0xb2d8244b
331453.47,4.0,67,4,4,1,9,0xb2d5b35dd
198792.53,2.0,31,3,3,2,8,0xb2d9359ad
839216.49,7.0,1,4,4,4,12,0xb2d3790bd
432.38,1.0,12,1,2,3,6,0xb2d218a9
500083.09,3.0,179,4,4,1,9,0xb2d1c5f0
60054.03,2.0,245,3,3,1,7,0xb2d64a01d
100650.99,2.0,0,3,3,4,10,0xb2d45a65d
10890.24,1.0,8,2,2,3,7,0xb2d61ee1
202580.0,2.0,18,3,3,2,8,0xb2d6cf6cd
43825.75,1.0,1,2,2,4,8,0xb2d3c2a1d
242.58,1.0,43,1,2,2,5,0xb2d5727c
208858.76,2.0,209,3,3,1,7,0xb2d5bab2
236.1,1.0,2,1,2,4,7,0xb2d518ccd
8895.01,2.0,11,2,3,3,8,0xb2d1f021d
1767.74,1.0,179,1,2,1,4,0xb2d392a6d
450.82,1.0,0,1,2,4,7,0xb2d69fc4
14029.38,5.0,92,2,4,1,7,0xb2d12eff
202000.0,2.0,0,3,3,4,10,0xb2d980add
78001.65,2.0,73,3,3,1,7,0xb2d8e2f9d
10803.85,1.0,0,2,2,4,8,0xb2d9a5fe
340047.83,2.0,96,4,3,1,8,0xb2d200e2d
14518.15,1.0,1,2,2,4,8,0xb2d8f035
16729.78,1.0,0,2,2,4,8,0xb2d56085d
1401.86,1.0,92,1,2,1,4,0xb2d1313e
3115.6,1.0,184,2,2,1,5,0xb2d3f720d
5764324.29,9.0,58,4,4,2,10,0xb2d97c81d
350031.91,7.0,143,4,4,1,9,0xb2d3d517d
202276.91,2.0,7,3,3,3,9,0xb2d986f6
400795.22,3.0,18,4,4,2,10,0xb2d8fba4
1451.41,1.0,184,1,2,1,4,0xb2d2c3c9d
81495.57,5.0,4,3,4,4,11,0xb2d8ee2c
11309.74,2.0,6,2,3,3,8,0xb2d92a3dd
261.15,1.0,19,1,2,2,5,0xb2d37cf4
25002.62,4.0,1,2,4,4,10,0xb2d94230
50224.01,2.0,52,2,3,2,7,0xb2d515d8
3856.59,1.0,28,2,2,2,6,0xb2d205c9
345713.37,1.0,191,4,2,1,7,0xb2d193e5d
51003.29,3.0,73,2,4,1,7,0xb2d5aa84d
1013098.29,3.0,40,4,4,2,10,0xb2d65655d
4754.73,1.0,3,2,2,4,8,0xb2d6a156
1060.09,2.0,184,1,3,1,5,0xb2d0a98bd
150000.0,2.0,3,3,3,4,10,0xb2d97a94
733263.85,4.0,6,4,4,3,11,0xb2d3389dd
10010.77,2.0,24,2,3,2,7,0xb2da12dc
200002.11,2.0,6,3,3,3,9,0xb2d96b64d
10001.18,2.0,48,2,3,2,7,0xb2d55edd
563594.91,6.0,20,4,4,2,10,0x3b9b2932
4283.12,1.0,184,2,2,1,5,0xb2d3590bd
208013.15,3.0,101,3,4,1,8,0xb2d24cc2d
1102186.96,2.0,1,4,3,4,11,0xb2d19af4
10018.7,1.0,67,2,2,1,5,0xb2d4c956
560114.0,2.0,179,4,3,1,8,0xb2d263c8
20138.86,1.0,15,2,2,3,7,0xb2d6aa1fd
4203.71,1.0,1,2,2,4,8,0xb2d70193d
903.17,1.0,39,1,2,2,5,0xb2d2dcf0
444873.06,7.0,0,4,4,4,12,0xb2d3dcfcd
620047.07,3.0,8,4,4,3,11,0xb2d386e3d
472007.26,4.0,27,4,4,2,10,0xb2d3fb4c
110038.37,3.0,39,3,4,2,9,0xb2d5efc7d
33514.21,1.0,0,2,2,4,8,0xb2d973bc
158.39,1.0,60,1,2,2,5,0xb2d8e3b3
500000.0,2.0,9,4,3,3,10,0xb2d96d9ad
25200.88,3.0,2,2,4,4,10,0xb2d5aeaed
6.06,1.0,68,1,2,1,4,0xb2d2706b
17.11,1.0,13,1,2,3,6,0xb2d6c5d3
1159.63,1.0,13,1,2,3,6,0xb2d59918
203307.19,2.0,3,3,3,4,10,0xb2d68c68d
17942067.25,3.0,5,4,4,3,11,0x3b9af42dd
9035.01,2.0,236,2,3,1,6,0x3b9b4046d
17394.21,4.0,2,2,4,4,10,0x3b9b17fcd
135566.55,4.0,0,3,4,4,11,0xb2d5a116d
230334.15,2.0,1,3,3,4,10,0xb2d56179
1972.02,2.0,2,1,3,4,8,0xb2d44fbbd
1407.5,1.0,184,1,2,1,4,0xb2d29581d
2467.8,1.0,7,1,2,3,6,0xb2d3404f
549397.68,6.0,11,4,4,3,11,0xb2d0f5d9d
2495.01,1.0,259,1,2,1,4,0xb2d68962d
440000.0,6.0,4,4,4,4,12,0xb2d10339
3.55,1.0,13,1,2,3,6,0xb2d9a632
261833.25,4.0,39,3,4,2,9,0xb2d3faa9
557.22,6.0,0,1,4,4,9,0xb2d067a8
366455.82,6.0,33,4,4,2,10,0xb2d5e456
202859.98,6.0,0,3,4,4,11,0xb2d0686d
100005.2,3.0,0,3,4,4,11,0xb2d92bff
177890.2,3.0,200,3,4,1,8,0x3b9b37c0d
1507.31,1.0,184,1,2,1,4,0xb2d0ef9ad
191.39,1.0,7,1,2,3,6,0xb2d388e3d
259.03,1.0,59,1,2,2,5,0xb2d28a8b
1.02,1.0,74,1,2,1,4,0xb2d94ed3
10984.95,1.0,47,2,2,2,6,0xb2d53fa1
3497.39,1.0,8,2,2,3,7,0xb2d6c0c2
130001.37,2.0,8,3,3,3,9,0xb2da4b71
2285.49,1.0,92,1,2,1,4,0xb2d2ea48d
506054.59,3.0,27,4,4,2,10,0xb2d6fccfd
502106.0,2.0,41,4,3,2,9,0xb2d91933
870655.78,1.0,18,4,2,2,8,0xb2d99369
55126.25,2.0,164,3,3,1,7,0xb2d19ed6
2010.95,1.0,0,1,2,4,7,0xb2d6b729
23.7,1.0,33,1,2,2,5,0xb2d21d65d
1430.27,1.0,3,1,2,4,7,0xb2d482dcd
320100.65,4.0,34,4,4,2,10,0xb2d2420e
91.19,1.0,9,1,2,3,6,0xb2d48191
15423.44,2.0,46,2,3,2,7,0x3b9b19cc
9700.07,1.0,7,2,2,3,7,0xb2d93a15d
50148.25,2.0,92,2,3,1,6,0xb2d100ccd
3002095.02,8.0,1,4,4,4,12,0xb2d81652d
20187.28,3.0,0,2,4,4,10,0xb2d5bcdb
1027.32,1.0,92,1,2,1,4,0xb2d1175fd
1100008.43,4.0,3,4,4,4,12,0xb2d9f1bd
4.44,1.0,147,1,2,1,4,0xb2d25a1b
72000.0,2.0,9,3,3,3,9,0xb2d938a4
1.82,1.0,10,1,2,3,6,0xb2d9140b
151641.86,1.0,92,3,2,1,6,0xb2d3bbc7d
6.33,1.0,46,1,2,2,5,0xb2d9102dd
2943.67,1.0,2,2,2,4,8,0xb2d65232
1508.29,1.0,184,1,2,1,4,0xb2d1f956d
9974.4,1.0,6,2,2,3,7,0xb2d36c69d
381943.68,7.0,11,4,4,3,11,0xb2d6404cd
55.04,1.0,13,1,2,3,6,0xb2d53ff1d
1050834.63,3.0,21,4,4,2,10,0xb2d57cb9
700431.69,2.0,14,4,3,3,10,0xb2da3404
6902.29,1.0,92,2,2,1,5,0xb2d321c9d
1652500.0,1.0,0,4,2,4,10,0xb2d91511d
1515.15,1.0,9,1,2,3,6,0xb2d4dc7d
500097.14,2.0,186,4,3,1,8,0xb2d4f2b2d
7.32,1.0,55,1,2,2,5,0xb2d57a13d
360003.8,2.0,87,4,3,1,8,0xb2d8ca9d
2426.53,1.0,92,1,2,1,4,0x3b9b22edd
2784.72,1.0,306,1,2,1,4,0xb2d39a99d
213906.77,2.0,19,3,3,2,8,0xb2d3c86dd
122124.13,4.0,10,3,4,3,10,0xb2d6b047d
63849.12,1.0,18,3,2,2,7,0xb2d54b89
265099.22,4.0,19,3,4,2,9,0xb2d3dd16d
1345.71,1.0,6,1,2,3,6,0xb2d250e1d
24019.18,1.0,26,2,2,2,6,0xb2d369c3
40003.38,1.0,18,2,2,2,6,0xb2da2a6d
170266.12,3.0,41,3,4,2,9,0xb2d64ebfd
11948.33,1.0,5,2,2,3,7,0xb2d38b8e
53002.13,2.0,60,3,3,2,8,0xb2d9b7c0
2120.07,1.0,24,1,2,2,5,0xb2d1ecf3
51.38,1.0,6,1,2,3,6,0xb2d27d49d
420000.0,3.0,0,4,4,4,12,0xb2d9810cd
1130.1,1.0,92,1,2,1,4,0xb2d24655d
500112.63,2.0,136,4,3,1,8,0xb2d30c61d
817400.51,1.0,0,4,2,4,10,0xb2d17bd8d
10032.98,2.0,92,2,3,1,6,0xb2d29db7d
734.51,1.0,4,1,2,4,7,0xb2d7ce68d
470002.3,2.0,0,4,3,4,11,0xb2d55d74
84907.13,2.0,21,3,3,2,8,0xb2d54064d
750046.06,4.0,32,4,4,2,10,0xb2d32ae1d
30000.95,2.0,10,2,3,3,8,0xb2d95fdc
157.27,1.0,3,1,2,4,7,0xb2d420a3d
3345.94,1.0,12,2,2,3,7,0xb2d2ef5bd
27667.13,1.0,9,2,2,3,7,0xb2d3a152d
4995.52,1.0,14,2,2,3,7,0xb2d6b4c8d
9086.78,1.0,21,2,2,2,6,0xb2d60ad6
105.36,1.0,13,1,2,3,6,0xb2d33764d
3421.53,1.0,23,2,2,2,6,0xb2d23a9ed
16343.47,1.0,127,2,2,1,5,0xb2d2ddb0
800120.15,2.0,56,4,3,2,9,0xb2d55f7a
251104.42,5.0,13,3,4,3,10,0xb2d5a05e
25.26,1.0,2,1,2,4,7,0xb2d435f4
26.81,1.0,11,1,2,3,6,0xb2d9d257
4377.58,1.0,31,2,2,2,6,0xb2d2c424d
7519.72,1.0,0,2,2,4,8,0xb2d6c04ad
7484.53,1.0,0,2,2,4,8,0xb2d787c8
100895.92,2.0,10,3,3,3,9,0xb2d7bfd2d
430032.2,2.0,0,4,3,4,11,0xb2d629f0d
120052.04,3.0,20,3,4,2,9,0xb2d61fcb
1000285.68,10.0,4,4,4,4,12,0x3b9b1950
68720.4,2.0,25,3,3,2,8,0xb2d5c77f
6386.59,1.0,208,2,2,1,5,0xb2d1ca87d
3.22,2.0,3,1,3,4,8,0x3b9b33f7
400000.13,3.0,13,4,4,3,11,0xb2d59b8b
400275.76,5.0,12,4,4,3,11,0x3b9b499fd
898.58,1.0,20,1,2,2,5,0xb2d69f6e
4.56,1.0,67,1,2,1,4,0xb2d9714d
2157.73,1.0,3,1,2,4,7,0xb2d4b44e
27084.17,1.0,0,2,2,4,8,0xb2d6acb1
4282.4,1.0,184,2,2,1,5,0xb2d2ec2c
2033.22,1.0,92,1,2,1,4,0xb2d0b652
330008.6,4.0,5,4,4,3,11,0xb2d31406d
50000.53,2.0,224,2,3,1,6,0xb2d6fb16
20721.66,1.0,66,2,2,2,6,0xb2d17044
300003.88,4.0,1,3,4,4,11,0xb2da6173
125088.48,5.0,39,3,4,2,9,0xb2d064f0
0.0,1.0,3,1,2,4,7,0xb2da63a5
1220001.67,4.0,16,4,4,2,10,0xb2d90437d
9985.56,1.0,7,2,2,3,7,0xb2d6b6a6d
200000.0,2.0,1,3,3,4,10,0xb2d98133
1000010.56,3.0,6,4,4,3,11,0xb2d967f1
855367.06,7.0,25,4,4,2,10,0xb2d17e65
50272.09,7.0,0,2,4,4,10,0x3b9aebc8
20058.94,1.0,1,2,2,4,8,0xb2d29158
1379.35,1.0,0,1,2,4,7,0xb2d83926
201702.26,2.0,74,3,3,1,7,0xb2d6b1e3d
316.71,1.0,14,1,2,3,6,0xb2d2a89d
839029.6,3.0,101,4,4,1,9,0xb2d2e388d
158745.52,2.0,4,3,3,4,10,0xb2d2d4f9
10000.32,2.0,87,2,3,1,6,0xb2d51b13
621900.99,3.0,6,4,4,3,11,0xb2d8e919d
160044.43,3.0,27,3,4,2,9,0xb2d425ba
59.82,1.0,32,1,2,2,5,0xb2d6c4f9d
707177.18,4.0,13,4,4,3,11,0xb2d5db9cd
2938.86,1.0,0,2,2,4,8,0xb2d59343
130002.43,4.0,53,3,4,2,9,0xb2d996f3
215035.2,2.0,193,3,3,1,7,0xb2d18f26d
4134.66,1.0,0,2,2,4,8,0xb2d631e5d
477995.95,4.0,25,4,4,2,10,0xb2d2def1
220377.1,2.0,92,3,3,1,7,0xb2d52c98d
10238.48,2.0,0,2,3,4,9,0xb2d44c2bd
150523.83,1.0,24,3,2,2,7,0xb2d94f02d
924.69,1.0,1,1,2,4,7,0xb2d906d8
1840000.0,4.0,8,4,4,3,11,0xb2d43261d
3028.08,1.0,25,2,2,2,6,0xb2d2c399d
920310.18,5.0,69,4,4,1,9,0xb2d58137d
9.91,1.0,58,1,2,2,5,0xb2d3ce4e
2602667.76,1.0,7,4,2,3,9,0xb2d45bc2d
40393.02,2.0,92,2,3,1,6,0xb2d12110d
13291.63,1.0,2,2,2,4,8,0xb2d995dc
448.59,1.0,112,1,2,1,4,0xb2d42a28d
5152334.4,8.0,3,4,4,4,12,0x3b9add51d
210453.82,10.0,0,3,4,4,11,0xb2d2ab5b
276.98,1.0,14,1,2,3,6,0xb2d645f0
5127.95,1.0,5,2,2,3,7,0xb2d37c8c
82.9,1.0,0,1,2,4,7,0xb2d6d4cc
1222754.14,2.0,0,4,3,4,11,0xb2d0f07bd
424.28,1.0,78,1,2,1,4,0xb2d1ae49d
12500.05,1.0,6,2,2,3,7,0xb2d5d771d
262279.38,3.0,0,3,4,4,11,0xb2d3b470
70.15,1.0,35,1,2,2,5,0xb2d8f9c7
551049.56,6.0,1,4,4,4,12,0x3b9b49d6d
250000.0,2.0,1,3,3,4,10,0xb2da673e
336624.86,4.0,25,4,4,2,10,0xb2d5e6a3d
5.48,1.0,47,1,2,2,5,0xb2d2d071
260146.28,4.0,11,3,4,3,10,0xb2d2ba68d
1162309.84,9.0,0,4,4,4,12,0xb2d5e16ad
780436.49,11.0,0,4,4,4,12,0xb2d1dd31d
204977.51,2.0,35,3,3,2,8,0xb2d685ef
700355.36,2.0,108,4,3,1,8,0xb2d3e2b0
2311.02,1.0,184,1,2,1,4,0xb2d3c5c3
1019.9,1.0,92,1,2,1,4,0xb2d06d55d
700000.0,4.0,6,4,4,3,11,0xb2d6f207
1177.92,1.0,13,1,2,3,6,0xb2d92312
2037.89,1.0,184,1,2,1,4,0xb2d3dfbc
398.51,1.0,8,1,2,3,6,0xb2d32904
33523.38,3.0,0,2,4,4,10,0xb2d55e11d
379598.0,2.0,32,4,3,2,9,0xb2d1bc7e
340007.11,5.0,151,4,4,1,9,0xb2d478d1d
11921.19,1.0,3,2,2,4,8,0xb2d91bb1
0.44,1.0,1,1,2,4,7,0xb2d3c34ed
461220.62,3.0,0,4,4,4,12,0xb2d1809d
242007.25,4.0,14,3,4,3,10,0xb2d4207ad
310235.97,2.0,139,4,3,1,8,0xb2d55109d
32483.68,1.0,28,2,2,2,6,0xb2d5bd5a
35024.84,4.0,36,2,4,2,8,0xb2d781fcd
300018.95,2.0,8,3,3,3,9,0xb2d903a4d
0.0,1.0,10,1,2,3,6,0xb2d8d5fc
170612.25,3.0,39,3,4,2,9,0xb2d6b2a5d
8101.76,1.0,15,2,2,3,7,0xb2d9b304
790011.22,6.0,3,4,4,4,12,0x3b9b2c40d
1134.34,1.0,20,1,2,2,5,0xb2d2e705
891.21,1.0,184,1,2,1,4,0xb2d25406d
51627.69,1.0,15,2,2,3,7,0xb2d69e79d
4179.59,1.0,92,2,2,1,5,0xb2d1150ed
1370.68,1.0,92,1,2,1,4,0xb2d0f487d
650263.9,5.0,5,4,4,3,11,0xb2d588d1d
1000391.34,5.0,0,4,4,4,12,0xb2d63191
364000.9,9.0,0,4,4,4,12,0xb2d5093ad
410000.86,3.0,4,4,4,4,12,0xb2d9a1bf
265958.77,3.0,4,3,4,4,11,0xb2d69e87d
2905.73,1.0,24,2,2,2,6,0xb2d1d8cad
80.78,1.0,9,1,2,3,6,0xb2d81d65
60002.22,3.0,80,3,4,1,8,0xb2d8c37dd
105077.17,3.0,4,3,4,4,11,0xb2d232b4
252665.04,2.0,105,3,3,1,7,0xb2d7ede3d
26004.38,2.0,10,2,3,3,8,0xb2d52caa
3136.3,1.0,53,2,2,2,6,0xb2d3552b
1001.57,1.0,153,1,2,1,4,0xb2d30940d
36.9,1.0,10,1,2,3,6,0xb2d99357
19.61,1.0,34,1,2,2,5,0xb2d64f2d
694209.05,9.0,0,4,4,4,12,0x3b9af16cd
10000.47,2.0,42,2,3,2,7,0xb2d9e221
71066.44,2.0,2,3,3,4,10,0xb2d12c7f
671073.98,8.0,9,4,4,3,11,0xb2d24378
230000.17,3.0,0,3,4,4,11,0xb2d6dad6
14995.56,1.0,12,2,2,3,7,0xb2d9415e
6.24,1.0,2,1,2,4,7,0xb2d8f348d
62596.83,1.0,0,3,2,4,9,0xb2d4d0da
4858.43,3.0,184,2,4,1,7,0x3b9b2c85d
44.35,1.0,59,1,2,2,5,0xb2d3f55fd
995.67,1.0,36,1,2,2,5,0xb2d518f3d
440000.0,6.0,8,4,4,3,11,0xb2d07511
4605.04,1.0,1,2,2,4,8,0xb2d700b8d
54463.15,5.0,144,3,4,1,8,0xb2d1ce2f
17227.64,1.0,3,2,2,4,8,0xb2d4e842
56004.18,2.0,69,3,3,1,7,0xb2d64193d
51972.72,2.0,25,2,3,2,7,0xb2d1941e
37044.95,2.0,1,2,3,4,9,0xb2d067b4d
500000.0,3.0,20,4,4,2,10,0xb2d953b3d
20423.57,2.0,41,2,3,2,7,0xb2d30a55
0.0,1.0,115,1,2,1,4,0xb2d0ba17d
4412.46,1.0,92,2,2,1,5,0xb2d22417d
379239.67,7.0,27,4,4,2,10,0xb2d26e25
2875.22,1.0,9,1,2,3,6,0xb2d9253e
1416.49,4.0,184,1,4,1,6,0x3b9aeed2d
1030010.87,2.0,27,4,3,2,9,0xb2d8689ed
20047.42,1.0,7,2,2,3,7,0xb2d8d3c8d
502347.74,4.0,8,4,4,3,11,0xb2d16dfa
33217.71,4.0,83,2,4,1,7,0xb2d09f9ad
440814.31,5.0,0,4,4,4,12,0xb2d83c35d
735.5,1.0,6,1,2,3,6,0xb2d1acc7d
200010.42,2.0,4,3,3,4,10,0xb2da0217
76526.78,1.0,92,3,2,1,6,0xb2d3beb6
31733.94,1.0,3,2,2,4,8,0xb2d62cf2d
300011.64,3.0,132,3,4,1,8,0xb2d5ee74d
22708.23,1.0,30,2,2,2,6,0xb2d8dd2f
2701.34,1.0,0,1,2,4,7,0xb2d623f4d
51009.2,1.0,92,2,2,1,5,0xb2d3361ed
388015.37,4.0,6,4,4,3,11,0xb2d9c5e9
4132.31,1.0,159,2,2,1,5,0xb2d1fc8dd
103.18,1.0,21,1,2,2,5,0xb2d23f32
20042.19,2.0,4,2,3,4,9,0xb2d12c83d
172981.95,2.0,87,3,3,1,7,0xb2d13891d
30523.31,3.0,3,2,4,4,10,0x3b9b198bd
6220.32,1.0,20,2,2,2,6,0xb2d609fed
3221.04,1.0,2,2,2,4,8,0xb2d9769d
39.15,1.0,88,1,2,1,4,0xb2d69907d
212.17,1.0,0,1,2,4,7,0xb2d6e23d
9.26,1.0,48,1,2,2,5,0xb2d3efd7
2.2,1.0,5,1,2,3,6,0xb2d20aaa
13.04,1.0,3,1,2,4,7,0xb2d37c26
50611.13,2.0,52,2,3,2,7,0xb2d6cfcb
1627.57,1.0,10,1,2,3,6,0xb2d744dfd
300000.0,2.0,13,3,3,3,9,0xb2d96148
5253.4,1.0,3,2,2,4,8,0xb2d1537cd
1325.67,1.0,92,1,2,1,4,0xb2d241d5d
756074.57,3.0,119,4,4,1,9,0xb2d6dc76
14.78,1.0,75,1,2,1,4,0xb2d98daf
1497.73,1.0,11,1,2,3,6,0xb2d24996d
1830.68,1.0,184,1,2,1,4,0xb2d06a18d
60002.85,2.0,74,3,3,1,7,0xb2d8c368d
0.53,1.0,46,1,2,2,5,0xb2d9bf96
500000.0,3.0,8,4,4,3,11,0xb2da3ab5
2808.93,1.0,1,1,2,4,7,0xb2d8c3d1
15007.8,1.0,1,2,2,4,8,0xb2d29ad0
220348.43,3.0,9,3,4,3,10,0xb2d12cdd
500010.56,2.0,45,4,3,2,9,0xb2d91654d
852.15,1.0,10,1,2,3,6,0xb2d99aba
120876.97,4.0,0,3,4,4,11,0xb2d10b73d
186647.12,1.0,305,3,2,1,6,0xb2d4eb4b
12509.45,3.0,252,2,4,1,7,0xb2d286a4d
440642.31,6.0,28,4,4,2,10,0xb2d12b7fd
55.19,1.0,7,1,2,3,6,0xb2d586b1
253640.31,3.0,13,3,4,3,10,0xb2d68ff1d
683.77,1.0,6,1,2,3,6,0xb2d2aaa7
3.98,1.0,10,1,2,3,6,0xb2d78410
27.53,1.0,11,1,2,3,6,0xb2d610bb
1339.21,1.0,2,1,2,4,7,0xb2d91f4f
251888.03,4.0,46,3,4,2,9,0xb2d07ccf
9271.89,3.0,184,2,4,1,7,0x3b9b3285
532667.94,1.0,125,4,2,1,7,0xb2d26a10d
416824.62,3.0,0,4,4,4,12,0xb2d0d7d8
577000.0,4.0,4,4,4,4,12,0xb2d2ee06d
335.3,1.0,1,1,2,4,7,0xb2d8f964d
72571.65,1.0,0,3,2,4,9,0xb2d620ebd
1567.08,1.0,7,1,2,3,6,0xb2d2d81c
500010.56,2.0,18,4,3,2,9,0xb2da2b7b
1104.14,1.0,10,1,2,3,6,0xb2d3c062d
260944.17,3.0,0,3,4,4,11,0xb2d2817c
409011.56,4.0,3,4,4,4,12,0xb2d3bc74
50017.96,2.0,116,2,3,1,6,0xb2d101cf
155000.0,3.0,0,3,4,4,11,0xb2d23bc9
200053.96,2.0,27,3,3,2,8,0xb2d64c4b
67675.01,6.0,0,3,4,4,11,0xb2d54f13d
353.88,1.0,18,1,2,2,5,0xb2d37c74
1400044.33,2.0,63,4,3,2,9,0xb2d9b586
11769.52,4.0,184,2,4,1,7,0x3b9af560
8556.17,1.0,13,2,2,3,7,0xb2d4c9a2
526337.26,5.0,27,4,4,2,10,0xb2d4a625
501776.19,2.0,31,4,3,2,9,0xb2d8f0f8d
1012.75,1.0,184,1,2,1,4,0xb2d2228fd
252985.9,3.0,3,3,4,4,11,0xb2d62df7
580015.38,5.0,6,4,4,3,11,0xb2d5d723d
31040.42,2.0,232,2,3,1,6,0xb2d21e1cd
575.11,1.0,39,1,2,2,5,0xb2d91b9ed
1079.78,1.0,184,1,2,1,4,0xb2d21821d
13418.66,2.0,0,2,3,4,9,0xb2d1d92fd
0.0,2.0,5,1,3,3,7,0xb2d220b0d
435009.86,3.0,4,4,4,4,12,0xb2d500ccd
15.92,1.0,0,1,2,4,7,0xb2d59dcfd
30006.75,2.0,116,2,3,1,6,0xb2d10c88d
540005.7,2.0,32,4,3,2,9,0xb2da00cc
13.41,1.0,55,1,2,2,5,0xb2d4feb7
19381.06,1.0,1,2,2,4,8,0xb2d40c26
250169.16,5.0,1,3,4,4,11,0xb2d5b9cc
9.09,1.0,5,1,2,3,6,0xb2d8fc38
423086.32,6.0,16,4,4,2,10,0xb2d14072d
12000000.0,3.0,3,4,4,4,12,0xb2d96acfd
42.52,1.0,84,1,2,1,4,0xb2d1cb78
10.76,1.0,25,1,2,2,5,0xb2d9e656
3204171.31,7.0,0,4,4,4,12,0xb2d8e820d
200015.31,2.0,12,3,3,3,9,0xb2d5e83bd
308736.52,3.0,3,4,4,4,12,0xb2d5fcafd
752395.08,3.0,3,4,4,4,12,0xb2d5ee64d
1.62,2.0,65,1,3,2,6,0xb2d1ab1b
11392.94,1.0,9,2,2,3,7,0xb2d8caf2d
638807.97,9.0,47,4,4,2,10,0xb2d41c3ad
319.46,1.0,16,1,2,2,5,0xb2d8fe19
1202165.02,26.0,0,4,4,4,12,0xb2d559e6d
1616.76,1.0,184,1,2,1,4,0xb2d1ace0d
260638.8,4.0,25,3,4,2,9,0xb2d17910d
150069.99,2.0,14,3,3,3,9,0xb2d19f65d
300000.0,2.0,12,3,3,3,9,0xb2d8e4d4d
645.67,1.0,10,1,2,3,6,0xb2d26719
2960.33,2.0,2,2,3,4,9,0xb2d0680bd
51019.18,2.0,6,2,3,3,8,0xb2d6b117d
4005.67,1.0,0,2,2,4,8,0xb2d53f57
600000.18,6.0,1,4,4,4,12,0xb2d1c1ded
8646.29,4.0,20,2,4,2,8,0xb2d11ed9
30000.01,2.0,1,2,3,4,9,0xb2da01c4
2005.28,1.0,92,1,2,1,4,0xb2d5d887d
2000031.67,3.0,18,4,4,2,10,0xb2da2309
30862.54,1.0,21,2,2,2,6,0xb2d30423d
2966408.28,2.0,21,4,3,2,9,0xb2d57882d
18118.81,1.0,92,2,2,1,5,0xb2d0eae4d
292.49,1.0,9,1,2,3,6,0xb2d8d257
4191.42,1.0,184,2,2,1,5,0xb2d1dca0d
11818.22,1.0,4,2,2,4,8,0xb2d22a06d
7309.15,1.0,18,2,2,2,6,0xb2d70561d
377235.16,12.0,6,4,4,3,11,0xb2d57ec9
684894.88,3.0,17,4,4,2,10,0xb2d2577ed
202008.76,3.0,10,3,4,3,10,0xb2d23f9bd
50001.06,2.0,39,2,3,2,7,0xb2d9ef22
55332.49,1.0,9,3,2,3,8,0xb2d5d811d
413699.52,3.0,82,4,4,1,9,0xb2d62ca4d
12047.89,2.0,0,2,3,4,9,0xb2d8a857
300056.09,5.0,108,3,4,1,8,0x3b9b2fbb
400008.45,2.0,123,4,3,1,8,0xb2d93831
213003.96,5.0,4,3,4,4,11,0xb2d95200d
10055.27,2.0,6,2,3,3,8,0xb2d9fcbd
37737.69,1.0,1,2,2,4,8,0xb2d1a786d
190.47,3.0,0,1,4,4,9,0xb2d06806
360095.91,2.0,0,4,3,4,11,0xb2d6157bd
500000.02,2.0,28,4,3,2,9,0xb2d65635
3213911.35,63.0,4,4,4,4,12,0xb2d14106
638145.28,5.0,2,4,4,4,12,0xb2d1a1d4
50002.16,2.0,97,2,3,1,6,0xb2d57f85
60097.49,1.0,16,3,2,2,7,0xb2d3a0e9
300000.16,2.0,21,3,3,2,8,0xb2d8d3d1d
92341.01,2.0,101,3,3,1,7,0xb2d114cc
60076.75,5.0,53,3,4,2,9,0xb2d5e554d
315855.99,2.0,139,4,3,1,8,0xb2d12699d
260715.31,4.0,1,3,4,4,11,0xb2d3c9e3
570748.15,6.0,100,4,4,1,9,0xb2d14e35
113571.56,3.0,92,3,4,1,8,0xb2d28b63d
1669000.63,34.0,0,4,4,4,12,0xb2d53c3fd
39877.8,3.0,7,2,4,3,9,0xb2d1f05fd
3560701.32,8.0,3,4,4,4,12,0xb2d6134fd
39.22,1.0,0,1,2,4,7,0xb2d9be86
2294.79,1.0,92,1,2,1,4,0xb2d11795d
793288.63,1.0,5,4,2,3,9,0xb2d5613dd
1.53,1.0,15,1,2,3,6,0xb2d6ef71
901017.46,3.0,2,4,4,4,12,0xb2d1b5d7d
1.59,1.0,8,1,2,3,6,0xb2d8e94e
350719.4,4.0,32,4,4,2,10,0xb2d9f574
3745.32,1.0,165,2,2,1,5,0xb2d32e4cd
480085.67,5.0,6,4,4,3,11,0xb2d14ffdd
121.14,1.0,33,1,2,2,5,0xb2d54b28
38406.01,4.0,27,2,4,2,8,0xb2d43053d
2193.32,1.0,92,1,2,1,4,0xb2d59f25d
87.23,1.0,14,1,2,3,6,0xb2d80409
100738.11,2.0,62,3,3,2,8,0xb2d18461d
500107.35,3.0,10,4,4,3,11,0xb2d21b27d
488.21,1.0,21,1,2,2,5,0xb2d34b12
28320.07,1.0,8,2,2,3,7,0xb2d24340
9933.55,2.0,92,2,3,1,6,0xb2d09323d
470000.0,2.0,5,4,3,3,10,0xb2d96961
7038.67,1.0,192,2,2,1,5,0xb2d65593d
30023.9,2.0,13,2,3,3,8,0xb2da31b3
1010.14,1.0,92,1,2,1,4,0xb2d626acd
0.0,1.0,8,1,2,3,6,0xb2d55eadd
2841.38,1.0,1,1,2,4,7,0xb2d31390d
1800067.23,5.0,8,4,4,3,11,0xb2d2c305d
20001.99,2.0,73,2,3,1,6,0xb2d786b6d
221024.68,3.0,55,3,4,2,9,0xb2d2bb50d
210751.24,2.0,75,3,3,1,7,0xb2d389d6d
2543.36,1.0,9,1,2,3,6,0xb2d9dd2c
1213.64,1.0,29,1,2,2,5,0xb2d65c5e
107925.56,2.0,67,3,3,1,7,0xb2d28941d
71175.91,1.0,4,3,2,4,9,0xb2d2a3a0d
2338.24,1.0,13,1,2,3,6,0xb2d1291d
150001.06,3.0,4,3,4,4,11,0xb2da4856
539358.57,2.0,76,4,3,1,8,0xb2d39110d
1519.35,7.0,11,1,4,3,8,0xb2d8fb9bd
202142.89,3.0,4,3,4,4,11,0xb2d1527ed
200000.0,2.0,12,3,3,3,9,0xb2da488f
532049.89,4.0,134,4,4,1,9,0xb2d0881b
200755.36,3.0,0,3,4,4,11,0xb2d10318
36.09,1.0,92,1,2,1,4,0xb2d25099d
4095.24,1.0,9,2,2,3,7,0xb2d6e94bd
381826.3,4.0,67,4,4,1,9,0xb2d20474d
50002.11,1.0,4,2,2,4,8,0xb2da412a
671310.87,9.0,0,4,4,4,12,0xb2d095acd
330044.23,3.0,53,4,4,2,10,0xb2d8fbbbd
11038.7,1.0,184,2,2,1,5,0xb2d1d92c
3019.22,1.0,11,2,2,3,7,0xb2d57b82
3493164.48,8.0,70,4,4,1,9,0xb2d26032d
602124.32,3.0,26,4,4,2,10,0xb2d6dd2ed
180005.72,2.0,92,3,3,1,7,0xb2d63cd9d
710130.94,4.0,5,4,4,3,11,0x3b9b4514d
500005.3,2.0,92,4,3,1,8,0xb2d6070b
301543.65,3.0,4,4,4,4,12,0xb2d0e0b7d
1730.43,1.0,184,1,2,1,4,0xb2d3e5b5d
107.33,2.0,73,1,3,1,5,0xb2d4ffe3
200720.42,2.0,5,3,3,3,9,0xb2d933bad
300480.07,2.0,15,4,3,3,10,0xb2d62217
103246.72,1.0,81,3,2,1,6,0xb2d0f1a8d
95.88,1.0,53,1,2,2,5,0xb2d42e6c
117.45,1.0,28,1,2,2,5,0xb2d337f1
53.61,6.0,1,1,4,4,9,0xb2d1de30d
23737.73,1.0,1,2,2,4,8,0xb2d5298fd
6221.69,1.0,97,2,2,1,5,0xb2d68b2a
649.17,1.0,4,1,2,4,7,0xb2d52535d
84.8,1.0,24,1,2,2,5,0xb2d6af74d
194631.72,1.0,0,3,2,4,9,0xb2d42f51d
80.19,1.0,101,1,2,1,4,0xb2d20dce
287285.87,1.0,2,3,2,4,9,0xb2d7010fd
777.6,1.0,14,1,2,3,6,0xb2d34efb
2911.5,1.0,92,2,2,1,5,0xb2d26430d
15714.16,1.0,0,2,2,4,8,0xb2d6a9e0d
321993.38,11.0,13,4,4,3,11,0x3b9b2950d
875045.47,9.0,10,4,4,3,11,0xb2d60814d
2317.98,1.0,92,1,2,1,4,0xb2d30a5c
4142.71,1.0,40,2,2,2,6,0xb2d820a6
619.54,1.0,4,1,2,4,7,0xb2d7172ed
476.81,1.0,1,1,2,4,7,0xb2d8f4a9d
1426.85,1.0,92,1,2,1,4,0xb2d11fb4d
500029.93,2.0,24,4,3,2,9,0xb2d9478bd
719517.42,4.0,0,4,4,4,12,0xb2d291e0d
92524.03,2.0,27,3,3,2,8,0xb2d1be46
18071.26,2.0,0,2,3,4,9,0xb2d64d6c
1452.99,1.0,0,1,2,4,7,0xb2d22c50
1115.23,1.0,64,1,2,2,5,0xb2d1ea3cd
3087.49,1.0,201,2,2,1,5,0xb2d52b01d
400684.64,2.0,60,4,3,2,9,0xb2d5641cd
700054.1,4.0,23,4,4,2,10,0xb2d68bc1
319728.4,6.0,3,4,4,4,12,0xb2d49048d
1600.22,1.0,184,1,2,1,4,0xb2d26aa6d
360423.76,2.0,76,4,3,1,8,0xb2d56c74
250208.82,2.0,2,3,3,4,10,0xb2d68686
62.87,1.0,89,1,2,1,4,0xb2d5a7db
495371.95,3.0,0,4,4,4,12,0xb2d5d5e0d
53248.44,1.0,0,3,2,4,9,0xb2d36b35d
102190.67,1.0,5,3,2,3,8,0xb2d8a672d
3469045.77,10.0,38,4,4,2,10,0xb2d08322d
100002.11,2.0,59,3,3,2,8,0xb2d658a7d
50001.17,2.0,52,2,3,2,7,0xb2d273ebd
205475.6,2.0,53,3,3,2,8,0xb2d55c22d
11025.37,1.0,0,2,2,4,8,0xb2d2f15f
2506426.52,9.0,1,4,4,4,12,0xb2d642bf
211977.1,6.0,0,3,4,4,11,0xb2d1a4cd
0.33,1.0,0,1,2,4,7,0xb2d26d61
80004.24,2.0,216,3,3,1,7,0xb2d43c2d
155920.62,5.0,0,3,4,4,11,0xb2d08457d
915.43,1.0,72,1,2,1,4,0xb2d1cdaed
650000.89,5.0,0,4,4,4,12,0xb2d41e24
5385.4,1.0,11,2,2,3,7,0xb2d6e7e4
4351.58,1.0,184,2,2,1,5,0xb2d1fe90d
11852.53,1.0,2,2,2,4,8,0xb2d3f3eed
15.19,1.0,46,1,2,2,5,0xb2d177c0
216072.8,11.0,2,3,4,4,11,0xb2d0683ad
435022.66,5.0,18,4,4,2,10,0xb2d5bb1a
3504373.14,4.0,0,4,4,4,12,0xb2d228ae
120271.75,2.0,15,3,3,3,9,0xb2d12898
1275.3,1.0,0,1,2,4,7,0xb2d8ee07
4000.1,1.0,0,2,2,4,8,0xb2d5278fd
2045764.49,2.0,3,4,3,4,11,0xb2d652e0
3287.39,1.0,216,2,2,1,5,0xb2d4cb6f
501881.59,3.0,31,4,4,2,10,0xb2d8de5a
81698.58,3.0,6,3,4,3,10,0xb2d2d50ad
2998.76,1.0,7,2,2,3,7,0xb2d3e8d4
430195.71,2.0,49,4,3,2,9,0xb2d22b6bd
501010.52,6.0,69,4,4,1,9,0xb2d0796ad
300040.96,2.0,193,3,3,1,7,0xb2d1e342d
10211.97,1.0,14,2,2,3,7,0xb2d6215cd
7033.47,1.0,9,2,2,3,7,0xb2d6337b
50002.11,2.0,202,2,3,1,6,0xb2d69214
52364.14,2.0,164,3,3,1,7,0xb2d1c2d2
146.95,1.0,9,1,2,3,6,0xb2d39a88
847092.85,7.0,21,4,4,2,10,0xb2d2224bd
143006.39,3.0,11,3,4,3,10,0xb2d56e73d
863.27,1.0,9,1,2,3,6,0xb2d28f45d
68.54,1.0,13,1,2,3,6,0xb2d8d549
85451.37,2.0,9,3,3,3,9,0xb2d238b1
20289.21,1.0,15,2,2,3,7,0xb2d84773d
760002.8,3.0,21,4,4,2,10,0xb2d90c5fd
37.16,1.0,75,1,2,1,4,0xb2d5ee2fd
371880.04,12.0,0,4,4,4,12,0x3b9b1806d
237008.66,5.0,3,3,4,4,11,0xb2d256d0d
308388.05,2.0,129,4,3,1,8,0xb2d6c498d
274.29,1.0,48,1,2,2,5,0xb2d3e881
890058.58,10.0,3,4,4,4,12,0xb2d1c78a
1667.8,1.0,10,1,2,3,6,0xb2d24f21d
708216.79,4.0,19,4,4,2,10,0xb2d58defd
57741.94,1.0,10,3,2,3,8,0xb2d27c4ad
5511.97,2.0,0,2,3,4,9,0x3b9ad002d
0.0,24.0,89,1,4,1,6,0xb2d108df
220002.32,2.0,92,3,3,1,7,0xb2d63803
21072.17,2.0,77,2,3,1,6,0xb2d55bc7d
100000.0,2.0,3,3,3,4,10,0xb2d0d49bd
500011.66,2.0,19,4,3,2,9,0xb2d60ce8d
400414.95,6.0,0,4,4,4,12,0xb2d62889
317637.79,2.0,52,4,3,2,9,0xb2d6b0d2
28579.71,1.0,14,2,2,3,7,0xb2d43673d
301468.83,3.0,36,4,4,2,10,0xb2d60672
745045.04,8.0,6,4,4,3,11,0xb2d12847d
70002.0,4.0,0,3,4,4,11,0xb2d625c4
2101298.19,4.0,18,4,4,2,10,0xb2d6fcccd
50218.1,2.0,56,2,3,2,7,0xb2d981a0
250000.04,2.0,3,3,3,4,10,0xb2d9b5fc
1635789.98,15.0,5,4,4,3,11,0xb2d2393f
7703.02,1.0,8,2,2,3,7,0xb2d6da17
146.35,1.0,3,1,2,4,7,0xb2d98fdf
40001.27,2.0,38,2,3,2,7,0xb2d925d0
382864.83,4.0,20,4,4,2,10,0xb2d07afc
7641.64,1.0,12,2,2,3,7,0xb2d4ada3
5457.13,1.0,24,2,2,2,6,0xb2d1d0d2
783.48,1.0,58,1,2,2,5,0xb2d3441dd
21.58,1.0,48,1,2,2,5,0xb2d97f40
1413145.06,12.0,18,4,4,2,10,0xb2d0c54dd
489428.56,9.0,4,4,4,4,12,0xb2d3bc8ad
105014.13,6.0,39,3,4,2,9,0xb2d5f6e1d
224411.61,1.0,0,3,2,4,9,0xb2d68311
30430.46,2.0,11,2,3,3,8,0xb2d0bfd9
327190.86,7.0,9,4,4,3,11,0xb2d8c67bd
204267.93,3.0,9,3,4,3,10,0x3b9adbab
108331.53,5.0,0,3,4,4,11,0xb2d16858
1500000.68,2.0,91,4,3,1,8,0xb2d0dfce
139251.65,2.0,14,3,3,3,9,0xb2d10667
301855.51,3.0,13,4,4,3,11,0xb2d8048cd
15048.66,1.0,122,2,2,1,5,0xb2d401c3d
941082.79,7.0,3,4,4,4,12,0xb2d103a7
198.77,1.0,25,1,2,2,5,0xb2d18d0f
280093.89,3.0,196,3,4,1,8,0xb2d0bf7fd
495947.53,5.0,0,4,4,4,12,0xb2d637cbd
51938.48,1.0,92,2,2,1,5,0xb2d4908fd
2.12,1.0,4,1,2,4,7,0xb2d29ba2d
490064.02,3.0,4,4,4,4,12,0xb2d94b02d
17.96,1.0,21,1,2,2,5,0xb2d2eecdd
1004.19,1.0,184,1,2,1,4,0xb2d5d70fd
27.85,1.0,11,1,2,3,6,0xb2d60aef
13153822.45,36.0,1,4,4,4,12,0x3b9adcc4
100692.91,2.0,153,3,3,1,7,0xb2d682dfd
3440.1,1.0,0,2,2,4,8,0xb2d5c78e
702518.5,2.0,35,4,3,2,9,0xb2d90b54d
1000361.92,3.0,0,4,4,4,12,0xb2d915f9
1403.3,1.0,0,1,2,4,7,0xb2d92d2b
790818.37,4.0,15,4,4,3,11,0xb2d4ac35
39000.26,2.0,92,2,3,1,6,0xb2d3be4dd
100367.86,3.0,0,3,4,4,11,0x3b9af101d
1984775.36,14.0,0,4,4,4,12,0x3b9b0e6ad
345076.87,10.0,2,4,4,4,12,0xb2d59812
3.45,1.0,1,1,2,4,7,0xb2d6a988
50000.53,2.0,41,2,3,2,7,0xb2d921b2d
4560.52,1.0,60,2,2,2,6,0xb2d234a8d
600033.41,4.0,17,4,4,2,10,0xb2d1c327
1711.2,1.0,173,1,2,1,4,0xb2d11ab5d
495.03,1.0,82,1,2,1,4,0xb2d35742
164271.73,4.0,56,3,4,2,9,0xb2d38cbdd
310210.35,2.0,21,4,3,2,9,0xb2d98c8f
7.86,1.0,1,1,2,4,7,0xb2d3f70c
1819544.69,11.0,0,4,4,4,12,0xb2d1b5a4
136960.22,4.0,1,3,4,4,11,0xb2d283ecd
200630.51,2.0,1,3,3,4,10,0xb2d2173bd
103004.13,3.0,91,3,4,1,8,0xb2d4fe38d
407820.77,3.0,22,4,4,2,10,0xb2d65335
320074.2,2.0,7,4,3,3,10,0xb2d5945ad
21231.98,1.0,10,2,2,3,7,0xb2d93f18
64790.8,1.0,21,3,2,2,7,0xb2d37c83d
145001.53,2.0,49,3,3,2,8,0xb2d9d83a
203.25,1.0,20,1,2,2,5,0xb2d39695
500000.22,5.0,2,4,4,4,12,0xb2d6c6cd
22.57,1.0,82,1,2,1,4,0xb2d83cd1
1355.65,1.0,98,1,2,1,4,0xb2d51ff3
0.0,2.0,4,1,3,4,8,0xb2d26f56
862064.86,4.0,0,4,4,4,12,0xb2d24269
13695.29,1.0,109,2,2,1,5,0xb2d67d86
86004.67,4.0,4,3,4,4,11,0xb2d42848d
1200008.84,4.0,26,4,4,2,10,0xb2d70665
8907.6,1.0,19,2,2,2,6,0xb2d478ce
1004.65,1.0,7,1,2,3,6,0xb2d5cbb8
3764068.32,15.0,13,4,4,3,11,0xb2d6ce97d
5053.58,1.0,92,2,2,1,5,0xb2d2432ad
1275.2,1.0,0,1,2,4,7,0xb2d8c64d
1217.81,1.0,92,1,2,1,4,0xb2d0d939d
1207.87,2.0,305,1,3,1,5,0xb2d09f4dd
500000.0,2.0,0,4,3,4,11,0xb2d2c797
50315.96,2.0,90,2,3,1,6,0xb2d57a97d
246.32,1.0,76,1,2,1,4,0xb2d94aed
974000.0,3.0,1,4,4,4,12,0xb2d0d959d
42379.1,3.0,35,2,4,2,8,0xb2d2b5c8
11873.48,1.0,1,2,2,4,8,0xb2d962e9
25.33,1.0,60,1,2,2,5,0xb2d99f71
989.22,1.0,1,1,2,4,7,0xb2d1e955d
420341.49,3.0,18,4,4,2,10,0xb2d26f4dd
50007.7,2.0,66,2,3,2,7,0xb2d235c9d
5000148.22,2.0,21,4,3,2,9,0xb2d95bc4d
496.7,1.0,3,1,2,4,7,0xb2d6f5ee
3176.19,1.0,0,2,2,4,8,0xb2d95ed1
15772.4,1.0,1,2,2,4,8,0xb2d34f88
28.27,1.0,92,1,2,1,4,0xb2d0a51ed
451208.12,8.0,18,4,4,2,10,0xb2d61980
10000.21,2.0,18,2,3,2,7,0xb2da2a0b
245.19,3.0,0,1,4,4,9,0xb2d0b0ba
10027.65,2.0,99,2,3,1,6,0xb2d5d519
1597499.98,25.0,39,4,4,2,10,0xb2d0e97a
2011501.88,7.0,4,4,4,4,12,0xb2d0faced
23102.74,1.0,99,2,2,1,5,0xb2d18694
442815.58,3.0,0,4,4,4,12,0xb2d6f4cbd
400000.51,2.0,26,4,3,2,9,0xb2d6e28e
82004.66,4.0,0,3,4,4,11,0xb2d619a0d
37667.72,1.0,215,2,2,1,5,0xb2d141a3
1534.32,1.0,121,1,2,1,4,0xb2d43dccd
90003.16,3.0,4,3,4,4,11,0xb2d96b37d
1900024.83,16.0,6,4,4,3,11,0xb2d11c46d
675.14,1.0,0,1,2,4,7,0xb2d89001
54224.17,1.0,11,3,2,3,8,0xb2d42392d
44788.7,4.0,3,2,4,4,10,0xb2d5bfb1d
208642.61,3.0,1,3,4,4,11,0xb2d39f91d
130005.0,3.0,188,3,4,1,8,0xb2d58ee4d
10003.5,2.0,108,2,3,1,6,0xb2d285bf
1777012.27,18.0,1,4,4,4,12,0xb2d40ec0d
1304.08,1.0,184,1,2,1,4,0xb2d395fdd
625.03,1.0,14,1,2,3,6,0xb2d22109
2952.59,1.0,184,2,2,1,5,0xb2d23338d
51.88,1.0,6,1,2,3,6,0xb2d60c44
678237.53,1.0,0,4,2,4,10,0xb2d5ce09d
10009.72,1.0,102,2,2,1,5,0xb2d96cb9
1654792.54,2.0,125,4,3,1,8,0xb2d0ebbf
100908.52,2.0,235,3,3,1,7,0xb2d17d0cd
430808.85,6.0,116,4,4,1,9,0xb2d643dbd
133727.88,3.0,0,3,4,4,11,0xb2d21116d
628.05,1.0,35,1,2,2,5,0xb2d45ec1d
6286.8,1.0,1,2,2,4,8,0xb2d22373
203704.78,2.0,117,3,3,1,7,0xb2d558e7d
200006.33,2.0,80,3,3,1,7,0xb2d98a45
37178.14,2.0,0,2,3,4,9,0xb2d4f586
3004.66,1.0,246,2,2,1,5,0xb2d1aff4d
1225.91,1.0,0,1,2,4,7,0xb2d54fdd
270093.91,15.0,11,3,4,3,10,0xb2d6200e
1229.09,1.0,92,1,2,1,4,0xb2d2722fd
450009.31,3.0,30,4,4,2,10,0xb2d3258c
0.0,1.0,3,1,2,4,7,0xb2d48757
74.09,1.0,12,1,2,3,6,0xb2d1d599d
82906.79,1.0,26,3,2,2,7,0xb2d69b16d
860749.42,8.0,3,4,4,4,12,0x3b9b1bc6d
603884.29,16.0,10,4,4,3,11,0xb2d0bfc9d
1675.05,1.0,69,1,2,1,4,0xb2d9aac5
447574.3,9.0,206,4,4,1,9,0x3b9b1262d
140009.57,2.0,74,3,3,1,7,0xb2d39f06
80007.95,3.0,42,3,4,2,9,0xb2d98e8a
25818.12,1.0,7,2,2,3,7,0xb2d41e64
876.49,1.0,8,1,2,3,6,0xb2da3c69
30112.83,3.0,4,2,4,4,10,0xb2d9b970
180.85,1.0,16,1,2,2,5,0xb2d20d79
465.24,1.0,4,1,2,4,7,0xb2d2b3b3d
404318.59,3.0,13,4,4,3,11,0xb2d64914
197833.05,5.0,0,3,4,4,11,0xb2d09350
10000.21,2.0,18,2,3,2,7,0xb2d95413d
229964.18,3.0,13,3,4,3,10,0xb2d56179d
10000.42,2.0,35,2,3,2,7,0xb2d9f774
1.17,1.0,27,1,2,2,5,0xb2d4658e
5059.37,1.0,7,2,2,3,7,0xb2d565f3
6263.67,1.0,0,2,2,4,8,0xb2d9d145
1007.28,1.0,7,1,2,3,6,0xb2d6b71c
150003.69,3.0,94,3,4,1,8,0xb2d80f04
3874.24,1.0,0,2,2,4,8,0xb2d6f6be
307469.48,2.0,43,4,3,2,9,0xb2d66a6ad
51460.26,2.0,25,2,3,2,7,0xb2d61c2a
32981.32,2.0,1,2,3,4,9,0xb2d06c47d
202154.77,2.0,99,3,3,1,7,0xb2d5a579
274.75,1.0,3,1,2,4,7,0xb2d1e096d
100045.99,2.0,7,3,3,3,9,0xb2d15a8e
2.49,1.0,31,1,2,2,5,0xb2d7d45f
160101.27,4.0,4,3,4,4,11,0xb2da3a5f
625000.13,2.0,17,4,3,2,9,0xb2d8c6a4d
2349259.41,26.0,0,4,4,4,12,0xb2d327a1
401685.36,3.0,28,4,4,2,10,0xb2d905ead
80073.5,3.0,3,3,4,4,11,0xb2d69aee
746196.88,10.0,8,4,4,3,11,0xb2d347d8d
268.03,1.0,13,1,2,3,6,0xb2d4a982
0.0,1.0,7,1,2,3,6,0xb2d6a0f2
154042.7,2.0,104,3,3,1,7,0xb2d5eb4dd
820078.6,4.0,14,4,4,3,11,0xb2d5d989d
1230.36,1.0,92,1,2,1,4,0xb2d427ded
837137.93,5.0,3,4,4,4,12,0xb2d17297d
1308026.14,4.0,0,4,4,4,12,0xb2d8cabdd
500007.3,3.0,48,4,4,2,10,0xb2d23aae
241879.74,1.0,1,3,2,4,9,0xb2d5f80e
200000.0,2.0,7,3,3,3,9,0xb2da5404
177003.63,6.0,3,3,4,4,11,0xb2d45cc1d
300018.0,2.0,0,3,3,4,10,0xb2d97a26
20005.25,2.0,122,2,3,1,6,0xb2d1a219d
5996.42,1.0,0,2,2,4,8,0xb2d6b77ad
110019.7,2.0,77,3,3,1,7,0xb2d0c8ff
2094.66,1.0,0,1,2,4,7,0xb2d69a33
2348.69,1.0,0,1,2,4,7,0xb2d27f23
1637.22,3.0,0,1,4,4,9,0xb2d586ff
37431.3,1.0,92,2,2,1,5,0xb2d43c04d
209715.74,10.0,0,3,4,4,11,0x3b9b1bf7d
16948.54,3.0,1,2,4,4,10,0x3b9b18d1
576677.24,4.0,15,4,4,3,11,0xb2d63d99d
204266.41,2.0,203,3,3,1,7,0xb2d693bcd
550030.34,6.0,48,4,4,2,10,0xb2d19771d
50000.0,1.0,4,2,2,4,8,0xb2da5f9c
21504.28,1.0,19,2,2,2,6,0xb2d68535
22501.85,1.0,208,2,2,1,5,0xb2d2c440d
340088.61,2.0,53,4,3,2,9,0xb2d18970
110020.98,2.0,63,3,3,2,8,0xb2d3db33d
314030.93,4.0,4,4,4,4,12,0x3b9ad0ddd
1657.94,1.0,14,1,2,3,6,0xb2d28984
476973.86,5.0,35,4,4,2,10,0xb2d24be6d
1000735.41,3.0,172,4,4,1,9,0xb2d2994a
255.73,1.0,4,1,2,4,7,0xb2d0c446
926.8,1.0,73,1,2,1,4,0xb2d27405
10167.08,2.0,182,2,3,1,6,0xb2d4264a
10003.72,1.0,0,2,2,4,8,0xb2d9dc59
443000.0,5.0,3,4,4,4,12,0xb2d3d2aed
19.16,1.0,18,1,2,2,5,0xb2d9f194
0.55,1.0,5,1,2,3,6,0xb2d192f7d
168.11,1.0,48,1,2,2,5,0xb2d53166
253908.03,5.0,28,3,4,2,9,0xb2d0a3d2d
109218.13,4.0,132,3,4,1,8,0x3b9b259ed
320462.35,3.0,1,4,4,4,12,0xb2d46393d
678119.33,3.0,0,4,4,4,12,0xb2d3d38f
261343.55,2.0,97,3,3,1,7,0xb2d0e20bd
2111.35,1.0,21,1,2,2,5,0x3b9ae8ba
0.22,1.0,3,1,2,4,7,0xb2d629a0
938.68,1.0,7,1,2,3,6,0xb2d1aded
673057.42,4.0,182,4,4,1,9,0xb2d2d34ed
19379.26,1.0,1,2,2,4,8,0xb2d1bab7
100851.45,3.0,18,3,4,2,9,0xb2d2e8f6
737897.21,3.0,0,4,4,4,12,0xb2d1856ad
80020.97,3.0,0,3,4,4,11,0xb2d5ced4d
10337.88,1.0,20,2,2,2,6,0xb2d6c3ff
11931.75,1.0,0,2,2,4,8,0xb2d180c8
71633.23,2.0,32,3,3,2,8,0xb2d25d5fd
21713.66,1.0,29,2,2,2,6,0xb2d8eba6d
8568.1,1.0,184,2,2,1,5,0xb2d1e9c4d
100160.03,2.0,51,3,3,2,8,0xb2d271c3
338000.0,21.0,3,4,4,4,12,0xb2d323ecd
21.37,1.0,19,1,2,2,5,0xb2d623c5
108.47,3.0,10,1,4,3,8,0xb2d0aa93
844351.92,4.0,27,4,4,2,10,0xb2d1bb4d
800937.15,3.0,0,4,4,4,12,0xb2d5cf4e
102604.02,1.0,10,3,2,3,8,0xb2d2129a
2260099.96,14.0,1,4,4,4,12,0xb2da34a6
86718.36,2.0,104,3,3,1,7,0xb2d16a79d
1070001.48,3.0,23,4,4,2,10,0xb2d90d56d
130000.0,3.0,0,3,4,4,11,0xb2d1d38d
4930.56,1.0,0,2,2,4,8,0xb2d34543d
1037012.21,4.0,90,4,4,1,9,0xb2d06875
12514.48,1.0,83,2,2,1,5,0xb2d17cecd
11505.01,1.0,12,2,2,3,7,0xb2d2f44dd
46713737.35,3.0,89,4,4,1,9,0xb2d4f14bd
170058.89,3.0,10,3,4,3,10,0xb2d0f4b2d
1317.33,1.0,92,1,2,1,4,0xb2d30e5fd
372358.14,8.0,0,4,4,4,12,0x3b9b0e57d
8627.65,3.0,184,2,4,1,7,0xb2d40194d
168224.9,2.0,0,3,3,4,10,0xb2d210b6
3505046.25,3.0,6,4,4,3,11,0xb2d1964d
40000.42,2.0,41,2,3,2,7,0xb2d921c8d
2156.81,1.0,22,1,2,2,5,0xb2d8692a
95519.77,6.0,75,3,4,1,8,0xb2d53c6bd
100004.22,2.0,92,3,3,1,7,0xb2d64820d
100013.72,2.0,5,3,3,3,9,0xb2d95b6dd
5884.12,1.0,33,2,2,2,6,0xb2d2e439
160001.21,3.0,3,3,4,4,11,0xb2d26f9ed
470009.36,2.0,14,4,3,3,10,0xb2d95fc6d
115843.13,1.0,25,3,2,2,7,0xb2d51c72d
36000.0,5.0,184,2,4,1,7,0xb2d1352a
50006.29,2.0,143,2,3,1,6,0xb2d5e59f
715.29,1.0,0,1,2,4,7,0xb2d11d72
51530.88,1.0,92,2,2,1,5,0xb2d2d12e
50284.74,2.0,1,2,3,4,9,0xb2d249c3d
10164.86,1.0,10,2,2,3,7,0xb2d58b70
252090.5,4.0,1,3,4,4,11,0xb2d8d4d2
200715.19,3.0,1,3,4,4,11,0x3b9b2560d
240014.05,3.0,48,3,4,2,9,0xb2d67de4
201421.04,2.0,68,3,3,1,7,0xb2d9b071
20002.36,3.0,6,2,4,3,9,0xb2d5e979
61000.0,3.0,1,3,4,4,11,0xb2d5a07bd
515077.79,2.0,83,4,3,1,8,0xb2d15ad4d
32216.53,1.0,182,2,2,1,5,0xb2d1a54cd
7219171.58,14.0,1,4,4,4,12,0xb2d40d4fd
433000.86,5.0,99,4,4,1,9,0xb2d55b4dd
975251.02,5.0,41,4,4,2,10,0xb2d3d134
50057.54,1.0,18,2,2,2,6,0xb2d6a715d
1.58,1.0,146,1,2,1,4,0xb2d906e2
13.82,1.0,80,1,2,1,4,0xb2d6d70c
105128.03,2.0,0,3,3,4,10,0xb2d7882b
305370.57,6.0,12,4,4,3,11,0xb2d5e3b3
50384.21,15.0,6,2,4,3,9,0x3b9af207
150199.75,2.0,46,3,3,2,8,0xb2d458b5
180.77,1.0,145,1,2,1,4,0xb2d5d5d2
575370.19,8.0,0,4,4,4,12,0xb2d0d1d2d
201496.73,2.0,26,3,3,2,8,0xb2d5b664
375.13,1.0,20,1,2,2,5,0xb2d4350c
9000011.26,4.0,1,4,4,4,12,0xb2d3512d
476975.14,5.0,0,4,4,4,12,0xb2d1341ad
30454.01,1.0,94,2,2,1,5,0xb2d488c0d
832.84,1.0,26,1,2,2,5,0xb2d586fa
133601.59,3.0,6,3,4,3,10,0xb2d9eec4
256427.22,2.0,108,3,3,1,7,0xb2d62b41d
413091.96,4.0,49,4,4,2,10,0xb2d1212bd
96441.9,2.0,38,3,3,2,8,0xb2d62718
10218.71,1.0,3,2,2,4,8,0xb2d92216
36343131.41,9.0,4,4,4,4,12,0xb2d227ded
2991.75,1.0,153,2,2,1,5,0xb2d31044
40277.21,2.0,167,2,3,1,6,0xb2d65a95d
151110.5,1.0,5,3,2,3,8,0xb2d2bb08
938202.55,7.0,68,4,4,1,9,0xb2d07e3ed
591.84,1.0,0,1,2,4,7,0xb2d8eeb5
60.47,1.0,0,1,2,4,7,0xb2d15b2ed
120108.89,2.0,21,3,3,2,8,0xb2d8337fd
9768.6,1.0,14,2,2,3,7,0xb2d25c79d
17289.3,1.0,14,2,2,3,7,0xb2d6c169
182017.08,4.0,27,3,4,2,9,0xb2d5a600d
327244.46,4.0,66,4,4,2,10,0xb2d5c5dad
200674.48,4.0,1,3,4,4,11,0xb2d0b032d
394873.33,3.0,1,4,4,4,12,0xb2d60af7
8269.12,1.0,9,2,2,3,7,0xb2d3f1ecd
226009.83,4.0,47,3,4,2,9,0xb2d5c0d5
245.98,1.0,84,1,2,1,4,0xb2d22ea3
6138.68,1.0,0,2,2,4,8,0xb2d50dd2
0.42,1.0,8,1,2,3,6,0xb2d69a48d
2709.66,1.0,184,1,2,1,4,0xb2d2164fd
53009.02,2.0,66,3,3,2,8,0xb2d281a0
813.12,1.0,4,1,2,4,7,0xb2d3c1b8
200254.34,1.0,9,3,2,3,8,0xb2d5312ad
9793.85,3.0,0,2,4,4,10,0xb2d0bf3fd
240012.8,2.0,32,3,3,2,8,0xb2d9f6e3
1349.16,1.0,17,1,2,2,5,0xb2d242db
53.78,1.0,7,1,2,3,6,0xb2d3157cd
723.35,1.0,6,1,2,3,6,0xb2d1ea37
60092.05,2.0,6,3,3,3,9,0xb2d31f86d
2913.57,3.0,1,2,4,4,10,0xb2d9e6d1
2.46,1.0,32,1,2,2,5,0xb2d57154
4534.59,1.0,6,2,2,3,7,0xb2d49103d
1341.08,1.0,9,1,2,3,6,0xb2d69691
1588.62,1.0,92,1,2,1,4,0xb2d1bec5d
106.39,1.0,19,1,2,2,5,0xb2d48a0dd
450008.09,4.0,21,4,4,2,10,0xb2d63803d
390126.71,5.0,5,4,4,3,11,0xb2d6114b
50009.74,2.0,196,2,3,1,6,0xb2d32dadd
3641.81,1.0,92,2,2,1,5,0xb2d16cf1d
275993.8,3.0,11,3,4,3,10,0xb2d64677
107032.55,1.0,34,3,2,2,7,0xb2d3259b
5.81,1.0,75,1,2,1,4,0xb2d96309
7017.36,1.0,29,2,2,2,6,0xb2d928d0
793000.47,4.0,0,4,4,4,12,0xb2d4d4a0d
202184.92,2.0,75,3,3,1,7,0xb2d6ca65
15160.49,1.0,7,2,2,3,7,0xb2d95453
4.78,2.0,20,1,3,2,6,0xb2d31700
1005.29,1.0,27,1,2,2,5,0xb2da0646
100091.46,6.0,0,3,4,4,11,0xb2d2e992d
427568.44,6.0,74,4,4,1,9,0xb2d3a250d
0.72,2.0,9,1,3,3,7,0xb2d5ae84d
1000000.0,1.0,0,4,2,4,10,0xb2d64345d
40.14,3.0,17,1,4,2,7,0xb2d3fbe3d
442251.26,3.0,31,4,4,2,10,0xb2d53edcd
471569.02,5.0,120,4,4,1,9,0xb2d2b384d
280180.96,3.0,46,3,4,2,9,0xb2d3e54bd
3228.83,1.0,24,2,2,2,6,0xb2d51faf
1.5,1.0,62,1,2,2,5,0xb2d643c8
520.23,4.0,0,1,4,4,9,0x3b9af0d7d
1986.03,1.0,231,1,2,1,4,0xb2d68bacd
497071.47,2.0,123,4,3,1,8,0xb2d5f83cd
3039.69,1.0,0,2,2,4,8,0xb2d6e7d0
60331.17,4.0,55,3,4,2,9,0xb2d64844d
243331.47,4.0,0,3,4,4,11,0xb2d56149d
5329.08,1.0,3,2,2,4,8,0xb2d3f302d
300006.49,3.0,45,3,4,2,9,0xb2d0dbdad
50001.58,2.0,92,2,3,1,6,0xb2d97e81d
50001.58,2.0,165,2,3,1,6,0xb2d8e030d
169.35,1.0,4,1,2,4,7,0xb2d68b0f
192197.11,2.0,21,3,3,2,8,0xb2d93623d
1815607.45,4.0,31,4,4,2,10,0xb2d42746d
733363.35,4.0,38,4,4,2,10,0xb2d0f37dd
314063.3,3.0,46,4,4,2,10,0xb2d5ffead
52.26,1.0,8,1,2,3,6,0xb2d4a25c
208212.81,2.0,111,3,3,1,7,0xb2d61ed1d
407000.0,9.0,0,4,4,4,12,0xb2d41456d
6254.97,1.0,1,2,2,4,8,0xb2d6f575
350107.96,7.0,62,4,4,2,10,0xb2d5a74bd
7663.54,1.0,0,2,2,4,8,0xb2d68cf7d
37759.49,2.0,28,2,3,2,7,0xb2d689a8
55299.44,2.0,76,3,3,1,7,0xb2d5875bd
216108.29,2.0,10,3,3,3,9,0xb2d19234d
2544.1,1.0,46,1,2,2,5,0xb2d1fa0d
159.41,2.0,21,1,3,2,6,0xb2d4f0de
1985704.36,69.0,0,4,4,4,12,0xb2d4a6ce
40028.73,3.0,0,2,4,4,10,0xb2d271ea
1667.59,1.0,165,1,2,1,4,0xb2d30838d
8715.38,1.0,5,2,2,3,7,0xb2d20e8b
3462.59,1.0,3,2,2,4,8,0xb2d80372d
109742.55,1.0,1,3,2,4,9,0xb2d3907ed
8042.32,1.0,184,2,2,1,5,0xb2d4ee04d
40079.2,1.0,130,2,2,1,5,0xb2d8f0fa
15581.17,2.0,131,2,3,1,6,0xb2d537f5d
1.59,1.0,6,1,2,3,6,0xb2d22093d
300962.2,8.0,0,4,4,4,12,0xb2d0e3f0
1030.36,1.0,184,1,2,1,4,0xb2d16626
2371.27,1.0,19,1,2,2,5,0xb2d976fc
400.9,1.0,32,1,2,2,5,0xb2d5d59cd
4.17,1.0,42,1,2,2,5,0xb2d40f87d
37684.74,2.0,184,2,3,1,6,0xb2d16bdcd
17000.67,2.0,6,2,3,3,8,0xb2d60711
302131.51,2.0,63,4,3,2,9,0xb2d9b9c4
2981535.71,10.0,27,4,4,2,10,0xb2d9451cd
50000.84,2.0,4,2,3,4,9,0xb2d9ad61
27908.95,2.0,127,2,3,1,6,0xb2d51832
252828.61,5.0,0,3,4,4,11,0xb2d1a3e6d
410383.24,12.0,4,4,4,4,12,0x3b9b12c4d
103966.64,1.0,184,3,2,1,6,0xb2d3d931d
889724.73,7.0,0,4,4,4,12,0xb2d5987ad
47770.98,1.0,5,2,2,3,7,0xb2d2a405d
8583.62,1.0,10,2,2,3,7,0xb2d2b79bd
5439.36,2.0,72,2,3,1,6,0xb2d12750d
4697.4,1.0,184,2,2,1,5,0x3b9b29d4d
2848.04,3.0,0,1,4,4,9,0xb2d2082cd
219.22,2.0,53,1,3,2,6,0x3b9b33a5d
33633.13,1.0,9,2,2,3,7,0xb2d517d0
541537.01,6.0,1,4,4,4,12,0xb2d13c1b
1141.55,1.0,184,1,2,1,4,0xb2d15962d
15142.28,2.0,7,2,3,3,8,0xb2d5e620d
252000.0,3.0,3,3,4,4,11,0xb2d4fd4e
2696.92,1.0,0,1,2,4,7,0xb2d3198b
40083.44,2.0,4,2,3,4,9,0xb2d19fc8
913.02,1.0,0,1,2,4,7,0xb2d361d9d
787085.99,3.0,52,4,4,2,10,0xb2d36cf1
310683.95,1.0,202,4,2,1,7,0xb2d46c36d
27795.4,1.0,11,2,2,3,7,0xb2d272bd
798083.91,13.0,0,4,4,4,12,0xb2d5cf8ed
297714.37,6.0,3,3,4,4,11,0xb2d6ffbf
4450000.08,7.0,0,4,4,4,12,0xb2d93021
200733.16,2.0,19,3,3,2,8,0xb2d8d019d
400015.02,3.0,9,4,4,3,11,0xb2d57747d
300000.0,2.0,1,3,3,4,10,0xb2da6690
37099.43,2.0,73,2,3,1,6,0xb2d5ac11d
517000.01,16.0,0,4,4,4,12,0xb2d57bab
1822048.9,10.0,76,4,4,1,9,0xb2d0ddd8
280108.25,4.0,102,3,4,1,8,0xb2d4b32ad
0.0,1.0,1,1,2,4,7,0xb2d454eb
3.03,1.0,39,1,2,2,5,0xb2d324ea
2215.28,1.0,0,1,2,4,7,0xb2d3d6db
15932.19,4.0,0,2,4,4,10,0xb2d64ff5
263465.72,4.0,97,3,4,1,8,0xb2d5d5b6d
501000.0,6.0,4,4,4,4,12,0xb2d20773d
460031.9,4.0,0,4,4,4,12,0xb2d6a101d
240065.1,2.0,20,3,3,2,8,0xb2d78dbb
1951627.84,4.0,60,4,4,2,10,0xb2d0ced8d
334.29,1.0,3,1,2,4,7,0xb2d57dffd
37349.59,1.0,5,2,2,3,7,0xb2d2b7c1d
465494.13,2.0,48,4,3,2,9,0xb2d3b4fdd
296.63,1.0,0,1,2,4,7,0xb2d2e871d
700007.39,2.0,14,4,3,3,10,0xb2da3836
315000.87,3.0,6,4,4,3,11,0xb2d20b7ed
4019.97,1.0,189,2,2,1,5,0xb2d6d755d
1250083.63,5.0,0,4,4,4,12,0xb2d5486c
37.27,1.0,16,1,2,2,5,0xb2d5f803d
12048.54,1.0,8,2,2,3,7,0xb2d458e6d
18043.1,1.0,7,2,2,3,7,0xb2d32665d
660251.32,12.0,8,4,4,3,11,0xb2d56fd3d
400710.84,3.0,14,4,4,3,11,0xb2d9bdb1
8378.42,6.0,184,2,4,1,7,0x3b9b32ccd
24554.91,1.0,12,2,2,3,7,0xb2d6c2c8d
8994.26,1.0,92,2,2,1,5,0xb2d5c832
400057.49,3.0,10,4,4,3,11,0xb2d79119d
1654.9,1.0,5,1,2,3,6,0xb2d2fff3d
97249.75,1.0,28,3,2,2,7,0xb2d20eecd
1313201.1,7.0,3,4,4,4,12,0xb2d55abad
681.62,1.0,70,1,2,1,4,0xb2d35b43
0.0,2.0,5,1,3,3,7,0xb2d0b1ccd
500010.57,2.0,102,4,3,1,8,0xb2d963a1d
29.18,1.0,42,1,2,2,5,0xb2d9e22f
70.88,1.0,6,1,2,3,6,0xb2d7c2eb
1047.79,2.0,21,1,3,2,6,0xb2d5faa6d
43010.59,2.0,11,2,3,3,8,0xb2d9bb67
507.12,1.0,16,1,2,2,5,0xb2d91c87
311275.56,3.0,104,4,4,1,9,0xb2d06e26d
100002.61,3.0,20,3,4,2,9,0xb2d9127dd
60.28,1.0,25,1,2,2,5,0xb2d3fcd4
1.77,1.0,8,1,2,3,6,0xb2d62d72
45.39,1.0,36,1,2,2,5,0xb2d9b2a0
442060.55,5.0,52,4,4,2,10,0xb2d37501
156266.08,1.0,186,3,2,1,6,0xb2d101f1d
35.41,1.0,63,1,2,2,5,0xb2d17d66d
80102.12,7.0,0,3,4,4,11,0xb2d53608
50000.53,3.0,25,2,4,2,8,0xb2da145e
918940.34,3.0,17,4,4,2,10,0xb2d5ce1cd
5.8,1.0,4,1,2,4,7,0xb2d2c99d
459231.4,6.0,63,4,4,2,10,0xb2d61997d
150064.96,3.0,18,3,4,2,9,0xb2d45820d
50055.98,2.0,18,2,3,2,7,0xb2d956edd
950001.58,3.0,2,4,4,4,12,0xb2da2f57
203601.36,2.0,166,3,3,1,7,0xb2d4279ad
29531.47,1.0,0,2,2,4,8,0xb2d32916d
331079.45,6.0,8,4,4,3,11,0xb2d28970d
302146.33,2.0,60,4,3,2,9,0xb2d9b25e
62.93,1.0,77,1,2,1,4,0xb2d982f3d
1448.51,1.0,110,1,2,1,4,0xb2d531ac
50001995.48,3.0,47,4,4,2,10,0x3b9aeb3cd
519.96,1.0,4,1,2,4,7,0xb2d26770
212.59,1.0,6,1,2,3,6,0xb2d341f4
2.83,1.0,19,1,2,2,5,0xb2d6c965
400021.47,4.0,41,4,4,2,10,0xb2d1ff05d
265159.05,8.0,14,3,4,3,10,0xb2d3dd78
21671.82,1.0,92,2,2,1,5,0xb2d1351e
3530.44,1.0,184,2,2,1,5,0xb2d344f5d
7294.23,1.0,223,2,2,1,5,0xb2d3b78ed
600.21,1.0,0,1,2,4,7,0xb2d467f1d
4000.92,1.0,4,2,2,4,8,0xb2d80523
63945.33,1.0,1,3,2,4,9,0xb2d52e61d
203687.59,2.0,84,3,3,1,7,0xb2d6bc7ed
4074.28,1.0,0,2,2,4,8,0xb2d7d47d
118041.24,2.0,181,3,3,1,7,0xb2d12090d
1197.55,1.0,1,1,2,4,7,0xb2d2fe2f
1964.9,1.0,23,1,2,2,5,0xb2d2617ad
186468.01,1.0,213,3,2,1,6,0xb2d4eb4bd
2670.2,1.0,16,1,2,2,5,0xb2d2ecced
2880.38,1.0,184,1,2,1,4,0xb2d2345bd
1011.27,1.0,92,1,2,1,4,0xb2d0ea7ed
640000.0,4.0,4,4,4,4,12,0xb2d8f2cdd
3771.5,1.0,0,2,2,4,8,0xb2d959cf
77.88,1.0,10,1,2,3,6,0xb2d6fa11d
1120.57,1.0,92,1,2,1,4,0xb2d34927d
258168.01,3.0,33,3,4,2,9,0xb2d3fb0fd
30.37,1.0,5,1,2,3,6,0xb2d60ac8
203031.7,3.0,118,3,4,1,8,0xb2d413bd
400115.36,6.0,11,4,4,3,11,0xb2d10643
154002.23,4.0,0,3,4,4,11,0xb2d0d58b
1968.25,1.0,1,1,2,4,7,0xb2d90311
1105.76,1.0,92,1,2,1,4,0xb2d610b7
270000.0,2.0,25,3,3,2,8,0xb2d94563d
412786.06,2.0,17,4,3,2,9,0xb2d6f173d
675.09,1.0,9,1,2,3,6,0xb2d2f11ed
5783.36,1.0,0,2,2,4,8,0xb2d6b4f0
515899.13,4.0,3,4,4,4,12,0xb2d24109d
40000.42,2.0,48,2,3,2,7,0xb2d9cc31
600847.36,5.0,0,4,4,4,12,0xb2d2d0abd
300053.24,3.0,14,3,4,3,10,0xb2d8d036d
208899.91,1.0,9,3,2,3,8,0xb2d5b131d
262036.52,4.0,3,3,4,4,11,0xb2d5cbd0d
52004.45,2.0,199,2,3,1,6,0xb2d4eec8
473745.21,9.0,12,4,4,3,11,0xb2d3e517d
1027275.49,26.0,0,4,4,4,12,0xb2d33084d
26.44,1.0,55,1,2,2,5,0xb2d3df3e
503851.19,12.0,52,4,4,2,10,0xb2d2604b
100000.36,8.0,0,3,4,4,11,0xb2d5ea48d
86.8,1.0,10,1,2,3,6,0xb2d475e3
14.98,1.0,8,1,2,3,6,0xb2d6cebf
600044.75,10.0,1,4,4,4,12,0xb2d20fa1d
91309.96,2.0,161,3,3,1,7,0xb2d28c16d
480235.65,6.0,10,4,4,3,11,0xb2d44b2ed
136451.91,1.0,1,3,2,4,9,0xb2d17f1bd
30872.9,2.0,17,2,3,2,7,0xb2d0b59ed
20384.12,1.0,0,2,2,4,8,0xb2d1271c
2057.49,1.0,22,1,2,2,5,0xb2d2f237
1.07,1.0,76,1,2,1,4,0xb2d5cdf1
7036.96,1.0,15,2,2,3,7,0xb2d93ec1
10146.76,2.0,62,2,3,2,7,0xb2d6a42bd
132.45,1.0,22,1,2,2,5,0xb2d69aa9
48.62,1.0,46,1,2,2,5,0xb2d59227
150002.92,2.0,73,3,3,1,7,0xb2d6f283
217482.91,5.0,4,3,4,4,11,0xb2d62300d
500072.88,10.0,2,4,4,4,12,0xb2d5e230d
35042.93,1.0,7,2,2,3,7,0xb2d1f751d
1004297.27,2.0,31,4,3,2,9,0xb2d8d935
2448.01,1.0,92,1,2,1,4,0xb2d10c87d
11472.35,1.0,22,2,2,2,6,0xb2d1ea6ed
90109.42,5.0,73,3,4,1,8,0xb2d235e9d
27808.53,1.0,0,2,2,4,8,0xb2d7ae9ad
171768.55,5.0,38,3,4,2,9,0xb2d1b9ffd
1092384.72,4.0,7,4,4,3,11,0xb2d242d4
200002.11,2.0,118,3,3,1,7,0xb2d781b2
450000.79,2.0,26,4,3,2,9,0xb2d68a3a
222188.02,1.0,0,3,2,4,9,0xb2d6f391
903334.75,4.0,12,4,4,3,11,0xb2d577af
2842.65,1.0,116,1,2,1,4,0xb2d4cc1ad
16.24,1.0,29,1,2,2,5,0xb2d2c018
322974.25,3.0,18,4,4,2,10,0xb2d16984
135838.17,3.0,21,3,4,2,9,0xb2d3280dd
134277.47,1.0,1,3,2,4,9,0xb2d59ce9
202211.94,2.0,112,3,3,1,7,0xb2d56b03d
4013.11,1.0,184,2,2,1,5,0xb2d1d853d
1262.02,1.0,92,1,2,1,4,0xb2d5ae38d
16001.17,1.0,0,2,2,4,8,0xb2d6ca57d
109.17,1.0,75,1,2,1,4,0xb2d56828
350044.39,4.0,1,4,4,4,12,0xb2d18885
15.83,1.0,62,1,2,2,5,0xb2d89361
1696271.82,11.0,24,4,4,2,10,0xb2d24625d
46130.83,16.0,18,2,4,2,8,0x3b9ada99d
26877.09,1.0,5,2,2,3,7,0xb2d39c14d
500000.0,14.0,3,4,4,4,12,0x3b9b366cd
2841621.67,12.0,8,4,4,3,11,0xb2d288e0d
10000.42,2.0,214,2,3,1,6,0xb2d74be6
2317.97,1.0,10,1,2,3,6,0xb2d57cee
18.85,1.0,1,1,2,4,7,0xb2d19f72d
2033.05,3.0,60,1,4,2,7,0xb2d22ba4d
115688.37,3.0,0,3,4,4,11,0xb2d1812e
961.34,1.0,195,1,2,1,4,0xb2d40e6cd
1762.3,1.0,3,1,2,4,7,0xb2d32f37
100.51,1.0,0,1,2,4,7,0xb2d8a64ad
129.28,1.0,0,1,2,4,7,0xb2d2817a
260019.06,3.0,48,3,4,2,9,0xb2d8ffeed
11769.01,1.0,21,2,2,2,6,0xb2d96587
7348.46,1.0,127,2,2,1,5,0xb2d90d03d
664800.77,13.0,3,4,4,4,12,0xb2d0c608d
903482.13,11.0,33,4,4,2,10,0xb2d13220d
234847.77,2.0,13,3,3,3,9,0xb2d1bb4b
0.0,1.0,0,1,2,4,7,0xb2da5d2c
58567.66,1.0,0,3,2,4,9,0xb2d1f489d
21147.01,1.0,8,2,2,3,7,0xb2d57c14d
56027.7,1.0,9,3,2,3,8,0xb2d42a0cd
80022.86,2.0,73,3,3,1,7,0xb2d5d24ed
305332.35,2.0,23,4,3,2,9,0xb2d6bbd9d
767137.56,18.0,6,4,4,3,11,0xb2d09892d
4002.27,1.0,19,2,2,2,6,0xb2d6b6ca
21167.16,1.0,21,2,2,2,6,0xb2d37c7fd
98636.29,1.0,0,3,2,4,9,0xb2d64a47d
2502.16,1.0,18,1,2,2,5,0xb2d8c82f
30.44,1.0,0,1,2,4,7,0xb2d18f37
207576.05,3.0,28,3,4,2,9,0xb2d34e5dd
370001.0,6.0,28,4,4,2,10,0xb2d55c73d
1670.49,1.0,9,1,2,3,6,0xb2d6c7fc
500000.16,2.0,8,4,3,3,10,0xb2d93005d
15312.82,1.0,92,2,2,1,5,0xb2d30448
300012.78,4.0,27,3,4,2,9,0xb2d6d4fcd
22506.54,2.0,74,2,3,1,6,0x3b9b3363d
150000.0,2.0,0,3,3,4,10,0xb2d9819b
1.73,1.0,57,1,2,2,5,0xb2d2d78e
32570.59,1.0,184,2,2,1,5,0xb2d2d9b5d
76099.58,5.0,10,3,4,3,10,0xb2d5b9d9
95065.35,7.0,1,3,4,4,11,0xb2d28292
40013.73,3.0,21,2,4,2,8,0xb2d548dcd
200031.64,2.0,8,3,3,3,9,0xb2d824ddd
13467.01,1.0,0,2,2,4,8,0xb2d6a8fb
760.17,1.0,5,1,2,3,6,0xb2d91360
218.02,2.0,20,1,3,2,6,0xb2d9e79f
100002.11,2.0,24,3,3,2,8,0xb2d949b6
0.05,1.0,4,1,2,4,7,0xb2d61e35
1065.73,1.0,54,1,2,2,5,0xb2d6c5e4d
60086.92,3.0,87,3,4,1,8,0xb2d63eedd
250000.0,3.0,5,3,4,3,10,0xb2d1801ed
5.49,1.0,12,1,2,3,6,0xb2d14685d
32.68,1.0,60,1,2,2,5,0xb2d32021
3680.45,1.0,0,2,2,4,8,0xb2d64a2ed
30000.63,2.0,45,2,3,2,7,0xb2d91886
50002.11,2.0,224,2,3,1,6,0xb2d6f9d3
31.91,1.0,53,1,2,2,5,0xb2d44aa5d
401421.25,3.0,9,4,4,3,11,0xb2d98779
100004.22,2.0,6,3,3,3,9,0xb2d967f3d
42.17,1.0,8,1,2,3,6,0xb2d90bdc
760094.14,7.0,0,4,4,4,12,0xb2d16a85d
453987.58,3.0,76,4,4,1,9,0xb2d65891d
80801.56,3.0,18,3,4,2,9,0xb2d2ffa0d
1116.35,1.0,92,1,2,1,4,0xb2d1ba65d
10004.5,2.0,28,2,3,2,7,0xb2d6ab15
3744059.68,2.0,53,4,3,2,9,0xb2d1070ad
10003.39,2.0,80,2,3,1,6,0xb2d5978c
180008.89,3.0,45,3,4,2,9,0xb2d84dbbd
61.32,1.0,4,1,2,4,7,0xb2d53b77
307561.42,4.0,67,4,4,1,9,0xb2d6ef04d
160508.12,1.0,1,3,2,4,9,0xb2d6fd03d
1018.88,1.0,92,1,2,1,4,0xb2d40cbdd
100547.06,1.0,4,3,2,4,9,0xb2d61a80
202939.02,3.0,18,3,4,2,9,0xb2d1cacfd
4278.29,1.0,92,2,2,1,5,0xb2d2ec2cd
37709.45,1.0,45,2,2,2,6,0xb2d4acd6
6118.94,1.0,0,2,2,4,8,0xb2d69ee6
150004.75,2.0,39,3,3,2,8,0xb2d9eaf7
190.92,1.0,1,1,2,4,7,0xb2d50778
105443.37,2.0,221,3,3,1,7,0xb2d4e72fd
220002.32,2.0,8,3,3,3,9,0xb2da4c8c
70820.94,2.0,48,3,3,2,8,0xb2d630e5d
2831.1,1.0,7,1,2,3,6,0xb2d403f0d
1773.89,1.0,5,1,2,3,6,0xb2d6b952
70357.61,1.0,11,3,2,3,8,0xb2d6f1c1d
112010.15,3.0,19,3,4,2,9,0xb2d56bdc
275.84,1.0,0,1,2,4,7,0xb2d2dae5
987584.28,8.0,70,4,4,1,9,0xb2d26cbcd
300005.29,3.0,144,3,4,1,8,0xb2d783f1d
1905649.33,13.0,0,4,4,4,12,0xb2d0d98f
25635.27,7.0,273,2,4,1,7,0xb2d3fb2ad
0.16,1.0,13,1,2,3,6,0xb2d41f60
202408.72,2.0,64,3,3,2,8,0xb2d56862
2030.39,2.0,9,1,3,3,7,0xb2d1a63ad
30000.32,2.0,196,2,3,1,6,0xb2d7ec1c
510664.16,2.0,126,4,3,1,8,0xb2d824e1d
273241.42,2.0,20,3,3,2,8,0xb2d75b92d
315036.42,5.0,28,4,4,2,10,0xb2d41e68d
1410.97,1.0,92,1,2,1,4,0xb2d219a5
6781.75,1.0,215,2,2,1,5,0xb2d212afd
2169.15,1.0,13,1,2,3,6,0xb2d54b7ad
400000.0,24.0,0,4,4,4,12,0xb2d56611d
10000.32,2.0,213,2,3,1,6,0xb2d684a1
181699.74,2.0,3,3,3,4,10,0xb2d5b0be
260000.34,3.0,4,3,4,4,11,0xb2d31187
24282.64,3.0,45,2,4,2,8,0xb2d0958dd
15667.61,1.0,10,2,2,3,7,0xb2d949b0
850487.02,25.0,0,4,4,4,12,0xb2d1b150
1215.51,1.0,25,1,2,2,5,0xb2d2ae15d
121.11,1.0,10,1,2,3,6,0xb2d64f86d
810940.89,2.0,25,4,3,2,9,0xb2d34e54
100002.11,2.0,67,3,3,1,7,0xb2d9ac8d
34180.77,2.0,92,2,3,1,6,0xb2d1f0a1d
200010.28,2.0,11,3,3,3,9,0xb2da215f
17843.37,3.0,4,2,4,4,10,0x3b9b3254d
255966.27,3.0,0,3,4,4,11,0xb2d24edad
822138.17,6.0,0,4,4,4,12,0xb2d0e824d
157027.69,4.0,4,3,4,4,11,0xb2d10cfdd
500096.99,3.0,8,4,4,3,11,0xb2d956fc
1383.94,1.0,4,1,2,4,7,0xb2d3312bd
700004.22,3.0,8,4,4,3,11,0xb2da2884
100004.22,2.0,92,3,3,1,7,0xb2d64879
128007.52,2.0,139,3,3,1,7,0xb2d53a60d
961042.51,2.0,6,4,3,3,10,0xb2d96182d
163821.73,3.0,13,3,4,3,10,0xb2d48c52d
100023.64,5.0,28,3,4,2,9,0xb2d50cf8
384255.62,2.0,4,4,3,4,11,0xb2d6f104d
2650014.5,4.0,6,4,4,3,11,0xb2d5a9bdd
5000067.36,3.0,22,4,4,2,10,0xb2d41325d
714.93,1.0,0,1,2,4,7,0xb2d2dfca
44.94,1.0,6,1,2,3,6,0xb2d5adce
360227.48,7.0,110,4,4,1,9,0xb2d4eaa5d
250083.49,3.0,126,3,4,1,8,0xb2d17d83d
519024.43,5.0,66,4,4,2,10,0xb2d5a660d
145006.3,3.0,60,3,4,2,9,0xb2d3a044
111289.56,2.0,1,3,3,4,10,0xb2d5f361
1.27,1.0,89,1,2,1,4,0xb2d16825
52385.82,2.0,245,3,3,1,7,0xb2d45ae2d
2612.89,1.0,184,1,2,1,4,0xb2d54c2bd
50000.53,2.0,14,2,3,3,8,0xb2da3855
325781.36,2.0,18,4,3,2,9,0xb2d5d42c
152040.73,3.0,19,3,4,2,9,0xb2d585c0d
15885.16,1.0,1,2,2,4,8,0xb2d3c61a
86067.98,5.0,12,3,4,3,10,0xb2d8faa5d
2736.66,1.0,2,1,2,4,7,0xb2d8ec43
44.18,1.0,59,1,2,2,5,0xb2d23652
140492.25,3.0,47,3,4,2,9,0xb2d4ef26d
1075.97,1.0,9,1,2,3,6,0xb2d36a0e
311.2,1.0,221,1,2,1,4,0xb2d4dd4a
320000.26,5.0,3,4,4,4,12,0xb2d1122b
6497309.82,2.0,35,4,3,2,9,0xb2d5dcfed
21081.54,2.0,34,2,3,2,7,0xb2d2ae4ed
795229.32,2.0,14,4,3,3,10,0xb2d40f55
24.63,1.0,8,1,2,3,6,0xb2d9a820
3.37,1.0,11,1,2,3,6,0xb2d5f1c8
0.0,1.0,7,1,2,3,6,0xb2d52c31d
100004.23,2.0,20,3,3,2,8,0xb2da1a71
605426.5,7.0,11,4,4,3,11,0xb2d64bcf
180008.23,3.0,52,3,4,2,9,0xb2d207d5d
1000064.17,3.0,13,4,4,3,11,0xb2d6dd3a
70000.0,2.0,5,3,3,3,9,0xb2d93158
444749.76,4.0,4,4,4,4,12,0xb2d594acd
208780.68,18.0,1,3,4,4,11,0x3b9b44c7d
51608.15,1.0,12,2,2,3,7,0xb2d6eb0b
20.56,1.0,10,1,2,3,6,0xb2d6da7c
522752.43,4.0,26,4,4,2,10,0xb2d3a10bd
13921.79,1.0,15,2,2,3,7,0xb2d717b9d
1110096.19,4.0,7,4,4,3,11,0xb2d22ef6
50046.4,2.0,143,2,3,1,6,0xb2d5cf67d
1016656.67,7.0,6,4,4,3,11,0xb2d2eb41d
1501658.37,8.0,0,4,4,4,12,0xb2d154b2
65450.55,3.0,56,3,4,2,9,0xb2d9a81d
210560.57,12.0,1,3,4,4,11,0xb2d229bcd
397549.14,10.0,1,4,4,4,12,0xb2d6325e
3606.76,1.0,184,2,2,1,5,0xb2d5c7b4d
1090000.33,7.0,5,4,4,3,11,0xb2d48277d
4.21,1.0,75,1,2,1,4,0xb2d69853
299625.65,2.0,8,3,3,3,9,0xb2d2965e
6576.89,1.0,28,2,2,2,6,0xb2d28541d
4589.33,1.0,184,2,2,1,5,0xb2d26f0b
410097.88,3.0,83,4,4,1,9,0xb2d0dc49d
215627.72,6.0,11,3,4,3,10,0xb2d55d22d
138016.29,4.0,27,3,4,2,9,0xb2d59558
831697.25,3.0,53,4,4,2,10,0xb2d168fbd
501068.95,6.0,0,4,4,4,12,0xb2d548a8d
101117.27,2.0,42,3,3,2,8,0xb2d90cfd
1143.55,1.0,2,1,2,4,7,0xb2d1fbd5
2.14,4.0,30,1,4,2,7,0xb2d2b977
61712.62,1.0,26,3,2,2,7,0xb2d255b0d
177.25,1.0,53,1,2,2,5,0xb2d35279d
0.0,1.0,0,1,2,4,7,0xb2d912f6d
151947.27,2.0,1,3,3,4,10,0xb2d655acd
1955.86,2.0,46,1,3,2,6,0xb2d5041ad
246008.73,5.0,53,3,4,2,9,0xb2d3d55e
933033.87,3.0,86,4,4,1,9,0xb2d39764d
2.17,1.0,28,1,2,2,5,0xb2d2cf3bd
17747.03,1.0,3,2,2,4,8,0xb2d2843b
20006.58,2.0,24,2,3,2,7,0xb2d5ea78d
19133.91,1.0,214,2,2,1,5,0xb2d090c1d
4108.37,1.0,114,2,2,1,5,0xb2d15bd4d
3434.18,1.0,0,2,2,4,8,0xb2d8fd9a
21801.69,1.0,13,2,2,3,7,0xb2d488bc
0.0,1.0,4,1,2,4,7,0xb2d3ba1a
500094.27,4.0,101,4,4,1,9,0xb2d43725d
35.19,1.0,27,1,2,2,5,0xb2d682ca
611.2,1.0,12,1,2,3,6,0xb2d6f550
1005.97,1.0,211,1,2,1,4,0xb2d45ce3d
350136.91,5.0,112,4,4,1,9,0xb2d60b69d
2108.66,1.0,0,1,2,4,7,0xb2d3e9f4
1000062.84,2.0,136,4,3,1,8,0xb2d1c1c6d
75291.4,2.0,146,3,3,1,7,0xb2d5e18ed
314.59,1.0,8,1,2,3,6,0xb2d8fa75d
300.19,1.0,8,1,2,3,6,0xb2d2bb59
155050.22,5.0,59,3,4,2,9,0xb2d4f161d
152029.8,7.0,1,3,4,4,11,0xb2d3fbe5d
74347.28,1.0,9,3,2,3,8,0xb2d2f7ff
38.14,1.0,4,1,2,4,7,0xb2d1eb9a
302462.02,3.0,83,4,4,1,9,0xb2d1c8eed
1038.98,1.0,0,1,2,4,7,0xb2d2dee3
396942.55,7.0,7,4,4,3,11,0xb2d58747
100771.17,2.0,0,3,3,4,10,0xb2d5b6e5
1704.26,1.0,184,1,2,1,4,0xb2d19e4b
4000459.43,8.0,0,4,4,4,12,0xb2d4562fd
131.85,1.0,22,1,2,2,5,0xb2d9e834
30510.96,1.0,12,2,2,3,7,0xb2d641cd
18595.11,1.0,21,2,2,2,6,0xb2d964a0
10114.28,2.0,60,2,3,2,7,0xb2d6ab15d
6.99,1.0,20,1,2,2,5,0xb2d23c9c
1000034.0,3.0,8,4,4,3,11,0xb2d4030ed
31766.86,3.0,7,2,4,3,9,0xb2d5d471d
3533.93,1.0,9,2,2,3,7,0xb2d4cb09
1356000.0,12.0,0,4,4,4,12,0xb2d14218
2888.9,1.0,167,2,2,1,5,0xb2d1b7c7d
50103.1,1.0,187,2,2,1,5,0xb2d2a8a1d
5414.94,1.0,0,2,2,4,8,0xb2d356d1d
617798.38,4.0,11,4,4,3,11,0xb2d6a246d
2130084.67,7.0,3,4,4,4,12,0xb2d62dfcd
2880005.48,5.0,1,4,4,4,12,0xb2d5d084d
5029.68,1.0,184,2,2,1,5,0xb2d4be15d
82847.65,2.0,92,3,3,1,7,0xb2d62aa7
536.01,1.0,23,1,2,2,5,0xb2d55af3
1369053.19,7.0,73,4,4,1,9,0xb2d5bcd8
1050.45,1.0,184,1,2,1,4,0x3b9b2325
78.61,2.0,18,1,3,2,6,0xb2d1a45cd
2081396.3,2.0,186,4,3,1,8,0xb2d308c1d
2068.39,1.0,92,1,2,1,4,0xb2d56e6c
228477.33,3.0,42,3,4,2,9,0xb2d59f52d
0.0,1.0,2,1,2,4,7,0xb2d22691
157015.43,2.0,0,3,3,4,10,0xb2d302c9
400000.0,3.0,29,4,4,2,10,0xb2da0aea
53.22,1.0,16,1,2,2,5,0xb2d9ec54
851602.23,5.0,5,4,4,3,11,0xb2d2d746d
435050.55,2.0,3,4,3,4,11,0xb2d21af0
4310.22,1.0,9,2,2,3,7,0xb2d2bbd3
798.03,2.0,47,1,3,2,6,0xb2d6b021
54968.82,1.0,3,3,2,4,9,0xb2d11fbcd
220014.94,2.0,45,3,3,2,8,0xb2d125c2d
400000.0,5.0,2,4,4,4,12,0xb2d23f5cd
172866.4,3.0,167,3,4,1,8,0xb2d38bb0d
200710.48,2.0,45,3,3,2,8,0xb2d5bd41
361166.2,2.0,139,4,3,1,8,0xb2d2e15ed
200742.02,2.0,39,3,3,2,8,0xb2d91e8cd
20009.86,2.0,235,2,3,1,6,0xb2d6e381d
1203322.29,2.0,70,4,3,1,8,0xb2d1a776
3.17,1.0,61,1,2,2,5,0xb2d9b317
3.89,1.0,12,1,2,3,6,0xb2d37c7d
5342.5,1.0,92,2,2,1,5,0x3b9b2ddad
2589.2,1.0,83,1,2,1,4,0xb2d284b6
91968.15,1.0,14,3,2,3,8,0xb2d637aed
140429.29,4.0,0,3,4,4,11,0xb2d12e08d
38.75,1.0,42,1,2,2,5,0xb2d565b5
2276913.82,14.0,14,4,4,3,11,0xb2d124bc
28563.78,1.0,19,2,2,2,6,0xb2d68ecfd
5005.14,1.0,83,2,2,1,5,0xb2d56c79
471424.81,5.0,10,4,4,3,11,0xb2d61a26d
275403.62,3.0,27,3,4,2,9,0xb2d910bed
9133.16,1.0,4,2,2,4,8,0xb2d26fc0d
500010.57,2.0,172,4,3,1,8,0xb2d8d632d
3707.44,4.0,0,2,4,4,10,0x3b9b0e25d
40147.2,1.0,23,2,2,2,6,0xb2d50992
805465.19,8.0,12,4,4,3,11,0x3b9af13b
2102.68,1.0,0,1,2,4,7,0xb2d26ed9
2708.91,1.0,0,1,2,4,7,0xb2d403b1
1467296.99,5.0,38,4,4,2,10,0xb2d0bd79d
242080.31,5.0,56,3,4,2,9,0xb2d58339d
1025.85,1.0,92,1,2,1,4,0xb2d08772d
369780.71,4.0,1,4,4,4,12,0xb2d41235
91.62,1.0,36,1,2,2,5,0xb2d5a916d
1211.75,1.0,184,1,2,1,4,0xb2d2e313d
4804.16,1.0,1,2,2,4,8,0xb2d6ffe8d
15001.58,2.0,18,2,3,2,7,0xb2d6598e
3027.92,1.0,92,2,2,1,5,0xb2d2ef7ad
0.0,1.0,48,1,2,2,5,0xb2d8e954d
774.29,1.0,12,1,2,3,6,0xb2d377bb
5341.24,1.0,11,2,2,3,7,0xb2d69b7cd
1137.6,1.0,184,1,2,1,4,0xb2d178b9d
101509.91,2.0,10,3,3,3,9,0xb2d32e2cd
399.16,1.0,47,1,2,2,5,0xb2d43751d
661883.55,6.0,3,4,4,4,12,0xb2d12f18
482847.57,3.0,18,4,4,2,10,0xb2d4e99dd
100257.26,2.0,60,3,3,2,8,0xb2d62cba
3946.82,1.0,3,2,2,4,8,0xb2d8f313
156474.49,3.0,4,3,4,4,11,0xb2d64f46d
102000.0,5.0,0,3,4,4,11,0xb2d26087d
60197.4,2.0,181,3,3,1,7,0xb2d17efe
15.2,1.0,10,1,2,3,6,0xb2d44c75d
1.29,1.0,31,1,2,2,5,0xb2d78688
47.94,1.0,9,1,2,3,6,0xb2d6b36b
3064.48,2.0,49,2,3,2,7,0xb2d6d0c3d
114.26,1.0,9,1,2,3,6,0xb2d3ab8c
1568.91,1.0,31,1,2,2,5,0xb2d4e143d
180021.07,3.0,8,3,4,3,10,0xb2d0713e
1050046.36,3.0,49,4,4,2,10,0xb2d5e671d
54035.09,2.0,83,3,3,1,7,0xb2d38ac3d
200015.62,2.0,24,3,3,2,8,0xb2d58dd9d
640701.91,4.0,27,4,4,2,10,0xb2d19268
158396.2,1.0,3,3,2,4,9,0xb2d6522b
177.47,1.0,3,1,2,4,7,0xb2d42bb2
8006.36,1.0,6,2,2,3,7,0xb2d754ed
60338.85,3.0,70,3,4,1,8,0xb2d50532d
3943.79,1.0,13,2,2,3,7,0xb2d8f3b0
100003.17,2.0,52,3,3,2,8,0xb2d907f2
20137.41,1.0,184,2,2,1,5,0xb2d3f298d
2502.01,3.0,0,1,4,4,9,0xb2d07299
3939.64,1.0,0,2,2,4,8,0xb2d6b8af
24143.48,1.0,0,2,2,4,8,0xb2d620c8d
1004396.18,5.0,110,4,4,1,9,0xb2d581a2d
2155.11,1.0,180,1,2,1,4,0xb2d37ff5d
401065.63,4.0,6,4,4,3,11,0xb2d62f1ad
30000.0,2.0,0,2,3,4,9,0xb2d97d1ed
358.91,1.0,47,1,2,2,5,0xb2d3b964d
201424.96,2.0,78,3,3,1,7,0xb2d639b5
1593550.27,8.0,30,4,4,2,10,0xb2d61f77d
21054.47,1.0,4,2,2,4,8,0xb2d5a733d
23770.27,1.0,7,2,2,3,7,0xb2d69a96
551954.41,2.0,35,4,3,2,9,0xb2d6e247d
62810.68,2.0,182,3,3,1,7,0xb2d4351ed
220000.0,3.0,0,3,4,4,11,0xb2da472d
460409.3,3.0,60,4,4,2,10,0xb2d24eb3d
980428.37,3.0,80,4,4,1,9,0xb2d563cfd
450698.56,2.0,15,4,3,3,10,0xb2d9d86a
2392.38,1.0,2,1,2,4,7,0xb2d6ebce
2.55,2.0,0,1,3,4,8,0xb2d6fff8
1043065.31,2.0,67,4,3,1,8,0xb2d65b3b
441729.18,5.0,18,4,4,2,10,0xb2d410cdd
43.54,1.0,0,1,2,4,7,0xb2d6a447d
11484.42,1.0,10,2,2,3,7,0xb2d62187d
20000.0,1.0,6,2,2,3,7,0xb2d4c1ecd
812421.95,5.0,0,4,4,4,12,0xb2d69086d
54033.2,2.0,125,3,3,1,7,0xb2d0d416d
30001.72,2.0,53,2,3,2,7,0xb2d9c742
460004.05,2.0,6,4,3,3,10,0xb2d78c11d
1.26,1.0,23,1,2,2,5,0xb2d6f74c
40156.03,1.0,92,2,2,1,5,0xb2d37be3d
2729809.41,4.0,5,4,4,3,11,0xb2d0d2bcd
250888.08,2.0,46,3,3,2,8,0xb2d9e58b
973.73,1.0,75,1,2,1,4,0xb2d3ba64d
103865.33,2.0,132,3,3,1,7,0xb2d54662d
103.48,1.0,30,1,2,2,5,0xb2d1d24ad
8597.22,1.0,60,2,2,2,6,0xb2d6e7aed
935.41,1.0,0,1,2,4,7,0xb2d58bce
3087.95,1.0,0,2,2,4,8,0xb2d6815e
600019.0,2.0,10,4,3,3,10,0xb2d96169
750114.05,4.0,52,4,4,2,10,0xb2d6217c
126.54,1.0,45,1,2,2,5,0xb2d0fbe8
70000.0,2.0,3,3,3,4,10,0xb2d0f69ed
41133.65,1.0,184,2,2,1,5,0xb2d112e9d
20079.45,1.0,143,2,2,1,5,0xb2d30c79d
20013.54,2.0,4,2,3,4,9,0xb2d587dcd
2886.7,1.0,2,2,2,4,8,0xb2d5e573
5048.01,1.0,92,2,2,1,5,0xb2d2a978d
86385.28,4.0,0,3,4,4,11,0xb2d09a86d
500022.05,2.0,102,4,3,1,8,0xb2d5fe00
4017.57,1.0,236,2,2,1,5,0xb2d4cd7dd
1094.84,1.0,0,1,2,4,7,0xb2d439b5d
248254.79,2.0,75,3,3,1,7,0xb2d1ac68d
585405.22,4.0,139,4,4,1,9,0xb2d42ffb
186020.19,2.0,92,3,3,1,7,0xb2d103c9d
19578.6,1.0,12,2,2,3,7,0xb2d59717d
481.62,1.0,4,1,2,4,7,0xb2d92cbb
2828.63,1.0,184,1,2,1,4,0x3b9b2b2ad
100160.02,2.0,173,3,3,1,7,0xb2d11810d
74965.89,1.0,4,3,2,4,9,0xb2d230a8d
3925.08,1.0,18,2,2,2,6,0xb2d2fc87
3.89,1.0,1,1,2,4,7,0xb2d53b28d
510153.21,3.0,0,4,4,4,12,0xb2d68493
55238.55,1.0,172,3,2,1,6,0xb2d29a91
7200.23,1.0,12,2,2,3,7,0xb2d96495d
1550.5,1.0,92,1,2,1,4,0xb2d4e2cdd
408586.6,3.0,105,4,4,1,9,0xb2d64914d
250002.64,1.0,11,3,2,3,8,0xb2da4c69
14.89,1.0,25,1,2,2,5,0xb2d22870d
150003.17,2.0,74,3,3,1,7,0xb2d5f205
190260.6,3.0,101,3,4,1,8,0xb2d5e103
34010.9,2.0,27,2,3,2,7,0xb2d6322cd
342868.19,2.0,56,4,3,2,9,0xb2d13f49d
581101.24,14.0,0,4,4,4,12,0xb2d5748bd
3194.4,1.0,159,2,2,1,5,0xb2d5d996d
5.75,1.0,145,1,2,1,4,0xb2d26d67d
2369.16,1.0,60,1,2,2,5,0xb2d64e6fd
15366.39,1.0,0,2,2,4,8,0xb2d18d80d
4483.46,1.0,273,2,2,1,5,0xb2d4a5b2d
300010.96,3.0,80,3,4,1,8,0xb2d108b4d
3139.62,1.0,0,2,2,4,8,0xb2d99fe3
755.51,3.0,11,1,4,3,8,0x3b9b1a18
1261.04,1.0,11,1,2,3,6,0xb2d3f2c2
6515.35,1.0,10,2,2,3,7,0xb2d202b8d
1.87,1.0,36,1,2,2,5,0xb2d61075
6769.36,1.0,0,2,2,4,8,0xb2d8e001
230004.86,2.0,185,3,3,1,7,0xb2d6ac7bd
631.59,1.0,17,1,2,2,5,0xb2d2406e
52001.49,4.0,6,2,4,3,9,0xb2d4ac79d
1789898.28,1.0,0,4,2,4,10,0xb2d6d1fb
6158.59,6.0,0,2,4,4,10,0xb2d09d5e
60004.55,3.0,12,3,4,3,10,0xb2d80280d
36735.89,2.0,206,2,3,1,6,0xb2d5bf67d
500026.39,2.0,42,4,3,2,9,0xb2d9e0c4
203554.14,2.0,125,3,3,1,7,0xb2d8f6f6d
525654.94,3.0,3,4,4,4,12,0xb2d12678
2927.84,1.0,0,2,2,4,8,0xb2d68f15
210.88,1.0,4,1,2,4,7,0xb2d3550b
82.24,1.0,30,1,2,2,5,0xb2d3a0e9d
406610.25,6.0,3,4,4,4,12,0xb2d6ad68
1.58,1.0,39,1,2,2,5,0xb2d921ee
422003.08,4.0,0,4,4,4,12,0xb2d5f89dd
171286.64,2.0,3,3,3,4,10,0xb2d07ed2d
100008.57,2.0,0,3,3,4,10,0xb2d6993e
60014.28,2.0,185,3,3,1,7,0xb2d50513
168011.53,2.0,95,3,3,1,7,0xb2d33537d
8.5,1.0,4,1,2,4,7,0xb2d9f8fe
33.32,1.0,29,1,2,2,5,0xb2d6cdd2
1732.55,1.0,3,1,2,4,7,0xb2d50666
202003.22,4.0,32,3,4,2,9,0xb2d9729b
131631.15,1.0,3,3,2,4,9,0xb2d597afd
50758.13,1.0,6,2,2,3,7,0xb2d2c452d
0.7,1.0,3,1,2,4,7,0xb2d6d4e9
500004.63,2.0,34,4,3,2,9,0xb2d17569
1810.93,1.0,92,1,2,1,4,0xb2d0a27cd
101793.41,2.0,21,3,3,2,8,0xb2d0c331d
270121.12,8.0,32,3,4,2,9,0xb2d56c89d
340007.19,2.0,116,4,3,1,8,0xb2d94598d
433018.06,4.0,1,4,4,4,12,0xb2d27ef0d
4255.15,1.0,0,2,2,4,8,0xb2d42e1dd
4130.37,1.0,0,2,2,4,8,0xb2d17640
219.59,1.0,31,1,2,2,5,0xb2d8cbd2
50000.0,3.0,4,2,4,4,10,0xb2d62a35d
4543.47,1.0,110,2,2,1,5,0xb2d19659d
183858.46,2.0,53,3,3,2,8,0xb2d3ad8e
36.49,1.0,6,1,2,3,6,0xb2d78301
901120.08,4.0,74,4,4,1,9,0xb2d3b46ed
534735.63,2.0,14,4,3,3,10,0xb2d5b5f3
96.13,2.0,152,1,3,1,5,0xb2d555b2d
103862.06,1.0,0,3,2,4,9,0xb2d59d49
344974.95,14.0,0,4,4,4,12,0x3b9b30bd
4298.76,1.0,0,2,2,4,8,0xb2d69fcbd
497.68,9.0,16,1,4,2,7,0xb2d0638f
450054.84,3.0,0,4,4,4,12,0xb2d62186d
227082.8,6.0,0,3,4,4,11,0xb2d08e3cd
1001.9,1.0,5,1,2,3,6,0xb2d9c5e4
6277.73,1.0,7,2,2,3,7,0xb2d5af8b
7465.86,1.0,92,2,2,1,5,0xb2d407bed
12344.7,1.0,11,2,2,3,7,0xb2d68a6d
84.44,1.0,55,1,2,2,5,0xb2d8ecba
100001.06,2.0,34,3,3,2,8,0xb2d93288
277660.41,3.0,6,3,4,3,10,0xb2d296ecd
100020.0,2.0,97,3,3,1,7,0xb2d51707d
120015.69,4.0,70,3,4,1,8,0xb2d1730ad
3141.17,1.0,0,2,2,4,8,0xb2d5c612d
39603.08,1.0,2,2,2,4,8,0xb2d3f9e4d
101761.11,2.0,2,3,3,4,10,0xb2d4a8f3d
715979.39,4.0,11,4,4,3,11,0xb2d6210ad
26.44,1.0,2,1,2,4,7,0xb2d487b9d
130104.38,4.0,0,3,4,4,11,0xb2d5d393d
1149537.89,2.0,13,4,3,3,10,0xb2d1e917d
32.87,1.0,11,1,2,3,6,0xb2d2622d
3.28,1.0,70,1,2,1,4,0xb2d42a6cd
900050.81,4.0,1,4,4,4,12,0xb2d6533c
20826.46,1.0,3,2,2,4,8,0xb2d230cad
407692.57,4.0,108,4,4,1,9,0xb2d0bf4cd
100651.33,2.0,5,3,3,3,9,0xb2d4b630
10000.21,2.0,92,2,3,1,6,0xb2d67ceb
795.14,1.0,1,1,2,4,7,0xb2d312e4
50040.86,2.0,167,2,3,1,6,0xb2d43708
29.9,1.0,54,1,2,2,5,0xb2d39eb1
314632.32,13.0,4,4,4,4,12,0xb2d6492dd
36675.08,1.0,4,2,2,4,8,0xb2d60951d
22530.23,1.0,29,2,2,2,6,0xb2d6c621d
95072.78,2.0,76,3,3,1,7,0xb2d17d6bd
500050.01,2.0,6,4,3,3,10,0xb2d94776d
230074.96,1.0,1,3,2,4,9,0xb2d64404d
1000061.85,3.0,3,4,4,4,12,0xb2d5f137d
1893.26,1.0,184,1,2,1,4,0xb2d51995d
17.94,1.0,9,1,2,3,6,0xb2d4f715
265906.83,3.0,11,3,4,3,10,0xb2d37f3fd
396.98,1.0,17,1,2,2,5,0xb2d8ff5f
1553.31,1.0,201,1,2,1,4,0xb2d6f099d
390010.05,7.0,112,4,4,1,9,0xb2d16bc2
6230.63,1.0,92,2,2,1,5,0xb2d36cfdd
52969.69,3.0,32,3,4,2,9,0xb2d52cd4
114.57,1.0,0,1,2,4,7,0xb2d96c03
57.63,1.0,26,1,2,2,5,0xb2d8ee53d
126000.0,7.0,7,3,4,3,10,0xb2d4e713
541049.32,7.0,14,4,4,3,11,0xb2d58de6d
2890.44,1.0,22,2,2,2,6,0xb2d1329e
1016.46,1.0,184,1,2,1,4,0xb2d0feb4d
1393.25,1.0,21,1,2,2,5,0xb2d432c1d
1458728.07,3.0,88,4,4,1,9,0xb2d5f5c6d
444.17,1.0,38,1,2,2,5,0xb2d630ad
31142.55,1.0,24,2,2,2,6,0xb2d0c243d
5444.38,1.0,92,2,2,1,5,0xb2d34e6d
1052681.7,13.0,1,4,4,4,12,0x3b9b3fa9d
53026.56,1.0,0,3,2,4,9,0xb2d651db
20000.21,2.0,172,2,3,1,6,0xb2d8d847d
12.71,1.0,25,1,2,2,5,0xb2d97df8
330432.22,2.0,0,4,3,4,11,0xb2d5ee27d
88361.15,3.0,30,3,4,2,9,0xb2d141c9d
451895.23,2.0,18,4,3,2,9,0xb2d6fcdf
393075.23,3.0,66,4,4,2,10,0xb2d6c8f6
390331.97,5.0,133,4,4,1,9,0xb2d534b6
329441.66,2.0,0,4,3,4,11,0xb2d417b0d
650026.92,3.0,3,4,4,4,12,0xb2d9d1b7
1304620.75,2.0,30,4,3,2,9,0xb2d244d8d
164006.19,3.0,11,3,4,3,10,0xb2d93ef1d
3107.85,1.0,204,2,2,1,5,0xb2d4a95e
70470.23,2.0,1,3,3,4,10,0xb2d3550bd
277601.48,1.0,92,3,2,1,6,0xb2d2d9d4d
111.98,1.0,5,1,2,3,6,0xb2d2a37b
13833.66,1.0,2,2,2,4,8,0xb2da36e3
500022.54,1.0,3,4,2,4,10,0xb2d287b1
1106.84,1.0,92,1,2,1,4,0xb2d40584d
23039.4,1.0,9,2,2,3,7,0xb2d2d7a0
40930.8,1.0,98,2,2,1,5,0xb2d6078ad
57791.3,2.0,83,3,3,1,7,0xb2d17927d
100006.85,2.0,3,3,3,4,10,0xb2d4663d
457900.28,3.0,5,4,4,3,11,0xb2d6d896d
101543.81,2.0,10,3,3,3,9,0xb2d3ff54d
203081.05,2.0,116,3,3,1,7,0xb2d63e93d
226.89,1.0,3,1,2,4,7,0xb2d5a55b
200710.42,2.0,39,3,3,2,8,0xb2d9f5b5
631952.12,4.0,0,4,4,4,12,0xb2d3f7a8d
101045.31,2.0,144,3,3,1,7,0xb2d24986d
57.83,1.0,0,1,2,4,7,0xb2d3dbdd
2320.21,1.0,184,1,2,1,4,0xb2d30a5cd
1605.83,1.0,1,1,2,4,7,0xb2d2b027
57508.28,9.0,0,3,4,4,11,0x3b9b25b5d
1474.93,1.0,184,1,2,1,4,0xb2d0cadcd
5049.29,1.0,92,2,2,1,5,0xb2d29facd
401420.83,2.0,32,4,3,2,9,0xb2d93b87d
51001.08,2.0,156,2,3,1,6,0xb2d6c389
200000.0,2.0,3,3,3,4,10,0xb2d9568a
4467.39,1.0,9,2,2,3,7,0xb2d43b1f
22904.82,1.0,211,2,2,1,5,0xb2d3b54e
3077.45,1.0,0,2,2,4,8,0xb2d529f7
627.75,1.0,73,1,2,1,4,0xb2d231dfd
771128.74,4.0,125,4,4,1,9,0xb2d14201d
13980.85,1.0,10,2,2,3,7,0xb2d34216
278123.14,1.0,24,3,2,2,7,0xb2d419c9d
560.73,1.0,4,1,2,4,7,0xb2d5b83b
1247.24,1.0,145,1,2,1,4,0xb2d78b66
880085.2,9.0,8,4,4,3,11,0xb2d24bb6d
5.44,1.0,16,1,2,2,5,0xb2d4d88fd
236614.75,1.0,13,3,2,3,8,0xb2d150a6
2555.63,1.0,1,1,2,4,7,0xb2d38ca7
130006.88,2.0,231,3,3,1,7,0xb2d6d4b6d
46.02,1.0,42,1,2,2,5,0xb2d8e45b
125008.17,4.0,14,3,4,3,10,0xb2d6926f
224359.75,2.0,2,3,3,4,10,0xb2d58ec9
250787.8,3.0,5,3,4,3,10,0xb2d0d030
111.37,1.0,7,1,2,3,6,0xb2d55a41
230000.0,2.0,14,3,3,3,9,0xb2d95efc
253059.67,2.0,83,3,3,1,7,0xb2d16054d
930004.51,17.0,8,4,4,3,11,0xb2d94b13d
21.38,1.0,60,1,2,2,5,0xb2d18da0d
290094.86,2.0,77,3,3,1,7,0xb2d33c68d
101779.07,2.0,110,3,3,1,7,0xb2d60ee0
7024.1,1.0,92,2,2,1,5,0xb2d42830d
10048.29,1.0,5,2,2,3,7,0xb2d929d5
40046.5,2.0,25,2,3,2,7,0xb2d68dccd
50859.46,2.0,245,2,3,1,6,0xb2d61a1a
1335.18,1.0,21,1,2,2,5,0xb2d20638d
2027913.23,5.0,31,4,4,2,10,0x3b9b1bafd
15992.28,7.0,0,2,4,4,10,0x3b9ae3ef
564.15,1.0,9,1,2,3,6,0xb2d5bb19
1120.78,1.0,10,1,2,3,6,0xb2d33476d
1568.09,1.0,2,1,2,4,7,0xb2d32f37d
654.53,1.0,2,1,2,4,7,0xb2d577f4
3264.45,1.0,3,2,2,4,8,0xb2d58938d
619.83,1.0,21,1,2,2,5,0xb2d3e7b0
1040021.95,5.0,76,4,4,1,9,0xb2d1236bd
3.51,1.0,1,1,2,4,7,0xb2d64791
846176.59,4.0,4,4,4,4,12,0xb2d59889d
50079.74,2.0,14,2,3,3,8,0xb2d25afa
10601.2,2.0,111,2,3,1,6,0xb2d94d37d
3.98,1.0,28,1,2,2,5,0xb2d203c3
201132.37,2.0,43,3,3,2,8,0xb2d943a8d
505490.74,3.0,39,4,4,2,10,0xb2d11f37d
102850.21,1.0,0,3,2,4,9,0xb2d2fe50d
251.04,1.0,16,1,2,2,5,0xb2d11fe0
6432.84,3.0,92,2,4,1,7,0xb2d2c904d
350000.43,2.0,4,4,3,4,11,0xb2d380da
10102.0,2.0,6,2,3,3,8,0xb2d9449f
602.87,1.0,0,1,2,4,7,0xb2d346e5d
0.35,1.0,3,1,2,4,7,0xb2d6a7f7d
50205.73,2.0,27,2,3,2,7,0xb2d9e1bf
70964.52,1.0,5,3,2,3,8,0xb2d3a99ed
2204007.9,13.0,21,4,4,2,10,0xb2d124bcd
300055.33,3.0,110,3,4,1,8,0xb2d5f07e
4045.01,1.0,172,2,2,1,5,0xb2d24744d
6694.5,1.0,184,2,2,1,5,0xb2d07205d
22682.81,1.0,0,2,2,4,8,0xb2d243f8d
130019.17,3.0,10,3,4,3,10,0xb2d23fbcd
488.91,1.0,22,1,2,2,5,0xb2d612d8
3482.63,1.0,0,2,2,4,8,0xb2d5e2d0
5860.41,1.0,3,2,2,4,8,0xb2d5b265
927004.32,7.0,0,4,4,4,12,0xb2d09bf7d
1150093.79,6.0,5,4,4,3,11,0xb2d218bcd
620098.74,6.0,4,4,4,4,12,0xb2d280a0d
12517.09,1.0,4,2,2,4,8,0xb2d9d2e4
11493.32,1.0,2,2,2,4,8,0xb2d9696e
1816.81,1.0,10,1,2,3,6,0xb2d41222d
704351.17,7.0,13,4,4,3,11,0xb2d22e68
352918.35,5.0,0,4,4,4,12,0xb2d57dd8
10336.6,1.0,0,2,2,4,8,0xb2d210edd
100001.9,2.0,76,3,3,1,7,0xb2d8d7ded
81.83,1.0,10,1,2,3,6,0xb2d96e75
18.8,1.0,10,1,2,3,6,0xb2d431d9
1080.93,1.0,92,1,2,1,4,0xb2d21a4cd
3178.13,1.0,18,2,2,2,6,0xb2d5e1ca
20.18,1.0,83,1,2,1,4,0xb2d62599d
80577.13,3.0,2,3,4,4,11,0xb2d11833d
326459.66,3.0,25,4,4,2,10,0xb2d398fbd
1684.4,1.0,10,1,2,3,6,0xb2d6f01e
50288.18,2.0,136,2,3,1,6,0xb2d56ef8
1086.62,1.0,0,1,2,4,7,0xb2d6bcf7
510663.9,2.0,17,4,3,2,9,0xb2d6a52fd
552486.8,3.0,5,4,4,3,11,0xb2d8f576
11758.23,4.0,92,2,4,1,7,0x3b9af560d
12240.78,1.0,0,2,2,4,8,0xb2d4dc78
1003.42,1.0,184,1,2,1,4,0xb2d65575d
386117.52,3.0,4,4,4,4,12,0xb2d067cdd
102.87,1.0,19,1,2,2,5,0xb2d9190e
821.47,1.0,0,1,2,4,7,0xb2d8ec0b
889.01,1.0,62,1,2,2,5,0xb2d604b6
200016.38,2.0,25,3,3,2,8,0xb2d6e1dbd
500612.38,5.0,0,4,4,4,12,0xb2d19ec6d
50172.28,3.0,40,2,4,2,8,0xb2d685d8d
185.26,1.0,104,1,2,1,4,0xb2d527b8d
303177.02,3.0,63,4,4,2,10,0xb2d0fda1d
680839.13,5.0,53,4,4,2,10,0xb2d12cb4
10385.72,1.0,15,2,2,3,7,0xb2d0e834
3003.58,1.0,122,2,2,1,5,0xb2d78025d
20201.14,1.0,184,2,2,1,5,0xb2d4e2bfd
1685.93,1.0,6,1,2,3,6,0xb2d41ff8
2066.64,1.0,18,1,2,2,5,0xb2d68611
50874.12,2.0,164,2,3,1,6,0xb2d6048e
520000.61,7.0,6,4,4,3,11,0xb2d6ed73
2036804.17,6.0,5,4,4,3,11,0xb2d59a9dd
480028.4,11.0,13,4,4,3,11,0xb2d9a2eb
2690.06,1.0,242,1,2,1,4,0xb2d3afccd
1901.32,1.0,96,1,2,1,4,0xb2d95a9dd
256690.71,1.0,4,3,2,4,9,0xb2d5cabed
330272.34,4.0,102,4,4,1,9,0xb2d33431d
100006.88,2.0,11,3,3,3,9,0xb2d69c37d
30605.27,3.0,55,2,4,2,8,0xb2d43c55d
401430.6,4.0,69,4,4,1,9,0xb2d9a27d
52337.75,5.0,11,3,4,3,10,0xb2d5b046d
1604236.21,5.0,80,4,4,1,9,0xb2d179f4
100187.43,2.0,4,3,3,4,10,0xb2d5fe82d
109141.04,4.0,41,3,4,2,9,0xb2d24aced
300033.23,5.0,1,3,4,4,11,0xb2d62457d
51722.99,1.0,92,2,2,1,5,0xb2d40917d
538047.44,6.0,9,4,4,3,11,0xb2d10057d
3839.79,1.0,10,2,2,3,7,0xb2d33a26d
2820315.58,3.0,27,4,4,2,10,0xb2d5af3f
50020.47,2.0,116,2,3,1,6,0xb2d3a1b5
400813.36,3.0,12,4,4,3,11,0xb2d16c57d
365000.0,4.0,7,4,4,3,11,0xb2d26724d
38.45,1.0,167,1,2,1,4,0xb2d2328cd
84.62,1.0,10,1,2,3,6,0xb2d2d3f9d
2.58,1.0,80,1,2,1,4,0xb2d3b7d5d
15157.99,1.0,22,2,2,2,6,0xb2d4353cd
3162.86,1.0,92,2,2,1,5,0xb2d0f723
53004.42,2.0,95,3,3,1,7,0xb2d78438
500000.04,2.0,9,4,3,3,10,0xb2d927ff
84654.8,2.0,0,3,3,4,10,0xb2d064d5d
1083197.85,3.0,13,4,4,3,11,0xb2d5dd27
44625.53,2.0,31,2,3,2,7,0xb2d5824dd
53154.67,2.0,18,3,3,2,8,0xb2d4a704d
1.53,1.0,47,1,2,2,5,0xb2d627c2
875838.17,3.0,1,4,4,4,12,0xb2d11afa
5577.43,1.0,1,2,2,4,8,0xb2d57c2c
249646.48,4.0,0,3,4,4,11,0xb2d341d1d
46026.4,5.0,0,2,4,4,10,0x3b9b10a0d
625478.59,6.0,3,4,4,4,12,0xb2d13b11d
881.2,1.0,29,1,2,2,5,0xb2d36205
1801.65,2.0,63,1,3,2,6,0xb2d467d6
685.61,1.0,16,1,2,2,5,0xb2d2e8f2d
535000.0,11.0,6,4,4,3,11,0xb2d44109d
22387.55,2.0,16,2,3,2,7,0xb2d5d422
70.69,1.0,10,1,2,3,6,0xb2d485c7
810.79,1.0,33,1,2,2,5,0xb2d0e36bd
362834.07,3.0,31,4,4,2,10,0xb2d3a599
218728.97,3.0,295,3,4,1,8,0xb2d1069dd
1400000.0,3.0,101,4,4,1,9,0xb2d296bbd
100255.58,4.0,3,3,4,4,11,0xb2d43832
104375.13,2.0,1,3,3,4,10,0xb2d1ccd9
4061.48,1.0,3,2,2,4,8,0xb2d39aef
20000.53,2.0,80,2,3,1,6,0xb2d5b53a
24205.78,2.0,3,2,3,4,9,0xb2d4600fd
6533.19,1.0,14,2,2,3,7,0xb2d342f3
1569.15,1.0,0,1,2,4,7,0xb2d50a1e
500000.0,2.0,1,4,3,4,11,0xb2d97ff6
475401.67,5.0,0,4,4,4,12,0xb2d22a05d
433006.02,5.0,8,4,4,3,11,0xb2d44d88d
6692.29,1.0,0,2,2,4,8,0x3b9b3047d
50012.41,2.0,200,2,3,1,6,0xb2d62a24
2.02,1.0,18,1,2,2,5,0xb2d2dba9d
520180.5,2.0,129,4,3,1,8,0xb2d598bad
60083.8,2.0,266,3,3,1,7,0xb2d3ff4c
100822.42,4.0,4,3,4,4,11,0xb2d27d55
1380040.6,6.0,8,4,4,3,11,0xb2d3adcfd
5030.26,1.0,184,2,2,1,5,0xb2d40d5ed
21908.26,1.0,11,2,2,3,7,0xb2d67dce
110002.95,2.0,53,3,3,2,8,0xb2d78648
16482.51,1.0,184,2,2,1,5,0xb2d24420d
192.99,1.0,24,1,2,2,5,0xb2d6b191
7192.67,1.0,3,2,2,4,8,0xb2d965f2
240013.33,3.0,41,3,4,2,9,0xb2d571afd
293099.75,2.0,93,3,3,1,7,0xb2d78c4ed
270061.93,4.0,10,3,4,3,10,0xb2d22f97d
103.57,1.0,47,1,2,2,5,0xb2d8d72a
2967.73,1.0,73,2,2,1,5,0xb2d3731bd
3243.97,1.0,40,2,2,2,6,0xb2d2e680d
30001.61,3.0,92,2,4,1,7,0xb2d09c71d
266031.3,2.0,3,3,3,4,10,0xb2d80d61d
545.87,1.0,0,1,2,4,7,0xb2d8eb3ed
10001.01,2.0,32,2,3,2,7,0xb2d8e32ed
1855058.55,8.0,1,4,4,4,12,0xb2d3b4fbd
253449.06,2.0,1,3,3,4,10,0xb2d16c96d
35974.26,6.0,0,2,4,4,10,0x3b9b375c
381680.13,6.0,0,4,4,4,12,0xb2d1603cd
170006.37,4.0,39,3,4,2,9,0xb2d610b5d
292.16,1.0,2,1,2,4,7,0xb2d2daf9
9821.89,1.0,184,2,2,1,5,0xb2d25937d
200038.6,4.0,51,3,4,2,9,0xb2d21e0bd
750000.3,4.0,0,4,4,4,12,0xb2d8ef99
670899.89,3.0,27,4,4,2,10,0xb2d625a9
9621.54,1.0,0,2,2,4,8,0xb2d7c44ed
70072.92,2.0,32,3,3,2,8,0xb2d56412d
20000.21,2.0,34,2,3,2,7,0xb2d8f817
1.47,1.0,11,1,2,3,6,0xb2d3b7f2d
7618.35,1.0,3,2,2,4,8,0xb2d67ecfd
3865395.15,9.0,1,4,4,4,12,0x3b9af157
25015.13,2.0,60,2,3,2,7,0xb2d9bc9d
150004.75,2.0,38,3,3,2,8,0xb2d92460d
16.23,1.0,12,1,2,3,6,0xb2d2e08cd
38.38,1.0,21,1,2,2,5,0xb2d12ec0
202000.0,2.0,27,3,3,2,8,0xb2da10da
33004.64,1.0,0,2,2,4,8,0xb2d13002d
170018.85,2.0,209,3,3,1,7,0xb2d5b2e5d
100002.99,3.0,116,3,4,1,8,0xb2d3cbbb
3088.92,1.0,9,2,2,3,7,0xb2d4fab9
526269.05,3.0,28,4,4,2,10,0xb2d65933d
1062.3,2.0,238,1,3,1,5,0xb2d2cbf6d
10374.61,1.0,92,2,2,1,5,0xb2d2c78ed
140010.47,3.0,23,3,4,2,9,0xb2d29eabd
936.05,1.0,9,1,2,3,6,0xb2d96597
201028.53,3.0,6,3,4,3,10,0xb2d68b4cd
130052.43,5.0,12,3,4,3,10,0x3b9b4973d
85027.74,3.0,172,3,4,1,8,0xb2d5c32c
10001.35,2.0,11,2,3,3,8,0xb2d2b379
230100.35,2.0,0,3,3,4,10,0xb2d1fe6d
304783.08,6.0,0,4,4,4,12,0xb2d5874fd
12984.05,1.0,0,2,2,4,8,0xb2d4770e
72.03,1.0,116,1,2,1,4,0xb2d2ced0
273.89,1.0,0,1,2,4,7,0xb2d5c847
200009.18,5.0,42,3,4,2,9,0xb2d44350
1328208.07,7.0,8,4,4,3,11,0xb2d63672d
20.8,1.0,20,1,2,2,5,0xb2d376f9
60000.63,2.0,60,3,3,2,8,0xb2d9c05b
1827.38,1.0,184,1,2,1,4,0x3b9ad4b7
3801.63,1.0,0,2,2,4,8,0xb2d5e1cad
4878.03,1.0,0,2,2,4,8,0xb2d523e1
291004.54,3.0,10,3,4,3,10,0xb2d57493d
15115.6,1.0,92,2,2,1,5,0xb2d35b3dd
231434.97,3.0,37,3,4,2,9,0xb2d4fc8cd
7.28,1.0,50,1,2,2,5,0xb2d3ee6a
1018643.59,2.0,32,4,3,2,9,0xb2d230bb
1425.95,1.0,11,1,2,3,6,0xb2d2dcf3d
6054.2,1.0,0,2,2,4,8,0xb2d69a43
652295.52,2.0,0,4,3,4,11,0xb2d405a3d
610088.18,9.0,69,4,4,1,9,0x3b9b39c8d
20044.0,2.0,146,2,3,1,6,0xb2d79003
4323.16,1.0,77,2,2,1,5,0xb2d68391
523065.71,5.0,1,4,4,4,12,0xb2d3d6a2
1000000.0,1.0,0,4,2,4,10,0xb2da6ab0
419.66,1.0,89,1,2,1,4,0xb2d5d4c1d
201171.51,3.0,42,3,4,2,9,0xb2d1335ad
80010.73,3.0,51,3,4,2,9,0xb2d69aeed
36.2,1.0,48,1,2,2,5,0xb2d3b08f
5006.85,1.0,17,2,2,2,6,0xb2d7ffecd
81.94,1.0,12,1,2,3,6,0xb2d62547
6243.07,1.0,45,2,2,2,6,0xb2d5b0b8
46437.12,3.0,0,2,4,4,10,0x3b9af490d
22445.17,1.0,0,2,2,4,8,0xb2d193bed
10118.98,2.0,90,2,3,1,6,0xb2d51d1e
476486.21,3.0,0,4,4,4,12,0xb2d0b4df
6532.43,1.0,138,2,2,1,5,0xb2d47612d
240003.8,3.0,172,3,4,1,8,0xb2d6eb8d
1165.88,1.0,17,1,2,2,5,0xb2d5ec00d
1274.42,1.0,13,1,2,3,6,0xb2d4e7c8
14705.43,1.0,204,2,2,1,5,0xb2d6609ad
2059.08,1.0,0,1,2,4,7,0xb2d8ea23d
509108.95,2.0,53,4,3,2,9,0xb2d5e9e9d
5558.51,1.0,81,2,2,1,5,0xb2d1f3ad
298095.44,3.0,48,3,4,2,9,0xb2d41e9dd
306683.78,6.0,6,4,4,3,11,0xb2d6e462
531085.48,2.0,1,4,3,4,11,0xb2d67ccfd
1131.9,1.0,184,1,2,1,4,0xb2d21aacd
2536.07,1.0,208,1,2,1,4,0xb2d645c8d
1033.9,1.0,184,1,2,1,4,0xb2d347b0d
183088.04,5.0,97,3,4,1,8,0xb2d5cf54d
7318.37,1.0,0,2,2,4,8,0xb2d8e24d
5057.63,1.0,129,2,2,1,5,0xb2d6284cd
1500638.55,5.0,3,4,4,4,12,0xb2d26816d
874791.24,7.0,5,4,4,3,11,0xb2d2f88fd
514439.59,5.0,0,4,4,4,12,0xb2d56bf3d
0.5,1.0,74,1,2,1,4,0xb2d646a6d
753040.64,6.0,8,4,4,3,11,0xb2d23ef6d
4327.35,1.0,0,2,2,4,8,0xb2d54ebc
20821.77,1.0,20,2,2,2,6,0xb2d84e77
617874.07,5.0,22,4,4,2,10,0xb2d3237ad
680034.83,4.0,31,4,4,2,10,0xb2d598a3
280029.58,3.0,0,3,4,4,11,0xb2d1c558d
320831.62,1.0,1,4,2,4,10,0xb2d0f742
6.12,1.0,60,1,2,2,5,0xb2d3dd4a
3258.45,1.0,92,2,2,1,5,0xb2d311cdd
500005.28,2.0,48,4,3,2,9,0xb2d91265d
427514.56,8.0,0,4,4,4,12,0x3b9af0f9d
5003.4,1.0,5,2,2,3,7,0xb2d54f0cd
50029.37,2.0,116,2,3,1,6,0xb2d2caf0
1265162.23,7.0,0,4,4,4,12,0xb2d0fbbfd
1168.68,1.0,0,1,2,4,7,0xb2d1400ad
70128.3,3.0,4,3,4,4,11,0xb2d230bad
275964.06,2.0,88,3,3,1,7,0xb2d23f05d
1115257.57,1.0,15,4,2,3,9,0xb2d9523e
1183.84,1.0,10,1,2,3,6,0xb2d6e06c
320107.62,3.0,76,4,4,1,9,0xb2d5e54cd
221100.0,6.0,4,3,4,4,11,0xb2da31ae
1450.91,1.0,184,1,2,1,4,0xb2d1300dd
14.33,1.0,39,1,2,2,5,0xb2d60e50
8.88,1.0,23,1,2,2,5,0xb2d955db
3.68,1.0,110,1,2,1,4,0xb2d21dd2d
770054.54,7.0,2,4,4,4,12,0xb2d59e0f
150000.37,1.0,28,3,2,2,7,0xb2d97b40
9605.73,1.0,0,2,2,4,8,0xb2d1cb61
663.13,1.0,5,1,2,3,6,0xb2d2b972
943.61,1.0,4,1,2,4,7,0xb2da29c1
377866.2,3.0,67,4,4,1,9,0xb2d5ed35d
182145.19,2.0,107,3,3,1,7,0xb2d4fd2c
1045.99,1.0,92,1,2,1,4,0xb2d1a44b
202718.07,3.0,9,3,4,3,10,0x3b9b4325d
13.0,1.0,104,1,2,1,4,0xb2d25298d
2996.16,1.0,184,2,2,1,5,0xb2d2dd27d
0.53,1.0,0,1,2,4,7,0xb2d950a1
200793.91,2.0,33,3,3,2,8,0xb2d5d4e9
0.0,1.0,9,1,2,3,6,0xb2d995cb
222.16,1.0,1,1,2,4,7,0xb2d790ff
1504.12,1.0,92,1,2,1,4,0xb2d5210cd
1.67,1.0,14,1,2,3,6,0xb2d97871
20650.04,1.0,28,2,2,2,6,0xb2d568c4d
457504.78,2.0,16,4,3,2,9,0xb2d6acf5d
5.47,1.0,11,1,2,3,6,0xb2d38fba
41.81,1.0,5,1,2,3,6,0xb2d4d207
447007.97,8.0,16,4,4,2,10,0xb2d109cbd
1000042.22,2.0,80,4,3,1,8,0xb2d985b6
1800000.99,8.0,6,4,4,3,11,0xb2d90550d
80001.48,3.0,11,3,4,3,10,0xb2da0007
370005.11,8.0,3,4,4,4,12,0xb2d23f62
85803.66,2.0,25,3,3,2,8,0xb2d204d9d
4742.65,1.0,1,2,2,4,8,0xb2d6f575d
884.14,1.0,0,1,2,4,7,0xb2d906c8
387880.97,3.0,20,4,4,2,10,0xb2d1b426
605836.65,7.0,9,4,4,3,11,0xb2d23f20
200095.45,2.0,14,3,3,3,9,0xb2d9e3c9
183072.56,2.0,164,3,3,1,7,0xb2d52b18
201255.95,4.0,1,3,4,4,11,0xb2d63493
200000.0,2.0,21,3,3,2,8,0xb2da26b8
525.75,1.0,10,1,2,3,6,0xb2d1fd51
292165.33,13.0,108,3,4,1,8,0x3b9b1b01d
9900.27,1.0,12,2,2,3,7,0xb2d37c89d
100004.22,2.0,221,3,3,1,7,0xb2d6d7bd
10211.53,1.0,15,2,2,3,7,0xb2d5cf15d
13.34,1.0,1,1,2,4,7,0xb2d8d1f5
1.39,1.0,82,1,2,1,4,0xb2d8c714d
3286055.71,13.0,6,4,4,3,11,0xb2d074e1
252876.01,2.0,158,3,3,1,7,0xb2d6cbb2d
2505.35,1.0,207,1,2,1,4,0xb2d61205d
500000.12,3.0,22,4,4,2,10,0xb2d78af0
1756.72,1.0,96,1,2,1,4,0xb2d62113d
511549.33,4.0,83,4,4,1,9,0xb2d68adad
300099.9,5.0,38,4,4,2,10,0x3b9b4469d
213348.68,2.0,1,3,3,4,10,0xb2d3bd31
9407.84,1.0,0,2,2,4,8,0xb2d204e5
160000.69,5.0,50,3,4,2,9,0xb2d90462d
2.19,1.0,77,1,2,1,4,0xb2d7ad0e
2125043.02,15.0,0,4,4,4,12,0xb2d1b27cd
3981386.8,27.0,0,4,4,4,12,0xb2d1ebadd
1026.05,1.0,92,1,2,1,4,0xb2d2e15ad
5284.92,1.0,92,2,2,1,5,0xb2d25a05d
207114.66,2.0,43,3,3,2,8,0xb2d5ed86d
191.08,1.0,6,1,2,3,6,0xb2d6a171d
651265.87,2.0,181,4,3,1,8,0xb2d38940
344526.09,2.0,129,4,3,1,8,0xb2d0feb3
364.35,3.0,92,1,4,1,6,0x3b9b2a10
2500922.19,2.0,1,4,3,4,11,0xb2d16e52
20.39,1.0,67,1,2,1,4,0xb2d2bd82d
520000.0,2.0,12,4,3,3,10,0xb2d1c7e1
110.18,1.0,1,1,2,4,7,0xb2d25761
60758.0,1.0,18,3,2,2,7,0xb2d343d5d
333436.94,5.0,11,4,4,3,11,0xb2d95d0dd
3780.48,1.0,153,2,2,1,5,0xb2d205c8d
5176.95,1.0,1,2,2,4,8,0xb2d99d9b
988775.73,8.0,13,4,4,3,11,0xb2d3a833d
6428.1,1.0,14,2,2,3,7,0xb2d5d7a8d
80003.4,3.0,24,3,4,2,9,0xb2d6bf4a
123256.52,3.0,202,3,4,1,8,0xb2d38ea3d
23457.37,1.0,2,2,2,4,8,0xb2d43b60
4048679.21,8.0,3,4,4,4,12,0xb2d082f9
60003.01,3.0,63,3,4,2,9,0xb2d4ec08d
4495.03,1.0,8,2,2,3,7,0xb2d30ce8
61179.85,1.0,0,3,2,4,9,0xb2d21003d
300008.0,2.0,1,3,3,4,10,0xb2d25694d
100000.0,1.0,0,3,2,4,9,0xb2d83407d
1116.99,1.0,184,1,2,1,4,0xb2d4866f
89.39,1.0,9,1,2,3,6,0xb2d3a165
2018.77,1.0,92,1,2,1,4,0xb2d2bced
6208.74,1.0,20,2,2,2,6,0xb2d653e2
606406.07,4.0,10,4,4,3,11,0x3b9af1d3d
40372.97,1.0,5,2,2,3,7,0xb2d21c91d
26713.68,1.0,18,2,2,2,6,0xb2d68ea8d
12136.16,1.0,2,2,2,4,8,0xb2d2ebb1d
1549685.55,3.0,104,4,4,1,9,0xb2d1b71b
130004.12,2.0,10,3,3,3,9,0xb2d96109d
2534.3,8.0,184,1,4,1,6,0xb2d22b9dd
4021821.69,1.0,184,4,2,1,7,0xb2d2ebfed
458006.02,7.0,39,4,4,2,10,0xb2d1bed9
940066.87,8.0,4,4,4,4,12,0xb2d1e042d
34643.68,1.0,0,2,2,4,8,0xb2d6a03a
10385.82,8.0,10,2,4,3,9,0x3b9b37add
200776.71,2.0,9,3,3,3,9,0xb2d68153d
500776.43,3.0,8,4,4,3,11,0xb2d50db4d
8.1,4.0,1,1,4,4,9,0xb2d6a801
400007.4,4.0,1,4,4,4,12,0xb2d8dc6ad
32.74,1.0,60,1,2,2,5,0xb2d34eaa
1916.6,1.0,3,1,2,4,7,0xb2d62b1ed
1100222.26,6.0,0,4,4,4,12,0xb2d1bb0e
264172.55,1.0,184,3,2,1,6,0xb2d246b8d
762045.43,3.0,13,4,4,3,11,0xb2d64905d
100059.28,2.0,0,3,3,4,10,0xb2d95f3ad
1020346.38,2.0,0,4,3,4,11,0xb2d1525d
38003.61,1.0,8,2,2,3,7,0xb2d631f5
100002.32,3.0,92,3,4,1,8,0xb2d6449e
200000.0,2.0,15,3,3,3,9,0xb2da3778
800099.79,4.0,20,4,4,2,10,0xb2d1c57dd
104222.26,3.0,32,3,4,2,9,0xb2d6f698d
461.12,1.0,0,1,2,4,7,0xb2d91bc3
9.91,1.0,7,1,2,3,6,0xb2d4bd48
131049.36,2.0,43,3,3,2,8,0xb2d5df97d
3425.29,1.0,0,2,2,4,8,0xb2d82373d
1000084.68,1.0,1,4,2,4,10,0xb2d36f5f
135.92,3.0,2,1,4,4,9,0xb2d2a9c8d
400027.81,2.0,4,4,3,4,11,0xb2d65c30d
603.01,1.0,0,1,2,4,7,0xb2d5c591
713004.17,5.0,11,4,4,3,11,0xb2d59408
400754.64,3.0,15,4,4,3,11,0xb2d97724d
11769.46,1.0,18,2,2,2,6,0xb2d6b857d
1052.45,1.0,92,1,2,1,4,0xb2d360de
1009777.1,4.0,81,4,4,1,9,0xb2d5e156
1342309.04,1.0,92,4,2,1,7,0xb2d20edbd
10126.35,1.0,0,2,2,4,8,0xb2d34bb7
400027.91,3.0,139,4,4,1,9,0xb2d56356d
4113.74,1.0,0,2,2,4,8,0xb2d4d3cdd
5814.85,1.0,10,2,2,3,7,0xb2d3ba5bd
2051.76,1.0,1,1,2,4,7,0xb2d6ffde
9348.64,1.0,108,2,2,1,5,0xb2d6877dd
10000.55,2.0,13,2,3,3,8,0xb2d62fef
374025.46,10.0,52,4,4,2,10,0xb2d6325ed
50078.33,2.0,92,2,3,1,6,0xb2d15cf9d
800935.07,9.0,0,4,4,4,12,0x3b9b0e69
1612600.65,3.0,13,4,4,3,11,0xb2d6f556
8956.03,1.0,0,2,2,4,8,0xb2d5d145d
6018.22,1.0,0,2,2,4,8,0xb2d52aeb
400012.81,2.0,108,4,3,1,8,0xb2d78fddd
280076.0,2.0,3,3,3,4,10,0xb2d5bf3cd
4137.77,1.0,0,2,2,4,8,0xb2d965b9
1058.84,1.0,92,1,2,1,4,0xb2d3356ad
495410.35,12.0,14,4,4,3,11,0xb2d685e7d
2385036.76,4.0,6,4,4,3,11,0xb2d13319d
68.19,1.0,10,1,2,3,6,0xb2d644ba
352.2,1.0,12,1,2,3,6,0xb2d2d2a4
326.57,1.0,15,1,2,3,6,0xb2d9449fd
336138.29,2.0,147,4,3,1,8,0xb2d489fe
13376.78,1.0,9,2,2,3,7,0xb2d5b072d
190.4,1.0,1,1,2,4,7,0xb2d549e7d
7.13,4.0,7,1,4,3,8,0xb2d0dbc1
10832.58,1.0,8,2,2,3,7,0xb2d6d2cfd
4503.79,1.0,16,2,2,2,6,0xb2d8ca6cd
21783.95,1.0,15,2,2,3,7,0xb2d27806d
230929.62,2.0,110,3,3,1,7,0xb2d60e35d
606002.62,14.0,6,4,4,3,11,0xb2d1bfc1
200004.22,2.0,63,3,3,2,8,0xb2d9b433
750174.3,9.0,13,4,4,3,11,0xb2d2eae0d
200711.85,2.0,40,3,3,2,8,0xb2d920abd
409851.88,1.0,0,4,2,4,10,0xb2d35977
2.04,2.0,88,1,3,1,5,0xb2d394f8
4557.98,1.0,10,2,2,3,7,0xb2d6e8e0d
1800049.63,4.0,11,4,4,3,11,0xb2d89ed5d
95.86,2.0,14,1,3,3,7,0x3b9b3378d
30000.0,1.0,4,2,2,4,8,0xb2da0ae7
586473.07,11.0,20,4,4,2,10,0xb2d78174d
294928.36,1.0,12,3,2,3,8,0xb2d27005d
152035.49,2.0,259,3,3,1,7,0xb2d5e23ad
42512.66,1.0,9,2,2,3,7,0xb2d26f30
134.76,1.0,9,1,2,3,6,0xb2d3a0b4
30000.63,2.0,11,2,3,3,8,0xb2da3b8f
340046.05,5.0,35,4,4,2,10,0xb2d43bd0d
1020129.76,7.0,0,4,4,4,12,0xb2d2ee50
1284034.78,3.0,0,4,4,4,12,0xb2d5d986d
200289.39,1.0,0,3,2,4,9,0xb2d930bfd
1625242.0,5.0,3,4,4,4,12,0xb2d7843cd
62198.16,1.0,92,3,2,1,6,0xb2d590c9
83024.11,3.0,10,3,4,3,10,0xb2d5b03f
2273.76,1.0,118,1,2,1,4,0xb2d50538d
2205.51,1.0,9,1,2,3,6,0xb2d29d02d
10527.85,1.0,166,2,2,1,5,0xb2d5c7f7
30.53,1.0,29,1,2,2,5,0xb2d5b31bd
802947.72,3.0,52,4,4,2,10,0xb2d28ec1d
17904.21,1.0,155,2,2,1,5,0xb2d55862d
1980.2,1.0,11,1,2,3,6,0xb2d6bcdcd
160092.52,4.0,25,3,4,2,9,0xb2d1d316d
0.56,1.0,48,1,2,2,5,0xb2d6d733
102134.96,6.0,0,3,4,4,11,0xb2d5edded
191297.89,1.0,9,3,2,3,8,0xb2d6dfe0d
295469.25,8.0,0,3,4,4,11,0xb2d25324d
321545.82,3.0,4,4,4,4,12,0xb2d6c9c3
200000.0,2.0,28,3,3,2,8,0xb2d8c6bb
43744.23,2.0,4,2,3,4,9,0xb2d9ed60
500011.75,2.0,197,4,3,1,8,0xb2d78cadd
20295.61,3.0,2,2,4,4,10,0xb2d578c4d
5390.4,1.0,8,2,2,3,7,0xb2d2027b
110001.17,3.0,42,3,4,2,9,0xb2d967b8
1.46,1.0,1,1,2,4,7,0xb2d6bffa
1276.13,1.0,0,1,2,4,7,0xb2d8fd4d
355038.55,4.0,25,4,4,2,10,0xb2d4f61bd
429046.31,11.0,18,4,4,2,10,0xb2d5b289d
20107.59,4.0,21,2,4,2,8,0xb2d2b680d
400.73,1.0,2,1,2,4,7,0xb2d3cf63
5578.3,1.0,32,2,2,2,6,0xb2d9d3dd
400093.68,4.0,59,4,4,2,10,0xb2d4463b
50120.81,2.0,6,2,3,3,8,0xb2d935f3
60002.22,3.0,18,3,4,2,9,0xb2d858b0d
1582.9,1.0,92,1,2,1,4,0x3b9b3669d
1382.91,1.0,0,1,2,4,7,0xb2d25b15
6082.21,1.0,10,2,2,3,7,0xb2d60762d
558299.38,6.0,26,4,4,2,10,0xb2d1fc53d
5.12,3.0,13,1,4,3,8,0xb2d61c75
14807.54,1.0,5,2,2,3,7,0xb2d6a0bb
3022.37,1.0,92,2,2,1,5,0xb2d35f82d
195758.11,3.0,6,3,4,3,10,0xb2d991a0
250000.0,2.0,2,3,3,4,10,0xb2d9bb0c
26447.2,1.0,0,2,2,4,8,0xb2d06a84d
595759.33,5.0,41,4,4,2,10,0xb2d44271
500015.91,13.0,0,4,4,4,12,0xb2d6c883d
350000.91,5.0,3,4,4,4,12,0xb2d6dd12d
100107.55,3.0,20,3,4,2,9,0xb2d4299e
200000.0,2.0,4,3,3,4,10,0xb2da5d21
140979.76,2.0,108,3,3,1,7,0xb2d5f028
12.73,1.0,10,1,2,3,6,0xb2d30036d
350068.78,9.0,3,4,4,4,12,0xb2d4d104d
200000.0,2.0,15,3,3,3,9,0xb2da3916
13754.45,1.0,0,2,2,4,8,0xb2d6a9bbd
0.0,1.0,55,1,2,2,5,0xb2d539ca
80002.53,2.0,62,3,3,2,8,0xb2d8f6be
654.8,1.0,9,1,2,3,6,0xb2d13d51
50009.1,3.0,2,2,4,4,10,0xb2d678ee
1065.72,1.0,92,1,2,1,4,0xb2d078cd
170005.68,4.0,6,3,4,3,10,0xb2d58267
1409.69,1.0,139,1,2,1,4,0xb2d16bc0
25690.84,2.0,27,2,3,2,7,0xb2d526f3
18892.16,2.0,8,2,3,3,8,0xb2d1dc49
3932586.82,13.0,42,4,4,2,10,0x3b9b418bd
500624.85,2.0,0,4,3,4,11,0xb2d99de5
552415.17,6.0,1,4,4,4,12,0x3b9b1b74
50355.29,2.0,0,2,3,4,9,0xb2d232ed
62320.85,2.0,92,3,3,1,7,0xb2d160dad
845032.65,7.0,34,4,4,2,10,0xb2d18b27d
102454.06,3.0,6,3,4,3,10,0xb2d17308
826429.59,7.0,4,4,4,4,12,0xb2d92520d
227815.44,2.0,0,3,3,4,10,0xb2d4c136d
2730797.53,7.0,0,4,4,4,12,0x3b9af180d
120069.84,8.0,0,3,4,4,11,0xb2d7893ed
3.04,1.0,40,1,2,2,5,0xb2d31156
2302.14,1.0,0,1,2,4,7,0xb2da271f
0.05,1.0,1,1,2,4,7,0xb2d42973
3959114.48,7.0,10,4,4,3,11,0xb2d59174d
80090.98,2.0,55,3,3,2,8,0xb2d221dc
4258.86,1.0,267,2,2,1,5,0xb2d36b1fd
740116.91,6.0,0,4,4,4,12,0xb2d6e17dd
990.65,1.0,6,1,2,3,6,0xb2d21768
15313.86,4.0,0,2,4,4,10,0xb2d078f6d
68.38,1.0,81,1,2,1,4,0xb2d317ead
53146.57,5.0,21,3,4,2,9,0x3b9af178
778450.89,4.0,5,4,4,3,11,0xb2d4a271d
3373.57,1.0,184,2,2,1,5,0xb2d11580d
340362.54,5.0,18,4,4,2,10,0xb2d5f7c5d
1496.42,1.0,92,1,2,1,4,0xb2d2e520d
150001.58,2.0,24,3,3,2,8,0xb2d94ab3d
211001.54,5.0,27,3,4,2,9,0xb2d5af27d
191042.52,4.0,4,3,4,4,11,0xb2d913e5d
270007.68,3.0,24,3,4,2,9,0xb2d45bd0d
4256.45,4.0,92,2,4,1,7,0xb2d09721d
177.29,1.0,1,1,2,4,7,0xb2d6f02c
78410.35,1.0,184,3,2,1,6,0xb2d1759dd
150029.46,4.0,1,3,4,4,11,0xb2d5d0c5
1095660.04,4.0,0,4,4,4,12,0xb2d1b6fcd
69212.45,2.0,0,3,3,4,10,0xb2d0d57ed
1465.38,1.0,2,1,2,4,7,0xb2d2abe7d
388106.43,2.0,23,4,3,2,9,0xb2d691c8
613009.0,27.0,0,4,4,4,12,0xb2d06ac1
50646.06,1.0,8,2,2,3,7,0xb2d94991
181.12,2.0,4,1,3,4,8,0xb2d21397
110104.61,3.0,76,3,4,1,8,0xb2d9734c
23376.86,1.0,0,2,2,4,8,0xb2d402b2d
53091.03,1.0,92,3,2,1,6,0xb2d22079
264274.62,3.0,67,3,4,1,8,0xb2d1a120d
1895.2,1.0,1,1,2,4,7,0xb2d94821
400095.69,3.0,11,4,4,3,11,0xb2d487bdd
30000.0,2.0,15,2,3,3,8,0xb2da380f
495420.9,8.0,10,4,4,3,11,0xb2d0edd9
5112.67,1.0,7,2,2,3,7,0xb2d26a26d
34002.43,3.0,77,2,4,1,7,0x3b9b3077d
438029.32,2.0,0,4,3,4,11,0xb2d4ee38
483812.43,3.0,4,4,4,4,12,0xb2d6a3ed
936.08,1.0,15,1,2,3,6,0xb2d3bf26d
30363.68,2.0,52,2,3,2,7,0xb2d6d6aed
1316.67,1.0,25,1,2,2,5,0xb2d2e31bd
168.97,1.0,60,1,2,2,5,0xb2d8c9b4
252119.11,2.0,0,3,3,4,10,0xb2d5be68d
7858.07,1.0,0,2,2,4,8,0xb2d6f9cd
50609.3,2.0,47,2,3,2,7,0xb2d6d497
1462508.7,3.0,8,4,4,3,11,0xb2d2817dd
400748.73,3.0,17,4,4,2,10,0xb2d5bb07
210015.79,2.0,181,3,3,1,7,0xb2d42c5fd
41.17,1.0,50,1,2,2,5,0xb2d96db3
60010.7,2.0,68,3,3,1,7,0xb2d0b952
100101.3,2.0,136,3,3,1,7,0xb2d63b97d
2231083.39,4.0,1,4,4,4,12,0xb2d2f0f8
140.75,1.0,21,1,2,2,5,0xb2d626ec
1053975.28,12.0,62,4,4,2,10,0xb2d5b31c
100023.03,2.0,6,3,3,3,9,0xb2d97e6b
10000.11,2.0,97,2,3,1,6,0xb2d85b24d
190005.81,3.0,14,3,4,3,10,0xb2da2ec7
1000552.17,2.0,25,4,3,2,9,0xb2d9cd9b
6.33,1.0,41,1,2,2,5,0xb2d90c6b
747.73,1.0,10,1,2,3,6,0xb2d40455d
1603.83,3.0,0,1,4,4,9,0x3b9af1e2
7829.05,1.0,18,2,2,2,6,0xb2d90847
5187.66,1.0,92,2,2,1,5,0xb2d1ba42d
81007.95,7.0,31,3,4,2,9,0xb2d0bd59d
1307281.33,8.0,12,4,4,3,11,0xb2d07f76d
10060.23,2.0,53,2,3,2,7,0xb2d0e834d
199000.93,9.0,38,3,4,2,9,0xb2d4e5edd
560274.33,3.0,66,4,4,2,10,0xb2d140ee
85818.91,3.0,67,3,4,1,8,0xb2d5f082d
50001.58,2.0,11,2,3,3,8,0xb2da3cff
2035.17,1.0,184,1,2,1,4,0xb2d0b652d
200000.0,2.0,11,3,3,3,9,0xb2da4aa0
7.94,1.0,11,1,2,3,6,0xb2d6aafbd
511149.86,3.0,62,4,4,2,10,0xb2d2bfdc
1059680.63,3.0,0,4,4,4,12,0xb2d20ebbd
1581.19,1.0,0,1,2,4,7,0xb2d57bc3
15194.82,1.0,5,2,2,3,7,0xb2d408d4
300000.0,2.0,6,3,3,3,9,0xb2d973bed
400000.11,3.0,11,4,4,3,11,0xb2d788fb
1800905.86,4.0,37,4,4,2,10,0xb2d1c944
344826.95,13.0,6,4,4,3,11,0xb2d10030
100100.6,2.0,151,3,3,1,7,0xb2d5b276d
1889.52,1.0,0,1,2,4,7,0xb2d6b922
19063.66,1.0,10,2,2,3,7,0xb2d2bd06
307313.23,7.0,0,4,4,4,12,0xb2d58356
7010000.0,4.0,3,4,4,4,12,0xb2d8e311d
1120.04,1.0,92,1,2,1,4,0xb2d42515d
300006.33,2.0,52,3,3,2,8,0xb2d909ab
310790.63,6.0,73,4,4,1,9,0xb2d4ee82d
170465.16,3.0,21,3,4,2,9,0xb2d06ad5
280308.36,3.0,39,3,4,2,9,0xb2d6f8a3d
22104.89,1.0,25,2,2,2,6,0xb2d2c77ad
1120319.92,1.0,15,4,2,3,9,0xb2d2a1a7d
2954.24,1.0,13,2,2,3,7,0xb2d93237d
847266.75,22.0,0,4,4,4,12,0xb2d06b21d
500000.0,2.0,19,4,3,2,9,0xb2da2fcb
1.58,1.0,184,1,2,1,4,0xb2d2a25bd
1710.02,1.0,10,1,2,3,6,0xb2d6ca1f
9559.35,1.0,0,2,2,4,8,0xb2d2fd57d
255004.17,6.0,3,3,4,4,11,0xb2d7fbb7d
33176.84,1.0,149,2,2,1,5,0xb2d6d404
1.43,1.0,90,1,2,1,4,0xb2d326c6
710007.51,3.0,10,4,4,3,11,0xb2d6e250
796.6,1.0,5,1,2,3,6,0xb2d6bba0
23.73,1.0,4,1,2,4,7,0xb2d6b9d2
1987.74,1.0,287,1,2,1,4,0xb2d53f8ad
2518.25,1.0,8,1,2,3,6,0xb2d2d217d
100408.51,1.0,10,3,2,3,8,0xb2d24f93d
690.41,1.0,184,1,2,1,4,0xb2d11ec3d
500000.28,2.0,26,4,3,2,9,0xb2d65ca1
100005.88,2.0,59,3,3,2,8,0xb2d36adc
302066.53,2.0,36,4,3,2,9,0xb2d9b2da
5446.33,1.0,1,2,2,4,8,0xb2d5c99dd
6.09,1.0,23,1,2,2,5,0xb2d30795
875.68,1.0,40,1,2,2,5,0xb2d58f96
99177.37,1.0,1,3,2,4,9,0xb2d22bb0d
70002.22,2.0,73,3,3,1,7,0xb2d8df66d
100057.44,2.0,3,3,3,4,10,0xb2d606e3d
103923.25,2.0,125,3,3,1,7,0xb2d41677
354062.71,5.0,1,4,4,4,12,0xb2d069c9
4694.22,1.0,92,2,2,1,5,0xb2d2d5ead
581.29,1.0,3,1,2,4,7,0xb2d1f3f6
150458.0,3.0,1,3,4,4,11,0xb2d17308d
306000.0,4.0,4,4,4,4,12,0xb2d5849bd
50654.01,1.0,12,2,2,3,7,0xb2d4c5f7d
100003.92,3.0,224,3,4,1,8,0xb2d54e70
104422.05,2.0,11,3,3,3,9,0xb2d59d49d
17.84,1.0,42,1,2,2,5,0xb2d4d1c0d
2090.87,1.0,21,1,2,2,5,0xb2d6ddb5
50081.01,2.0,13,2,3,3,8,0xb2d58427
120048.0,2.0,214,3,3,1,7,0xb2d562d9
144940.59,1.0,0,3,2,4,9,0xb2d836e4d
13810.37,1.0,0,2,2,4,8,0xb2d54f10
2.62,1.0,0,1,2,4,7,0xb2d33f88
38288.0,1.0,1,2,2,4,8,0xb2d1e126d
33048.49,4.0,104,2,4,1,7,0xb2d62ee6
3793.8,1.0,9,2,2,3,7,0xb2d31805
300720.1,3.0,24,4,4,2,10,0xb2d69896d
8286.57,1.0,184,2,2,1,5,0xb2d28cd1d
60298.19,2.0,50,3,3,2,8,0xb2d1a0ab
21600.54,1.0,18,2,2,2,6,0xb2d6b155
207.31,1.0,8,1,2,3,6,0xb2d2f364
15.85,1.0,81,1,2,1,4,0xb2d85d2c
1255106.9,5.0,10,4,4,3,11,0xb2d33e55
3020.62,1.0,184,2,2,1,5,0xb2d28683
303358.71,9.0,1,4,4,4,12,0xb2d40ef2d
100235.1,5.0,3,3,4,4,11,0xb2d6b602d
1159.61,1.0,188,1,2,1,4,0xb2d40e10d
930103.82,4.0,20,4,4,2,10,0xb2d65da0d
110951.04,1.0,60,3,2,2,7,0xb2d3c0d1d
3722.31,1.0,16,2,2,2,6,0xb2d8d080
147442.63,2.0,5,3,3,3,9,0xb2d4914c
70001.17,4.0,4,3,4,4,11,0xb2d98c6f
933862.43,18.0,4,4,4,4,12,0x3b9b461ad
109900.48,1.0,18,3,2,2,7,0xb2d343ced
1000000.0,2.0,0,4,3,4,11,0xb2d9839e
34602.57,1.0,22,2,2,2,6,0xb2d68535d
430066.15,3.0,136,4,4,1,9,0xb2d11ad2d
1897.69,1.0,4,1,2,4,7,0xb2d4cb28d
500004.12,3.0,18,4,4,2,10,0xb2d8fc8ed
524014.95,12.0,0,4,4,4,12,0xb2d2625fd
2.73,2.0,40,1,3,2,6,0xb2d50fbc
100471.97,7.0,61,3,4,2,9,0xb2d0785ad
1800078.01,2.0,70,4,3,1,8,0xb2d1ae98d
15.83,1.0,40,1,2,2,5,0xb2d90c4d
550001.58,3.0,0,4,4,4,12,0xb2d968ed
3000035.1,2.0,3,4,3,4,11,0xb2d17091d
3398.25,1.0,4,2,2,4,8,0xb2d554b1d
283203.81,3.0,8,3,4,3,10,0xb2d6443bd
655000.0,9.0,0,4,4,4,12,0xb2d5fd18d
2516.79,1.0,184,1,2,1,4,0xb2d42bc3d
72407.6,3.0,136,3,4,1,8,0xb2d411c2d
178362.66,4.0,1,3,4,4,11,0xb2d8eb0dd
19123.52,1.0,11,2,2,3,7,0xb2d69513d
140052.29,4.0,9,3,4,3,10,0xb2d2aca3d
34.81,1.0,3,1,2,4,7,0xb2d4f7d5d
2636.14,1.0,10,1,2,3,6,0xb2d3f361
10.03,1.0,19,1,2,2,5,0xb2d464d3
3282.45,1.0,31,2,2,2,6,0xb2d2e90c
1428.95,1.0,92,1,2,1,4,0xb2d3637d
340000.0,12.0,8,4,4,3,11,0xb2d6d023d
81668.26,4.0,3,3,4,4,11,0xb2d5b757d
210043.76,4.0,35,3,4,2,9,0xb2d65114
21926.73,1.0,0,2,2,4,8,0xb2d6a5ba
1041.95,2.0,92,1,3,1,5,0xb2d25afcd
200000.0,2.0,29,3,3,2,8,0xb2da0b96
223632.37,1.0,182,3,2,1,6,0xb2d0805ed
3696.64,1.0,0,2,2,4,8,0xb2d78b9a
431077.14,16.0,0,4,4,4,12,0xb2d1af3fd
22735.15,1.0,15,2,2,3,7,0xb2d8c640
9766.76,2.0,29,2,3,2,7,0xb2d6c890
8.57,1.0,54,1,2,2,5,0xb2d6a98bd
50079.8,2.0,1,2,3,4,9,0xb2d2a5a1d
703927.23,7.0,16,4,4,2,10,0xb2d627dd
3891.7,1.0,273,2,2,1,5,0xb2d364c6d
250000.0,3.0,7,3,4,3,10,0xb2d59d19
500010.57,2.0,158,4,3,1,8,0xb2d8efc1d
150005.28,3.0,45,3,4,2,9,0xb2d8d4d2d
19.42,1.0,20,1,2,2,5,0xb2d6a831d
97298.18,3.0,18,3,4,2,9,0xb2d525a4d
171263.7,2.0,1,3,3,4,10,0xb2d11fd0
16028.9,3.0,7,2,4,3,9,0xb2d4f4fa
450012.04,2.0,53,4,3,2,9,0xb2d9be50
14.52,1.0,0,1,2,4,7,0xb2d20ab2
977809.67,6.0,0,4,4,4,12,0xb2d1336e
3004680.36,4.0,3,4,4,4,12,0xb2d17c52d
421367.84,7.0,3,4,4,4,12,0xb2d11816d
311680.24,4.0,39,4,4,2,10,0xb2d620d8d
100557.88,3.0,21,3,4,2,9,0xb2d4299ed
1440000.0,8.0,4,4,4,4,12,0xb2d224f6
50000.53,2.0,189,2,3,1,6,0xb2d859a4d
209253.38,2.0,103,3,3,1,7,0xb2d5f085
1017.63,2.0,92,1,3,1,5,0x3b9b4261d
500000.0,3.0,29,4,4,2,10,0xb2d5887d
50001.49,2.0,80,2,3,1,6,0xb2d5aa88
8353.37,1.0,60,2,2,2,6,0xb2d40e35d
21585.57,1.0,10,2,2,3,7,0xb2d8cf8ad
100013.64,1.0,8,3,2,3,8,0xb2d9e8ea
7297.17,1.0,92,2,2,1,5,0xb2d42369d
2051.76,1.0,29,1,2,2,5,0xb2d69bab
50001.46,2.0,27,2,3,2,7,0xb2d6dfd3
21090.44,1.0,20,2,2,2,6,0xb2d53522d
8.05,1.0,25,1,2,2,5,0xb2d34dad
119394.78,1.0,9,3,2,3,8,0xb2d4c2cad
7406.02,1.0,11,2,2,3,7,0xb2d8b1b1d
385297.74,9.0,0,4,4,4,12,0xb2d41055d
931641.34,5.0,0,4,4,4,12,0xb2d08f6e
200003.31,2.0,19,3,3,2,8,0xb2d13c86d
52.49,1.0,41,1,2,2,5,0xb2d2d488
204336.7,2.0,128,3,3,1,7,0xb2d58f1cd
50.3,1.0,47,1,2,2,5,0xb2d1765a
123150.4,4.0,0,3,4,4,11,0xb2d426c9d
104442.79,2.0,115,3,3,1,7,0xb2d548b2
316538.29,4.0,83,4,4,1,9,0xb2d59469
2327.14,1.0,9,1,2,3,6,0xb2d1d5ae
51.36,1.0,1,1,2,4,7,0xb2d6bf6f
52363.79,2.0,72,3,3,1,7,0xb2d1c2d2d
391309.78,2.0,129,4,3,1,8,0xb2d3c55ed
319387.14,5.0,158,4,4,1,9,0xb2d07834d
171929.18,1.0,38,3,2,2,7,0xb2d68653d
310057.99,1.0,137,4,2,1,7,0xb2d54b78d
350000.0,2.0,11,4,3,3,10,0xb2d8e848d
581776.55,5.0,6,4,4,3,11,0x3b9b33c8
783305.65,10.0,62,4,4,2,10,0xb2d45874d
5.47,1.0,74,1,2,1,4,0xb2d6070bd
612163.41,5.0,4,4,4,4,12,0xb2d0ab6dd
120043.83,3.0,18,3,4,2,9,0xb2d5cec6d
1611.26,1.0,92,1,2,1,4,0xb2d1892f
120004.8,2.0,11,3,3,3,9,0xb2da2599
1924230.51,7.0,49,4,4,2,10,0xb2d57462d
645493.28,3.0,10,4,4,3,11,0xb2d4ce0a
4.54,1.0,15,1,2,3,6,0xb2d68e69
2358.05,1.0,10,1,2,3,6,0xb2d69715d
66524.38,1.0,5,3,2,3,8,0xb2d3ac1cd
3104.87,1.0,112,2,2,1,5,0xb2d4a95ed
0.0,1.0,2,1,2,4,7,0xb2d31a0b
98.01,1.0,20,1,2,2,5,0xb2d10c7c
2797.62,5.0,15,1,4,3,8,0xb2d4f2c7d
200710.42,2.0,39,3,3,2,8,0xb2d9f512
136131.69,6.0,1,3,4,4,11,0x3b9b0e58d
4888.1,1.0,104,2,2,1,5,0xb2d59ff0
2065160.02,2.0,0,4,3,4,11,0xb2d1c1e9d
210049.04,2.0,0,3,3,4,10,0xb2d3c570
132.5,2.0,80,1,3,1,5,0xb2d37e41d
507528.29,4.0,17,4,4,2,10,0xb2d118d2d
54403.52,2.0,1,3,3,4,10,0xb2d430a8d
15156.37,1.0,184,2,2,1,5,0xb2d2bf31d
623.59,1.0,9,1,2,3,6,0xb2d2ed12
238967.71,6.0,3,3,4,4,11,0xb2d0ee5ed
26.14,1.0,3,1,2,4,7,0xb2d80eb8
2349.33,1.0,92,1,2,1,4,0xb2d3eb19d
603.72,1.0,39,1,2,2,5,0xb2d28222d
100009.66,2.0,6,3,3,3,9,0xb2d151e7d
2496598.96,7.0,10,4,4,3,11,0xb2d0a511d
250093.94,4.0,110,3,4,1,8,0xb2d21fa7d
1707.03,1.0,3,1,2,4,7,0xb2d5ae96
100831.7,2.0,134,3,3,1,7,0xb2d19b25
502362.62,2.0,0,4,3,4,11,0xb2d13d15
500000.0,3.0,21,4,4,2,10,0xb2d94ecfd
101841.4,1.0,0,3,2,4,9,0xb2d5d68a
4839.35,1.0,184,2,2,1,5,0xb2d30785d
35102.44,1.0,92,2,2,1,5,0xb2d61c8fd
10590.01,1.0,0,2,2,4,8,0xb2d292b0d
0.77,2.0,6,1,3,3,7,0xb2d24dd0d
60000.63,2.0,35,3,3,2,8,0xb2d9f9f7
1283.78,1.0,92,1,2,1,4,0xb2d243b9d
1134805.13,6.0,0,4,4,4,12,0x3b9af17ed
30001.27,2.0,56,2,3,2,7,0xb2d9c384
314780.75,4.0,3,4,4,4,12,0xb2d4b31dd
437113.24,1.0,31,4,2,2,8,0xb2d3dc57
110062.67,2.0,200,3,3,1,7,0xb2d19fadd
150114.17,2.0,175,3,3,1,7,0xb2d1b53b
35001.53,3.0,97,2,4,1,7,0xb2d6fcfa
184757.0,139.0,1,3,4,4,11,0xb2d350d9d
450897.61,3.0,3,4,4,4,12,0xb2d6d33a
1306073.2,10.0,8,4,4,3,11,0xb2d5cb7ed
1910.54,1.0,184,1,2,1,4,0xb2d2bac0d
100004.75,1.0,1,3,2,4,9,0xb2da1028
140011.24,3.0,139,3,4,1,8,0xb2d45329
61039.8,3.0,1,3,4,4,11,0xb2d9491e
17160.9,1.0,0,2,2,4,8,0xb2d17887d
2594.55,1.0,0,1,2,4,7,0xb2d98e30
1505490.01,4.0,25,4,4,2,10,0xb2d5b01d
160009.46,5.0,52,3,4,2,9,0xb2d63585d
400102.08,3.0,18,4,4,2,10,0xb2d57fd4
5624.5,1.0,9,2,2,3,7,0xb2d8ff04
50003.78,2.0,27,2,3,2,7,0xb2d5639e
90.13,1.0,9,1,2,3,6,0xb2d912add
419485.57,3.0,33,4,4,2,10,0xb2d78149
231403.96,2.0,157,3,3,1,7,0xb2d1511ad
53364.7,2.0,4,3,3,4,10,0xb2d2cc1ed
490.04,1.0,35,1,2,2,5,0xb2d1570c
255612.4,3.0,77,3,4,1,8,0xb2d5a5c4d
151192.25,3.0,1,3,4,4,11,0xb2d41955d
1359.23,1.0,92,1,2,1,4,0x3b9b2428d
11.99,1.0,5,1,2,3,6,0xb2d5e034
383343.85,3.0,0,4,4,4,12,0xb2d4126d
300051.55,2.0,35,3,3,2,8,0xb2d923acd
93.34,1.0,22,1,2,2,5,0xb2d920be
5121.36,1.0,37,2,2,2,6,0xb2d589e9
500885.73,3.0,1,4,4,4,12,0xb2d5e156d
433.91,1.0,25,1,2,2,5,0xb2d6b9dd
65019.13,1.0,0,3,2,4,9,0xb2d785aa
772702.55,3.0,1,4,4,4,12,0xb2d9d762
1.31,1.0,10,1,2,3,6,0xb2d4c669d
200000.11,2.0,19,3,3,2,8,0xb2d9c4cf
0.0,1.0,5,1,2,3,6,0xb2d5a10f
1375430.16,9.0,10,4,4,3,11,0xb2d44100
7897.83,1.0,29,2,2,2,6,0xb2d0fc9bd
358639.65,3.0,14,4,4,3,11,0xb2d5c041d
8517.62,1.0,1,2,2,4,8,0xb2d2eeacd
61.44,1.0,0,1,2,4,7,0xb2d55730
10.34,1.0,19,1,2,2,5,0xb2d8ee2d
127284.83,4.0,0,3,4,4,11,0xb2d51ba2d
31920.41,1.0,14,2,2,3,7,0xb2d8e056d
522247.46,4.0,94,4,4,1,9,0xb2d66300
396.67,1.0,0,1,2,4,7,0xb2d526ec
146000.68,5.0,0,3,4,4,11,0xb2d420dcd
101895.08,3.0,104,3,4,1,8,0xb2d1ca62d
42177.25,1.0,0,2,2,4,8,0xb2d1db2d
91125.39,3.0,92,3,4,1,8,0xb2d5f681
120274.72,4.0,13,3,4,3,10,0xb2d5536ad
300000.0,2.0,21,3,3,2,8,0xb2d951f8d
8.6,1.0,16,1,2,2,5,0xb2d391cb
19915.1,1.0,18,2,2,2,6,0xb2d1bd71
154927.86,2.0,1,3,3,4,10,0xb2d5f354d
731.77,1.0,49,1,2,2,5,0xb2d26c2f
1148.39,1.0,4,1,2,4,7,0xb2d2f782
30.86,1.0,39,1,2,2,5,0xb2d5b04b
90000.95,2.0,47,3,3,2,8,0xb2d91532
106044.78,2.0,35,3,3,2,8,0xb2d9f09a
50000.0,2.0,1,2,3,4,9,0xb2da62f7
198.33,2.0,1,1,3,4,8,0x3b9b372bd
15151.12,1.0,7,2,2,3,7,0xb2d3c3ebd
281.51,1.0,84,1,2,1,4,0xb2d2f60a
1134308.08,3.0,25,4,4,2,10,0xb2d5c30ed
18742.5,1.0,4,2,2,4,8,0xb2d57d05d
516.09,1.0,1,1,2,4,7,0xb2d6bd34d
1560.77,1.0,0,1,2,4,7,0xb2d38088
9002.09,4.0,46,2,4,2,8,0xb2d60234d
40208.67,4.0,0,2,4,4,10,0xb2d0f2ef
118004.85,2.0,3,3,3,4,10,0xb2d0d128
8087.15,1.0,184,2,2,1,5,0xb2d29778
338683.3,4.0,4,4,4,4,12,0xb2d62f6ed
270000.06,1.0,0,3,2,4,9,0xb2d41ba6
1220025.76,2.0,25,4,3,2,9,0xb2da13a7
200019.0,2.0,83,3,3,1,7,0xb2d97e78
4677.19,1.0,51,2,2,2,6,0xb2d47af1
90003.8,3.0,132,3,4,1,8,0xb2d6893fd
500008.53,3.0,12,4,4,3,11,0xb2d6cc95d
2.09,1.0,1,1,2,4,7,0xb2d3f5c3d
1023.02,1.0,4,1,2,4,7,0xb2d4881b
200012.67,2.0,55,3,3,2,8,0xb2d9adb4
560001.27,4.0,26,4,4,2,10,0xb2d59035
736305.67,6.0,1,4,4,4,12,0xb2d1815ed
4224.33,1.0,0,2,2,4,8,0xb2d20accd
78674.32,2.0,1,3,3,4,10,0xb2d17e72d
777144.49,5.0,1,4,4,4,12,0xb2d09f84d
2107.77,2.0,5,1,3,3,7,0xb2d3492d
916013.01,13.0,1,4,4,4,12,0xb2d4ac2d
801.0,1.0,0,1,2,4,7,0xb2d2ee1c
490056.58,2.0,70,4,3,1,8,0xb2d6acb5d
1836.95,1.0,0,1,2,4,7,0xb2d2bd93
80068.47,3.0,1,3,4,4,11,0xb2d91efa
230017.32,4.0,4,3,4,4,11,0xb2d09a28d
434.66,1.0,69,1,2,1,4,0xb2d96f32d
3054.66,1.0,11,2,2,3,7,0xb2d97a04
4416.51,1.0,11,2,2,3,7,0xb2d6f554
1158.72,1.0,35,1,2,2,5,0xb2d68328d
100004.29,2.0,97,3,3,1,7,0xb2d6573b
310.7,1.0,69,1,2,1,4,0xb2d6d5d3d
81.02,1.0,75,1,2,1,4,0xb2d444ccd
30978.4,1.0,7,2,2,3,7,0xb2d55e5cd
1032247.1,5.0,0,4,4,4,12,0xb2d49ebdd
3305597.97,3.0,34,4,4,2,10,0xb2d1964dd
14072.7,1.0,11,2,2,3,7,0xb2d2fce8d
100818.39,2.0,10,3,3,3,9,0xb2d24b9a
900003.3,5.0,7,4,4,3,11,0xb2d63737
200058.19,4.0,80,3,4,1,8,0xb2d63a9ed
121717.54,3.0,95,3,4,1,8,0xb2d5e618d
10041.86,1.0,14,2,2,3,7,0xb2d3223f
11010.3,47.0,9,2,4,3,9,0xb2d126f0
370033.17,4.0,27,4,4,2,10,0xb2d60f85d
208057.63,1.0,5,3,2,3,8,0xb2d62c02d
1657338.26,2.0,6,4,3,3,10,0x3b9b4962d
14828.52,1.0,3,2,2,4,8,0xb2da07fd
10000.42,2.0,41,2,3,2,7,0xb2d91e4a
604982.13,2.0,22,4,3,2,9,0xb2d0769ad
51359.4,2.0,10,2,3,3,8,0xb2d612dcd
221.57,1.0,0,1,2,4,7,0xb2d75b30
2.64,1.0,22,1,2,2,5,0xb2d6c85d
1399.68,1.0,69,1,2,1,4,0xb2d289f1d
3419.31,1.0,129,2,2,1,5,0xb2d1759bd
2200091.18,5.0,19,4,4,2,10,0xb2d5aa93
286198.95,4.0,23,3,4,2,9,0xb2d78cc1d
1.47,1.0,9,1,2,3,6,0xb2d5fb46
260150.16,5.0,31,3,4,2,9,0xb2d2a107d
30302.94,2.0,1,2,3,4,9,0xb2d3a6a4
17306.72,2.0,19,2,3,2,7,0xb2d3c1fa
30400.96,4.0,26,2,4,2,8,0x3b9b48f9d
16357.7,1.0,20,2,2,2,6,0xb2d572a7d
64.34,1.0,1,1,2,4,7,0xb2d3a8a3
10335.69,1.0,2,2,2,4,8,0xb2d220b9d
5255933.66,3.0,125,4,4,1,9,0xb2d5b537d
105246.21,2.0,136,3,3,1,7,0xb2d346ebd
280884.99,2.0,263,3,3,1,7,0xb2d2e398d
147533.77,3.0,0,3,4,4,11,0xb2d2cfc2d
10399.51,1.0,10,2,2,3,7,0xb2d8e197
120049.0,2.0,0,3,3,4,10,0xb2d06866
383139.84,4.0,14,4,4,3,11,0xb2d45867d
1743313.31,5.0,11,4,4,3,11,0xb2d22c18d
460000.0,4.0,9,4,4,3,11,0xb2d0dd10d
311111.91,1.0,47,4,2,2,8,0xb2d52012d
6190.27,1.0,0,2,2,4,8,0x3b9af506d
61569.67,7.0,1,3,4,4,11,0x3b9af24ad
200009.5,3.0,34,3,4,2,9,0xb2d9f59c
200000.0,2.0,3,3,3,4,10,0xb2d62b0fd
2953.61,1.0,92,2,2,1,5,0xb2d320c2d
2300696.19,1.0,0,4,2,4,10,0xb2d147c0d
600620.5,3.0,0,4,4,4,12,0xb2d5515cd
350802.85,3.0,4,4,4,4,12,0xb2d5a7aad
355381.25,2.0,3,4,3,4,11,0xb2d12608
16756.72,1.0,14,2,2,3,7,0xb2d3196f
183.11,1.0,2,1,2,4,7,0xb2d342e6
50000.53,2.0,80,2,3,1,6,0xb2d23c26d
13955.2,1.0,0,2,2,4,8,0xb2d1291ad
15061.52,1.0,184,2,2,1,5,0xb2d5f7abd
631.91,1.0,10,1,2,3,6,0xb2d783aed
600710.42,4.0,4,4,4,4,12,0xb2d0bfbfd
20067.58,2.0,98,2,3,1,6,0xb2d57fc5d
5097841.04,2.0,0,4,3,4,11,0xb2d10b20d
45000.48,2.0,20,2,3,2,7,0xb2d68711
1.15,1.0,76,1,2,1,4,0xb2d5c748
210000.0,4.0,0,3,4,4,11,0xb2d5d9b4d
2283120.57,6.0,0,4,4,4,12,0xb2d2bcc8d
702462.99,2.0,12,4,3,3,10,0xb2d22c83
200000.24,2.0,17,3,3,2,8,0xb2da2e8f
2730.38,1.0,19,1,2,2,5,0xb2d2d9abd
16306.31,1.0,14,2,2,3,7,0xb2d97cfd
893974.69,8.0,39,4,4,2,10,0xb2d10f96d
10032.96,1.0,92,2,2,1,5,0xb2d4b30fd
1.66,1.0,38,1,2,2,5,0xb2d6f580d
1020035.02,7.0,8,4,4,3,11,0xb2d63cb2d
1651143.59,5.0,0,4,4,4,12,0x3b9b1813d
405398.6,4.0,11,4,4,3,11,0xb2d14cf1d
51113.46,2.0,1,2,3,4,9,0xb2d60387d
608011.7,4.0,8,4,4,3,11,0xb2d3045bd
6270.29,1.0,0,2,2,4,8,0xb2d8d106
0.0,1.0,9,1,2,3,6,0xb2d5cc20
322962.46,3.0,48,4,4,2,10,0xb2d16984d
8359.84,1.0,0,2,2,4,8,0xb2d9202c
500000.82,2.0,5,4,3,3,10,0xb2d681fd
202843.51,2.0,147,3,3,1,7,0xb2d6e380
81003.62,1.0,6,3,2,3,8,0xb2d2de59d
4.12,1.0,19,1,2,2,5,0xb2da20ab
1319.88,1.0,92,1,2,1,4,0xb2d17bc7d
10243.74,1.0,155,2,2,1,5,0xb2d5d804d
83841.27,3.0,213,3,4,1,8,0x3b9b3c7bd
1003.38,1.0,6,1,2,3,6,0xb2d958e9d
14.13,1.0,19,1,2,2,5,0xb2d6b696
5912.87,1.0,104,2,2,1,5,0xb2d104e3
504126.72,2.0,0,4,3,4,11,0xb2d22512d
6290.44,1.0,0,2,2,4,8,0xb2d33db9d
972.67,1.0,27,1,2,2,5,0xb2d90e8c
661.11,1.0,4,1,2,4,7,0xb2d3f6e5
4221.78,1.0,22,2,2,2,6,0xb2d140c2
200002.11,2.0,46,3,3,2,8,0xb2d9d980
22573.06,1.0,1,2,2,4,8,0xb2d6efa0
100024.79,1.0,2,3,2,4,9,0xb2d9c868
1450.05,1.0,208,1,2,1,4,0xb2d5c11b
4248577.38,2.0,0,4,3,4,11,0xb2d237c7d
230987.7,1.0,21,3,2,2,7,0xb2d1be4e
200765.0,2.0,55,3,3,2,8,0xb2d68cfad
363474.28,2.0,1,4,3,4,11,0xb2d2c72a
5068.64,2.0,92,2,3,1,6,0xb2d20387d
3745.82,1.0,12,2,2,3,7,0xb2d65471
1214.24,1.0,92,1,2,1,4,0xb2d1fc62d
500052.32,3.0,4,4,4,4,12,0xb2d8de5ad
1125.19,1.0,11,1,2,3,6,0xb2d6c2b8
100000.0,5.0,0,3,4,4,11,0xb2d170b3d
11151.11,1.0,10,2,2,3,7,0xb2d238abd
600020.65,6.0,7,4,4,3,11,0xb2d4336b
219494.39,2.0,1,3,3,4,10,0xb2d12fa9d
752.76,1.0,2,1,2,4,7,0xb2d94bb7
1000025.14,3.0,12,4,4,3,11,0xb2d12739
18.58,1.0,33,1,2,2,5,0xb2d551f5
201634.73,7.0,0,3,4,4,11,0xb2d4915fd
3165.9,1.0,184,2,2,1,5,0xb2d0f723d
214817.39,2.0,63,3,3,2,8,0xb2d5bab2d
117.13,1.0,23,1,2,2,5,0xb2d995db
242182.42,4.0,87,3,4,1,8,0xb2d07dd3d
100003.17,2.0,228,3,3,1,7,0xb2d6f1bc
57.09,1.0,67,1,2,1,4,0xb2d14b0ad
813430.16,5.0,1,4,4,4,12,0xb2d58725d
0.32,1.0,1,1,2,4,7,0xb2d118e5
100745.0,2.0,0,3,3,4,10,0xb2d9018dd
7074.09,1.0,184,2,2,1,5,0xb2d25f89
175.82,1.0,26,1,2,2,5,0xb2d553fe
66557.52,1.0,6,3,2,3,8,0xb2d6a4a3d
501776.51,3.0,43,4,4,2,10,0xb2d78807d
100080.75,2.0,203,3,3,1,7,0xb2d1bdd0
41676.27,4.0,23,2,4,2,8,0xb2d582ded
2581.3,1.0,240,1,2,1,4,0xb2d13c2e
7674.65,1.0,1,2,2,4,8,0xb2d50dd2d
37102.46,1.0,4,2,2,4,8,0xb2d2c301
9304908.68,4.0,0,4,4,4,12,0xb2d1436c
162786.55,1.0,0,3,2,4,9,0xb2d375d6
1260.23,1.0,184,1,2,1,4,0xb2d22501d
5.96,1.0,105,1,2,1,4,0xb2d88c43d
271018.74,11.0,8,3,4,3,10,0xb2d24d57d
200093.32,3.0,27,3,4,2,9,0xb2d62df5
50094.59,2.0,13,2,3,3,8,0xb2d389be
80028.58,2.0,49,3,3,2,8,0xb2d24532d
257051.03,1.0,0,3,2,4,9,0xb2d38d00d
3507.49,1.0,3,2,2,4,8,0xb2d2e2f7
300494.59,3.0,9,4,4,3,11,0xb2d55992
17295.42,1.0,4,2,2,4,8,0xb2d53f48
603554.82,4.0,173,4,4,1,9,0xb2d65bf8d
8915.27,3.0,1,2,4,4,10,0xb2d23f17
2510.89,1.0,184,1,2,1,4,0xb2d28dbdd
2.55,1.0,2,1,2,4,7,0xb2d4b3b2
81130.61,7.0,0,3,4,4,11,0xb2d1a30d
3475.64,2.0,184,2,3,1,6,0xb2d16e84d
20000.21,2.0,62,2,3,2,7,0xb2d8f75cd
50208.36,1.0,92,2,2,1,5,0xb2d55d67
58392.13,3.0,0,3,4,4,11,0xb2d8f6d1d
384557.02,2.0,0,4,3,4,11,0xb2d184c1
5050.15,3.0,105,2,4,1,7,0xb2d60810d
70808.77,1.0,92,3,2,1,6,0xb2d240c4d
30000.95,2.0,199,2,3,1,6,0xb2d69466
26008.52,1.0,6,2,2,3,7,0xb2d6bb58d
0.0,2.0,84,1,3,1,5,0xb2d459bd
553010.41,2.0,184,4,3,1,8,0xb2d65609d
1687766.81,10.0,0,4,4,4,12,0xb2d3f610
322074.55,1.0,5,4,2,3,9,0xb2d3658e
21.58,1.0,39,1,2,2,5,0xb2d927ee
164275.4,3.0,63,3,4,2,9,0xb2d5615dd
961001.54,4.0,0,4,4,4,12,0xb2d6423a
3924.25,1.0,1,2,2,4,8,0xb2d1525fd
430540.25,2.0,0,4,3,4,11,0xb2d9a5b8
751179.97,3.0,46,4,4,2,10,0xb2d90b57d
78600.0,5.0,0,3,4,4,11,0x3b9b377e
568001.31,5.0,1,4,4,4,12,0xb2d659c0
50002.64,2.0,209,2,3,1,6,0xb2d4100ed
412146.72,9.0,0,4,4,4,12,0x3b9b45e8
106020.75,4.0,235,3,4,1,8,0xb2d32ee4d
10003.53,2.0,19,2,3,2,7,0xb2d5abd2d
2387.29,1.0,13,1,2,3,6,0xb2d27747d
235018.89,4.0,21,3,4,2,9,0xb2d5a34ad
7755.47,1.0,0,2,2,4,8,0xb2d3683c
2647.04,1.0,7,1,2,3,6,0xb2d1d897d
8479.02,1.0,0,2,2,4,8,0xb2d6bcdad
2202074.03,8.0,2,4,4,4,12,0xb2d2369ad
70006.35,2.0,39,3,3,2,8,0xb2d45998d
270044.04,7.0,19,3,4,2,9,0xb2d2b8b0
6183.88,1.0,92,2,2,1,5,0xb2d205a8
6777.48,1.0,4,2,2,4,8,0xb2d6d3b2d
60691.04,1.0,3,3,2,4,9,0xb2d57b84d
320101.77,3.0,12,4,4,3,11,0xb2d3934cd
436038.41,4.0,0,4,4,4,12,0xb2d78736d
60049.67,3.0,41,3,4,2,9,0xb2d6adcdd
354401.82,8.0,0,4,4,4,12,0xb2d1a674d
1669.91,1.0,60,1,2,2,5,0xb2d253fad
10.66,1.0,18,1,2,2,5,0xb2d177c6d
1700068.25,5.0,24,4,4,2,10,0xb2d1b29cd
60013.5,4.0,11,3,4,3,10,0xb2d09b0c
3601824.07,35.0,1,4,4,4,12,0xb2d22a7f
11001615.0,2.0,3,4,3,4,11,0xb2d9347ad
320002.95,11.0,42,4,4,2,10,0xb2d0c85ed
472873.38,6.0,4,4,4,4,12,0xb2d65983d
1657747.13,8.0,0,4,4,4,12,0xb2d57a11d
1118.54,2.0,96,1,3,1,5,0xb2d089f3d
50636.83,2.0,3,2,3,4,9,0xb2d6c0afd
38883.74,1.0,25,2,2,2,6,0xb2d63e0dd
319074.07,3.0,10,4,4,3,11,0xb2d17ada
19493.29,1.0,0,2,2,4,8,0xb2d92552d
5.37,1.0,33,1,2,2,5,0xb2d25375
100817.37,2.0,116,3,3,1,7,0xb2d62ec3d
691855.26,6.0,19,4,4,2,10,0xb2d1e8e0d
50000.53,2.0,83,2,3,1,6,0xb2d985aa
37539.01,1.0,0,2,2,4,8,0xb2d69080d
107.81,1.0,54,1,2,2,5,0xb2d5f060
93000.0,3.0,2,3,4,4,11,0xb2d50ca2d
190013.25,3.0,74,3,4,1,8,0xb2d63729d
63914.34,3.0,3,3,4,4,11,0x3b9af139d
450024.38,2.0,119,4,3,1,8,0xb2d6c5c9d
450048.06,4.0,15,4,4,3,11,0xb2d9489fd
806093.31,3.0,0,4,4,4,12,0xb2d58134d
10000.95,2.0,92,2,3,1,6,0xb2d6588e
2307.86,1.0,6,1,2,3,6,0xb2d57373d
1108.5,1.0,92,1,2,1,4,0xb2d38a70
1102505.92,4.0,53,4,4,2,10,0xb2d9a086
1208562.15,4.0,11,4,4,3,11,0xb2d4ed1ad
100062.59,2.0,132,3,3,1,7,0xb2d22360
1501953.77,4.0,101,4,4,1,9,0xb2d5f4d0d
2354.06,1.0,2,1,2,4,7,0xb2d43447d
203334.21,2.0,20,3,3,2,8,0xb2d577afd
52783.09,1.0,92,3,2,1,6,0xb2d11b97d
14017.26,1.0,15,2,2,3,7,0xb2d8cd3dd
851144.62,6.0,87,4,4,1,9,0xb2d3f881
8376.27,1.0,0,2,2,4,8,0xb2d9429cd
7919.05,3.0,40,2,4,2,8,0xb2d0c6cad
100001.84,2.0,192,3,3,1,7,0xb2d5d56b
301604.63,2.0,8,4,3,3,10,0xb2d6bb73
5482.17,1.0,131,2,2,1,5,0xb2d6b9d5d
520.11,1.0,72,1,2,1,4,0xb2d92437d
2420.52,1.0,1,1,2,4,7,0xb2d8d14dd
802.26,1.0,0,1,2,4,7,0xb2d96b74
1642.91,1.0,0,1,2,4,7,0xb2d6b968
150773.44,1.0,184,3,2,1,6,0xb2d5000ad
4938.79,1.0,21,2,2,2,6,0xb2d963d7
4038.8,1.0,10,2,2,3,7,0xb2d41d2c
3.05,1.0,16,1,2,2,5,0xb2d7d190
7437.99,1.0,0,2,2,4,8,0xb2d57ee4
210166.29,2.0,31,3,3,2,8,0xb2d93795d
2562027.57,7.0,18,4,4,2,10,0xb2d1ad7a
13885.63,2.0,0,2,3,4,9,0xb2d32fc1d
505027.79,3.0,13,4,4,3,11,0xb2d6b1efd
91116.25,2.0,20,3,3,2,8,0xb2d15766d
307125.82,3.0,110,4,4,1,9,0xb2d60db5d
22869.95,3.0,4,2,4,4,10,0xb2d8d087d
203911.3,1.0,9,3,2,3,8,0xb2d412a3d
5381.3,1.0,10,2,2,3,7,0xb2d3dbafd
8427.18,1.0,7,2,2,3,7,0xb2d6bb5b
1117.9,1.0,184,1,2,1,4,0xb2d25152d
900030.93,8.0,6,4,4,3,11,0xb2d1de9dd
4.73,1.0,60,1,2,2,5,0xb2d1a024d
20087.67,2.0,62,2,3,2,7,0xb2d7f224d
10000.32,2.0,206,2,3,1,6,0xb2d5c4a2d
28745.68,1.0,7,2,2,3,7,0xb2d2d798
150000.37,2.0,33,3,3,2,8,0xb2d68708
200013.72,3.0,67,3,4,1,8,0xb2d992f3
385142.76,3.0,11,4,4,3,11,0xb2d22513d
600003.49,4.0,1,4,4,4,12,0xb2d6bcd0
150001.58,2.0,92,3,3,1,7,0xb2d980f9d
68461.68,1.0,33,3,2,2,7,0xb2d0baa4
100447.82,2.0,263,3,3,1,7,0xb2d45a5fd
10101.08,1.0,184,2,2,1,5,0xb2d19e56d
421.75,1.0,0,1,2,4,7,0xb2d5588bd
60.44,1.0,74,1,2,1,4,0xb2d5b5cb
30000.32,2.0,77,2,3,1,6,0xb2d996a0
1607.18,1.0,0,1,2,4,7,0xb2d23c0c
600070.05,2.0,12,4,3,3,10,0xb2d64491d
72251.37,2.0,26,3,3,2,8,0xb2d26050d
300000.0,2.0,20,3,3,2,8,0xb2d8d3cc
3617.32,1.0,184,2,2,1,5,0xb2d220a2
824180.24,8.0,5,4,4,3,11,0xb2d0da8bd
200031.34,2.0,29,3,3,2,8,0xb2d942f7
4104.88,1.0,0,2,2,4,8,0xb2d67d5dd
373.37,2.0,13,1,3,3,7,0xb2d2bbaed
1025.52,1.0,92,1,2,1,4,0xb2d0e6f3d
98374.23,3.0,92,3,4,1,8,0xb2d69e8ed
10237.35,1.0,141,2,2,1,5,0xb2d37c22d
600000.0,2.0,6,4,3,3,10,0xb2da597e
16250.42,1.0,2,2,2,4,8,0xb2d2ebccd
81035.32,2.0,12,3,3,3,9,0xb2d5f20a
80080.11,3.0,18,3,4,2,9,0xb2d2f897d
7.8,1.0,74,1,2,1,4,0xb2d47ba0
41305.66,1.0,28,2,2,2,6,0xb2d5ac6ed
55197.41,2.0,53,3,3,2,8,0xb2d1b8a7d
20638.01,1.0,1,2,2,4,8,0xb2d6b4c0d
354560.36,5.0,1,4,4,4,12,0xb2d16ec7
38.57,1.0,21,1,2,2,5,0xb2d79040
592167.34,3.0,0,4,4,4,12,0xb2d691c8d
300004.72,2.0,53,3,3,2,8,0xb2d22d9cd
150001.58,2.0,13,3,3,3,9,0xb2d95e4ad
9985.85,5.0,92,2,4,1,7,0xb2d3784ed
3105.34,4.0,17,2,4,2,8,0xb2d2579cd
950632.84,7.0,4,4,4,4,12,0xb2d3c421d
11792.27,1.0,9,2,2,3,7,0xb2d593e0
10085.19,2.0,118,2,3,1,6,0xb2d2a2d3d
49.62,2.0,40,1,3,2,6,0xb2d31b72
4.65,1.0,57,1,2,2,5,0xb2d1a31cd
600.91,1.0,0,1,2,4,7,0xb2d6baf2d
30038.45,2.0,62,2,3,2,7,0xb2d63549d
300071.18,3.0,41,3,4,2,9,0xb2d5aaa3d
39000.91,2.0,12,2,3,3,8,0xb2d1e709d
1804.11,1.0,92,1,2,1,4,0xb2d33ec8d
10000.32,2.0,92,2,3,1,6,0xb2d65e8fd
250000.0,4.0,0,3,4,4,11,0xb2d6a977d
457451.14,6.0,0,4,4,4,12,0xb2d26a54
189409.96,2.0,46,3,3,2,8,0xb2d6bff1
496585.74,2.0,57,4,3,2,9,0xb2d60f4d
195.86,1.0,23,1,2,2,5,0xb2d61019
9.5,1.0,69,1,2,1,4,0xb2d9a2c3
1760000.0,14.0,0,4,4,4,12,0xb2d11112d
2209.24,1.0,25,1,2,2,5,0xb2d4e9c3
411378.93,2.0,128,4,3,1,8,0xb2d6da0ad
380166.79,3.0,60,4,4,2,10,0xb2d58ef5
50010.56,1.0,7,2,2,3,7,0xb2d931d9
5.78,1.0,1,1,2,4,7,0xb2d60a26
491259.73,1.0,0,4,2,4,10,0xb2d63007d
47019.02,5.0,0,2,4,4,10,0x3b9b48f2d
9243.94,1.0,15,2,2,3,7,0xb2d85bead
2283300.97,19.0,0,4,4,4,12,0x3b9b1811d
20619.83,3.0,1,2,4,4,10,0xb2d54f09d
549.13,1.0,4,1,2,4,7,0xb2d3a1aa
25736.35,1.0,21,2,2,2,6,0xb2d5772fd
90000.95,2.0,123,3,3,1,7,0xb2d93b92d
353997.41,7.0,2,4,4,4,12,0xb2d1723bd
370074.77,2.0,11,4,3,3,10,0xb2d52724d
400736.05,4.0,11,4,4,3,11,0xb2d6881dd
25989.45,1.0,10,2,2,3,7,0xb2d3e881d
200000.0,2.0,12,3,3,3,9,0xb2da4977
3081260.28,8.0,15,4,4,3,11,0x3b9b490dd
308833.85,52.0,0,4,4,4,12,0xb2d0bc4ad
256005.86,5.0,67,3,4,1,8,0xb2d65696d
533000.95,5.0,5,4,4,3,11,0xb2d0be2ad
260008.23,5.0,0,3,4,4,11,0xb2d91d76d
1485456.36,3.0,83,4,4,1,9,0xb2d2dc2d
330029.55,5.0,31,4,4,2,10,0xb2d1e518d
195008.99,6.0,1,3,4,4,11,0xb2d57947
505715.19,6.0,0,4,4,4,12,0xb2d3c356d
42.24,1.0,19,1,2,2,5,0xb2d23a5ed
3117.01,1.0,3,2,2,4,8,0xb2d25c35
576645.56,3.0,83,4,4,1,9,0xb2d10487d
276006.63,5.0,55,3,4,2,9,0xb2d1beb2
5870.46,1.0,5,2,2,3,7,0xb2d48c76d
148.3,1.0,37,1,2,2,5,0xb2d30b42
33223.25,2.0,0,2,3,4,9,0xb2d064d2
6248.4,1.0,9,2,2,3,7,0xb2d2b7bcd
761476.0,4.0,0,4,4,4,12,0xb2d311a3d
23.12,1.0,13,1,2,3,6,0xb2d589e9d
37.76,1.0,1,1,2,4,7,0xb2d8ef25
126.32,1.0,20,1,2,2,5,0xb2d52bd1
126899.86,2.0,184,3,3,1,7,0xb2d1fc3ed
100009.63,2.0,97,3,3,1,7,0xb2d58e3dd
86.98,1.0,0,1,2,4,7,0xb2d912e1d
250017.95,5.0,54,3,4,2,9,0xb2d15283d
359344.03,4.0,6,4,4,3,11,0xb2d418d5d
16475.08,1.0,10,2,2,3,7,0xb2d48e45
190000.07,3.0,6,3,4,3,10,0xb2d2a305d
50346.19,2.0,67,2,3,1,6,0xb2d3d413d
110002.64,4.0,31,3,4,2,9,0xb2d28a75d
5467.39,1.0,15,2,2,3,7,0xb2d0cd0a
86.12,1.0,0,1,2,4,7,0xb2d53601d
101046.33,2.0,32,3,3,2,8,0xb2d3bb2fd
256348.51,1.0,11,3,2,3,8,0xb2d911d1
2570.03,1.0,17,1,2,2,5,0xb2d6e4a3
220002.31,3.0,11,3,4,3,10,0xb2d925bfd
6447.53,1.0,9,2,2,3,7,0xb2d5ad13d
42330.44,1.0,204,2,2,1,5,0xb2d60d9dd
50000.53,2.0,35,2,3,2,7,0xb2d9f992
15505.09,1.0,1,2,2,4,8,0xb2d291a4d
280004.23,3.0,14,3,4,3,10,0xb2d518d4d
708464.16,4.0,8,4,4,3,11,0xb2d21d4c
430049.91,6.0,25,4,4,2,10,0xb2d0e3ced
524.73,1.0,16,1,2,2,5,0xb2d98a78
420001.5,3.0,8,4,4,3,11,0xb2d691f6d
163022.28,2.0,21,3,3,2,8,0xb2d54c07d
11599.76,1.0,15,2,2,3,7,0xb2d2ecd7d
197.26,1.0,10,1,2,3,6,0xb2d9d2e9
18544.05,1.0,0,2,2,4,8,0xb2d5051f
450068.06,2.0,0,4,3,4,11,0xb2d25261d
205591.21,1.0,167,3,2,1,6,0xb2d1dd4fd
10044.67,2.0,5,2,3,3,8,0xb2da3c00
3252.93,1.0,0,2,2,4,8,0xb2d5f9a7d
3849.06,2.0,39,2,3,2,7,0x3b9b2924
90494.22,2.0,34,3,3,2,8,0xb2d5ad43d
1005.24,1.0,0,1,2,4,7,0xb2d55cd2d
1241.34,2.0,92,1,3,1,5,0xb2d0e3c4d
4105846.16,3.0,133,4,4,1,9,0xb2d5d776
318013.21,5.0,62,4,4,2,10,0xb2d24f83d
1180087.37,3.0,11,4,4,3,11,0xb2d163b1d
11.97,1.0,33,1,2,2,5,0xb2d48266d
35910.39,1.0,15,2,2,3,7,0xb2d48c56d
14498.75,1.0,184,2,2,1,5,0xb2d3e474d
512102.53,2.0,21,4,3,2,9,0xb2d14878d
137859.1,3.0,217,3,4,1,8,0xb2d5cf3c
1010.28,1.0,92,1,2,1,4,0xb2d3eb06d
334.87,1.0,4,1,2,4,7,0xb2d2b7ac
3439.7,1.0,1,2,2,4,8,0xb2d3b26f
385.71,1.0,9,1,2,3,6,0xb2d22c83d
270009.39,5.0,6,3,4,3,10,0xb2d16cbcd
40446.56,4.0,5,2,4,3,9,0xb2d55a6a
650003.71,7.0,6,4,4,3,11,0xb2d21d3ed
301197.71,2.0,25,4,3,2,9,0xb2d64e7e
3933.7,1.0,0,2,2,4,8,0xb2d59a81d
12300.09,2.0,0,2,3,4,9,0xb2d550ead
11847.38,1.0,34,2,2,2,6,0xb2d6d7a2
101401.44,1.0,160,3,2,1,6,0xb2d22eb1
500000.0,3.0,0,4,4,4,12,0xb2d97802
381.13,1.0,61,1,2,2,5,0xb2d575f2
0.63,2.0,49,1,3,2,6,0xb2d50e13
138026.77,5.0,1,3,4,4,11,0xb2d064f0d
2089.71,1.0,0,1,2,4,7,0xb2d5efd7
50009.42,3.0,90,2,4,1,7,0xb2d0d0ddd
821998.25,5.0,35,4,4,2,10,0xb2d367fad
50099.41,1.0,1,2,2,4,8,0xb2d9f35d
1544638.24,7.0,3,4,4,4,12,0xb2d5d5bad
690003.89,8.0,0,4,4,4,12,0xb2d63751d
18796.77,1.0,10,2,2,3,7,0xb2d5b56a
0.0,1.0,1,1,2,4,7,0xb2d95fead
1502475.0,6.0,245,4,4,1,9,0xb2d6d337d
73840.08,2.0,259,3,3,1,7,0xb2d42f40d
424066.09,7.0,67,4,4,1,9,0xb2d5606e
57.0,5.0,7,1,4,3,8,0xb2d06b0ad
4.64,1.0,4,1,2,4,7,0xb2d33dff
63796.89,2.0,25,3,3,2,8,0xb2d3a189d
220739.6,3.0,5,3,4,3,10,0xb2d3d92bd
2.73,2.0,39,1,3,2,6,0xb2d07300
11973029.39,5.0,0,4,4,4,12,0xb2d6d9bcd
16323.06,1.0,184,2,2,1,5,0xb2d4fdffd
14781.23,1.0,50,2,2,2,6,0xb2d1d865
4166.67,3.0,237,2,4,1,7,0xb2d5fda0d
360859.56,2.0,20,4,3,2,9,0xb2d640f9d
150004.55,4.0,95,3,4,1,8,0xb2d3fe0bd
14.57,15.0,64,1,4,2,7,0x3b9b36cdd
276708.4,3.0,0,3,4,4,11,0xb2d6a2b2d
550000.1,4.0,10,4,4,3,11,0xb2d10e1dd
313413.75,1.0,21,4,2,2,8,0xb2d2ab37d
20569.09,2.0,101,2,3,1,6,0xb2d64545d
30000.32,2.0,200,2,3,1,6,0xb2d7abe6
474442.48,4.0,11,4,4,3,11,0xb2d1878bd
1627.37,1.0,6,1,2,3,6,0xb2d31958
6.42,1.0,83,1,2,1,4,0xb2d824c1
1111.89,1.0,92,1,2,1,4,0xb2d29852d
937227.94,11.0,47,4,4,2,10,0xb2d07557
200013.35,2.0,98,3,3,1,7,0xb2d61570d
113010.76,3.0,27,3,4,2,9,0xb2d5925bd
201028.47,4.0,3,3,4,4,11,0x3b9b3e43
0.0,1.0,5,1,2,3,6,0xb2da5ca2
200024.84,3.0,53,3,4,2,9,0xb2d56cb2d
409012.52,4.0,42,4,4,2,10,0xb2d5ea0c
350010.06,5.0,10,4,4,3,11,0xb2d3abcd
764838.3,4.0,0,4,4,4,12,0xb2d5f2ced
31006.23,1.0,1,2,2,4,8,0x3b9af008
1125.01,1.0,1,1,2,4,7,0xb2d26f2c
260311.31,14.0,38,3,4,2,9,0xb2d5f68f
206437.71,2.0,27,3,3,2,8,0xb2d1045d
52035.46,2.0,179,2,3,1,6,0xb2d59105
3093.9,1.0,9,2,2,3,7,0xb2d87121
459000.0,3.0,1,4,4,4,12,0xb2d81d7b
1842.6,1.0,0,1,2,4,7,0xb2d7048e
411231.15,3.0,94,4,4,1,9,0xb2d4773ed
51796.26,2.0,82,2,3,1,6,0xb2d40dbcd
9328.36,1.0,22,2,2,2,6,0xb2d6bda1d
89033.56,4.0,0,3,4,4,11,0xb2d210afd
2969.85,1.0,0,2,2,4,8,0xb2d5d162
12345.3,1.0,3,2,2,4,8,0xb2d29f7a
200031.36,2.0,26,3,3,2,8,0xb2d94085d
50022.98,5.0,68,2,4,1,7,0xb2d0a7ef
614081.41,7.0,76,4,4,1,9,0xb2d180acd
1190944.18,13.0,0,4,4,4,12,0xb2d10f76d
310006.54,4.0,94,4,4,1,9,0xb2d87cb3
271927.3,6.0,0,3,4,4,11,0xb2d07f9ad
50488.23,1.0,184,2,2,1,5,0xb2d331f4d
1495.24,1.0,73,1,2,1,4,0xb2d21d78
12.23,1.0,20,1,2,2,5,0xb2d37931
1874846.65,8.0,0,4,4,4,12,0xb2d194d6d
50099.68,2.0,146,2,3,1,6,0xb2d8cb84d
901888.62,3.0,3,4,4,4,12,0xb2d16c52d
600096.35,3.0,8,4,4,3,11,0xb2d96858
1937.53,1.0,184,1,2,1,4,0xb2d1abfcd
250966.23,2.0,7,3,3,3,9,0xb2d1532fd
9728.39,1.0,9,2,2,3,7,0xb2d3d6d8
1287.76,1.0,0,1,2,4,7,0xb2d91ca2
4.29,1.0,110,1,2,1,4,0xb2d652e3d
202852.68,3.0,129,3,4,1,8,0xb2d1b26ed
220878.0,2.0,118,3,3,1,7,0xb2d434b1d
331639.54,3.0,1,4,4,4,12,0xb2d6b341d
10175.69,1.0,184,2,2,1,5,0xb2d2f361d
140041.72,2.0,221,3,3,1,7,0xb2d35ae5d
53001.12,2.0,59,3,3,2,8,0xb2d8fbd6d
1633.93,1.0,24,1,2,2,5,0xb2d7efb1
78.7,1.0,46,1,2,2,5,0xb2d2842a
65982.43,2.0,0,3,3,4,10,0xb2d0e611
196722.55,5.0,33,3,4,2,9,0xb2d60b08
205098.93,2.0,224,3,3,1,7,0xb2d2b097
480373.51,8.0,0,4,4,4,12,0x3b9af0cfd
4952442.8,9.0,0,4,4,4,12,0xb2d95eadd
710009.47,4.0,1,4,4,4,12,0xb2d3ee62d
18742.91,1.0,26,2,2,2,6,0xb2d49f4fd
12267.07,1.0,21,2,2,2,6,0xb2d2974f
24560.52,2.0,13,2,3,3,8,0xb2d19b17d
1407892.4,8.0,34,4,4,2,10,0xb2d0fb3d
30001.58,2.0,34,2,3,2,7,0xb2d9f69b
156019.81,3.0,76,3,4,1,8,0xb2d5a5fe
10795.92,1.0,1,2,2,4,8,0xb2d49718d
4617.88,1.0,10,2,2,3,7,0xb2d69592
100001.06,2.0,48,3,3,2,8,0xb2d90cfdd
3238.41,1.0,21,2,2,2,6,0xb2d2459c
70600.07,2.0,27,3,3,2,8,0xb2d416b9d
4710.45,2.0,184,2,3,1,6,0xb2d56bd8
240005.07,2.0,16,3,3,2,8,0xb2d99444
2000107.17,3.0,39,4,4,2,10,0xb2d605c5d
356220.98,2.0,37,4,3,2,9,0xb2d6d6d4d
2246.14,1.0,94,1,2,1,4,0xb2d36a4cd
239656.86,5.0,13,3,4,3,10,0xb2d27034d
700073.52,3.0,7,4,4,3,11,0xb2d8e507d
4342.71,1.0,0,2,2,4,8,0xb2d2a8a6
2738.65,1.0,49,1,2,2,5,0xb2d3902dd
128.6,1.0,4,1,2,4,7,0xb2d21303d
50001.58,2.0,200,2,3,1,6,0xb2d78ce2
500000.26,5.0,1,4,4,4,12,0xb2d3c340
1446.38,1.0,14,1,2,3,6,0xb2d39e0d
5419.28,1.0,13,2,2,3,7,0xb2d961e9
690826.43,7.0,18,4,4,2,10,0xb2d69897d
207489.71,2.0,97,3,3,1,7,0xb2d33989d
138531.54,3.0,1,3,4,4,11,0xb2d1f7c2d
10000.42,2.0,97,2,3,1,6,0xb2d58ddd
1196341.91,1.0,1,4,2,4,10,0xb2d37258d
8.13,1.0,36,1,2,2,5,0xb2d47142
2085.52,1.0,0,1,2,4,7,0xb2d409b2d
10005.27,1.0,20,2,2,2,6,0xb2d2eeb0
18.05,1.0,18,1,2,2,5,0xb2d2c6d2
180024.21,2.0,6,3,3,3,9,0xb2d5ce8fd
20257.75,1.0,207,2,2,1,5,0xb2d60df5d
2296.71,1.0,5,1,2,3,6,0xb2d6162fd
20012.96,3.0,80,2,4,1,7,0xb2d5727bd
510005.78,3.0,182,4,4,1,9,0xb2d635c3d
22331.99,1.0,3,2,2,4,8,0xb2d27bb2d
11825.18,1.0,12,2,2,3,7,0xb2d69b46d
373155.49,8.0,0,4,4,4,12,0x3b9af24cd
0.05,1.0,3,1,2,4,7,0xb2d30549
549306.48,8.0,27,4,4,2,10,0xb2d240e3d
281000.01,2.0,81,3,3,1,7,0xb2d0d028d
144890.26,3.0,25,3,4,2,9,0xb2d2dc24d
311098.39,5.0,45,4,4,2,10,0xb2d077abd
320537.21,9.0,0,4,4,4,12,0xb2d13b61d
550103.37,2.0,21,4,3,2,9,0xb2d8d306
521095.28,4.0,15,4,4,3,11,0xb2d40dd9
200190.97,2.0,3,3,3,4,10,0xb2d6506fd
93002.94,3.0,172,3,4,1,8,0xb2d6f9c2d
50229.34,2.0,6,2,3,3,8,0xb2d3ea99d
815.15,1.0,2,1,2,4,7,0xb2d585a5
329.62,1.0,4,1,2,4,7,0xb2d6b448
1080220.1,4.0,50,4,4,2,10,0xb2d2800fd
1.76,1.0,34,1,2,2,5,0xb2d5e693
230910.05,4.0,1,3,4,4,11,0xb2d7546fd
560000.0,2.0,183,4,3,1,8,0xb2d8c357
33.28,1.0,12,1,2,3,6,0xb2d1f908d
1978.03,1.0,0,1,2,4,7,0xb2d65345
161844.97,3.0,101,3,4,1,8,0xb2d584d4d
100003.17,2.0,39,3,3,2,8,0xb2d9ec16
50002.22,3.0,74,2,4,1,7,0xb2d98420
32.24,1.0,19,1,2,2,5,0xb2d5c7ae
435008.94,6.0,116,4,4,1,9,0xb2d15401d
3.53,1.0,51,1,2,2,5,0xb2d20ffe
370089.92,3.0,13,4,4,3,11,0x3b9b4069d
47133.19,22.0,7,2,4,3,9,0xb2d0ccdfd
1009.59,1.0,92,1,2,1,4,0xb2d2b86cd
300021.27,4.0,14,3,4,3,10,0xb2d4708bd
310033.01,4.0,48,4,4,2,10,0xb2d18692d
256905.81,2.0,10,3,3,3,9,0xb2d584fdd
67075.46,2.0,77,3,3,1,7,0x3b9adbd0d
160014.98,6.0,19,3,4,2,9,0xb2d0a2a3d
12.54,1.0,48,1,2,2,5,0xb2d316ac
521423.87,9.0,20,4,4,2,10,0xb2d197cad
371308.25,2.0,21,4,3,2,9,0xb2d6347c
22838.68,1.0,0,2,2,4,8,0xb2d9ed6d
2.85,1.0,13,1,2,3,6,0xb2d95bbdd
5594.36,1.0,0,2,2,4,8,0xb2d68ef4
100001.06,2.0,14,3,3,3,9,0xb2da3a17
1726.42,1.0,249,1,2,1,4,0xb2d1863ed
32985.74,1.0,1,2,2,4,8,0xb2d623c5d
36046.36,1.0,10,2,2,3,7,0xb2d4f6cf
1864.59,1.0,184,1,2,1,4,0xb2d27298
1429.21,1.0,10,1,2,3,6,0xb2d92a93
3395.96,1.0,146,2,2,1,5,0xb2d8cb05
208296.18,1.0,1,3,2,4,9,0xb2d31821
385933.24,1.0,0,4,2,4,10,0xb2d0f4ead
726489.34,7.0,11,4,4,3,11,0x3b9b4267d
777066.31,11.0,1,4,4,4,12,0xb2d07295d
193491.04,3.0,83,3,4,1,8,0xb2d4135ad
285012.3,3.0,35,3,4,2,9,0xb2d59456
401355.62,7.0,16,4,4,2,10,0xb2d128a1
140007.4,2.0,111,3,3,1,7,0xb2d6d6acd
4898.49,1.0,4,2,2,4,8,0xb2d15d2bd
550079.88,3.0,0,4,4,4,12,0xb2d5d120d
37.18,1.0,11,1,2,3,6,0xb2d69f3cd
870828.66,3.0,125,4,4,1,9,0xb2d14f21d
250000.0,2.0,23,3,3,2,8,0xb2d9d256
146.78,2.0,98,1,3,1,5,0xb2d09f53d
200816.41,4.0,24,3,4,2,9,0xb2d5d07dd
303.26,2.0,81,1,3,1,5,0xb2d35669
201095.61,1.0,109,3,2,1,6,0xb2d3bb84d
503553.11,2.0,22,4,3,2,9,0xb2d8d2ded
89989.92,1.0,0,3,2,4,9,0xb2d20226d
124177.12,6.0,0,3,4,4,11,0xb2d07591
28779.23,1.0,20,2,2,2,6,0xb2d638bcd
383.94,1.0,9,1,2,3,6,0xb2d4dbe9d
11810.73,2.0,184,2,3,1,6,0x3b9adcb4d
550011.8,4.0,8,4,4,3,11,0xb2d96729d
147.23,1.0,8,1,2,3,6,0xb2d1bbef
500500.02,3.0,13,4,4,3,11,0xb2d08d43
220000.0,2.0,3,3,3,4,10,0xb2d9733e
59.94,1.0,30,1,2,2,5,0xb2d92735
141105.06,3.0,19,3,4,2,9,0xb2d19449
7821.07,1.0,9,2,2,3,7,0xb2d6d62ed
758.78,1.0,17,1,2,2,5,0xb2d12fbe
99959.95,1.0,1,3,2,4,9,0xb2da3c1d
20001.68,3.0,63,2,4,2,8,0xb2d8cdf8d
35.94,1.0,184,1,2,1,4,0xb2d12880
90348.34,2.0,10,3,3,3,9,0xb2d9c466
4139.52,1.0,0,2,2,4,8,0xb2d16617
1160150.06,6.0,6,4,4,3,11,0xb2d9d84b
287000.0,4.0,8,3,4,3,10,0xb2d9694ed
8137.48,1.0,0,2,2,4,8,0xb2d6b72ad
205367.81,1.0,92,3,2,1,6,0xb2d405f7d
48.83,1.0,48,1,2,2,5,0xb2d604c8d
242934.36,3.0,3,3,4,4,11,0x3b9b2a91d
103955.86,2.0,25,3,3,2,8,0xb2d4d81d
1511.36,1.0,184,1,2,1,4,0x3b9b2351d
3081.98,1.0,4,2,2,4,8,0xb2d9dd53
148236.54,3.0,120,3,4,1,8,0xb2d5ec47
160000.0,15.0,3,3,4,4,11,0x3b9b0e38d
70.81,1.0,60,1,2,2,5,0xb2d62ed3
1354795.47,3.0,17,4,4,2,10,0xb2d9e486
110006.92,2.0,70,3,3,1,7,0xb2d63f37
206101.51,1.0,0,3,2,4,9,0xb2d430ebd
3593.84,1.0,4,2,2,4,8,0xb2d30ac3
0.64,1.0,1,1,2,4,7,0xb2d15af6d
3335.09,1.0,0,2,2,4,8,0x3b9b3664d
50176.47,2.0,0,2,3,4,9,0xb2d53042
128227.62,2.0,1,3,3,4,10,0xb2d96339
689724.72,14.0,1,4,4,4,12,0xb2d2604bd
50000.0,2.0,6,2,3,3,8,0xb2d96dbad
403520.83,3.0,33,4,4,2,10,0xb2d41ea5d
1218.43,1.0,92,1,2,1,4,0xb2d0af01d
21.75,1.0,75,1,2,1,4,0xb2d636a6d
16.36,1.0,35,1,2,2,5,0xb2d930e2
318179.24,2.0,5,4,3,3,10,0xb2d3d38fd
31515.53,8.0,5,2,4,3,9,0xb2d19f0cd
5025525.19,11.0,9,4,4,3,11,0xb2d8e912
500054.37,7.0,11,4,4,3,11,0xb2d191c5
200003.0,2.0,1,3,3,4,10,0xb2d192e4d
229115.45,4.0,11,3,4,3,10,0xb2d15368
92822.53,4.0,63,3,4,2,9,0xb2d43ec0
245.82,1.0,0,1,2,4,7,0xb2d64407
461026.45,5.0,28,4,4,2,10,0xb2d17206d
157462.95,1.0,7,3,2,3,8,0xb2d5e578d
24000.03,8.0,6,2,4,3,9,0xb2d5da55
5357.08,1.0,15,2,2,3,7,0xb2d93ee0
2033983.48,4.0,13,4,4,3,11,0xb2d64e85d
335357.57,3.0,18,4,4,2,10,0xb2d649ef
5999.57,1.0,9,2,2,3,7,0xb2d4f573d
13548.06,1.0,8,2,2,3,7,0xb2d68c9bd
68.93,1.0,8,1,2,3,6,0xb2d6a283
81507.73,2.0,34,3,3,2,8,0xb2d17e80
30368.92,1.0,0,2,2,4,8,0xb2d8e816d
120010.32,2.0,21,3,3,2,8,0xb2d8e7a1d
988.57,2.0,0,1,3,4,8,0xb2d47e8c
200006.52,2.0,13,3,3,3,9,0xb2d61b3a
1348.54,1.0,92,1,2,1,4,0xb2d2ebe1
503805.32,2.0,55,4,3,2,9,0xb2d44318d
73.41,1.0,0,1,2,4,7,0xb2d171b4d
200004.22,2.0,228,3,3,1,7,0xb2d6f59c
50541.35,2.0,195,2,3,1,6,0xb2d5c4b9d
61432.42,2.0,67,3,3,1,7,0xb2d67e04
400000.0,2.0,6,4,3,3,10,0xb2d9b0a2
875011.08,7.0,16,4,4,2,10,0xb2d8d5c3d
300002.94,3.0,0,3,4,4,11,0xb2d243d4
250000.0,2.0,7,3,3,3,9,0xb2d9700ed
10087.11,1.0,92,2,2,1,5,0xb2d2ef3dd
1782.76,1.0,10,1,2,3,6,0xb2d4784ad
490000.0,3.0,0,4,4,4,12,0xb2d8cfd1
450000.0,3.0,1,4,4,4,12,0xb2d6b360d
80018.61,4.0,0,3,4,4,11,0xb2d6dabbd
0.0,1.0,8,1,2,3,6,0xb2d227a0
1500086.89,3.0,8,4,4,3,11,0xb2d9c9bd
457589.07,8.0,18,4,4,2,10,0xb2d562fb
2181.43,1.0,18,1,2,2,5,0xb2d0fb0d
641323.82,6.0,0,4,4,4,12,0xb2d40cd9
13099.58,1.0,0,2,2,4,8,0xb2d6028bd
111077.65,1.0,10,3,2,3,8,0xb2d2c464d
227491.43,2.0,101,3,3,1,7,0xb2d11c6ed
537281.41,3.0,41,4,4,2,10,0xb2d1bb0c
191827.83,3.0,18,3,4,2,9,0xb2d4537bd
9263515.58,18.0,4,4,4,4,12,0xb2d07bfc
39047.28,1.0,20,2,2,2,6,0xb2d6b674d
86418.83,3.0,13,3,4,3,10,0xb2d2d551
200003.11,2.0,12,3,3,3,9,0xb2d951e1d
3073585.79,62.0,1,4,4,4,12,0xb2d14106d
10600.78,4.0,0,2,4,4,10,0x3b9af2bc
1505.4,2.0,1,1,3,4,8,0xb2d965a4
84545.14,5.0,11,3,4,3,10,0x3b9af3b2d
205004.48,3.0,19,3,4,2,9,0xb2d94351
335979.94,13.0,0,4,4,4,12,0x3b9b3efdd
130740.47,2.0,196,3,3,1,7,0xb2d606d5
51048.28,2.0,94,2,3,1,6,0xb2d1941ed
1344.88,2.0,92,1,3,1,5,0xb2d0793f
39.0,1.0,19,1,2,2,5,0xb2d6a673
55783.96,1.0,2,3,2,4,9,0xb2d2b7c5
39406.73,1.0,0,2,2,4,8,0xb2d66534d
10706838.97,1.0,184,4,2,1,7,0xb2d19f10d
200765.3,2.0,33,3,3,2,8,0xb2d9dc86
0.0,1.0,6,1,2,3,6,0xb2d28028d
60603.77,2.0,7,3,3,3,9,0x3b9b30bed
730775.37,11.0,14,4,4,3,11,0xb2d08aa3
35813.79,3.0,0,2,4,4,10,0xb2d21344d
115.21,1.0,9,1,2,3,6,0xb2d3fb88
3429.02,1.0,9,2,2,3,7,0xb2d5d5c2d
3108.33,1.0,0,2,2,4,8,0xb2d557c6
70078.53,4.0,10,3,4,3,10,0xb2d5df35
507572.25,3.0,233,4,4,1,9,0xb2d609cad
18768.63,1.0,3,2,2,4,8,0xb2d99e81
2843.28,1.0,0,1,2,4,7,0xb2d30049
4764.94,1.0,46,2,2,2,6,0xb2d2bc95
1760.7,1.0,6,1,2,3,6,0xb2d9287b
226096.31,1.0,0,3,2,4,9,0xb2d965f3d
2032.48,1.0,24,1,2,2,5,0xb2d284b1d
240312.43,2.0,0,3,3,4,10,0xb2d64a8b
230001.91,6.0,87,3,4,1,8,0xb2d415ead
0.0,1.0,8,1,2,3,6,0xb2d3c339
21640.25,2.0,2,2,3,4,9,0x3b9b0e79d
1262.24,1.0,10,1,2,3,6,0xb2d1cb51
250002.89,3.0,0,3,4,4,11,0xb2d60caad
400028.47,3.0,0,4,4,4,12,0xb2d5fd57
62501.58,1.0,4,3,2,4,9,0xb2d15315
5531.96,1.0,184,2,2,1,5,0xb2d425f8d
207092.02,2.0,59,3,3,2,8,0xb2d58ba9
16463.18,1.0,0,2,2,4,8,0xb2d1d9d6d
4734.01,1.0,16,2,2,2,6,0xb2d8e48bd
250002.05,3.0,22,3,4,2,9,0xb2d691b9
1016000.0,6.0,5,4,4,3,11,0xb2d23993
5096.57,1.0,10,2,2,3,7,0xb2d6be43
1011.12,1.0,184,1,2,1,4,0xb2d2834ad
17.44,1.0,9,1,2,3,6,0xb2d51d4a
220042.43,4.0,4,3,4,4,11,0xb2d1b3d2
922352.45,9.0,1,4,4,4,12,0xb2d4f09a
100086.02,2.0,188,3,3,1,7,0xb2d3788ad
300472.38,3.0,13,4,4,3,11,0xb2d62eedd
630.3,1.0,0,1,2,4,7,0xb2da4bcd
100032.22,3.0,18,3,4,2,9,0xb2d78809
107444.47,3.0,43,3,4,2,9,0xb2d08534d
2.8,1.0,50,1,2,2,5,0xb2d6b599d
636410.24,3.0,129,4,4,1,9,0xb2d20e23
45000.33,3.0,81,2,4,1,7,0xb2d11c2bd
280094.58,2.0,4,3,3,4,10,0xb2d9ff6c
1115017.37,12.0,28,4,4,2,10,0xb2d557a5d
27544.6,3.0,0,2,4,4,10,0xb2d8c6b3d
115977.92,1.0,5,3,2,3,8,0xb2d39c04
79.11,1.0,2,1,2,4,7,0xb2d4eee5
100108.4,2.0,45,3,3,2,8,0xb2d2cdfd
93.67,1.0,6,1,2,3,6,0xb2d4137a
51768.31,2.0,203,2,3,1,6,0xb2d53b4fd
5003.43,1.0,74,2,2,1,5,0xb2d8e57b
250648.1,2.0,266,3,3,1,7,0xb2d1e338d
12000.0,2.0,184,2,3,1,6,0xb2d65ce2
33605.43,2.0,230,2,3,1,6,0xb2d613e9d
4162.3,1.0,193,2,2,1,5,0xb2d1e5b8d
4226.79,1.0,169,2,2,1,5,0xb2d42569
1000000.0,14.0,0,4,4,4,12,0xb2d076e3d
14.42,1.0,35,1,2,2,5,0xb2d63464
102.14,1.0,32,1,2,2,5,0xb2d9f422
1455000.0,1.0,1,4,2,4,10,0xb2d6e194
21.11,1.0,60,1,2,2,5,0xb2d9b9fd
12416.59,1.0,184,2,2,1,5,0xb2d15670d
284001.91,1.0,10,3,2,3,8,0xb2d90eca
3036942.71,4.0,21,4,4,2,10,0xb2d6918ad
300751.11,1.0,99,4,2,1,7,0xb2d6d128d
50000.53,2.0,92,2,3,1,6,0xb2d98148
7185.06,1.0,142,2,2,1,5,0xb2d2b926
20582.12,1.0,0,2,2,4,8,0xb2d46e00
179124.35,2.0,53,3,3,2,8,0xb2d1658ed
16268.78,1.0,7,2,2,3,7,0xb2d5e4aa
201216.19,1.0,11,3,2,3,8,0xb2d91dd5
1094.66,1.0,24,1,2,2,5,0xb2d1387bd
26967.56,2.0,24,2,3,2,7,0xb2d4b461d
70026.53,3.0,0,3,4,4,11,0xb2d5ff8e
3.2,1.0,6,1,2,3,6,0xb2d5489b
422889.54,4.0,1,4,4,4,12,0xb2d56457d
400093.94,3.0,14,4,4,3,11,0xb2d78be0d
1406422.8,7.0,7,4,4,3,11,0xb2d60047
662.04,1.0,41,1,2,2,5,0xb2d635a5d
406616.45,3.0,32,4,4,2,10,0xb2d14e6cd
200004.77,2.0,10,3,3,3,9,0xb2d3b6f8
380062.47,3.0,193,4,4,1,9,0xb2d56f14d
23343.64,1.0,1,2,2,4,8,0xb2d5af11d
1948.54,1.0,184,1,2,1,4,0xb2d35d29d
280762.6,4.0,60,3,4,2,9,0xb2d64ef8d
709.72,1.0,21,1,2,2,5,0xb2d1b678d
3046.24,1.0,3,2,2,4,8,0xb2d32c1e
30000.32,2.0,8,2,3,3,8,0xb2da4a6b
9200091.08,2.0,0,4,3,4,11,0xb2d3b5c4
175245.64,2.0,49,3,3,2,8,0xb2d5f586d
20000.21,2.0,179,2,3,1,6,0xb2d58e34
3064.42,1.0,92,2,2,1,5,0xb2d19ed9d
277637.31,2.0,5,3,3,3,9,0xb2d38aa5d
12.87,1.0,69,1,2,1,4,0xb2d5aa77
230.88,1.0,15,1,2,3,6,0xb2d404a6d
383957.34,2.0,8,4,3,3,10,0xb2d4732ad
180.36,1.0,1,1,2,4,7,0xb2da2821
8721.9,1.0,92,2,2,1,5,0xb2d3c33fd
402138.65,4.0,144,4,4,1,9,0xb2d148ead
20000.9,2.0,24,2,3,2,7,0xb2d5ae2ad
81893.05,2.0,39,3,3,2,8,0xb2d6d27dd
683.2,1.0,13,1,2,3,6,0xb2d6c1ba
903.69,1.0,20,1,2,2,5,0xb2d6bd17
800000.0,1.0,5,4,2,3,9,0xb2d3d068d
21828.94,1.0,4,2,2,4,8,0xb2d2845fd
402909.96,4.0,9,4,4,3,11,0xb2d5ba23
700004.38,4.0,23,4,4,2,10,0xb2d24fced
4673.16,1.0,11,2,2,3,7,0xb2d60a96d
39821.08,1.0,2,2,2,4,8,0xb2d2250dd
4516.96,1.0,2,2,2,4,8,0xb2d69a1b
16023.61,1.0,46,2,2,2,6,0xb2d869c1d
132.41,1.0,20,1,2,2,5,0xb2d21ea3d
50009.21,2.0,10,2,3,3,8,0x3b9b30e5d
28.44,1.0,40,1,2,2,5,0xb2d37ce6
52861.9,1.0,1,3,2,4,9,0xb2d2c1dfd
499.31,1.0,10,1,2,3,6,0xb2d23a03
8377.07,1.0,5,2,2,3,7,0xb2d4a45ed
600012.54,7.0,27,4,4,2,10,0xb2d3c33dd
240117.0,2.0,12,3,3,3,9,0xb2da0773
14.25,1.0,52,1,2,2,5,0xb2d8f729
0.0,2.0,60,1,3,2,6,0xb2d254af
25633.68,1.0,8,2,2,3,7,0xb2d25fb8
10087.12,1.0,184,2,2,1,5,0xb2d5e990d
9.0,1.0,10,1,2,3,6,0xb2d6c2bfd
217898.67,4.0,21,3,4,2,9,0xb2d1082fd
56836.21,1.0,20,3,2,2,7,0xb2d2cd58d
61613.56,1.0,0,3,2,4,9,0xb2d6ad59d
3402771.81,2.0,32,4,3,2,9,0xb2d1794fd
70202.13,4.0,4,3,4,4,11,0xb2d9b365
80069.89,2.0,67,3,3,1,7,0xb2d61c56d
244018.24,2.0,0,3,3,4,10,0xb2d2971b
733694.4,2.0,122,4,3,1,8,0xb2d625d1d
300021.21,2.0,62,3,3,2,8,0xb2d52e36
10406.57,1.0,0,2,2,4,8,0xb2d4cdc6d
1280264.11,6.0,1,4,4,4,12,0xb2d59576d
20603.81,2.0,5,2,3,3,8,0xb2d9e5d0
0.0,2.0,52,1,3,2,6,0xb2d50549
145228.56,2.0,136,3,3,1,7,0xb2d41ea0d
1261.72,1.0,1,1,2,4,7,0xb2d47769
49.17,1.0,3,1,2,4,7,0xb2d42600d
50746.0,3.0,57,2,4,2,8,0xb2d776ea
255033.19,2.0,0,3,3,4,10,0xb2d427f2d
8443.28,1.0,2,2,2,4,8,0xb2d2bc48
201452.66,2.0,73,3,3,1,7,0xb2d6ca65d
3329.56,2.0,21,2,3,2,7,0xb2d54ad0
6530.43,1.0,0,2,2,4,8,0xb2d0d08ad
49107.36,2.0,221,2,3,1,6,0xb2d5c954d
18009.42,1.0,34,2,2,2,6,0xb2d96d99
300000.0,2.0,11,3,3,3,9,0xb2da428e
3360067.41,13.0,19,4,4,2,10,0xb2d35f94
86.38,1.0,1,1,2,4,7,0xb2d93494
542000.0,22.0,0,4,4,4,12,0xb2d708a0d
150582.96,2.0,101,3,3,1,7,0xb2d6f06ed
466009.84,2.0,32,4,3,2,9,0xb2da011a
2296.83,1.0,1,1,2,4,7,0xb2d915ae
53113.73,1.0,6,3,2,3,8,0xb2d18d7e
540541.42,3.0,25,4,4,2,10,0xb2d2cc36
708564.74,4.0,64,4,4,2,10,0xb2d6c57fd
533608.94,11.0,3,4,4,4,12,0x3b9b33e1d
1409.95,1.0,1,1,2,4,7,0xb2d6d3f3d
0.58,1.0,2,1,2,4,7,0xb2d6c407
500000.08,2.0,26,4,3,2,9,0xb2d8c9d9d
0.25,3.0,71,1,4,1,6,0xb2d1ab87d
81344.98,2.0,10,3,3,3,9,0xb2d4cadbd
1001010.27,3.0,41,4,4,2,10,0xb2d066afd
240007.76,8.0,12,3,4,3,10,0xb2d175afd
82.29,1.0,13,1,2,3,6,0xb2d58716
50099.54,2.0,81,2,3,1,6,0xb2d629ad
620000.72,4.0,0,4,4,4,12,0xb2d174a9d
2.85,2.0,26,1,3,2,6,0xb2d26b16
1.26,1.0,5,1,2,3,6,0xb2d307f0d
26409.94,1.0,6,2,2,3,7,0xb2d9017c
771634.59,5.0,68,4,4,1,9,0xb2d433ddd
19387.67,1.0,1,2,2,4,8,0xb2d1b308d
443274.75,2.0,111,4,3,1,8,0xb2d30d58d
7377617.29,5.0,13,4,4,3,11,0xb2d3a0a0d
24541.74,2.0,11,2,3,3,8,0xb2d6b23a
2791.21,1.0,0,1,2,4,7,0xb2d6bd91
1781.42,1.0,10,1,2,3,6,0xb2d90117
434295.34,2.0,95,4,3,1,8,0xb2d94534
510666.49,2.0,117,4,3,1,8,0xb2d78a9a
204779.23,4.0,4,3,4,4,11,0xb2d381c6d
902.9,1.0,0,1,2,4,7,0xb2d6f363
1800000.0,2.0,3,4,3,4,11,0xb2d97988d
32.44,1.0,34,1,2,2,5,0xb2d2974a
100002.11,2.0,59,3,3,2,8,0xb2d6f52d
100004.41,2.0,32,3,3,2,8,0xb2d15492
151738.63,2.0,14,3,3,3,9,0xb2d20a16d
870684.06,2.0,0,4,3,4,11,0xb2d5c255d
433058.53,4.0,10,4,4,3,11,0xb2d2507cd
336466.36,7.0,0,4,4,4,12,0xb2d33420d
6259.18,1.0,32,2,2,2,6,0xb2d69ee6d
300105.24,4.0,18,4,4,2,10,0xb2d097ebd
3594.65,1.0,4,2,2,4,8,0xb2d57bc5
20005.32,3.0,47,2,4,2,8,0xb2d5e979d
1189054.29,7.0,0,4,4,4,12,0xb2d62b09d
8923.27,1.0,237,2,2,1,5,0xb2d41b1c
513766.0,8.0,14,4,4,3,11,0xb2d78f3dd
53554.84,2.0,136,3,3,1,7,0xb2d3e618d
1898573.34,32.0,0,4,4,4,12,0xb2d24d50
1911.48,1.0,0,1,2,4,7,0xb2d6baa0
250050.21,2.0,29,3,3,2,8,0xb2d78afad
85341.01,2.0,25,3,3,2,8,0xb2d65cb0d
60013.76,2.0,137,3,3,1,7,0xb2d565c0
39.23,1.0,45,1,2,2,5,0xb2d0c376
3657.44,1.0,46,2,2,2,6,0xb2d9954c
11717.42,1.0,1,2,2,4,8,0xb2d6963cd
159928.8,1.0,22,3,2,2,7,0xb2d7910fd
307061.47,4.0,80,4,4,1,9,0xb2d24c2f
2017.64,1.0,5,1,2,3,6,0xb2d961ad
2.4,1.0,21,1,2,2,5,0xb2d82453
43175.64,1.0,0,2,2,4,8,0xb2d99696
100011.7,2.0,158,3,3,1,7,0xb2d6c19a
1700.34,1.0,5,1,2,3,6,0xb2d2e997
386.72,1.0,8,1,2,3,6,0xb2d40b60
70000.74,2.0,92,3,3,1,7,0xb2d98188d
96095.77,2.0,25,3,3,2,8,0xb2d6a703d
10341.06,1.0,184,2,2,1,5,0xb2d27ae4d
80073.8,3.0,0,3,4,4,11,0xb2d0b34dd
504774.67,2.0,0,4,3,4,11,0xb2d1232d
530000.95,3.0,10,4,4,3,11,0xb2d9496f
1963.46,1.0,92,1,2,1,4,0xb2d31003d
5523.41,1.0,9,2,2,3,7,0xb2d92600d
10001.9,2.0,74,2,3,1,6,0xb2d0de37
1016555.87,4.0,60,4,4,2,10,0xb2d61295d
2818.97,1.0,184,1,2,1,4,0xb2d4414cd
217.59,1.0,9,1,2,3,6,0xb2d6f11d
49.05,1.0,10,1,2,3,6,0xb2d5a8a8
404007.29,4.0,77,4,4,1,9,0xb2d2c75dd
30002.89,2.0,20,2,3,2,7,0xb2d31453d
190051.34,4.0,13,3,4,3,10,0xb2d1129ad
300000.0,2.0,2,3,3,4,10,0xb2d93981d
4.86,1.0,11,1,2,3,6,0xb2da37d9
2510349.27,3.0,27,4,4,2,10,0xb2d61a4ed
6.47,1.0,12,1,2,3,6,0xb2d31054d
45000.84,3.0,90,2,4,1,7,0xb2d6af98
270000.0,2.0,6,3,3,3,9,0xb2d96e94d
54931.91,2.0,49,3,3,2,8,0xb2d35a61d
34000.93,3.0,53,2,4,2,8,0xb2d98e74
341303.62,5.0,3,4,4,4,12,0xb2d6c048
1159.12,1.0,184,1,2,1,4,0xb2d504b7d
828.58,1.0,87,1,2,1,4,0xb2d2719e
845052.58,10.0,3,4,4,4,12,0x3b9b3097d
200000.84,2.0,13,3,3,3,9,0xb2d8e1c6d
17.73,1.0,15,1,2,3,6,0xb2da0bef
130009.51,3.0,39,3,4,2,9,0xb2d1fb1f
100064.27,1.0,22,3,2,2,7,0xb2d6152c
200000.0,2.0,5,3,3,3,9,0xb2d6502dd
5771.39,1.0,28,2,2,2,6,0xb2d2827e
100188.21,1.0,106,3,2,1,6,0xb2d2c58cd
85049.64,3.0,172,3,4,1,8,0xb2d0aabcd
1636180.89,4.0,8,4,4,3,11,0xb2d3a098
33002.5,4.0,9,2,4,3,9,0xb2d753c9
2500.99,1.0,10,1,2,3,6,0xb2d784a9
500000.0,2.0,26,4,3,2,9,0xb2da157f
5733.46,1.0,214,2,2,1,5,0xb2d695b6d
2.05,1.0,4,1,2,4,7,0xb2d69071d
182455.95,2.0,7,3,3,3,9,0x3b9b2d71
45089.37,1.0,101,2,2,1,5,0xb2d44c66d
211000.0,2.0,20,3,3,2,8,0xb2da27a3
2954282.39,97.0,11,4,4,3,11,0xb2d10abdd
1213.14,3.0,101,1,4,1,6,0xb2d0c950
82918.11,1.0,11,3,2,3,8,0xb2d1dbf5
8914.05,1.0,11,2,2,3,7,0xb2d25e2dd
12241909.06,10.0,0,4,4,4,12,0xb2d0ecec
653.53,1.0,112,1,2,1,4,0xb2d82632
201457.58,2.0,29,3,3,2,8,0xb2d1b2d5
50020.17,2.0,74,2,3,1,6,0xb2d65df2d
1128.75,1.0,92,1,2,1,4,0xb2d39a55d
1108305.64,3.0,0,4,4,4,12,0xb2d30fb5
241000.0,7.0,0,3,4,4,11,0xb2d41a3cd
1664.14,1.0,124,1,2,1,4,0xb2d38cde
41895.3,1.0,236,2,2,1,5,0xb2d316b0d
500000.0,2.0,16,4,3,2,9,0xb2d99a19
7582.11,1.0,8,2,2,3,7,0xb2d4ae10d
60994.33,1.0,0,3,2,4,9,0xb2d1dfced
270000.0,2.0,26,3,3,2,8,0xb2d15e70d
12095.65,1.0,1,2,2,4,8,0xb2d2fec1d
3134.66,1.0,92,2,2,1,5,0xb2d30ac7
181.48,1.0,8,1,2,3,6,0xb2d5bb40
7388.34,1.0,12,2,2,3,7,0xb2d5f3b3d
80.59,1.0,9,1,2,3,6,0xb2d74c75
10292.99,5.0,184,2,4,1,7,0x3b9ae5a2d
9187.81,4.0,0,2,4,4,10,0x3b9b0ed2
502233.04,2.0,29,4,3,2,9,0xb2d7722bd
390810.71,6.0,6,4,4,3,11,0xb2d1a341d
110204.41,3.0,139,3,4,1,8,0xb2d58713
919151.34,4.0,53,4,4,2,10,0xb2d090c3d
215000.0,2.0,12,3,3,3,9,0xb2d962e2
81.41,1.0,46,1,2,2,5,0xb2d69902d
374.29,1.0,5,1,2,3,6,0xb2d9d598
801066.79,4.0,13,4,4,3,11,0xb2d8ce8ed
16347.98,1.0,184,2,2,1,5,0xb2d33e72d
102.71,1.0,18,1,2,2,5,0xb2d8dc3f
244761.49,4.0,3,3,4,4,11,0xb2d6bcb1d
200000.88,2.0,1,3,3,4,10,0xb2d9393ed
850013.76,5.0,13,4,4,3,11,0xb2d06c1ed
600107.62,7.0,3,4,4,4,12,0xb2d921f5d
10211.4,1.0,56,2,2,2,6,0xb2d3e8edd
0.0,1.0,25,1,2,2,5,0xb2d4ff4a
394034.21,7.0,21,4,4,2,10,0xb2d60493d
0.0,1.0,4,1,2,4,7,0xb2d8d851
21.39,1.0,17,1,2,2,5,0xb2d37a15
170034.46,3.0,80,3,4,1,8,0xb2d11b75d
24.79,1.0,24,1,2,2,5,0xb2d652f9
160029.64,27.0,0,3,4,4,11,0xb2d226d9d
27463.39,2.0,56,2,3,2,7,0xb2d6b223
2905.26,1.0,245,2,2,1,5,0xb2d3fe8e
1017.5,1.0,184,1,2,1,4,0xb2d0b874d
100013.44,2.0,17,3,3,2,8,0xb2d2121d
1519793.26,3.0,82,4,4,1,9,0xb2d110db
12781.12,1.0,26,2,2,2,6,0xb2d33ee9
375.65,1.0,117,1,2,1,4,0xb2d29637d
17920.88,1.0,2,2,2,4,8,0xb2d3b359d
48742.91,2.0,29,2,3,2,7,0xb2d639d7d
90047.41,2.0,0,3,3,4,10,0xb2d5f331d
10293.84,1.0,7,2,2,3,7,0xb2d24caed
112.41,1.0,21,1,2,2,5,0xb2d25eba
10491.28,1.0,3,2,2,4,8,0xb2d65578d
2860.09,1.0,94,1,2,1,4,0xb2d1ae1f
10355.53,1.0,4,2,2,4,8,0xb2d6283fd
214826.57,2.0,45,3,3,2,8,0xb2d1a4a1
401358.79,7.0,17,4,4,2,10,0xb2d128a1d
1494.56,1.0,0,1,2,4,7,0xb2d2c488d
2689.9,1.0,11,1,2,3,6,0xb2d1ffc4d
1.69,1.0,77,1,2,1,4,0xb2d8226c
1294229.51,12.0,11,4,4,3,11,0xb2d5c6ead
290338.7,12.0,6,3,4,3,10,0xb2d60b92d
395171.06,2.0,67,4,3,1,8,0xb2d56fcad
810027.94,4.0,14,4,4,3,11,0xb2d4ff65d
583.79,1.0,3,1,2,4,7,0xb2d2e151
110662.18,3.0,33,3,4,2,9,0xb2d2f864
282859.99,3.0,6,3,4,3,10,0xb2d10d2bd
501071.08,4.0,55,4,4,2,10,0xb2d6fd1fd
96.67,2.0,0,1,3,4,8,0xb2d80304d
4188.44,1.0,8,2,2,3,7,0xb2d3ab35
451934.81,16.0,1,4,4,4,12,0xb2d78d01d
137327.64,4.0,1,3,4,4,11,0xb2d837a7d
110765.38,2.0,92,3,3,1,7,0xb2d09066d
97.38,1.0,7,1,2,3,6,0xb2d78d2cd
260099.82,4.0,87,3,4,1,8,0xb2d59a51d
595773.31,2.0,63,4,3,2,9,0xb2d3505bd
390646.48,5.0,0,4,4,4,12,0x3b9af1df
1235.51,2.0,0,1,3,4,8,0x3b9b46a8
270270.1,3.0,1,3,4,4,11,0xb2d43d1ed
351747.65,3.0,31,4,4,2,10,0xb2d578f5d
1100005.65,1.0,0,4,2,4,10,0xb2d3a642d
200012.67,1.0,0,3,2,4,9,0xb2d8a5a4
7044.89,1.0,6,2,2,3,7,0xb2d21fb6d
1037604.25,8.0,33,4,4,2,10,0xb2d5ec39
440014.59,6.0,5,4,4,3,11,0xb2d0d030d
30399.76,1.0,9,2,2,3,7,0xb2d43d8fd
26902.67,1.0,0,2,2,4,8,0xb2d63c68d
18021.74,1.0,13,2,2,3,7,0xb2d6a9fe
11513.73,1.0,9,2,2,3,7,0xb2d334c6d
9.09,1.0,8,1,2,3,6,0xb2d8fab4d
2927.53,1.0,140,2,2,1,5,0xb2d2576c
200082.15,2.0,147,3,3,1,7,0xb2d40520
50874.96,2.0,256,2,3,1,6,0xb2d6048ed
99270.11,4.0,0,3,4,4,11,0xb2d84858d
47.8,1.0,71,1,2,1,4,0xb2d5d9d5
302131.98,2.0,58,4,3,2,9,0xb2d9787a
106323.79,8.0,1,3,4,4,11,0xb2d0648bd
301.01,1.0,0,1,2,4,7,0xb2d950df
23523.61,1.0,0,2,2,4,8,0xb2d2031dd
85899.42,4.0,0,3,4,4,11,0x3b9af2efd
910117.25,4.0,28,4,4,2,10,0xb2d13f27d
1399.19,1.0,92,1,2,1,4,0xb2d269c2d
1013.37,1.0,25,1,2,2,5,0xb2d40b8d
145796.17,9.0,0,3,4,4,11,0xb2d210b5d
13001819.15,3.0,41,4,4,2,10,0xb2d69194
260005.91,3.0,56,3,4,2,9,0xb2d9c16f
2.5,1.0,23,1,2,2,5,0xb2d6b49c
1026530.31,3.0,80,4,4,1,9,0xb2d6b3f6
9535.67,1.0,0,2,2,4,8,0xb2d961f1
500079.04,4.0,4,4,4,4,12,0xb2d56cf7d
110794.76,2.0,0,3,3,4,10,0xb2d2fb38d
6.34,1.0,104,1,2,1,4,0xb2d95afe
3299.73,1.0,0,2,2,4,8,0xb2d61fed
680932.7,4.0,0,4,4,4,12,0xb2d6a3edd
51095.33,1.0,5,2,2,3,7,0xb2d8c374d
4724.04,1.0,7,2,2,3,7,0xb2d3b78d
9.48,1.0,10,1,2,3,6,0xb2d9a159
214366.4,3.0,4,3,4,4,11,0xb2d6ad61
70043.92,3.0,53,3,4,2,9,0xb2d6283ed
3603.01,1.0,1,2,2,4,8,0xb2d6fe07d
2.67,1.0,110,1,2,1,4,0xb2d193ead
50110.48,2.0,173,2,3,1,6,0xb2d28fbf
76.83,1.0,19,1,2,2,5,0xb2d6d004
251010.72,2.0,21,3,3,2,8,0xb2da1ce8
472.16,1.0,8,1,2,3,6,0xb2d48be8d
111.61,1.0,14,1,2,3,6,0xb2d6a3d8
332022.24,3.0,151,4,4,1,9,0xb2d5d169d
181.68,1.0,16,1,2,2,5,0xb2d19257
2000000.0,1.0,1,4,2,4,10,0xb2d94ad2d
294937.4,5.0,4,3,4,4,11,0xb2d0b857d
4308.58,2.0,184,2,3,1,6,0x3b9b198ad
3923.21,1.0,9,2,2,3,7,0xb2d2b549
430000.67,3.0,3,4,4,4,12,0xb2d56060
11425.98,1.0,0,2,2,4,8,0xb2d6ab00d
260003.67,5.0,74,3,4,1,8,0xb2d5e477
1262.49,1.0,10,1,2,3,6,0xb2d341b4
620006.74,4.0,3,4,4,4,12,0xb2d57396d
270.1,1.0,8,1,2,3,6,0xb2d6a5fc
70678.62,2.0,0,3,3,4,10,0xb2d6b29fd
13001.14,2.0,10,2,3,3,8,0xb2d96340d
400688.14,6.0,28,4,4,2,10,0xb2d3c944d
1430787.13,9.0,13,4,4,3,11,0xb2d637e6
20470.7,1.0,12,2,2,3,7,0xb2d6cf41
250086.22,5.0,0,3,4,4,11,0xb2d2204e
9102.57,1.0,184,2,2,1,5,0xb2d3120fd
460020.48,3.0,55,4,4,2,10,0xb2d68dc2
1992.92,1.0,184,1,2,1,4,0xb2d072d3d
343006.53,3.0,7,4,4,3,11,0xb2d15262d
200000.0,2.0,5,3,3,3,9,0xb2da2515
6.44,1.0,28,1,2,2,5,0xb2d94e32
2264.58,2.0,4,1,3,4,8,0xb2d1b81a
240026.39,5.0,52,3,4,2,9,0xb2d5e477d
1611.62,1.0,14,1,2,3,6,0xb2d563ead
60079.84,2.0,28,3,3,2,8,0xb2d620fc
1621.01,1.0,10,1,2,3,6,0xb2d2e4fed
435004.59,5.0,6,4,4,3,11,0xb2da3800
20000.21,2.0,46,2,3,2,7,0xb2d62b8f
1062201.72,9.0,34,4,4,2,10,0xb2d56c2b
3248.84,1.0,1,2,2,4,8,0xb2d58a28d
250020.43,3.0,72,3,4,1,8,0xb2d69394
71650.47,2.0,31,3,3,2,8,0xb2d683ded
1120.61,3.0,92,1,4,1,6,0x3b9b1337
410122.94,5.0,64,4,4,2,10,0xb2d15424d
338251.4,4.0,39,4,4,2,10,0xb2d1f0dfd
4380229.44,7.0,1,4,4,4,12,0xb2d9b669
529001.06,4.0,11,4,4,3,11,0xb2d4ebc1
25145.65,1.0,92,2,2,1,5,0xb2d356a8d
50003.08,2.0,18,2,3,2,7,0xb2d077a4
23.52,1.0,26,1,2,2,5,0xb2d9aa72
1024899.3,2.0,43,4,3,2,9,0xb2d6689bd
4616.57,1.0,18,2,2,2,6,0xb2d9963d
40000.42,2.0,0,2,3,4,9,0xb2da1573
4.04,1.0,25,1,2,2,5,0xb2d37666
5961.34,1.0,15,2,2,3,7,0xb2d9b3fb
36.56,1.0,24,1,2,2,5,0xb2d271cc
8386.91,1.0,0,2,2,4,8,0xb2d6e8e4d
1017.23,1.0,184,1,2,1,4,0xb2d08d5cd
1015.57,1.0,184,1,2,1,4,0xb2d294b6d
52005.35,2.0,108,2,3,1,6,0xb2d52cd4d
687834.44,3.0,31,4,4,2,10,0xb2d5366d
61424.72,2.0,31,3,3,2,8,0xb2d67e04d
401037.82,3.0,7,4,4,3,11,0xb2d78d1bd
2.65,1.0,5,1,2,3,6,0xb2d1f572
110101.81,4.0,11,3,4,3,10,0xb2d8d76f
1007106.14,2.0,82,4,3,1,8,0xb2d8d406d
256010.19,2.0,92,3,3,1,7,0x3b9b353fd
10212.28,1.0,92,2,2,1,5,0xb2d297cbd
505.16,1.0,1,1,2,4,7,0xb2d3ec24
5648.57,1.0,11,2,2,3,7,0xb2d6d9add
20001.06,2.0,27,2,3,2,7,0xb2d589e3
4354.93,1.0,92,2,2,1,5,0xb2d4e6ead
124802.82,1.0,3,3,2,4,9,0xb2d1bb4ed
1226.62,1.0,1,1,2,4,7,0xb2d3aaa8
45492.8,1.0,0,2,2,4,8,0xb2d1fc3fd
573000.74,5.0,3,4,4,4,12,0xb2d6261fd
50001.06,2.0,105,2,3,1,6,0xb2d0a694
143.56,1.0,195,1,2,1,4,0xb2d33230
1981.89,1.0,53,1,2,2,5,0xb2d59bbbd
3247.71,2.0,92,2,3,1,6,0xb2d0a2aed
650.62,1.0,1,1,2,4,7,0xb2d9650a
4033.32,1.0,0,2,2,4,8,0xb2d7864c
46654.06,1.0,2,2,2,4,8,0xb2d2c313d
66.15,1.0,180,1,2,1,4,0xb2d59966d
206658.49,2.0,92,3,3,1,7,0xb2d3e6cf
676636.93,4.0,32,4,4,2,10,0xb2d2a4aed
600055.63,3.0,1,4,4,4,12,0xb2d4103ad
1400015.22,4.0,27,4,4,2,10,0xb2d60854d
12102.72,1.0,184,2,2,1,5,0xb2d2f4c6d
3083.2,1.0,23,2,2,2,6,0xb2d21f96d
196151.77,3.0,19,3,4,2,9,0xb2d28f52d
65000.34,3.0,98,3,4,1,8,0xb2d2837e
3454.98,1.0,133,2,2,1,5,0xb2d20629d
7648.94,1.0,15,2,2,3,7,0xb2d319b4d
3794.09,1.0,92,2,2,1,5,0xb2d2b300d
1487.74,1.0,28,1,2,2,5,0xb2d1fb48
211173.22,33.0,0,3,4,4,11,0xb2d3a8e9d
20.78,1.0,10,1,2,3,6,0xb2d51c66
382621.6,4.0,0,4,4,4,12,0xb2d40cd7
1000000.6,3.0,5,4,4,3,11,0xb2d9fafd
500029.56,3.0,0,4,4,4,12,0xb2d5b6fd
11642.71,1.0,22,2,2,2,6,0xb2d68b6d
1570477.37,5.0,41,4,4,2,10,0xb2d4f8d1d
550107.47,3.0,18,4,4,2,10,0xb2d9b4a1
590972.28,7.0,4,4,4,4,12,0xb2d7eedcd
131568.57,1.0,21,3,2,2,7,0xb2d60f42
1107847.55,8.0,6,4,4,3,11,0xb2d5f8b9d
110014.7,3.0,41,3,4,2,9,0xb2d9e5cf
1003552.42,2.0,19,4,3,2,9,0xb2d912a8
2740.36,2.0,188,1,3,1,5,0xb2d07f62d
4518.7,1.0,0,2,2,4,8,0xb2d6b5fd
1574409.11,3.0,53,4,4,2,10,0xb2d2608dd
22181.71,1.0,18,2,2,2,6,0xb2d6ea17
31355.2,2.0,143,2,3,1,6,0xb2d61be0
36705.65,2.0,6,2,3,3,8,0xb2d2dab6
178323.82,5.0,11,3,4,3,10,0xb2d5a7bf
176.45,1.0,47,1,2,2,5,0xb2d1e111
25912.63,1.0,14,2,2,3,7,0xb2d55414d
251002.84,5.0,139,3,4,1,8,0xb2d5ebbdd
22771.42,1.0,22,2,2,2,6,0xb2d6be7fd
914845.82,13.0,11,4,4,3,11,0xb2d441b3
200005.66,2.0,7,3,3,3,9,0xb2d78585d
401764.59,2.0,45,4,3,2,9,0xb2d10677
50001.06,2.0,214,2,3,1,6,0xb2d1c8d7
570005.31,5.0,0,4,4,4,12,0x3b9b2e85d
5663.51,2.0,92,2,3,1,6,0xb2d3a59ad
50886.05,2.0,34,2,3,2,7,0xb2d61c2ad
342815.42,3.0,10,4,4,3,11,0xb2d1002bd
3522.61,1.0,184,2,2,1,5,0xb2d24331d
500070.49,3.0,11,4,4,3,11,0xb2d55700d
1000052.08,2.0,1,4,3,4,11,0xb2da0639
616130.39,2.0,94,4,3,1,8,0xb2d390a5
111205.02,2.0,41,3,3,2,8,0xb2d62c64d
100002.23,3.0,55,3,4,2,9,0xb2d227e7
718.08,1.0,0,1,2,4,7,0xb2d8ee16
23.51,1.0,116,1,2,1,4,0xb2d23fb6d
105376.38,2.0,168,3,3,1,7,0xb2d2b623d
0.0,1.0,5,1,2,3,6,0xb2d48f9a
1101782.37,3.0,32,4,4,2,10,0xb2d9ffac
5180.94,1.0,52,2,2,2,6,0xb2d2d9d6
3284.24,1.0,124,2,2,1,5,0xb2d4cb6fd
688.32,1.0,69,1,2,1,4,0xb2d2f9f9
80000.53,2.0,1,3,3,4,10,0xb2da147e
191401.38,3.0,74,3,4,1,8,0xb2d343a3
28600.17,2.0,3,2,3,4,9,0x3b9b349a
10425.59,2.0,53,2,3,2,7,0xb2d4d1b4d
321551.66,2.0,32,4,3,2,9,0xb2d2a115d
80016.53,2.0,108,3,3,1,7,0xb2d5aa1e
894.23,1.0,10,1,2,3,6,0xb2d6eb06
4950.21,1.0,139,2,2,1,5,0xb2d6af93d
1190.74,1.0,10,1,2,3,6,0xb2d2d6c4
202066.18,1.0,1,3,2,4,9,0xb2d9b198
0.84,1.0,23,1,2,2,5,0xb2d65d81d
38086.83,1.0,4,2,2,4,8,0xb2d9d846
64019.65,3.0,4,3,4,4,11,0xb2d65229d
2677.86,1.0,92,1,2,1,4,0xb2d20dbf
380025.4,1.0,0,4,2,4,10,0xb2d69da9d
353714.95,6.0,0,4,4,4,12,0xb2d4ebc7d
113.56,1.0,10,1,2,3,6,0xb2d95d33
104848.21,2.0,32,3,3,2,8,0xb2d5f467
500000.0,3.0,1,4,4,4,12,0xb2d682ead
2653.47,1.0,92,1,2,1,4,0xb2d2699dd
68.41,1.0,41,1,2,2,5,0xb2d62967
3664.88,1.0,9,2,2,3,7,0xb2d34360d
5561.43,1.0,0,2,2,4,8,0xb2d1758e
424442.61,4.0,38,4,4,2,10,0xb2d1966c
12458.53,1.0,0,2,2,4,8,0xb2d5d79dd
8079.88,1.0,18,2,2,2,6,0xb2d97998
9110.04,1.0,29,2,2,2,6,0xb2d91c18
100002.11,2.0,92,3,3,1,7,0xb2d644f1d
4645.73,1.0,215,2,2,1,5,0xb2d2a5d7d
326399.6,3.0,186,4,4,1,9,0xb2d6f6c0
359003.92,9.0,18,4,4,2,10,0xb2d67eb0
80.8,2.0,46,1,3,2,6,0xb2d99a6d
96005.06,3.0,31,3,4,2,9,0xb2d59e22
3026.09,2.0,92,2,3,1,6,0xb2d10564
0.0,1.0,1,1,2,4,7,0xb2d92b55
140011.23,3.0,47,3,4,2,9,0xb2d45329d
526704.97,3.0,87,4,4,1,9,0xb2d61955d
130.82,1.0,60,1,2,2,5,0xb2d788e1d
15774.36,1.0,18,2,2,2,6,0xb2d6bdbed
235000.0,6.0,0,3,4,4,11,0xb2d25bc1d
5100.34,1.0,182,2,2,1,5,0xb2d2389f
1627018.05,8.0,24,4,4,2,10,0xb2d19453d
1171.22,1.0,38,1,2,2,5,0xb2d644ef
2816.36,1.0,3,1,2,4,7,0xb2d782d4
3409.18,1.0,169,2,2,1,5,0xb2d3340f
0.0,1.0,8,1,2,3,6,0xb2d5762d
211108.35,2.0,77,3,3,1,7,0xb2d0c609
11341.31,1.0,0,2,2,4,8,0xb2d3d6b1
501777.23,3.0,30,4,4,2,10,0xb2d59410
110980.95,2.0,92,3,3,1,7,0x3b9b371ed
69.99,1.0,10,1,2,3,6,0xb2d2226e
480030.96,2.0,6,4,3,3,10,0xb2d6b007d
46308.17,3.0,61,2,4,2,8,0xb2d681a5d
50000.53,2.0,80,2,3,1,6,0xb2d8d869d
354726.71,5.0,18,4,4,2,10,0xb2d25b0d
30027.83,1.0,14,2,2,3,7,0xb2d6315fd
1214.87,1.0,9,1,2,3,6,0xb2d632b6
559906.77,9.0,23,4,4,2,10,0xb2d22d61
230020.0,2.0,4,3,3,4,10,0xb2da51ad
50003.17,2.0,217,2,3,1,6,0xb2d6ffe0
27666.9,1.0,5,2,2,3,7,0xb2d629f8d
0.54,1.0,1,1,2,4,7,0xb2d0d194
912.01,1.0,8,1,2,3,6,0xb2d935d3
5.47,2.0,62,1,3,2,6,0x3b9b4788
19.3,1.0,60,1,2,2,5,0xb2d6071ad
4175.64,2.0,0,2,3,4,9,0xb2d0a6c8
7087.36,1.0,184,2,2,1,5,0xb2d590f4
1544.07,1.0,3,1,2,4,7,0xb2d6c1c5
110.79,1.0,16,1,2,2,5,0xb2d9c38d
9.5,1.0,70,1,2,1,4,0xb2d9607e
88489.77,3.0,0,3,4,4,11,0xb2d0b524d
590015.32,4.0,7,4,4,3,11,0xb2d0b75bd
280007.66,6.0,67,3,4,1,8,0xb2d58070d
53000.56,2.0,228,3,3,1,7,0xb2d6f775
130042.32,2.0,154,3,3,1,7,0xb2d48552
319.71,3.0,0,1,4,4,9,0x3b9b1875
1.81,1.0,9,1,2,3,6,0xb2d9ac5e
319045.65,2.0,14,4,3,3,10,0xb2d52262
305003.62,4.0,1,4,4,4,12,0xb2d39eb3
501776.04,2.0,30,4,3,2,9,0xb2d93e96
3404.59,1.0,0,2,2,4,8,0xb2d65a78d
20000.0,2.0,4,2,3,4,9,0xb2d646f7
1700.95,1.0,31,1,2,2,5,0xb2d6ffe6d
500000.0,2.0,10,4,3,3,10,0xb2d96cf3
3097.02,1.0,92,2,2,1,5,0xb2d08f8ad
170784.46,4.0,94,3,4,1,8,0xb2d4d13e
51190.97,1.0,136,2,2,1,5,0xb2d58436
6355.26,1.0,7,2,2,3,7,0xb2d25413
1511.56,1.0,164,1,2,1,4,0xb2d40fdd
250041.22,3.0,84,3,4,1,8,0xb2d55d44
97.7,1.0,48,1,2,2,5,0xb2d39028
240009.17,3.0,167,3,4,1,8,0xb2d4384dd
210456.3,3.0,15,3,4,3,10,0xb2d0bfd9d
274000.66,3.0,22,3,4,2,9,0xb2d15d63
16498.88,1.0,184,2,2,1,5,0xb2d58a49d
7724746.53,10.0,18,4,4,2,10,0xb2d1df92
1.93,1.0,50,1,2,2,5,0xb2d1ace1d
5023.68,1.0,184,2,2,1,5,0xb2d59f51d
14004.29,1.0,10,2,2,3,7,0xb2d8f421
50020.68,1.0,7,2,2,3,7,0xb2d46fdbd
13711.48,1.0,105,2,2,1,5,0xb2d5d9a3d
3966.86,1.0,9,2,2,3,7,0xb2d28129
5749.6,1.0,158,2,2,1,5,0xb2d43487
1016.91,1.0,184,1,2,1,4,0xb2d0d92bd
120002.53,2.0,18,3,3,2,8,0xb2d94f32
174241.06,2.0,0,3,3,4,10,0xb2d15eccd
100006.51,2.0,224,3,3,1,7,0xb2d242a0d
503882.61,2.0,61,4,3,2,9,0xb2d8ecca
99.45,1.0,1,1,2,4,7,0xb2d23116
955123.47,8.0,10,4,4,3,11,0xb2d1e8a6d
126128.58,4.0,13,3,4,3,10,0xb2d5cf2cd
1140088.63,5.0,158,4,4,1,9,0xb2d30373d
60000.11,3.0,0,3,4,4,11,0xb2d93281
714.35,1.0,5,1,2,3,6,0xb2d680a9d
6456.41,1.0,162,2,2,1,5,0xb2d553e9d
544647.82,5.0,41,4,4,2,10,0xb2d58528
105033.16,2.0,188,3,3,1,7,0xb2d51e0bd
7593.01,1.0,184,2,2,1,5,0xb2d0c057
2413.55,1.0,137,1,2,1,4,0xb2d2908fd
401448.78,2.0,0,4,3,4,11,0xb2d7bc96d
200000.0,2.0,28,3,3,2,8,0xb2da0d3f
3184.91,1.0,12,2,2,3,7,0xb2d27393
82.17,1.0,9,1,2,3,6,0xb2d4536d
481817.4,1.0,8,4,2,3,9,0xb2d2203b
1453.2,1.0,184,1,2,1,4,0xb2d22aa8
1674.11,1.0,13,1,2,3,6,0xb2d342e8
1159090.29,9.0,39,4,4,2,10,0xb2d27fea
1847.2,1.0,10,1,2,3,6,0xb2d21c50d
46006.24,3.0,24,2,4,2,8,0xb2d6451ad
9942.04,1.0,29,2,2,2,6,0xb2d91c2f
300093.25,2.0,116,3,3,1,7,0xb2d5ddc3
403101.0,7.0,66,4,4,2,10,0xb2d3fbdc
70.99,1.0,5,1,2,3,6,0xb2d2baa0
300312.33,8.0,80,4,4,1,9,0xb2d3fb75d
387908.46,3.0,14,4,4,3,11,0xb2d1b426d
910669.02,22.0,28,4,4,2,10,0xb2d17f58d
66132.45,1.0,43,3,2,2,7,0xb2d6935bd
50000.0,2.0,0,2,3,4,9,0xb2d905efd
5.25,1.0,46,1,2,2,5,0xb2d31367
31.15,1.0,47,1,2,2,5,0xb2d58d19d
507.49,1.0,0,1,2,4,7,0xb2d973d0
925111.62,5.0,14,4,4,3,11,0xb2d06abd
2155.21,1.0,6,1,2,3,6,0xb2d68e67
45112.89,1.0,2,2,2,4,8,0xb2d06967d
129.59,1.0,57,1,2,2,5,0xb2d1fa5d
488.49,1.0,3,1,2,4,7,0xb2d30d06d
200000.0,2.0,13,3,3,3,9,0xb2d95fcf
326003.76,4.0,6,4,4,3,11,0xb2d91376d
155531.49,2.0,66,3,3,2,8,0xb2d4d0cad
60.57,1.0,0,1,2,4,7,0xb2d7851e
1100.72,1.0,0,1,2,4,7,0xb2d62bca
203555.08,2.0,28,3,3,2,8,0xb2d6b6acd
9391.14,4.0,1,2,4,4,10,0xb2d07df6d
400018.05,2.0,27,4,3,2,9,0xb2d90caed
400373.25,3.0,3,4,4,4,12,0xb2d64cd7d
2000.41,1.0,1,1,2,4,7,0xb2d6ab08
785039.55,9.0,4,4,4,4,12,0xb2d52650d
588002.78,4.0,11,4,4,3,11,0xb2d94645d
11.4,1.0,72,1,2,1,4,0xb2d958a7d
11370000.0,11.0,1,4,4,4,12,0xb2d3555dd
7091.18,1.0,82,2,2,1,5,0xb2d32087d
800899.48,14.0,10,4,4,3,11,0xb2d6c4c8d
88.28,1.0,21,1,2,2,5,0xb2d38c2ad
926625.37,2.0,56,4,3,2,9,0xb2d40ee8
647157.78,3.0,11,4,4,3,11,0xb2d3f708d
23.5,1.0,5,1,2,3,6,0xb2d1ecd3
1197844.17,15.0,0,4,4,4,12,0x3b9af298
85.82,1.0,10,1,2,3,6,0xb2d9e908
762611.19,9.0,3,4,4,4,12,0xb2d2474ed
15331.54,1.0,15,2,2,3,7,0xb2d319b8d
551951.75,4.0,0,4,4,4,12,0xb2d3ba77d
300009.52,2.0,200,3,3,1,7,0xb2d78d8fd
212.56,1.0,139,1,2,1,4,0xb2d5e0aad
9539.34,1.0,1,2,2,4,8,0xb2d1feb7d
500228.18,2.0,4,4,3,4,11,0xb2d97941
4863.09,1.0,184,2,2,1,5,0xb2d0e78a
202843.24,2.0,139,3,3,1,7,0xb2d918b9d
190000.0,3.0,0,3,4,4,11,0xb2d5f3e6d
140079.99,3.0,67,3,4,1,8,0xb2d91b7fd
796.41,1.0,93,1,2,1,4,0xb2d29866d
200153.62,2.0,15,3,3,3,9,0xb2d65797d
19.08,1.0,10,1,2,3,6,0xb2da15e1
376582.07,6.0,45,4,4,2,10,0xb2d3c5aad
79.33,1.0,13,1,2,3,6,0xb2d2aae6
170011.72,3.0,49,3,4,2,9,0xb2d58f57
1346.97,1.0,92,1,2,1,4,0xb2d2f9e6
1502.81,4.0,0,1,4,4,9,0xb2d08cd5
1170835.83,9.0,0,4,4,4,12,0x3b9af100d
135.96,1.0,74,1,2,1,4,0xb2d9744c
42488.17,1.0,0,2,2,4,8,0xb2d526c3d
242.51,1.0,9,1,2,3,6,0xb2d40ef9
121003.27,3.0,0,3,4,4,11,0xb2d59423d
203610.5,3.0,120,3,4,1,8,0xb2d0b85c
450116.51,2.0,132,4,3,1,8,0xb2d6c298d
10.36,1.0,62,1,2,2,5,0xb2d2ec54
256401.01,5.0,21,3,4,2,9,0xb2d5903ed
651809.66,5.0,18,4,4,2,10,0xb2d39f0ad
18.11,2.0,17,1,3,2,6,0xb2d30a55d
100095.5,2.0,111,3,3,1,7,0xb2d0c8f8
127849.56,1.0,180,3,2,1,6,0xb2d259e4d
112592.01,2.0,70,3,3,1,7,0xb2d18420d
13642.32,1.0,9,2,2,3,7,0xb2d5c953
61776.05,2.0,3,3,3,4,10,0xb2d1ea2dd
84047.88,2.0,41,3,3,2,8,0xb2d593d2d
486109.29,3.0,0,4,4,4,12,0xb2d0b4dfd
1448.28,1.0,184,1,2,1,4,0xb2d1bb34d
421.29,1.0,10,1,2,3,6,0xb2d32cbbd
10301.86,1.0,202,2,2,1,5,0xb2d5d21ad
77.07,1.0,1,1,2,4,7,0xb2d8001c
51212.9,1.0,92,2,2,1,5,0xb2d0d24fd
120313.73,1.0,1,3,2,4,9,0xb2d5abe3
224057.88,2.0,7,3,3,3,9,0xb2d51699
502367.12,3.0,36,4,4,2,10,0xb2d9aa86
60.97,1.0,11,1,2,3,6,0xb2d53cc6
524.32,1.0,25,1,2,2,5,0xb2d391b3
3147.19,1.0,5,2,2,3,7,0xb2d2c3fc
2255.83,1.0,20,1,2,2,5,0xb2d2e22cd
364403.98,5.0,5,4,4,3,11,0xb2d5c1c6
312033.4,5.0,8,4,4,3,11,0xb2d40ba9d
2103.17,1.0,1,1,2,4,7,0xb2d6b962
215007.85,4.0,24,3,4,2,9,0xb2d56e4a
31.82,1.0,18,1,2,2,5,0xb2d20dced
261170.03,2.0,24,3,3,2,8,0xb2d6cbb4
5514.88,1.0,1,2,2,4,8,0xb2d41083d
1058.52,1.0,184,1,2,1,4,0xb2d241dad
650073.92,4.0,1,4,4,4,12,0x3b9b3628
500052.1,2.0,8,4,3,3,10,0xb2d9ad0c
1.83,1.0,7,1,2,3,6,0xb2da2c0c
129953.25,1.0,0,3,2,4,9,0xb2d475d4
200005.87,2.0,22,3,3,2,8,0xb2d40c71d
1500000.13,3.0,14,4,4,3,11,0xb2d65a71
60180.52,2.0,31,3,3,2,8,0xb2d427a0d
200008.45,2.0,189,3,3,1,7,0xb2d83a1c
140010.5,4.0,41,3,4,2,9,0xb2d3422cd
6450402.83,2.0,0,4,3,4,11,0xb2d8c622d
5799.68,1.0,17,2,2,2,6,0xb2d3159ed
14514.91,2.0,33,2,3,2,7,0xb2d06554
50757.12,6.0,5,2,4,3,9,0xb2d8f46d
486.56,1.0,1,1,2,4,7,0xb2d688d4
3341.61,1.0,92,2,2,1,5,0xb2d0ae95
4733036.19,9.0,0,4,4,4,12,0xb2d8cdebd
306422.1,3.0,18,4,4,2,10,0xb2d9a14e
1932.98,1.0,184,1,2,1,4,0xb2d37568
1999.22,1.0,1,1,2,4,7,0xb2d8ebbcd
20000.63,2.0,60,2,3,2,7,0xb2d9b963
3956.87,1.0,3,2,2,4,8,0xb2d6e8be
983258.82,8.0,0,4,4,4,12,0xb2d17cfcd
100529.59,3.0,38,3,4,2,9,0xb2d6c50bd
5.57,1.0,19,1,2,2,5,0xb2d3dce0
2013.26,3.0,146,1,4,1,6,0x3b9adb52d
3401.79,1.0,244,2,2,1,5,0xb2d61f57d
42653.34,2.0,15,2,3,3,8,0x3b9b2b77d
336.07,1.0,12,1,2,3,6,0xb2d28776d
500105.69,2.0,60,4,3,2,9,0xb2d8d667d
16.12,1.0,0,1,2,4,7,0xb2d53034d
1891085.95,8.0,6,4,4,3,11,0xb2d31bf7d
50038.69,2.0,76,2,3,1,6,0xb2d2113dd
942992.08,7.0,11,4,4,3,11,0xb2d103a7d
51373.87,2.0,59,2,3,2,7,0xb2d5b88bd
312115.49,4.0,54,4,4,2,10,0xb2d23e25
550008.4,2.0,22,4,3,2,9,0xb2d8d306d
4617.75,1.0,0,2,2,4,8,0xb2d4ed48d
18.44,1.0,48,1,2,2,5,0xb2d90dc4d
10165.51,2.0,111,2,3,1,6,0xb2d6473ed
93.38,1.0,12,1,2,3,6,0xb2d514ba
800007.58,6.0,5,4,4,3,11,0xb2d91447d
254044.65,2.0,41,3,3,2,8,0xb2d5b417d
141065.3,3.0,39,3,4,2,9,0xb2d22d26d
200099.4,2.0,259,3,3,1,7,0xb2d1130c
375.8,1.0,17,1,2,2,5,0xb2d54e4dd
1214.68,1.0,92,1,2,1,4,0xb2d1f2c7d
174759.42,3.0,1,3,4,4,11,0xb2d284a7d
50003.72,2.0,22,2,3,2,7,0xb2d9b089
552894.71,2.0,14,4,3,3,10,0xb2d0fa1ed
0.0,1.0,4,1,2,4,7,0xb2d9b700
1063026.93,5.0,13,4,4,3,11,0xb2d24d95
1265597.35,11.0,0,4,4,4,12,0xb2d18f8dd
852.18,1.0,0,1,2,4,7,0xb2d537af
9.07,1.0,41,1,2,2,5,0xb2d31378
279.0,1.0,1,1,2,4,7,0xb2d52212
4915.84,1.0,10,2,2,3,7,0xb2d96dde
80003.43,2.0,18,3,3,2,8,0xb2d8808dd
7000.37,1.0,15,2,2,3,7,0xb2d98864
24.47,1.0,68,1,2,1,4,0xb2d8e247d
515859.51,1.0,23,4,2,2,8,0xb2d6e802
1320.3,1.0,9,1,2,3,6,0xb2d2073ad
256690.0,3.0,175,3,4,1,8,0xb2d2ffded
24996.16,1.0,20,2,2,2,6,0xb2d69a35d
685959.94,3.0,9,4,4,3,11,0xb2d4b376
500015.87,2.0,209,4,3,1,8,0xb2d2d581d
218.55,1.0,28,1,2,2,5,0xb2d28fc2
250028.85,5.0,5,3,4,3,10,0xb2d4a692d
41380.33,1.0,16,2,2,2,6,0xb2d39ee4
75.21,1.0,20,1,2,2,5,0xb2d203bdd
810839.53,4.0,1,4,4,4,12,0xb2d43494d
11359.97,2.0,0,2,3,4,9,0xb2d21248d
50353.64,2.0,75,2,3,1,6,0xb2d603a9
2794.25,1.0,0,1,2,4,7,0xb2d50566
2223717.2,4.0,1,4,4,4,12,0xb2d92a09d
1000000.2,1.0,0,4,2,4,10,0xb2d78399d
177960.94,16.0,1,3,4,4,11,0xb2d2e873d
100243.99,3.0,4,3,4,4,11,0xb2d44dd1d
10117.75,1.0,95,2,2,1,5,0xb2d8478cd
143014.53,2.0,213,3,3,1,7,0xb2d6f67c
50577.13,1.0,12,2,2,3,7,0xb2d51ca9d
33691.07,4.0,0,2,4,4,10,0xb2d0ba91
440336.28,4.0,97,4,4,1,9,0xb2d5b021d
358394.73,7.0,0,4,4,4,12,0xb2d27669
991.67,1.0,8,1,2,3,6,0xb2d36434
4232.59,4.0,1,2,4,4,10,0x3b9af4c5
138436.33,7.0,3,3,4,4,11,0xb2d4e146d
1915.95,1.0,0,1,2,4,7,0xb2d5b125
501786.67,3.0,0,4,4,4,12,0xb2d8ead4
154.53,1.0,58,1,2,2,5,0xb2d63ef9
99.93,1.0,0,1,2,4,7,0xb2d8dbb4
10530.98,1.0,1,2,2,4,8,0xb2d606ce
95.0,1.0,60,1,2,2,5,0xb2d8fcf9
590.11,1.0,0,1,2,4,7,0xb2d3198bd
50957.27,6.0,3,2,4,4,10,0xb2d8f46dd
1140040.62,3.0,42,4,4,2,10,0xb2d4ebcf
200753.49,2.0,35,3,3,2,8,0xb2d8f58ed
30042.01,2.0,208,2,3,1,6,0xb2d69cf1d
40.72,1.0,5,1,2,3,6,0xb2d3f7fed
13.48,1.0,20,1,2,2,5,0xb2d22b3fd
115341.5,3.0,0,3,4,4,11,0xb2d6542f
119497.15,3.0,0,3,4,4,11,0xb2d19bc0
102495.01,2.0,167,3,3,1,7,0xb2d59258d
181261.37,1.0,92,3,2,1,6,0xb2d1b040d
200001.26,2.0,7,3,3,3,9,0xb2d972c1
640248.36,4.0,151,4,4,1,9,0xb2d1becbd
6516.02,1.0,216,2,2,1,5,0xb2d3bbf2d
160091.63,3.0,11,3,4,3,10,0xb2d3fe9ed
4.89,1.0,51,1,2,2,5,0xb2d87eb6
490000.74,3.0,0,4,4,4,12,0xb2d5e0bcd
200001.26,2.0,25,3,3,2,8,0xb2d78771d
1772.88,1.0,92,1,2,1,4,0xb2d1a276d
410041.15,6.0,19,4,4,2,10,0xb2d1bed9d
9629.08,1.0,13,2,2,3,7,0xb2d32ed9
112.72,1.0,2,1,2,4,7,0xb2d45827
639.2,1.0,69,1,2,1,4,0xb2d2b095d
693007.25,5.0,2,4,4,4,12,0xb2d6def9d
1757.3,1.0,0,1,2,4,7,0xb2d9ad29
100002.11,3.0,42,3,4,2,9,0xb2d92123d
1874.56,1.0,184,1,2,1,4,0xb2d5afb3d
1800044.41,4.0,0,4,4,4,12,0xb2d628a9
3169641.23,20.0,11,4,4,3,11,0x3b9adca7d
1019.93,1.0,92,1,2,1,4,0xb2d2a169
10000.32,2.0,25,2,3,2,7,0xb2da0e04
11241.56,1.0,184,2,2,1,5,0xb2d3cbb6d
10665.8,1.0,124,2,2,1,5,0xb2d3a68ed
161518.75,2.0,19,3,3,2,8,0xb2d57695d
8606.85,1.0,8,2,2,3,7,0xb2d685b9d
143000.0,14.0,38,3,4,2,9,0xb2d19e38
20174.38,1.0,85,2,2,1,5,0xb2d6bcc1
2303.88,1.0,3,1,2,4,7,0xb2d4e55a
121053.11,1.0,0,3,2,4,9,0xb2d3f7a4
1153541.31,5.0,27,4,4,2,10,0xb2d637e6d
15.2,1.0,28,1,2,2,5,0xb2d9c932
52241.27,2.0,175,3,3,1,7,0xb2d61e2ad
200000.0,2.0,1,3,3,4,10,0xb2da6709
405835.97,8.0,69,4,4,1,9,0xb2d24fb3d
45217.58,1.0,13,2,2,3,7,0xb2d38a07d
1316.66,1.0,12,1,2,3,6,0xb2d34556
150015.95,3.0,112,3,4,1,8,0xb2d8da7b
75.88,1.0,81,1,2,1,4,0xb2d85837d
500000.0,2.0,0,4,3,4,11,0xb2da6b80
177430.16,1.0,15,3,2,3,8,0xb2d18c29
32174.23,1.0,0,2,2,4,8,0xb2d264abd
8700091.92,2.0,123,4,3,1,8,0xb2d935a9d
301065.63,2.0,34,4,3,2,9,0xb2d9ffc4
463705.54,9.0,3,4,4,4,12,0xb2d15451
582.71,1.0,21,1,2,2,5,0xb2d37a5f
155152.08,3.0,24,3,4,2,9,0xb2d1b4a0d
675.6,1.0,9,1,2,3,6,0xb2d4424ed
11.65,1.0,50,1,2,2,5,0xb2d34772d
301065.8,2.0,55,4,3,2,9,0xb2d9cc38
60438.43,5.0,2,3,4,4,11,0xb2d6e3c8
20314.56,2.0,24,2,3,2,7,0xb2d857a7
1696.73,1.0,4,1,2,4,7,0xb2d43a01
100025.59,3.0,93,3,4,1,8,0xb2d3ae38d
41001.73,2.0,95,2,3,1,6,0xb2d60332d
63878.95,1.0,1,3,2,4,9,0xb2d5a882d
3697.37,1.0,9,2,2,3,7,0xb2d8d7cfd
1623.66,1.0,15,1,2,3,6,0x3b9b3386d
3023.55,1.0,3,2,2,4,8,0xb2d5bce0d
2217.48,1.0,73,1,2,1,4,0xb2d609dc
10353.77,1.0,2,2,2,4,8,0xb2d6ceb9
2598824.66,5.0,77,4,4,1,9,0xb2d089a7
508885.59,2.0,5,4,3,3,10,0xb2d6d891
709952.61,2.0,91,4,3,1,8,0xb2d8f6a4d
4576.2,2.0,10,2,3,3,8,0xb2d97f9e
2888.41,1.0,1,2,2,4,8,0xb2d5d211d
150089.68,3.0,13,3,4,3,10,0xb2d5f8d6
97.5,1.0,11,1,2,3,6,0xb2d20b7a
519.96,1.0,1,1,2,4,7,0xb2d5a55cd
214782.48,5.0,2,3,4,4,11,0x3b9b3cedd
200004.22,2.0,228,3,3,1,7,0xb2d6f43f
858.78,2.0,184,1,3,1,5,0xb2d118e4d
5173.56,1.0,184,2,2,1,5,0xb2d26fb5d
842.44,1.0,2,1,2,4,7,0xb2d1e03f
1255454.58,7.0,8,4,4,3,11,0xb2d8dfb6
1177.45,1.0,5,1,2,3,6,0xb2d2f8c0d
400040.42,3.0,69,4,4,1,9,0xb2d5e498
10.45,1.0,67,1,2,1,4,0xb2d99d69
1570355.68,1.0,0,4,2,4,10,0xb2d3f243
300009.5,2.0,77,3,3,1,7,0xb2d991fc
603951.7,6.0,92,4,4,1,9,0xb2d19f62d
95.64,1.0,1,1,2,4,7,0xb2d1deb8d
130764.69,4.0,175,3,4,1,8,0xb2d1766dd
1.06,1.0,18,1,2,2,5,0xb2d61974
86595.6,3.0,214,3,4,1,8,0xb2d4016dd
1129679.16,11.0,18,4,4,2,10,0xb2d1a9e2d
52978.37,6.0,1,3,4,4,11,0xb2d1c53c
20000.21,2.0,32,2,3,2,7,0xb2da04bb
120392.45,5.0,8,3,4,3,10,0xb2d62c9bd
1484.87,1.0,8,1,2,3,6,0xb2d34dcad
1172549.79,1.0,0,4,2,4,10,0xb2d22d8fd
8396.47,1.0,14,2,2,3,7,0xb2d6b99f
22086.93,1.0,0,2,2,4,8,0xb2d69113d
10062.38,2.0,63,2,3,2,7,0xb2d40e4c
150023.63,3.0,4,3,4,4,11,0xb2d0675dd
168011.94,2.0,0,3,3,4,10,0xb2d0f666d
362438.77,2.0,11,4,3,3,10,0xb2d17fadd
59.07,2.0,27,1,3,2,6,0xb2d071b9
50000.67,2.0,42,2,3,2,7,0xb2d286a6
315802.29,6.0,0,4,4,4,12,0xb2d0623ad
113953.71,2.0,87,3,3,1,7,0xb2d227d8d
400257.99,2.0,73,4,3,1,8,0xb2d6313a
61228.08,3.0,16,3,4,2,9,0xb2d69365d
35.94,1.0,12,1,2,3,6,0xb2d2622dd
20440.21,2.0,143,2,3,1,6,0xb2d5c394d
40498.0,5.0,14,2,4,3,9,0xb2d78685d
251854.3,5.0,0,3,4,4,11,0xb2d0686f
11538.63,2.0,0,2,3,4,9,0x3b9b2d9ed
0.64,1.0,8,1,2,3,6,0xb2d3b81f
553271.34,2.0,129,4,3,1,8,0xb2d5ca42
7308.4,2.0,39,2,3,2,7,0xb2d0ec02
8.89,2.0,29,1,3,2,6,0xb2d93392
101116.6,1.0,0,3,2,4,9,0xb2d3c357d
1667684.83,2.0,7,4,3,3,10,0xb2d2f0f8d
254433.37,2.0,4,3,3,4,10,0xb2d2b90e
250000.0,2.0,3,3,3,4,10,0xb2d8f50cd
50020.92,2.0,153,2,3,1,6,0xb2d61b59d
1070002.63,5.0,10,4,4,3,11,0xb2d5e3c5d
301555.74,4.0,6,4,4,3,11,0xb2d59df6
1166665.36,9.0,8,4,4,3,11,0x3b9af53ad
66334.17,1.0,29,3,2,2,7,0xb2d3ea85d
1477778.35,3.0,0,4,4,4,12,0x3b9b2a4c
109095.13,1.0,13,3,2,3,8,0xb2d469a8
7.92,1.0,18,1,2,2,5,0xb2da2554
175116.28,5.0,90,3,4,1,8,0xb2d10d09
22380.91,1.0,15,2,2,3,7,0xb2d3196fd
700026.95,7.0,6,4,4,3,11,0xb2d6fbde
1824.46,1.0,0,1,2,4,7,0xb2d80320
100005.28,2.0,55,3,3,2,8,0xb2d9c358
42.27,1.0,28,1,2,2,5,0xb2d37d16
200553.89,1.0,11,3,2,3,8,0xb2d2e070d
15.2,1.0,88,1,2,1,4,0xb2d58d14d
4482.69,1.0,5,2,2,3,7,0xb2d58512d
1274.79,1.0,92,1,2,1,4,0xb2d29fe3
1501.46,1.0,131,1,2,1,4,0xb2d43cc1d
18001.65,2.0,24,2,3,2,7,0xb2d94907d
150102.01,8.0,11,3,4,3,10,0xb2d5747ed
409924.24,7.0,15,4,4,3,11,0x3b9b3b70d
364661.91,4.0,14,4,4,3,11,0xb2d155c4d
204266.05,2.0,43,3,3,2,8,0xb2d6a164d
133025.86,6.0,27,3,4,2,9,0xb2d16bdb
3440096.98,5.0,46,4,4,2,10,0xb2d34bc0
34.92,1.0,74,1,2,1,4,0xb2d4cdbad
700382.52,4.0,8,4,4,3,11,0xb2d8e94dd
70099.89,6.0,59,3,4,2,9,0xb2d7c756d
0.0,1.0,3,1,2,4,7,0xb2d6ba79
100000.0,2.0,6,3,3,3,9,0xb2d97062
12295.2,2.0,92,2,3,1,6,0xb2d64d33
2.09,2.0,28,1,3,2,6,0xb2d0685dd
1526.29,1.0,1,1,2,4,7,0xb2d36a3dd
221.29,1.0,5,1,2,3,6,0xb2d5e1a5
22117.5,1.0,96,2,2,1,5,0xb2d55ef5d
8.63,1.0,160,1,2,1,4,0xb2d283dfd
1240155.97,4.0,80,4,4,1,9,0xb2d5b377d
100015.16,2.0,18,3,3,2,8,0xb2d187ce
91219.05,1.0,7,3,2,3,8,0xb2d2ff6cd
300120.33,3.0,22,4,4,2,10,0xb2d62330d
10007.48,1.0,0,2,2,4,8,0xb2d6f0e5d
30000.32,2.0,27,2,3,2,7,0xb2d9412d
387003.2,5.0,94,4,4,1,9,0x3b9b2b85
3208.01,1.0,9,2,2,3,7,0xb2d2e548
3101.69,1.0,16,2,2,2,6,0xb2d92570
36856.18,1.0,3,2,2,4,8,0xb2d55f43d
62.82,1.0,52,1,2,2,5,0xb2d78fc4
10738.93,1.0,0,2,2,4,8,0xb2d1f4bb
80003.39,2.0,94,3,3,1,7,0xb2d655ff
3.99,1.0,1,1,2,4,7,0xb2d293da
290011.82,6.0,6,3,4,3,10,0xb2d15525
2795.46,1.0,0,1,2,4,7,0xb2d5bde7
50000.53,2.0,49,2,3,2,7,0xb2d9d7f4
300000.0,2.0,0,3,3,4,10,0xb2da6bb0
360.55,1.0,18,1,2,2,5,0xb2d4913ed
171116.66,11.0,1,3,4,4,11,0xb2d189cbd
4228.86,1.0,0,2,2,4,8,0xb2d6be9c
1001.87,1.0,186,1,2,1,4,0xb2d6af53d
809516.12,9.0,10,4,4,3,11,0xb2d53781
500034.14,11.0,1,4,4,4,12,0xb2d5fe3f
450099.07,2.0,14,4,3,3,10,0xb2d645b4d
288.62,1.0,1,1,2,4,7,0xb2d6b7c9
200138.91,2.0,3,3,3,4,10,0xb2d3cf59d
140063.75,5.0,0,3,4,4,11,0xb2d603d6
201659.21,2.0,148,3,3,1,7,0xb2d1a5dcd
334.13,1.0,77,1,2,1,4,0xb2d3f7fb
10000.63,1.0,1,2,2,4,8,0xb2d25251d
200000.0,2.0,14,3,3,3,9,0xb2d95df0
537396.69,7.0,0,4,4,4,12,0xb2d649e4
102534.45,2.0,111,3,3,1,7,0xb2d4f69dd
629.82,1.0,0,1,2,4,7,0xb2d20768d
2646.68,1.0,10,1,2,3,6,0xb2d2c962d
8936.03,1.0,0,2,2,4,8,0xb2d901cdd
20429.31,1.0,16,2,2,2,6,0xb2d11457
48.33,1.0,7,1,2,3,6,0xb2d6c1f0
110772.28,2.0,35,3,3,2,8,0xb2d32d5e
541.38,1.0,10,1,2,3,6,0xb2d57628d
1010.12,1.0,92,1,2,1,4,0xb2d182ffd
12.78,1.0,50,1,2,2,5,0xb2d99018
17.45,1.0,19,1,2,2,5,0xb2d6bbe9
200720.92,3.0,15,3,4,3,10,0xb2d8e067
450000.0,1.0,0,4,2,4,10,0xb2d9f581
700918.25,4.0,42,4,4,2,10,0xb2d0638dd
700705.3,4.0,0,4,4,4,12,0xb2d1a34dd
693016.77,12.0,6,4,4,3,11,0xb2d5ad92
3905.43,1.0,9,2,2,3,7,0xb2d4ebeb
40096.42,3.0,43,2,4,2,8,0xb2d56bf1
1000154.7,1.0,1,4,2,4,10,0xb2d3abc3d
152313.54,2.0,4,3,3,4,10,0xb2d5e958d
3043.15,1.0,2,2,2,4,8,0xb2d56d68
125635.18,3.0,4,3,4,4,11,0xb2d949c8d
2336.65,1.0,184,1,2,1,4,0xb2d245f6d
316.81,1.0,133,1,2,1,4,0xb2d6e60cd
140027.01,2.0,157,3,3,1,7,0xb2d5f8de
244.36,1.0,10,1,2,3,6,0xb2d6dbccd
20646.33,2.0,18,2,3,2,7,0xb2d69681d
356426.68,4.0,97,4,4,1,9,0xb2d650e5d
1555346.36,7.0,0,4,4,4,12,0xb2d695c4d
50612.85,2.0,0,2,3,4,9,0xb2d1bbc9
122165.86,2.0,200,3,3,1,7,0xb2d27bfb
327555.51,2.0,3,4,3,4,11,0xb2d3c528d
290110.37,5.0,19,3,4,2,9,0xb2d5e4cfd
100152.56,2.0,23,3,3,2,8,0xb2d3a0a6d
200000.0,2.0,12,3,3,3,9,0xb2da4683
488000.0,8.0,7,4,4,3,11,0xb2d0676bd
400000.0,4.0,7,4,4,3,11,0xb2d0e7e7d
1844.16,1.0,184,1,2,1,4,0xb2d1016b
800574.9,22.0,0,4,4,4,12,0xb2d3c410
44.71,1.0,0,1,2,4,7,0xb2d2fae3
1763000.29,9.0,0,4,4,4,12,0xb2d0ac79d
1500000.0,2.0,0,4,3,4,11,0xb2d982ccd
10000.0,2.0,3,2,3,4,9,0xb2d69e81d
62902.37,1.0,9,3,2,3,8,0xb2d6ef09
176100.74,1.0,92,3,2,1,6,0xb2d40a45d
100005.35,3.0,32,3,4,2,9,0xb2d26268
50.0,1.0,20,1,2,2,5,0xb2d6a3a8
4449.2,1.0,15,2,2,3,7,0xb2d756b3
1000000.16,3.0,12,4,4,3,11,0xb2d8e599
8.15,1.0,29,1,2,2,5,0xb2d93e7fd
3867463.18,5.0,10,4,4,3,11,0xb2d39121d
48.62,1.0,1,1,2,4,7,0xb2d7837c
100151.54,4.0,1,3,4,4,11,0x3b9af11bd
746320.83,5.0,33,4,4,2,10,0x3b9b2d84d
1622.18,1.0,184,1,2,1,4,0xb2d1ce13
1261205.37,11.0,0,4,4,4,12,0xb2d5d385d
1772191.58,4.0,168,4,4,1,9,0xb2d2f5de
501067.53,3.0,21,4,4,2,10,0xb2da06b8
201559.99,3.0,9,3,4,3,10,0xb2d15e15
200806.74,2.0,48,3,3,2,8,0xb2d65b12d
114975.56,2.0,4,3,3,4,10,0xb2d6f961
5800.32,2.0,92,2,3,1,6,0xb2d08ef3d
4694.75,1.0,10,2,2,3,7,0xb2d20c1e
1.64,1.0,49,1,2,2,5,0xb2d65fb7
0.01,1.0,34,1,2,2,5,0xb2d11788
2464438.38,1.0,0,4,2,4,10,0xb2d8d02ad
5464.05,1.0,260,2,2,1,5,0xb2d2064a
52007.01,2.0,186,2,3,1,6,0xb2d18463d
50544.36,2.0,36,2,3,2,7,0xb2d6d0ced
3050.36,1.0,0,2,2,4,8,0xb2d9b29f
272355.17,9.0,0,3,4,4,11,0xb2d0e891d
59636.78,1.0,0,3,2,4,9,0xb2d6a6ab
344148.65,7.0,22,4,4,2,10,0xb2d19947d
350104.08,5.0,6,4,4,3,11,0xb2d21e9b
494019.59,4.0,26,4,4,2,10,0xb2d35cf6
30086.12,1.0,10,2,2,3,7,0xb2d2da0a
1000216.38,2.0,0,4,3,4,11,0xb2d9818fd
415126.79,12.0,0,4,4,4,12,0x3b9b4692d
30248.28,2.0,5,2,3,3,8,0x3b9b3839d
1000272.99,4.0,200,4,4,1,9,0xb2d2531e
3548.28,1.0,4,2,2,4,8,0xb2d1fd4ad
2102011.28,3.0,94,4,4,1,9,0xb2d7fd69d
10000.53,1.0,15,2,2,3,7,0xb2da2a4e
1491.31,1.0,249,1,2,1,4,0xb2d5eb7ed
60008.67,3.0,10,3,4,3,10,0xb2d44105d
50000.0,4.0,96,2,4,1,7,0xb2d39226
462.21,1.0,1,1,2,4,7,0xb2d5feb4d
100073.01,2.0,52,3,3,2,8,0xb2d6d2fad
24965.44,1.0,22,2,2,2,6,0xb2d651e5
230163.29,1.0,9,3,2,3,8,0xb2d2f300
640755.99,7.0,24,4,4,2,10,0xb2d0faacd
262174.41,8.0,12,3,4,3,10,0xb2d0ce0c
8307.82,1.0,10,2,2,3,7,0xb2d9082a
0.0,2.0,60,1,3,2,6,0xb2d50939
1654.88,1.0,10,1,2,3,6,0xb2d8f21f
320000.02,3.0,1,4,4,4,12,0xb2d243d4d
836922.55,5.0,0,4,4,4,12,0xb2d8f55cd
10420.29,1.0,7,2,2,3,7,0xb2d7870cd
46520.3,1.0,10,2,2,3,7,0xb2d6c080d
9208.44,1.0,4,2,2,4,8,0xb2d64981
50852.16,3.0,3,2,4,4,10,0xb2d0d58dd
31804.59,1.0,0,2,2,4,8,0xb2d0c10ad
854.99,1.0,0,1,2,4,7,0xb2d1fa75d
2680.43,1.0,184,1,2,1,4,0xb2d20dbfd
305062.85,2.0,15,4,3,3,10,0xb2d6c403
44750.37,1.0,9,2,2,3,7,0xb2d3b6cc
490004.9,8.0,13,4,4,3,11,0xb2d12d18d
502486.88,3.0,55,4,4,2,10,0xb2d9a5a7
53776.49,2.0,21,3,3,2,8,0xb2d5a28cd
501563.95,1.0,92,4,2,1,7,0xb2d6009cd
110.47,1.0,89,1,2,1,4,0xb2d7c34a
257225.93,7.0,28,3,4,2,9,0xb2d22d2cd
141360.86,2.0,15,3,3,3,9,0xb2d5ea44d
205769.66,2.0,32,3,3,2,8,0xb2d57c1f
520602.67,7.0,11,4,4,3,11,0xb2d5fe53d
2227856.31,13.0,2,4,4,4,12,0xb2d6453dd
410045.53,3.0,18,4,4,2,10,0xb2d63951d
2285.96,1.0,153,1,2,1,4,0xb2d1f147d
100167.19,1.0,10,3,2,3,8,0xb2d52ff0d
23.4,1.0,146,1,2,1,4,0xb2d8fe17
1319.36,1.0,0,1,2,4,7,0xb2d1a573
1003725.05,2.0,16,4,3,2,9,0xb2d22540
500710.42,3.0,8,4,4,3,11,0xb2d9b74e
1486.93,1.0,311,1,2,1,4,0xb2d46ffd
355632.89,2.0,95,4,3,1,8,0xb2d12608d
264016.4,17.0,0,3,4,4,11,0x3b9b36c6d
6.78,1.0,57,1,2,2,5,0xb2d68540
505329.92,2.0,102,4,3,1,8,0xb2d8149e
1688.22,1.0,19,1,2,2,5,0xb2d09a72
55083.49,2.0,6,3,3,3,9,0xb2d53b31d
28916.81,3.0,14,2,4,3,9,0x3b9b35d0d
1950587.79,4.0,0,4,4,4,12,0xb2d6ef81d
240003.08,4.0,1,3,4,4,11,0xb2d1c2a5d
770681.78,18.0,6,4,4,3,11,0xb2d19a70d
109388.19,12.0,24,3,4,2,9,0xb2d214a3d
237591.82,3.0,49,3,4,2,9,0xb2d962e2d
8691.62,1.0,0,2,2,4,8,0xb2d8ec0dd
800000.0,5.0,22,4,4,2,10,0xb2d5fb92
1077.63,1.0,10,1,2,3,6,0xb2d78d76
100004.38,5.0,45,3,4,2,9,0xb2d633d2d
124787.33,3.0,1,3,4,4,11,0xb2d1b1b9
73.79,1.0,9,1,2,3,6,0xb2d214d9d
548303.45,3.0,18,4,4,2,10,0xb2d6fdb0d
244013.24,3.0,26,3,4,2,9,0xb2d4fef8d
4.35,1.0,19,1,2,2,5,0xb2d6b530
420088.97,3.0,1,4,4,4,12,0xb2d42ca2d
11000.35,2.0,10,2,3,3,8,0xb2d9619dd
233039.3,2.0,4,3,3,4,10,0xb2d1aa13d
2693.77,1.0,184,1,2,1,4,0xb2d2f76ad
19797.63,1.0,92,2,2,1,5,0xb2d2805b
131.38,1.0,22,1,2,2,5,0xb2d3e771d
98496.86,1.0,15,3,2,3,8,0xb2d59605
15327.42,1.0,17,2,2,2,6,0xb2d69853d
88.67,1.0,57,1,2,2,5,0xb2d947c1
460000.4,8.0,0,4,4,4,12,0xb2d515e8d
80000.84,2.0,21,3,3,2,8,0xb2da227e
39.33,1.0,7,1,2,3,6,0xb2d4b964
342.23,1.0,18,1,2,2,5,0xb2d2017ad
59.92,1.0,30,1,2,2,5,0xb2d2875a
200317.34,4.0,53,3,4,2,9,0xb2d2c2db
1025304.35,2.0,216,4,3,1,8,0xb2d3ef29
390012.35,2.0,92,4,3,1,8,0xb2d97c53d
1287523.37,4.0,20,4,4,2,10,0xb2d5c8bad
7333.49,1.0,184,2,2,1,5,0xb2d11dbcd
563802.94,4.0,37,4,4,2,10,0xb2d6110cd
313037.16,5.0,20,4,4,2,10,0xb2d6300ed
10410.85,1.0,5,2,2,3,7,0xb2d9611c
9034.31,1.0,18,2,2,2,6,0xb2d308cdd
30433.36,1.0,14,2,2,3,7,0xb2d4f273
1127.7,1.0,11,1,2,3,6,0xb2d95b0c
155808.92,3.0,4,3,4,4,11,0xb2d5f6dad
106.62,1.0,1,1,2,4,7,0xb2da2861
751223.05,5.0,63,4,4,2,10,0xb2d41164d
440000.0,5.0,7,4,4,3,11,0xb2d95cc0d
376837.31,2.0,118,4,3,1,8,0xb2d0d8e8
5862.95,1.0,12,2,2,3,7,0xb2d61b6cd
11623.23,1.0,0,2,2,4,8,0xb2d696f5
57.92,1.0,5,1,2,3,6,0xb2d2d4d6
745.94,2.0,64,1,3,2,6,0xb2d4697b
526.78,1.0,3,1,2,4,7,0xb2d41730d
8243.7,1.0,4,2,2,4,8,0xb2d6ab91
49.91,1.0,2,1,2,4,7,0xb2d2164cd
18567.74,1.0,37,2,2,2,6,0xb2d55479
450097.81,3.0,0,4,4,4,12,0xb2d330d2d
364474.92,2.0,60,4,3,2,9,0xb2d56c74d
5000.42,1.0,18,2,2,2,6,0xb2d56a53
1308.17,1.0,92,1,2,1,4,0x3b9b3b32
328057.03,3.0,13,4,4,3,11,0xb2d57de3
274821.46,4.0,10,3,4,3,10,0xb2d2ad9a
11280.31,1.0,1,2,2,4,8,0xb2d69bb3
5994.16,1.0,0,2,2,4,8,0xb2d29b39
290064.94,2.0,9,3,3,3,9,0xb2d6d152d
1101196.11,15.0,2,4,4,4,12,0xb2d083ce
275236.91,5.0,62,3,4,2,9,0xb2d1605ed
45524.9,1.0,165,2,2,1,5,0xb2d328b9d
697.21,1.0,46,1,2,2,5,0xb2d0d9eed
2403.96,1.0,1,1,2,4,7,0xb2d6c6c3d
867002.24,5.0,8,4,4,3,11,0xb2d8dc99
259527.81,3.0,13,3,4,3,10,0xb2d5ccbf
160004.53,3.0,101,3,4,1,8,0xb2d64430
0.0,1.0,4,1,2,4,7,0xb2d62804
434074.54,3.0,31,4,4,2,10,0xb2d68369d
104211.12,3.0,87,3,4,1,8,0xb2d4100f
10063.72,1.0,20,2,2,2,6,0xb2d3c0c0
39809.77,1.0,0,2,2,4,8,0xb2d2b7c5d
4.4,1.0,77,1,2,1,4,0xb2d242af
101076.53,4.0,118,3,4,1,8,0xb2d40939
103961.37,1.0,111,3,2,1,6,0xb2d1539e
14862.61,5.0,0,2,4,4,10,0xb2d094ecd
393000.83,3.0,9,4,4,3,11,0xb2d17764d
127.25,1.0,3,1,2,4,7,0xb2d3bf43
0.0,2.0,6,1,3,3,7,0xb2d3dbc4
31610.84,2.0,70,2,3,1,6,0xb2d55d45
5186.04,1.0,4,2,2,4,8,0xb2d50ce1
500001.35,3.0,0,4,4,4,12,0xb2d2380dd
1081136.9,11.0,3,4,4,4,12,0xb2d26003d
17122.7,1.0,2,2,2,4,8,0xb2d5be8d
29.58,1.0,18,1,2,2,5,0xb2d9cf00
100931.68,1.0,92,3,2,1,6,0xb2d16b16d
1.06,1.0,47,1,2,2,5,0xb2d9d994
3267.33,1.0,1,2,2,4,8,0xb2d1e12bd
15602.3,1.0,21,2,2,2,6,0xb2d96479
4227.49,1.0,181,2,2,1,5,0xb2d1a40f
443939.51,9.0,4,4,4,4,12,0xb2d135a3d
200014.66,5.0,29,3,4,2,9,0x3b9b2647
22414.53,3.0,0,2,4,4,10,0xb2d6db18d
790633.92,4.0,0,4,4,4,12,0x3b9b3396d
2373.35,1.0,92,1,2,1,4,0xb2d1fa5ad
618.39,27.0,0,1,4,4,9,0x3b9b45a6
1430345.41,9.0,3,4,4,4,12,0xb2d5978dd
799.51,3.0,0,1,4,4,9,0x3b9af250
1084153.94,5.0,27,4,4,2,10,0xb2d4371d
1451.81,1.0,92,1,2,1,4,0xb2d22aa8d
11.0,1.0,23,1,2,2,5,0xb2d6c651d
126000.87,2.0,10,3,3,3,9,0xb2d9896f
200017.48,2.0,32,3,3,2,8,0xb2d6bc6d
54839.88,2.0,6,3,3,3,9,0xb2d4372ed
20062.1,2.0,35,2,3,2,7,0xb2d6ed5ed
300017.08,5.0,66,3,4,2,9,0xb2d5658bd
600000.0,3.0,0,4,4,4,12,0xb2d5bd0f
630075.22,7.0,21,4,4,2,10,0xb2d10b28d
410430.52,6.0,75,4,4,1,9,0xb2d4c259
123871.52,3.0,6,3,4,3,10,0xb2d52a3fd
9.08,1.0,31,1,2,2,5,0xb2d90697d
857195.82,19.0,1,4,4,4,12,0xb2d46f94
210000.0,2.0,0,3,3,4,10,0xb2da63c9
155073.78,3.0,31,3,4,2,9,0xb2d6499ed
160001.69,2.0,105,3,3,1,7,0xb2d95df9d
3002.42,1.0,32,2,2,2,6,0xb2d9996f
185908.46,2.0,4,3,3,4,10,0xb2d62cdfd
184.21,1.0,1,1,2,4,7,0xb2d9a03a
9336.22,1.0,14,2,2,3,7,0xb2d1fbf7
1.84,1.0,18,1,2,2,5,0xb2d4350ad
700000.0,3.0,0,4,4,4,12,0xb2d5c055d
196009.83,2.0,11,3,3,3,9,0xb2d43254
121670.08,1.0,4,3,2,4,9,0xb2da01d4
34001.54,3.0,66,2,4,2,8,0xb2d7ee8d
200006.12,2.0,70,3,3,1,7,0xb2d43c2dd
300233.42,2.0,11,4,3,3,10,0xb2d3ce26
131716.12,3.0,92,3,4,1,8,0xb2d1a6aad
548.71,1.0,24,1,2,2,5,0xb2d8de56
235920.25,2.0,60,3,3,2,8,0xb2d22c8dd
500009.0,2.0,7,4,3,3,10,0xb2da56dd
130633.85,4.0,43,3,4,2,9,0xb2d4c9db
6033.78,1.0,0,2,2,4,8,0xb2d38f21d
650187.93,3.0,3,4,4,4,12,0xb2d07c9dd
0.0,1.0,0,1,2,4,7,0xb2d6279a
596.98,1.0,10,1,2,3,6,0xb2d8ef81
65003.43,2.0,49,3,3,2,8,0xb2d9ae4c
591.72,1.0,0,1,2,4,7,0xb2d60b1dd
1044934.47,6.0,0,4,4,4,12,0xb2d0e0fb
60032.76,2.0,62,3,3,2,8,0xb2d470a8
40029.89,2.0,21,2,3,2,7,0xb2d36dc8
700890.18,4.0,19,4,4,2,10,0xb2d6bdf9d
716353.35,5.0,77,4,4,1,9,0x3b9b4423d
22601.21,2.0,1,2,3,4,9,0xb2d6b8c9d
91927.18,4.0,90,3,4,1,8,0xb2d43ec0d
151200.42,2.0,214,3,3,1,7,0xb2d69cacd
660548.41,2.0,88,4,3,1,8,0xb2d47dd5
31268.53,1.0,40,2,2,2,6,0xb2d27957
390008.44,5.0,4,4,4,4,12,0xb2d5b296
1230065.09,8.0,12,4,4,3,11,0xb2d3f5aed
100012.97,2.0,209,3,3,1,7,0xb2d247b6
191827.45,3.0,5,3,4,3,10,0xb2d6cdf3d
200711.41,3.0,37,3,4,2,9,0x3b9b19e5
1650.32,1.0,92,1,2,1,4,0xb2d17185d
2098.78,1.0,9,1,2,3,6,0xb2d43545
71386.11,2.0,60,3,3,2,8,0xb2d26f90d
139757.26,2.0,1,3,3,4,10,0xb2d3b707d
450996.05,8.0,4,4,4,4,12,0xb2d5aa48d
200062.81,3.0,6,3,4,3,10,0xb2d68989
2.4,1.0,16,1,2,2,5,0xb2d3139bd
80005.43,2.0,145,3,3,1,7,0xb2d3c234
5006.71,1.0,136,2,2,1,5,0xb2d64463d
37.47,1.0,44,1,2,2,5,0xb2d98314
202483.06,2.0,94,3,3,1,7,0xb2d67041
300007.21,3.0,0,3,4,4,11,0xb2d5dd68d
550206.36,2.0,69,4,3,1,8,0xb2d44034d
1721081.07,10.0,3,4,4,4,12,0xb2d14c02d
3786.75,1.0,152,2,2,1,5,0xb2d60895
6385.55,1.0,9,2,2,3,7,0xb2d36a0ed
1000039.14,4.0,25,4,4,2,10,0xb2d963fbd
25031.42,1.0,16,2,2,2,6,0xb2d92f65d
101821.15,2.0,209,3,3,1,7,0xb2d5a905d
254974.23,31.0,0,3,4,4,11,0x3b9af288d
15148488.68,2.0,3,4,3,4,11,0xb2d23b0fd
200199.91,2.0,4,3,3,4,10,0xb2d6a8e6
220033.83,17.0,2,3,4,4,11,0xb2d65bb5d
70701.89,1.0,35,3,2,2,7,0xb2d37ca3
370019.88,3.0,10,4,4,3,11,0xb2d2cdc9d
5626.88,1.0,18,2,2,2,6,0xb2d6c2dcd
1013.08,1.0,92,1,2,1,4,0xb2d2b2e0d
501038.78,3.0,78,4,4,1,9,0xb2d598c7
10131.98,2.0,4,2,3,4,9,0xb2d5e47e
10010.32,2.0,32,2,3,2,7,0xb2d9fd09
102764.11,2.0,102,3,3,1,7,0xb2d60fe3d
297.33,1.0,33,1,2,2,5,0xb2d61d70d
619022.33,8.0,3,4,4,4,12,0xb2d5e493d
3774.68,1.0,14,2,2,3,7,0xb2d8ca74
158084.11,2.0,0,3,3,4,10,0xb2d598da
505330.7,2.0,116,4,3,1,8,0xb2d788fcd
80011.84,4.0,92,3,4,1,8,0xb2d0e86d
1347953.18,1.0,92,4,2,1,7,0xb2d09d30
441187.1,2.0,101,4,3,1,8,0xb2d117cdd
20165.92,2.0,118,2,3,1,6,0xb2d640a2d
5870.89,1.0,46,2,2,2,6,0xb2d98472
453690.57,2.0,118,4,3,1,8,0xb2d0bf19d
20253.43,1.0,4,2,2,4,8,0x3b9b41a9d
200866.02,2.0,12,3,3,3,9,0xb2d627c6d
290064.34,2.0,0,3,3,4,10,0xb2d97239
107.67,1.0,78,1,2,1,4,0xb2d9709dd
7857.57,1.0,0,2,2,4,8,0xb2d4f57fd
202131.82,2.0,93,3,3,1,7,0xb2d9780cd
300067.89,3.0,11,3,4,3,10,0xb2d1080dd
18728.58,11.0,6,2,4,3,9,0xb2d0e899
1051.18,1.0,23,1,2,2,5,0xb2d1f75c
2732.12,1.0,92,1,2,1,4,0xb2d0d674d
160001.69,1.0,7,3,2,3,8,0xb2d90306
22544.83,1.0,1,2,2,4,8,0xb2d70922d
500000.22,3.0,9,4,4,3,11,0xb2d9ecb8
791012.57,3.0,11,4,4,3,11,0xb2da03d4
216064.74,6.0,70,3,4,1,8,0x3b9b39cd
306710.47,5.0,87,4,4,1,9,0xb2d260d8
700013.65,7.0,42,4,4,2,10,0xb2d4ee00
29739.1,1.0,1,2,2,4,8,0xb2da135f
146142.47,3.0,108,3,4,1,8,0xb2d56d94
30351.47,1.0,92,2,2,1,5,0xb2d22743d
81775.25,1.0,76,3,2,1,6,0xb2d19300
2473.64,1.0,1,1,2,4,7,0xb2d8d0d8
230056.79,2.0,200,3,3,1,7,0xb2d6f6d0
5571.13,1.0,106,2,2,1,5,0xb2d8dcc2d
843190.24,8.0,63,4,4,2,10,0xb2d06d06d
8711.78,1.0,18,2,2,2,6,0xb2d9959a
24.55,1.0,9,1,2,3,6,0xb2d3041d
450073.6,5.0,17,4,4,2,10,0xb2d90d3a
125063.99,2.0,76,3,3,1,7,0xb2d31cadd
82132.59,2.0,0,3,3,4,10,0xb2d07ed1
520010.97,5.0,46,4,4,2,10,0xb2d98c10
170043.72,2.0,129,3,3,1,7,0xb2d63ced
1283.27,1.0,92,1,2,1,4,0xb2d58940d
30349.75,3.0,1,2,4,4,10,0xb2d5ad84d
1163.72,1.0,0,1,2,4,7,0xb2d557c6d
1374829.26,1.0,0,4,2,4,10,0xb2d31e19d
510665.23,2.0,34,4,3,2,9,0xb2d6b049
1022.44,1.0,2,1,2,4,7,0xb2d2bddd
1000000.0,2.0,0,4,3,4,11,0xb2d98014d
801083.47,3.0,1,4,4,4,12,0xb2d9be67
1230545.33,1.0,6,4,2,3,9,0xb2d0afa3d
411554.69,6.0,56,4,4,2,10,0xb2d68296d
65116.37,2.0,0,3,3,4,10,0xb2d08d37d
100004.83,2.0,76,3,3,1,7,0xb2d5d3d5d
150015.32,2.0,18,3,3,2,8,0xb2d58f3d
400000.0,3.0,10,4,4,3,11,0xb2d9322dd
110003.06,2.0,80,3,3,1,7,0xb2d988a9
40067.58,1.0,3,2,2,4,8,0xb2d59731d
50586.41,2.0,122,2,3,1,6,0xb2d63bf9d
6229.55,1.0,17,2,2,2,6,0xb2d9158b
320040.2,4.0,0,4,4,4,12,0xb2d78252
21161.75,1.0,29,2,2,2,6,0xb2d6d306
200000.0,2.0,2,3,3,4,10,0xb2d93691d
50256.59,1.0,184,2,2,1,5,0xb2d55d67d
52580.83,2.0,92,3,3,1,7,0xb2d3e9bcd
20001.16,2.0,69,2,3,1,6,0xb2d8e90d
300002.11,3.0,6,3,4,3,10,0xb2d976f6d
537003.41,9.0,31,4,4,2,10,0xb2d560c2d
592082.8,5.0,11,4,4,3,11,0xb2d326e0
86.33,1.0,35,1,2,2,5,0xb2d37c99d
1.61,1.0,13,1,2,3,6,0xb2d15627d
90123.73,2.0,92,3,3,1,7,0xb2d24fc3d
507.4,1.0,0,1,2,4,7,0xb2d591cc
54005.13,2.0,185,3,3,1,7,0xb2d6264fd
6815.65,1.0,7,2,2,3,7,0xb2d31d99d
5889.04,1.0,6,2,2,3,7,0xb2d25c24d
392512.13,3.0,1,4,4,4,12,0xb2d686f7d
666177.46,4.0,8,4,4,3,11,0xb2d65d3fd
805026.7,4.0,5,4,4,3,11,0xb2d5ab8d
50000.0,2.0,0,2,3,4,9,0xb2d97dc6d
7014.38,1.0,5,2,2,3,7,0xb2d58589
18673.15,1.0,229,2,2,1,5,0xb2d4d48cd
406692.3,5.0,135,4,4,1,9,0xb2d08282d
8805.35,1.0,0,2,2,4,8,0xb2d93ce9
56152.65,2.0,125,3,3,1,7,0xb2d51bbbd
2025.14,1.0,184,1,2,1,4,0xb2d233cc
210953.37,3.0,0,3,4,4,11,0xb2d1fa19d
500006.04,2.0,7,4,3,3,10,0xb2d93046d
6228.42,2.0,0,2,3,4,9,0x3b9b0fb5d
120028.37,3.0,133,3,4,1,8,0xb2d56fe6
53143.55,1.0,1,3,2,4,9,0xb2d282e6
0.0,6.0,1,1,4,4,9,0xb2d1923d
100003.17,2.0,199,3,3,1,7,0xb2d695dbd
1300.29,1.0,28,1,2,2,5,0xb2d6cab9
272374.29,3.0,0,3,4,4,11,0xb2d598b6d
400000.0,3.0,7,4,4,3,11,0xb2d7876cd
21510.79,1.0,110,2,2,1,5,0xb2d58fc4d
306331.38,1.0,4,4,2,4,10,0xb2d129a3d
855.9,1.0,11,1,2,3,6,0xb2d31e90d
22.72,1.0,0,1,2,4,7,0xb2d33070
227699.77,6.0,0,3,4,4,11,0xb2d0686dd
62410.59,3.0,1,3,4,4,11,0xb2d5ae6d
98593.58,3.0,55,3,4,2,9,0xb2d6016d
20292.93,2.0,80,2,3,1,6,0xb2d5bcd5d
214.4,1.0,36,1,2,2,5,0xb2d4f17d
2084095.07,6.0,39,4,4,2,10,0xb2d8f445d
80781.08,2.0,18,3,3,2,8,0xb2d52ed7d
1503665.23,6.0,34,4,4,2,10,0xb2d14825d
40368.91,1.0,1,2,2,4,8,0xb2d2287dd
51547.18,2.0,67,2,3,1,6,0xb2d5798ad
2427.32,1.0,7,1,2,3,6,0xb2d5c884d
500000.0,2.0,10,4,3,3,10,0xb2d96b4f
450693.22,3.0,14,4,4,3,11,0xb2d15f60
30000.95,2.0,38,2,3,2,7,0xb2d6f6acd
703506.62,4.0,18,4,4,2,10,0xb2d14f75d
0.47,1.0,49,1,2,2,5,0xb2d2c298
550073.27,1.0,7,4,2,3,9,0xb2d99922
60001.27,2.0,25,3,3,2,8,0xb2da1213
38135.76,2.0,8,2,3,3,8,0xb2d38cacd
42606.26,2.0,77,2,3,1,6,0x3b9b2f97d
120047.39,2.0,70,3,3,1,7,0xb2d157d5d
1529.9,1.0,7,1,2,3,6,0x3b9acd9b
124037.83,4.0,2,3,4,4,11,0xb2d5b17e
82192.62,1.0,5,3,2,3,8,0xb2d521ced
502463.45,3.0,193,4,4,1,9,0xb2d2c360d
105197.56,2.0,21,3,3,2,8,0xb2d5c62ad
385000.53,15.0,9,4,4,3,11,0xb2d3bd0ed
18406.46,1.0,2,2,2,4,8,0xb2d6af88d
143076.5,5.0,24,3,4,2,9,0xb2d09916d
3253.09,1.0,92,2,2,1,5,0xb2d18abcd
112474.06,1.0,92,3,2,1,6,0xb2d3a32fd
202843.15,2.0,13,3,3,3,9,0xb2d6fa97
18.55,1.0,166,1,2,1,4,0xb2d8cff9d
1770.5,1.0,92,1,2,1,4,0xb2d20b0dd
1367736.04,8.0,27,4,4,2,10,0xb2d5f42ad
135101.54,2.0,10,3,3,3,9,0xb2d07535
100370.11,3.0,16,3,4,2,9,0xb2d58a29d
1086682.29,3.0,101,4,4,1,9,0xb2d257d8d
156987.47,3.0,35,3,4,2,9,0xb2d2bb85
3755.4,1.0,221,2,2,1,5,0xb2d48b95d
170038.01,3.0,97,3,4,1,8,0xb2d58b8cd
37000.0,3.0,4,2,4,4,10,0xb2d06a9bd
1323.2,1.0,12,1,2,3,6,0xb2d6ad9ed
430028.17,5.0,4,4,4,4,12,0xb2d07700d
103083.99,2.0,76,3,3,1,7,0xb2d6925cd
95.69,1.0,6,1,2,3,6,0xb2d26a98d
6896.08,1.0,1,2,2,4,8,0xb2d2fd9b
134.84,1.0,33,1,2,2,5,0xb2d3e8ec
100046.49,3.0,13,3,4,3,10,0xb2d0f218d
529.7,1.0,0,1,2,4,7,0xb2d20f4ad
150334.96,2.0,0,3,3,4,10,0xb2d69ebbd
1320093.8,8.0,6,4,4,3,11,0xb2d681e4d
203391.05,1.0,49,3,2,2,7,0xb2d68d22d
917000.0,9.0,5,4,4,3,11,0xb2d580e7d
371.16,1.0,81,1,2,1,4,0xb2d66927
159.44,2.0,36,1,3,2,6,0xb2d3f198
232069.56,1.0,202,3,2,1,6,0xb2d4ff04d
2080.72,1.0,0,1,2,4,7,0xb2d58e23
42.15,1.0,48,1,2,2,5,0xb2d570ca
216299.08,1.0,0,3,2,4,9,0xb2d2c001
255277.42,3.0,28,3,4,2,9,0xb2d075bad
187251.67,2.0,62,3,3,2,8,0xb2d6bff1d
226830.31,10.0,0,3,4,4,11,0xb2d14606d
40000.84,3.0,0,2,4,4,10,0xb2d944fb
180256.47,2.0,0,3,3,4,10,0xb2d623a6d
688.21,1.0,0,1,2,4,7,0xb2d687b2
45209.6,6.0,109,2,4,1,7,0xb2d09652d
3502154.35,11.0,5,4,4,3,11,0xb2d6207ed
252805.73,3.0,1,3,4,4,11,0xb2d2196dd
42635.2,1.0,184,2,2,1,5,0xb2d41c9ad
691172.6,6.0,31,4,4,2,10,0xb2d41af9
145.02,1.0,39,1,2,2,5,0xb2d20416d
124346.24,1.0,1,3,2,4,9,0xb2d6bdaa
460826.53,3.0,63,4,4,2,10,0xb2d67eb1d
4875.91,1.0,0,2,2,4,8,0xb2d58ea0d
1967099.14,4.0,33,4,4,2,10,0xb2d59702
217451.8,3.0,24,3,4,2,9,0xb2d0d940d
4280.88,1.0,37,2,2,2,6,0xb2d26745
202039.78,3.0,133,3,4,1,8,0xb2d654b7d
2845.27,1.0,1,1,2,4,7,0xb2d5e894d
111005.37,2.0,42,3,3,2,8,0xb2d60277
14004.6,1.0,138,2,2,1,5,0xb2d319d8d
336212.51,6.0,25,4,4,2,10,0xb2d2ad9ad
2087033.75,15.0,0,4,4,4,12,0x3b9b125ad
1089.62,1.0,1,1,2,4,7,0xb2d68ba6d
530952.14,2.0,0,4,3,4,11,0xb2d9b62f
2000217.76,2.0,53,4,3,2,9,0xb2d97d56
59229.5,4.0,3,3,4,4,11,0xb2d08e52d
1021.57,1.0,184,1,2,1,4,0xb2d10d7fd
1491068.73,4.0,38,4,4,2,10,0xb2d103bbd
1783.76,1.0,17,1,2,2,5,0xb2d2baffd
50001.06,2.0,24,2,3,2,7,0xb2d94826d
1085073.73,3.0,1,4,4,4,12,0xb2d4e3d4
55789.22,2.0,9,3,3,3,9,0xb2d5cad2
4431910.57,5.0,0,4,4,4,12,0xb2d1d3cfd
4.3,1.0,29,1,2,2,5,0xb2d6b489d
50151.13,2.0,110,2,3,1,6,0xb2d2ecc2d
323718.73,4.0,0,4,4,4,12,0xb2d21139d
1100.5,1.0,145,1,2,1,4,0xb2d57f99
690899.48,7.0,6,4,4,3,11,0xb2d7911ad
1167.99,1.0,8,1,2,3,6,0xb2d26261d
400064.05,5.0,24,4,4,2,10,0xb2d149c5d
43200.1,1.0,0,2,2,4,8,0xb2d29ec8
87406.72,3.0,35,3,4,2,9,0xb2d5746ad
69392.17,2.0,153,3,3,1,7,0xb2d0ed2bd
338565.91,5.0,104,4,4,1,9,0xb2d1bfded
100084.21,2.0,196,3,3,1,7,0xb2d3616dd
7496.61,1.0,10,2,2,3,7,0xb2d9e286
81010.26,3.0,21,3,4,2,9,0xb2d3bf4a
251422.23,4.0,78,3,4,1,8,0xb2d50564
1731.07,1.0,92,1,2,1,4,0xb2d22528d
7.16,1.0,34,1,2,2,5,0xb2d7f067d
3000795.85,13.0,0,4,4,4,12,0xb2d21a5cd
2497.72,1.0,189,1,2,1,4,0xb2d6d910d
74581.08,1.0,184,3,2,1,6,0xb2d29cb6
160104.55,5.0,63,3,4,2,9,0xb2d8d76fd
3991.0,1.0,15,2,2,3,7,0xb2d6d12c
18000.0,1.0,1,2,2,4,8,0xb2d0eb5b
15779.57,1.0,184,2,2,1,5,0xb2d11bf7d
190554.71,3.0,1,3,4,4,11,0xb2d59e5bd
52.14,1.0,69,1,2,1,4,0xb2d9764b
43029.62,2.0,6,2,3,3,8,0xb2d3e5cb
2023.38,1.0,184,1,2,1,4,0xb2d269b0d
86530.71,1.0,0,3,2,4,9,0xb2d6a888
100145.63,4.0,10,3,4,3,10,0xb2d56fd2d
1825.63,1.0,92,1,2,1,4,0x3b9ad4b7d
225.78,1.0,30,1,2,2,5,0xb2d6cfa3d
30020.55,2.0,256,2,3,1,6,0xb2d141d5d
20001.19,2.0,0,2,3,4,9,0xb2d697c7
6880.41,1.0,113,2,2,1,5,0xb2d4fe84
1334733.45,2.0,80,4,3,1,8,0xb2d22f4ad
39690.89,1.0,0,2,2,4,8,0xb2d43c0cd
541.03,1.0,0,1,2,4,7,0xb2d96b4e
0.56,3.0,60,1,4,2,7,0xb2d23bf7
50000.0,2.0,95,2,3,1,6,0xb2d7f230
6170.29,1.0,0,2,2,4,8,0xb2d76a56d
70051.16,2.0,47,3,3,2,8,0xb2d6d874
2635.4,1.0,2,1,2,4,7,0xb2d6ed90
313248.8,10.0,0,4,4,4,12,0xb2d14398
925.32,1.0,66,1,2,2,5,0xb2d5d969
39.57,1.0,5,1,2,3,6,0xb2d3ee92
52300.27,2.0,5,3,3,3,9,0xb2d3ad8b
140.0,1.0,4,1,2,4,7,0xb2d9c326
120001.27,2.0,18,3,3,2,8,0xb2d956a2
194040.14,3.0,132,3,4,1,8,0xb2d1e86ad
1161.27,1.0,92,1,2,1,4,0xb2d0ab1ad
475096.93,3.0,28,4,4,2,10,0xb2d236f6d
324309.76,2.0,122,4,3,1,8,0xb2d20fffd
831.79,1.0,52,1,2,2,5,0xb2d47d23
21635.28,1.0,0,2,2,4,8,0xb2d86e4cd
2139.13,1.0,17,1,2,2,5,0xb2d3b793
263153.88,3.0,9,3,4,3,10,0xb2d426f1
2000042.73,3.0,92,4,4,1,9,0xb2d3a8e6d
8844.8,1.0,6,2,2,3,7,0xb2d69245
58956.82,1.0,9,3,2,3,8,0xb2d2d140
1136.45,1.0,18,1,2,2,5,0xb2d3b286
233426.44,4.0,10,3,4,3,10,0xb2d67d6cd
203414.09,3.0,1,3,4,4,11,0xb2d13a35
14.02,1.0,13,1,2,3,6,0xb2d64338d
549.68,2.0,3,1,3,4,8,0xb2d6a3f2
668.52,1.0,11,1,2,3,6,0xb2d4ffac
289411.89,3.0,0,3,4,4,11,0xb2d1761ad
381011.64,8.0,1,4,4,4,12,0xb2d1bb54
26689.0,1.0,18,2,2,2,6,0xb2d5d760d
1368.82,1.0,1,1,2,4,7,0xb2d7d47dd
505602.09,2.0,28,4,3,2,9,0xb2d92ebdd
21782.31,1.0,1,2,2,4,8,0xb2d6ddd6
858328.14,5.0,60,4,4,2,10,0xb2d8d03ad
312120.6,6.0,59,4,4,2,10,0xb2d35f54d
1059.25,1.0,92,1,2,1,4,0xb2d45cced
2022782.02,6.0,75,4,4,1,9,0xb2d1a891d
4006.77,1.0,118,2,2,1,5,0xb2d6beb4d
100290.52,2.0,104,3,3,1,7,0xb2d50259d
300006.39,2.0,24,3,3,2,8,0xb2d9463b
911166.39,4.0,0,4,4,4,12,0xb2d68462d
742029.76,5.0,9,4,4,3,11,0xb2d1cf67
19351.17,2.0,92,2,3,1,6,0x3b9b1720
180029.96,3.0,101,3,4,1,8,0xb2d67ee4
245004.5,4.0,93,3,4,1,8,0xb2d69a62d
500000.0,2.0,11,4,3,3,10,0xb2d94a52d
1419080.44,4.0,34,4,4,2,10,0xb2d56fead
251059.72,8.0,25,3,4,2,9,0xb2d64ce4d
8212.01,1.0,0,2,2,4,8,0xb2d8f539d
98.85,1.0,41,1,2,2,5,0xb2d50b60
528765.64,4.0,1,4,4,4,12,0xb2d6b281
152008.38,5.0,77,3,4,1,8,0xb2d0ab76
10101.68,1.0,92,2,2,1,5,0xb2d2e253
205455.15,2.0,87,3,3,1,7,0xb2d2a311d
50000.09,2.0,3,2,3,4,9,0xb2d969a4d
1002837.59,4.0,5,4,4,3,11,0xb2d5c71dd
7.42,1.0,19,1,2,2,5,0xb2d258f7
10000.21,2.0,193,2,3,1,6,0xb2d644dfd
900500.86,5.0,7,4,4,3,11,0xb2d69d7b
130090.25,3.0,60,3,4,2,9,0xb2d7ec14d
1013.29,1.0,184,1,2,1,4,0xb2d3f78bd
7643.77,1.0,184,2,2,1,5,0x3b9b3462
4002.72,1.0,92,2,2,1,5,0xb2d2a747d
277776.65,2.0,1,3,3,4,10,0xb2d54b46d
101713.48,2.0,249,3,3,1,7,0xb2d60e68d
1019.72,1.0,184,1,2,1,4,0xb2d1421bd
90004.43,2.0,0,3,3,4,10,0xb2da478f
2462.56,1.0,0,1,2,4,7,0xb2d9c72b
1450865.8,5.0,21,4,4,2,10,0xb2d226e2d
12390.08,1.0,8,2,2,3,7,0xb2d30e40
50001.26,3.0,116,2,4,1,7,0xb2d8ecb2d
10000.0,7.0,21,2,4,2,8,0xb2d1a090d
2843.65,1.0,9,1,2,3,6,0xb2d60f4c
29.9,5.0,16,1,4,2,7,0xb2d07dba
19253.65,1.0,69,2,2,1,5,0xb2d2cee5d
2672.5,1.0,30,1,2,2,5,0xb2d40d13
3.21,1.0,49,1,2,2,5,0xb2d6d8a1
10.74,1.0,21,1,2,2,5,0xb2d6848f
19.95,1.0,74,1,2,1,4,0xb2d5b339d
300114.91,3.0,8,4,4,3,11,0xb2d9fb48
12762.65,2.0,66,2,3,2,7,0xb2d4e560d
37037.46,1.0,49,2,2,2,6,0xb2d37c8dd
14007.93,1.0,16,2,2,2,6,0xb2d95d41
4183.17,1.0,53,2,2,2,6,0xb2d22125d
1118030.5,31.0,1,4,4,4,12,0xb2d5ae40d
38.14,1.0,5,1,2,3,6,0xb2d2c5ad
100005.28,2.0,40,3,3,2,8,0xb2d91eb7d
2275814.03,3.0,136,4,4,1,9,0xb2d3e131d
111409.11,5.0,39,3,4,2,9,0xb2d63c73d
3888.0,1.0,43,2,2,2,6,0xb2d696c6d
114551.32,2.0,0,3,3,4,10,0xb2d58720
500015.87,2.0,92,4,3,1,8,0xb2d27731
57269.05,1.0,35,3,2,2,7,0xb2d435c5
100895.74,2.0,4,3,3,4,10,0xb2d950d8d
2099.9,1.0,0,1,2,4,7,0xb2d09c13
603121.34,2.0,8,4,3,3,10,0xb2d239a9d
153009.26,2.0,69,3,3,1,7,0xb2d3a653d
5113.09,1.0,10,2,2,3,7,0xb2d43db8d
628033.52,4.0,32,4,4,2,10,0xb2d2d5dbd
61392.93,2.0,41,3,3,2,8,0xb2d6015a
37729.06,4.0,11,2,4,3,9,0xb2d6675ed
450516.67,4.0,101,4,4,1,9,0xb2d3e99bd
362773.09,3.0,70,4,4,1,9,0xb2d9394c
1913.01,1.0,92,1,2,1,4,0xb2d08cc6d
59.38,1.0,9,1,2,3,6,0xb2d3f319
66552.38,1.0,7,3,2,3,8,0xb2d68942d
690099.76,5.0,98,4,4,1,9,0xb2d57301d
2674.03,1.0,9,1,2,3,6,0xb2d32370d
100013.3,2.0,112,3,3,1,7,0xb2d13820
0.0,1.0,4,1,2,4,7,0xb2d8cae1
968577.9,4.0,1,4,4,4,12,0xb2d2276dd
110071.34,2.0,87,3,3,1,7,0xb2d1c67ad
687499.21,5.0,24,4,4,2,10,0xb2d355efd
55266.94,1.0,230,3,2,1,6,0xb2d317a3
100151.53,2.0,28,3,3,2,8,0xb2d45181
8014.85,1.0,92,2,2,1,5,0xb2d0ad2cd
6.86,1.0,130,1,2,1,4,0xb2d14adbd
28507.26,1.0,1,2,2,4,8,0xb2d2b7bfd
606137.35,4.0,102,4,4,1,9,0xb2d52d96d
39675.13,1.0,3,2,2,4,8,0xb2d229d1d
222000.0,15.0,3,3,4,4,11,0xb2d297abd
1426.76,1.0,213,1,2,1,4,0xb2d46812d
4.11,1.0,58,1,2,2,5,0xb2d67fa7
500000.0,4.0,8,4,4,3,11,0xb2d0e35a
530000.0,49.0,4,4,4,4,12,0xb2d164c5
1085966.4,16.0,0,4,4,4,12,0x3b9af1fcd
1.27,1.0,39,1,2,2,5,0xb2d92517d
10497.42,1.0,214,2,2,1,5,0xb2d37016d
2175.23,1.0,20,1,2,2,5,0xb2d2c3b2d
359076.87,3.0,76,4,4,1,9,0xb2d28b85d
10019.38,2.0,6,2,3,3,8,0xb2da352d
150082.57,2.0,129,3,3,1,7,0xb2d39fa6
1560517.91,6.0,11,4,4,3,11,0x3b9b32a2d
7.93,1.0,19,1,2,2,5,0xb2d1d73e
74010.64,12.0,0,3,4,4,11,0x3b9b264dd
18449.51,1.0,19,2,2,2,6,0xb2d606ebd
11487.75,1.0,216,2,2,1,5,0xb2d27816d
1252110.9,4.0,70,4,4,1,9,0xb2d27b0dd
4334707.7,16.0,0,4,4,4,12,0xb2d1228b
255498.49,3.0,66,3,4,2,9,0xb2d59198d
1.04,23.0,4,1,4,4,9,0xb2d0cb89
1406.82,1.0,184,1,2,1,4,0xb2d3331ad
72117.48,4.0,5,3,4,3,10,0xb2d5fa71
130306.86,2.0,0,3,3,4,10,0xb2d115c5d
40687.21,1.0,1,2,2,4,8,0xb2d25fb8d
2090.34,1.0,9,1,2,3,6,0xb2d990c0
192.31,1.0,8,1,2,3,6,0xb2d8cb67
1353.63,1.0,3,1,2,4,7,0xb2d295fb
300313.43,3.0,12,4,4,3,11,0xb2d39497d
61302.26,1.0,0,3,2,4,9,0xb2d3a621d
600031.66,2.0,1,4,3,4,11,0xb2d6dfa4
70369.77,3.0,4,3,4,4,11,0xb2d52c87d
400013.81,3.0,20,4,4,2,10,0xb2d1b483d
100003.17,2.0,235,3,3,1,7,0xb2d6e654
1674.59,1.0,92,1,2,1,4,0xb2d36c89d
551068.27,3.0,32,4,4,2,10,0xb2d85881
150044.17,4.0,147,3,4,1,8,0xb2d239cf
766563.52,3.0,8,4,4,3,11,0xb2d1ea2ad
41.82,1.0,43,1,2,2,5,0xb2d1c47b
60305.24,2.0,0,3,3,4,10,0xb2d1d073
251352.71,2.0,15,3,3,3,9,0xb2d7658d
205059.41,8.0,0,3,4,4,11,0x3b9af112d
8811.0,1.0,1,2,2,4,8,0xb2d0841fd
1215.62,1.0,92,1,2,1,4,0xb2d3178ed
64003.74,3.0,47,3,4,2,9,0xb2d59811d
476320.17,3.0,34,4,4,2,10,0xb2d1e8cc
11776.35,1.0,6,2,2,3,7,0xb2d22cead
1544.48,1.0,160,1,2,1,4,0xb2d5614bd
2771.45,2.0,2,1,3,4,8,0xb2d0912b
420245.06,8.0,11,4,4,3,11,0xb2d0f9f0d
60.02,1.0,40,1,2,2,5,0xb2d13a48d
500001.1,3.0,1,4,4,4,12,0xb2d8ef8a
118.81,1.0,32,1,2,2,5,0xb2d3fd05d
47.19,1.0,4,1,2,4,7,0xb2d699c9d
612289.03,6.0,1,4,4,4,12,0xb2d23f20d
2407.25,1.0,18,1,2,2,5,0xb2d2a243d
151688.56,2.0,20,3,3,2,8,0xb2d346c3d
3728250.43,3.0,19,4,4,2,10,0xb2d38d64
3945416.63,12.0,1,4,4,4,12,0xb2d647a3d
30091.08,1.0,92,2,2,1,5,0xb2d55a81d
670693.09,8.0,1,4,4,4,12,0xb2d43d77d
185769.14,2.0,116,3,3,1,7,0xb2d1a4aed
432044.59,5.0,92,4,4,1,9,0xb2d36b39d
461200.79,2.0,17,4,3,2,9,0xb2d65c50d
3662.03,1.0,7,2,2,3,7,0xb2d2d9dad
501776.28,2.0,24,4,3,2,9,0xb2d9d2af
741487.41,7.0,21,4,4,2,10,0x3b9b4439d
15445.55,1.0,0,2,2,4,8,0xb2d230a5d
37514.59,16.0,4,2,4,4,10,0xb2d3a094d
642.0,1.0,0,1,2,4,7,0xb2d6b5ab
240088.72,6.0,92,3,4,1,8,0xb2d39a4ed
146.56,1.0,15,1,2,3,6,0xb2d95f0bd
535055.48,1.0,1,4,2,4,10,0xb2d5cfd1d
45389747.03,3.0,1,4,4,4,12,0xb2d32925
60775.9,2.0,4,3,3,4,10,0xb2d9418cd
1083.38,2.0,0,1,3,4,8,0x3b9b1849d
470000.0,11.0,0,4,4,4,12,0xb2d5f78d
305655.68,3.0,39,4,4,2,10,0xb2d10060d
50001.58,2.0,95,2,3,1,6,0xb2d973ea
250009.94,2.0,108,3,3,1,7,0xb2d56edad
203477.55,2.0,0,3,3,4,10,0xb2d60460d
1212.65,1.0,5,1,2,3,6,0xb2d2ebbf
700000.0,2.0,5,4,3,3,10,0xb2da5cc6
150003.17,2.0,80,3,3,1,7,0xb2d8d417d
5.85,1.0,80,1,2,1,4,0xb2d6163dd
17.85,1.0,8,1,2,3,6,0xb2d5b9d6
445228.57,17.0,3,4,4,4,12,0xb2d57ed8d
16000055.19,3.0,0,4,4,4,12,0xb2d36546
17.98,1.0,12,1,2,3,6,0xb2d48c66d
13121.59,1.0,92,2,2,1,5,0xb2d22b63d
30731.6,3.0,102,2,4,1,7,0xb2d0c1e3d
201424.17,2.0,61,3,3,2,8,0xb2d8f761d
600006.33,2.0,20,4,3,2,9,0xb2d95180
438.0,1.0,2,1,2,4,7,0xb2d3403f
560003.48,4.0,1,4,4,4,12,0xb2d99a4b
410019.4,8.0,6,4,4,3,11,0xb2d2ae17d
3781.73,1.0,24,2,2,2,6,0xb2d0ecf5d
2196.39,1.0,11,1,2,3,6,0xb2d21cac
45000.07,1.0,0,2,2,4,8,0xb2d3c9ebd
115143.08,2.0,2,3,3,4,10,0xb2d4d1f0
8650.54,1.0,29,2,2,2,6,0xb2d91bff
71.18,1.0,39,1,2,2,5,0xb2d2e0a5
481.47,1.0,9,1,2,3,6,0xb2d6bfbfd
30000.32,2.0,42,2,3,2,7,0xb2d9e7a5
150095.92,3.0,39,3,4,2,9,0xb2d389bed
10000.42,2.0,235,2,3,1,6,0xb2d6e3d5
0.02,1.0,19,1,2,2,5,0xb2d9070bd
836.29,1.0,0,1,2,4,7,0xb2d68f0bd
922946.8,3.0,1,4,4,4,12,0xb2d16f93d
2412.13,1.0,11,1,2,3,6,0xb2d6cf21
121156.58,5.0,74,3,4,1,8,0xb2d5e588d
2962.5,1.0,184,2,2,1,5,0x3b9b402c
10021.85,1.0,2,2,2,4,8,0xb2d93a3b
220016.93,6.0,0,3,4,4,11,0xb2d1526bd
177007.65,2.0,200,3,3,1,7,0xb2d08b76
50002.24,2.0,60,2,3,2,7,0xb2d8a581d
436083.05,3.0,81,4,4,1,9,0xb2d43aa4d
1010.56,5.0,92,1,4,1,6,0xb2d2de72d
710.03,1.0,8,1,2,3,6,0xb2d2dd8ed
30192.69,1.0,1,2,2,4,8,0xb2d6cc1d
204617.29,2.0,186,3,3,1,7,0xb2d67041d
100003.56,1.0,0,3,2,4,9,0xb2d2f15bd
10000.98,2.0,34,2,3,2,7,0xb2d9ed45
39994.79,1.0,0,2,2,4,8,0xb2d1a431d
228272.45,9.0,0,3,4,4,11,0xb2d06831d
1721.53,1.0,188,1,2,1,4,0xb2d2d15bd
0.5,1.0,24,1,2,2,5,0xb2d7ee30
280931.4,2.0,0,3,3,4,10,0xb2d15fb8d
240013.91,5.0,18,3,4,2,9,0xb2d07b15
500099.14,4.0,27,4,4,2,10,0xb2d0b01bd
30976.75,1.0,0,2,2,4,8,0xb2d0c410d
3913.75,1.0,8,2,2,3,7,0xb2d6520fd
11828.17,1.0,184,2,2,1,5,0xb2d38762d
92.3,1.0,2,1,2,4,7,0xb2d5d04c
1661.02,1.0,33,1,2,2,5,0xb2d483a8d
174594.76,4.0,95,3,4,1,8,0xb2d14985
31078.63,1.0,0,2,2,4,8,0xb2d4fc93d
82661.87,2.0,249,3,3,1,7,0xb2d3ba7cd
89442.3,3.0,0,3,4,4,11,0xb2d5a602d
270026.69,2.0,95,3,3,1,7,0xb2d259b2
300000.9,2.0,5,3,3,3,9,0xb2d5cdf4
350096.07,5.0,10,4,4,3,11,0xb2d14902
807190.94,10.0,0,4,4,4,12,0xb2d1aee0d
10073.39,1.0,112,2,2,1,5,0xb2d3c0c0d
75700.75,1.0,3,3,2,4,9,0xb2d4c9d5
601422.76,4.0,28,4,4,2,10,0xb2d6a18a
460014.57,2.0,80,4,3,1,8,0xb2d98b19
310.9,1.0,129,1,2,1,4,0xb2d4dd4ad
7930.42,7.0,0,2,4,4,10,0x3b9b29b7d
1362.39,1.0,15,1,2,3,6,0xb2d3109a
4405.59,1.0,0,2,2,4,8,0xb2d41dc6
49606.5,1.0,225,2,2,1,5,0xb2d3616ed
101743.71,3.0,0,3,4,4,11,0xb2d23ffc
7.51,1.0,46,1,2,2,5,0xb2d271ad
254443.13,2.0,13,3,3,3,9,0xb2d6cd1d
50474.29,1.0,92,2,2,1,5,0xb2d3eb6ad
413354.05,3.0,6,4,4,3,11,0xb2d4ee38d
409955.85,3.0,218,4,4,1,9,0x3b9b3646d
1441.09,2.0,0,1,3,4,8,0xb2d4d037
10037.72,1.0,0,2,2,4,8,0xb2da011d
1216.28,1.0,92,1,2,1,4,0xb2d189bc
50010.95,2.0,63,2,3,2,7,0xb2d55601d
1550.37,1.0,69,1,2,1,4,0xb2d2c463d
18197.71,1.0,260,2,2,1,5,0xb2d2e75fd
497255.88,1.0,6,4,2,3,9,0xb2d270e2
70000.74,2.0,49,3,3,2,8,0xb2d9d75f
1846321.96,2.0,0,4,3,4,11,0xb2d2d724d
925942.08,6.0,13,4,4,3,11,0xb2d63a4bd
934.22,2.0,1,1,3,4,8,0xb2d58757
201421.25,2.0,22,3,3,2,8,0xb2d8d18bd
202969.29,3.0,3,3,4,4,11,0x3b9b2b2fd
10095.96,1.0,0,2,2,4,8,0xb2d43bffd
53113.64,2.0,0,3,3,4,10,0xb2d45eed
1481.58,1.0,7,1,2,3,6,0xb2d2f926
6021.54,1.0,0,2,2,4,8,0xb2d5f69d
551955.3,2.0,29,4,3,2,9,0xb2d8ff5cd
10000.11,2.0,7,2,3,3,8,0xb2da4a25
0.0,1.0,184,1,2,1,4,0xb2d576aed
99.15,1.0,20,1,2,2,5,0xb2d9313bd
100.23,1.0,48,1,2,2,5,0xb2d6c66a
1066.28,1.0,3,1,2,4,7,0xb2d62aadd
10000.32,2.0,60,2,3,2,7,0xb2d9bae9
234905.87,2.0,194,3,3,1,7,0xb2d81e2dd
275.04,6.0,18,1,4,2,7,0x3b9b486a
55622.43,4.0,4,3,4,4,11,0xb2d23248d
150158.64,1.0,1,3,2,4,9,0xb2d6fad0
10.66,1.0,11,1,2,3,6,0xb2d6058bd
50001.58,2.0,11,2,3,3,8,0xb2da3d13
1583.85,1.0,0,1,2,4,7,0xb2d67db8
7260.18,1.0,55,2,2,2,6,0xb2d390e7d
400000.0,2.0,20,4,3,2,9,0xb2da2aed
76.0,1.0,12,1,2,3,6,0xb2d2bd93d
541637.7,2.0,1,4,3,4,11,0xb2d89f13d
1632.06,1.0,1,1,2,4,7,0xb2d3ce44
1684.75,1.0,11,1,2,3,6,0xb2d3a3b3d
25670.67,1.0,66,2,2,2,6,0xb2d526f3d
873.92,1.0,40,1,2,2,5,0xb2d1624c
414.75,2.0,59,1,3,2,6,0x3b9b4909d
3390.59,1.0,24,2,2,2,6,0xb2d1cdc8d
104334.69,2.0,41,3,3,2,8,0xb2d369c4d
250009.8,3.0,13,3,4,3,10,0xb2d56d9f
120001.27,2.0,76,3,3,1,7,0xb2d8d86bd
150003.17,2.0,38,3,3,2,8,0xb2d92811
25974.23,1.0,0,2,2,4,8,0xb2d9598e
50125.75,2.0,121,2,3,1,6,0xb2d1b7f3
111008.49,2.0,0,3,3,4,10,0xb2d6b28c
21.27,1.0,0,1,2,4,7,0xb2d6e611d
112438.77,2.0,27,3,3,2,8,0xb2d59eebd
217.53,1.0,0,1,2,4,7,0xb2d24ac6d
4642.8,1.0,10,2,2,3,7,0xb2d58c28d
510369.13,3.0,10,4,4,3,11,0xb2d5e06bd
320794.69,4.0,2,4,4,4,12,0xb2d3539b
30878.4,1.0,0,2,2,4,8,0xb2d2c08e
380922.89,6.0,14,4,4,3,11,0xb2d78252d
100045.63,1.0,5,3,2,3,8,0xb2d2aceb
54436.12,1.0,0,3,2,4,9,0xb2d34921d
5389.03,1.0,184,2,2,1,5,0xb2d59d30
307011.37,5.0,18,4,4,2,10,0xb2d2d9e9
50098.57,2.0,49,2,3,2,7,0xb2d9d83e
6679.24,1.0,184,2,2,1,5,0xb2d1e9f5d
14999.82,1.0,10,2,2,3,7,0xb2d39913
4792.3,2.0,23,2,3,2,7,0xb2d177c7
140002.81,2.0,7,3,3,3,9,0xb2d95f59
403.98,1.0,1,1,2,4,7,0xb2d5ec32d
23203.81,1.0,21,2,2,2,6,0xb2d5f8c6d
2399.43,1.0,11,1,2,3,6,0xb2d41121
57.53,1.0,43,1,2,2,5,0xb2d68530d
64890.3,2.0,10,3,3,3,9,0xb2d9630c
16209.78,1.0,18,2,2,2,6,0xb2d41199
8033.36,1.0,23,2,2,2,6,0xb2d9ddb4
897580.68,6.0,0,4,4,4,12,0xb2d2224f
800061.6,4.0,181,4,4,1,9,0xb2d2c322d
209538.45,2.0,35,3,3,2,8,0xb2d08f5a
12398.09,1.0,92,2,2,1,5,0xb2d4c1e8d
1.31,1.0,69,1,2,1,4,0xb2d6440bd
100.13,1.0,30,1,2,2,5,0xb2d21b83
103861.61,1.0,19,3,2,2,7,0xb2d1539ed
230002.43,3.0,18,3,4,2,9,0xb2d952b0d
5622.55,1.0,5,2,2,3,7,0xb2d37178
104932.75,1.0,92,3,2,1,6,0xb2d2298ad
100084.41,2.0,0,3,3,4,10,0xb2d3cbe5
305000.15,2.0,22,4,3,2,9,0xb2d9b086
361117.13,8.0,0,4,4,4,12,0x3b9b0fd7
20859.91,1.0,92,2,2,1,5,0xb2d241c8
218844.49,1.0,1,3,2,4,9,0xb2d1fa09
300021.37,3.0,21,3,4,2,9,0xb2d6034f
518.54,1.0,57,1,2,2,5,0xb2d97748d
130913.96,2.0,3,3,3,4,10,0xb2d56acfd
466659.58,2.0,62,4,3,2,9,0xb2d5b84fd
3806.49,3.0,182,2,4,1,7,0xb2d0fbb0d
37350.96,2.0,14,2,3,3,8,0xb2d09077d
20000.42,2.0,213,2,3,1,6,0xb2d685dfd
508886.08,2.0,135,4,3,1,8,0xb2d8e33f
152003.6,8.0,47,3,4,2,9,0xb2d61ca9d
3.17,1.0,89,1,2,1,4,0xb2d88b4d
450000.0,1.0,0,4,2,4,10,0xb2da6b74
46189.17,1.0,8,2,2,3,7,0xb2d91847
6455.55,1.0,201,2,2,1,5,0xb2d35e7fd
61761.01,2.0,0,3,3,4,10,0xb2d53027
1844.44,1.0,1,1,2,4,7,0xb2d419dbd
1451.5,1.0,5,1,2,3,6,0xb2d64d0dd
362196.74,2.0,4,4,3,4,11,0xb2d6e63f
717386.72,2.0,14,4,3,3,10,0xb2d23b0e
300178.76,2.0,99,4,3,1,8,0xb2d41dfdd
3481.19,1.0,1,2,2,4,8,0xb2d8d387
200005.07,3.0,151,3,4,1,8,0xb2d8350bd
95.46,2.0,5,1,3,3,7,0xb2d1b22bd
312.92,1.0,8,1,2,3,6,0xb2d96594
30025.91,1.0,6,2,2,3,7,0xb2d2c42fd
100000.0,2.0,7,3,3,3,9,0xb2d54cc3d
20230.01,2.0,25,2,3,2,7,0xb2d92e74d
0.11,1.0,20,1,2,2,5,0xb2d5c746
457054.14,1.0,92,4,2,1,7,0xb2d0e9bcd
3500.42,1.0,1,2,2,4,8,0xb2d364f2
3246.65,1.0,92,2,2,1,5,0xb2d47380d
292.48,1.0,0,1,2,4,7,0xb2d94943
9568.71,1.0,15,2,2,3,7,0xb2d6b9fed
1513811.05,4.0,17,4,4,2,10,0xb2d157d3d
500037.12,2.0,14,4,3,3,10,0xb2d645ad
632259.9,3.0,22,4,4,2,10,0xb2d364d7d
424539.99,3.0,18,4,4,2,10,0xb2d7c014d
264449.73,5.0,19,3,4,2,9,0x3b9ad43cd
136111.71,2.0,18,3,3,2,8,0xb2d1f494
370305.8,4.0,69,4,4,1,9,0xb2d574d9
960.23,1.0,9,1,2,3,6,0xb2d6acd3
9611.11,1.0,39,2,2,2,6,0xb2d32d5ed
30000.0,17.0,0,2,4,4,10,0xb2d201cb
3.29,1.0,84,1,2,1,4,0xb2d68221d
0.0,1.0,8,1,2,3,6,0xb2da3c15
280000.07,6.0,3,3,4,4,11,0xb2d5badfd
812137.04,5.0,48,4,4,2,10,0xb2d41322d
5409.81,1.0,0,2,2,4,8,0xb2d25496
1065.54,1.0,112,1,2,1,4,0xb2d4ba92d
4148.24,1.0,12,2,2,3,7,0xb2d17896d
603072.62,3.0,139,4,4,1,9,0xb2d18834
628810.49,6.0,33,4,4,2,10,0xb2d0893fd
85801.43,1.0,42,3,2,2,7,0xb2d43005
37810.81,1.0,0,2,2,4,8,0xb2d5302ad
221650.91,4.0,22,3,4,2,9,0xb2d76440d
60000.0,1.0,0,3,2,4,9,0xb2d58daf
260228.37,3.0,8,3,4,3,10,0xb2d23f29
7092.96,1.0,184,2,2,1,5,0xb2d1ba80d
88572.11,1.0,4,3,2,4,9,0xb2d7b024d
336191.44,2.0,26,4,3,2,9,0xb2d76431
305676.49,2.0,82,4,3,1,8,0xb2d298edd
10345.68,1.0,46,2,2,2,6,0xb2d68eead
636318.68,8.0,0,4,4,4,12,0xb2d3132a
4584.93,1.0,92,2,2,1,5,0xb2d26f0bd
1023784.34,1.0,0,4,2,4,10,0xb2d34cfc
13523.41,1.0,11,2,2,3,7,0xb2d5e0add
663302.8,6.0,136,4,4,1,9,0xb2d3ee8fd
309670.21,3.0,92,4,4,1,9,0x3b9b25de
50008.66,2.0,6,2,3,3,8,0xb2d8c5e3d
10001.91,2.0,55,2,3,2,7,0xb2d59609
700712.13,4.0,6,4,4,3,11,0xb2d1c7f7d
200002.11,3.0,53,3,4,2,9,0xb2d5e9fc
6597.88,1.0,2,2,2,4,8,0xb2d83616
82.85,1.0,20,1,2,2,5,0xb2d2b2d9
20000.63,2.0,92,2,3,1,6,0xb2d64109
50041.89,2.0,1,2,3,4,9,0xb2d69c7cd
86103.35,1.0,1,3,2,4,9,0xb2d3789c
95.37,1.0,0,1,2,4,7,0xb2d68ad2d
53.91,1.0,22,1,2,2,5,0xb2d6e9c3
90084.31,7.0,31,3,4,2,9,0xb2d57c19
2084271.3,6.0,0,4,4,4,12,0xb2d5ae6e
12590.42,2.0,11,2,3,3,8,0xb2d0be87
323460.73,4.0,5,4,4,3,11,0xb2d0d8ecd
14282.45,1.0,15,2,2,3,7,0xb2d6a069
0.0,48.0,7,1,4,3,8,0xb2d1f6d3d
10005.7,2.0,60,2,3,2,7,0xb2d6049ed
161833.75,2.0,52,3,3,2,8,0xb2d1cc8bd
402365.1,3.0,59,4,4,2,10,0xb2d423cad
5856.59,1.0,9,2,2,3,7,0xb2d3c365d
250014.11,2.0,179,3,3,1,7,0xb2d0ae0fd
9222.38,1.0,10,2,2,3,7,0xb2d990a5
573868.98,16.0,8,4,4,3,11,0x3b9b291e
329595.76,7.0,11,4,4,3,11,0xb2d37504d
500027.32,3.0,56,4,4,2,10,0xb2d39c1cd
10091.56,1.0,184,2,2,1,5,0xb2d32fddd
30576.87,3.0,111,2,4,1,7,0xb2d0a389d
150190.41,2.0,119,3,3,1,7,0xb2d44351
518000.0,9.0,4,4,4,4,12,0xb2d3c5ed
16750.14,1.0,21,2,2,2,6,0xb2da086b
255567.3,5.0,8,3,4,3,10,0xb2d4d4d4d
2734.45,1.0,9,1,2,3,6,0xb2d6f51dd
138168.71,1.0,92,3,2,1,6,0xb2d0ec34d
3101.69,1.0,16,2,2,2,6,0xb2d93338
5200.09,1.0,9,2,2,3,7,0xb2d9051bd
200025.61,2.0,0,3,3,4,10,0xb2d6815cd
23296.43,1.0,11,2,2,3,7,0xb2d319ced
410062.17,6.0,3,4,4,4,12,0xb2d0df06
309.65,1.0,18,1,2,2,5,0xb2d3239d
10028.41,1.0,2,2,2,4,8,0xb2d64abfd
606033.41,4.0,24,4,4,2,10,0xb2d138d3
161991.94,1.0,15,3,2,3,8,0xb2d360bfd
120091.0,2.0,97,3,3,1,7,0xb2d1c8bdd
50830.66,3.0,4,2,4,4,10,0xb2d623d1d
582682.97,4.0,1,4,4,4,12,0xb2d1e30dd
10070.69,1.0,61,2,2,2,6,0xb2d4383f
800218.75,6.0,11,4,4,3,11,0xb2d179cd
62201.7,2.0,62,3,3,2,8,0xb2d15cbad
50003.52,2.0,76,2,3,1,6,0xb2d58b2f
1719.77,2.0,14,1,3,3,7,0xb2d36abe
374.22,1.0,82,1,2,1,4,0xb2d2820bd
1575.18,1.0,92,1,2,1,4,0xb2d1f8bad
1219507.43,3.0,12,4,4,3,11,0xb2d6cc2a
916081.41,1.0,0,4,2,4,10,0xb2d42b00
113360.84,1.0,3,3,2,4,9,0xb2d17f9dd
20588.98,2.0,56,2,3,2,7,0xb2d15e8dd
323132.44,3.0,0,4,4,4,12,0xb2d6c02cd
9.5,1.0,25,1,2,2,5,0xb2d3e940
230087.21,5.0,10,3,4,3,10,0xb2d5823cd
445.98,1.0,23,1,2,2,5,0xb2d290a0d
154.69,2.0,6,1,3,3,7,0xb2d0a760
7.8,1.0,75,1,2,1,4,0xb2d977ee
3.57,1.0,5,1,2,3,6,0xb2d6222e
50016.57,2.0,48,2,3,2,7,0xb2d9db46
255516.61,3.0,186,3,4,1,8,0x3b9b38b1
200024.06,4.0,67,3,4,1,8,0xb2d1598e
400004.22,2.0,45,4,3,2,9,0xb2d91d5fd
10.7,1.0,6,1,2,3,6,0xb2d26dc9
500656.31,2.0,13,4,3,3,10,0xb2d5b181
2545.7,1.0,84,1,2,1,4,0xb2d5fe44d
200000.0,2.0,10,3,3,3,9,0xb2da4e7f
180003.8,3.0,14,3,4,3,10,0xb2da0c82
216532.14,4.0,47,3,4,2,9,0xb2d3a576d
81023.11,2.0,186,3,3,1,7,0xb2d10aeed
60386.77,2.0,75,3,3,1,7,0xb2d63b53d
30.78,1.0,35,1,2,2,5,0xb2d13c3a
15.04,1.0,2,1,2,4,7,0xb2d22badd
8930.93,1.0,92,2,2,1,5,0x3b9b482ad
200000.21,2.0,19,3,3,2,8,0xb2d95388d
22714.13,2.0,5,2,3,3,8,0xb2d78c5d
200037.52,2.0,0,3,3,4,10,0xb2da1f66
502015.95,2.0,11,4,3,3,10,0xb2d6caab
2057.32,1.0,2,1,2,4,7,0xb2d6b53ad
450014.16,4.0,3,4,4,4,12,0xb2d1a2aa
718.24,3.0,0,1,4,4,9,0x3b9b46f5d
1708.47,1.0,9,1,2,3,6,0xb2d6af12d
73926.99,2.0,175,3,3,1,7,0xb2d24696d
50049.5,1.0,2,2,2,4,8,0xb2d3bb36
320240.62,2.0,34,4,3,2,9,0xb2d52762d
10173.81,2.0,252,2,3,1,6,0xb2d5e5b9
193035.0,12.0,0,3,4,4,11,0x3b9b37bd
1193.56,1.0,184,1,2,1,4,0xb2d1d712d
9461.94,1.0,5,2,2,3,7,0xb2d56d11
166.25,1.0,68,1,2,1,4,0xb2d6ff3e
42.08,1.0,1,1,2,4,7,0xb2d246be
206062.06,4.0,10,3,4,3,10,0xb2d25b79d
9284.86,1.0,0,2,2,4,8,0xb2d974e4d
2510072.49,14.0,6,4,4,3,11,0xb2d52e0ad
710260.08,4.0,3,4,4,4,12,0xb2d51ddb
609684.0,4.0,53,4,4,2,10,0xb2d168f4d
202500.23,2.0,1,3,3,4,10,0xb2d8c716d
156005.97,6.0,136,3,4,1,8,0xb2d51932d
310000.0,1.0,0,4,2,4,10,0xb2d8dd2b
1607871.52,3.0,0,4,4,4,12,0xb2d173ced
206458.41,2.0,122,3,3,1,7,0xb2d5040cd
560000.0,1.0,1,4,2,4,10,0xb2d98127
450861.1,2.0,14,4,3,3,10,0xb2d11f3b
70411.61,5.0,14,3,4,3,10,0xb2d0658d
20452.76,2.0,90,2,3,1,6,0xb2d60a2dd
10015.43,2.0,13,2,3,3,8,0xb2d648acd
605685.08,3.0,55,4,4,2,10,0xb2d10fb9d
347095.59,2.0,17,4,3,2,9,0xb2d56f18d
71.05,1.0,18,1,2,2,5,0xb2d5bb06
106403.01,3.0,158,3,4,1,8,0xb2d2609cd
2907.65,1.0,184,2,2,1,5,0xb2d45c27d
1510.34,1.0,10,1,2,3,6,0xb2d6b89ed
205805.06,5.0,74,3,4,1,8,0xb2d08032d
3.02,1.0,1,1,2,4,7,0xb2d5afc0d
31401.21,1.0,0,2,2,4,8,0xb2d775b8d
101062.78,2.0,11,3,3,3,9,0xb2d95b3fd
3579.72,1.0,15,2,2,3,7,0xb2d7007fd
1550010.95,3.0,1,4,4,4,12,0xb2d9833cd
808.7,2.0,184,1,3,1,5,0xb2d4a278d
241409.44,4.0,61,3,4,2,9,0xb2d18022d
605467.68,5.0,5,4,4,3,11,0xb2d0cdc1
100001.06,2.0,41,3,3,2,8,0xb2d921c9d
2303.55,1.0,10,1,2,3,6,0xb2d92682
50000.53,4.0,153,2,4,1,7,0xb2d23597d
163.95,1.0,10,1,2,3,6,0xb2d9205c
18604.99,1.0,0,2,2,4,8,0xb2da07ac
363536.71,5.0,6,4,4,3,11,0xb2d44a54d
19908.4,1.0,49,2,2,2,6,0xb2d91375d
210006.1,2.0,13,3,3,3,9,0xb2d900d8d
2117.61,1.0,92,1,2,1,4,0xb2d17f9fd
287.51,1.0,6,1,2,3,6,0xb2d41685
23249.05,1.0,13,2,2,3,7,0xb2d255ecd
730009.48,10.0,14,4,4,3,11,0xb2d1f89a
195022.53,4.0,42,3,4,2,9,0xb2d55eddd
331116.03,4.0,20,4,4,2,10,0xb2d24ebbd
6316.1,1.0,20,2,2,2,6,0xb2d96006
157000.43,3.0,0,3,4,4,11,0xb2d0de18d
3337.0,1.0,20,2,2,2,6,0xb2d38cb2d
83088.88,2.0,132,3,3,1,7,0xb2d2b232d
540.96,4.0,5,1,4,3,8,0xb2d28207
788.86,1.0,2,1,2,4,7,0xb2d31d15
912819.45,7.0,24,4,4,2,10,0xb2d1491d
60089.98,2.0,18,3,3,2,8,0xb2d6940cd
100003.52,3.0,66,3,4,2,9,0xb2d5b78a
18780.56,1.0,92,2,2,1,5,0xb2d0faa2
3986.19,1.0,12,2,2,3,7,0xb2d20c1ed
140000.0,3.0,1,3,4,4,11,0xb2d6a726d
83.25,1.0,34,1,2,2,5,0xb2d6a35b
95.45,1.0,42,1,2,2,5,0xb2d29251
670166.16,4.0,108,4,4,1,9,0xb2d1bed1d
400000.0,3.0,8,4,4,3,11,0xb2d970fad
5000211.11,2.0,67,4,3,1,8,0xb2d944e8d
441454.16,7.0,6,4,4,3,11,0xb2d2035dd
170289.27,2.0,28,3,3,2,8,0xb2d29b9f
401421.99,3.0,18,4,4,2,10,0xb2d6c4ecd
3.54,1.0,17,1,2,2,5,0xb2d14a53
70280.13,4.0,20,3,4,2,9,0xb2d3e5db
10000001.47,28.0,0,4,4,4,12,0xb2d3891c
771003.21,8.0,10,4,4,3,11,0xb2d5965bd
410847.22,3.0,5,4,4,3,11,0xb2d1ff09
1094.99,1.0,4,1,2,4,7,0xb2d3f956
0.63,1.0,19,1,2,2,5,0xb2da2212
25888.94,1.0,20,2,2,2,6,0xb2d0f33dd
50022.18,1.0,3,2,2,4,8,0xb2d8a69ad
929460.66,3.0,9,4,4,3,11,0xb2d8ea31d
501538.51,3.0,4,4,4,4,12,0xb2d245d4
20000.84,2.0,53,2,3,2,7,0xb2d97b05
10000.11,2.0,70,2,3,1,6,0xb2d9a669
1399310.8,7.0,0,4,4,4,12,0x3b9b0e2dd
36915.14,1.0,0,2,2,4,8,0xb2d9cfe3
9727.55,1.0,7,2,2,3,7,0xb2d64b06d
18.97,1.0,27,1,2,2,5,0xb2d29bad
50077.21,2.0,108,2,3,1,6,0xb2d5ba40d
140000.0,2.0,3,3,3,4,10,0xb2d5b161d
406000.76,11.0,4,4,4,4,12,0xb2d31530d
100005.71,2.0,231,3,3,1,7,0xb2d25128d
425511.22,2.0,0,4,3,4,11,0xb2d5ed96d
3.1,1.0,15,1,2,3,6,0xb2d93c6bd
200004.22,2.0,98,3,3,1,7,0xb2d96e19d
70.89,1.0,73,1,2,1,4,0xb2d261e9
6.85,1.0,22,1,2,2,5,0xb2d9f760
1583.1,2.0,13,1,3,3,7,0xb2d0732ad
8177.03,1.0,7,2,2,3,7,0xb2d6d045d
967572.58,1.0,9,4,2,3,9,0xb2d24836d
402935.41,3.0,62,4,4,2,10,0xb2d63d1d
1.17,1.0,33,1,2,2,5,0xb2d925dad
2551.73,1.0,92,1,2,1,4,0xb2d242c0d
521082.13,5.0,90,4,4,1,9,0xb2d3d6a2d
1080.16,1.0,130,1,2,1,4,0xb2d684c1d
200637.21,2.0,62,3,3,2,8,0xb2d1e8a8d
600030.12,4.0,98,4,4,1,9,0xb2d11fcfd
172173.34,2.0,77,3,3,1,7,0xb2d1744ad
1002.3,1.0,92,1,2,1,4,0xb2d2ce76d
5520.23,1.0,0,2,2,4,8,0xb2d85b9a
13639.72,1.0,9,2,2,3,7,0xb2d27361d
1107267.39,14.0,4,4,4,4,12,0xb2d51ddbd
473262.69,3.0,14,4,4,3,11,0xb2d25017
72.1,1.0,208,1,2,1,4,0xb2d2ced0d
2227.52,1.0,10,1,2,3,6,0xb2d6d4d0
100055.96,2.0,108,3,3,1,7,0xb2d5ef70d
10219.65,1.0,85,2,2,1,5,0xb2d68d3cd
50498.6,1.0,0,2,2,4,8,0xb2d0cbc6d
20243.09,1.0,63,2,2,2,6,0xb2d62978d
11521.97,1.0,14,2,2,3,7,0xb2d824f9
7750.77,1.0,29,2,2,2,6,0xb2d9be16
1508437.14,3.0,0,4,4,4,12,0xb2d23fd5d
3.17,1.0,55,1,2,2,5,0xb2d8e2fd
118285000.0,8.0,6,4,4,3,11,0xb2d25ed7
1608263.34,8.0,1,4,4,4,12,0xb2d1e4f8d
4.14,1.0,0,1,2,4,7,0xb2d9428a
196.18,1.0,22,1,2,2,5,0xb2d1c08e
600075.41,4.0,32,4,4,2,10,0xb2d0ce7e
481175.52,4.0,34,4,4,2,10,0xb2d141ddd
1068.37,1.0,184,1,2,1,4,0xb2d334f9d
9346.17,1.0,16,2,2,2,6,0xb2d1c452d
450176.17,2.0,42,4,3,2,9,0xb2d9b504
74995.2,2.0,14,3,3,3,9,0x3b9af0c4d
696.21,1.0,0,1,2,4,7,0xb2d21122
3915.75,1.0,18,2,2,2,6,0xb2d2d43b
50052.16,2.0,25,2,3,2,7,0xb2d39a2c
418.56,1.0,0,1,2,4,7,0xb2d1ef44d
49.07,1.0,4,1,2,4,7,0xb2d3ff28d
662777.14,7.0,11,4,4,3,11,0xb2d16377d
490120.01,3.0,143,4,4,1,9,0xb2d3dfebd
6787.78,1.0,14,2,2,3,7,0xb2d6bbd0
406.84,2.0,2,1,3,4,8,0xb2d337d0d
2524.54,1.0,7,1,2,3,6,0xb2d6c539
1267087.89,17.0,14,4,4,3,11,0x3b9b17e9d
20089.33,1.0,19,2,2,2,6,0xb2d6135ed
200025.82,2.0,180,3,3,1,7,0xb2d55804
325557.04,5.0,0,4,4,4,12,0xb2d51225d
125789.84,6.0,5,3,4,3,10,0x3b9b2f30d
2000045.21,2.0,24,4,3,2,9,0xb2d5bfeb
390313.69,4.0,53,4,4,2,10,0xb2d18a7cd
57959.89,1.0,2,3,2,4,9,0xb2d382cf
7.81,1.0,3,1,2,4,7,0xb2d25576d
604.56,2.0,8,1,3,3,7,0x3b9b3117
780009.34,4.0,8,4,4,3,11,0xb2d6c983d
996000.0,11.0,6,4,4,3,11,0xb2d59c80d
280144.7,3.0,19,3,4,2,9,0xb2d3e067d
342661.76,4.0,12,4,4,3,11,0xb2d57ce8
50203.72,1.0,13,2,2,3,7,0xb2d33911d
5761.41,1.0,230,2,2,1,5,0xb2d6f2f4d
106881.46,4.0,0,3,4,4,11,0xb2d17c02
23129.99,1.0,1,2,2,4,8,0xb2d61a7f
90000.0,1.0,9,3,2,3,8,0xb2d0cfcc
200000.0,2.0,26,3,3,2,8,0xb2da1444
1924.89,1.0,4,1,2,4,7,0xb2d43dc5d
1869.48,1.0,184,1,2,1,4,0xb2d2a4d2d
900068.65,5.0,27,4,4,2,10,0xb2d535c5d
1351482.11,1.0,92,4,2,1,7,0xb2d12a24d
135043.37,5.0,5,3,4,3,10,0xb2d1083f
220006.97,2.0,95,3,3,1,7,0xb2d9733ed
250003.69,3.0,38,3,4,2,9,0xb2d92453d
1025283.42,4.0,12,4,4,3,11,0xb2d432d6d
160128.42,2.0,226,3,3,1,7,0xb2d1ff8ed
1016.34,1.0,184,1,2,1,4,0xb2d27a83d
3301.83,1.0,17,2,2,2,6,0xb2d69bb6d
40332.55,4.0,11,2,4,3,9,0xb2d1f905
1422.13,1.0,49,1,2,2,5,0xb2d3b9f8
450002.15,3.0,5,4,4,3,11,0xb2d9306ed
110.56,1.0,6,1,2,3,6,0xb2d8fcdd
18886.38,1.0,28,2,2,2,6,0xb2d6c8abd
372660.78,3.0,21,4,4,2,10,0xb2d16277
2458.88,1.0,78,1,2,1,4,0xb2d1cd8e
430091.58,4.0,0,4,4,4,12,0xb2d2dee2d
461017.62,5.0,21,4,4,2,10,0xb2d603d9
35167.03,1.0,1,2,2,4,8,0xb2d0b18d
4261.88,1.0,14,2,2,3,7,0xb2d7c2ebd
6105.05,1.0,2,2,2,4,8,0xb2d5d74dd
130010.1,2.0,133,3,3,1,7,0xb2d4a2cfd
824298.22,3.0,48,4,4,2,10,0xb2d15a9fd
50.2,1.0,3,1,2,4,7,0xb2d5ea32
7074.24,1.0,184,2,2,1,5,0xb2d2b323d
1607.09,1.0,92,1,2,1,4,0xb2d25522
41.6,1.0,0,1,2,4,7,0xb2d9439ad
10.93,1.0,3,1,2,4,7,0xb2d6bf79d
10000.58,3.0,4,2,4,4,10,0xb2d612ead
100424.79,2.0,5,3,3,3,9,0xb2d0bd07d
500000.0,2.0,13,4,3,3,10,0xb2d9618f
40003.38,4.0,45,2,4,2,8,0xb2d584a0
874412.06,3.0,9,4,4,3,11,0xb2d23cf6d
30761.2,1.0,63,2,2,2,6,0xb2d2645b
388196.96,5.0,41,4,4,2,10,0xb2d534b6d
9646.53,1.0,21,2,2,2,6,0xb2d5a10dd
500710.96,3.0,12,4,4,3,11,0xb2d5fdd5
210316.58,3.0,102,3,4,1,8,0xb2d428f4d
403731.03,3.0,77,4,4,1,9,0xb2d2bcdf
415237.83,12.0,32,4,4,2,10,0xb2d6195bd
3188.6,1.0,4,2,2,4,8,0xb2d2db64d
592157.7,7.0,1,4,4,4,12,0xb2d5dd7fd
106443.46,1.0,7,3,2,3,8,0xb2d94902
80000.0,4.0,6,3,4,3,10,0xb2d59b7bd
1232808.1,4.0,8,4,4,3,11,0xb2d16b3ad
6829.57,1.0,1,2,2,4,8,0xb2d6c158
130001.37,3.0,154,3,4,1,8,0xb2d6d69fd
116505.55,3.0,20,3,4,2,9,0xb2d9ab4a
469.46,1.0,0,1,2,4,7,0xb2d635d9d
395.99,1.0,8,1,2,3,6,0xb2d8e653
400073.19,3.0,4,4,4,4,12,0xb2d22a6dd
1942.15,1.0,187,1,2,1,4,0xb2d6bbbdd
50633.85,1.0,92,2,2,1,5,0xb2d1d026d
20001277.22,2.0,111,4,3,1,8,0xb2d5b446
1519.57,1.0,184,1,2,1,4,0xb2d11706d
400304.56,3.0,9,4,4,3,11,0xb2d63c2fd
100001.06,2.0,56,3,3,2,8,0xb2d9c694
530244.79,1.0,45,4,2,2,8,0xb2d9480b
53005.93,3.0,132,3,4,1,8,0xb2d6f8afd
122286.44,2.0,0,3,3,4,10,0xb2d24e0e
150288.82,1.0,1,3,2,4,9,0xb2d5c679d
1220025.82,3.0,110,4,4,1,9,0xb2d79103d
234000.5,3.0,0,3,4,4,11,0xb2d12aae
500000.0,3.0,12,4,4,3,11,0xb2da4286
1000084.8,2.0,75,4,3,1,8,0xb2d29149
7.68,1.0,36,1,2,2,5,0xb2d5ccea
1582.42,1.0,125,1,2,1,4,0xb2d2ffbfd
417420.38,3.0,139,4,4,1,9,0xb2d55a39d
981423.56,2.0,1,4,3,4,11,0xb2d654a2d
2693.44,1.0,0,1,2,4,7,0xb2d91389
241392.27,2.0,51,3,3,2,8,0xb2d6269dd
224714.04,2.0,24,3,3,2,8,0xb2d5de02d
31388.78,1.0,0,2,2,4,8,0xb2d2562ed
335016.04,3.0,108,4,4,1,9,0xb2d438b2
2861.61,1.0,10,1,2,3,6,0xb2d399f6
802.58,1.0,2,1,2,4,7,0xb2d200a5d
303673.34,4.0,60,4,4,2,10,0xb2d240b3d
57089.39,2.0,203,3,3,1,7,0xb2d162b7d
220002.89,2.0,21,3,3,2,8,0xb2d952d7d
58.21,1.0,12,1,2,3,6,0xb2d26048
1902.44,1.0,43,1,2,2,5,0xb2d85ce3d
460034.05,6.0,59,4,4,2,10,0xb2d4c259d
4128882.42,4.0,10,4,4,3,11,0xb2d23c62d
110255.41,3.0,181,3,4,1,8,0xb2d594c8
617.74,1.0,1,1,2,4,7,0xb2d2e295d
660021.17,2.0,9,4,3,3,10,0xb2d266a5
7.34,1.0,40,1,2,2,5,0xb2d9e99e
2180139.94,3.0,21,4,4,2,10,0xb2d56324
11.95,1.0,33,1,2,2,5,0xb2d9c5e7
11945.27,1.0,18,2,2,2,6,0xb2d8db43d
550015.04,3.0,19,4,4,2,10,0xb2d78bfa
266.44,1.0,4,1,2,4,7,0xb2d772d3d
66658.19,5.0,1,3,4,4,11,0xb2d0b636d
500644.95,2.0,4,4,3,4,11,0xb2d574c1
1307.75,1.0,135,1,2,1,4,0xb2d602f3
60230.13,2.0,0,3,3,4,10,0xb2d2affc
916.87,1.0,9,1,2,3,6,0xb2d50f1bd
203211.86,2.0,111,3,3,1,7,0xb2d249da
1050300.26,2.0,43,4,3,2,9,0xb2d6d09cd
200000.0,2.0,63,3,3,2,8,0xb2d9b9bd
702859.45,3.0,18,4,4,2,10,0xb2d5054c
429555.88,4.0,126,4,4,1,9,0xb2d122bed
173135.52,6.0,63,3,4,2,9,0xb2d537a9d
500100.0,1.0,4,4,2,4,10,0xb2da25b1
2456.04,1.0,10,1,2,3,6,0xb2d26939d
400351.23,3.0,14,4,4,3,11,0xb2d43edfd
3006.09,1.0,4,2,2,4,8,0xb2d9b2e5
94.68,1.0,75,1,2,1,4,0xb2d1a8d0
593004.34,5.0,0,4,4,4,12,0xb2d2468e
839.8,1.0,9,1,2,3,6,0xb2da03f6
500000.96,1.0,1,4,2,4,10,0xb2d94a55
200173.35,2.0,8,3,3,3,9,0xb2d7018ed
500087.22,2.0,0,4,3,4,11,0xb2d928d9d
500012.03,3.0,42,4,4,2,10,0xb2d9d54f
55.88,1.0,167,1,2,1,4,0xb2d3b875
2179536.26,4.0,3,4,4,4,12,0xb2d0cc5d
402199.92,5.0,0,4,4,4,12,0xb2d4d1a5d
181.61,2.0,60,1,3,2,6,0xb2d537ced
40070.33,4.0,67,2,4,1,7,0xb2d3489f
70379.77,2.0,25,3,3,2,8,0xb2d5c01bd
444.87,1.0,28,1,2,2,5,0xb2d26239d
733.92,1.0,11,1,2,3,6,0xb2d7747d
18000.76,2.0,21,2,3,2,7,0xb2da1c6d
8500.4,4.0,0,2,4,4,10,0x3b9af26a
459612.83,42.0,0,4,4,4,12,0x3b9b1919d
100869.76,1.0,45,3,2,2,7,0xb2d62528d
1990.01,1.0,203,1,2,1,4,0xb2d75768d
474.91,1.0,184,1,2,1,4,0xb2d29fa7d
1191784.35,11.0,10,4,4,3,11,0xb2d129ce
1125.28,1.0,14,1,2,3,6,0xb2d63169d
300065.63,2.0,1,3,3,4,10,0xb2d93c7dd
541454.15,6.0,4,4,4,4,12,0xb2d4f6b8d
685.42,1.0,1,1,2,4,7,0xb2d2fba3
8857.31,1.0,6,2,2,3,7,0xb2d6a7d6d
130088.42,2.0,231,3,3,1,7,0xb2d4c0c8d
0.0,1.0,0,1,2,4,7,0xb2d6c378d
18034766.21,2.0,11,4,3,3,10,0x3b9aecd7
3949.48,1.0,1,2,2,4,8,0xb2d4f737
3321045.8,4.0,4,4,4,4,12,0xb2d617afd
1463.78,1.0,92,1,2,1,4,0xb2d1dae6d
733112.01,2.0,24,4,3,2,9,0xb2d3bba3d
563036.65,4.0,2,4,4,4,12,0xb2d60058
10374.8,1.0,108,2,2,1,5,0xb2d3162ed
662793.93,19.0,10,4,4,3,11,0xb2d46f94d
13107.73,2.0,12,2,3,3,8,0xb2d2e5d2d
1063265.89,12.0,0,4,4,4,12,0xb2d19190d
432930.51,4.0,67,4,4,1,9,0xb2d4168cd
10010.32,2.0,53,2,3,2,7,0xb2d9c9d1
5094.18,1.0,32,2,2,2,6,0xb2d9d34f
7274.95,1.0,20,2,2,2,6,0xb2d7ec6ed
1244.85,2.0,184,1,3,1,5,0xb2d09d2bd
980898.25,2.0,157,4,3,1,8,0xb2d3eb7cd
58921.17,1.0,39,3,2,2,7,0xb2d6e69d
5112.36,1.0,184,2,2,1,5,0xb2d13901d
82456.35,2.0,11,3,3,3,9,0xb2d1c27fd
200927.36,3.0,30,3,4,2,9,0x3b9af58b
3646.35,1.0,1,2,2,4,8,0xb2d3ab18d
1622.77,1.0,92,1,2,1,4,0xb2d21868
82843.42,2.0,0,3,3,4,10,0xb2d62aa7d
201131.98,2.0,19,3,3,2,8,0xb2d5e5cbd
100005.27,2.0,47,3,3,2,8,0xb2d5e66d
4794.01,1.0,137,2,2,1,5,0xb2d29c1fd
120068.82,3.0,0,3,4,4,11,0xb2d6c062
2582598.92,26.0,4,4,4,4,12,0xb2d12630d
11.45,1.0,5,1,2,3,6,0xb2d9f945
863359.9,3.0,104,4,4,1,9,0xb2d1e0f7d
1596.2,1.0,184,1,2,1,4,0xb2d256a8d
100056.92,2.0,31,3,3,2,8,0xb2d57fc8
40007.19,2.0,95,2,3,1,6,0xb2d6037dd
284927.25,2.0,27,3,3,2,8,0xb2d3b07ed
13415.72,1.0,1,2,2,4,8,0xb2d264cf
805446.06,14.0,1,4,4,4,12,0xb2d46f91d
37.39,1.0,63,1,2,2,5,0xb2d4d829
7235.18,1.0,184,2,2,1,5,0xb2d2f8dad
1778.0,1.0,5,1,2,3,6,0xb2d55205
2087.38,1.0,1,1,2,4,7,0xb2d85773d
239604.01,3.0,16,3,4,2,9,0xb2d1066dd
200056.6,2.0,6,3,3,3,9,0xb2d6ef1bd
0.96,1.0,35,1,2,2,5,0xb2d185bd
100004.05,2.0,49,3,3,2,8,0xb2d9b501
541.43,1.0,9,1,2,3,6,0xb2d27e53
14381.98,1.0,184,2,2,1,5,0xb2d2eb71d
1619.13,1.0,19,1,2,2,5,0xb2d68bbf
10008.62,2.0,128,2,3,1,6,0xb2d5a97c
270000.01,3.0,6,3,4,3,10,0xb2d56b12d
2394.23,1.0,1,1,2,4,7,0xb2d9c493
163027.67,3.0,1,3,4,4,11,0xb2d20b07
105004.44,4.0,3,3,4,4,11,0xb2d5f3f2
31835.07,1.0,20,2,2,2,6,0xb2d0b00fd
39.22,1.0,5,1,2,3,6,0xb2d77fd5d
1059158.24,2.0,86,4,3,1,8,0xb2d34ccb
129191.12,3.0,11,3,4,3,10,0xb2d2a36ed
6562.09,1.0,1,2,2,4,8,0xb2d65102
500015.83,2.0,67,4,3,1,8,0xb2d9ab95
96.58,1.0,49,1,2,2,5,0xb2d61628d
15.41,3.0,49,1,4,2,7,0xb2d8c6d6
179410.68,1.0,1,3,2,4,9,0xb2da3b85
240745.86,4.0,10,3,4,3,10,0xb2d60190d
590254.1,5.0,13,4,4,3,11,0xb2d0c8aed
7519.75,1.0,184,2,2,1,5,0xb2d176b5d
957.78,1.0,35,1,2,2,5,0xb2d45ccbd
4152.62,1.0,6,2,2,3,7,0xb2d31673
440060.54,4.0,39,4,4,2,10,0xb2d1966cd
2091.28,1.0,0,1,2,4,7,0xb2d3d598d
160001.69,2.0,27,3,3,2,8,0xb2d942e3d
505067.21,9.0,27,4,4,2,10,0xb2d93674d
40355.32,1.0,11,2,2,3,7,0xb2d49d71d
565.14,1.0,5,1,2,3,6,0xb2d92d7c
357396.48,2.0,16,4,3,2,9,0xb2d17986d
60001.27,2.0,199,3,3,1,7,0xb2d69807
1111.73,1.0,10,1,2,3,6,0xb2d65364d
2.05,4.0,11,1,4,3,8,0xb2d094e4
5301.45,1.0,0,2,2,4,8,0xb2d6aef4
200020.87,2.0,5,3,3,3,9,0xb2d9a3ff
304264.54,2.0,101,4,3,1,8,0xb2d92cf3d
1230005.34,14.0,18,4,4,2,10,0xb2d3eafe
83.75,1.0,28,1,2,2,5,0xb2d8f355
3252.31,1.0,2,2,2,4,8,0xb2d68744
2530000.01,3.0,4,4,4,4,12,0xb2d143b0d
8413.95,1.0,0,2,2,4,8,0xb2d17f66
5160.01,1.0,29,2,2,2,6,0xb2d91f82
413161.99,9.0,0,4,4,4,12,0xb2d4f40ad
1050016.4,2.0,11,4,3,3,10,0xb2d6b986
53248.17,2.0,208,3,3,1,7,0xb2d512d0d
410171.79,4.0,11,4,4,3,11,0xb2d126e5
7067.3,1.0,92,2,2,1,5,0xb2d25f89d
10243.0,2.0,94,2,3,1,6,0xb2d5e83a
1827.27,1.0,15,1,2,3,6,0xb2d6899ad
65282.18,1.0,10,3,2,3,8,0xb2d41899d
300123.79,4.0,4,4,4,4,12,0xb2d07098d
1050.52,1.0,92,1,2,1,4,0xb2d42ca6d
50001.58,2.0,80,2,3,1,6,0xb2d98a6a
210.4,1.0,9,1,2,3,6,0xb2d26a2a
400010.02,3.0,11,4,4,3,11,0xb2d9034dd
25.86,1.0,75,1,2,1,4,0xb2d56629d
184238.46,9.0,0,3,4,4,11,0x3b9b2f0dd
20090.59,1.0,184,2,2,1,5,0xb2d3a0cb
124.26,1.0,10,1,2,3,6,0xb2d2c026
500176.04,2.0,1,4,3,4,11,0xb2da0644
2175012.57,8.0,4,4,4,4,12,0xb2d1b695d
1137155.35,7.0,12,4,4,3,11,0xb2d11be2
8.69,1.0,20,1,2,2,5,0xb2d3e4b4
789.49,1.0,4,1,2,4,7,0xb2d996e0
3.11,5.0,8,1,4,3,8,0xb2d2a0da
504473.95,4.0,68,4,4,1,9,0xb2d6f323d
90003.8,2.0,56,3,3,2,8,0xb2d9bf18
582.62,1.0,67,1,2,1,4,0xb2d37069d
52812.76,1.0,175,3,2,1,6,0xb2d534c3d
480000.0,2.0,74,4,3,1,8,0xb2d9a2af
49076.73,5.0,0,2,4,4,10,0x3b9b3a81
500100.07,2.0,13,4,3,3,10,0xb2d65ffcd
26.92,1.0,2,1,2,4,7,0xb2d2f7de
172030.8,1.0,49,3,2,2,7,0xb2d56a36d
517074.49,1.0,92,4,2,1,7,0xb2d079f1
8035.11,1.0,92,2,2,1,5,0xb2d50f6a
19.57,2.0,73,1,3,1,5,0xb2d26006d
265460.22,2.0,10,3,3,3,9,0xb2d5ec3cd
18096.88,1.0,9,2,2,3,7,0xb2d8d349d
2396.72,1.0,144,1,2,1,4,0xb2d49d51d
200006.33,2.0,80,3,3,1,7,0xb2d8d028d
1304.84,1.0,184,1,2,1,4,0xb2d192ecd
40006.3,2.0,34,2,3,2,7,0xb2d650dcd
67579.24,1.0,92,3,2,1,6,0xb2d2d010
2801.99,1.0,23,1,2,2,5,0xb2d3a0d4
228.15,1.0,67,1,2,1,4,0xb2d45a14d
3682.58,1.0,5,2,2,3,7,0xb2d26ee9d
435828.08,7.0,4,4,4,4,12,0xb2d3fe80d
168972.62,4.0,63,3,4,2,9,0xb2d28e96
2678.76,1.0,0,1,2,4,7,0xb2d9d0eb
1255.82,1.0,9,1,2,3,6,0xb2d6e9c3d
88914.5,2.0,12,3,3,3,9,0xb2d643d8d
19738.3,1.0,5,2,2,3,7,0xb2d2d3cc
83415.88,3.0,0,3,4,4,11,0xb2d06913d
51073.47,2.0,206,2,3,1,6,0xb2d5c77fd
501776.04,2.0,35,4,3,2,9,0xb2d9fc1e
12121.98,1.0,0,2,2,4,8,0xb2d67ec4
383310.27,3.0,70,4,4,1,9,0xb2d61ef3d
400011.54,3.0,125,4,4,1,9,0xb2d63694d
110007.97,4.0,10,3,4,3,10,0xb2d516a3
205714.03,2.0,245,3,3,1,7,0xb2d1658dd
462003.97,14.0,25,4,4,2,10,0xb2d0eb04d
1047248.71,5.0,1,4,4,4,12,0xb2d4adbdd
3975.53,1.0,1,2,2,4,8,0xb2d4dcd4
1.13,1.0,69,1,2,1,4,0xb2d8d9d5d
2.05,1.0,28,1,2,2,5,0xb2d8c70a
173017.49,2.0,10,3,3,3,9,0xb2d52bc8
650021.01,10.0,6,4,4,3,11,0xb2d6474ed
2460.78,1.0,184,1,2,1,4,0xb2d3a8a7d
30000.32,2.0,39,2,3,2,7,0xb2d9f3a0
129866.14,4.0,2,3,4,4,11,0xb2d2a327
210092.22,3.0,4,3,4,4,11,0xb2d6a9e3d
201558.13,2.0,5,3,3,3,9,0xb2d7d2ddd
900001.06,3.0,28,4,4,2,10,0xb2da0a89
1170207.92,21.0,1,4,4,4,12,0xb2d2679a
460042.49,3.0,27,4,4,2,10,0xb2d62236d
60033.33,2.0,67,3,3,1,7,0xb2d50961d
607581.02,4.0,6,4,4,3,11,0xb2d1112f
442140.8,5.0,10,4,4,3,11,0xb2d63a3ad
98.47,1.0,12,1,2,3,6,0xb2d24e66
2.01,1.0,77,1,2,1,4,0xb2d8223cd
53158.17,2.0,63,3,3,2,8,0xb2d4cc67d
1524289.91,7.0,12,4,4,3,11,0xb2d5b0f2d
40044.71,1.0,5,2,2,3,7,0xb2d18d7ed
2276.3,1.0,9,1,2,3,6,0xb2d2f58ad
380425.67,3.0,61,4,4,2,10,0xb2d5776ed
60025.36,2.0,157,3,3,1,7,0xb2d5a0ead
150630.87,2.0,4,3,3,4,10,0xb2d483fbd
50301.96,2.0,84,2,3,1,6,0xb2d2a07fd
5028.52,1.0,184,2,2,1,5,0xb2d482d4d
6951.14,1.0,10,2,2,3,7,0xb2d4df84d
72346.41,2.0,1,3,3,4,10,0xb2d11068
10000.11,2.0,14,2,3,3,8,0xb2da37c9
431882.63,6.0,0,4,4,4,12,0x3b9ad1c8d
187970.46,7.0,25,3,4,2,9,0xb2d3a901d
75807.14,2.0,52,3,3,2,8,0xb2d45aacd
1905.81,1.0,197,1,2,1,4,0xb2d57fd3
6656.31,1.0,106,2,2,1,5,0xb2d4fb1dd
1887.5,2.0,215,1,3,1,5,0xb2d6148ed
3508.78,1.0,16,2,2,2,6,0xb2d8eb75d
294003.1,4.0,42,3,4,2,9,0xb2d967f9d
260009.84,3.0,11,3,4,3,10,0xb2d9411ed
520288.72,2.0,0,4,3,4,11,0xb2d61cc6
15688.59,1.0,0,2,2,4,8,0xb2d0d39e
17.04,1.0,55,1,2,2,5,0xb2d1a81e
600000.0,3.0,1,4,4,4,12,0xb2da5e79
3.27,1.0,66,1,2,2,5,0xb2d972a8
101936.56,2.0,73,3,3,1,7,0xb2d64a16
352156.13,4.0,4,4,4,4,12,0xb2d43068d
321010.59,5.0,175,4,4,1,9,0xb2d4ef53
44255.56,1.0,1,2,2,4,8,0xb2d4357f
600019.0,2.0,92,4,3,1,8,0xb2d97e2cd
3005.16,1.0,120,2,2,1,5,0xb2d29ce8
40390.82,1.0,13,2,2,3,7,0xb2d39cc5
14000.15,2.0,31,2,3,2,7,0xb2d93bb3
68765.4,5.0,92,3,4,1,8,0xb2d26eb2d
440090.3,3.0,87,4,4,1,9,0xb2d152c0d
481.21,1.0,13,1,2,3,6,0xb2d34819d
1904.4,1.0,229,1,2,1,4,0xb2d6f01fd
1089.31,1.0,184,1,2,1,4,0xb2d22a15d
210050.93,5.0,7,3,4,3,10,0xb2d29d03
33551.94,1.0,10,2,2,3,7,0xb2d46f15d
500001.0,3.0,0,4,4,4,12,0xb2d59410d
2272.3,1.0,9,1,2,3,6,0xb2d435dc
2424.28,1.0,0,1,2,4,7,0xb2d5a9e2
110003.89,4.0,48,3,4,2,9,0xb2d6bf4ad
580.06,1.0,1,1,2,4,7,0xb2d1fefd
81190.84,1.0,146,3,2,1,6,0xb2d43ce9
1162288.66,5.0,7,4,4,3,11,0xb2d50418d
11263.32,1.0,10,2,2,3,7,0xb2d30291d
10000.17,2.0,11,2,3,3,8,0xb2d6a6b7
4167.03,1.0,21,2,2,2,6,0xb2d60a56
103435.26,3.0,11,3,4,3,10,0xb2d62117d
1378.32,1.0,92,1,2,1,4,0xb2d1294fd
252.17,1.0,26,1,2,2,5,0xb2d1c8c4d
320016.51,2.0,76,4,3,1,8,0xb2d0d2b8d
478.32,3.0,0,1,4,4,9,0xb2d7f3c3d
1601.59,1.0,14,1,2,3,6,0xb2d64770d
211203.93,3.0,80,3,4,1,8,0xb2d2f134
1299.76,1.0,184,1,2,1,4,0xb2d29893d
1450102.55,6.0,25,4,4,2,10,0xb2d12581d
200000.0,2.0,4,3,3,4,10,0xb2da5ff1
7.27,1.0,74,1,2,1,4,0xb2d60924d
1018616.98,9.0,70,4,4,1,9,0xb2d42105d
2966.44,11.0,211,2,4,1,7,0xb2d209f5d
467653.23,2.0,0,4,3,4,11,0xb2d91441d
100004.75,3.0,20,3,4,2,9,0xb2da14bf
1400000.0,3.0,28,4,4,2,10,0xb2d900d6
109249.27,2.0,196,3,3,1,7,0xb2d173cdd
300063.43,3.0,1,3,4,4,11,0xb2d9ab50
3490.98,1.0,184,2,2,1,5,0xb2d27bcd
2125.28,2.0,92,1,3,1,5,0xb2d081a8d
121010.77,3.0,70,3,4,1,8,0xb2d076c5d
0.0,1.0,1,1,2,4,7,0xb2d8e620
10000.42,2.0,92,2,3,1,6,0xb2d63d7e
2023.12,1.0,92,1,2,1,4,0xb2d23275d
3338.33,1.0,91,2,2,1,5,0xb2d512f6
20000.21,2.0,48,2,3,2,7,0xb2d9dbe6
1473.46,1.0,12,1,2,3,6,0xb2d319e7d
1457.79,1.0,7,1,2,3,6,0xb2d6dea9
163491.81,10.0,0,3,4,4,11,0xb2d2567a
4599.79,1.0,92,2,2,1,5,0xb2d10b1bd
100009.87,2.0,158,3,3,1,7,0xb2d5b7c6d
200033.7,3.0,11,3,4,3,10,0xb2d58930d
1285.02,1.0,6,1,2,3,6,0xb2d753bed
105.64,1.0,14,1,2,3,6,0xb2d2a40ed
100001.59,3.0,38,3,4,2,9,0xb2d87a10d
60064.2,3.0,111,3,4,1,8,0xb2d0d563
680000.0,2.0,60,4,3,2,9,0xb2d8fee4
11331.19,1.0,5,2,2,3,7,0xb2d1ea37d
34.46,2.0,77,1,3,1,5,0xb2d087b0
3403.69,1.0,0,2,2,4,8,0xb2d5a51b
2000068.99,2.0,0,4,3,4,11,0xb2d6092e
204312.26,2.0,101,3,3,1,7,0xb2d67f37d
6741.81,1.0,8,2,2,3,7,0xb2d37762
501779.74,2.0,5,4,3,3,10,0xb2d6b2ee
5248.61,1.0,2,2,2,4,8,0xb2d25b31
400016.93,2.0,92,4,3,1,8,0xb2d63e79
14072.4,1.0,13,2,2,3,7,0xb2d6b7c6d
5223.46,1.0,32,2,2,2,6,0xb2d17d7bd
312152.79,3.0,4,4,4,4,12,0xb2d6e5e4d
820000.18,7.0,0,4,4,4,12,0xb2d7881fd
19044.63,2.0,0,2,3,4,9,0xb2d16bebd
50001.06,2.0,38,2,3,2,7,0xb2d929e6d
20107.02,1.0,193,2,2,1,5,0xb2d35551d
993351.53,5.0,9,4,4,3,11,0xb2d18060d
0.0,1.0,3,1,2,4,7,0xb2da5cd1
430038.9,6.0,1,4,4,4,12,0x3b9af198d
602181.91,2.0,34,4,3,2,9,0xb2d8fbbe
230004.87,2.0,80,3,3,1,7,0xb2d12f32
5045.06,1.0,92,2,2,1,5,0xb2d0fffcd
75000.07,3.0,0,3,4,4,11,0xb2d60e34d
100090.41,3.0,63,3,4,2,9,0xb2d629add
28655.47,1.0,6,2,2,3,7,0xb2d2b18e
392035.56,4.0,5,4,4,3,11,0xb2d2209d
6512.25,1.0,12,2,2,3,7,0xb2d5710ed
10101.63,2.0,101,2,3,1,6,0xb2d7ec83d
847047.16,2.0,0,4,3,4,11,0xb2d1b86ad
940821.94,5.0,0,4,4,4,12,0xb2d537f8d
2995.76,1.0,92,2,2,1,5,0xb2d2340bd
133014.0,2.0,87,3,3,1,7,0xb2d41f83
207134.17,1.0,15,3,2,3,8,0xb2d68319d
320000.0,6.0,7,4,4,3,11,0xb2d63153d
200001.06,2.0,7,3,3,3,9,0xb2da4dbb
280002.96,2.0,55,3,3,2,8,0xb2d2d200d
100061.64,2.0,192,3,3,1,7,0xb2d417e7
1016.55,2.0,184,1,3,1,5,0xb2d0f4e5d
5282.99,2.0,5,2,3,3,8,0xb2d1b81f
100431.09,2.0,12,3,3,3,9,0xb2d0c27b
300483.43,2.0,140,4,3,1,8,0xb2d3873c
1780146.86,3.0,101,4,4,1,9,0xb2d10f24d
20653.7,1.0,63,2,2,2,6,0xb2d60d5dd
500026.68,2.0,133,4,3,1,8,0xb2d42f5f
50634.12,1.0,4,2,2,4,8,0xb2d9546bd
11792.28,1.0,1,2,2,4,8,0xb2d8e09ad
5015.81,1.0,30,2,2,2,6,0xb2d4f2cad
55355.01,1.0,0,3,2,4,9,0xb2d3c1b8d
310309.29,3.0,21,4,4,2,10,0xb2d6159ed
469.04,1.0,77,1,2,1,4,0xb2d8c609d
3761.26,1.0,0,2,2,4,8,0xb2d6e7bc
4891.45,1.0,137,2,2,1,5,0xb2d23608d
539.15,1.0,2,1,2,4,7,0xb2d25434
1747.51,2.0,92,1,3,1,5,0xb2d07fbdd
400004.22,2.0,34,4,3,2,9,0xb2d630fc
3677.42,1.0,8,2,2,3,7,0xb2d9517a
1000000.0,2.0,92,4,3,1,8,0xb2d599a0
380018.15,4.0,27,4,4,2,10,0xb2d92848d
620000.0,5.0,0,4,4,4,12,0xb2d65164
23251.11,1.0,92,2,2,1,5,0xb2d3e45fd
4679.2,1.0,10,2,2,3,7,0xb2d6337bd
4775.97,1.0,0,2,2,4,8,0xb2d137ab
150367.68,2.0,108,3,3,1,7,0xb2d6ac3cd
1723134.98,3.0,34,4,4,2,10,0xb2d5818ad
218000.0,1.0,4,3,2,4,9,0xb2d9572cd
900022.5,4.0,0,4,4,4,12,0xb2d6533cd
9.32,1.0,1,1,2,4,7,0xb2d7ab3c
248001.7,2.0,10,3,3,3,9,0xb2da4e62
3.99,1.0,33,1,2,2,5,0xb2d1c4ef
252081.55,3.0,9,3,4,3,10,0xb2d1c3dcd
2734.82,1.0,0,1,2,4,7,0xb2d31d5dd
62778.25,2.0,83,3,3,1,7,0xb2d4ced0
103004.35,2.0,14,3,3,3,9,0xb2da33fa
3350125.38,8.0,14,4,4,3,11,0xb2d5bba1d
30008.42,1.0,3,2,2,4,8,0xb2d59601
157.26,1.0,0,1,2,4,7,0xb2d6a8bc
53548.69,1.0,0,3,2,4,9,0xb2d36b73d
591.18,1.0,69,1,2,1,4,0xb2d08779d
6600.24,1.0,0,2,2,4,8,0xb2d1800bd
450000.0,2.0,20,4,3,2,9,0xb2da2a4a
406279.72,3.0,17,4,4,2,10,0xb2d6188b
2984.21,1.0,0,2,2,4,8,0xb2d9778b
1079.66,1.0,0,1,2,4,7,0xb2d20f9ad
273018.64,3.0,18,3,4,2,9,0xb2d5c328d
350291.85,6.0,1,4,4,4,12,0xb2d5b28ad
932.37,1.0,0,1,2,4,7,0xb2d29fa3
81233.23,2.0,1,3,3,4,10,0xb2d1595cd
130001.37,2.0,98,3,3,1,7,0xb2d96ee5d
1003055.68,6.0,24,4,4,2,10,0xb2d5b556d
100000.0,2.0,1,3,3,4,10,0xb2da5f4d
1221.06,1.0,1,1,2,4,7,0xb2d3c115
8725.88,1.0,18,2,2,2,6,0xb2d1100ed
3231.68,1.0,6,2,2,3,7,0xb2d7472cd
365.33,1.0,3,1,2,4,7,0xb2d2ecde
40317.27,1.0,11,2,2,3,7,0xb2d1787b
80001.0,3.0,6,3,4,3,10,0xb2d9312e
1171.1,1.0,184,1,2,1,4,0xb2d20446d
41434.46,1.0,15,2,2,3,7,0xb2d1a8d3d
127542.55,2.0,0,3,3,4,10,0xb2d3b4f2
500000.0,3.0,5,4,4,3,11,0xb2d97044
30000.32,2.0,80,2,3,1,6,0xb2d991a6
200556.98,1.0,5,3,2,3,8,0xb2d6a9f1d
26.4,1.0,0,1,2,4,7,0xb2d914ac
251526.95,4.0,11,3,4,3,10,0xb2d9b8ed
26062.39,4.0,0,2,4,4,10,0xb2d0937dd
26.07,1.0,10,1,2,3,6,0xb2d6d207d
120611.47,1.0,146,3,2,1,6,0xb2d6ade9
132.57,1.0,9,1,2,3,6,0xb2d67dbbd
1128.89,1.0,11,1,2,3,6,0xb2d8d294
10125.56,1.0,3,2,2,4,8,0xb2d9e0d9
460006.42,3.0,14,4,4,3,11,0xb2d51dded
602565.6,3.0,111,4,4,1,9,0xb2d1eba1d
51196.27,1.0,14,2,2,3,7,0xb2d4f42d
1037.64,1.0,228,1,2,1,4,0xb2d6c45ad
363228.45,2.0,0,4,3,4,11,0xb2d5f0a4d
1492.07,1.0,92,1,2,1,4,0xb2d406e5d
262331.24,3.0,42,3,4,2,9,0xb2d5ccbfd
1068.29,2.0,159,1,3,1,5,0xb2d6d495d
0.54,2.0,1,1,3,4,8,0xb2d0d471d
43259.09,1.0,4,2,2,4,8,0xb2d6a03ad
300000.0,2.0,1,3,3,4,10,0xb2d947c5d
4019.38,1.0,4,2,2,4,8,0xb2d18d3ed
400021.72,2.0,11,4,3,3,10,0xb2d59dd7
514961.73,2.0,210,4,3,1,8,0xb2d3db97d
124.28,1.0,8,1,2,3,6,0xb2d2d823
75.59,1.0,20,1,2,2,5,0xb2d39bf2
554109.07,2.0,144,4,3,1,8,0xb2d2ef46d
400001.61,3.0,0,4,4,4,12,0xb2d3a944
1217.19,1.0,92,1,2,1,4,0xb2d22350
80001.05,5.0,94,3,4,1,8,0xb2d70405
390024.13,3.0,1,4,4,4,12,0xb2d5f491d
758.87,10.0,0,1,4,4,9,0x3b9b307d
1929937.77,11.0,70,4,4,1,9,0xb2d23fe5d
104195.31,1.0,0,3,2,4,9,0xb2d3975b
51297.97,3.0,4,2,4,4,10,0xb2d0fc4a
500000.0,4.0,0,4,4,4,12,0xb2d98cc8
100076.1,2.0,116,3,3,1,7,0xb2d0b66ad
6262.87,1.0,92,2,2,1,5,0x3b9b26f2d
8448.76,1.0,9,2,2,3,7,0xb2d8fe6bd
350203.91,5.0,80,4,4,1,9,0xb2d21235d
1483.91,1.0,92,1,2,1,4,0xb2d13698d
3131.49,1.0,10,2,2,3,7,0x3b9b2ef5
20747.57,1.0,0,2,2,4,8,0xb2d31e08d
500035.59,2.0,7,4,3,3,10,0xb2d656fdd
597.03,1.0,30,1,2,2,5,0xb2d99667
4345.28,1.0,0,2,2,4,8,0xb2d65037
7067.52,1.0,92,2,2,1,5,0xb2d2b312d
1492374.46,4.0,6,4,4,3,11,0xb2d2091cd
50.24,1.0,11,1,2,3,6,0xb2d59c33
2033545.59,1.0,186,4,2,1,7,0xb2d3e697d
52.31,1.0,78,1,2,1,4,0xb2d6fe95
564913.34,3.0,116,4,4,1,9,0xb2d23bdfd
60000.64,4.0,202,3,4,1,8,0xb2d642ce
401131.43,3.0,19,4,4,2,10,0xb2d9afe4
1866.81,4.0,19,1,4,2,7,0x3b9b17ce
192003.33,4.0,0,3,4,4,11,0xb2d3d55ed
520458.01,9.0,18,4,4,2,10,0xb2d1be62d
20000.45,2.0,18,2,3,2,7,0xb2da29ef
273295.48,7.0,97,3,4,1,8,0xb2d1123dd
50145.56,5.0,11,2,4,3,9,0xb2d53190d
4147.56,1.0,6,2,2,3,7,0xb2d75444d
30929.96,1.0,139,2,2,1,5,0xb2d1f7d8d
500000.98,4.0,9,4,4,3,11,0xb2d99d78
814511.52,4.0,3,4,4,4,12,0xb2d236fad
80272.41,1.0,95,3,2,1,6,0xb2d94e76
30427.37,1.0,60,2,2,2,6,0xb2d6e129
15157.45,1.0,20,2,2,2,6,0xb2d9675a
15692.79,1.0,6,2,2,3,7,0xb2d2a2afd
1273.93,1.0,184,1,2,1,4,0xb2d1046fd
210014.87,2.0,165,3,3,1,7,0xb2d5dcc9d
0.0,2.0,63,1,3,2,6,0xb2d4f97cd
305482.79,3.0,19,4,4,2,10,0xb2d630f7d
4576.04,1.0,2,2,2,4,8,0xb2d3422dd
130001.8,4.0,6,3,4,3,10,0xb2d8df3c
110001.16,2.0,74,3,3,1,7,0xb2d9a120
514366.86,2.0,60,4,3,2,9,0xb2d24c7ed
71121.94,2.0,1,3,3,4,10,0xb2d46862d
5476.97,1.0,4,2,2,4,8,0xb2d6c6fe
50117.43,2.0,35,2,3,2,7,0xb2d59800d
500000.24,3.0,23,4,4,2,10,0xb2d78af0d
105006.27,3.0,35,3,4,2,9,0x3b9b2924d
0.0,1.0,0,1,2,4,7,0xb2d3942bd
30000.63,2.0,74,2,3,1,6,0xb2d99c12
120973.32,2.0,0,3,3,4,10,0xb2d58277d
52903.41,4.0,8,3,4,3,10,0xb2d682a3
6028.35,1.0,0,2,2,4,8,0xb2d67dbc
1422.4,1.0,184,1,2,1,4,0xb2d35026d
12698.76,1.0,0,2,2,4,8,0xb2d319e0d
100784.36,2.0,0,3,3,4,10,0xb2d41067
204281.52,2.0,209,3,3,1,7,0xb2d50c07d
100615.22,4.0,3,3,4,4,11,0xb2d6c388d
720275.06,3.0,74,4,4,1,9,0xb2d551c0d
410017.35,2.0,92,4,3,1,8,0xb2d65e65d
70030.17,3.0,57,3,4,2,9,0xb2d687a8d
254.55,1.0,22,1,2,2,5,0xb2d4f142d
4269.95,1.0,18,2,2,2,6,0xb2d1abc7
1325915.82,6.0,0,4,4,4,12,0xb2d642bfd
144487.87,1.0,1,3,2,4,9,0xb2d11d0dd
121163.76,2.0,101,3,3,1,7,0xb2d8ec80d
106024.34,2.0,39,3,3,2,8,0xb2d29502d
100001.06,2.0,196,3,3,1,7,0xb2d7ef9d
2119.18,1.0,184,1,2,1,4,0xb2d1ccc1d
2596.5,1.0,184,1,2,1,4,0xb2d0aff0d
3015.43,1.0,0,2,2,4,8,0xb2d68fe7d
486773.39,3.0,0,4,4,4,12,0xb2d0f61dd
1.06,1.0,231,1,2,1,4,0xb2d60efd
82857.47,3.0,164,3,4,1,8,0xb2d3f3bbd
241714.46,5.0,62,3,4,2,9,0xb2d5e726d
754807.45,6.0,6,4,4,3,11,0xb2d1a419d
7747611.92,1.0,1,4,2,4,10,0xb2d9916a
25381.14,1.0,72,2,2,1,5,0xb2d30fb0
100040.28,2.0,83,3,3,1,7,0xb2d39637d
8317.53,3.0,184,2,4,1,7,0xb2d0afc8d
7379.58,1.0,76,2,2,1,5,0xb2d5f088d
2149.0,3.0,163,1,4,1,6,0xb2d46648
330410.93,2.0,0,4,3,4,11,0xb2d689b2
25.12,1.0,10,1,2,3,6,0xb2d538a3
1666.25,1.0,13,1,2,3,6,0xb2d17c88
2062.23,1.0,2,1,2,4,7,0xb2d78fa6d
2464460.33,16.0,11,4,4,3,11,0x3b9b19b6d
450003.47,5.0,1,4,4,4,12,0xb2d63a5e
4020.37,1.0,11,2,2,3,7,0xb2d94885
501853.31,2.0,29,4,3,2,9,0xb2d9a69e
2855.72,1.0,199,1,2,1,4,0xb2d68044d
100021.07,2.0,25,3,3,2,8,0xb2d459c0d
2129319.74,18.0,0,4,4,4,12,0xb2d593ddd
444019.36,3.0,10,4,4,3,11,0xb2d52feed
354975.18,2.0,37,4,3,2,9,0xb2d72536d
72.71,1.0,3,1,2,4,7,0xb2d89ef1
155000.0,2.0,1,3,3,4,10,0x3b9b0ffc
51003.54,2.0,92,2,3,1,6,0xb2d5575bd
308.74,1.0,10,1,2,3,6,0xb2d958ded
930746.42,4.0,3,4,4,4,12,0xb2d767b4
404551.08,3.0,28,4,4,2,10,0xb2d6acc7
200017.92,3.0,80,3,4,1,8,0xb2d6508ed
156271.64,2.0,3,3,3,4,10,0xb2d3b8cfd
161014.78,6.0,6,3,4,3,10,0xb2d530f6d
130368.22,3.0,3,3,4,4,11,0xb2d4ec8ad
104702.07,3.0,56,3,4,2,9,0xb2d12215
231.99,1.0,40,1,2,2,5,0xb2d32745
70001.16,4.0,3,3,4,4,11,0xb2d53d4cd
401947.97,3.0,26,4,4,2,10,0xb2d40eeb
134294.61,2.0,184,3,3,1,7,0xb2d0a6e5d
500022.43,3.0,0,4,4,4,12,0xb2d1ea24d
256371.67,2.0,13,3,3,3,9,0xb2d42114d
151021.22,3.0,11,3,4,3,10,0xb2d41974d
5.77,1.0,9,1,2,3,6,0xb2d8f56a
128.34,1.0,31,1,2,2,5,0xb2d7878ad
236064.31,2.0,25,3,3,2,8,0xb2d230b5
12019.2,1.0,160,2,2,1,5,0xb2d64964d
20567.81,1.0,3,2,2,4,8,0xb2d2b5e3d
30364.43,1.0,3,2,2,4,8,0xb2d6af70d
160001.69,2.0,188,3,3,1,7,0xb2d6a8e6d
6705.45,3.0,0,2,4,4,10,0xb2d1d450d
379642.84,9.0,13,4,4,3,11,0xb2d4c803d
635.64,1.0,23,1,2,2,5,0xb2d1b2c0d
19898.7,1.0,1,2,2,4,8,0xb2d55c3bd
160003.38,2.0,165,3,3,1,7,0xb2d8e0fcd
168.84,1.0,10,1,2,3,6,0xb2da1eb3
10009.78,1.0,14,2,2,3,7,0xb2d6a032d
14193.1,1.0,1,2,2,4,8,0xb2d6c088
600065.7,3.0,9,4,4,3,11,0xb2d9e47a
200379.84,3.0,0,3,4,4,11,0xb2d42813d
205974.06,2.0,1,3,3,4,10,0xb2d6456ed
160067.29,2.0,116,3,3,1,7,0xb2d39a94d
400046.32,4.0,8,4,4,3,11,0xb2d9f041
2.9,1.0,50,1,2,2,5,0xb2d1dbf1
170189.66,3.0,0,3,4,4,11,0xb2d6128ed
80045.31,3.0,48,3,4,2,9,0xb2d62ba9d
242046.5,5.0,70,3,4,1,8,0xb2d13e8dd
430000.0,3.0,13,4,4,3,11,0xb2da1bd7
300025.43,3.0,6,3,4,3,10,0xb2d7167fd
1600006.69,4.0,93,4,4,1,9,0xb2d12a8e
3070.6,1.0,35,2,2,2,6,0xb2d5da73
300014.73,7.0,3,3,4,4,11,0xb2d1ebf0
200593.63,2.0,0,3,3,4,10,0xb2d0b961
220100.82,2.0,165,3,3,1,7,0xb2d11063d
184956.39,2.0,25,3,3,2,8,0xb2d14bb9d
1803.27,2.0,155,1,3,1,5,0xb2d467d6d
540671.88,2.0,61,4,3,2,9,0xb2d3aaae
402.69,1.0,0,1,2,4,7,0xb2d2e5a3d
60077.05,4.0,39,3,4,2,9,0xb2d13fd3d
5002.74,1.0,62,2,2,2,6,0xb2d92d0a
940.22,1.0,101,1,2,1,4,0xb2d2fba8d
619.0,1.0,0,1,2,4,7,0xb2d8eb03
4298.98,1.0,0,2,2,4,8,0xb2d69bcb
422849.39,4.0,53,4,4,2,10,0xb2d4de98
1102057.22,6.0,0,4,4,4,12,0xb2d4f175
338.3,1.0,0,1,2,4,7,0xb2d1d5fb
124662.26,2.0,33,3,3,2,8,0xb2d2c23ed
540859.26,4.0,4,4,4,4,12,0xb2d4f366d
11580.55,2.0,0,2,3,4,9,0x3b9b1865d
202293.1,2.0,76,3,3,1,7,0xb2d255b7d
339392.86,1.0,137,4,2,1,7,0xb2d2ffafd
112665.94,4.0,8,3,4,3,10,0xb2d93844d
40510.63,1.0,10,2,2,3,7,0xb2d700fa
91.84,1.0,47,1,2,2,5,0xb2d8fa72d
2680186.22,10.0,3,4,4,4,12,0xb2d1bcf1d
120.75,1.0,26,1,2,2,5,0xb2d5178ad
33192.05,2.0,3,2,3,4,9,0xb2d0cdbcd
80.64,2.0,0,1,3,4,8,0xb2d53048
10093.68,2.0,17,2,3,2,7,0xb2d90911d
200000.0,2.0,11,3,3,3,9,0xb2da4d50
985.08,1.0,7,1,2,3,6,0xb2d23712
140032.9,5.0,11,3,4,3,10,0xb2d3118bd
2.72,1.0,5,1,2,3,6,0xb2d900fa
200005.99,2.0,8,3,3,3,9,0xb2d9508e
131183.25,2.0,111,3,3,1,7,0xb2d2068ed
7.56,1.0,70,1,2,1,4,0xb2d99e47
3649.03,1.0,0,2,2,4,8,0xb2d8ec0bd
430015.11,4.0,22,4,4,2,10,0xb2d21ad9d
472.61,1.0,9,1,2,3,6,0xb2d16401
240586.17,2.0,66,3,3,2,8,0xb2d36372d
303060.72,3.0,119,4,4,1,9,0xb2d84d7ed
20094.28,2.0,83,2,3,1,6,0xb2d5911cd
0.0,1.0,0,1,2,4,7,0xb2d77f65d
5025.91,1.0,95,2,2,1,5,0xb2d5ba37d
106467.7,3.0,53,3,4,2,9,0xb2d30f8e
513280.0,8.0,0,4,4,4,12,0xb2d27578d
200710.49,2.0,50,3,3,2,8,0xb2d9d68b
59069.8,2.0,103,3,3,1,7,0xb2d63f24
10167.3,1.0,92,2,2,1,5,0xb2d0b200d
10243.23,2.0,186,2,3,1,6,0xb2d5e83ad
231032.53,3.0,1,3,4,4,11,0xb2d60fb2d
8192.74,1.0,23,2,2,2,6,0xb2d62666d
1.8,1.0,2,1,2,4,7,0xb2d68c58d
188480.89,1.0,246,3,2,1,6,0xb2d42741d
490015.85,4.0,4,4,4,4,12,0xb2d15c06d
3.57,2.0,0,1,3,4,8,0xb2d67cd1
554907.29,3.0,95,4,4,1,9,0xb2d088fcd
300448.85,2.0,259,4,3,1,8,0xb2d2ac4fd
101452.48,2.0,0,3,3,4,10,0xb2d63cbad
100001.06,2.0,55,3,3,2,8,0xb2d68423
2305.43,1.0,21,1,2,2,5,0xb2d23069
202969.4,2.0,0,3,3,4,10,0xb2d2b317
36003.2,2.0,1,2,3,4,9,0xb2d5c671d
30188.48,1.0,0,2,2,4,8,0xb2d28093
52210.43,1.0,23,3,2,2,7,0xb2d23623d
400000.33,3.0,1,4,4,4,12,0xb2d6babcd
7093.8,1.0,10,2,2,3,7,0xb2d8c7f1
1970145.59,5.0,97,4,4,1,9,0xb2d2f0b8d
51261.7,2.0,228,2,3,1,6,0xb2d33de6d
167172.14,7.0,0,3,4,4,11,0xb2d6ed97
5002330.04,20.0,0,4,4,4,12,0xb2d27074d
8326.67,1.0,0,2,2,4,8,0xb2d6c1b5d
350787.68,4.0,0,4,4,4,12,0xb2d35bdc
2245.24,1.0,0,1,2,4,7,0xb2d42e0d
1551694.2,10.0,3,4,4,4,12,0x3b9b18eed
597.6,1.0,82,1,2,1,4,0xb2d5ad59
1334724.27,3.0,8,4,4,3,11,0xb2d9c3e7
310742.54,4.0,52,4,4,2,10,0xb2d0862dd
1046.04,1.0,184,1,2,1,4,0xb2d287c3d
10100.61,2.0,92,2,3,1,6,0xb2d633ddd
280005.44,2.0,0,3,3,4,10,0xb2d4c064d
32740.07,10.0,25,2,4,2,8,0xb2d0992ed
4449.11,1.0,174,2,2,1,5,0xb2d14b56d
563003.85,6.0,34,4,4,2,10,0xb2d78e23d
500168.4,6.0,41,4,4,2,10,0xb2d112cdd
85722.36,1.0,49,3,2,2,7,0xb2d3ba8bd
302329.71,2.0,57,4,3,2,9,0xb2d8f73ad
490241.92,3.0,92,4,4,1,9,0xb2d57a5ed
112331.06,2.0,14,3,3,3,9,0xb2d7650ad
9500.4,1.0,13,2,2,3,7,0xb2d9398c
57941.0,3.0,0,3,4,4,11,0x3b9b18d1d
81175.02,1.0,0,3,2,4,9,0xb2d3534dd
6171.95,1.0,9,2,2,3,7,0xb2d33a05
204289.7,5.0,11,3,4,3,10,0xb2d465f0
62792.08,1.0,305,3,2,1,6,0xb2d5fb14
50001.06,2.0,25,2,3,2,7,0xb2da1304
1200000.74,5.0,1,4,4,4,12,0xb2d693e6d
10001.06,2.0,173,2,3,1,6,0xb2d62759
163.21,3.0,0,1,4,4,9,0xb2d11751d
10638.48,1.0,113,2,2,1,5,0xb2d52e08
4293.01,1.0,60,2,2,2,6,0xb2d18970d
10.64,1.0,33,1,2,2,5,0xb2d6cc4a
43034.11,1.0,0,2,2,4,8,0xb2d6505cd
1595.3,2.0,184,1,3,1,5,0xb2d0b09a
70004.21,1.0,0,3,2,4,9,0xb2d3aaf9d
57518.51,1.0,1,3,2,4,9,0xb2d5ab54
1653.73,2.0,92,1,3,1,5,0x3b9b309dd
420952.92,2.0,2,4,3,4,11,0xb2d6d463
3643.79,1.0,20,2,2,2,6,0xb2d23e77
950009.09,9.0,18,4,4,2,10,0xb2d60e4bd
1261877.89,1.0,33,4,2,2,8,0xb2d2cc7ad
500084.18,2.0,6,4,3,3,10,0xb2d8d326d
558010.25,5.0,14,4,4,3,11,0xb2d20697d
204983.25,2.0,232,3,3,1,7,0xb2d637add
200285.17,1.0,4,3,2,4,9,0xb2d2e90cd
6089.02,1.0,92,2,2,1,5,0xb2d5092ed
1000105.9,7.0,20,4,4,2,10,0xb2d8b042
45000.0,3.0,67,2,4,1,7,0xb2d6af98d
4061.31,1.0,0,2,2,4,8,0xb2d8790ad
960.0,1.0,1,1,2,4,7,0xb2d60a70
1511.67,1.0,29,1,2,2,5,0xb2d3abc1d
8.88,1.0,4,1,2,4,7,0xb2d33667d
160042.32,4.0,12,3,4,3,10,0xb2d6880dd
3.47,1.0,16,1,2,2,5,0xb2d222c4
344825.86,1.0,0,4,2,4,10,0xb2d1f6d5
22973.74,1.0,4,2,2,4,8,0xb2d21128d
125.43,1.0,13,1,2,3,6,0xb2d39194
469440.27,1.0,12,4,2,3,9,0xb2d14f33
475061.28,2.0,49,4,3,2,9,0xb2d5e38bd
9009.36,1.0,6,2,2,3,7,0xb2d52dba
5638.57,1.0,184,2,2,1,5,0xb2d34f4c
42.01,1.0,55,1,2,2,5,0xb2d8d006
120002.01,4.0,11,3,4,3,10,0xb2d94114
0.0,1.0,4,1,2,4,7,0xb2d97d6d
509876.49,5.0,30,4,4,2,10,0xb2d29cccd
1135.08,1.0,184,1,2,1,4,0xb2d1580fd
1003623.76,2.0,33,4,3,2,9,0xb2d9b14a
140088.43,2.0,52,3,3,2,8,0xb2d3391e
257650.04,3.0,105,3,4,1,8,0xb2d65e5dd
40027.44,1.0,18,2,2,2,6,0xb2d7fcb1
104403.5,2.0,143,3,3,1,7,0xb2d4c970d
57757.26,1.0,10,3,2,3,8,0xb2d82674d
1409.74,1.0,19,1,2,2,5,0xb2d923ab
100509.98,2.0,55,3,3,2,8,0xb2d13d04d
72687.51,3.0,45,3,4,2,9,0xb2d59bc6
887043.65,4.0,12,4,4,3,11,0xb2d2702fd
380.76,1.0,5,1,2,3,6,0xb2d9f3fe
50000.0,2.0,34,2,3,2,7,0xb2d1e8f0
200948.74,2.0,11,3,3,3,9,0xb2d0d941
142.55,1.0,10,1,2,3,6,0xb2d37ffed
354.02,1.0,21,1,2,2,5,0xb2d09b2d
210.67,1.0,184,1,2,1,4,0xb2d312f7d
1000000.0,2.0,8,4,3,3,10,0xb2d9a321
61854.32,1.0,0,3,2,4,9,0xb2d2e31ed
141192.4,5.0,25,3,4,2,9,0x3b9b3bd6d
1249.18,1.0,92,1,2,1,4,0xb2d28201d
8.97,1.0,60,1,2,2,5,0xb2d43ce4
0.11,1.0,75,1,2,1,4,0xb2d3e518
200710.44,2.0,43,3,3,2,8,0xb2d9e94d
20689.64,2.0,1,2,3,4,9,0xb2d59075
63334.96,2.0,60,3,3,2,8,0xb2d15855d
3.02,1.0,6,1,2,3,6,0xb2d37ce0
100009.76,2.0,125,3,3,1,7,0xb2d0dbd8
130003.62,5.0,104,3,4,1,8,0xb2d23f9fd
250000.0,2.0,28,3,3,2,8,0xb2da0f59
85.88,1.0,0,1,2,4,7,0xb2d3aed0d
415172.23,3.0,33,4,4,2,10,0xb2d6e0a4d
51493.74,2.0,104,2,3,1,6,0xb2d5ae4bd
2075.79,1.0,10,1,2,3,6,0xb2d598a0d
98253.79,3.0,31,3,4,2,9,0xb2d5954e
202138.76,2.0,106,3,3,1,7,0xb2d95b3cd
500020.04,2.0,13,4,3,3,10,0xb2d9daed
141535.53,5.0,2,3,4,4,11,0xb2d6ac73d
223007.27,2.0,122,3,3,1,7,0xb2d160d4d
1110083.09,11.0,8,4,4,3,11,0xb2d11fff
72.1,1.0,78,1,2,1,4,0xb2d33c8cd
1000272.73,4.0,108,4,4,1,9,0xb2d2531ed
0.48,1.0,8,1,2,3,6,0xb2d54f10d
1112.49,1.0,184,1,2,1,4,0xb2d1c404d
150314.07,3.0,10,3,4,3,10,0xb2d23a26d
302931.1,2.0,92,4,3,1,8,0xb2d6e63fd
1172.25,1.0,158,1,2,1,4,0xb2d24f31d
5399.45,1.0,83,2,2,1,5,0xb2d1c281d
18455.25,1.0,1,2,2,4,8,0xb2d16631
20.99,1.0,8,1,2,3,6,0xb2d8e7d1
1144466.74,5.0,0,4,4,4,12,0xb2d244d1d
500050.23,2.0,4,4,3,4,11,0xb2d8da5ed
6.96,1.0,173,1,2,1,4,0xb2d5c53fd
269749.97,3.0,6,3,4,3,10,0xb2d411d2d
37706.0,2.0,6,2,3,3,8,0xb2d0d4e4d
295113.73,8.0,0,3,4,4,11,0xb2d43a42
5762.63,1.0,131,2,2,1,5,0xb2d60d60d
1928.1,27.0,0,1,4,4,9,0x3b9b45a6d
36218.54,3.0,0,2,4,4,10,0xb2d5305a
5103.27,1.0,184,2,2,1,5,0xb2d07453d
1087.39,1.0,92,1,2,1,4,0xb2d57ee0d
178.86,1.0,1,1,2,4,7,0xb2d89368d
1001.21,1.0,125,1,2,1,4,0xb2d9399e
83695.2,1.0,10,3,2,3,8,0xb2d8fce8
730413.33,6.0,0,4,4,4,12,0xb2d16ec3d
11951.65,1.0,5,2,2,3,7,0xb2d698e5d
0.72,1.0,9,1,2,3,6,0xb2d9db77
703.56,5.0,92,1,4,1,6,0xb2d0a4c3
63028.91,3.0,11,3,4,3,10,0xb2d59581
423.96,1.0,0,1,2,4,7,0xb2d86938d
61524.31,1.0,13,3,2,3,8,0xb2d1037cd
533.6,1.0,36,1,2,2,5,0xb2d5f14d
111875.39,2.0,200,3,3,1,7,0xb2d249bed
1354.42,1.0,92,1,2,1,4,0xb2d33790d
8951.42,1.0,14,2,2,3,7,0xb2d551ca
94.8,1.0,0,1,2,4,7,0xb2d97915
524005.24,4.0,6,4,4,3,11,0xb2d67e76d
0.24,3.0,19,1,4,2,7,0xb2d59c1b
16.19,1.0,0,1,2,4,7,0xb2d6c0c9
501829.37,2.0,39,4,3,2,9,0xb2d78a5f
1518582.53,13.0,6,4,4,3,11,0xb2d1041ad
243767.73,7.0,2,3,4,4,11,0xb2d1edaed
66.25,1.0,4,1,2,4,7,0xb2d6c06bd
0.0,1.0,92,1,2,1,4,0xb2d2ddbbd
1936.42,1.0,9,1,2,3,6,0xb2d4db80d
2030.39,1.0,92,1,2,1,4,0xb2d10f74d
262.59,1.0,63,1,2,2,5,0xb2d0c6bb
102035.21,2.0,102,3,3,1,7,0xb2d57330d
50562.21,1.0,12,2,2,3,7,0xb2d077a4d
3373.39,1.0,166,2,2,1,5,0xb2d3dc57d
1003.99,1.0,13,1,2,3,6,0xb2d678a6d
1006.82,1.0,184,1,2,1,4,0xb2d4218c
1393176.61,3.0,0,4,4,4,12,0xb2d6e02cd
798.01,1.0,82,1,2,1,4,0xb2d5384bd
4352382.4,18.0,5,4,4,3,11,0xb2d33936d
6157.01,1.0,10,2,2,3,7,0xb2d0f11e
0.74,1.0,208,1,2,1,4,0xb2d7865e
9.2,1.0,44,1,2,2,5,0xb2d93374
110012.33,3.0,6,3,4,3,10,0xb2d5f361d
19.0,1.0,34,1,2,2,5,0xb2d66b52
5502.66,2.0,92,2,3,1,6,0xb2d0cb4ed
26000.0,2.0,3,2,3,4,9,0xb2d974cbd
406874.56,6.0,10,4,4,3,11,0xb2d6c8d0d
790023.79,4.0,11,4,4,3,11,0xb2d4ac35d
100824.74,2.0,249,3,3,1,7,0xb2d48b52d
140001.52,3.0,171,3,4,1,8,0xb2d472fad
38020.49,1.0,22,2,2,2,6,0xb2d1cca6d
1020016.47,4.0,63,4,4,2,10,0xb2d5a5afd
104.53,1.0,9,1,2,3,6,0xb2d7861dd
2612.47,1.0,92,1,2,1,4,0xb2d26813d
1993.91,1.0,102,1,2,1,4,0xb2d42e48d
261038.63,10.0,0,3,4,4,11,0xb2d52bbfd
1645066.57,3.0,4,4,4,4,12,0xb2d14fedd
1589000.0,13.0,6,4,4,3,11,0xb2d0c57fd
10301.19,2.0,208,2,3,1,6,0xb2d5a849d
332013.01,3.0,94,4,4,1,9,0xb2d6403dd
375394.88,4.0,69,4,4,1,9,0xb2d574d9d
291.21,1.0,70,1,2,1,4,0xb2d0eee6
340007.57,7.0,0,4,4,4,12,0x3b9b3a4bd
336517.15,3.0,33,4,4,2,10,0xb2d59686d
1.59,1.0,72,1,2,1,4,0xb2d8c760
180798.26,3.0,11,3,4,3,10,0xb2d58b9dd
330.46,1.0,0,1,2,4,7,0xb2d2180b
6864.69,1.0,2,2,2,4,8,0xb2d4571ad
2000169.68,2.0,92,4,3,1,8,0xb2d34154d
643746.18,6.0,11,4,4,3,11,0xb2d0c712d
200.63,1.0,10,1,2,3,6,0xb2da265a
380197.34,4.0,33,4,4,2,10,0xb2d17e8fd
176576.48,3.0,87,3,4,1,8,0xb2d22f06d
426223.87,11.0,0,4,4,4,12,0xb2d642d4d
8.44,1.0,13,1,2,3,6,0xb2d95d15d
211939.87,2.0,11,3,3,3,9,0xb2da0f99
3933.34,1.0,11,2,2,3,7,0xb2d8e70a
1691.18,1.0,92,1,2,1,4,0xb2d0b910d
60004.18,4.0,11,3,4,3,10,0xb2d52b0a
480037.97,2.0,77,4,3,1,8,0xb2d5e9bad
4517.4,1.0,6,2,2,3,7,0xb2d2d2b7d
215.34,1.0,10,1,2,3,6,0xb2d4fea1
4772.11,1.0,184,2,2,1,5,0xb2d2b3cad
100205.32,3.0,0,3,4,4,11,0xb2d18a72d
102.75,1.0,298,1,2,1,4,0xb2d41116d
600000.0,2.0,0,4,3,4,11,0xb2da6bf7
11576.74,1.0,291,2,2,1,5,0xb2d52c0cd
3635.75,1.0,14,2,2,3,7,0xb2d59a1dd
50557.43,2.0,80,2,3,1,6,0xb2d8d07cd
789.88,1.0,9,1,2,3,6,0xb2d2a46c
205092.92,2.0,69,3,3,1,7,0xb2d58bbfd
79.71,1.0,7,1,2,3,6,0xb2d69cd5d
2001.01,1.0,10,1,2,3,6,0xb2d94132
480096.25,4.0,92,4,4,1,9,0xb2d4d372d
1313.1,1.0,39,1,2,2,5,0xb2d36cf9d
500000.02,2.0,25,4,3,2,9,0xb2d6b0fb
58903.89,2.0,25,3,3,2,8,0xb2d16259d
102000.0,5.0,1,3,4,4,11,0xb2d2e8ffd
210518.79,2.0,63,3,3,2,8,0xb2d4278cd
1500034.83,4.0,18,4,4,2,10,0xb2d58eee
70917.63,2.0,181,3,3,1,7,0xb2d5c8f2
400048.59,2.0,206,4,3,1,8,0xb2d68fd5
356011.17,2.0,129,4,3,1,8,0xb2d2aa23
92.88,1.0,1,1,2,4,7,0xb2d7ee93
950598.33,2.0,21,4,3,2,9,0xb2d067bdd
47797.9,1.0,6,2,2,3,7,0xb2d220a9d
154937.52,1.0,8,3,2,3,8,0xb2d420d6
614288.41,3.0,1,4,4,4,12,0x3b9b42ddd
4384.74,1.0,26,2,2,2,6,0xb2d303d6
40000.42,2.0,92,2,3,1,6,0xb2d980f8
72.29,1.0,5,1,2,3,6,0xb2d35350
130051.26,6.0,10,3,4,3,10,0xb2d08689d
200005.8,2.0,25,3,3,2,8,0xb2d8f71bd
260141.41,3.0,1,3,4,4,11,0xb2d1bd7f
173.24,1.0,0,1,2,4,7,0xb2d4ef5b
380012.03,2.0,92,4,3,1,8,0xb2d97dff
107420.73,1.0,182,3,2,1,6,0xb2d551b3
4.8,1.0,35,1,2,2,5,0xb2d25848d
500000.0,2.0,13,4,3,3,10,0xb2d96086
1128648.03,2.0,76,4,3,1,8,0xb2d4ea0ad
600006.77,7.0,16,4,4,2,10,0xb2d12caad
7080.56,1.0,92,2,2,1,5,0xb2d590f4d
289135.66,11.0,0,3,4,4,11,0xb2d2e3f1d
1403.19,1.0,1,1,2,4,7,0xb2d69319
7041.99,1.0,5,2,2,3,7,0xb2d2dda9d
853285.0,14.0,0,4,4,4,12,0x3b9af149
4045.7,1.0,184,2,2,1,5,0x3b9b366ed
12010.42,1.0,1,2,2,4,8,0xb2d53503d
42001.85,2.0,18,2,3,2,7,0xb2d48d89
253146.59,2.0,174,3,3,1,7,0xb2d5a773d
200021.17,2.0,13,3,3,3,9,0xb2d8d62d
714039.32,5.0,7,4,4,3,11,0xb2d4f555d
20050.43,2.0,2,2,3,4,9,0xb2d8c607d
264.28,1.0,0,1,2,4,7,0xb2d63627d
70199.69,1.0,92,3,2,1,6,0xb2d59610
97707.16,2.0,26,3,3,2,8,0xb2d36df4d
619440.21,5.0,139,4,4,1,9,0xb2d11ff2
71071.34,3.0,24,3,4,2,9,0xb2d11068d
3917.34,2.0,0,2,3,4,9,0x3b9b1bffd
170737.91,3.0,80,3,4,1,8,0xb2d60b82d
1105.1,1.0,143,1,2,1,4,0xb2d69a03
245012.03,8.0,6,3,4,3,10,0xb2d0feae
19806.04,1.0,180,2,2,1,5,0xb2d11623
10656.36,2.0,7,2,3,3,8,0x3b9aea5c
59.92,1.0,27,1,2,2,5,0xb2d6de10d
203221.0,4.0,139,3,4,1,8,0xb2d51b25d
600770.0,7.0,1,4,4,4,12,0xb2d147ded
3034.24,1.0,6,2,2,3,7,0xb2d2aaf4
978.13,1.0,1,1,2,4,7,0xb2d56646
1144.01,1.0,184,1,2,1,4,0xb2d3f181d
100017.87,2.0,104,3,3,1,7,0xb2d5f58d
78.96,1.0,0,1,2,4,7,0xb2d31053
1227.93,1.0,77,1,2,1,4,0xb2d29ad6
331936.21,7.0,0,4,4,4,12,0xb2d56e88
46437.37,1.0,184,2,2,1,5,0xb2d0ee4bd
9006.96,2.0,18,2,3,2,7,0xb2d689a8d
52611.9,2.0,97,3,3,1,7,0xb2d51499d
2027701.74,6.0,0,4,4,4,12,0xb2d6d090d
250008.18,5.0,32,3,4,2,9,0x3b9b3d65
10325.31,1.0,1,2,2,4,8,0xb2d6b222
400021.16,3.0,32,4,4,2,10,0xb2d5e718d
2801.17,1.0,0,1,2,4,7,0xb2d70022
176000.0,5.0,1,3,4,4,11,0xb2d3b4f2d
1646061.62,6.0,21,4,4,2,10,0xb2d103e7d
401420.83,2.0,39,4,3,2,9,0xb2d9f570
2948074.23,4.0,0,4,4,4,12,0xb2d5007c
7004.41,1.0,1,2,2,4,8,0xb2d3bdbad
30002.11,2.0,188,2,3,1,6,0xb2d62545
53031.66,2.0,118,3,3,1,7,0xb2d4a716d
600043.05,6.0,112,4,4,1,9,0xb2d5cc90d
614.27,1.0,26,1,2,2,5,0xb2d3089c
100012.04,3.0,59,3,4,2,9,0xb2d2932e
2600215.91,8.0,27,4,4,2,10,0xb2d8ea83d
1300020.78,5.0,0,4,4,4,12,0xb2d8cbd8d
1596139.48,8.0,10,4,4,3,11,0xb2d3ffcfd
559624.02,11.0,1,4,4,4,12,0x3b9b1917d
7986.03,1.0,1,2,2,4,8,0xb2d2db0dd
6382.95,1.0,92,2,2,1,5,0xb2d558d0
119219.43,1.0,184,3,2,1,6,0xb2d2729dd
187316.94,1.0,6,3,2,3,8,0xb2d94dc5d
1296079.75,8.0,5,4,4,3,11,0xb2d38164
20.45,1.0,24,1,2,2,5,0xb2d6b91e
7006.21,1.0,1,2,2,4,8,0xb2d6fd2cd
72073.29,1.0,5,3,2,3,8,0xb2d26477
25.31,1.0,81,1,2,1,4,0xb2d62eba
88.12,1.0,20,1,2,2,5,0xb2d2dd5b
800023.48,5.0,0,4,4,4,12,0xb2d78a62d
500000.84,3.0,12,4,4,3,11,0xb2d98e05
747772.39,3.0,18,4,4,2,10,0xb2d1c4c1
29760.46,2.0,1,2,3,4,9,0x3b9b349ad
120156.18,3.0,0,3,4,4,11,0xb2d0d5fed
590.51,1.0,15,1,2,3,6,0xb2d28a74
350040.12,3.0,8,4,4,3,11,0xb2d2cf51d
485.45,1.0,41,1,2,2,5,0xb2d1dbefd
257.66,1.0,23,1,2,2,5,0xb2d6c69ed
20044.88,3.0,18,2,4,2,8,0xb2d43840d
220002.4,2.0,126,3,3,1,7,0xb2d52b28d
197.24,1.0,8,1,2,3,6,0xb2d591aed
887515.56,5.0,11,4,4,3,11,0xb2d60b74d
10291.57,1.0,84,2,2,1,5,0xb2d59451
173499.27,2.0,10,3,3,3,9,0x3b9b39bcd
114.07,1.0,6,1,2,3,6,0xb2d2c7a5d
6496.38,1.0,21,2,2,2,6,0xb2d963fd
500822.42,3.0,5,4,4,3,11,0xb2d2dd5dd
5059.44,1.0,184,2,2,1,5,0xb2d2843dd
80093.46,2.0,25,3,3,2,8,0xb2d13f4ed
11.68,1.0,4,1,2,4,7,0xb2d59427
60004.46,2.0,10,3,3,3,9,0xb2d60470d
23000.95,2.0,73,2,3,1,6,0xb2d5d15cd
22.96,1.0,76,1,2,1,4,0xb2d93395
1233.33,1.0,92,1,2,1,4,0xb2d1504dd
30006.72,1.0,0,2,2,4,8,0xb2d9526bd
31498.99,5.0,0,2,4,4,10,0x3b9af3de
1261.41,1.0,184,1,2,1,4,0xb2d071ec
20066.01,1.0,92,2,2,1,5,0xb2d5dfa9d
163351.62,3.0,1,3,4,4,11,0xb2d4d11bd
1314.11,1.0,92,1,2,1,4,0xb2d1772dd
76399.82,3.0,92,3,4,1,8,0x3b9b157ed
353.96,1.0,55,1,2,2,5,0xb2d2d63bd
1423664.78,10.0,11,4,4,3,11,0xb2d4ff97d
66869.94,4.0,4,3,4,4,11,0xb2d0fac1d
1008.3,1.0,92,1,2,1,4,0xb2d213fbd
160050.15,3.0,80,3,4,1,8,0xb2d622ebd
48796.11,10.0,15,2,4,3,9,0xb2d2a185d
100004.22,2.0,48,3,3,2,8,0xb2d90fa9
10892.56,1.0,130,2,2,1,5,0xb2d57d29
200012.45,3.0,32,3,4,2,9,0xb2d9f551
2.69,1.0,75,1,2,1,4,0xb2d694c3
175442.67,5.0,13,3,4,3,10,0xb2d1db95d
276918.08,3.0,3,3,4,4,11,0xb2d3ca8ad
14482.18,1.0,0,2,2,4,8,0xb2d6b845
70552.64,4.0,74,3,4,1,8,0xb2d8d9e7
57632.88,1.0,21,3,2,2,7,0xb2d0e2aed
6989.72,1.0,184,2,2,1,5,0xb2d31276d
51.42,1.0,0,1,2,4,7,0xb2d86811d
129.71,1.0,56,1,2,2,5,0xb2d9bf2c
1348347.77,5.0,28,4,4,2,10,0xb2d22df9d
18.48,1.0,39,1,2,2,5,0xb2d68607
1397000.0,17.0,0,4,4,4,12,0xb2d69605
434255.66,3.0,104,4,4,1,9,0xb2d3f324d
475105.09,2.0,90,4,3,1,8,0xb2d96e14d
10509.84,1.0,10,2,2,3,7,0xb2d6ea5dd
998064.22,14.0,1,4,4,4,12,0xb2d0d484d
5.3,1.0,10,1,2,3,6,0xb2da0de5
6882.26,1.0,5,2,2,3,7,0xb2d3ea34
2504.32,1.0,1,1,2,4,7,0xb2d48c2d
218162.94,2.0,133,3,3,1,7,0xb2d3f184
200038.2,2.0,0,3,3,4,10,0xb2d6e7af
576199.14,5.0,21,4,4,2,10,0xb2d1be58d
803462.78,7.0,6,4,4,3,11,0xb2d55115d
774433.1,3.0,0,4,4,4,12,0xb2d57399d
6737.82,2.0,20,2,3,2,7,0xb2d267a6
20000.84,2.0,55,2,3,2,7,0xb2d900fed
500752.51,3.0,21,4,4,2,10,0xb2d6df92d
20140.71,1.0,5,2,2,3,7,0xb2d2ac44d
150000.86,3.0,0,3,4,4,11,0xb2d5c921d
160002.55,5.0,12,3,4,3,10,0xb2d65104d
241696.79,8.0,18,3,4,2,9,0xb2d0d30dd
274464.31,6.0,1,3,4,4,11,0xb2d23f26d
460094.74,2.0,1,4,3,4,11,0xb2d59b1ed
300000.0,2.0,26,3,3,2,8,0xb2da14bd
500710.99,3.0,12,4,4,3,11,0xb2d5fdd5d
307001.48,4.0,6,4,4,3,11,0xb2d95403d
200342.62,1.0,80,3,2,1,6,0xb2d1a776d
113620.34,1.0,4,3,2,4,9,0xb2d347c0d
400401.62,4.0,25,4,4,2,10,0xb2d992b5
7376794.53,1.0,0,4,2,4,10,0xb2d2bc56d
30000.63,2.0,80,2,3,1,6,0xb2d98c1d
101126.31,3.0,0,3,4,4,11,0xb2d08daed
2390056.96,13.0,8,4,4,3,11,0xb2d4f521d
426430.28,12.0,8,4,4,3,11,0xb2d67f02d
43908.31,1.0,0,2,2,4,8,0xb2d6addad
80056.52,2.0,1,3,3,4,10,0xb2da1eab
0.63,1.0,92,1,2,1,4,0xb2d2882f
133.46,2.0,11,1,3,3,7,0xb2d933f3d
4.76,1.0,14,1,2,3,6,0xb2d2928e
500064.32,2.0,20,4,3,2,9,0xb2d8d3aad
983.11,1.0,79,1,2,1,4,0xb2d5bdecd
4000.92,1.0,4,2,2,4,8,0xb2d8042fd
51001.85,2.0,32,2,3,2,7,0xb2d63f7c
128.41,1.0,67,1,2,1,4,0xb2d15a6f
16.2,1.0,20,1,2,2,5,0xb2d2f1b0
436678.89,2.0,7,4,3,3,10,0xb2d304d9
384025.74,6.0,3,4,4,4,12,0xb2d2154c
1380518.7,5.0,3,4,4,4,12,0xb2d63796d
355501.79,3.0,32,4,4,2,10,0xb2d297df
280032.87,3.0,34,3,4,2,9,0xb2d4c8ebd
50002.11,2.0,83,2,3,1,6,0xb2d5e92a
503552.98,2.0,80,4,3,1,8,0xb2d99394
564.91,1.0,0,1,2,4,7,0xb2d261b2d
380003.16,3.0,28,4,4,2,10,0xb2d9c5ab
646634.49,18.0,13,4,4,3,11,0xb2d0b9cad
363028.7,5.0,14,4,4,3,11,0xb2d1aa6cd
50001.58,2.0,73,2,3,1,6,0xb2d62a7ad
2861273.38,21.0,8,4,4,3,11,0xb2d1b750
3255.27,1.0,6,2,2,3,7,0xb2d6ef78d
42193.1,1.0,0,2,2,4,8,0xb2d28db2d
4010.92,1.0,13,2,2,3,7,0xb2d31de3d
91701.67,1.0,77,3,2,1,6,0xb2d26ab3d
0.67,1.0,167,1,2,1,4,0xb2d3a8a1
284.45,1.0,26,1,2,2,5,0xb2d91f67
2000063.33,3.0,49,4,4,2,10,0xb2d9d107
200012.09,3.0,111,3,4,1,8,0xb2d61c45d
8341.29,1.0,2,2,2,4,8,0xb2d16701
615324.66,9.0,27,4,4,2,10,0xb2d1047fd
370.95,1.0,70,1,2,1,4,0xb2d59119d
324561.37,3.0,87,4,4,1,9,0xb2d29438
17.39,1.0,6,1,2,3,6,0xb2d2fd98d
119642.68,3.0,1,3,4,4,11,0xb2d24016d
350685.95,1.0,158,4,2,1,7,0xb2d604c9d
60097.02,2.0,122,3,3,1,7,0xb2d65dffd
6717.94,1.0,121,2,2,1,5,0xb2d6bf19d
170765.72,5.0,1,3,4,4,11,0xb2d61b9cd
50017.81,6.0,21,2,4,2,8,0xb2d618dad
1112.23,1.0,10,1,2,3,6,0xb2d3af11
203041.56,2.0,40,3,3,2,8,0xb2d6b76dd
57517.48,1.0,10,3,2,3,8,0xb2d9493a
100005.17,2.0,8,3,3,3,9,0xb2d7ee9ad
47002.79,1.0,0,2,2,4,8,0xb2d912f3d
4764.11,1.0,151,2,2,1,5,0xb2d3500d
361199.7,3.0,3,4,4,4,12,0xb2d16f2bd
4.22,1.0,4,1,2,4,7,0xb2da3343
39.14,1.0,26,1,2,2,5,0xb2d9b5f4
2300150.23,5.0,11,4,4,3,11,0xb2d50e66
466261.17,1.0,5,4,2,3,9,0xb2d95f12
98.63,1.0,22,1,2,2,5,0xb2d950b4
305000.25,8.0,3,4,4,4,12,0xb2d5725e
192.85,1.0,88,1,2,1,4,0xb2d1f77e
5057.77,1.0,184,2,2,1,5,0xb2d2d75b
1563.52,2.0,178,1,3,1,5,0xb2d358d2d
17552.02,1.0,9,2,2,3,7,0xb2d39931d
1000010.56,2.0,34,4,3,2,9,0xb2d942ed
2942.64,1.0,184,2,2,1,5,0xb2d3ac5bd
1193.06,1.0,10,1,2,3,6,0xb2d8cad4
51314.94,1.0,0,2,2,4,8,0xb2d64459
10578.29,1.0,0,2,2,4,8,0xb2d2eadd
200056.61,3.0,0,3,4,4,11,0xb2d12e8ad
472008.97,13.0,5,4,4,3,11,0xb2d10a11d
10361.99,2.0,21,2,3,2,7,0xb2d53df1d
283076.24,5.0,108,3,4,1,8,0xb2d5d290d
609945.74,8.0,4,4,4,4,12,0xb2d1d9e2d
8.16,1.0,3,1,2,4,7,0xb2d63b11d
433915.45,3.0,67,4,4,1,9,0xb2d381ced
2237184.72,43.0,4,4,4,4,12,0xb2d26445d
2649.71,1.0,9,1,2,3,6,0xb2d42423
1155.04,1.0,2,1,2,4,7,0xb2d2008a
96576.45,2.0,136,3,3,1,7,0xb2d609ebd
102164.22,3.0,13,3,4,3,10,0xb2d5bff7d
899.19,1.0,0,1,2,4,7,0xb2d8f20f
201154.5,2.0,22,3,3,2,8,0xb2d69916d
1062197.84,4.0,0,4,4,4,12,0xb2d92a5cd
780040.09,3.0,18,4,4,2,10,0xb2d08875d
300012.67,2.0,14,3,3,3,9,0xb2da349d
579984.87,2.0,43,4,3,2,9,0xb2d0811ad
10000.11,2.0,14,2,3,3,8,0xb2da37a8
11747.63,1.0,0,2,2,4,8,0xb2d3f390
3323.75,3.0,10,2,4,3,9,0xb2d40fab
451598.69,2.0,55,4,3,2,9,0xb2d9089cd
30239.02,2.0,83,2,3,1,6,0xb2d62315d
475398.6,5.0,3,4,4,4,12,0xb2d25f7bd
107618.5,2.0,9,3,3,3,9,0xb2d6e6d5
16.88,1.0,56,1,2,2,5,0xb2d99d19
44.52,1.0,8,1,2,3,6,0xb2d2d972
212472.45,2.0,25,3,3,2,8,0xb2d3b8a4d
7050192.68,4.0,31,4,4,2,10,0xb2d151a0d
1312.87,1.0,23,1,2,2,5,0xb2d23d93
305026.34,3.0,24,4,4,2,10,0xb2d649fdd
115075.58,5.0,41,3,4,2,9,0xb2d5de9e
3103.75,3.0,77,2,4,1,7,0xb2d37f0a
50191.37,2.0,67,2,3,1,6,0xb2d56f94
2300000.0,2.0,92,4,3,1,8,0xb2d5a59dd
2042.46,1.0,2,1,2,4,7,0xb2d83c70d
20161.87,1.0,28,2,2,2,6,0xb2d6d704d
24191.16,5.0,129,2,4,1,7,0x3b9adb4dd
1831.41,1.0,49,1,2,2,5,0xb2d92675
706.03,4.0,19,1,4,2,7,0xb2d9a3c0
488934.47,4.0,1,4,4,4,12,0xb2d16fe1d
100032.69,3.0,4,3,4,4,11,0xb2d10ee0
1527.01,1.0,216,1,2,1,4,0xb2d598e6d
330056.11,2.0,92,4,3,1,8,0xb2d4eed9d
2.82,1.0,1,1,2,4,7,0xb2d6f2f9d
32413.35,1.0,18,2,2,2,6,0xb2d68645d
4523.03,1.0,1,2,2,4,8,0xb2d6f0c4
18.79,1.0,25,1,2,2,5,0xb2d9c914
6569.79,1.0,10,2,2,3,7,0xb2d304bcd
2591000.0,10.0,0,4,4,4,12,0xb2d0f54fd
52035.43,2.0,87,2,3,1,6,0xb2d59105d
52095.25,2.0,60,2,3,2,7,0xb2d65a70d
371033.5,2.0,6,4,3,3,10,0xb2d594f0d
10.41,11.0,31,1,4,2,7,0x3b9ada60
1617926.32,17.0,0,4,4,4,12,0xb2d07a6ed
89.3,1.0,77,1,2,1,4,0xb2d694ea
150067.15,3.0,158,3,4,1,8,0xb2d11db7
307.66,1.0,20,1,2,2,5,0xb2d5ba5c
2795.24,1.0,92,1,2,1,4,0xb2d0db2ed
1060.5,1.0,92,1,2,1,4,0xb2d06bc9d
12504.11,5.0,8,2,4,3,9,0xb2d2afd3d
3077.79,1.0,2,2,2,4,8,0xb2d327d2
28.13,1.0,74,1,2,1,4,0xb2d96ec8
304731.03,3.0,1,4,4,4,12,0xb2d6db13d
210747.06,2.0,17,3,3,2,8,0xb2d90703
257870.75,3.0,95,3,4,1,8,0xb2d257bbd
170083.25,3.0,18,3,4,2,9,0xb2d64ef0d
43005.66,4.0,56,2,4,2,8,0xb2d2b1fb
556057.08,10.0,11,4,4,3,11,0xb2d11939
31.68,3.0,77,1,4,1,6,0xb2d33258
1496.38,1.0,0,1,2,4,7,0xb2d6af6d
1716815.08,4.0,24,4,4,2,10,0xb2d2266ed
2.04,1.0,5,1,2,3,6,0xb2d6d6f0
468683.8,4.0,1,4,4,4,12,0xb2d63bcdd
20225.21,2.0,213,2,3,1,6,0xb2d5f6a2d
231160.59,3.0,59,3,4,2,9,0xb2d5cdd4
6.93,1.0,0,1,2,4,7,0xb2d418ea
19881.99,1.0,15,2,2,3,7,0xb2d68cb6
6122.41,1.0,8,2,2,3,7,0xb2d57cd8
1390009.99,7.0,110,4,4,1,9,0xb2d2cfc6
22176.85,1.0,92,2,2,1,5,0xb2d36652d
91014.95,3.0,21,3,4,2,9,0xb2d2aaba
205833.38,2.0,92,3,3,1,7,0xb2d65246d
310009.94,3.0,112,4,4,1,9,0xb2d91894d
1.13,1.0,25,1,2,2,5,0xb2d7ee30d
10000.21,2.0,193,2,3,1,6,0xb2d78a6f
551332.5,3.0,0,4,4,4,12,0xb2d0c2dbd
1015.1,1.0,92,1,2,1,4,0xb2d2748ed
494064.68,14.0,0,4,4,4,12,0xb2d2663ad
579055.25,14.0,0,4,4,4,12,0x3b9b1c00d
0.8,1.0,75,1,2,1,4,0xb2d3ea24d
187.7,1.0,3,1,2,4,7,0xb2d48c71
200068.9,2.0,171,3,3,1,7,0xb2d24a17
260061.17,3.0,34,3,4,2,9,0xb2d6ea4ad
44611.47,1.0,3,2,2,4,8,0xb2d1c1e3d
501691.71,3.0,8,4,4,3,11,0xb2d5dd89
112.61,1.0,67,1,2,1,4,0xb2d633b7d
60047.36,3.0,98,3,4,1,8,0xb2d826f4d
2708.15,1.0,0,1,2,4,7,0xb2d54f31
203941.94,2.0,34,3,3,2,8,0xb2d4d08dd
38.99,1.0,6,1,2,3,6,0xb2da316d
706075.45,6.0,0,4,4,4,12,0xb2d5bf28
1073.36,1.0,92,1,2,1,4,0xb2d11811
210000.0,2.0,21,3,3,2,8,0xb2d986a3
21266.27,1.0,0,2,2,4,8,0xb2d6dbce
65767.52,2.0,0,3,3,4,10,0x3b9b348d
29.12,1.0,83,1,2,1,4,0xb2d22685d
32.91,1.0,79,1,2,1,4,0xb2d27f7b
223239.97,2.0,122,3,3,1,7,0xb2d1b11ed
17930.46,1.0,5,2,2,3,7,0xb2d942d6
1570010.44,7.0,15,4,4,3,11,0xb2d17ef1
500000.0,2.0,7,4,3,3,10,0xb2da57e7
173500.63,3.0,3,3,4,4,11,0xb2d911c0
100001.06,2.0,74,3,3,1,7,0xb2d99fd3
2058.5,1.0,50,1,2,2,5,0xb2d29d86
9.55,1.0,39,1,2,2,5,0xb2d9805c
235.99,1.0,10,1,2,3,6,0xb2d9b051
500004.22,3.0,10,4,4,3,11,0xb2d963add
550053.53,3.0,102,4,4,1,9,0xb2d62ddf
369000.0,7.0,0,4,4,4,12,0x3b9b1a37d
204299.56,2.0,139,3,3,1,7,0xb2d5df6dd
20109.67,1.0,75,2,2,1,5,0xb2d396d1d
400000.0,1.0,3,4,2,4,10,0xb2da6569
50073.17,2.0,39,2,3,2,7,0xb2d603cbd
1523281.32,6.0,9,4,4,3,11,0xb2d6c8fdd
179483.02,5.0,0,3,4,4,11,0xb2d617c4
400000.0,3.0,0,4,4,4,12,0xb2d1b2d5d
53984.39,1.0,21,3,2,2,7,0xb2d2ce80d
16.69,1.0,14,1,2,3,6,0xb2d400bf
45.05,1.0,78,1,2,1,4,0xb2d688d1d
2206352.93,18.0,5,4,4,3,11,0xb2d5e7a6d
1010230.62,1.0,146,4,2,1,7,0xb2d54f21
1000010.56,2.0,24,4,3,2,9,0xb2d94aedd
30000.0,3.0,167,2,4,1,7,0xb2d6b6f0
295936.5,4.0,15,3,4,3,10,0xb2d14ed8d
3960.33,1.0,0,2,2,4,8,0xb2d0bf52d
370269.16,2.0,174,4,3,1,8,0xb2d15276
51688.42,1.0,92,2,2,1,5,0xb2d13fd1d
180121.91,2.0,116,3,3,1,7,0xb2d435a1d
12.0,1.0,24,1,2,2,5,0xb2d5e56c
13113.46,1.0,184,2,2,1,5,0xb2d26a2cd
100002.68,2.0,59,3,3,2,8,0xb2d21797d
45680.53,1.0,10,2,2,3,7,0xb2d49bebd
1867.21,1.0,22,1,2,2,5,0xb2d20f44d
31350.0,1.0,41,2,2,2,6,0xb2d8df0a
467529.42,7.0,6,4,4,3,11,0xb2d1b545d
1210.15,3.0,11,1,4,3,8,0xb2d15519d
3085.21,1.0,184,2,2,1,5,0xb2d51fb3
10000.0,2.0,12,2,3,3,8,0xb2d95b9d
490000.62,4.0,7,4,4,3,11,0xb2d606d4d
200721.23,2.0,46,3,3,2,8,0xb2d9e152
695161.04,2.0,179,4,3,1,8,0xb2d248fad
1694.01,1.0,2,1,2,4,7,0xb2d3ca70
20057.9,1.0,284,2,2,1,5,0xb2d6a65bd
115017.15,4.0,11,3,4,3,10,0xb2d5de9ed
3673.54,1.0,92,2,2,1,5,0xb2d08152d
180037.28,3.0,0,3,4,4,11,0xb2d1959bd
401509.66,2.0,4,4,3,4,11,0xb2d8ed0d
770061.22,4.0,167,4,4,1,9,0xb2d21462
17182.89,1.0,46,2,2,2,6,0xb2d27ccf
306433.79,2.0,185,4,3,1,8,0xb2d6a8ead
270.35,1.0,78,1,2,1,4,0xb2d2d4ce
200941.61,3.0,46,3,4,2,9,0xb2d716a3d
50.86,2.0,6,1,3,3,7,0xb2d4e872d
460056.63,3.0,111,4,4,1,9,0xb2d27af1
15647.38,1.0,9,2,2,3,7,0xb2d78083d
50088.48,2.0,209,2,3,1,6,0xb2d5b58bd
63556.36,6.0,3,3,4,4,11,0xb2d38271
303379.37,3.0,1,4,4,4,12,0xb2d3f3a5d
24.12,1.0,75,1,2,1,4,0xb2d3e1b3
240200.31,3.0,6,3,4,3,10,0xb2d64a8bd
593517.22,3.0,32,4,4,2,10,0xb2d1226a
600010.06,7.0,25,4,4,2,10,0xb2d07aebd
4567.99,1.0,184,2,2,1,5,0xb2d15af8d
3703.35,1.0,0,2,2,4,8,0xb2d59d2e
100002.65,3.0,8,3,4,3,10,0xb2d5991d
172337.64,2.0,15,3,3,3,9,0xb2d36a1dd
1000398.16,1.0,0,4,2,4,10,0xb2d1aef0d
1077.47,1.0,92,1,2,1,4,0x3b9b439cd
0.37,1.0,19,1,2,2,5,0xb2d953a3d
100102.15,2.0,56,3,3,2,8,0xb2d3afefd
70086.24,2.0,79,3,3,1,7,0xb2d1a0ad
600019.02,2.0,102,4,3,1,8,0xb2d96169d
710526.1,5.0,0,4,4,4,12,0xb2d3d57cd
1000103.95,2.0,189,4,3,1,8,0xb2d158e6d
30166.78,4.0,0,2,4,4,10,0xb2d29b85d
256160.36,5.0,77,3,4,1,8,0xb2d5a05ed
464193.53,4.0,17,4,4,2,10,0xb2d06fa8d
8000.0,1.0,9,2,2,3,7,0xb2d1f3bed
4977.6,1.0,9,2,2,3,7,0xb2d3382d
50069.0,4.0,0,2,4,4,10,0xb2d54e0cd
122119.32,4.0,6,3,4,3,10,0xb2d568bed
21606.23,1.0,184,2,2,1,5,0xb2d0baf2
1351.35,1.0,184,1,2,1,4,0xb2d1102dd
500149.7,6.0,48,4,4,2,10,0xb2d14cc1
219368.25,10.0,0,3,4,4,11,0xb2d599c3
152.18,1.0,54,1,2,2,5,0xb2d64b3f
530244.77,7.0,3,4,4,4,12,0xb2d52913d
900.52,1.0,1,1,2,4,7,0xb2d40636
708764.52,3.0,9,4,4,3,11,0xb2d316aed
1370.79,1.0,92,1,2,1,4,0xb2d40cb8d
330156.99,8.0,2,4,4,4,12,0xb2d562fbd
48.57,1.0,34,1,2,2,5,0xb2d6baaf
1549.75,1.0,200,1,2,1,4,0xb2d3a25ed
19149.95,1.0,8,2,2,3,7,0xb2d12704
2790372.2,4.0,47,4,4,2,10,0xb2d34bc0d
200010.45,2.0,21,3,3,2,8,0xb2d9cce9
50000.53,2.0,14,2,3,3,8,0xb2da3795
2798.65,1.0,7,1,2,3,6,0xb2d13c70d
15611.08,1.0,184,2,2,1,5,0xb2d2bf55
23.97,1.0,0,1,2,4,7,0xb2d9d035
3394455.96,1.0,0,4,2,4,10,0xb2d1fdc5d
21603.3,1.0,4,2,2,4,8,0xb2d62181d
240883.21,2.0,11,3,3,3,9,0xb2d964f8d
1100136.62,3.0,1,4,4,4,12,0xb2d925e7d
300000.0,7.0,3,3,4,4,11,0xb2d2d1a5
200000.0,2.0,15,3,3,3,9,0xb2da3a11
789003.66,4.0,42,4,4,2,10,0xb2d1a5eed
291003.07,2.0,48,3,3,2,8,0xb2d91246
70027.46,3.0,24,3,4,2,9,0xb2d582ecd
42060.51,3.0,116,2,4,1,7,0xb2d6c996d
1027.47,1.0,184,1,2,1,4,0xb2d26eddd
10682.92,1.0,0,2,2,4,8,0xb2d1dabdd
1650117.71,15.0,0,4,4,4,12,0xb2d548f9d
100027.38,2.0,0,3,3,4,10,0xb2d3604dd
160090.96,3.0,110,3,4,1,8,0xb2d2d944
70495.18,1.0,31,3,2,2,7,0xb2d37ccd
12525.89,1.0,0,2,2,4,8,0xb2d8a676d
2.69,1.0,63,1,2,2,5,0xb2d60cead
710067.5,5.0,7,4,4,3,11,0xb2d6d0acd
9398.76,1.0,92,2,2,1,5,0xb2d0d430d
1210.66,1.0,141,1,2,1,4,0xb2d63391d
511.62,3.0,92,1,4,1,6,0xb2d2bf8f
102800.12,2.0,0,3,3,4,10,0xb2d58911d
453643.08,2.0,0,4,3,4,11,0xb2d12c76
1832.57,1.0,18,1,2,2,5,0xb2d4c84cd
535.52,1.0,18,1,2,2,5,0xb2d19a43d
51678.86,1.0,4,2,2,4,8,0xb2d68d0ad
18986.1,1.0,9,2,2,3,7,0xb2d31421d
545072.43,5.0,1,4,4,4,12,0x3b9ad0c4
352028.85,13.0,0,4,4,4,12,0xb2d252ed
726206.03,1.0,0,4,2,4,10,0xb2d965a4d
1050024.57,3.0,183,4,4,1,9,0xb2d27805d
250204.23,3.0,1,3,4,4,11,0xb2d5e69d
250108.42,2.0,221,3,3,1,7,0xb2d1bb4c
547837.81,9.0,6,4,4,3,11,0xb2d593fdd
100022.89,2.0,172,3,3,1,7,0xb2d2a9a6
191418.5,3.0,31,3,4,2,9,0xb2d6430ed
16963.82,1.0,0,2,2,4,8,0xb2d128d8d
281841.77,3.0,14,3,4,3,10,0xb2d432fdd
92.3,1.0,21,1,2,2,5,0xb2d2c0ec
51879.63,1.0,113,2,2,1,5,0xb2d3bf76d
4263.91,1.0,184,2,2,1,5,0x3b9b4419
1848.05,1.0,2,1,2,4,7,0xb2d65220d
430014.16,5.0,1,4,4,4,12,0xb2d95e7cd
239059.56,2.0,98,3,3,1,7,0xb2d5a45bd
203386.15,3.0,5,3,4,3,10,0xb2d5b2e2
57.02,2.0,0,1,3,4,8,0x3b9b2344d
1038.08,1.0,184,1,2,1,4,0xb2d3283fd
8.83,1.0,14,1,2,3,6,0xb2d303bd
5.91,1.0,9,1,2,3,6,0xb2d79082d
6.11,1.0,90,1,2,1,4,0xb2d6cf57
256006.02,6.0,10,3,4,3,10,0xb2d50cfa
2.33,1.0,14,1,2,3,6,0xb2d26bae
1085201.92,13.0,13,4,4,3,11,0xb2d56c17d
56.61,1.0,13,1,2,3,6,0xb2d4239cd
50000.53,2.0,42,2,3,2,7,0xb2d9e6cc
21192.97,1.0,92,2,2,1,5,0xb2d0baf2d
10335.65,1.0,0,2,2,4,8,0xb2d6b0c1d
1.41,1.0,82,1,2,1,4,0xb2d6549c
50874.18,2.0,171,2,3,1,6,0xb2d5fc0f
1536.01,1.0,118,1,2,1,4,0xb2d5090ed
466.47,1.0,9,1,2,3,6,0xb2d88d1d
368.55,1.0,10,1,2,3,6,0xb2d6bf54
742121.04,2.0,31,4,3,2,9,0xb2d31ab8d
1024.46,1.0,126,1,2,1,4,0xb2d91f8dd
21320.24,1.0,0,2,2,4,8,0xb2d2ae30
397239.58,6.0,0,4,4,4,12,0xb2d0a458d
2709813.35,15.0,0,4,4,4,12,0x3b9ae4abd
124975.76,1.0,3,3,2,4,9,0xb2d0d02f
1208.77,1.0,92,1,2,1,4,0xb2d2f207d
1065.81,1.0,6,1,2,3,6,0xb2d92984
10000.37,2.0,11,2,3,3,8,0xb2d63f94
208451.86,4.0,95,3,4,1,8,0xb2d4f931d
132.0,1.0,0,1,2,4,7,0xb2d2b0cfd
6670.98,1.0,184,2,2,1,5,0xb2d2df48d
2878.95,1.0,6,1,2,3,6,0xb2d62167d
562004.96,7.0,7,4,4,3,11,0xb2d41049d
39.5,1.0,20,1,2,2,5,0xb2d68c7ed
2250036.07,4.0,83,4,4,1,9,0xb2d4e86a
2882.4,1.0,10,1,2,3,6,0xb2d4806e
1585.97,1.0,1,1,2,4,7,0xb2d3536a
100035.53,6.0,13,3,4,3,10,0xb2d5e47cd
167075.38,2.0,41,3,3,2,8,0xb2d279ebd
744002.75,7.0,1,4,4,4,12,0xb2d4c272
5311.29,1.0,114,2,2,1,5,0xb2d6c2f6
301.27,1.0,9,1,2,3,6,0xb2d8dd34
425268.84,4.0,33,4,4,2,10,0xb2d16991
2804.68,1.0,0,1,2,4,7,0xb2d1a428
200775.64,3.0,37,3,4,2,9,0xb2d4cb67d
1271.02,1.0,184,1,2,1,4,0xb2d22cbad
301065.73,2.0,19,4,3,2,9,0xb2d91249d
12455.53,1.0,10,2,2,3,7,0xb2d8d3edd
5.81,1.0,32,1,2,2,5,0xb2d993a6
10561.1,1.0,0,2,2,4,8,0xb2d6d996
10003.23,1.0,11,2,2,3,7,0xb2da3181
565413.16,3.0,0,4,4,4,12,0xb2d24176
1142130.04,8.0,25,4,4,2,10,0xb2d16a4ad
300027.76,2.0,7,3,3,3,9,0xb2d537cd
1060353.97,3.0,6,4,4,3,11,0xb2d3725cd
366299.68,2.0,32,4,3,2,9,0xb2da04b1
3957.78,1.0,0,2,2,4,8,0xb2d528ab
7444.97,1.0,18,2,2,2,6,0xb2d92bea
2000062.21,11.0,3,4,4,4,12,0xb2d6ab80d
10635.33,1.0,19,2,2,2,6,0xb2d1802ed
185.79,1.0,10,1,2,3,6,0xb2d22e50d
5941.9,1.0,5,2,2,3,7,0xb2d423df
3299.24,1.0,14,2,2,3,7,0xb2d5d598d
6.78,1.0,4,1,2,4,7,0xb2d5ea30d
675.08,1.0,17,1,2,2,5,0xb2d2fc8bd
1306.68,1.0,6,1,2,3,6,0xb2d351e6
600006.33,2.0,24,4,3,2,9,0xb2d94521d
477098.52,4.0,35,4,4,2,10,0xb2d1caa8d
30701.58,2.0,27,2,3,2,7,0xb2d2f0c8d
290002.79,7.0,70,3,4,1,8,0xb2d2ce66d
2.45,1.0,74,1,2,1,4,0xb2d5ad3d
18026.48,1.0,9,2,2,3,7,0xb2d6d202d
471118.86,4.0,23,4,4,2,10,0xb2d3ae16d
1560.7,1.0,2,1,2,4,7,0xb2d62954d
899.69,1.0,46,1,2,2,5,0xb2d328fa
7706.69,1.0,184,2,2,1,5,0xb2d3fa21d
905.99,1.0,7,1,2,3,6,0xb2d0d96fd
282887.84,3.0,20,3,4,2,9,0xb2d0b9c7
81.67,1.0,24,1,2,2,5,0xb2d305b4
60012.19,2.0,25,3,3,2,8,0xb2d6b152d
2013.42,1.0,92,1,2,1,4,0xb2d3d6ccd
190129.72,3.0,221,3,4,1,8,0xb2d31cd2d
85.31,1.0,35,1,2,2,5,0xb2d67ce8
100070.7,3.0,38,3,4,2,9,0xb2d2ff9bd
272911.96,2.0,30,3,3,2,8,0xb2d23a0d
162144.35,3.0,62,3,4,2,9,0xb2d78ffbd
30563.22,2.0,92,2,3,1,6,0xb2d65883d
1000468.59,1.0,0,4,2,4,10,0xb2d4cae6d
3544.2,2.0,91,2,3,1,6,0xb2d1b5b8
302131.71,2.0,76,4,3,1,8,0xb2d99cb2
6180.68,1.0,140,2,2,1,5,0xb2d3343dd
72853.75,1.0,5,3,2,3,8,0xb2d0a9b1d
6519.86,1.0,2,2,2,4,8,0xb2d6e2cb
501004.63,3.0,0,4,4,4,12,0xb2d9f750
20480.81,2.0,73,2,3,1,6,0xb2d60afdd
10000.24,2.0,36,2,3,2,7,0xb2d6c704d
2850650.85,6.0,20,4,4,2,10,0xb2d76960d
100011.07,2.0,48,3,3,2,8,0xb2d60e94
564149.2,3.0,0,4,4,4,12,0xb2d6a6e9d
2766.7,2.0,29,1,3,2,6,0xb2d5ff26
498.29,2.0,19,1,3,2,6,0x3b9b24cd
1063.27,1.0,17,1,2,2,5,0xb2d91c7a
50000.0,2.0,1,2,3,4,9,0xb2da646c
1626.32,1.0,92,1,2,1,4,0xb2d2d00ad
146537.17,1.0,0,3,2,4,9,0xb2d2f146d
52833.11,1.0,92,3,2,1,6,0xb2d37a4ed
6879.57,1.0,19,2,2,2,6,0xb2d0f531d
1057.37,1.0,117,1,2,1,4,0xb2d18f2d
4071.13,1.0,2,2,2,4,8,0xb2d8daf4d
150040.84,3.0,27,3,4,2,9,0xb2d681e6d
550.92,1.0,7,1,2,3,6,0xb2d6b511
230009.93,4.0,17,3,4,2,9,0xb2d50a0ed
100004.22,2.0,92,3,3,1,7,0xb2d6693ad
2119.5,1.0,77,1,2,1,4,0xb2d40eb7d
31789.45,2.0,92,2,3,1,6,0xb2d134ee
50029.5,2.0,3,2,3,4,9,0xb2d3c426d
201.9,1.0,49,1,2,2,5,0xb2d3d2e8d
10136.07,1.0,92,2,2,1,5,0xb2d5d977d
9291.23,1.0,11,2,2,3,7,0xb2d42113d
839.68,1.0,3,1,2,4,7,0xb2d3c5a7
300000.0,2.0,26,3,3,2,8,0xb2d949aad
116.82,1.0,75,1,2,1,4,0xb2d2460bd
236.68,1.0,0,1,2,4,7,0xb2d8f620d
318531.33,1.0,10,4,2,3,9,0xb2d2b362
230088.87,5.0,4,3,4,4,11,0xb2d6fc05d
10608.22,1.0,3,2,2,4,8,0xb2d2eacd
28.32,1.0,60,1,2,2,5,0xb2d5ad41d
531388.85,2.0,4,4,3,4,11,0xb2d12678d
872.17,1.0,5,1,2,3,6,0xb2d4f889
11.43,1.0,47,1,2,2,5,0xb2d411eb
484534.18,6.0,14,4,4,3,11,0xb2d08600
10000.21,2.0,28,2,3,2,7,0xb2da09c3
2505.35,1.0,0,1,2,4,7,0xb2d6b59dd
30004.19,4.0,111,2,4,1,7,0xb2d5ebe7
214356.37,2.0,126,3,3,1,7,0xb2d16c9dd
90157.82,1.0,0,3,2,4,9,0xb2d284b6d
52000.55,2.0,104,2,3,1,6,0xb2d12c88d
150.48,1.0,9,1,2,3,6,0xb2d26702
603.67,1.0,0,1,2,4,7,0xb2d14b2dd
501066.65,3.0,15,4,4,3,11,0xb2d4f8ffd
0.68,1.0,19,1,2,2,5,0xb2d5ea36
280200.96,2.0,12,3,3,3,9,0xb2da21a7
130000.0,1.0,2,3,2,4,9,0xb2d91919d
40001.96,2.0,92,2,3,1,6,0xb2d55501d
14035.43,2.0,184,2,3,1,6,0xb2d07dccd
121003.43,4.0,45,3,4,2,9,0xb2d9119cd
11.4,1.0,11,1,2,3,6,0xb2d9cfaf
27.38,2.0,11,1,3,3,7,0xb2d078cad
3.66,1.0,167,1,2,1,4,0xb2d2105a
1252.84,1.0,7,1,2,3,6,0xb2d24b21d
60692.4,1.0,104,3,2,1,6,0xb2d3c59f
0.0,1.0,4,1,2,4,7,0xb2d5f696
86220.75,2.0,69,3,3,1,7,0xb2d2de5fd
412286.06,5.0,0,4,4,4,12,0xb2d12129
1000287.75,2.0,0,4,3,4,11,0xb2d5573a
170767.73,1.0,2,3,2,4,9,0xb2d2599f
202137.34,2.0,76,3,3,1,7,0xb2d6457fd
1360856.27,7.0,1,4,4,4,12,0xb2d391d6d
54238.82,1.0,0,3,2,4,9,0xb2d30f5bd
280103.56,7.0,11,3,4,3,10,0xb2d5c5f1d
101.59,1.0,15,1,2,3,6,0xb2d3436f
232260.57,3.0,92,3,4,1,8,0xb2d1f208
1121.14,1.0,184,1,2,1,4,0xb2d0d3f6
3050.64,1.0,9,2,2,3,7,0xb2d3552bd
5.21,1.0,70,1,2,1,4,0xb2d65df7d
20000.63,2.0,60,2,3,2,7,0xb2d9ba5e
115083.37,3.0,6,3,4,3,10,0xb2d52f19d
1087614.18,2.0,6,4,3,3,10,0xb2d0bb8dd
3425.05,2.0,184,2,3,1,6,0xb2d264ebd
500006.23,4.0,26,4,4,2,10,0xb2d96ce2d
110250.92,3.0,58,3,4,2,9,0xb2d1ef7c
102045.8,2.0,18,3,3,2,8,0xb2d652f3
2005.78,1.0,3,1,2,4,7,0xb2d964ab
107046.77,2.0,0,3,3,4,10,0xb2d209c4
376880.02,14.0,0,4,4,4,12,0x3b9af108d
5998.82,1.0,12,2,2,3,7,0xb2d6f19e
1057.46,1.0,92,1,2,1,4,0xb2d421fad
200062.59,2.0,10,3,3,3,9,0xb2d6a1ed
530022.79,2.0,14,4,3,3,10,0xb2d9b572
47843.07,1.0,6,2,2,3,7,0xb2d2607d
185062.68,2.0,11,3,3,3,9,0xb2d4ae1b
161378.44,5.0,0,3,4,4,11,0xb2d3a54cd
2084860.18,2.0,171,4,3,1,8,0x3b9adcc2d
413048.35,4.0,112,4,4,1,9,0xb2d1d85ed
25542.34,1.0,0,2,2,4,8,0xb2d88f21
6283.04,1.0,9,2,2,3,7,0xb2d6c97f
425035.95,5.0,7,4,4,3,11,0xb2d68e28d
3049.3,1.0,2,2,2,4,8,0xb2d6b7f9
137.91,1.0,7,1,2,3,6,0xb2d6cb59
100015.62,3.0,18,3,4,2,9,0xb2d3e47d
156029.06,10.0,6,3,4,3,10,0xb2d63814
100944.57,2.0,108,3,3,1,7,0xb2d66694d
50939.7,1.0,69,2,2,1,5,0xb2d26bec
33.6,1.0,62,1,2,2,5,0xb2d273b5
406357.05,2.0,3,4,3,4,11,0xb2d1e774d
4431.7,1.0,230,2,2,1,5,0xb2d2d5b4d
5396.13,1.0,92,2,2,1,5,0xb2d20157d
1476.26,1.0,50,1,2,2,5,0xb2d6b708
1154345.71,13.0,0,4,4,4,12,0xb2d4b322d
7277.66,1.0,6,2,2,3,7,0xb2d357e1d
15006.07,1.0,48,2,2,2,6,0xb2d9ddb0
39.63,1.0,14,1,2,3,6,0xb2d606fb
117933.99,2.0,132,3,3,1,7,0xb2d3e4a0
2.89,1.0,14,1,2,3,6,0xb2d5ecd4d
71008.18,4.0,24,3,4,2,9,0xb2d57debd
509.57,1.0,2,1,2,4,7,0xb2d67d5f
70140.51,2.0,27,3,3,2,8,0xb2d6e9e0d
27.41,1.0,5,1,2,3,6,0xb2d0d4ec
10367.39,1.0,92,2,2,1,5,0xb2d30869d
200008.44,2.0,10,3,3,3,9,0xb2d95d35d
2321.27,1.0,36,1,2,2,5,0xb2d933e1
2050.12,1.0,184,1,2,1,4,0xb2d2403fd
110001.0,2.0,4,3,3,4,10,0xb2da5a59
0.0,1.0,92,1,2,1,4,0xb2d4c7e8d
210001.18,6.0,11,3,4,3,10,0xb2d5be92d
64.43,1.0,9,1,2,3,6,0xb2d511ad
60000.63,2.0,18,3,3,2,8,0xb2d9575bd
6608.98,1.0,9,2,2,3,7,0xb2d2ddaad
8868.42,1.0,1,2,2,4,8,0xb2d35d77d
3280.68,1.0,13,2,2,3,7,0xb2d96408
327923.82,1.0,0,4,2,4,10,0xb2d13eebd
100005.98,2.0,87,3,3,1,7,0xb2d11069d
1336.81,1.0,10,1,2,3,6,0xb2d7030e
300007.84,3.0,19,3,4,2,9,0xb2d5d807d
580126.2,3.0,62,4,4,2,10,0xb2d4ac16d
553625.93,4.0,6,4,4,3,11,0xb2d4f6d3d
411.09,1.0,10,1,2,3,6,0xb2d596cd
165007.33,7.0,76,3,4,1,8,0xb2d5b98f
200000.0,1.0,0,3,2,4,9,0xb2da666f
16327.79,1.0,35,2,2,2,6,0xb2d2ddb0d
200830.2,2.0,24,3,3,2,8,0xb2d24ddc
31.95,1.0,15,1,2,3,6,0xb2d68e64
105086.28,2.0,83,3,3,1,7,0xb2d4243cd
13354.53,1.0,0,2,2,4,8,0xb2d7087dd
200006.57,5.0,195,3,4,1,8,0xb2d63c82d
270026.15,5.0,14,3,4,3,10,0xb2d2118fd
80294.3,1.0,60,3,2,2,7,0xb2d2cbb4d
40149.31,1.0,114,2,2,1,5,0xb2d1fbd9
20522.24,1.0,0,2,2,4,8,0xb2d6c29e
1056591.22,2.0,3,4,3,4,11,0xb2d5d5a3d
625510.04,3.0,41,4,4,2,10,0xb2d41131d
2.22,1.0,19,1,2,2,5,0xb2d71734
30482.04,1.0,4,2,2,4,8,0xb2d8ed8e
114.53,1.0,10,1,2,3,6,0xb2d5c43bd
615712.3,2.0,65,4,3,2,9,0xb2d10269d
13.64,1.0,0,1,2,4,7,0xb2d95480
1270.37,1.0,213,1,2,1,4,0xb2d60563d
134.49,3.0,28,1,4,2,7,0xb2d6a96bd
70002.22,2.0,74,3,3,1,7,0xb2d9991e
70015.78,2.0,0,3,3,4,10,0xb2d60eec
800000.0,2.0,8,4,3,3,10,0xb2da4ef7
202355.25,2.0,73,3,3,1,7,0xb2d49546d
260010.33,2.0,39,3,3,2,8,0xb2d6de2bd
317222.23,1.0,92,4,2,1,7,0xb2d3c76cd
522486.46,3.0,6,4,4,3,11,0xb2d28730
931707.28,17.0,0,4,4,4,12,0xb2d5c580d
1109.56,1.0,184,1,2,1,4,0xb2d38a70d
1000021.23,2.0,6,4,3,3,10,0xb2d103f0
50059.65,1.0,122,2,2,1,5,0xb2d6b3abd
2349.79,1.0,92,1,2,1,4,0xb2d2c2f6d
13140.65,1.0,153,2,2,1,5,0xb2d66a30d
1010.02,1.0,92,1,2,1,4,0xb2d235ecd
5008.24,1.0,166,2,2,1,5,0xb2d8e56fd
77501.57,2.0,20,3,3,2,8,0xb2d40990d
2276.27,1.0,0,1,2,4,7,0xb2d92301
3318.05,1.0,0,2,2,4,8,0xb2d5c67b
2042685.64,2.0,40,4,3,2,9,0xb2d6a389d
1000994.63,7.0,8,4,4,3,11,0xb2d10baed
836.76,1.0,4,1,2,4,7,0xb2d651c9d
151483.11,3.0,1,3,4,4,11,0xb2d2997ed
102983.77,2.0,80,3,3,1,7,0xb2d288d7
540001.99,5.0,6,4,4,3,11,0xb2d6c624d
295058.57,3.0,0,3,4,4,11,0xb2d1a740d
252160.7,11.0,4,3,4,4,11,0xb2d6550bd
75632.55,1.0,27,3,2,2,7,0xb2d4e987d
50001.58,2.0,74,2,3,1,6,0xb2d99934
9235.02,1.0,15,2,2,3,7,0xb2d1c6f9d
3008.14,1.0,46,2,2,2,6,0xb2d81ffd
2034.03,1.0,92,1,2,1,4,0xb2d109b7
10004.29,1.0,2,2,2,4,8,0xb2d62cd1d
0.33,5.0,0,1,4,4,9,0x3b9b406cd
100045.64,2.0,25,3,3,2,8,0xb2d5a836d
2193.22,1.0,0,1,2,4,7,0xb2d39919
90763.1,3.0,4,3,4,4,11,0xb2d4bea3d
385137.12,3.0,3,4,4,4,12,0xb2d5d0c5d
1177.79,1.0,26,1,2,2,5,0xb2d22305d
892.46,11.0,92,1,4,1,6,0xb2d28de7
1158.47,2.0,92,1,3,1,5,0xb2d11ee7d
500107.72,2.0,8,4,3,3,10,0xb2d921ce
112000.45,2.0,7,3,3,3,9,0xb2d61df9
50002.06,3.0,7,2,4,3,9,0xb2d92a8cd
503552.6,2.0,69,4,3,1,8,0xb2d9ac82
2260359.25,9.0,6,4,4,3,11,0xb2d074b9d
205520.61,3.0,129,3,4,1,8,0xb2d459d1d
505329.6,2.0,34,4,3,2,9,0xb2d8a5e6d
6011.43,1.0,158,2,2,1,5,0xb2d665fcd
7053.73,1.0,42,2,2,2,6,0xb2d3a843d
5571.92,1.0,135,2,2,1,5,0xb2d39ee2d
580089.57,3.0,4,4,4,4,12,0xb2d91da2d
260019.41,2.0,182,3,3,1,7,0xb2d51dfed
3710.59,1.0,99,2,2,1,5,0xb2d1f361
20000.63,3.0,157,2,4,1,7,0xb2d6352dd
300031.28,2.0,8,3,3,3,9,0xb2d9a90f
1011.33,1.0,211,1,2,1,4,0xb2d3c212d
828918.06,9.0,0,4,4,4,12,0x3b9af131d
105823.82,3.0,1,3,4,4,11,0xb2d4100fd
129341.23,1.0,7,3,2,3,8,0xb2d2d99fd
10000.64,2.0,60,2,3,2,7,0xb2d9a7fc
816037.01,7.0,11,4,4,3,11,0x3b9b37bbd
996804.77,5.0,56,4,4,2,10,0xb2d1f9d8d
3195.04,1.0,9,2,2,3,7,0xb2d421d8d
21100.3,2.0,67,2,3,1,6,0xb2d5bbe4d
400562.38,2.0,60,4,3,2,9,0xb2d0f595d
1166.59,1.0,0,1,2,4,7,0xb2d41e5ed
846064.04,5.0,10,4,4,3,11,0xb2d3c63ed
33001.82,2.0,18,2,3,2,7,0xb2d5ce25d
1063.35,1.0,92,1,2,1,4,0xb2d2cc5cd
1143018.12,3.0,80,4,4,1,9,0xb2d16b35d
500000.0,2.0,10,4,3,3,10,0xb2d9fa00
3372.86,1.0,103,2,2,1,5,0xb2d241b0
8513.8,1.0,3,2,2,4,8,0xb2d99e74
400010.98,2.0,102,4,3,1,8,0xb2d614b0
2.28,1.0,18,1,2,2,5,0xb2d956e3d
511995.82,3.0,49,4,4,2,10,0xb2d302c9d
534342.97,6.0,75,4,4,1,9,0xb2d3e9b1d
11047.6,1.0,174,2,2,1,5,0xb2d6b4a9
53115.45,2.0,92,3,3,1,7,0xb2d45eedd
7192.3,1.0,10,2,2,3,7,0xb2d412ae
1095.77,2.0,4,1,3,4,8,0xb2d32ce4
2.11,1.0,62,1,2,2,5,0xb2d93f89
620031.67,5.0,14,4,4,3,11,0xb2d5f9cbd
3685.16,1.0,92,2,2,1,5,0xb2d25412d
2391.16,1.0,2,1,2,4,7,0xb2d226ead
307774.89,5.0,0,4,4,4,12,0xb2d60dbbd
400000.0,2.0,11,4,3,3,10,0xb2da4cc6
100608.21,3.0,48,3,4,2,9,0xb2d62de6
207114.1,2.0,96,3,3,1,7,0xb2d6857dd
20042.07,1.0,309,2,2,1,5,0xb2d6140ad
330028.87,2.0,7,4,3,3,10,0xb2d92dca
185745.82,2.0,0,3,3,4,10,0xb2d2c65b
395605.82,4.0,0,4,4,4,12,0xb2d126e5d
10.49,1.0,4,1,2,4,7,0xb2d6d7f0d
9959.51,1.0,92,2,2,1,5,0xb2d2dc08d
60091.63,2.0,13,3,3,3,9,0xb2da3645
300022.48,2.0,221,3,3,1,7,0xb2d694c1d
631280.08,7.0,81,4,4,1,9,0xb2d304fed
500322.36,3.0,5,4,4,3,11,0xb2d6d3fbd
331.03,1.0,1,1,2,4,7,0xb2d63b80d
850029.7,8.0,3,4,4,4,12,0xb2d16d43d
0.0,1.0,8,1,2,3,6,0xb2d24b5b
183727.43,2.0,63,3,3,2,8,0xb2d48812d
400004.22,2.0,35,4,3,2,9,0xb2d9f8f6
1426410.65,1.0,0,4,2,4,10,0xb2d201d8d
109528.22,2.0,49,3,3,2,8,0xb2d256d9d
115.84,1.0,69,1,2,1,4,0xb2d22af0d
200146.62,3.0,3,3,4,4,11,0xb2d38ba3d
71.41,1.0,0,1,2,4,7,0xb2d621bb
480077.96,5.0,1,4,4,4,12,0xb2d59897
50000.53,3.0,59,2,4,2,8,0xb2d90012
41464.75,3.0,12,2,4,3,9,0xb2d51e8ad
22066.23,1.0,92,2,2,1,5,0xb2d3b57ed
1095.05,2.0,83,1,3,1,5,0x3b9b3d0f
4040.81,1.0,184,2,2,1,5,0xb2d2ce42
30000633.33,3.0,10,4,4,3,11,0xb2d963f9d
8.9,1.0,40,1,2,2,5,0xb2d921f1
500004.27,3.0,24,4,4,2,10,0xb2d9c575
815.99,1.0,10,1,2,3,6,0xb2d56008
170588.94,1.0,9,3,2,3,8,0xb2d8f8e1
500000.0,2.0,0,4,3,4,11,0xb2da0c64
50000.0,1.0,4,2,2,4,8,0xb2da61fe
31.26,1.0,11,1,2,3,6,0xb2d5d1c5
100020.22,2.0,193,3,3,1,7,0xb2d60bced
3344.82,1.0,184,2,2,1,5,0xb2d0ae95d
440143.13,4.0,92,4,4,1,9,0xb2d0acdfd
1401431.58,3.0,23,4,4,2,10,0xb2d90a28d
100046.45,2.0,60,3,3,2,8,0xb2d9b454
188.15,1.0,5,1,2,3,6,0xb2d53079
200176.75,2.0,0,3,3,4,10,0xb2d3f600d
153603.2,2.0,31,3,3,2,8,0xb2d2e3a9d
10026.84,1.0,92,2,2,1,5,0xb2d63c13d
118024.85,1.0,10,3,2,3,8,0xb2d3a1edd
7192.37,1.0,110,2,2,1,5,0xb2d53f4fd
59.45,3.0,116,1,4,1,6,0xb2d39274d
1026714.25,4.0,19,4,4,2,10,0xb2d1547ad
936199.83,6.0,18,4,4,2,10,0xb2d08b3b
14795.43,1.0,142,2,2,1,5,0xb2d1d865d
2314.68,12.0,184,1,4,1,6,0xb2d120ebd
214511.35,6.0,6,3,4,3,10,0xb2d3ad26
876.16,1.0,70,1,2,1,4,0xb2d629d5d
278860.64,1.0,8,3,2,3,8,0xb2d210e8d
60133.2,2.0,3,3,3,4,10,0xb2d62612d
4382.37,1.0,0,2,2,4,8,0xb2d69b68d
4057237.02,3.0,4,4,4,4,12,0x3b9b38e0d
25894.9,1.0,9,2,2,3,7,0xb2d455f1d
8.81,1.0,26,1,2,2,5,0xb2d6b80e
44000.37,2.0,27,2,3,2,7,0xb2d6d093d
4529.05,1.0,10,2,2,3,7,0xb2d4ddd9
10380.91,1.0,0,2,2,4,8,0xb2d59d2ed
25.29,1.0,42,1,2,2,5,0xb2d3a622
208680.06,2.0,38,3,3,2,8,0xb2d57125d
413000.91,10.0,9,4,4,3,11,0xb2d26514
1005.51,1.0,92,1,2,1,4,0xb2d2e430
266902.59,3.0,26,3,4,2,9,0xb2d41e36
50122.63,4.0,32,2,4,2,8,0xb2d6bed9d
1023.71,1.0,18,1,2,2,5,0xb2d64976
1162.11,1.0,0,1,2,4,7,0xb2d9cae9
1741.64,1.0,41,1,2,2,5,0xb2d32098
1985744.8,8.0,21,4,4,2,10,0xb2d1806cd
504330.66,2.0,4,4,3,4,11,0xb2d94addd
1950035.71,9.0,18,4,4,2,10,0xb2d557f5d
3.53,1.0,4,1,2,4,7,0xb2d39555d
1956.26,1.0,184,1,2,1,4,0xb2d124ddd
685000.83,15.0,0,4,4,4,12,0xb2d55c1e
183225.61,6.0,106,3,4,1,8,0xb2d11044d
501824.08,3.0,39,4,4,2,10,0xb2d98d2e
1002579.43,3.0,2,4,4,4,12,0xb2d9cfe6
1161888.47,6.0,18,4,4,2,10,0xb2d5b040
600.0,1.0,0,1,2,4,7,0xb2d0a42cd
1482.38,1.0,184,1,2,1,4,0xb2d2c78ad
570362.81,1.0,82,4,2,1,7,0xb2d2d6afd
99.82,1.0,20,1,2,2,5,0xb2d099df
200002.11,2.0,18,3,3,2,8,0xb2da2ee1
12487.14,1.0,0,2,2,4,8,0xb2d5e4aad
190210.82,3.0,96,3,4,1,8,0xb2d1e7fe
1143052.56,6.0,0,4,4,4,12,0xb2d56fb2d
4544.44,1.0,9,2,2,3,7,0xb2d4ea34d
110003.7,3.0,55,3,4,2,9,0xb2d969c1d
200006.33,2.0,39,3,3,2,8,0xb2d9ec7b
102291.07,2.0,82,3,3,1,7,0xb2d5728dd
260.29,1.0,5,1,2,3,6,0xb2d91953
2041.25,2.0,5,1,3,3,7,0xb2d09159d
14742.98,1.0,15,2,2,3,7,0xb2d47729
19657.88,1.0,171,2,2,1,5,0xb2d2e41b
84066.79,6.0,26,3,4,2,9,0xb2d5540f
185024.63,4.0,0,3,4,4,11,0xb2d5f002
9182.78,1.0,23,2,2,2,6,0xb2d5fb1dd
520411.21,3.0,7,4,4,3,11,0xb2d96476d
796.67,1.0,19,1,2,2,5,0xb2d37c56
22749.31,1.0,28,2,2,2,6,0xb2d5cc6f
1206126.35,9.0,3,4,4,4,12,0xb2d580e1d
90000.0,1.0,9,3,2,3,8,0xb2d96c6f
99.45,1.0,9,1,2,3,6,0xb2d565c9
20739.46,1.0,92,2,2,1,5,0xb2d08f7ad
300000.0,2.0,0,3,3,4,10,0xb2d982efd
546175.49,7.0,0,4,4,4,12,0xb2d108bc
15318.46,1.0,6,2,2,3,7,0xb2da4e8a
1150016.23,4.0,25,4,4,2,10,0xb2d5a76cd
507434.41,3.0,0,4,4,4,12,0xb2d6c5bfd
745171.59,9.0,11,4,4,3,11,0xb2d0668ed
1517.53,1.0,55,1,2,2,5,0xb2d4704d
1047505.07,7.0,8,4,4,3,11,0xb2d3d867d
5983.65,2.0,10,2,3,3,8,0xb2d8f986
100092.83,2.0,80,3,3,1,7,0xb2d35075
250600.0,4.0,0,3,4,4,11,0x3b9b3506
500864.22,2.0,55,4,3,2,9,0xb2d8f9fd
284041.89,13.0,11,3,4,3,10,0xb2d5f68fd
405042.01,6.0,0,4,4,4,12,0xb2d6ad68d
102691.12,2.0,0,3,3,4,10,0xb2d5eab7
60.27,1.0,2,1,2,4,7,0xb2d9e0e8
330053.56,4.0,67,4,4,1,9,0xb2d2bfd7d
873133.76,10.0,0,4,4,4,12,0xb2d682aed
150000.0,1.0,8,3,2,3,8,0xb2d22a02
0.0,1.0,10,1,2,3,6,0xb2d8d820
676216.73,12.0,1,4,4,4,12,0xb2d1a768d
467325.98,4.0,0,4,4,4,12,0xb2d7c13ed
4.36,1.0,36,1,2,2,5,0xb2d9277cd
147179.61,2.0,6,3,3,3,9,0xb2d61980d
167170.0,11.0,1,3,4,4,11,0xb2d21347
20186.34,1.0,184,2,2,1,5,0xb2d20d3e
17.92,1.0,18,1,2,2,5,0xb2d920bed
40239.52,1.0,92,2,2,1,5,0xb2d43057d
713.93,2.0,9,1,3,3,7,0xb2d2ed5f
52.33,1.0,17,1,2,2,5,0xb2d6af60
0.98,1.0,35,1,2,2,5,0xb2d9d98e
401468.02,3.0,40,4,4,2,10,0xb2d380dc
1693.68,1.0,9,1,2,3,6,0xb2d15be6d
2287.55,1.0,0,1,2,4,7,0xb2d5cc07d
101082.8,2.0,5,3,3,3,9,0xb2d1a25dd
30196.72,1.0,7,2,2,3,7,0xb2d2b5ccd
25893.29,1.0,97,2,2,1,5,0xb2d5cc58
15004241.71,2.0,0,4,3,4,11,0xb2da4fbc
216876.0,1.0,9,3,2,3,8,0xb2d42f99
7148.41,1.0,92,2,2,1,5,0xb2d20cf5d
595076.86,3.0,157,4,4,1,9,0xb2d37ff8
6960.93,1.0,92,2,2,1,5,0xb2d339d6d
400087.17,2.0,3,4,3,4,11,0xb2d65226
44136.07,3.0,7,2,4,3,9,0xb2d935f7
5854.96,1.0,3,2,2,4,8,0xb2d30405
3832.94,2.0,138,2,3,1,6,0x3b9b261f
2208.63,1.0,184,1,2,1,4,0xb2d2a36fd
2034.07,1.0,184,1,2,1,4,0xb2d0ee1dd
1965.41,1.0,184,1,2,1,4,0xb2d13065d
5430.2,1.0,184,2,2,1,5,0xb2d2c4bdd
50008.97,3.0,102,2,4,1,7,0xb2d07ce8d
200000.01,2.0,19,3,3,2,8,0xb2d6c12ad
960081.47,5.0,4,4,4,4,12,0xb2d1cab3d
89.24,1.0,5,1,2,3,6,0xb2d91c8d
1392.01,1.0,15,1,2,3,6,0xb2d43088
752208.95,4.0,25,4,4,2,10,0xb2d43747
358.34,1.0,1,1,2,4,7,0xb2d6cf25
400000.02,2.0,23,4,3,2,9,0xb2d9cf52
106243.34,2.0,6,3,3,3,9,0xb2d3cbd9d
2648.66,1.0,1,1,2,4,7,0xb2d62d19
350.25,1.0,22,1,2,2,5,0xb2d2344f
486538.23,4.0,6,4,4,3,11,0xb2d13e86d
505042.39,4.0,35,4,4,2,10,0xb2d197c1d
11598.26,1.0,0,2,2,4,8,0xb2d91c07
200017.96,3.0,179,3,4,1,8,0xb2d614f5d
145909.24,5.0,14,3,4,3,10,0xb2d51e76d
5367.66,1.0,185,2,2,1,5,0xb2d17a4ed
22358.32,1.0,18,2,2,2,6,0xb2d1479e
180007.64,2.0,129,3,3,1,7,0xb2d63dd5d
500926.44,3.0,4,4,4,4,12,0xb2d9aeb7
0.33,1.0,60,1,2,2,5,0xb2d52083
6810.66,2.0,194,2,3,1,6,0xb2d27410d
4474.58,1.0,0,2,2,4,8,0xb2d68c61
10014.17,2.0,21,2,3,2,7,0xb2d29c6b
200000.0,2.0,6,3,3,3,9,0xb2da59aa
130000.0,4.0,0,3,4,4,11,0xb2d3291fd
0.0,1.0,0,1,2,4,7,0xb2d41273
800008.45,2.0,188,4,3,1,8,0xb2d6a920
20044.19,2.0,139,2,3,1,6,0xb2d8c361d
206102.99,5.0,172,3,4,1,8,0xb2d34a8ad
19866.69,1.0,15,2,2,3,7,0xb2d6a4b6
170011.51,3.0,95,3,4,1,8,0xb2d33575d
1058.39,1.0,209,1,2,1,4,0xb2d18f2dd
30000.63,2.0,6,2,3,3,8,0xb2d9685b
60255.55,1.0,195,3,2,1,6,0xb2d33d9a
8907.21,1.0,14,2,2,3,7,0xb2d916d5
601072.04,4.0,1,4,4,4,12,0xb2d60650d
25467.22,2.0,32,2,3,2,7,0xb2d56fced
124.08,1.0,69,1,2,1,4,0xb2d37f46
1344.83,1.0,14,1,2,3,6,0xb2d4d849
49912.92,1.0,34,2,2,2,6,0xb2d97b8b
300000.32,2.0,20,3,3,2,8,0xb2da26ff
104.0,1.0,21,1,2,2,5,0xb2d5fdc3
1056.99,1.0,8,1,2,3,6,0xb2d71854
1615.11,1.0,9,1,2,3,6,0xb2d1d596
400026.57,6.0,101,4,4,1,9,0xb2d32a14
58749.77,2.0,7,3,3,3,9,0xb2d28396
81.29,1.0,19,1,2,2,5,0xb2d8e7eb
503552.73,2.0,43,4,3,2,9,0xb2d8e33fd
1291.09,1.0,297,1,2,1,4,0xb2d64a66d
10001.27,3.0,3,2,4,4,10,0xb2d07984d
505329.88,2.0,102,4,3,1,8,0xb2d96a8bd
500.22,1.0,2,1,2,4,7,0xb2d6c4ab
270748.01,2.0,27,3,3,2,8,0xb2d13f69d
37.57,1.0,11,1,2,3,6,0xb2d2cbf5
15024.05,1.0,11,2,2,3,7,0xb2d3fcbe
20833.98,1.0,6,2,2,3,7,0xb2d9b009
360016.33,2.0,214,4,3,1,8,0xb2d262c5d
42.88,1.0,1,1,2,4,7,0xb2d35059d
39647.08,1.0,16,2,2,2,6,0xb2d6c167d
105311.64,6.0,18,3,4,2,9,0x3b9b43c8d
15307.34,1.0,6,2,2,3,7,0xb2d5e0b9d
250000.0,2.0,22,3,3,2,8,0xb2d9accf
64000.26,3.0,2,3,4,4,11,0xb2d65100
1160000.0,7.0,1,4,4,4,12,0xb2d13ff5
540000.0,6.0,0,4,4,4,12,0xb2d5eb9a
210008.87,2.0,69,3,3,1,7,0xb2d8e66ad
878.02,1.0,24,1,2,2,5,0xb2d55147d
540023.54,3.0,18,4,4,2,10,0xb2d9804e
1405.42,1.0,10,1,2,3,6,0xb2d4196f
202545.74,7.0,1,3,4,4,11,0x3b9b1845d
271.17,1.0,52,1,2,2,5,0xb2d3edd7d
51790.64,1.0,184,2,2,1,5,0xb2d4363cd
450065.3,3.0,48,4,4,2,10,0xb2d5265ed
30383.32,2.0,147,2,3,1,6,0xb2d81ec0d
8.26,1.0,39,1,2,2,5,0xb2d5fa6a
301071.33,3.0,4,4,4,4,12,0xb2d9d672
270021.06,2.0,0,3,3,4,10,0xb2d57c92d
490328.66,8.0,0,4,4,4,12,0xb2d3a48bd
24.79,1.0,14,1,2,3,6,0xb2d31beb
18496.99,1.0,29,2,2,2,6,0xb2d92356d
260015.6,4.0,66,3,4,2,9,0xb2d3c1ef
200009.84,3.0,32,3,4,2,9,0xb2d2b0ce
1380.31,1.0,0,1,2,4,7,0xb2d6429f
162.82,2.0,37,1,3,2,6,0xb2d8393ed
115.19,1.0,21,1,2,2,5,0xb2d65174
570000.08,2.0,7,4,3,3,10,0xb2d4067ad
5052.87,1.0,25,2,2,2,6,0xb2d53502
4921.66,2.0,80,2,3,1,6,0xb2d3b3b6d
200094.34,3.0,59,3,4,2,9,0xb2d0d2b0
480114.24,6.0,0,4,4,4,12,0xb2d179dfd
407071.88,6.0,68,4,4,1,9,0xb2d11431d
63002.13,3.0,101,3,4,1,8,0xb2d692bd
212.17,1.0,29,1,2,2,5,0xb2d3df8a
410096.59,2.0,14,4,3,3,10,0xb2d6a05fd
8.01,1.0,13,1,2,3,6,0xb2d95545
97.22,1.0,17,1,2,2,5,0xb2d6caf3
52050.62,2.0,80,2,3,1,6,0xb2d59fc4d
2498.06,1.0,184,1,2,1,4,0xb2d1b90fd
982286.99,8.0,51,4,4,2,10,0xb2d17498d
3093.11,1.0,92,2,2,1,5,0xb2d2c027d
44.69,2.0,1,1,3,4,8,0xb2d1b5fcd
1532.5,1.0,184,1,2,1,4,0xb2d2bb60d
140065.3,3.0,87,3,4,1,8,0xb2d4e7e3
7793.37,1.0,29,2,2,2,6,0xb2d92d27
739021.51,16.0,6,4,4,3,11,0xb2d3b919d
200001.0,2.0,25,3,3,2,8,0xb2da09c4
800047.73,4.0,4,4,4,4,12,0xb2d23979d
1173.01,1.0,92,1,2,1,4,0xb2d2344dd
72.81,1.0,84,1,2,1,4,0xb2d30eea
1515.54,1.0,92,1,2,1,4,0xb2d10c93d
131706.78,1.0,16,3,2,2,7,0xb2d8e38bd
374119.52,4.0,18,4,4,2,10,0xb2d5915fd
72.07,1.0,0,1,2,4,7,0xb2d3bf94d
247.64,1.0,7,1,2,3,6,0xb2d27f82d
600043.56,5.0,76,4,4,1,9,0xb2d52b30
1300080.47,2.0,92,4,3,1,8,0xb2d27411
45002.16,3.0,188,2,4,1,7,0xb2d68928d
68832.55,1.0,4,3,2,4,9,0xb2d189b1d
1261.86,1.0,84,1,2,1,4,0xb2d36976
4191.83,1.0,4,2,2,4,8,0xb2d434ed
7337.88,2.0,13,2,3,3,8,0xb2d49591d
14189.75,1.0,5,2,2,3,7,0xb2d09e55d
461.23,1.0,15,1,2,3,6,0xb2d1fbf7d
363089.49,5.0,4,4,4,4,12,0xb2d26554d
180002.51,2.0,45,3,3,2,8,0xb2d31357d
415722.22,3.0,10,4,4,3,11,0xb2d5f9c0d
174.92,1.0,55,1,2,2,5,0xb2d4a543
540853.52,5.0,3,4,4,4,12,0xb2d49e86d
1016.07,1.0,92,1,2,1,4,0xb2d3e5dcd
11947.52,1.0,11,2,2,3,7,0xb2d590b5d
2.39,1.0,13,1,2,3,6,0xb2d35286
1839137.9,9.0,1,4,4,4,12,0xb2d20bf9d
849.32,2.0,0,1,3,4,8,0x3b9b40b0
0.0,1.0,77,1,2,1,4,0xb2d4df8d
644017.01,8.0,0,4,4,4,12,0xb2d10358d
219410.64,3.0,3,3,4,4,11,0xb2d61954d
1022034.44,15.0,0,4,4,4,12,0xb2d083ced
7549.84,1.0,0,2,2,4,8,0xb2d1ab47d
554744.72,4.0,10,4,4,3,11,0xb2d12d97d
298.76,1.0,0,1,2,4,7,0xb2d6089f
203051.76,4.0,42,3,4,2,9,0xb2d41f48d
470625.2,3.0,133,4,4,1,9,0xb2d16ee5d
1590.16,1.0,0,1,2,4,7,0xb2d3aac0
1776.27,1.0,0,1,2,4,7,0xb2d638a3d
32048.46,3.0,1,2,4,4,10,0xb2d1c1ddd
1450.97,1.0,5,1,2,3,6,0xb2d64e71d
941.65,1.0,9,1,2,3,6,0xb2d7bfbc
6064.0,2.0,77,2,3,1,6,0xb2d2a828
5.04,7.0,3,1,4,4,9,0xb2d22c9a
7166.24,1.0,12,2,2,3,7,0xb2d3fd44d
5612.91,1.0,195,2,2,1,5,0xb2d57de9d
61111.76,2.0,45,3,3,2,8,0xb2d236d9d
24.6,1.0,46,1,2,2,5,0xb2d97154
700000.0,2.0,1,4,3,4,11,0xb2d981e0d
2212.28,1.0,272,1,2,1,4,0xb2d444dbd
8065.97,1.0,83,2,2,1,5,0xb2d60d8a
9873.91,1.0,0,2,2,4,8,0xb2d6d5c6d
835882.21,7.0,4,4,4,4,12,0x3b9b3892
110083.92,2.0,15,3,3,3,9,0xb2d6863b
3.2,1.0,60,1,2,2,5,0xb2d32efb
50425.58,2.0,83,2,3,1,6,0xb2d6ad17d
21098.08,1.0,6,2,2,3,7,0xb2d2a1fa
196724.2,5.0,125,3,4,1,8,0xb2d60b08d
200091.65,2.0,161,3,3,1,7,0xb2d08abe
1432.03,1.0,8,1,2,3,6,0xb2d1a809
51246.79,3.0,0,2,4,4,10,0xb2d782e8
284032.8,6.0,3,3,4,4,11,0xb2d78f56d
1389.4,1.0,159,1,2,1,4,0xb2d150e6
432699.93,4.0,47,4,4,2,10,0xb2d3b6a0
0.0,1.0,1,1,2,4,7,0xb2d68bcdd
10176.01,2.0,249,2,3,1,6,0xb2d59d2f
1931.13,1.0,92,1,2,1,4,0xb2d37568d
1.04,2.0,5,1,3,3,7,0xb2d2cf9e
460005.45,4.0,10,4,4,3,11,0xb2d5c4c0d
110004.64,2.0,14,3,3,3,9,0xb2da3375
120008.31,2.0,235,3,3,1,7,0x3b9b368cd
363.62,1.0,4,1,2,4,7,0xb2d299b2d
535.11,1.0,0,1,2,4,7,0xb2d6a273
200210.6,2.0,11,3,3,3,9,0xb2d9dc4a
4088.13,1.0,35,2,2,2,6,0xb2d45740
588069.64,4.0,0,4,4,4,12,0xb2d51e4fd
500815.26,4.0,46,4,4,2,10,0xb2d64207
10674.8,1.0,167,2,2,1,5,0xb2d23921
1106.41,1.0,10,1,2,3,6,0xb2d965a9
520000.0,2.0,26,4,3,2,9,0xb2da146d
0.53,1.0,68,1,2,1,4,0xb2d8e0e2d
250.58,1.0,10,1,2,3,6,0xb2d6df98
7072.76,1.0,92,2,2,1,5,0xb2d0cbe0d
264620.86,2.0,167,3,3,1,7,0xb2d5c82dd
50222.04,2.0,83,2,3,1,6,0xb2d60398d
412400.93,4.0,21,4,4,2,10,0xb2d64876d
2.19,1.0,88,1,2,1,4,0xb2d5c563
80003.38,2.0,49,3,3,2,8,0xb2d9d48d
905696.61,7.0,5,4,4,3,11,0xb2d64729d
467737.5,3.0,76,4,4,1,9,0xb2d1ce73d
721777.05,4.0,11,4,4,3,11,0xb2d28136
471611.58,2.0,73,4,3,1,8,0xb2d2e947d
24583.28,1.0,75,2,2,1,5,0xb2d0d1ae
382.25,1.0,9,1,2,3,6,0xb2d2fcaf
120699.8,2.0,1,3,3,4,10,0xb2d60607
14925.58,5.0,0,2,4,4,10,0x3b9b3dfad
10.05,1.0,3,1,2,4,7,0xb2d247bed
8.61,1.0,62,1,2,2,5,0xb2d8f084d
285176.07,4.0,0,3,4,4,11,0xb2d1e8b7d
240000.35,6.0,1,3,4,4,11,0xb2d413ab
1888.0,2.0,5,1,3,3,7,0xb2d378b8d
150006.02,3.0,95,3,4,1,8,0xb2d35b20
882335.72,5.0,6,4,4,3,11,0xb2d244fa
15.48,1.0,6,1,2,3,6,0xb2d6d463d
9531.19,1.0,8,2,2,3,7,0xb2d1e915d
7567.12,1.0,9,2,2,3,7,0xb2d6ad77
11678.71,1.0,1,2,2,4,8,0xb2d29b24
100.62,1.0,55,1,2,2,5,0xb2d67225
4460.24,1.0,18,2,2,2,6,0xb2d5cf1a
60014.08,2.0,4,3,3,4,10,0xb2d6ab18d
1017027.04,21.0,7,4,4,3,11,0xb2d0cf72d
11.58,1.0,18,1,2,2,5,0xb2d5677f
60005.61,6.0,0,3,4,4,11,0xb2d6c7ea
27174.06,9.0,53,2,4,2,8,0xb2d5da55d
80006.34,2.0,167,3,3,1,7,0xb2d24bab
202380.08,2.0,73,3,3,1,7,0xb2d6b926d
141.25,1.0,7,1,2,3,6,0xb2d8a76d
207874.45,3.0,101,3,4,1,8,0xb2d13c8cd
90003.8,2.0,48,3,3,2,8,0xb2d91063d
9800.61,1.0,9,2,2,3,7,0xb2d26da9d
20004.95,2.0,5,2,3,3,8,0xb2d13546
2000118.39,4.0,153,4,4,1,9,0xb2d41c7ed
134406.13,3.0,33,3,4,2,9,0xb2d63516d
27713.44,1.0,0,2,2,4,8,0xb2d6bf43
15205.06,1.0,184,2,2,1,5,0xb2d41580d
521749.06,4.0,0,4,4,4,12,0xb2d0f3d1d
2854.14,1.0,184,1,2,1,4,0xb2d1f9bed
200000.42,2.0,10,3,3,3,9,0xb2d9257cd
9644.96,1.0,0,2,2,4,8,0xb2d60a51
1021.39,1.0,184,1,2,1,4,0xb2d26c74d
350018.81,3.0,16,4,4,2,10,0xb2d9b6ca
2.06,1.0,40,1,2,2,5,0xb2d9d2ae
2334.8,1.0,154,1,2,1,4,0xb2d4d071
152547.27,2.0,2,3,3,4,10,0xb2d219e6d
106315.52,1.0,7,3,2,3,8,0xb2d17fb2
50174.57,2.0,0,2,3,4,9,0xb2d59a4fd
41750.13,1.0,1,2,2,4,8,0xb2d388a5
44852.7,1.0,4,2,2,4,8,0xb2d6266ed
82106.51,2.0,164,3,3,1,7,0xb2d1934ad
600000.0,2.0,6,4,3,3,10,0xb2d9f27c
5454.11,1.0,184,2,2,1,5,0xb2d36cadd
260033.86,3.0,151,3,4,1,8,0xb2d1f885d
220011.48,3.0,8,3,4,3,10,0xb2d9f5ff
4667.87,1.0,15,2,2,3,7,0xb2d8c859
9241.33,1.0,184,2,2,1,5,0xb2d34de7d
350000.03,2.0,9,4,3,3,10,0xb2d929ccd
100003.21,2.0,164,3,3,1,7,0xb2d6099b
9334.78,5.0,184,2,4,1,7,0x3b9b276cd
532741.12,5.0,7,4,4,3,11,0xb2d0723dd
1116.11,1.0,0,1,2,4,7,0xb2d51b83
1003.72,1.0,0,1,2,4,7,0xb2d5ee17
984.65,1.0,85,1,2,1,4,0xb2d1bf8fd
2332.56,1.0,62,1,2,2,5,0xb2d4d071d
157020.34,2.0,98,3,3,1,7,0xb2d5d0d4
3110.61,1.0,184,2,2,1,5,0xb2d2f615
100.9,1.0,24,1,2,2,5,0xb2d23be8
105005.99,2.0,98,3,3,1,7,0xb2d5b1a0
100713.18,2.0,0,3,3,4,10,0xb2d435a3d
10300.1,1.0,9,2,2,3,7,0xb2d34074
8.52,1.0,0,1,2,4,7,0xb2d8e68fd
701.19,1.0,0,1,2,4,7,0xb2d9c54e
75040.0,1.0,0,3,2,4,9,0xb2d244ced
19470.88,1.0,92,2,2,1,5,0xb2d357c0
118246.39,1.0,11,3,2,3,8,0xb2d53540d
191941.86,9.0,0,3,4,4,11,0xb2d65b58d
12843.77,2.0,15,2,3,3,8,0xb2d444f5
54.93,1.0,1,1,2,4,7,0xb2d4ee27d
68002.68,3.0,92,3,4,1,8,0xb2d97bc7d
120047.11,2.0,256,3,3,1,7,0xb2d43711
0.78,1.0,1,1,2,4,7,0xb2d1655c
930015.02,4.0,5,4,4,3,11,0xb2d9a299
55.54,1.0,53,1,2,2,5,0xb2d156b5
345.71,1.0,1,1,2,4,7,0xb2d9348c
933175.3,5.0,66,4,4,2,10,0xb2d3a49dd
100005.36,2.0,59,3,3,2,8,0xb2d252add
500046.57,3.0,0,4,4,4,12,0xb2d24a78d
22461.29,1.0,1,2,2,4,8,0xb2d2635e
2401.57,5.0,0,1,4,4,9,0x3b9af166d
60329.84,2.0,153,3,3,1,7,0xb2d62105d
85.27,1.0,17,1,2,2,5,0xb2d6816a
5645.09,1.0,6,2,2,3,7,0xb2d78c98
0.74,1.0,207,1,2,1,4,0xb2d38413d
31535.5,1.0,25,2,2,2,6,0xb2d1cdfb
695054.19,7.0,2,4,4,4,12,0xb2d59a7e
0.0,1.0,2,1,2,4,7,0xb2d6bcb3d
470016.65,6.0,1,4,4,4,12,0xb2d1b612
11216.42,1.0,0,2,2,4,8,0xb2d0e9ca
203287.13,3.0,11,3,4,3,10,0xb2d138ccd
7655.8,1.0,1,2,2,4,8,0xb2d21f9c
0.0,2.0,6,1,3,3,7,0xb2d4ee0e
61938.39,2.0,18,3,3,2,8,0xb2d69807d
583152.09,4.0,0,4,4,4,12,0xb2d2e9d8
1172183.25,7.0,11,4,4,3,11,0xb2d49d54
550080.82,5.0,4,4,4,4,12,0xb2d15d3ed
285.27,3.0,2,1,4,4,9,0xb2d09a03
12.31,1.0,18,1,2,2,5,0xb2d3a0aad
4603.04,1.0,89,2,2,1,5,0xb2d1dd02d
9780.89,1.0,184,2,2,1,5,0xb2d11ddcd
820000.0,6.0,1,4,4,4,12,0xb2d1ae0dd
7720322.48,10.0,17,4,4,2,10,0xb2d1df92d
0.0,1.0,0,1,2,4,7,0xb2d93d2a
20469.57,1.0,3,2,2,4,8,0xb2d5e11dd
352405.54,1.0,54,4,2,2,8,0xb2d35bdcd
500027.38,2.0,6,4,3,3,10,0xb2d95ef3d
201422.95,2.0,9,3,3,3,9,0xb2d6a654d
3.2,2.0,3,1,3,4,8,0xb2d06801
60101.61,2.0,41,3,3,2,8,0xb2d92094
77356.1,6.0,4,3,4,4,11,0x3b9af6abd
186837.19,3.0,139,3,4,1,8,0x3b9b3dbcd
500000.12,3.0,16,4,4,2,10,0xb2d23904
150171.8,7.0,41,3,4,2,9,0xb2d6d7aad
2314.67,1.0,184,1,2,1,4,0xb2d141c5d
270.95,1.0,6,1,2,3,6,0xb2d0db47
470028.73,2.0,4,4,3,4,11,0xb2d0b9f4d
11.27,1.0,7,1,2,3,6,0xb2d9557dd
10000.21,3.0,206,2,4,1,7,0xb2d06679
1566.42,1.0,9,1,2,3,6,0xb2d5060b
1392733.77,5.0,1,4,4,4,12,0xb2d3eb0a
1304989.75,1.0,0,4,2,4,10,0xb2da2d1a
14048.69,1.0,5,2,2,3,7,0xb2d229b5d
182.22,2.0,1,1,3,4,8,0xb2da4bf8
287495.41,2.0,108,3,3,1,7,0xb2d41890d
620002.01,4.0,173,4,4,1,9,0xb2d63762d
1453000.0,8.0,0,4,4,4,12,0xb2d8ec99d
1000167.51,6.0,8,4,4,3,11,0xb2d0d0ca
200000.0,2.0,13,3,3,3,9,0xb2da422f
1149526.18,3.0,0,4,4,4,12,0xb2d1898ed
10000.0,1.0,10,2,2,3,7,0xb2d9ea04
46077.35,1.0,0,2,2,4,8,0xb2d412d0
431164.22,7.0,3,4,4,4,12,0xb2d64e80d
600495.19,2.0,186,4,3,1,8,0xb2d39a47d
1.58,1.0,62,1,2,2,5,0xb2d8e0dc
30.19,1.0,57,1,2,2,5,0xb2d9b66d
10000.82,2.0,39,2,3,2,7,0xb2d9ec40
899725.4,7.0,19,4,4,2,10,0xb2d1deb0
410003.05,3.0,41,4,4,2,10,0xb2d24cead
404195.5,2.0,8,4,3,3,10,0xb2d20346d
100.86,1.0,52,1,2,2,5,0xb2d52a0d
110008.7,2.0,53,3,3,2,8,0xb2d63589d
30136.2,3.0,70,2,4,1,7,0xb2d6a7bed
1197284.86,9.0,4,4,4,4,12,0xb2d240d9d
51544.17,1.0,184,2,2,1,5,0xb2d376ead
1178441.83,3.0,1,4,4,4,12,0xb2d3b96ad
1217.45,1.0,184,1,2,1,4,0xb2d189bcd
3880.55,1.0,1,2,2,4,8,0xb2d31a46
1057746.37,17.0,0,4,4,4,12,0x3b9b1274d
2.34,1.0,24,1,2,2,5,0xb2d803a7
200000.75,2.0,26,3,3,2,8,0xb2d904d2d
750043.14,8.0,18,4,4,2,10,0xb2d0f852
6560.41,1.0,92,2,2,1,5,0xb2d23914d
214235.23,2.0,122,3,3,1,7,0xb2d23bd0d
567301.39,6.0,18,4,4,2,10,0xb2d1b856d
696496.77,6.0,3,4,4,4,12,0xb2d41773
290.76,1.0,0,1,2,4,7,0xb2d5dd84d
13156.76,1.0,8,2,2,3,7,0xb2d52945d
170943.0,1.0,13,3,2,3,8,0xb2d2b9cfd
55.92,1.0,7,1,2,3,6,0xb2d471a9
1212698.18,3.0,144,4,4,1,9,0xb2d0fd76d
33.01,1.0,11,1,2,3,6,0xb2d11596d
100047.16,2.0,10,3,3,3,9,0xb2d743b0
5626.78,1.0,0,2,2,4,8,0xb2d6e8ce
1368.65,1.0,92,1,2,1,4,0xb2d26e71d
1925006.21,14.0,34,4,4,2,10,0xb2d16f29
1015.19,1.0,92,1,2,1,4,0xb2d2ebab
45759.0,1.0,0,2,2,4,8,0xb2d6fe23
102529.03,2.0,12,3,3,3,9,0xb2d51033d
11118.57,1.0,20,2,2,2,6,0xb2d785a2d
19343.66,1.0,17,2,2,2,6,0xb2d97db5
106559.58,1.0,10,3,2,3,8,0xb2d3cce6d
200710.85,3.0,30,3,4,2,9,0xb2d9b852
3.69,1.0,11,1,2,3,6,0xb2d959dfd
1349.84,1.0,184,1,2,1,4,0xb2d2ebe1d
450000.5,3.0,0,4,4,4,12,0xb2da522f
10122.57,2.0,39,2,3,2,7,0xb2d6d02f
12844.85,1.0,0,2,2,4,8,0xb2d1f419
252.0,1.0,0,1,2,4,7,0xb2d6a6ca
22.39,1.0,10,1,2,3,6,0xb2d1914c
795007.63,4.0,14,4,4,3,11,0xb2d6583ed
123.86,1.0,6,1,2,3,6,0xb2d2f1ba
83.59,1.0,74,1,2,1,4,0xb2d593efd
8.34,1.0,25,1,2,2,5,0xb2d91a65
1035.52,1.0,88,1,2,1,4,0xb2d376b1d
760477.95,6.0,2,4,4,4,12,0xb2d23d61d
30664.92,3.0,2,2,4,4,10,0xb2d2b195
5292.2,1.0,9,2,2,3,7,0xb2d6f922
230000.0,2.0,13,3,3,3,9,0xb2da39bb
6015.55,1.0,216,2,2,1,5,0xb2d70578
380000.0,2.0,0,4,3,4,11,0xb2d97dffd
50062.85,2.0,116,2,3,1,6,0xb2d0ee39d
300006.35,2.0,213,3,3,1,7,0xb2d22c78d
104258.36,2.0,47,3,3,2,8,0xb2d6bb54
11.34,1.0,49,1,2,2,5,0xb2d4fc21
581584.46,4.0,0,4,4,4,12,0xb2d78747d
61831.04,1.0,21,3,2,2,7,0xb2d32b42
28029.19,2.0,31,2,3,2,7,0xb2d39951d
2105.22,1.0,92,1,2,1,4,0xb2d3491bd
2046.53,2.0,1,1,3,4,8,0xb2d2a828d
169.05,1.0,6,1,2,3,6,0xb2d60b7ad
17371.22,1.0,18,2,2,2,6,0xb2d6c2d8d
17903.92,5.0,3,2,4,4,10,0xb2d5f1add
5424.6,1.0,10,2,2,3,7,0xb2d3a12e
0.0,1.0,0,1,2,4,7,0xb2d6ec76d
200000.0,2.0,29,3,3,2,8,0xb2da09f7
1805.53,1.0,21,1,2,2,5,0xb2d587e8d
150006.34,3.0,55,3,4,2,9,0xb2d907f2d
612799.27,2.0,83,4,3,1,8,0xb2d78b51d
2500352.19,5.0,15,4,4,3,11,0xb2d2b914
450220.47,3.0,58,4,4,2,10,0xb2d8c6d3d
20000.82,2.0,21,2,3,2,7,0xb2d46a0ad
141713.69,10.0,3,3,4,4,11,0xb2d56bd5d
1440077.41,7.0,48,4,4,2,10,0xb2d30061d
355645.36,13.0,0,4,4,4,12,0xb2d5a292
6658.04,1.0,0,2,2,4,8,0xb2d6b566
288.17,1.0,3,1,2,4,7,0xb2d690c2d
635965.73,2.0,92,4,3,1,8,0x3b9ae085d
636900.84,2.0,27,4,3,2,9,0xb2d481c7
21737.77,1.0,0,2,2,4,8,0xb2d2a53bd
1031.51,1.0,5,1,2,3,6,0xb2d4cf39
14986.45,1.0,5,2,2,3,7,0xb2d156e2d
2473751.68,4.0,43,4,4,2,10,0xb2d948f5d
10401.11,1.0,10,2,2,3,7,0xb2d91c13
8818.87,1.0,0,2,2,4,8,0xb2d2dda4
220649.64,5.0,1,3,4,4,11,0xb2d946ccd
10061.06,2.0,0,2,3,4,9,0xb2d0a48dd
1589.17,1.0,192,1,2,1,4,0xb2d40ec8d
10310020.0,2.0,5,4,3,3,10,0xb2d5d566
3291.64,1.0,6,2,2,3,7,0xb2d07de4
47.01,1.0,1,1,2,4,7,0xb2d6929f
90632.3,1.0,98,3,2,1,6,0xb2d28760
21038.63,2.0,3,2,3,4,9,0xb2d242b7d
51001.11,2.0,101,2,3,1,6,0xb2d743bdd
2564.68,4.0,0,1,4,4,9,0x3b9b184cd
1419.98,1.0,10,1,2,3,6,0xb2d3f82c
25008.23,3.0,11,2,4,3,9,0xb2d360a3d
93664.81,4.0,0,3,4,4,11,0xb2d62337d
455728.61,3.0,14,4,4,3,11,0xb2d6c4ad
5049.34,1.0,16,2,2,2,6,0xb2d5d216d
50000.53,3.0,70,2,4,1,7,0xb2d4c037
101741.43,3.0,129,3,4,1,8,0xb2d643f1d
20479.76,6.0,1,2,4,4,10,0xb2d064acd
551804.07,5.0,32,4,4,2,10,0xb2d63bf3
0.0,1.0,97,1,2,1,4,0xb2d6472cd
158379.76,3.0,25,3,4,2,9,0xb2d518b2
6304.57,1.0,28,2,2,2,6,0xb2d13db1
330889.8,3.0,48,4,4,2,10,0xb2d9d63a
5923.99,1.0,0,2,2,4,8,0xb2d3c0aad
1068.05,1.0,259,1,2,1,4,0xb2d3175ad
12000106.86,2.0,184,4,3,1,8,0xb2d60808d
250000.05,2.0,20,3,3,2,8,0xb2d8d4b6
500052.1,2.0,1,4,3,4,11,0xb2d8f8b2
1170.72,1.0,19,1,2,2,5,0xb2d22d83d
350000.0,2.0,20,4,3,2,9,0xb2d955c4d
0.0,1.0,10,1,2,3,6,0xb2d99b23
87319.87,2.0,104,3,3,1,7,0xb2d2b33cd
8315.26,1.0,32,2,2,2,6,0xb2d43a95d
1168.17,1.0,0,1,2,4,7,0xb2d3e98e
21038.19,4.0,5,2,4,3,9,0xb2d07c08
400517.61,2.0,189,4,3,1,8,0xb2d20677
1010055.5,2.0,214,4,3,1,8,0xb2d5dd6fd
67048.25,2.0,20,3,3,2,8,0xb2d0c50a
1130514.58,3.0,27,4,4,2,10,0xb2d262c7
43.51,1.0,35,1,2,2,5,0xb2d34d45
842.83,1.0,3,1,2,4,7,0xb2d466d9
7012.27,1.0,176,2,2,1,5,0xb2d62c6ad
601395.65,3.0,13,4,4,3,11,0xb2d6c6f4
43.4,1.0,89,1,2,1,4,0xb2d36a15d
389021.72,2.0,14,4,3,3,10,0xb2d68447d
6.62,1.0,22,1,2,2,5,0xb2d8e003
20035.57,1.0,4,2,2,4,8,0xb2d2a987d
1109.57,1.0,0,1,2,4,7,0xb2d50658
1707.47,1.0,3,1,2,4,7,0xb2d906c7
52143.18,5.0,62,2,4,2,8,0xb2d682a3d
1203.6,1.0,182,1,2,1,4,0xb2d3bfa7
280184.97,3.0,12,3,4,3,10,0xb2d24054d
500015.83,2.0,32,4,3,2,9,0xb2d9fc81
473352.45,6.0,0,4,4,4,12,0xb2d3a2e9d
500032.73,4.0,83,4,4,1,9,0xb2d591b0d
3039.78,2.0,92,2,3,1,6,0xb2d08107d
218542.96,2.0,80,3,3,1,7,0xb2d3bec6d
1340.69,1.0,10,1,2,3,6,0xb2d43393
1728359.14,5.0,3,4,4,4,12,0xb2d5b6cbd
585.99,1.0,4,1,2,4,7,0xb2d2e151d
300000.26,2.0,0,3,3,4,10,0xb2d9c0bb
20125.04,1.0,1,2,2,4,8,0xb2d2eb9c
15094.04,1.0,0,2,2,4,8,0xb2d433c3d
2284628.99,14.0,1,4,4,4,12,0xb2d62f23d
10158.86,1.0,92,2,2,1,5,0xb2d19975d
374202.96,6.0,55,4,4,2,10,0xb2d1b1e6d
2012.8,1.0,159,1,2,1,4,0xb2d30a1b
0.0,1.0,6,1,2,3,6,0xb2d3fbc8
500029.83,1.0,5,4,2,3,9,0xb2d31688
0.0,1.0,3,1,2,4,7,0xb2d5e071d
1104743.18,20.0,0,4,4,4,12,0x3b9b17f5d
1808292.3,3.0,143,4,4,1,9,0xb2d4fe3ed
1671.69,1.0,92,1,2,1,4,0xb2d324bf
50023.53,2.0,25,2,3,2,7,0xb2d3c0d9
750000.04,7.0,1,4,4,4,12,0xb2d25de5d
3207111.37,3.0,105,4,4,1,9,0xb2d626b3d
318.75,1.0,9,1,2,3,6,0xb2d79075
65000.69,2.0,83,3,3,1,7,0xb2d983b2
1064.27,1.0,22,1,2,2,5,0xb2d30d9cd
354.59,1.0,0,1,2,4,7,0xb2da068b
24796.73,1.0,0,2,2,4,8,0xb2d17da1
364966.74,3.0,123,4,4,1,9,0xb2d3a599d
6001.47,1.0,10,2,2,3,7,0xb2d5b897
7873.3,1.0,14,2,2,3,7,0xb2d64bd2d
739.82,4.0,0,1,4,4,9,0x3b9b46d6
500076.05,2.0,26,4,3,2,9,0xb2d92f09
14557.48,1.0,10,2,2,3,7,0xb2d5cee2d
370738.65,4.0,6,4,4,3,11,0xb2d52b6d
1243.91,1.0,11,1,2,3,6,0xb2d68e24
130308.68,4.0,45,3,4,2,9,0xb2d6fc70d
101408.53,2.0,0,3,3,4,10,0xb2d281e0d
8315.88,1.0,0,2,2,4,8,0xb2d61133d
775.51,1.0,59,1,2,2,5,0xb2d3a4de
15869.96,3.0,0,2,4,4,10,0x3b9b45d0
8.88,1.0,13,1,2,3,6,0xb2d9e0c8
498492.78,1.0,10,4,2,3,9,0xb2d4bb4cd
1965.94,1.0,10,1,2,3,6,0xb2d6cc73
827100.25,3.0,196,4,4,1,9,0xb2d3a93ed
631140.73,5.0,3,4,4,4,12,0xb2d42751
100001.06,2.0,67,3,3,1,7,0xb2d9af99
8404.65,1.0,6,2,2,3,7,0xb2d1a880
200002.11,2.0,27,3,3,2,8,0xb2d9411ad
1067748.82,7.0,0,4,4,4,12,0xb2d1b04c
105202.26,2.0,165,3,3,1,7,0xb2d44db4d
15845.03,1.0,63,2,2,2,6,0xb2d3829d
152173.18,2.0,73,3,3,1,7,0xb2d61f94d
8206.0,1.0,1,2,2,4,8,0xb2d93be8
16340.6,1.0,10,2,2,3,7,0xb2d5e4a9
390091.94,2.0,18,4,3,2,9,0xb2d4de98d
0.24,1.0,67,1,2,1,4,0xb2d55a51d
796025.14,10.0,7,4,4,3,11,0xb2d3bda2d
1760.41,1.0,63,1,2,2,5,0xb2d67d3e
1127.45,1.0,92,1,2,1,4,0xb2d26119d
4007.34,1.0,8,2,2,3,7,0xb2d64481
290208.46,6.0,21,3,4,2,9,0xb2d41115d
170043.76,2.0,221,3,3,1,7,0xb2d63cedd
2143.27,1.0,5,1,2,3,6,0xb2d234dd
8612.51,1.0,0,2,2,4,8,0xb2d69058
208.69,1.0,0,1,2,4,7,0xb2d4b9b5d
4010429.67,5.0,8,4,4,3,11,0xb2d18f35d
352056.69,14.0,14,4,4,3,11,0xb2d1b544d
300078.1,2.0,189,3,3,1,7,0xb2d25ee0d
10614.2,1.0,29,2,2,2,6,0xb2d923f0
2530001.54,10.0,0,4,4,4,12,0xb2d1c8d5d
2993.24,3.0,0,2,4,4,10,0xb2d06d70d
663734.52,2.0,83,4,3,1,8,0xb2d09ef0d
50117.6,6.0,21,2,4,2,8,0xb2d3831b
1170631.15,15.0,0,4,4,4,12,0x3b9af149d
183229.54,9.0,0,3,4,4,11,0xb2d2bcae
5832.84,1.0,21,2,2,2,6,0xb2d6eeefd
188514.78,5.0,0,3,4,4,11,0xb2d5b5c6d
175089.27,10.0,11,3,4,3,10,0xb2d6b12ed
5208.85,1.0,8,2,2,3,7,0xb2d8ce73d
40001.33,4.0,74,2,4,1,7,0xb2d93f81d
51453.08,2.0,151,2,3,1,6,0xb2d60629d
202892.54,2.0,96,3,3,1,7,0xb2d27446
3110.94,1.0,2,2,2,4,8,0xb2d33f3e
4609.0,1.0,184,2,2,1,5,0xb2d0dfb2d
3112034.08,35.0,0,4,4,4,12,0xb2d6ac15
1300000.0,12.0,1,4,4,4,12,0xb2d2b184d
170010.36,3.0,103,3,4,1,8,0xb2d62b64d
60083.72,2.0,174,3,3,1,7,0xb2d3ff4cd
1117.6,1.0,4,1,2,4,7,0xb2d3207dd
150013.82,2.0,28,3,3,2,8,0xb2d67ccbd
575.82,1.0,1,1,2,4,7,0xb2d37d7fd
78929.39,1.0,1,3,2,4,9,0xb2d40123
3673.24,1.0,0,2,2,4,8,0xb2d3f154
20.86,1.0,46,1,2,2,5,0xb2d3252d
40001.27,2.0,92,2,3,1,6,0xb2d6495e
794.79,1.0,4,1,2,4,7,0xb2d94540
18.57,1.0,4,1,2,4,7,0xb2d26fc6
100001.06,2.0,18,3,3,2,8,0xb2d957a9
1549.55,2.0,92,1,3,1,5,0xb2d0b2f2d
366003.87,4.0,35,4,4,2,10,0xb2d9d5f0
5143.36,1.0,92,2,2,1,5,0xb2d12078d
735566.44,12.0,0,4,4,4,12,0xb2d0cd5e
2.1,1.0,10,1,2,3,6,0xb2d86ed0
3299.61,1.0,125,2,2,1,5,0xb2d2a4db
600127.7,4.0,7,4,4,3,11,0xb2d0d9ebd
1087.69,1.0,9,1,2,3,6,0xb2d8d6c6
383548.76,3.0,0,4,4,4,12,0xb2d274dbd
155372.16,2.0,0,3,3,4,10,0xb2d2d28bd
200074.24,2.0,92,3,3,1,7,0xb2d48ffb
5950.58,2.0,19,2,3,2,7,0xb2d19576
412.52,1.0,9,1,2,3,6,0xb2d56008d
5107.97,1.0,92,2,2,1,5,0xb2d4056e
201543.24,4.0,74,3,4,1,8,0xb2d61495d
1212.42,3.0,92,1,4,1,6,0x3b9b16e8
103524.21,2.0,70,3,3,1,7,0xb2d4fe62
246120.47,5.0,0,3,4,4,11,0xb2d51697
160347.99,3.0,143,3,4,1,8,0xb2d28bd9
8230.62,1.0,13,2,2,3,7,0xb2d4118f
90.12,1.0,4,1,2,4,7,0xb2d2199d
3376.1,1.0,195,2,2,1,5,0xb2d241b0d
100026.96,2.0,179,3,3,1,7,0xb2d51293d
4.37,1.0,12,1,2,3,6,0xb2d2e817
44657.73,1.0,161,2,2,1,5,0xb2d42e5b
62037.62,2.0,203,3,3,1,7,0xb2d3273cd
1567.6,1.0,10,1,2,3,6,0xb2d26962d
1303089.82,1.0,235,4,2,1,7,0xb2d6edd4d
172708.34,4.0,10,3,4,3,10,0xb2d4f91fd
213170.71,4.0,40,3,4,2,9,0xb2d3b863d
5043059.79,4.0,41,4,4,2,10,0xb2d5d9c9d
311284.9,1.0,0,4,2,4,10,0xb2d3ba29
9.85,1.0,39,1,2,2,5,0xb2d27f97
10173.64,2.0,160,2,3,1,6,0xb2d5e5b9d
311104.3,2.0,40,4,3,2,9,0xb2d45838
380004.05,3.0,6,4,4,3,11,0xb2d229d4
300252.84,3.0,182,4,4,1,9,0xb2d36809
60277.89,1.0,184,3,2,1,6,0xb2d5f49a
1000067.45,8.0,37,4,4,2,10,0xb2d41a9ad
7506.5,1.0,0,2,2,4,8,0xb2d18054
2672.18,2.0,184,1,3,1,5,0xb2d08897d
4.53,1.0,36,1,2,2,5,0xb2d0f3d6
501858.52,2.0,19,4,3,2,9,0xb2d96f3dd
4.22,1.0,62,1,2,2,5,0xb2d9a836
200731.92,2.0,16,3,3,2,8,0xb2d6b177
110074.04,6.0,14,3,4,3,10,0xb2d96795d
5200.44,1.0,0,2,2,4,8,0xb2d6b533
500000.06,2.0,7,4,3,3,10,0xb2d9e903
100683.52,2.0,256,3,3,1,7,0xb2d659a1d
1917.31,1.0,9,1,2,3,6,0xb2d90136
600012.5,11.0,12,4,4,3,11,0xb2d1f89ad
2120001.15,15.0,5,4,4,3,11,0xb2d2b088
57.83,1.0,59,1,2,2,5,0xb2d586f4
220107.53,3.0,39,3,4,2,9,0xb2d14041d
60142.48,2.0,0,3,3,4,10,0xb2d5a13e
309042.26,3.0,91,4,4,1,9,0xb2d4a570d
9.0,2.0,12,1,3,3,7,0xb2d1bbca
3697.92,1.0,97,2,2,1,5,0xb2d6476cd
1100072.83,10.0,8,4,4,3,11,0xb2d153f2d
1435878.56,8.0,0,4,4,4,12,0xb2d65826
29542.87,2.0,3,2,3,4,9,0xb2d0a0a8
203628.7,2.0,154,3,3,1,7,0xb2d14916
252.25,1.0,10,1,2,3,6,0xb2d981fc
200102.11,2.0,12,3,3,3,9,0xb2d9f885
70264.38,2.0,19,3,3,2,8,0xb2d37c6bd
716241.92,11.0,4,4,4,4,12,0xb2d280f5d
300000.0,1.0,1,3,2,4,9,0xb2da6992
509735.16,16.0,1,4,4,4,12,0xb2d5361fd
2.13,1.0,104,1,2,1,4,0xb2d598d9d
50001.06,2.0,24,2,3,2,7,0xb2d94991d
500099.56,2.0,3,4,3,4,11,0xb2d63d83
15002569.51,2.0,20,4,3,2,9,0xb2d43c7fd
56895.07,1.0,1,3,2,4,9,0xb2d654a3
29147.25,1.0,0,2,2,4,8,0xb2d32a6f
200077.58,2.0,12,3,3,3,9,0xb2d684b4
547977.28,8.0,101,4,4,1,9,0xb2d20c07d
13073.7,1.0,4,2,2,4,8,0xb2d63159
201103.1,4.0,10,3,4,3,10,0xb2d1e2b0d
2295895.76,3.0,30,4,4,2,10,0xb2d0adeed
2260.01,1.0,7,1,2,3,6,0xb2d4da80
39847.24,1.0,6,2,2,3,7,0xb2d18d2b
1400011.63,3.0,0,4,4,4,12,0xb2d4f0ded
3.02,1.0,3,1,2,4,7,0xb2d8e732
1170.41,1.0,27,1,2,2,5,0xb2d4194fd
102521.3,2.0,52,3,3,2,8,0xb2d40a51d
200020.86,2.0,21,3,3,2,8,0xb2d98a55
2657.81,1.0,6,1,2,3,6,0xb2d6f55ad
420984.38,4.0,0,4,4,4,12,0xb2d6efec
90867.15,3.0,26,3,4,2,9,0xb2d583bcd
427.34,6.0,8,1,4,3,8,0xb2d35be5d
20201.67,3.0,10,2,4,3,9,0xb2d47bead
433094.94,3.0,0,4,4,4,12,0xb2d86f83d
37.18,3.0,74,1,4,1,6,0x3b9ace4a
132276.3,5.0,0,3,4,4,11,0xb2d59cf3d
2412.12,1.0,184,1,2,1,4,0xb2d59be9d
3936.69,1.0,92,2,2,1,5,0xb2d07440d
710023.64,3.0,66,4,4,2,10,0xb2d8dab0d
247216.13,2.0,26,3,3,2,8,0xb2d230b5d
1042.33,1.0,184,1,2,1,4,0xb2d2ce81d
32291.4,2.0,0,2,3,4,9,0xb2d5cf5ad
155199.23,11.0,0,3,4,4,11,0xb2d1851dd
721003.08,11.0,0,4,4,4,12,0xb2d08aa3d
500000.0,2.0,9,4,3,3,10,0xb2d9e74f
4215.5,1.0,0,2,2,4,8,0xb2d2dac3
200008.45,2.0,154,3,3,1,7,0xb2d8f62ed
224.96,1.0,13,1,2,3,6,0xb2d3193cd
483.52,1.0,0,1,2,4,7,0xb2d8eb1d
140004.43,2.0,60,3,3,2,8,0xb2d9ba1e
25003.68,2.0,8,2,3,3,8,0xb2da378d
1.0,1.0,42,1,2,2,5,0xb2d92431d
125089.0,4.0,35,3,4,2,9,0xb2d6f88b
6366.11,1.0,6,2,2,3,7,0xb2d8e992d
100102.21,2.0,45,3,3,2,8,0xb2d91544d
500000.0,2.0,12,4,3,3,10,0xb2da4812
30001.48,3.0,31,2,4,2,8,0xb2d912f0
30000.95,2.0,10,2,3,3,8,0xb2d96052d
355116.93,3.0,5,4,4,3,11,0xb2d56c11
602532.58,5.0,47,4,4,2,10,0xb2d5b267d
32900.08,1.0,5,2,2,3,7,0xb2d9296fd
4366.25,1.0,92,2,2,1,5,0xb2d5abced
30874.32,2.0,6,2,3,3,8,0xb2d5808dd
3077.19,1.0,1,2,2,4,8,0xb2d70166d
71.12,1.0,110,1,2,1,4,0xb2d5bb06d
160004.2,5.0,13,3,4,3,10,0xb2d2c805d
760.26,1.0,9,1,2,3,6,0xb2d53013d
50078.3,2.0,92,2,3,1,6,0xb2d62dbd
80000.84,2.0,49,3,3,2,8,0xb2d9d7ab
4561.32,3.0,6,2,4,3,9,0xb2d78ec2
500000.08,2.0,27,4,3,2,9,0xb2d8c7f8
50010.95,2.0,83,2,3,1,6,0xb2d1ad9ad
1.27,1.0,12,1,2,3,6,0xb2d94199d
35248.91,1.0,168,2,2,1,5,0xb2d46f27
12546.35,1.0,9,2,2,3,7,0xb2d78d50
114483.29,1.0,4,3,2,4,9,0xb2d6b1b1
13.13,1.0,61,1,2,2,5,0xb2d5abf9
720078.64,7.0,3,4,4,4,12,0xb2d11406d
450025.98,2.0,80,4,3,1,8,0xb2d8d7a7d
1017.5,1.0,184,1,2,1,4,0xb2d1a32fd
15585.82,1.0,11,2,2,3,7,0xb2d92057d
22.19,1.0,124,1,2,1,4,0xb2d5cc89d
9243.21,1.0,0,2,2,4,8,0xb2d6501cd
2756.83,1.0,0,1,2,4,7,0xb2d54f12d
530039.78,5.0,1,4,4,4,12,0xb2d652fb
202309.27,2.0,90,3,3,1,7,0xb2d6a6f4d
1765000.0,8.0,1,4,4,4,12,0xb2d0ec8fd
3502.7,1.0,7,2,2,3,7,0xb2d3bfd9
9388.52,1.0,92,2,2,1,5,0xb2d2509dd
5.7,1.0,2,1,2,4,7,0xb2d6bf0fd
51081.33,2.0,6,2,3,3,8,0xb2d7f2e7
151254.25,4.0,3,3,4,4,11,0xb2d65bc5
7.23,1.0,7,1,2,3,6,0xb2d1d973
280.91,1.0,42,1,2,2,5,0xb2d657f6
7383.92,6.0,0,2,4,4,10,0xb2d1923dd
560009.14,4.0,52,4,4,2,10,0xb2d5ad20d
761.94,1.0,10,1,2,3,6,0xb2d6ef2ed
0.0,1.0,7,1,2,3,6,0xb2da3844
12294.43,2.0,0,2,3,4,9,0xb2d64d33d
7.93,1.0,14,1,2,3,6,0xb2d5b5f4
26130.49,1.0,0,2,2,4,8,0xb2d24e03d
8.33,1.0,13,1,2,3,6,0xb2d60a92
146069.16,310.0,0,3,4,4,11,0x3b9b4643d
650369.34,3.0,0,4,4,4,12,0xb2d8c9b6
4502.27,1.0,42,2,2,2,6,0xb2d3252dd
870000.0,8.0,0,4,4,4,12,0xb2d30539
230946.87,3.0,97,3,4,1,8,0xb2d1b4fdd
2689.2,1.0,92,1,2,1,4,0xb2d1afd6d
158.23,1.0,3,1,2,4,7,0xb2d16980d
316022.52,5.0,14,4,4,3,11,0xb2d0d515d
300000.56,2.0,27,3,3,2,8,0xb2d21175d
141906.24,3.0,49,3,4,2,9,0xb2d16705d
3400.86,1.0,33,2,2,2,6,0xb2d93ac8
5044.91,1.0,92,2,2,1,5,0xb2d5a199d
516129.51,4.0,0,4,4,4,12,0xb2d2c2f2
30531.55,2.0,92,2,3,1,6,0xb2d55d45d
20322.09,1.0,84,2,2,1,5,0xb2d37c42
4002826.97,8.0,0,4,4,4,12,0xb2d0c55fd
1.06,1.0,6,1,2,3,6,0xb2d6b405
102156.41,2.0,199,3,3,1,7,0xb2d43bb4
20105.37,1.0,92,2,2,1,5,0xb2d439b1
40069.5,2.0,1,2,3,4,9,0xb2d0693fd
30.04,1.0,12,1,2,3,6,0xb2d30f49
500000.0,2.0,22,4,3,2,9,0xb2d98ea5
300125.77,8.0,6,4,4,3,11,0x3b9b3a97
3.63,1.0,10,1,2,3,6,0xb2da042d
5755.12,1.0,250,2,2,1,5,0xb2d43487d
3053000.52,12.0,1,4,4,4,12,0xb2d07c62d
1332.78,1.0,28,1,2,2,5,0xb2d1b8b5d
50001.06,2.0,31,2,3,2,7,0xb2d93a9e
28707.4,1.0,10,2,2,3,7,0xb2d94fd7
139947.4,2.0,168,3,3,1,7,0xb2d56e8dd
72001.84,3.0,87,3,4,1,8,0xb2d2d819d
0.0,1.0,1,1,2,4,7,0xb2d55422
53116.54,2.0,95,3,3,1,7,0xb2d4d97ad
5210.35,1.0,54,2,2,2,6,0xb2d53620
214.23,1.0,0,1,2,4,7,0xb2d56689
323665.63,7.0,27,4,4,2,10,0xb2d8048dd
525361.16,8.0,3,4,4,4,12,0xb2d43d6ad
189110.18,1.0,0,3,2,4,9,0xb2d4c194
2134.37,1.0,76,1,2,1,4,0xb2d25d5ed
5093.65,1.0,14,2,2,3,7,0xb2d24a36d
500021.16,2.0,200,4,3,1,8,0xb2d51c81d
1461301.9,17.0,0,4,4,4,12,0x3b9b0fb9
660017.31,6.0,9,4,4,3,11,0xb2d5f58bd
28480.26,7.0,0,2,4,4,10,0xb2d094add
286424.01,2.0,135,3,3,1,7,0xb2d5ac0ad
420009.21,4.0,11,4,4,3,11,0xb2d4c95dd
500000.0,2.0,0,4,3,4,11,0xb2d8f1fdd
560204.88,5.0,21,4,4,2,10,0xb2d99867
17512.38,1.0,211,2,2,1,5,0xb2d3bd66d
6.62,1.0,25,1,2,2,5,0xb2d454fc
439616.14,2.0,122,4,3,1,8,0xb2d121cad
0.32,1.0,87,1,2,1,4,0xb2d3ad01
11.83,2.0,20,1,3,2,6,0xb2d09fd6
500006.06,2.0,15,4,3,3,10,0xb2d9ae45
127.13,1.0,84,1,2,1,4,0xb2d10301
190011.62,3.0,147,3,4,1,8,0xb2d698e3d
5.17,1.0,20,1,2,2,5,0xb2d5d3b9
430042.95,8.0,53,4,4,2,10,0xb2d3bbbad
1112115.55,2.0,42,4,3,2,9,0xb2d19af4d
13061.57,2.0,0,2,3,4,9,0xb2d0bc97
400000.0,3.0,7,4,4,3,11,0xb2da372e
500005.28,2.0,76,4,3,1,8,0xb2d8dbcfd
82.96,1.0,7,1,2,3,6,0xb2d16963
1400040.57,7.0,92,4,4,1,9,0xb2d1d4f4d
1903.27,1.0,15,1,2,3,6,0xb2d68774
2088351.91,1.0,193,4,2,1,7,0xb2d46f1fd
2000338.72,2.0,23,4,3,2,9,0xb2d68ffdd
4.85,1.0,20,1,2,2,5,0xb2d94969
150003.71,2.0,0,3,3,4,10,0xb2d2a68a
3727.69,1.0,184,2,2,1,5,0xb2d079b9d
93.21,1.0,3,1,2,4,7,0xb2d110add
124.7,1.0,11,1,2,3,6,0xb2d54f65
90002.45,3.0,5,3,4,3,10,0xb2d26185d
1036053.04,4.0,132,4,4,1,9,0xb2d1ae04
1050877.38,6.0,0,4,4,4,12,0x3b9af1e6
252008.68,3.0,5,3,4,3,10,0xb2d6289b
497.34,2.0,10,1,3,3,7,0xb2d9f17d
57015.64,5.0,9,3,4,3,10,0xb2d92079
150001.58,2.0,119,3,3,1,7,0xb2d94140d
640039.8,6.0,0,4,4,4,12,0xb2d5fd65
4077.48,2.0,1,2,3,4,9,0xb2d18f87d
423137.5,11.0,1,4,4,4,12,0xb2d1925ad
370.54,1.0,3,1,2,4,7,0xb2d6b15bd
520198.96,6.0,108,4,4,1,9,0xb2d194ddd
350259.7,2.0,1,4,3,4,11,0xb2d6becd
11.18,1.0,69,1,2,1,4,0xb2d64408d
281081.54,4.0,0,3,4,4,11,0xb2d61434d
581585.59,5.0,18,4,4,2,10,0xb2d5e562
2860887.5,16.0,6,4,4,3,11,0xb2d3c378d
375173.06,3.0,2,4,4,4,12,0xb2d9b5fd
200004.6,2.0,0,3,3,4,10,0xb2d93552d
1888065.19,9.0,10,4,4,3,11,0x3b9b37ab
8073.1,1.0,0,2,2,4,8,0xb2d439f6
3.6,1.0,31,1,2,2,5,0xb2d6a0c8
467021.33,6.0,94,4,4,1,9,0xb2d32e43d
42113.56,1.0,26,2,2,2,6,0xb2d5f358
2690027.46,4.0,3,4,4,4,12,0xb2d1d227
81053.92,3.0,97,3,4,1,8,0xb2d5dd3ad
449054.03,3.0,70,4,4,1,9,0xb2d2dfacd
20000.21,2.0,6,2,3,3,8,0xb2d96a74d
890286.66,3.0,18,4,4,2,10,0xb2d45c2c
160048.32,3.0,3,3,4,4,11,0xb2d5eb18
76.78,1.0,70,1,2,1,4,0xb2d2ce2a
730010.56,3.0,4,4,4,4,12,0xb2d9773dd
4582.65,1.0,98,2,2,1,5,0xb2d3bca4d
1057.45,1.0,0,1,2,4,7,0xb2d2b61b
1010000.15,5.0,5,4,4,3,11,0xb2d6b6e2
214827.36,2.0,137,3,3,1,7,0xb2d1a4a1d
164759.15,3.0,31,3,4,2,9,0xb2d5f352d
500000.0,2.0,21,4,3,2,9,0xb2d9509fd
1343.91,1.0,79,1,2,1,4,0xb2d3a0ad
6.45,1.0,80,1,2,1,4,0xb2d5ab2d
200000.0,1.0,0,3,2,4,9,0xb2da6b26
100875.84,4.0,0,3,4,4,11,0xb2d53c51d
520307.88,2.0,92,4,3,1,8,0xb2d61cc6d
40237.92,12.0,2,2,4,4,10,0xb2d10030d
62135.3,2.0,92,3,3,1,7,0xb2d62932d
70315.69,2.0,216,3,3,1,7,0xb2d39625d
1855.89,1.0,10,1,2,3,6,0xb2d2d045
206.8,1.0,51,1,2,2,5,0xb2d7c166d
9470982.58,2.0,27,4,3,2,9,0xb2d3a36dd
500010.23,4.0,14,4,4,3,11,0xb2d6e879d
50579.07,2.0,42,2,3,2,7,0xb2d8cdc3d
1196.61,1.0,10,1,2,3,6,0xb2d2bbd9d
4030.56,1.0,140,2,2,1,5,0xb2d3a526
1482.52,1.0,184,1,2,1,4,0xb2d12d47d
15826.26,1.0,27,2,2,2,6,0xb2d44959d
10003.48,1.0,27,2,2,2,6,0xb2d98e52
1201.25,1.0,11,1,2,3,6,0xb2d324b2d
21.64,1.0,32,1,2,2,5,0xb2d8dfdb
513.17,6.0,10,1,4,3,8,0xb2d098e0d
60002.53,2.0,217,3,3,1,7,0xb2d71701
5742.5,1.0,9,2,2,3,7,0xb2d3c2d9d
27135.27,1.0,0,2,2,4,8,0xb2d6cd2cd
23.43,1.0,74,1,2,1,4,0xb2d942c6
111837.0,1.0,9,3,2,3,8,0xb2d4f52ed
63147.35,2.0,216,3,3,1,7,0xb2d433e7d
500000.0,2.0,0,4,3,4,11,0xb2d9837a
6674.48,1.0,29,2,2,2,6,0xb2d938ba
0.0,1.0,2,1,2,4,7,0xb2d99330
1819.48,1.0,9,1,2,3,6,0xb2d36505
195249.29,14.0,3,3,4,4,11,0x3b9af17cd
80000.0,2.0,0,3,3,4,10,0xb2d496ecd
331504.03,3.0,1,4,4,4,12,0xb2d1332cd
4051001.43,1.0,7,4,2,3,9,0xb2da02d4
200055.18,2.0,1,3,3,4,10,0xb2d5617d
233440.86,3.0,0,3,4,4,11,0xb2d6a34d
14306.04,1.0,0,2,2,4,8,0xb2d6e962d
3821.29,1.0,17,2,2,2,6,0xb2d45a98
7007.28,1.0,18,2,2,2,6,0xb2d6b722d
1842.39,1.0,92,1,2,1,4,0xb2d1016bd
22150.09,1.0,5,2,2,3,7,0xb2d2de2bd
362087.61,2.0,1,4,3,4,11,0xb2d0c96c
100062.42,2.0,125,3,3,1,7,0xb2d2805c
7481.16,11.0,184,2,4,1,7,0xb2d104b1
1700086.3,25.0,4,4,4,4,12,0xb2d6f057d
87.19,1.0,22,1,2,2,5,0xb2d1c801
81934.52,3.0,136,3,4,1,8,0xb2d538d7d
974421.09,15.0,1,4,4,4,12,0xb2d17830d
389857.75,2.0,86,4,3,1,8,0xb2d20dd0d
735467.52,11.0,18,4,4,2,10,0xb2d0897fd
160001.0,1.0,1,3,2,4,9,0xb2d5d89f
1525.84,1.0,28,1,2,2,5,0xb2d87b79
100003.92,5.0,48,3,4,2,9,0xb2d99ea3
73515.93,3.0,3,3,4,4,11,0xb2d782c2
251835.36,2.0,69,3,3,1,7,0xb2d6546a
987291.89,11.0,10,4,4,3,11,0xb2d4386d
85.28,1.0,10,1,2,3,6,0xb2d586b7
23.35,1.0,54,1,2,2,5,0xb2d5e182
330082.51,6.0,24,4,4,2,10,0xb2d16b5fd
1066.1,1.0,21,1,2,2,5,0xb2d2a390
263.54,1.0,1,1,2,4,7,0xb2d35806
121614.82,2.0,139,3,3,1,7,0xb2d55277d
400000.0,3.0,3,4,4,4,12,0xb2d94460d
199057.28,6.0,21,3,4,2,9,0xb2d1a3d3d
5567.64,1.0,92,2,2,1,5,0xb2d38747
60855.24,3.0,172,3,4,1,8,0xb2d5c779
3011.37,1.0,184,2,2,1,5,0x3b9af629d
430025.5,8.0,14,4,4,3,11,0xb2d1bc1cd
132075.39,1.0,10,3,2,3,8,0xb2d20108d
2018888.33,1.0,0,4,2,4,10,0xb2d3f9d1d
770037.33,7.0,25,4,4,2,10,0xb2d520f7d
392975.46,1.0,1,4,2,4,10,0xb2da14a0
300001.48,2.0,21,3,3,2,8,0xb2d94fcad
335003.97,5.0,1,4,4,4,12,0xb2d78427
123920.63,1.0,8,3,2,3,8,0xb2d40c5c
310671.24,2.0,97,4,3,1,8,0xb2d683edd
2190462.28,2.0,4,4,3,4,11,0xb2d471d3d
4794.58,1.0,9,2,2,3,7,0xb2d2947d
50000.64,2.0,19,2,3,2,7,0xb2d43554d
8376.16,1.0,7,2,2,3,7,0xb2d69b89d
200201.42,6.0,0,3,4,4,11,0xb2d59b0ad
4529.08,1.0,137,2,2,1,5,0xb2d49065d
500032.24,3.0,97,4,4,1,9,0xb2d6394cd
21.46,1.0,5,1,2,3,6,0xb2d7bce2
78020.19,3.0,18,3,4,2,9,0x3b9b1880d
50015.78,3.0,2,2,4,4,10,0xb2d31855d
85190.35,3.0,20,3,4,2,9,0xb2d4f1bed
15026.31,1.0,3,2,2,4,8,0xb2d620e8d
31.66,1.0,20,1,2,2,5,0xb2d56ab9
300001.26,2.0,23,3,3,2,8,0xb2d98746
4869.78,1.0,18,2,2,2,6,0xb2d205e1
303551.64,2.0,34,4,3,2,9,0xb2d420d8
17396.33,1.0,14,2,2,3,7,0xb2d69751d
41.29,1.0,9,1,2,3,6,0xb2d438c8d
110.05,1.0,22,1,2,2,5,0xb2d98cfb
2458.19,1.0,0,1,2,4,7,0xb2d6f029
96.34,1.0,126,1,2,1,4,0xb2d4d3a9d
405570.25,4.0,179,4,4,1,9,0xb2d3844cd
34903.35,1.0,184,2,2,1,5,0xb2d40562
100429.75,2.0,64,3,3,2,8,0xb2d11ad5
1007668.87,18.0,3,4,4,4,12,0xb2d152b9d
30000.95,2.0,31,2,3,2,7,0xb2d617e9d
50000.0,2.0,1,2,3,4,9,0xb2da1c4c
3186.84,1.0,10,2,2,3,7,0xb2d6b458
1.37,1.0,75,1,2,1,4,0xb2d99c7f
4.36,1.0,3,1,2,4,7,0xb2d38e29
8438.68,1.0,3,2,2,4,8,0xb2d6e818d
67923.33,1.0,10,3,2,3,8,0xb2d5d4bdd
17559.27,1.0,0,2,2,4,8,0xb2d0dab1
201511.28,2.0,55,3,3,2,8,0xb2d5c710d
603776.21,2.0,8,4,3,3,10,0xb2d641c5d
160000.0,2.0,2,3,3,4,10,0xb2d436ad
205000.19,2.0,21,3,3,2,8,0xb2d90bd7d
3.61,1.0,35,1,2,2,5,0xb2d3c98bd
3592.58,1.0,92,2,2,1,5,0xb2d1ec9c
2050.22,1.0,14,1,2,3,6,0xb2d68a62
561036.76,5.0,13,4,4,3,11,0xb2d3e62bd
20.42,1.0,18,1,2,2,5,0xb2d1bc74
159471.01,2.0,0,3,3,4,10,0xb2d06e6ed
311349.64,3.0,13,4,4,3,11,0xb2d339e4
51745.9,3.0,147,2,4,1,7,0xb2d0b399
50108.81,2.0,123,2,3,1,6,0xb2d5c5d0
125035.82,3.0,42,3,4,2,9,0xb2d2d238d
240054.09,2.0,27,3,3,2,8,0xb2d9bc7f
1255107.0,5.0,102,4,4,1,9,0xb2d33e55d
30524.8,2.0,164,2,3,1,6,0xb2d60492d
633.37,1.0,7,1,2,3,6,0xb2d8d676d
9.87,1.0,47,1,2,2,5,0xb2d92402
389.24,1.0,53,1,2,2,5,0xb2d90302d
70005.65,3.0,75,3,4,1,8,0xb2d6659dd
30191.66,3.0,4,2,4,4,10,0xb2d53255d
20.78,1.0,21,1,2,2,5,0xb2d26856d
503552.45,2.0,60,4,3,2,9,0xb2d9c354
205.82,1.0,13,1,2,3,6,0xb2d59eb7
0.3,1.0,1,1,2,4,7,0xb2d62654d
140005.39,3.0,47,3,4,2,9,0xb2d5bd6ad
200001.68,2.0,9,3,3,3,9,0xb2d6fce0d
580981.44,3.0,4,4,4,4,12,0xb2d6ff9e
43446.82,1.0,10,2,2,3,7,0xb2d3f5c5d
200011.31,2.0,25,3,3,2,8,0xb2d9426f
25812.78,1.0,10,2,2,3,7,0xb2d1dd08
513734.5,2.0,1,4,3,4,11,0xb2d969fad
3466.62,1.0,0,2,2,4,8,0xb2d6e7cc
10000.85,2.0,18,2,3,2,7,0xb2d5fcd7
12017.73,1.0,184,2,2,1,5,0xb2d20ef7d
35297.25,1.0,9,2,2,3,7,0xb2d4b664
322.99,1.0,19,1,2,2,5,0xb2d25b5ed
110558.21,1.0,0,3,2,4,9,0xb2d55c78d
2924.11,1.0,184,2,2,1,5,0xb2d1f945d
2025000.0,7.0,1,4,4,4,12,0xb2d24af7d
900615.37,2.0,20,4,3,2,9,0xb2d5fcdad
500000.0,3.0,14,4,4,3,11,0xb2d915ca
1016.46,1.0,184,1,2,1,4,0xb2d0fe43d
415273.95,2.0,14,4,3,3,10,0xb2d59074
39.19,1.0,25,1,2,2,5,0xb2d23299
51014.65,2.0,101,2,3,1,6,0xb2d1baeed
30718.39,1.0,0,2,2,4,8,0xb2d58973d
135.64,1.0,9,1,2,3,6,0xb2d6f5be
32.12,1.0,92,1,2,1,4,0xb2d3a1a8
17.63,1.0,0,1,2,4,7,0xb2d68e79
510714.23,2.0,25,4,3,2,9,0xb2d1b911d
1700093.44,4.0,2,4,4,4,12,0xb2d62f58
31929.68,1.0,0,2,2,4,8,0xb2d60551d
5062.64,1.0,184,2,2,1,5,0xb2d3b252
24237.33,2.0,11,2,3,3,8,0xb2d390f9d
405748.57,2.0,49,4,3,2,9,0xb2d1554cd
4453.51,1.0,0,2,2,4,8,0xb2d6aef9d
230034.45,4.0,21,3,4,2,9,0xb2d954ebd
190438.45,4.0,0,3,4,4,11,0x3b9b1825d
113990.62,7.0,0,3,4,4,11,0xb2d29005d
122040.62,3.0,3,3,4,4,11,0xb2d104e4
207501.93,6.0,4,3,4,4,11,0xb2d53ad2d
753033.16,27.0,13,4,4,3,11,0xb2d5e9b0d
4501.87,1.0,0,2,2,4,8,0xb2d79124d
102666.65,2.0,209,3,3,1,7,0xb2d165a8d
330001.53,6.0,22,4,4,2,10,0xb2d559d6
8276.68,1.0,0,2,2,4,8,0xb2d96747
400000.0,4.0,19,4,4,2,10,0xb2d8d808
1455.66,1.0,25,1,2,2,5,0xb2d5c11bd
649903.11,3.0,0,4,4,4,12,0xb2d117ded
30000.32,2.0,31,2,3,2,7,0xb2d93ba3d
3082.25,1.0,92,2,2,1,5,0xb2d51fb3d
690165.73,3.0,0,4,4,4,12,0xb2d588f1d
590499.56,1.0,4,4,2,4,10,0xb2d267ecd
6120.12,1.0,184,2,2,1,5,0xb2d443d7
365022.65,9.0,47,4,4,2,10,0xb2d0da1fd
1351.88,1.0,92,1,2,1,4,0xb2d294c7d
3107.62,1.0,92,2,2,1,5,0xb2d2f615d
1679.15,1.0,184,1,2,1,4,0xb2d3aab1d
287155.24,2.0,34,3,3,2,8,0xb2d4f496
1606.01,1.0,6,1,2,3,6,0xb2d442bed
25732.89,1.0,92,2,2,1,5,0xb2d15bfcd
14.78,1.0,49,1,2,2,5,0xb2d40977
828655.74,5.0,8,4,4,3,11,0xb2d21daad
348.74,1.0,10,1,2,3,6,0xb2d3f28d
2008175.0,11.0,55,4,4,2,10,0xb2d249b3d
107418.48,4.0,76,3,4,1,8,0xb2d069a2
50002.74,2.0,70,2,3,1,6,0xb2d1ea0e
1008307.13,5.0,11,4,4,3,11,0xb2d0722ad
5112.7,1.0,0,2,2,4,8,0xb2d8c821
250085.28,3.0,48,3,4,2,9,0xb2d1fea9d
190008.97,3.0,0,3,4,4,11,0xb2d6d5d1d
80096.37,3.0,132,3,4,1,8,0xb2d5dd99
33964.33,1.0,0,2,2,4,8,0xb2d69eaa
2184.53,1.0,184,1,2,1,4,0xb2d1763ad
1017099.73,5.0,18,4,4,2,10,0xb2d38744d
573946.08,4.0,22,4,4,2,10,0xb2d2ecc8
50008.54,2.0,93,2,3,1,6,0xb2d979b5d
110054.04,2.0,6,3,3,3,9,0xb2d131c3d
2078.57,1.0,1,1,2,4,7,0xb2d257f7
1149527.38,11.0,19,4,4,2,10,0xb2d53781d
6550.99,2.0,5,2,3,3,8,0xb2d937de
250739.25,3.0,24,3,4,2,9,0xb2d0fd41d
15365.23,1.0,17,2,2,2,6,0xb2d6ea17d
2000.12,2.0,3,1,3,4,8,0xb2d3bcd7d
1110280.41,4.0,0,4,4,4,12,0xb2d0d613
200000.0,2.0,17,3,3,2,8,0xb2da370c
20697.91,2.0,74,2,3,1,6,0xb2d5a913d
4797.5,1.0,0,2,2,4,8,0xb2d8f6f2d
550031.58,9.0,11,4,4,3,11,0xb2d12138d
675.02,2.0,0,1,3,4,8,0xb2d096d6d
240007.4,3.0,106,3,4,1,8,0xb2d60dab
500033.1,2.0,48,4,3,2,9,0xb2d56351d
116071.67,1.0,7,3,2,3,8,0xb2d822f8d
36126.01,1.0,9,2,2,3,7,0xb2d316b9d
127451.77,2.0,18,3,3,2,8,0xb2d551b3d
301087.14,2.0,1,4,3,4,11,0xb2d9538c
70022.59,1.0,17,3,2,2,7,0xb2d92058
98530.43,2.0,62,3,3,2,8,0xb2d1cc3fd
1390.73,1.0,251,1,2,1,4,0xb2d150e6d
2060.78,1.0,202,1,2,1,4,0xb2d24642d
360011.4,2.0,97,4,3,1,8,0xb2d84357d
6237.39,1.0,15,2,2,3,7,0xb2d9b40c
373.66,1.0,18,1,2,2,5,0xb2d1bff7
10137.94,1.0,184,2,2,1,5,0xb2d5e396d
300072.29,3.0,8,3,4,3,10,0xb2d19881
7912.75,1.0,49,2,2,2,6,0xb2d2e6bf
1023.92,2.0,0,1,3,4,8,0xb2d29107
52010.76,2.0,171,2,3,1,6,0xb2d24fa3d
5946.27,1.0,0,2,2,4,8,0xb2d9087d
1001.65,1.0,165,1,2,1,4,0xb2d10a6dd
50634.12,1.0,4,2,2,4,8,0xb2d94bd5d
894523.03,4.0,4,4,4,4,12,0xb2d4382f
996830.68,5.0,46,4,4,2,10,0xb2d5e759d
50001.06,2.0,38,2,3,2,7,0xb2d92a22d
749.46,1.0,10,1,2,3,6,0xb2d17f80d
286972.91,2.0,92,3,3,1,7,0xb2d65712d
95660.78,1.0,7,3,2,3,8,0xb2d311a0d
7889.41,1.0,9,2,2,3,7,0xb2d42c8ed
710020.49,5.0,10,4,4,3,11,0xb2d8d7ec
210012.06,3.0,73,3,4,1,8,0xb2d53259d
409.04,1.0,7,1,2,3,6,0xb2d210ee
534.27,1.0,18,1,2,2,5,0xb2d6c143
500000.0,2.0,1,4,3,4,11,0xb2d9cbf8
200005.36,8.0,10,3,4,3,10,0xb2d1e00bd
55002.9,2.0,34,3,3,2,8,0xb2d9f22f
3009.25,1.0,20,2,2,2,6,0xb2d60a7ad
460812.96,3.0,5,4,4,3,11,0xb2d1366c
3629.41,2.0,184,2,3,1,6,0xb2d3d4d3
492.61,1.0,28,1,2,2,5,0xb2d6f88fd
615649.23,4.0,82,4,4,1,9,0xb2d62bced
45.0,1.0,75,1,2,1,4,0xb2d62d6bd
160004.24,2.0,24,3,3,2,8,0xb2d4ec54
3421.21,1.0,2,2,2,4,8,0xb2d956ba
10012.94,2.0,117,2,3,1,6,0xb2d6937d
550157.1,4.0,27,4,4,2,10,0xb2d30e88d
56451.2,1.0,11,3,2,3,8,0xb2d6f5e8d
1456956.78,3.0,4,4,4,4,12,0xb2d5408d
1537.66,1.0,4,1,2,4,7,0xb2d6f755
600944.68,6.0,3,4,4,4,12,0xb2d54f8d
649141.57,8.0,13,4,4,3,11,0xb2d1099dd
180000.0,6.0,1,3,4,4,11,0xb2d30f95
4263102.85,9.0,1,4,4,4,12,0xb2d5c290d
357651.61,2.0,207,4,3,1,8,0xb2d63a4e
26049.55,2.0,5,2,3,3,8,0xb2d9693c
342345.25,1.0,0,4,2,4,10,0xb2d90366d
50000.19,2.0,4,2,3,4,9,0xb2d6950cd
628901.75,3.0,55,4,4,2,10,0xb2d0e67a
2119.0,1.0,7,1,2,3,6,0xb2d60579
3629.96,1.0,2,2,2,4,8,0xb2d8c3d1d
73.18,1.0,60,1,2,2,5,0xb2d52dd6
200029.16,2.0,2,3,3,4,10,0xb2d64ebed
335027.1,3.0,0,4,4,4,12,0xb2d1ccecd
392.19,1.0,60,1,2,2,5,0xb2d2623dd
8028.07,1.0,92,2,2,1,5,0xb2d5c200d
75000.0,1.0,1,3,2,4,9,0xb2da6625
11856.75,1.0,199,2,2,1,5,0xb2d6075d
25086.37,1.0,8,2,2,3,7,0xb2d366cfd
50001.53,2.0,20,2,3,2,7,0xb2da0414
309408.38,3.0,18,4,4,2,10,0xb2d08468d
6320.23,1.0,0,2,2,4,8,0xb2d34505
200000.0,2.0,24,3,3,2,8,0xb2da1592
363283.64,7.0,0,4,4,4,12,0x3b9ae3efd
4533.53,1.0,0,2,2,4,8,0xb2d36382d
100001.06,2.0,53,3,3,2,8,0xb2d9cf8a
170005.1,2.0,18,3,3,2,8,0xb2d215b5
178138.2,2.0,184,3,3,1,7,0xb2d1bc32d
500000.0,2.0,8,4,3,3,10,0xb2da5052
5847.95,1.0,5,2,2,3,7,0xb2d483d9d
180842.26,7.0,1,3,4,4,11,0x3b9b298fd
452391.34,5.0,50,4,4,2,10,0xb2d0855ed
2886.88,1.0,92,2,2,1,5,0xb2d32276
387.04,1.0,23,1,2,2,5,0xb2d62302d
41.4,1.0,1,1,2,4,7,0xb2d77603
63150.54,3.0,4,3,4,4,11,0xb2d932ded
267302.4,1.0,0,3,2,4,9,0xb2d41273d
4106.54,1.0,40,2,2,2,6,0xb2d62a2cd
170980.98,3.0,108,3,4,1,8,0xb2d5d814d
13.14,1.0,0,1,2,4,7,0xb2d8e07b
90001.71,3.0,136,3,4,1,8,0xb2d63ae3d
1434534.01,3.0,110,4,4,1,9,0xb2d0c311d
150001.58,2.0,139,3,3,1,7,0xb2d91562d
0.17,6.0,7,1,4,3,8,0xb2d2dd4ed
450004.75,2.0,92,4,3,1,8,0xb2d64329d
10825.66,1.0,15,2,2,3,7,0xb2d69b6ed
1236492.09,2.0,14,4,3,3,10,0xb2d35672d
1203.96,1.0,9,1,2,3,6,0xb2d327b8d
0.0,1.0,3,1,2,4,7,0xb2d0f888
50034.13,1.0,3,2,2,4,8,0xb2d8cb8dd
248.17,1.0,9,1,2,3,6,0xb2d194fdd
481000.88,3.0,11,4,4,3,11,0xb2d765f6d
500301.1,9.0,12,4,4,3,11,0xb2d29f78d
188021.05,2.0,203,3,3,1,7,0xb2d1cddf
1853166.48,3.0,0,4,4,4,12,0xb2d10ab0d
100012.19,2.0,147,3,3,1,7,0xb2d6ce2a
520027.73,2.0,0,4,3,4,11,0xb2d9a959
300227.9,4.0,21,4,4,2,10,0xb2d1104cd
10178.75,2.0,171,2,3,1,6,0xb2d5aaa6
232447.72,5.0,39,3,4,2,9,0xb2d0f3a3
29329.81,2.0,1,2,3,4,9,0xb2d309e1d
36180.5,1.0,10,2,2,3,7,0xb2d8eb43d
320010.36,4.0,193,4,4,1,9,0xb2d7bdcad
800130.2,2.0,125,4,3,1,8,0xb2d126acd
38487.56,1.0,10,2,2,3,7,0xb2d2ff01
50097.89,2.0,46,2,3,2,7,0xb2d4be37
17367.22,1.0,0,2,2,4,8,0xb2d60a82d
2104.03,1.0,92,1,2,1,4,0xb2d14b5cd
63027.48,2.0,103,3,3,1,7,0xb2d2f28a
25098.85,1.0,184,2,2,1,5,0xb2d6142cd
2837.14,8.0,189,1,4,1,6,0xb2d619a6
18085.9,1.0,7,2,2,3,7,0xb2d6b634
100001.06,2.0,18,3,3,2,8,0xb2da310d
56248.53,2.0,18,3,3,2,8,0xb2d46384d
872519.27,1.0,7,4,2,3,9,0xb2d265a1d
759022.37,12.0,74,4,4,1,9,0xb2d67eb0d
400000.27,3.0,8,4,4,3,11,0xb2d6faf6d
141364.39,2.0,10,3,3,3,9,0xb2d2cf4b
736.43,1.0,0,1,2,4,7,0xb2d0d13f
323024.69,9.0,22,4,4,2,10,0xb2d1ba61d
260099.5,2.0,0,3,3,4,10,0xb2d97214d
364279.81,3.0,60,4,4,2,10,0xb2d5907b
500153.06,2.0,5,4,3,3,10,0xb2d9fa67
577058.65,5.0,0,4,4,4,12,0xb2d68273d
443011.94,9.0,25,4,4,2,10,0xb2d5c5abd
34.83,1.0,39,1,2,2,5,0xb2d3136ad
80000.84,2.0,55,3,3,2,8,0xb2d903bbd
254032.69,4.0,87,3,4,1,8,0xb2d522bdd
568.82,1.0,10,1,2,3,6,0xb2d34935
143012.48,7.0,1,3,4,4,11,0xb2d988e7
6600.88,1.0,0,2,2,4,8,0xb2d2eb25d
5649.63,1.0,9,2,2,3,7,0xb2d84802
31.67,1.0,60,1,2,2,5,0xb2d9c0c7
96514.7,5.0,14,3,4,3,10,0xb2d07f79d
30086.76,1.0,22,2,2,2,6,0xb2d39cf6
166.08,1.0,22,1,2,2,5,0xb2d24664
912285.34,5.0,11,4,4,3,11,0xb2d42f61d
87803.18,1.0,1,3,2,4,9,0xb2d8f8e9d
218.34,1.0,6,1,2,3,6,0xb2d1d56fd
105777.84,1.0,185,3,2,1,6,0xb2d2e9e8d
200002.91,2.0,27,3,3,2,8,0xb2d727c7d
47.72,2.0,5,1,3,3,7,0xb2d59fc3
212945.49,6.0,6,3,4,3,10,0x3b9b39cdd
934.72,1.0,9,1,2,3,6,0xb2d6db30
200058.67,2.0,208,3,3,1,7,0xb2d56e78d
460011.76,2.0,26,4,3,2,9,0xb2d7877ad
494.39,1.0,3,1,2,4,7,0xb2d5fa9e
163.68,1.0,80,1,2,1,4,0xb2d5be71d
461000.97,3.0,0,4,4,4,12,0xb2d55e2cd
207591.82,10.0,12,3,4,3,10,0xb2d599c3d
2500.0,1.0,45,1,2,2,5,0xb2d5bd5ad
417616.39,4.0,0,4,4,4,12,0xb2d213dcd
300006.4,3.0,59,3,4,2,9,0xb2d9a7d4
30000.32,2.0,32,2,3,2,7,0xb2d9fead
1174.1,1.0,92,1,2,1,4,0xb2d1eed7d
24.81,1.0,4,1,2,4,7,0xb2d623fad
8839.54,1.0,5,2,2,3,7,0xb2d6d370d
5.25,1.0,0,1,2,4,7,0xb2d99703
65331.28,1.0,0,3,2,4,9,0xb2d78797d
469542.54,6.0,25,4,4,2,10,0xb2d64eaed
203427.05,2.0,188,3,3,1,7,0xb2d5dfa1d
1659.77,1.0,0,1,2,4,7,0xb2d912bc
10175.84,2.0,157,2,3,1,6,0xb2d59d2fd
2591.56,1.0,184,1,2,1,4,0xb2d4ce80d
4249.92,1.0,5,2,2,3,7,0xb2d8dabcd
7148.34,1.0,0,2,2,4,8,0xb2d6c021
200001.26,2.0,29,3,3,2,8,0xb2d94150d
50002.86,4.0,259,2,4,1,7,0xb2d06efd
63697.23,1.0,92,3,2,1,6,0x3b9b26e7
190.82,1.0,0,1,2,4,7,0xb2d8fa09d
287288.57,6.0,1,3,4,4,11,0xb2d2b29cd
45889.92,1.0,5,2,2,3,7,0x3b9b3792
110039.07,3.0,11,3,4,3,10,0xb2d59527d
808087.22,9.0,0,4,4,4,12,0xb2d0ff2ed
1.86,1.0,29,1,2,2,5,0xb2d68499
67070.99,1.0,5,3,2,3,8,0xb2d41b53d
41.01,1.0,12,1,2,3,6,0xb2d0bf87d
1423.68,1.0,9,1,2,3,6,0xb2d26c30
282348.32,6.0,0,3,4,4,11,0x3b9af2aad
323.1,1.0,14,1,2,3,6,0xb2d2f1f3
41.97,1.0,39,1,2,2,5,0xb2d275d0
59442.9,4.0,4,3,4,4,11,0x3b9b2dec
604395.23,6.0,7,4,4,3,11,0xb2d459b2
800056.51,7.0,3,4,4,4,12,0xb2d576b1
175.72,1.0,7,1,2,3,6,0xb2d2ad35d
22.81,1.0,40,1,2,2,5,0xb2d4c81a
2164.5,1.0,184,1,2,1,4,0xb2d34674d
61333.21,1.0,2,3,2,4,9,0xb2d2d02f
1060084.85,4.0,15,4,4,3,11,0xb2d91242
5206.46,1.0,184,2,2,1,5,0xb2d30ef9
71682.11,2.0,0,3,3,4,10,0xb2d2778ad
5933.46,1.0,213,2,2,1,5,0xb2d3fa01
28.58,2.0,1,1,3,4,8,0xb2d099ffd
200000.01,7.0,15,3,4,3,10,0xb2d10e72
852016.34,5.0,0,4,4,4,12,0xb2d0c48d
950000.85,6.0,0,4,4,4,12,0xb2d60a13d
1156646.34,8.0,67,4,4,1,9,0xb2d2456b
115786.19,2.0,0,3,3,4,10,0xb2d210b4
214036.0,2.0,3,3,3,4,10,0xb2d68c47d
22450.77,1.0,92,2,2,1,5,0xb2d215d0d
200008.44,2.0,28,3,3,2,8,0xb2d9f0b2
210829.96,2.0,34,3,3,2,8,0xb2d9fe58
50000.53,2.0,41,2,3,2,7,0xb2d921d2d
787010.56,22.0,11,4,4,3,11,0xb2d38386d
3046.64,2.0,150,2,3,1,6,0x3b9addd4
482784.61,6.0,32,4,4,2,10,0xb2d11d35
292166.96,3.0,0,3,4,4,11,0xb2d1c22fd
1400074.57,3.0,11,4,4,3,11,0xb2d6baa4d
13755.51,1.0,0,2,2,4,8,0xb2d2ac80d
20000.63,2.0,38,2,3,2,7,0xb2d91e76
887373.02,10.0,2,4,4,4,12,0xb2d51251d
29.37,1.0,9,1,2,3,6,0xb2d379ab
47387.49,2.0,11,2,3,3,8,0xb2d6f487d
644297.37,2.0,0,4,3,4,11,0xb2d16c32d
328.45,1.0,3,1,2,4,7,0xb2d6a7e1
12.57,1.0,4,1,2,4,7,0xb2d54112
3000.76,1.0,17,2,2,2,6,0xb2d5bc1bd
89896.44,4.0,0,3,4,4,11,0xb2d3e1bfd
40000.59,2.0,9,2,3,3,8,0xb2d18338
2500042.96,16.0,20,4,4,2,10,0xb2d606efd
154026.52,3.0,15,3,4,3,10,0xb2d5576fd
359472.74,3.0,0,4,4,4,12,0xb2d2ced9d
16318.94,1.0,6,2,2,3,7,0xb2d6d615
720281.63,3.0,19,4,4,2,10,0xb2d68ca1
170032.18,3.0,4,3,4,4,11,0xb2d92d22d
281042.43,8.0,13,3,4,3,10,0xb2d515e7d
1808.83,1.0,159,1,2,1,4,0xb2d6bd07d
22829.97,1.0,9,2,2,3,7,0xb2d54758d
151070.4,3.0,18,3,4,2,9,0xb2d3f68dd
140051.19,4.0,11,3,4,3,10,0xb2d11135d
1250008.0,4.0,22,4,4,2,10,0xb2d85723d
7064.55,1.0,1,2,2,4,8,0xb2d613c2d
0.7,1.0,9,1,2,3,6,0xb2d25198d
411387.17,2.0,126,4,3,1,8,0xb2d6d947d
87728.93,3.0,41,3,4,2,9,0xb2d1155b
132842.46,2.0,56,3,3,2,8,0xb2d6bb12
200010.01,2.0,4,3,3,4,10,0xb2d61283
3477.77,1.0,6,2,2,3,7,0xb2d32bba
0.0,1.0,1,1,2,4,7,0xb2d3a687
146.78,2.0,76,1,3,1,5,0xb2d261dd
358293.9,6.0,11,4,4,3,11,0xb2d3dc27d
78478.55,4.0,8,3,4,3,10,0xb2d6b151
17821.97,1.0,22,2,2,2,6,0xb2d2521a
600961.54,3.0,103,4,4,1,9,0xb2d89ff9d
10401.3,1.0,177,2,2,1,5,0xb2d405c5
32269.88,1.0,0,2,2,4,8,0xb2d3ca70d
50419.15,29.0,109,2,4,1,7,0xb2d212d0
1.06,1.0,20,1,2,2,5,0xb2d94b7d
475630.35,7.0,21,4,4,2,10,0xb2d393e8
800751.1,4.0,11,4,4,3,11,0xb2d6f68f
0.63,1.0,0,1,2,4,7,0xb2d5ef7b
8002.01,1.0,1,2,2,4,8,0xb2d3829f
6602.4,1.0,14,2,2,3,7,0xb2d7ee63d
412.04,1.0,32,1,2,2,5,0xb2d62bb6d
330115.94,5.0,3,4,4,4,12,0xb2d9e560
191869.21,3.0,11,3,4,3,10,0xb2d33149
491638.83,3.0,0,4,4,4,12,0xb2d110afd
300375.14,3.0,0,4,4,4,12,0xb2d0a567
279191.49,3.0,0,3,4,4,11,0xb2d85a97d
29944.51,1.0,0,2,2,4,8,0xb2d4be45
152425.71,2.0,95,3,3,1,7,0xb2d17afdd
91167.39,1.0,40,3,2,2,7,0xb2d1c96dd
582670.6,3.0,1,4,4,4,12,0xb2d1c1ffd
182051.53,4.0,0,3,4,4,11,0x3b9af1f9d
202326.76,3.0,80,3,4,1,8,0xb2d6536bd
11.62,1.0,4,1,2,4,7,0xb2d78366d
367582.03,3.0,4,4,4,4,12,0xb2d4648fd
1000000.78,2.0,20,4,3,2,9,0xb2d6a596
1682.18,2.0,0,1,3,4,8,0xb2d2111dd
347451.43,2.0,87,4,3,1,8,0xb2d125ddd
2577.58,1.0,7,1,2,3,6,0xb2d2e2cfd
7982.05,1.0,28,2,2,2,6,0xb2d24807
602095.42,4.0,25,4,4,2,10,0xb2d94982d
100019.04,2.0,92,3,3,1,7,0xb2d61c9ed
6325.03,1.0,19,2,2,2,6,0xb2d9d6a0
23512.99,2.0,0,2,3,4,9,0xb2d5e8e1
170003.59,2.0,39,3,3,2,8,0xb2d9f003
26221.19,6.0,0,2,4,4,10,0x3b9b182a
800099.66,7.0,179,4,4,1,9,0xb2d0afdad
245.2,1.0,226,1,2,1,4,0xb2d2883ad
1053.46,1.0,184,1,2,1,4,0xb2d360ded
2464.12,1.0,186,1,2,1,4,0xb2d6a63a
700072.58,3.0,32,4,4,2,10,0xb2d7ef60d
18070.03,1.0,8,2,2,3,7,0xb2d2147bd
0.87,1.0,0,1,2,4,7,0xb2d6e087
28.1,1.0,23,1,2,2,5,0xb2d1c4b8
230014.22,2.0,34,3,3,2,8,0xb2d6db02
260052.26,5.0,20,3,4,2,9,0xb2d67eecd
116007.53,1.0,30,3,2,2,7,0xb2d43139d
1556061.35,5.0,25,4,4,2,10,0xb2d5bdf1d
21.27,1.0,4,1,2,4,7,0xb2d59a1b
19666.85,1.0,92,2,2,1,5,0xb2d09786d
814449.02,7.0,0,4,4,4,12,0xb2d2638bd
2578.82,1.0,148,1,2,1,4,0xb2d13c2ed
300000.0,3.0,9,3,4,3,10,0xb2d2afd1d
200070.92,2.0,141,3,3,1,7,0xb2d22008
1111007.46,6.0,4,4,4,4,12,0xb2d34727d
97.05,1.0,8,1,2,3,6,0xb2d32065
2340.33,2.0,92,1,3,1,5,0xb2d0c899d
160691.87,1.0,0,3,2,4,9,0xb2d263fd
12014.31,2.0,78,2,3,1,6,0xb2d4d764
1071122.43,20.0,9,4,4,3,11,0xb2d2679ad
13454.69,1.0,23,2,2,2,6,0xb2d17ee4
17987.27,1.0,0,2,2,4,8,0xb2d5ced5
210627.17,4.0,0,3,4,4,11,0xb2d07739d
916.98,1.0,14,1,2,3,6,0xb2d2425ed
561.09,1.0,60,1,2,2,5,0xb2d5effa
11042.2,1.0,8,2,2,3,7,0xb2d95c13
1601.35,1.0,11,1,2,3,6,0xb2d2b90ed
200099.94,2.0,126,3,3,1,7,0xb2d26f65
500533.11,1.0,111,4,2,1,7,0xb2d93ec4
1411394.44,8.0,0,4,4,4,12,0xb2d1530b
106.89,1.0,13,1,2,3,6,0xb2d282b9
26120.82,5.0,266,2,4,1,7,0xb2d6350bd
5816.18,1.0,180,2,2,1,5,0xb2d5cc5f
1091001.91,14.0,0,4,4,4,12,0xb2d401d4d
230134.18,2.0,4,3,3,4,10,0xb2d9aa29
4945.3,1.0,18,2,2,2,6,0xb2da30e6
61965.02,1.0,1,3,2,4,9,0xb2d5d383d
110010.02,5.0,27,3,4,2,9,0xb2d98c97
9236.47,1.0,1,2,2,4,8,0xb2d68911
4.95,1.0,8,1,2,3,6,0xb2d59aa8d
285.34,1.0,10,1,2,3,6,0xb2da0241
3799.01,1.0,10,2,2,3,7,0xb2d9fd4b
1238.22,1.0,92,1,2,1,4,0xb2d152eed
2544.27,1.0,7,1,2,3,6,0xb2d8f9ecd
0.0,1.0,8,1,2,3,6,0xb2da12c8
6.28,1.0,9,1,2,3,6,0xb2d56270d
251141.71,3.0,11,3,4,3,10,0xb2d163a8
44926.24,1.0,24,2,2,2,6,0xb2d5f495d
294079.08,4.0,60,3,4,2,9,0xb2d1da0e
350545.04,4.0,25,4,4,2,10,0xb2d219b7d
185236.42,4.0,0,3,4,4,11,0x3b9b3ae2d
440011.32,3.0,1,4,4,4,12,0xb2d6d74ed
799.1,1.0,0,1,2,4,7,0xb2d1d3b2d
276454.79,6.0,0,3,4,4,11,0xb2d6911dd
17738.35,1.0,0,2,2,4,8,0xb2d62d12
10780.6,1.0,177,2,2,1,5,0xb2d0c4c4
50017.0,2.0,192,2,3,1,6,0xb2d4951c
12916.34,1.0,20,2,2,2,6,0xb2d6948bd
400010.97,2.0,10,4,3,3,10,0xb2d614b0d
22.15,2.0,30,1,3,2,6,0xb2d60c31
18350.5,2.0,5,2,3,3,8,0xb2d21983
721546.22,1.0,1,4,2,4,10,0xb2d2f701d
600125.07,2.0,13,4,3,3,10,0xb2d6f9b0d
1500035.49,2.0,39,4,3,2,9,0xb2d5ffdbd
6562.55,1.0,122,2,2,1,5,0xb2d37cb5
608640.84,6.0,36,4,4,2,10,0xb2d639a7
400018.62,6.0,14,4,4,3,11,0xb2d10c41d
1096.08,2.0,92,1,3,1,5,0xb2d392cdd
15165.33,1.0,184,2,2,1,5,0xb2d28bf9d
424062.4,5.0,0,4,4,4,12,0xb2d3d4d6d
246064.0,5.0,0,3,4,4,11,0xb2d6ef7ed
80000.84,2.0,60,3,3,2,8,0xb2d9c045
3753.39,1.0,92,2,2,1,5,0xb2d3dc7dd
41455.58,2.0,25,2,3,2,7,0xb2d2ae9bd
501863.24,2.0,0,4,3,4,11,0xb2d3e426d
404264.39,2.0,84,4,3,1,8,0xb2d951ebd
133834.36,5.0,0,3,4,4,11,0xb2d2b13bd
210029.45,3.0,70,3,4,1,8,0xb2d0d2b0d
280005.96,3.0,196,3,4,1,8,0xb2d61b10d
101707.68,2.0,24,3,3,2,8,0xb2d2e1efd
69957.3,5.0,34,3,4,2,9,0xb2d9d838
120094.0,2.0,0,3,3,4,10,0xb2da61a3
80604.73,3.0,11,3,4,3,10,0xb2d61887d
10742.76,1.0,0,2,2,4,8,0xb2d3fa24d
0.0,1.0,8,1,2,3,6,0xb2d91feed
255926.67,3.0,3,3,4,4,11,0xb2d270e4d
7117.38,1.0,1,2,2,4,8,0xb2da03cf
546.94,1.0,44,1,2,2,5,0xb2d5c44a
25.73,1.0,2,1,2,4,7,0xb2d17528d
398487.28,2.0,79,4,3,1,8,0xb2d8f79ed
216173.25,9.0,0,3,4,4,11,0xb2d2111ed
472504.87,3.0,32,4,4,2,10,0xb2d915c2d
42.8,1.0,77,1,2,1,4,0xb2d2fd60
1050.11,1.0,92,1,2,1,4,0xb2d07269d
5.83,1.0,19,1,2,2,5,0xb2d26e67
10.33,1.0,13,1,2,3,6,0xb2d2df47
134832.4,4.0,10,3,4,3,10,0xb2d0f3a3d
150026.42,3.0,77,3,4,1,8,0xb2d27e36
4419.61,1.0,92,2,2,1,5,0xb2d1673d
24041.43,1.0,15,2,2,3,7,0xb2d6a9edd
20778.08,1.0,0,2,2,4,8,0xb2d1ca6e
2247.72,1.0,1,1,2,4,7,0xb2d78417
260098.28,3.0,181,3,4,1,8,0xb2d2e772d
2082.19,1.0,10,1,2,3,6,0xb2d62474
1520650.31,12.0,0,4,4,4,12,0xb2d5c5bd
901398.0,3.0,25,4,4,2,10,0xb2d7819fd
70028.1,2.0,98,3,3,1,7,0xb2d58249d
90449.02,5.0,4,3,4,4,11,0xb2d32400d
100000.0,2.0,98,3,3,1,7,0xb2d34a71
696.3,1.0,65,1,2,2,5,0xb2d39466
133589.21,1.0,0,3,2,4,9,0xb2d25effd
240000.43,4.0,5,3,4,3,10,0xb2d31089d
0.57,3.0,78,1,4,1,6,0xb2d07d48d
110002.33,3.0,8,3,4,3,10,0xb2d970a3
0.0,1.0,4,1,2,4,7,0xb2d8d600d
427464.19,2.0,9,4,3,3,10,0xb2d6d1da
475.93,1.0,18,1,2,2,5,0xb2d21f28d
1950.63,1.0,10,1,2,3,6,0xb2d637e1
25.68,1.0,60,1,2,2,5,0xb2d4914ad
56921.46,2.0,164,3,3,1,7,0xb2d1b74e
33088.07,1.0,0,2,2,4,8,0xb2d5510cd
25962.04,1.0,4,2,2,4,8,0xb2d2a1ecd
0.0,2.0,0,1,3,4,8,0xb2d14ce5
105411.59,2.0,185,3,3,1,7,0xb2d41737d
250001.57,3.0,3,3,4,4,11,0xb2d2723cd
2307.22,2.0,0,1,3,4,8,0xb2d07e82
1.9,1.0,70,1,2,1,4,0xb2d63313
773056.56,11.0,0,4,4,4,12,0xb2d14ee0
970000.0,2.0,6,4,3,3,10,0xb2d6353dd
63.33,1.0,90,1,2,1,4,0xb2d8a295
51276.42,1.0,184,2,2,1,5,0xb2d2fb1fd
63.5,1.0,12,1,2,3,6,0xb2d4ee0a
370901.06,4.0,31,4,4,2,10,0xb2d5a79dd
699.87,1.0,5,1,2,3,6,0xb2d53ef8d
35001.33,3.0,104,2,4,1,7,0xb2d07fd5
1346.88,1.0,92,1,2,1,4,0xb2d24ff2d
5005.27,1.0,21,2,2,2,6,0xb2d6429e
8141.98,1.0,0,2,2,4,8,0xb2d28419d
310000.01,4.0,0,4,4,4,12,0xb2d1beccd
260404.5,6.0,3,3,4,4,11,0xb2d54a97d
18000.76,2.0,49,2,3,2,7,0xb2d9d4de
267000.0,2.0,2,3,3,4,10,0xb2d9b8df
11.78,1.0,46,1,2,2,5,0xb2d5d19d
2.17,8.0,48,1,4,2,7,0xb2d3831ed
1000069.77,2.0,15,4,3,3,10,0xb2d5989b
111707.64,1.0,15,3,2,3,8,0xb2d19ff7d
244342.16,3.0,28,3,4,2,9,0xb2d156a9
1.01,5.0,75,1,4,1,6,0x3b9b34ca
8054.22,1.0,143,2,2,1,5,0xb2d68233d
550052.62,5.0,9,4,4,3,11,0xb2d18881
0.0,1.0,1,1,2,4,7,0xb2d78974
100003.17,3.0,19,3,4,2,9,0xb2d6953dd
150235.08,2.0,10,3,3,3,9,0xb2d1f9d4d
754.72,1.0,12,1,2,3,6,0xb2d181a6d
11903.63,3.0,0,2,4,4,10,0x3b9af0f1
4808.94,1.0,0,2,2,4,8,0xb2d4cb8b
220006.97,2.0,53,3,3,2,8,0xb2d9ca23
1432774.08,3.0,12,4,4,3,11,0xb2d39fd7d
0.11,1.0,19,1,2,2,5,0xb2da2a40
709.45,1.0,2,1,2,4,7,0xb2d905c6
2.16,1.0,35,1,2,2,5,0xb2d08f37
10359.38,1.0,71,2,2,1,5,0xb2d56566d
40007.02,3.0,27,2,4,2,8,0xb2d56e3fd
5698.04,1.0,184,2,2,1,5,0xb2d1fdf3d
145604.38,4.0,11,3,4,3,10,0xb2d6a501
10623.97,2.0,0,2,3,4,9,0xb2d54ea7
196.97,1.0,1,1,2,4,7,0xb2d696ffd
120047.95,2.0,122,3,3,1,7,0xb2d562d9d
242118.09,3.0,12,3,4,3,10,0xb2d4234c
100.8,1.0,112,1,2,1,4,0xb2d51b45
10171.46,2.0,25,2,3,2,7,0xb2da0c37
763.31,1.0,21,1,2,2,5,0xb2d28a55
471923.96,4.0,3,4,4,4,12,0xb2d6ecbdd
524.1,1.0,39,1,2,2,5,0xb2d5d5dd
10008.09,3.0,40,2,4,2,8,0x3b9b3bf2
348552.89,7.0,13,4,4,3,11,0xb2d0c265
53.9,1.0,0,1,2,4,7,0xb2d21a8c
632425.99,12.0,25,4,4,2,10,0xb2d138cad
1007.66,1.0,184,1,2,1,4,0xb2d3dbb0d
730010.13,9.0,70,4,4,1,9,0x3b9b471a
124328.66,2.0,200,3,3,1,7,0xb2d1347bd
1015.93,1.0,184,1,2,1,4,0xb2d16ccdd
694185.78,3.0,18,4,4,2,10,0xb2d5407fd
46.41,1.0,66,1,2,2,5,0xb2d20764
6515.49,1.0,17,2,2,2,6,0xb2d2e85bd
1006.33,1.0,184,1,2,1,4,0xb2d249f7d
0.46,12.0,3,1,4,4,9,0xb2d68141d
2003.79,1.0,8,1,2,3,6,0xb2d8df87d
7463.04,1.0,10,2,2,3,7,0xb2d6439b
104.37,1.0,59,1,2,2,5,0xb2d2218b
936.32,1.0,12,1,2,3,6,0xb2d14c5e
500076.05,3.0,6,4,4,3,11,0xb2d9eacd
277647.9,11.0,11,3,4,3,10,0xb2d576a1d
33694.0,1.0,0,2,2,4,8,0xb2d6ab97
50001.06,2.0,13,2,3,3,8,0xb2d0a694d
121064.44,2.0,1,3,3,4,10,0xb2d5a6c3d
2060.43,1.0,8,1,2,3,6,0xb2d39207d
5399.58,1.0,10,2,2,3,7,0xb2d78f1f
276001.99,3.0,20,3,4,2,9,0xb2d98c26
2528.21,3.0,184,1,4,1,6,0xb2d246a8d
510011.56,2.0,23,4,3,2,9,0xb2d909ebd
257133.16,4.0,129,3,4,1,8,0xb2d0eef6
5201.46,1.0,92,2,2,1,5,0xb2d30ef9d
13308.29,1.0,0,2,2,4,8,0xb2d6b7e7d
259163.47,8.0,0,3,4,4,11,0xb2d3e5a3d
553166.98,7.0,83,4,4,1,9,0xb2d5f0b5
226282.67,2.0,124,3,3,1,7,0xb2d41ef1d
0.0,2.0,28,1,3,2,6,0xb2d0f968
502298.12,2.0,13,4,3,3,10,0xb2d64e7ed
43076.28,1.0,0,2,2,4,8,0xb2d51f43
46877.81,2.0,1,2,3,4,9,0xb2d437ff
0.76,1.0,9,1,2,3,6,0xb2d558c1d
502539.96,3.0,46,4,4,2,10,0xb2d9283c
6934.18,2.0,11,2,3,3,8,0xb2d782e6d
155013.24,3.0,4,3,4,4,11,0xb2d8d4e7d
51411.29,8.0,3,2,4,4,10,0x3b9af1f7
56981.68,1.0,0,3,2,4,9,0xb2d5be8dd
80000020.03,5.0,130,4,4,1,9,0xb2d413b3d
300535.07,5.0,6,4,4,3,11,0xb2d25094d
10601.81,1.0,184,2,2,1,5,0xb2d0e050d
1045.08,1.0,10,1,2,3,6,0xb2d3173f
742712.77,5.0,78,4,4,1,9,0xb2d3e387d
309860.08,2.0,128,4,3,1,8,0xb2d64323d
1156167.64,9.0,12,4,4,3,11,0xb2d6d037d
100018.94,2.0,45,3,3,2,8,0xb2d59c4dd
40501.12,2.0,60,2,3,2,7,0xb2d9be0d
385.84,1.0,11,1,2,3,6,0xb2d376d4d
31207.59,1.0,14,2,2,3,7,0xb2d6cf41d
210063.02,2.0,125,3,3,1,7,0xb2d2a749d
201421.0,2.0,62,3,3,2,8,0xb2d9b3bf
536323.46,5.0,247,4,4,1,9,0xb2d5e56fd
56000.59,2.0,92,3,3,1,7,0xb2d636fed
102101.86,3.0,25,3,4,2,9,0xb2d48534d
32.68,1.0,0,1,2,4,7,0xb2d58cbcd
150114.06,2.0,83,3,3,1,7,0xb2d1b53bd
1036.03,1.0,47,1,2,2,5,0xb2d985c7
37.92,1.0,1,1,2,4,7,0xb2d178a2d
60042.63,3.0,53,3,4,2,9,0xb2d28085d
5547.3,1.0,2,2,2,4,8,0xb2d20fc9
52058.71,2.0,158,2,3,1,6,0xb2d5da52d
220461.77,2.0,56,3,3,2,8,0xb2d88a34d
30008.38,2.0,20,2,3,2,7,0xb2d3b722
22622.37,1.0,7,2,2,3,7,0xb2d1e92ad
17669.46,2.0,184,2,3,1,6,0xb2d284b5
251070.2,3.0,74,3,4,1,8,0xb2d161bad
5211.68,1.0,2,2,2,4,8,0xb2d6e915d
740045.33,6.0,13,4,4,3,11,0xb2d49604d
372.27,1.0,8,1,2,3,6,0xb2d251f4
232080.65,4.0,160,3,4,1,8,0xb2d5f39ed
256190.77,11.0,2,3,4,4,11,0xb2d069dad
51345.12,1.0,6,2,2,3,7,0xb2d0bc4fd
209376.19,2.0,83,3,3,1,7,0xb2d406fad
178983.72,2.0,8,3,3,3,9,0xb2d5844e
100462.75,1.0,4,3,2,4,9,0xb2d6271cd
551860.61,4.0,1,4,4,4,12,0xb2d6ce1d
40468.23,2.0,203,2,3,1,6,0xb2d630b3d
11427.56,1.0,13,2,2,3,7,0xb2d8cb1c
2200030.04,5.0,8,4,4,3,11,0xb2d6d0bc
512433.32,9.0,4,4,4,4,12,0xb2d6811fd
1400.12,1.0,9,1,2,3,6,0xb2d4f992
75648.13,2.0,9,3,3,3,9,0xb2d24935
100052.33,3.0,6,3,4,3,10,0xb2d547f8
2138.9,1.0,184,1,2,1,4,0xb2d30c25d
3746.68,1.0,0,2,2,4,8,0xb2d14632
41240.19,3.0,4,2,4,4,10,0xb2d230cfd
270004.12,3.0,41,3,4,2,9,0xb2d9a70f
214.74,1.0,18,1,2,2,5,0xb2d96ca0
230087.96,2.0,7,3,3,3,9,0xb2d5df2ad
6.89,2.0,4,1,3,4,8,0xb2d643a4d
76101.25,2.0,0,3,3,4,10,0xb2d131bbd
25001.26,2.0,18,2,3,2,7,0xb2da311e
3684.22,1.0,3,2,2,4,8,0xb2d91ef4
163004.07,4.0,28,3,4,2,9,0xb2d9641e
20000.44,2.0,80,2,3,1,6,0xb2d8c9b0
12697.41,1.0,6,2,2,3,7,0xb2d98a13
64.73,1.0,28,1,2,2,5,0xb2d63178
85907.91,3.0,8,3,4,3,10,0xb2d57b68d
841000.0,8.0,3,4,4,4,12,0xb2d10999d
819.79,1.0,9,1,2,3,6,0xb2d43ae0d
282502.99,6.0,3,3,4,4,11,0xb2d200dc
14225.59,1.0,0,2,2,4,8,0xb2d96ebe
6703.39,1.0,5,2,2,3,7,0xb2d6d778
362065.13,2.0,3,4,3,4,11,0xb2d4f3ff
1100199.97,3.0,22,4,4,2,10,0xb2d5bd91
250712.04,3.0,10,3,4,3,10,0x3b9b4785
500022.89,8.0,7,4,4,3,11,0xb2d6ed73d
81638.11,1.0,4,3,2,4,9,0xb2d59e2dd
90440.86,2.0,12,3,3,3,9,0xb2d5be18d
1070.17,1.0,265,1,2,1,4,0xb2d5b012
5332.98,1.0,92,2,2,1,5,0xb2d27dab
60001.05,3.0,92,3,4,1,8,0xb2d63ac9
92277.44,13.0,3,3,4,4,11,0x3b9af1cb
50082.84,2.0,81,2,3,1,6,0xb2d0cfcb
200621.21,2.0,6,3,3,3,9,0xb2d975c3
965324.8,5.0,0,4,4,4,12,0x3b9af2d9d
41.27,1.0,19,1,2,2,5,0xb2d8fa69
876035.4,5.0,74,4,4,1,9,0xb2d4b198
10137.76,1.0,0,2,2,4,8,0xb2d309f7d
17327.23,1.0,12,2,2,3,7,0xb2d6802ad
628039.63,13.0,1,4,4,4,12,0xb2d6596b
130011.63,2.0,193,3,3,1,7,0xb2d1791bd
1450906.17,5.0,39,4,4,2,10,0xb2d3d208
427041.32,5.0,1,4,4,4,12,0xb2d304c2d
205726.15,2.0,0,3,3,4,10,0xb2d5b8a4d
5074.01,1.0,184,2,2,1,5,0xb2d0eb68d
700630.21,5.0,1,4,4,4,12,0xb2d0b600
250017.68,4.0,55,3,4,2,9,0xb2d0dbd8d
555.75,3.0,25,1,4,2,7,0x3b9b0f79
88322.12,2.0,217,3,3,1,7,0xb2d27800d
65.41,1.0,0,1,2,4,7,0xb2d23276
120584.28,5.0,31,3,4,2,9,0xb2d68478d
333140.93,3.0,1,4,4,4,12,0xb2d911c0d
390000.69,6.0,0,4,4,4,12,0xb2d2377fd
66404.8,2.0,22,3,3,2,8,0xb2d60f44
4650071.74,4.0,52,4,4,2,10,0xb2d56bd4d
120003.64,3.0,18,3,4,2,9,0xb2d0d979d
4155.73,1.0,9,2,2,3,7,0xb2d42632d
12.73,1.0,17,1,2,2,5,0xb2d6a007
1979.38,1.0,92,1,2,1,4,0xb2d5e496d
201421.1,2.0,43,3,3,2,8,0xb2d8e6fe
12.02,2.0,2,1,3,4,8,0xb2d9afba
51371.75,2.0,213,2,3,1,6,0xb2d529bb
1065000.02,8.0,3,4,4,4,12,0xb2d2b138d
50609.89,2.0,139,2,3,1,6,0xb2d6d497d
5428.33,1.0,21,2,2,2,6,0xb2d1943d
1430.32,1.0,184,1,2,1,4,0xb2d3637dd
16601.08,1.0,0,2,2,4,8,0xb2d6b567
50047.58,2.0,63,2,3,2,7,0xb2d5897fd
200000.35,2.0,6,3,3,3,9,0xb2d8f297
271000.9,3.0,0,3,4,4,11,0xb2d22cc3d
210011.5,2.0,0,3,3,4,10,0xb2d45f42d
155.07,2.0,1,1,3,4,8,0xb2d06d47d
215052.85,7.0,25,3,4,2,9,0xb2d29088
190007.92,4.0,97,3,4,1,8,0xb2d6e5b8d
600081.53,3.0,20,4,4,2,10,0xb2d68317
50054.89,2.0,157,2,3,1,6,0xb2d2477b
420195.04,4.0,23,4,4,2,10,0xb2d9f1a7
575511.7,5.0,1,4,4,4,12,0xb2d2529ad
847000.42,6.0,8,4,4,3,11,0xb2d40a2ad
50502.61,1.0,92,2,2,1,5,0xb2d287d0d
100002.11,2.0,66,3,3,2,8,0xb2d8ef36d
1.47,1.0,5,1,2,3,6,0xb2d647aa
150000.0,2.0,3,3,3,4,10,0xb2d62aac
50002.64,2.0,188,2,3,1,6,0xb2d6a42ed
560542.44,5.0,1,4,4,4,12,0xb2d1c5b5
510551.09,5.0,75,4,4,1,9,0xb2d3c0b9d
151852.11,3.0,4,3,4,4,11,0xb2d60e78
5712.49,1.0,184,2,2,1,5,0xb2d31264
3773.82,1.0,0,2,2,4,8,0xb2d6a03cd
510000.02,3.0,6,4,4,3,11,0xb2d6cc98d
595134.45,3.0,60,4,4,2,10,0xb2d37ff8d
90.64,1.0,15,1,2,3,6,0xb2d6fbc1
0.01,1.0,92,1,2,1,4,0xb2d2ad19d
879.05,1.0,1,1,2,4,7,0xb2d5a613
150417.45,4.0,10,3,4,3,10,0xb2d29e68
450052.31,3.0,13,4,4,3,11,0xb2d13d05d
2.11,1.0,4,1,2,4,7,0xb2d9960c
507239.69,18.0,10,4,4,3,11,0xb2d0d43dd
4708901.78,10.0,3,4,4,4,12,0xb2d10b2b
420208.76,1.0,12,4,2,3,9,0xb2d318bf
350000.0,2.0,74,4,3,1,8,0xb2d9a3a7
10203.3,1.0,0,2,2,4,8,0xb2d36238d
10000.95,2.0,129,2,3,1,6,0xb2d5ec69d
1050087.51,3.0,13,4,4,3,11,0xb2d3f16a
100000.0,2.0,0,3,3,4,10,0xb2d975c8
644757.32,3.0,0,4,4,4,12,0xb2d6b340d
11687.44,1.0,7,2,2,3,7,0xb2da2739
4494.25,2.0,0,2,3,4,9,0xb2d0a66e
21418.64,1.0,10,2,2,3,7,0xb2d6018ad
80010.7,2.0,235,3,3,1,7,0xb2d1ea5bd
20000.63,2.0,92,2,3,1,6,0xb2d6439a
14443.71,1.0,0,2,2,4,8,0xb2d42850
300002.12,9.0,69,3,4,1,8,0xb2d53385d
194.12,1.0,4,1,2,4,7,0xb2d30c1cd
980.66,1.0,15,1,2,3,6,0xb2d8dff4
79631.75,3.0,11,3,4,3,10,0xb2d555fad
242296.86,2.0,1,3,3,4,10,0xb2d4ce0ad
1102.52,1.0,92,1,2,1,4,0xb2d203d1d
867.56,1.0,9,1,2,3,6,0xb2d1465b
323198.71,3.0,94,4,4,1,9,0xb2d6f6c0d
12044.63,1.0,184,2,2,1,5,0xb2d13110d
374.51,1.0,1,1,2,4,7,0xb2d31052d
7382.66,1.0,0,2,2,4,8,0xb2d5a100d
65.83,1.0,44,1,2,2,5,0xb2d618acd
29612.33,1.0,25,2,2,2,6,0xb2d2fc64
110003.48,2.0,80,3,3,1,7,0xb2d8d28ad
2904.38,1.0,0,2,2,4,8,0xb2d4c687
4.06,1.0,60,1,2,2,5,0xb2d6db42
510034.1,7.0,4,4,4,4,12,0xb2d0ebbad
103013.8,2.0,199,3,3,1,7,0xb2d4eaa1d
103633.71,2.0,11,3,3,3,9,0xb2d0f3a6d
8004.31,1.0,3,2,2,4,8,0xb2d2ac03d
50113.2,2.0,116,2,3,1,6,0xb2d487ab
128.59,1.0,9,1,2,3,6,0xb2d4c186
6.28,1.0,9,1,2,3,6,0xb2d638ca
450036.16,3.0,28,4,4,2,10,0xb2d6c124d
181034.45,4.0,7,3,4,3,10,0xb2d33922
9.11,2.0,42,1,3,2,6,0xb2d68b2dd
57.36,1.0,75,1,2,1,4,0xb2d5a825d
32.57,1.0,66,1,2,2,5,0xb2d6b6d5
43021.86,1.0,21,2,2,2,6,0xb2d1a737d
2855.93,1.0,1,1,2,4,7,0xb2d449ced
10000.26,2.0,14,2,3,3,8,0xb2d63e7f
2012.84,1.0,10,1,2,3,6,0xb2d955a5
285144.34,5.0,1,3,4,4,11,0xb2d17fc3d
7064.47,1.0,0,2,2,4,8,0xb2d6b56cd
120084.49,1.0,9,3,2,3,8,0xb2d77f42
110006.21,3.0,129,3,4,1,8,0xb2d2cc04d
2629.58,1.0,184,1,2,1,4,0xb2d38ad5d
4179.71,1.0,112,2,2,1,5,0xb2d3b50dd
204016.01,2.0,96,3,3,1,7,0xb2d0e04ad
206.14,1.0,0,1,2,4,7,0xb2d43707
85.24,1.0,67,1,2,1,4,0xb2d625d3
27457.29,1.0,0,2,2,4,8,0xb2d21539
260013.78,2.0,35,3,3,2,8,0xb2d166e4
20365.71,2.0,90,2,3,1,6,0xb2d603fad
10000.11,2.0,92,2,3,1,6,0xb2d642f4d
102100.75,2.0,11,3,3,3,9,0xb2d64edfd
250089.46,2.0,66,3,3,2,8,0xb2d6143ed
21.78,1.0,60,1,2,2,5,0xb2d39c23d
3046.07,4.0,184,2,4,1,7,0x3b9b3576d
807453.38,6.0,3,4,4,4,12,0xb2d55c03d
102343.01,2.0,27,3,3,2,8,0xb2d2a315d
0.0,1.0,10,1,2,3,6,0xb2d5d278
160.61,1.0,24,1,2,2,5,0xb2d6c009
110004.01,3.0,90,3,4,1,8,0xb2d6a7a8d
355001.98,2.0,9,4,3,3,10,0xb2d9aa54
4919.34,1.0,3,2,2,4,8,0xb2d8d059
1802.75,1.0,92,1,2,1,4,0xb2d572a5d
1361193.88,3.0,1,4,4,4,12,0xb2d355edd
36850.3,1.0,3,2,2,4,8,0xb2d9f70c
70.17,1.0,3,1,2,4,7,0xb2d42e7dd
200009.01,2.0,83,3,3,1,7,0xb2d2b245d
467410.95,8.0,33,4,4,2,10,0xb2d37880d
50650.92,1.0,0,2,2,4,8,0xb2d8ccdbd
6479.5,1.0,0,2,2,4,8,0xb2d944e3d
1003000.0,3.0,0,4,4,4,12,0xb2d38e9bd
13.39,1.0,9,1,2,3,6,0xb2d8c419
800025.33,2.0,10,4,3,3,10,0xb2d95eafd
550200.41,3.0,1,4,4,4,12,0xb2d2234cd
1102775.73,5.0,7,4,4,3,11,0xb2d55273d
50000.53,2.0,59,2,3,2,7,0xb2d8fefa
6256.07,1.0,0,2,2,4,8,0xb2d3e4a9d
50000.84,2.0,32,2,3,2,7,0xb2d3df8ad
50423.19,2.0,13,2,3,3,8,0xb2d68501
7302.38,1.0,1,2,2,4,8,0xb2d62cc5
252523.19,3.0,0,3,4,4,11,0xb2d7c7c7d
545490.26,6.0,1,4,4,4,12,0xb2d37314d
1065490.86,9.0,0,4,4,4,12,0x3b9b1260d
2470696.45,77.0,0,4,4,4,12,0xb2d4a6ced
153257.2,2.0,0,3,3,4,10,0xb2d62cc1d
720044.29,4.0,4,4,4,4,12,0xb2d5e498d
20.53,1.0,9,1,2,3,6,0xb2d6c878
600087.87,3.0,2,4,4,4,12,0xb2d57c89d
302131.86,2.0,82,4,3,1,8,0xb2d6ec50
12.35,1.0,92,1,2,1,4,0xb2d280a6d
201769.02,4.0,24,3,4,2,9,0xb2d5f0b4d
1.59,1.0,81,1,2,1,4,0xb2d8d2e9d
4841.52,1.0,0,2,2,4,8,0xb2d68744d
804000.0,18.0,0,4,4,4,12,0xb2d4ff88d
0.0,5.0,36,1,4,2,7,0xb2d9c265
2232.65,1.0,10,1,2,3,6,0xb2d43545d
162.55,1.0,6,1,2,3,6,0xb2d960f4
50001.58,2.0,67,2,3,1,6,0xb2d9aa43
223004.33,5.0,83,3,4,1,8,0xb2d3e279d
7985.04,1.0,184,2,2,1,5,0xb2d31220d
121023.56,3.0,1,3,4,4,11,0xb2d93e5fd
80099.88,2.0,41,3,3,2,8,0xb2d921b8d
296017.93,2.0,0,3,3,4,10,0xb2d69ca9d
220037.08,3.0,3,3,4,4,11,0xb2d553bfd
110012.02,2.0,228,3,3,1,7,0xb2d6561fd
738.74,1.0,2,1,2,4,7,0xb2d6a3cc
6459.2,1.0,9,2,2,3,7,0xb2d706edd
30000.0,3.0,0,2,4,4,10,0xb2d8eb57
3113.88,1.0,12,2,2,3,7,0xb2d4e568d
102022.73,3.0,129,3,4,1,8,0xb2d50ae5
795334.57,6.0,0,4,4,4,12,0xb2d204fdd
213000.0,2.0,22,3,3,2,8,0xb2da217f
7457.81,1.0,0,2,2,4,8,0xb2d6874c
164.0,1.0,9,1,2,3,6,0xb2d2e69b
500000.0,2.0,29,4,3,2,9,0xb2da0a86
321261.42,3.0,5,4,4,3,11,0xb2d1bc89
2239.42,1.0,23,1,2,2,5,0xb2d46995d
9008.85,1.0,20,2,2,2,6,0xb2d54f30d
2401.34,1.0,14,1,2,3,6,0xb2d8cd2cd
453005.48,2.0,13,4,3,3,10,0xb2d94c22
0.0,1.0,4,1,2,4,7,0xb2d34e77
120000.0,2.0,3,3,3,4,10,0xb2d974ae
11764.64,1.0,24,2,2,2,6,0xb2d21b1ad
680035.84,4.0,21,4,4,2,10,0xb2d598a3d
32185.6,1.0,20,2,2,2,6,0xb2d15a59
105000.35,5.0,6,3,4,3,10,0xb2d4a3fbd
5.28,1.0,26,1,2,2,5,0xb2d6c743
15148.06,1.0,92,2,2,1,5,0xb2d285a9d
381744.3,3.0,0,4,4,4,12,0xb2d52da3d
400122.96,5.0,90,4,4,1,9,0xb2d660f5d
1710000.0,5.0,0,4,4,4,12,0xb2d645a6
307122.66,3.0,8,4,4,3,11,0xb2d61be5
379.48,1.0,7,1,2,3,6,0xb2d68c9e
80251.34,4.0,0,3,4,4,11,0xb2d2bcb5d
202456.37,2.0,84,3,3,1,7,0xb2d5d151
3.16,1.0,19,1,2,2,5,0xb2d60e20
856419.6,8.0,2,4,4,4,12,0x3b9ad188d
240002.93,2.0,24,3,3,2,8,0xb2d6c5bb
76166.5,1.0,0,3,2,4,9,0xb2d256d2d
189106.33,3.0,108,3,4,1,8,0xb2d343a3d
1047.83,1.0,16,1,2,2,5,0xb2d1ea21d
208723.03,2.0,1,3,3,4,10,0xb2d3e950d
1792.21,1.0,71,1,2,1,4,0xb2d27c8cd
301066.26,2.0,33,4,3,2,9,0xb2d65208
3825.17,1.0,186,2,2,1,5,0xb2d6b917d
3108.31,1.0,270,2,2,1,5,0xb2d31aacd
15000100.0,2.0,6,4,3,3,10,0xb2da506f
3495.78,1.0,194,2,2,1,5,0xb2d65a8fd
2786.55,1.0,92,1,2,1,4,0xb2d2fb78d
110008.27,4.0,195,3,4,1,8,0xb2d5a0c5
51611.49,1.0,184,2,2,1,5,0xb2d0d6a7
1153.8,1.0,92,1,2,1,4,0xb2d23a7ad
6.91,1.0,14,1,2,3,6,0xb2d419ff
4018.88,1.0,30,2,2,2,6,0xb2d1bf81d
60087.75,2.0,42,3,3,2,8,0xb2d17dd1
4497.35,1.0,0,2,2,4,8,0xb2d699b2
897315.84,5.0,3,4,4,4,12,0xb2d19b36
120588.12,2.0,13,3,3,3,9,0xb2d5b8a3
10586.53,1.0,25,2,2,2,6,0xb2d6d306d
16193.86,1.0,0,2,2,4,8,0xb2d61c0b
216272.82,3.0,0,3,4,4,11,0xb2d42b54
600012.24,6.0,11,4,4,3,11,0xb2d0ff0fd
1558.38,1.0,0,1,2,4,7,0xb2d38acbd
409077.52,2.0,5,4,3,3,10,0xb2d8f440d
47.9,4.0,71,1,4,1,6,0x3b9b4640d
42997.97,2.0,0,2,3,4,9,0xb2d30baf
20003.04,1.0,2,2,2,4,8,0xb2d31b4d
1237959.45,9.0,0,4,4,4,12,0x3b9b35f0d
25133.16,2.0,245,2,3,1,6,0xb2d28cfed
1700040.15,3.0,137,4,4,1,9,0xb2d8ecc9
565970.58,2.0,82,4,3,1,8,0xb2d652efd
339.34,1.0,4,1,2,4,7,0xb2d2cfc0
307.43,1.0,88,1,2,1,4,0xb2d54ce3d
398000.0,3.0,0,4,4,4,12,0xb2d8d385d
20002206.05,7.0,11,4,4,3,11,0xb2d3f682d
6696.87,1.0,7,2,2,3,7,0xb2d4a96b
610100.0,10.0,1,4,4,4,12,0xb2d13228d
0.23,1.0,7,1,2,3,6,0xb2d8da8d
405.52,3.0,4,1,4,4,9,0x3b9af186d
8058.23,1.0,92,2,2,1,5,0xb2d60d8ad
687860.08,4.0,15,4,4,3,11,0xb2d30d40d
77380.67,1.0,10,3,2,3,8,0xb2d78e1cd
10.01,2.0,60,1,3,2,6,0xb2d8fcbd
89011.76,3.0,4,3,4,4,11,0xb2d1b350
34431.51,1.0,0,2,2,4,8,0xb2d17f66d
85825.3,3.0,73,3,4,1,8,0xb2d588fb
220011.09,3.0,17,3,4,2,9,0xb2d9d303
580000.68,4.0,2,4,4,4,12,0xb2d93694d
4273971.53,2.0,31,4,3,2,9,0xb2d5999b
21.18,1.0,80,1,2,1,4,0xb2d14fe0
25.7,1.0,23,1,2,2,5,0xb2d6aee2
39040.16,1.0,0,2,2,4,8,0xb2d1a17f
20171.75,1.0,92,2,2,1,5,0xb2d2e409d
47494.31,1.0,26,2,2,2,6,0xb2d357c0d
800005.91,5.0,21,4,4,2,10,0xb2d5fb92d
20002.01,3.0,46,2,4,2,8,0xb2d1326bd
0.0,1.0,68,1,2,1,4,0xb2d8e6b4d
60001.9,2.0,214,3,3,1,7,0xb2d71916
1340200.97,6.0,3,4,4,4,12,0xb2d1467fd
4097.17,1.0,0,2,2,4,8,0xb2d95da5
200062.87,2.0,12,3,3,3,9,0xb2d1af9ad
14126.45,1.0,0,2,2,4,8,0xb2d9941c
285730.46,5.0,1,3,4,4,11,0xb2d0b56fd
603564.84,10.0,0,4,4,4,12,0xb2d60b27d
7191.96,1.0,234,2,2,1,5,0xb2d2b926d
0.01,1.0,46,1,2,2,5,0xb2d29c6bd
305248.9,2.0,36,4,3,2,9,0xb2d2c6e9d
1044322.25,6.0,4,4,4,4,12,0xb2d16d4ed
291100.43,3.0,12,3,4,3,10,0xb2da0c7f
15000.16,2.0,87,2,3,1,6,0xb2d8cb3b
165006.0,3.0,97,3,4,1,8,0xb2d15995
901.37,1.0,17,1,2,2,5,0xb2d6afda
4225.63,1.0,92,2,2,1,5,0xb2d31bfbd
10010.36,1.0,4,2,2,4,8,0xb2d581d8d
488854.83,10.0,0,4,4,4,12,0xb2d17264
1194.13,1.0,92,1,2,1,4,0xb2d0c9fa
6156.07,2.0,18,2,3,2,7,0xb2d1bae4
1000004.21,6.0,4,4,4,4,12,0xb2d8f60ed
2816.83,1.0,4,1,2,4,7,0xb2d7904ed
3.47,1.0,50,1,2,2,5,0xb2d9a5e7
1818.26,1.0,184,1,2,1,4,0xb2d281fed
3408.02,1.0,1,2,2,4,8,0xb2d994a1
741106.1,7.0,0,4,4,4,12,0xb2d2e04fd
11001.68,1.0,92,2,2,1,5,0xb2d0759ed
40666.0,3.0,0,2,4,4,10,0xb2d96eabd
80813.62,2.0,186,3,3,1,7,0xb2d60e75d
13495.39,1.0,112,2,2,1,5,0xb2d1c77ed
12.04,1.0,42,1,2,2,5,0xb2d580d3d
357033.24,10.0,19,4,4,2,10,0xb2d11131d
390.94,1.0,67,1,2,1,4,0xb2d551cad
423128.46,3.0,87,4,4,1,9,0xb2d6c39cd
380925.8,2.0,83,4,3,1,8,0xb2d321a7d
3089.9,1.0,25,2,2,2,6,0xb2d29430d
170007.65,2.0,81,3,3,1,7,0xb2d16f3cd
121031.19,3.0,10,3,4,3,10,0xb2d4225f
456.44,1.0,10,1,2,3,6,0xb2d6dcf5
26786.19,1.0,92,2,2,1,5,0xb2d2e39ed
5423.77,1.0,3,2,2,4,8,0xb2d2b7c4
2675.42,1.0,92,1,2,1,4,0xb2d2543ed
13421.85,1.0,10,2,2,3,7,0xb2d2d3c0
1378.94,2.0,5,1,3,3,7,0x3b9b3898
29649.96,1.0,7,2,2,3,7,0xb2d6b567d
6348.99,1.0,184,2,2,1,5,0x3b9b17c5d
5992.52,1.0,9,2,2,3,7,0xb2d5f62fd
30978.42,1.0,3,2,2,4,8,0xb2d51a4b
0.84,1.0,6,1,2,3,6,0xb2d96a88d
6009.95,1.0,20,2,2,2,6,0xb2d8ea17d
700003.17,4.0,0,4,4,4,12,0xb2d96adfd
11079.29,1.0,184,2,2,1,5,0xb2d1d092d
13477.19,1.0,20,2,2,2,6,0xb2d3f16dd
793.6,1.0,54,1,2,2,5,0xb2d94651
1208584.33,3.0,28,4,4,2,10,0xb2d40712d
29395.51,1.0,0,2,2,4,8,0xb2d2c08ed
60.59,1.0,25,1,2,2,5,0xb2d28d24
13221.08,1.0,28,2,2,2,6,0xb2d6f5b0d
55330.85,2.0,27,3,3,2,8,0xb2d43b7ad
214157.16,11.0,14,3,4,3,10,0xb2d9d490
230058.13,3.0,108,3,4,1,8,0xb2d6b18c
4.82,1.0,24,1,2,2,5,0xb2d58794
421.44,1.0,60,1,2,2,5,0xb2d1bdf9d
230027.51,3.0,20,3,4,2,9,0xb2d62d6cd
2054.6,3.0,20,1,4,2,7,0x3b9adf37d
500025.87,3.0,0,4,4,4,12,0xb2d78546d
120097.89,3.0,83,3,4,1,8,0xb2d119e6d
0.27,1.0,3,1,2,4,7,0xb2d6cfa1
100008.49,2.0,90,3,3,1,7,0xb2d975c8d
50000.01,1.0,5,2,2,3,7,0xb2d5978cd
300015.36,2.0,9,3,3,3,9,0xb2d55e0c
4000.38,1.0,0,2,2,4,8,0xb2d6bcf1
340004.61,5.0,3,4,4,4,12,0xb2d5cebfd
40.23,1.0,48,1,2,2,5,0xb2d65ec8
7889.44,1.0,3,2,2,4,8,0xb2d93629
60001.27,2.0,74,3,3,1,7,0xb2d99d3b
100659.86,1.0,0,3,2,4,9,0xb2d6b0e5
6030.08,1.0,92,2,2,1,5,0xb2d47653d
42507.34,2.0,0,2,3,4,9,0xb2d47291d
2309.99,1.0,0,1,2,4,7,0xb2d6bb23
3144.94,1.0,91,2,2,1,5,0xb2d6ecc6d
202545.34,2.0,1,3,3,4,10,0xb2d6522e
10942.57,1.0,0,2,2,4,8,0xb2d68811
31065.65,1.0,4,2,2,4,8,0xb2d62cf6d
99.23,1.0,47,1,2,2,5,0xb2d1e4d4
77282.89,1.0,0,3,2,4,9,0xb2d3984dd
38041.8,2.0,90,2,3,1,6,0xb2d57bb1d
94.42,1.0,6,1,2,3,6,0xb2d692a2
84200.61,3.0,1,3,4,4,11,0xb2da4a17
50021.75,2.0,184,2,3,1,6,0xb2d3711d
520008.21,5.0,4,4,4,4,12,0xb2d59b57
40273.47,1.0,6,2,2,3,7,0xb2d3a4f0d
510009.07,4.0,11,4,4,3,11,0xb2d1fec1d
409205.15,7.0,11,4,4,3,11,0xb2d13f60d
1004881.0,2.0,197,4,3,1,8,0xb2d418a7d
90012.04,9.0,5,3,4,3,10,0xb2d19ddd
100.35,1.0,32,1,2,2,5,0xb2d74465d
1.48,1.0,11,1,2,3,6,0x3b9b4a14
1131032.24,4.0,15,4,4,3,11,0xb2d68362d
10601.89,1.0,3,2,2,4,8,0xb2d39d57d
131539.16,16.0,55,3,4,2,9,0xb2d0ea13d
168578.74,11.0,0,3,4,4,11,0x3b9b4700d
53798.02,1.0,5,3,2,3,8,0xb2d29d2a
1935085.02,14.0,0,4,4,4,12,0x3b9af15dd
50082.37,2.0,14,2,3,3,8,0xb2d8cdbdd
15142.63,1.0,13,2,2,3,7,0xb2d48c5bd
10000.63,2.0,12,2,3,3,8,0xb2d95aa4d
600019.66,5.0,63,4,4,2,10,0xb2d23281d
260485.85,2.0,59,3,3,2,8,0xb2d5c4bcd
207114.18,2.0,5,3,3,3,9,0xb2d5f7f3d
413714.27,4.0,58,4,4,2,10,0xb2d50fa5
10412.46,1.0,0,2,2,4,8,0xb2d2da8c
20117.65,2.0,11,2,3,3,8,0xb2d9264e
2023.12,1.0,92,1,2,1,4,0xb2d23302d
4641.53,1.0,11,2,2,3,7,0xb2d95119
400018.31,4.0,9,4,4,3,11,0xb2d9f667
2313.42,1.0,9,1,2,3,6,0xb2d457b6
1598206.22,12.0,0,4,4,4,12,0x3b9b0fa3
27994.24,1.0,92,2,2,1,5,0x3b9af46c
10751.46,1.0,3,2,2,4,8,0xb2d2f005
1101.47,1.0,93,1,2,1,4,0xb2d399bcd
200000.0,2.0,23,3,3,2,8,0xb2da1f7a
62.38,1.0,34,1,2,2,5,0xb2d2752b
221647.07,3.0,10,3,4,3,10,0xb2d243edd
30000.19,4.0,3,2,4,4,10,0xb2d550bbd
1011.37,1.0,92,1,2,1,4,0xb2d1234fd
1.21,1.0,1,1,2,4,7,0xb2d34525
8500.81,1.0,2,2,2,4,8,0xb2d6d3d8
150004.49,2.0,214,3,3,1,7,0xb2d20078
19106.72,2.0,0,2,3,4,9,0xb2d8dd24d
188013.83,2.0,66,3,3,2,8,0xb2d6c09bd
6717.0,1.0,3,2,2,4,8,0xb2d96ff7
2.34,1.0,12,1,2,3,6,0xb2d6b12a
144322.07,3.0,98,3,4,1,8,0xb2d5dd9bd
1.02,1.0,17,1,2,2,5,0xb2d2fc60
1092396.04,7.0,27,4,4,2,10,0xb2d25a81
889347.45,4.0,5,4,4,3,11,0xb2d26194d
50064.1,2.0,0,2,3,4,9,0xb2d56098
6056.27,1.0,23,2,2,2,6,0xb2d7f187d
188.14,1.0,8,1,2,3,6,0xb2d469a8d
904.28,1.0,9,1,2,3,6,0xb2d9d891
310000.0,3.0,9,4,4,3,11,0xb2d5c399
20002.96,2.0,31,2,3,2,7,0xb2d3fb26d
300013.56,3.0,0,3,4,4,11,0xb2d32a5fd
703.46,1.0,3,1,2,4,7,0xb2d6ce0f
6021.3,1.0,0,2,2,4,8,0xb2d99559
150006.8,2.0,129,3,3,1,7,0xb2d26164d
152195.83,2.0,0,3,3,4,10,0xb2da098e
14757.49,1.0,10,2,2,3,7,0xb2d26647d
1938.28,2.0,92,1,3,1,5,0xb2d19bb6d
353319.05,4.0,0,4,4,4,12,0xb2d1f2d2d
400000.0,3.0,2,4,4,4,12,0xb2d57e4c
304.55,1.0,2,1,2,4,7,0xb2da3c51
600152.47,3.0,46,4,4,2,10,0xb2d1a6b9d
104297.01,1.0,175,3,2,1,6,0xb2d0c60fd
50294.31,2.0,82,2,3,1,6,0xb2d6547dd
8566.26,1.0,0,2,2,4,8,0xb2d3921b
50077.73,2.0,10,2,3,3,8,0xb2d95a82
190054.05,3.0,80,3,4,1,8,0xb2d5d68ad
51066.86,2.0,92,2,3,1,6,0xb2d5acb7d
420086.88,7.0,18,4,4,2,10,0xb2d5a67cd
180012.51,2.0,1,3,3,4,10,0xb2d60b41
8605.73,1.0,0,2,2,4,8,0xb2d92b4b
1456.76,1.0,136,1,2,1,4,0xb2d6d2f6
928.52,1.0,5,1,2,3,6,0xb2d2506d
110303.11,3.0,8,3,4,3,10,0xb2d8dfa6d
6011.17,1.0,93,2,2,1,5,0xb2d61eb1d
4182.32,1.0,0,2,2,4,8,0xb2d8b1d1d
2166.16,1.0,10,1,2,3,6,0xb2d3ebccd
35000.37,2.0,21,2,3,2,7,0xb2da20da
1905888.13,6.0,10,4,4,3,11,0xb2d598e7
152907.35,2.0,0,3,3,4,10,0xb2d0a005
2.68,1.0,69,1,2,1,4,0xb2d95e05
882397.04,5.0,3,4,4,4,12,0xb2d6278cd
4907.53,1.0,20,2,2,2,6,0xb2d5406c
360000.02,1.0,5,4,2,3,9,0xb2d3a0e7
400000.0,2.0,11,4,3,3,10,0xb2da4b15
80003.38,2.0,92,3,3,1,7,0xb2d64829d
200000.0,2.0,11,3,3,3,9,0xb2d93888d
26879.24,10.0,50,2,4,2,8,0xb2d2605e
52448.79,1.0,8,3,2,3,8,0xb2d6f063d
28187.07,1.0,8,2,2,3,7,0xb2d6b34dd
194877.95,3.0,158,3,4,1,8,0xb2d6a8dad
1246.91,1.0,2,1,2,4,7,0xb2d933b1d
0.05,1.0,8,1,2,3,6,0xb2d2491b
81163.13,2.0,95,3,3,1,7,0xb2d6358ad
3687.44,1.0,15,2,2,3,7,0xb2d52dd9d
121589.74,1.0,13,3,2,3,8,0xb2d6bf0a
1000000.0,2.0,1,4,3,4,11,0xb2d9de7d
1925.46,2.0,3,1,3,4,8,0xb2d0e37ed
500049.87,2.0,6,4,3,3,10,0xb2d9ebb6
480716.48,3.0,5,4,4,3,11,0xb2d86a4ed
501796.36,2.0,30,4,3,2,9,0xb2d93ebb
3019.33,1.0,92,2,2,1,5,0xb2d26356d
601132.87,3.0,8,4,4,3,11,0xb2d9b6b7
400005.91,3.0,3,4,4,4,12,0xb2d63c80
50000.53,2.0,25,2,3,2,7,0xb2da154e
131615.45,2.0,4,3,3,4,10,0xb2d6ab82d
570177.49,3.0,1,4,4,4,12,0xb2d62ce7d
8017.03,1.0,184,2,2,1,5,0x3b9af6d1d
856027.85,3.0,10,4,4,3,11,0xb2d14ce9d
503635.83,7.0,0,4,4,4,12,0xb2d0bcfd
163002.67,2.0,84,3,3,1,7,0xb2d21540d
2700248.81,3.0,14,4,4,3,11,0xb2d06b61
66172.87,2.0,0,3,3,4,10,0xb2d59cf2
332361.01,8.0,59,4,4,2,10,0xb2d1cd36d
2.27,1.0,5,1,2,3,6,0xb2d6f3bb
39888.98,1.0,1,2,2,4,8,0xb2d364d9
398211.67,4.0,5,4,4,3,11,0xb2d10dd0
0.83,1.0,86,1,2,1,4,0xb2d5d6ec
240003.8,3.0,80,3,4,1,8,0xb2d6eb8dd
364005.14,4.0,0,4,4,4,12,0xb2d1b9c7d
220000.0,2.0,6,3,3,3,9,0xb2d9b25b
3615.57,1.0,184,2,2,1,5,0xb2d261bed
70003.49,3.0,6,3,4,3,10,0xb2d929edd
40029.71,5.0,1,2,4,4,10,0xb2d9eccb
980092.39,4.0,188,4,4,1,9,0xb2d07efe
368.01,1.0,40,1,2,2,5,0xb2d0742ed
90065.16,2.0,50,3,3,2,8,0xb2d2e7c2d
270875.97,4.0,0,3,4,4,11,0xb2d6a9e2d
6.86,1.0,19,1,2,2,5,0xb2d943acd
24953.31,1.0,13,2,2,3,7,0xb2d2aae8d
4031.18,1.0,184,2,2,1,5,0xb2d243f4d
1551890.69,7.0,4,4,4,4,12,0xb2d2a7fa
61858.19,5.0,9,3,4,3,10,0x3b9b0f1c
1651.76,1.0,15,1,2,3,6,0xb2d28278d
30010.86,2.0,21,2,3,2,7,0xb2d78c4b
789974.15,9.0,9,4,4,3,11,0xb2d657fad
360914.22,6.0,83,4,4,1,9,0xb2d3f23ad
1849.2,8.0,0,1,4,4,9,0x3b9af1f7d
800068.61,9.0,0,4,4,4,12,0xb2d359b8d
3145962.28,7.0,0,4,4,4,12,0x3b9b1814d
444644.72,2.0,0,4,3,4,11,0xb2d2f0d7d
1069.91,1.0,252,1,2,1,4,0xb2d6abe2
400008.44,2.0,31,4,3,2,9,0xb2d93831d
440000.0,13.0,7,4,4,3,11,0xb2d0c993d
213010.92,2.0,206,3,3,1,7,0xb2d5c5c3d
1200.48,1.0,92,1,2,1,4,0xb2d1db58d
500091.93,6.0,12,4,4,3,11,0xb2d592f4
300284.51,3.0,0,4,4,4,12,0x3b9b0e66d
7448.53,1.0,1,2,2,4,8,0xb2d6baafd
9010.55,1.0,4,2,2,4,8,0xb2d6ea6f
3430.3,1.0,4,2,2,4,8,0xb2d52db6
2000417.65,3.0,3,4,4,4,12,0xb2d6f78ad
604.44,3.0,0,1,4,4,9,0xb2d0685fd
11.3,2.0,0,1,3,4,8,0xb2d19533d
1560.38,1.0,3,1,2,4,7,0xb2d68ecd
130626.97,1.0,19,3,2,2,7,0xb2d3abbad
430000.0,2.0,8,4,3,3,10,0xb2da50ac
82912.26,2.0,105,3,3,1,7,0xb2d605b4d
262587.36,5.0,19,3,4,2,9,0xb2d11c42
1535.01,2.0,76,1,3,1,5,0xb2d4f98fd
102.93,1.0,21,1,2,2,5,0xb2d91ac9
134025.71,3.0,49,3,4,2,9,0xb2d509dad
3319.08,1.0,9,2,2,3,7,0xb2d4c178d
1695.62,1.0,92,1,2,1,4,0xb2d221acd
1112000.0,2.0,18,4,3,2,9,0xb2d912be
30000.97,3.0,11,2,4,3,9,0xb2d5c6edd
456.87,1.0,0,1,2,4,7,0xb2d617bb
92.08,1.0,9,1,2,3,6,0xb2d38a1ed
505330.7,2.0,25,4,3,2,9,0xb2d78a9ad
14290.66,1.0,1,2,2,4,8,0xb2d5305f
100605.82,2.0,36,3,3,2,8,0xb2d7d25a
252665.05,2.0,106,3,3,1,7,0xb2d95df4
182047.7,4.0,70,3,4,1,8,0xb2d22d2fd
305015.85,2.0,4,4,3,4,11,0xb2d9d5d0
50001.78,3.0,98,2,4,1,7,0xb2d0ee16d
2555.27,1.0,14,1,2,3,6,0xb2d1d319
3057.92,1.0,4,2,2,4,8,0xb2d9d28e
25100.23,1.0,3,2,2,4,8,0xb2d68ea5d
0.02,1.0,27,1,2,2,5,0xb2d92860d
3441.08,1.0,20,2,2,2,6,0xb2d37037
233344.26,3.0,92,3,4,1,8,0xb2d6b0d1
558335.29,5.0,0,4,4,4,12,0xb2d2fb22d
8816.21,1.0,184,2,2,1,5,0xb2d1affcd
423022.03,2.0,139,4,3,1,8,0xb2d53cb6d
5028.66,1.0,92,2,2,1,5,0xb2d430fcd
30000.32,2.0,45,2,3,2,7,0xb2d91baad
64239.73,2.0,67,3,3,1,7,0xb2d39de1d
200010.46,2.0,0,3,3,4,10,0xb2d91e6fd
143919.93,1.0,0,3,2,4,9,0xb2d45a41
241710.57,2.0,56,3,3,2,8,0xb2d93f56d
518216.52,1.0,5,4,2,3,9,0xb2d61d1ad
405556.78,2.0,71,4,3,1,8,0xb2d9a655
838207.71,3.0,49,4,4,2,10,0xb2d3c9e6d
400087.35,3.0,9,4,4,3,11,0xb2d60e44
300000.0,2.0,7,3,3,3,9,0xb2da549d
90850.46,3.0,1,3,4,4,11,0xb2d160cb
470089.48,6.0,49,4,4,2,10,0xb2d18100d
154.26,1.0,19,1,2,2,5,0xb2d398add
9727.5,1.0,0,2,2,4,8,0xb2d570afd
500013.2,2.0,60,4,3,2,9,0xb2d9b8fb
660.01,2.0,9,1,3,3,7,0xb2d69b1f
20730.52,1.0,99,2,2,1,5,0xb2d62580d
659.3,1.0,1,1,2,4,7,0xb2d0d7e8d
2638.89,1.0,92,1,2,1,4,0xb2d5f585d
220620.22,82.0,0,3,4,4,11,0xb2d06826d
330012.22,2.0,9,4,3,3,10,0xb2d10a2cd
430000.55,2.0,20,4,3,2,9,0xb2d8d5e9
30094.97,2.0,165,2,3,1,6,0xb2d3ae51d
15806.55,1.0,184,2,2,1,5,0x3b9b23bdd
60093.14,2.0,49,3,3,2,8,0xb2d8fe35
400071.48,2.0,6,4,3,3,10,0xb2d6c832d
40474.67,2.0,179,2,3,1,6,0xb2d388a5d
328.35,1.0,13,1,2,3,6,0xb2d90d31
667603.51,4.0,3,4,4,4,12,0xb2d16071d
3034.86,1.0,184,2,2,1,5,0xb2d0f8ccd
20.7,1.0,47,1,2,2,5,0xb2d813a1
282355.36,4.0,4,3,4,4,11,0xb2d60b99d
15000.0,1.0,92,2,2,1,5,0xb2d60073d
50002.64,2.0,6,2,3,3,8,0xb2d8e690d
23.59,1.0,0,1,2,4,7,0xb2d4343f
1004.79,1.0,184,1,2,1,4,0xb2d5291bd
16913.26,1.0,0,2,2,4,8,0xb2d6c0b4
40965.38,3.0,3,2,4,4,10,0xb2d1f062d
10005.28,1.0,48,2,2,2,6,0xb2d91028
361584.14,5.0,32,4,4,2,10,0xb2d1372bd
1016.54,1.0,184,1,2,1,4,0xb2d0f6f2d
65235.41,1.0,13,3,2,3,8,0xb2d2cecdd
6599.76,1.0,2,2,2,4,8,0xb2d3cea7
300000.0,2.0,3,3,3,4,10,0xb2d97e23d
51323.03,2.0,92,2,3,1,6,0x3b9b2e12d
8868.08,1.0,10,2,2,3,7,0xb2d3436fd
2627.71,1.0,11,1,2,3,6,0xb2da080b
316851.99,2.0,111,4,3,1,8,0xb2d7829cd
8310.4,1.0,73,2,2,1,5,0xb2d6151d
232000.0,1.0,1,3,2,4,9,0xb2d9e512
307467.25,2.0,232,4,3,1,8,0xb2d6eee2d
107.56,1.0,1,1,2,4,7,0xb2d94c24d
1764000.0,11.0,3,4,4,4,12,0xb2d13bc0
1130000.0,3.0,18,4,4,2,10,0xb2d950a0d
2503.61,1.0,14,1,2,3,6,0xb2d6beb2d
2421060.46,2.0,76,4,3,1,8,0xb2d6867bd
1616493.8,2.0,107,4,3,1,8,0xb2d1bf0ed
36.33,1.0,62,1,2,2,5,0xb2d5f5f5d
76099.68,5.0,102,3,4,1,8,0xb2d5b9d9d
590053.5,8.0,5,4,4,3,11,0xb2d6ed8ad
62.63,1.0,63,1,2,2,5,0xb2d91870d
9023.47,1.0,0,2,2,4,8,0xb2d0d9b2d
50001.33,2.0,80,2,3,1,6,0xb2d5d9e5
421527.02,3.0,8,4,4,3,11,0xb2d628d1d
9663.41,1.0,184,2,2,1,5,0xb2d24a65d
24856.8,1.0,55,2,2,2,6,0xb2d37f8ad
3373.79,1.0,305,2,2,1,5,0xb2d3b77ad
200019.39,3.0,22,3,4,2,9,0xb2d9f1c8
341.85,1.0,1,1,2,4,7,0xb2d627d0
310007.6,2.0,6,4,3,3,10,0xb2d99802
76.69,1.0,26,1,2,2,5,0xb2d921e9d
386630.54,3.0,171,4,4,1,9,0xb2d41162d
89192.86,2.0,123,3,3,1,7,0xb2d200a2d
197171.34,3.0,1,3,4,4,11,0xb2d0f04c
3085.48,1.0,23,2,2,2,6,0xb2d25b41
100004.22,1.0,14,3,2,3,8,0xb2da2ea9
3675.17,1.0,10,2,2,3,7,0xb2d6e7fcd
10000.21,2.0,39,2,3,2,7,0xb2d9efa7
1275.83,1.0,77,1,2,1,4,0xb2d4d96b
98862.97,1.0,92,3,2,1,6,0xb2d30186d
500299.02,2.0,0,4,3,4,11,0xb2d5cf4ed
190231.81,3.0,14,3,4,3,10,0xb2d5f93fd
2241.38,1.0,104,1,2,1,4,0xb2d435e6d
21008.05,1.0,0,2,2,4,8,0xb2d8692ad
260059.59,8.0,53,3,4,2,9,0xb2d3f356
400736.27,3.0,16,4,4,2,10,0xb2d5fc16
2287541.78,11.0,15,4,4,3,11,0xb2d26a97d
196193.37,4.0,118,3,4,1,8,0xb2d56831d
30000.71,1.0,0,2,2,4,8,0xb2d58e34d
0.0,1.0,4,1,2,4,7,0xb2d93b0c
3.36,1.0,8,1,2,3,6,0xb2d42b0b
146000.0,3.0,1,3,4,4,11,0xb2d53823d
36.81,1.0,208,1,2,1,4,0xb2d175a0d
183.49,1.0,42,1,2,2,5,0xb2d48903d
1364.89,1.0,0,1,2,4,7,0xb2d31195
232000.0,5.0,0,3,4,4,11,0xb2d5a0b5d
49.47,1.0,41,1,2,2,5,0xb2d15dc7d
2495.74,1.0,21,1,2,2,5,0xb2d19f01d
32.3,6.0,0,1,4,4,9,0xb2d06a76
0.97,1.0,61,1,2,2,5,0xb2d42ae5
100011.39,2.0,87,3,3,1,7,0xb2d3ba3b
302542.18,2.0,29,4,3,2,9,0xb2d6ea21d
36.17,1.0,4,1,2,4,7,0xb2d4f5d1
1.65,1.0,13,1,2,3,6,0xb2d6a074d
300027.73,2.0,92,3,3,1,7,0xb2d97a26d
110384.02,6.0,0,3,4,4,11,0xb2d687b5d
101146.06,2.0,151,3,3,1,7,0xb2d5fcbed
285922.06,5.0,67,3,4,1,8,0xb2d6f7d9d
14989.9,1.0,92,2,2,1,5,0xb2d06ff4d
3266.05,1.0,44,2,2,2,6,0xb2d25c40
3339.4,1.0,0,2,2,4,8,0xb2d423a3
540021.37,5.0,189,4,4,1,9,0xb2d074a4d
50002.11,2.0,53,2,3,2,7,0xb2d32614
2363.87,1.0,6,1,2,3,6,0xb2d5b08dd
0.0,1.0,8,1,2,3,6,0xb2d5897bd
50688.03,1.0,10,2,2,3,7,0xb2d9986d
50677.99,1.0,148,2,2,1,5,0xb2d6d47e
200117.28,2.0,63,3,3,2,8,0xb2d86bee
801100.92,3.0,32,4,4,2,10,0xb2da043e
505329.52,2.0,93,4,3,1,8,0xb2d97ff6d
267782.53,2.0,106,3,3,1,7,0xb2d9359f
201.43,1.0,6,1,2,3,6,0xb2d54e92
132004.18,3.0,0,3,4,4,11,0xb2d5a103d
301065.7,2.0,46,4,3,2,9,0xb2d9e569
60004.94,2.0,74,3,3,1,7,0xb2d4b90c
331725.94,4.0,39,4,4,2,10,0xb2d61538d
59.01,4.0,110,1,4,1,6,0xb2d29b7fd
2534.54,1.0,1,1,2,4,7,0xb2d6e476d
550724.93,6.0,38,4,4,2,10,0xb2d1af0bd
258182.53,8.0,0,3,4,4,11,0xb2d0ce0cd
5094.69,1.0,184,2,2,1,5,0xb2d2aad1d
866.9,1.0,20,1,2,2,5,0xb2d6c1dd
313209.63,3.0,60,4,4,2,10,0xb2d5ced9d
50000.53,2.0,6,2,3,3,8,0xb2da2625
370040.07,6.0,3,4,4,4,12,0xb2d6571a
516.57,2.0,61,1,3,2,6,0xb2d2eafb
613557.96,3.0,239,4,4,1,9,0xb2d295b8d
5566.29,2.0,10,2,3,3,8,0xb2d9af32
12576.13,1.0,92,2,2,1,5,0xb2d287a5
150510.63,3.0,4,3,4,4,11,0xb2d1490e
51783.0,2.0,126,2,3,1,6,0xb2d5ec3dd
487136.34,3.0,46,4,4,2,10,0xb2d3e214
300028.19,2.0,3,3,3,4,10,0xb2d5af40
3354.73,1.0,3,2,2,4,8,0xb2d6b836
22270.11,1.0,1,2,2,4,8,0xb2d64ffe
414396.3,2.0,70,4,3,1,8,0xb2d4a98c
1413.76,21.0,0,1,4,4,9,0x3b9ae3e4d
20122.44,1.0,189,2,2,1,5,0xb2d2b40fd
150052.9,4.0,67,3,4,1,8,0xb2d0db28
191896.86,3.0,25,3,4,2,9,0xb2d19b04d
1629.14,1.0,0,1,2,4,7,0xb2d8c6b1d
2904490.66,4.0,41,4,4,2,10,0xb2d561a8d
42330.25,4.0,0,2,4,4,10,0x3b9af116
50000.53,2.0,53,2,3,2,7,0xb2d9d11e
14.12,2.0,42,1,3,2,6,0xb2d57107
301065.74,2.0,50,4,3,2,9,0xb2d9d8cc
50003.2,2.0,146,2,3,1,6,0xb2d65b56d
8006715.49,5.0,92,4,4,1,9,0x3b9af646d
123329.04,4.0,4,3,4,4,11,0xb2d67fa0
20726.75,1.0,11,2,2,3,7,0xb2d61269d
7066.37,1.0,7,2,2,3,7,0xb2d8f229
213858.89,2.0,75,3,3,1,7,0xb2d33e3c
528710.61,8.0,8,4,4,3,11,0xb2d40fc2d
1.19,1.0,40,1,2,2,5,0xb2d9a076
24599.12,2.0,3,2,3,4,9,0xb2d1605fd
607591.14,4.0,98,4,4,1,9,0xb2d1112fd
23011.65,1.0,14,2,2,3,7,0xb2d6c3b7
158105.26,3.0,121,3,4,1,8,0xb2d3bcb2
100052.46,2.0,92,3,3,1,7,0xb2d25341d
1103633.06,4.0,0,4,4,4,12,0xb2d65d58d
200000.0,1.0,0,3,2,4,9,0xb2da5f5d
110001.16,2.0,24,3,3,2,8,0xb2d94a92d
1778.9,1.0,184,1,2,1,4,0xb2d2a376d
1112.71,1.0,92,1,2,1,4,0x3b9b2e73d
5246.27,1.0,93,2,2,1,5,0xb2d3b5bd
1679.13,1.0,0,1,2,4,7,0xb2d3cad1
580000.0,2.0,15,4,3,3,10,0xb2da319e
158333.43,5.0,7,3,4,3,10,0xb2d14cce
5649.13,1.0,0,2,2,4,8,0xb2d222ffd
25735.66,1.0,15,2,2,3,7,0xb2d9c7fc
277.41,1.0,15,1,2,3,6,0xb2d6a3e7
61568.88,7.0,0,3,4,4,11,0xb2d13b9e
166009.8,2.0,87,3,3,1,7,0xb2d2be0bd
2932.42,1.0,184,2,2,1,5,0xb2d2adb0d
7331008.38,8.0,42,4,4,2,10,0xb2d63f55d
596.09,5.0,0,1,4,4,9,0x3b9af2c9d
945258.38,16.0,1,4,4,4,12,0xb2d240da
20085.31,3.0,6,2,4,3,9,0xb2d96b35
80503.5,3.0,18,3,4,2,9,0xb2d5bf1ed
35.87,1.0,39,1,2,2,5,0xb2d14f69d
226.08,1.0,0,1,2,4,7,0xb2d6c081
8833.71,1.0,38,2,2,2,6,0xb2d8d6aa
2645.49,1.0,92,1,2,1,4,0xb2d15365d
61.27,1.0,28,1,2,2,5,0xb2d7c1f8
0.0,1.0,18,1,2,2,5,0xb2d0a2d4
441.13,1.0,9,1,2,3,6,0xb2d280acd
1217.14,1.0,263,1,2,1,4,0xb2d63f1ed
1320093.83,9.0,2,4,4,4,12,0xb2d58df0d
56000.0,2.0,4,3,3,4,10,0xb2da5dc1
1409.79,1.0,10,1,2,3,6,0xb2d58d4d
21001.86,2.0,33,2,3,2,7,0xb2d9e280
50003.06,2.0,10,2,3,3,8,0xb2d962edd
1004942.93,2.0,5,4,3,3,10,0xb2d1c42bd
1.2,1.0,92,1,2,1,4,0xb2d282cbd
570012.04,2.0,116,4,3,1,8,0xb2d782d3d
10702.35,1.0,3,2,2,4,8,0xb2d2eaddd
600002.11,5.0,25,4,4,2,10,0xb2d5dbb8d
880044.61,4.0,63,4,4,2,10,0xb2d29b4c
21653.19,2.0,20,2,3,2,7,0xb2d6841ed
114814.57,1.0,16,3,2,2,7,0xb2d78569
143.42,1.0,103,1,2,1,4,0xb2d33230d
21701.15,3.0,0,2,4,4,10,0xb2d30b17
5642.25,1.0,92,2,2,1,5,0xb2d32966
11497.7,1.0,4,2,2,4,8,0xb2d2e62fd
248010.83,5.0,53,3,4,2,9,0xb2d3f623
335041.36,5.0,40,4,4,2,10,0xb2d411e6d
54989.28,1.0,10,3,2,3,8,0xb2d96cbf
4767.83,2.0,184,2,3,1,6,0xb2d0cc6cd
399002.06,3.0,6,4,4,3,11,0xb2d69e03d
2258.21,1.0,9,1,2,3,6,0xb2d4806ed
74234.32,3.0,0,3,4,4,11,0xb2d29319
200000.01,2.0,13,3,3,3,9,0xb2d9a17e
180456.21,2.0,0,3,3,4,10,0xb2d1f87a
0.0,1.0,7,1,2,3,6,0xb2d283c9
537657.09,6.0,0,4,4,4,12,0xb2d5d3f7d
4600.08,1.0,0,2,2,4,8,0xb2d9740d
5134.86,8.0,92,2,4,1,7,0xb2d08a64
501778.2,5.0,27,4,4,2,10,0xb2d655c8d
1007.25,1.0,92,1,2,1,4,0xb2d31b57d
1274.87,1.0,234,1,2,1,4,0xb2d2a2d9d
2417.12,1.0,184,1,2,1,4,0xb2d1fd78d
13.42,1.0,11,1,2,3,6,0xb2d5f9a0
980133.58,4.0,21,4,4,2,10,0xb2d58685d
230.64,1.0,9,1,2,3,6,0xb2d590f9
867138.35,4.0,96,4,4,1,9,0xb2d60a25d
77073.15,1.0,99,3,2,1,6,0xb2d85230
3694.5,1.0,130,2,2,1,5,0xb2d685cd
10052.36,1.0,92,2,2,1,5,0xb2d47daed
4341.77,1.0,188,2,2,1,5,0xb2d28f1dd
137.95,1.0,84,1,2,1,4,0xb2d92cd2d
12002.94,2.0,1,2,3,4,9,0xb2d5eb40d
3168.84,1.0,9,2,2,3,7,0xb2d50a74
945850.72,5.0,54,4,4,2,10,0xb2d0fefad
10002.93,2.0,42,2,3,2,7,0xb2d2b1fbd
675570.39,10.0,11,4,4,3,11,0xb2d17264d
787000.0,7.0,1,4,4,4,12,0xb2d5ca4b
374538.85,1.0,4,4,2,4,10,0xb2d5a720d
203921.53,2.0,92,3,3,1,7,0xb2d2850ed
40.9,1.0,1,1,2,4,7,0xb2d3fd7c
225.64,1.0,11,1,2,3,6,0xb2d37a35
96518.82,1.0,6,3,2,3,8,0xb2d6c889
13423.67,1.0,0,2,2,4,8,0xb2d1581ed
211284.35,3.0,0,3,4,4,11,0xb2d552f9
714830.63,4.0,4,4,4,4,12,0xb2d67faed
43539.54,1.0,15,2,2,3,7,0xb2d3a106d
102362.82,2.0,56,3,3,2,8,0xb2d6c03dd
828.15,1.0,10,1,2,3,6,0xb2d4da3ad
157362.26,1.0,92,3,2,1,6,0x3b9b25b0d
2113.4,1.0,0,1,2,4,7,0xb2d3466ad
41.89,1.0,1,1,2,4,7,0xb2d5e960
100000.42,3.0,0,3,4,4,11,0xb2d6449ed
182053.18,1.0,13,3,2,3,8,0xb2d3980bd
1440356.3,4.0,0,4,4,4,12,0xb2d3caeb
1033709.74,11.0,24,4,4,2,10,0xb2d086d1
4048.64,1.0,0,2,2,4,8,0xb2d65038
3323.71,1.0,5,2,2,3,7,0xb2d32ed9d
400387.8,3.0,5,4,4,3,11,0xb2d6e7fad
300000.0,2.0,6,3,3,3,9,0xb2da546b
320903.3,9.0,11,4,4,3,11,0xb2d94ffed
1275.31,1.0,92,1,2,1,4,0xb2d2511ad
5031.65,1.0,92,2,2,1,5,0xb2d3a965d
1042527.5,2.0,4,4,3,4,11,0xb2d5ae81d
326097.76,3.0,0,4,4,4,12,0xb2d6a8fcd
10897.27,1.0,0,2,2,4,8,0xb2d6b958
103231.48,2.0,25,3,3,2,8,0xb2d68ca2d
6080.72,1.0,0,2,2,4,8,0xb2d6519cd
500000.0,2.0,6,4,3,3,10,0xb2da5932
20.59,1.0,0,1,2,4,7,0xb2d2c289
1203046.48,8.0,18,4,4,2,10,0xb2d116e2d
200000.42,2.0,25,3,3,2,8,0xb2d9cd81
395007.63,6.0,0,4,4,4,12,0xb2d21037d
70267.12,1.0,184,3,2,1,6,0xb2d59610d
106213.08,1.0,21,3,2,2,7,0xb2d5c5fad
580028.09,5.0,11,4,4,3,11,0xb2d5a759d
155873.41,3.0,1,3,4,4,11,0xb2d2667f
1303644.69,3.0,60,4,4,2,10,0xb2d41e36d
927222.46,13.0,11,4,4,3,11,0xb2d51fcfd
293005.81,4.0,6,3,4,3,10,0xb2d41f64d
1127014.83,8.0,46,4,4,2,10,0xb2d1527bd
1004325.61,2.0,25,4,3,2,9,0xb2d6b157
233554.82,3.0,3,3,4,4,11,0xb2d6babfd
2010.36,1.0,0,1,2,4,7,0xb2d5ee17d
11407.73,1.0,265,2,2,1,5,0xb2d682f5d
156.84,1.0,88,1,2,1,4,0xb2d67e6fd
500076.05,2.0,18,4,3,2,9,0xb2d91242d
534.86,1.0,46,1,2,2,5,0xb2d5e5add
7.24,1.0,92,1,2,1,4,0xb2d2b0add
1631.45,1.0,0,1,2,4,7,0xb2d1e6bb
1709.59,1.0,0,1,2,4,7,0xb2d364ecd
1330594.8,3.0,8,4,4,3,11,0xb2d40f35d
260.01,1.0,60,1,2,2,5,0xb2d258f5
2000220.32,4.0,13,4,4,3,11,0xb2d6a12cd
50059.65,1.0,122,2,2,1,5,0xb2d6b39bd
841.27,1.0,11,1,2,3,6,0xb2d20866
130322.01,2.0,136,3,3,1,7,0xb2d3816fd
2557.17,1.0,0,1,2,4,7,0xb2d9646b
27830.62,1.0,9,2,2,3,7,0xb2d36d99d
658.75,1.0,0,1,2,4,7,0xb2d9bdf3
1.52,1.0,52,1,2,2,5,0xb2d28c94d
4959.27,1.0,88,2,2,1,5,0xb2d56613d
95.11,1.0,24,1,2,2,5,0xb2d93bcc
450970.61,6.0,3,4,4,4,12,0xb2d245f2d
700711.22,4.0,10,4,4,3,11,0xb2d6ea40d
3330.66,1.0,1,2,2,4,8,0xb2d4f796d
520002.15,4.0,5,4,4,3,11,0xb2d4ee00d
634.74,1.0,12,1,2,3,6,0xb2d17726d
98.55,1.0,12,1,2,3,6,0xb2d08a07
115933.82,3.0,3,3,4,4,11,0xb2d2dd56d
312986.48,3.0,52,4,4,2,10,0xb2d3d9d3
300012.69,2.0,195,3,3,1,7,0xb2d69d7c
12533.39,1.0,20,2,2,2,6,0xb2d60516d
14165.53,1.0,86,2,2,1,5,0xb2d39519
351.86,2.0,0,1,3,4,8,0xb2d0ea04
306747.91,3.0,33,4,4,2,10,0xb2d68367d
98.77,1.0,0,1,2,4,7,0xb2d61b45d
2290.34,1.0,26,1,2,2,5,0xb2d27118
70002.27,3.0,22,3,4,2,9,0xb2d35a80d
102341.67,7.0,4,3,4,4,11,0xb2d3ce57
340004.75,13.0,1,4,4,4,12,0xb2d252edd
600378.8,2.0,1,4,3,4,11,0xb2d4d963
7508.72,1.0,9,2,2,3,7,0xb2d713de
390054.1,7.0,4,4,4,4,12,0xb2d40b68
42444.12,1.0,184,2,2,1,5,0xb2d2b48ad
315093.83,3.0,10,4,4,3,11,0xb2d6eb75d
2249.97,1.0,184,1,2,1,4,0x3b9b2477d
200038.01,2.0,92,3,3,1,7,0xb2d19705d
791113.47,12.0,22,4,4,2,10,0x3b9b17d3d
430788.42,3.0,13,4,4,3,11,0xb2d98679
483000.0,13.0,3,4,4,4,12,0xb2d53b56
150044.13,4.0,55,3,4,2,9,0xb2d239cfd
3256118.98,5.0,2,4,4,4,12,0xb2d780c5d
399051.58,4.0,0,4,4,4,12,0xb2d5b658d
3077.41,1.0,10,2,2,3,7,0xb2d34bb5
4.12,1.0,67,1,2,1,4,0xb2d64874d
1535.64,1.0,92,1,2,1,4,0xb2d22456d
139823.03,2.0,8,3,3,3,9,0xb2d49e17
0.0,1.0,1,1,2,4,7,0xb2da54a8
321201.65,2.0,10,4,3,3,10,0xb2d1949bd
214529.14,3.0,0,3,4,4,11,0xb2d6155cd
186843.09,9.0,2,3,4,4,11,0x3b9b4602d
1.29,1.0,79,1,2,1,4,0xb2d3aa81
21919.18,2.0,50,2,3,2,7,0xb2d90387d
151884.54,1.0,1,3,2,4,9,0xb2d0ee85
880037.28,3.0,18,4,4,2,10,0xb2d11b53d
161836.86,3.0,119,3,4,1,8,0xb2d28464d
310399.76,2.0,3,4,3,4,11,0xb2d2c2f2d
401056.29,2.0,67,4,3,1,8,0xb2d0d05cd
41000.43,2.0,10,2,3,3,8,0xb2d61505
1233.42,4.0,21,1,4,2,7,0x3b9b1326
23651.09,2.0,20,2,3,2,7,0xb2d6f497
464.48,1.0,12,1,2,3,6,0xb2d3b35ad
3224.22,2.0,0,2,3,4,9,0x3b9af1d4d
319101.94,3.0,0,4,4,4,12,0xb2d3a289d
243.64,1.0,1,1,2,4,7,0xb2d68ad9
550307.41,3.0,4,4,4,4,12,0xb2d6fb84
10197.07,1.0,59,2,2,2,6,0xb2d59e48d
84455.38,1.0,6,3,2,3,8,0xb2d6a39dd
100170.64,2.0,193,3,3,1,7,0xb2d25fc9d
839.09,1.0,0,1,2,4,7,0xb2d6910c
22.41,1.0,6,1,2,3,6,0xb2d69c71
450780.97,3.0,7,4,4,3,11,0xb2d9b817
505329.72,3.0,97,4,4,1,9,0xb2d97044d
700082.97,1.0,4,4,2,4,10,0xb2d8f1b9
371321.08,2.0,21,4,3,2,9,0xb2d31366d
144004.81,3.0,1,3,4,4,11,0xb2d1fd5cd
160.6,1.0,13,1,2,3,6,0xb2d1a325
20000.0,1.0,4,2,2,4,8,0xb2da610f
609885.66,5.0,7,4,4,3,11,0xb2d35b2a
770008.06,8.0,11,4,4,3,11,0xb2d5b26ed
5631.17,1.0,0,2,2,4,8,0xb2d8df6d
100001.85,3.0,179,3,4,1,8,0xb2d2d6db
70.06,1.0,116,1,2,1,4,0xb2d1500ad
281004.6,6.0,12,3,4,3,10,0xb2d636f0d
600672.27,9.0,0,4,4,4,12,0xb2d0e090d
365000.13,4.0,7,4,4,3,11,0xb2d5b365d
354.35,1.0,34,1,2,2,5,0xb2d8e23bd
16075.66,1.0,0,2,2,4,8,0xb2d2fb31
25175.15,2.0,171,2,3,1,6,0xb2d5fa85
466.85,1.0,49,1,2,2,5,0xb2d77415
576534.81,2.0,90,4,3,1,8,0xb2d51dd8d
471465.74,9.0,32,4,4,2,10,0xb2d6e2c6
0.0,1.0,1,1,2,4,7,0xb2d901a3
10017.72,2.0,78,2,3,1,6,0xb2d91247d
1.2,1.0,0,1,2,4,7,0xb2d1bc77d
230002.01,9.0,13,3,4,3,10,0xb2d631fbd
300076.45,5.0,11,3,4,3,10,0xb2d48b5a
388109.32,2.0,41,4,3,2,9,0xb2d6a43dd
300051.48,2.0,0,3,3,4,10,0xb2d9690ed
164316.77,1.0,1,3,2,4,9,0xb2d1fa0a
61.28,1.0,112,1,2,1,4,0xb2d683add
3948.75,1.0,12,2,2,3,7,0xb2d85a6c
10578.06,1.0,92,2,2,1,5,0xb2d231cbd
1020.27,1.0,10,1,2,3,6,0xb2d1dcfa
164844.79,6.0,0,3,4,4,11,0xb2d441dad
2214234.32,7.0,5,4,4,3,11,0xb2d23c3d
12191003.83,5.0,0,4,4,4,12,0xb2d06ac3
139183.1,3.0,35,3,4,2,9,0xb2d52af4d
51933.64,2.0,139,2,3,1,6,0xb2d5389fd
501776.08,2.0,29,4,3,2,9,0xb2d8ff93d
5207.76,4.0,184,2,4,1,7,0x3b9b0e1cd
20078.01,1.0,92,2,2,1,5,0xb2d31f05d
2501.2,1.0,1,1,2,4,7,0xb2d7011f
9574.66,1.0,42,2,2,2,6,0xb2d36934d
594.92,1.0,3,1,2,4,7,0xb2d69395
5061.49,1.0,92,2,2,1,5,0xb2d2aaabd
95.34,1.0,116,1,2,1,4,0xb2d26576d
214850.6,3.0,102,3,4,1,8,0xb2d31669d
561777.62,4.0,3,4,4,4,12,0xb2d6043dd
231559.43,2.0,16,3,3,2,8,0xb2d3a25fd
325688.08,2.0,27,4,3,2,9,0xb2d6b62ad
480000.04,3.0,14,4,4,3,11,0xb2d13700d
890100.61,3.0,7,4,4,3,11,0xb2d1bd8fd
8398.09,1.0,14,2,2,3,7,0xb2d5a99cd
300000.0,2.0,13,3,3,3,9,0xb2da4283
995.6,2.0,9,1,3,3,7,0xb2d32741d
711.13,1.0,22,1,2,2,5,0xb2d2690ed
14373.42,1.0,2,2,2,4,8,0xb2d932fed
64804.51,2.0,48,3,3,2,8,0xb2d6ef23d
105.05,1.0,8,1,2,3,6,0xb2d9ec0a
200000.0,2.0,104,3,3,1,7,0xb2d80269d
90041.21,2.0,101,3,3,1,7,0xb2d518a5d
250001.41,3.0,6,3,4,3,10,0xb2d8cb96d
2405.38,1.0,0,1,2,4,7,0xb2d78775
100082.98,2.0,105,3,3,1,7,0xb2d36d27
202001.87,7.0,3,3,4,4,11,0xb2d16b1fd
22300.17,1.0,208,2,2,1,5,0xb2d3a264d
50042.31,2.0,6,2,3,3,8,0xb2d4f952
1484.42,1.0,22,1,2,2,5,0xb2d343c6
621043.32,12.0,70,4,4,1,9,0xb2d4c931d
162599.34,2.0,80,3,3,1,7,0xb2d53d22
74047.73,4.0,25,3,4,2,9,0xb2d45be3d
4756.96,1.0,0,2,2,4,8,0xb2d68f97
200710.49,2.0,49,3,3,2,8,0xb2d9da38
8.97,1.0,56,1,2,2,5,0xb2d93bc9d
200053.21,3.0,39,3,4,2,9,0xb2d9a60f
350.34,1.0,0,1,2,4,7,0xb2d19f7ad
27.14,1.0,33,1,2,2,5,0xb2d58127
646790.59,5.0,22,4,4,2,10,0xb2d19239d
200000.0,1.0,0,3,2,4,9,0xb2d2d486d
461466.14,4.0,27,4,4,2,10,0xb2d4f761d
72081.22,1.0,0,3,2,4,9,0xb2d54aa2d
133007.69,2.0,99,3,3,1,7,0xb2d35f8fd
3980.25,3.0,158,2,4,1,7,0xb2d2c53bd
0.0,1.0,5,1,2,3,6,0xb2d14396
50006.88,2.0,66,2,3,2,7,0xb2d6be26d
5253.21,1.0,92,2,2,1,5,0xb2d11a16d
5860.87,1.0,4,2,2,4,8,0xb2d98e71
477963.59,4.0,28,4,4,2,10,0xb2d56214
290279.48,2.0,2,3,3,4,10,0xb2d62f70
400177.37,3.0,2,4,4,4,12,0xb2d538e2
945.66,1.0,7,1,2,3,6,0xb2d62dc3
2730.9,1.0,10,1,2,3,6,0xb2d4f937
250475.93,5.0,0,3,4,4,11,0xb2d57e34
590470.68,6.0,14,4,4,3,11,0xb2d14129d
14148.41,1.0,3,2,2,4,8,0xb2d39589d
453376.39,3.0,11,4,4,3,11,0x3b9b3e05d
2820.14,1.0,0,1,2,4,7,0xb2d9389d
51077.66,3.0,55,2,4,2,8,0xb2d19ad3
100004.92,2.0,80,3,3,1,7,0xb2d5a569
42062.56,2.0,12,2,3,3,8,0xb2d19a45d
10015.51,2.0,17,2,3,2,7,0xb2d946f6
3070297.87,2.0,0,4,3,4,11,0xb2d4c93dd
2.28,2.0,18,1,3,2,6,0xb2d0dc9d
650.32,1.0,0,1,2,4,7,0xb2d341cfd
80037.38,2.0,91,3,3,1,7,0xb2d5a826d
1500141.18,4.0,24,4,4,2,10,0xb2d628a9d
1218.9,1.0,0,1,2,4,7,0xb2d67465
100005.28,2.0,27,3,3,2,8,0xb2da08bf
1412238.93,4.0,11,4,4,3,11,0xb2d145cdd
137753.33,1.0,0,3,2,4,9,0xb2d60188d
11075.09,1.0,0,2,2,4,8,0xb2d6b0c4
1407.16,1.0,0,1,2,4,7,0xb2d57c3bd
15044.83,1.0,113,2,2,1,5,0xb2d4238cd
940067.83,6.0,0,4,4,4,12,0xb2d61226d
11118.66,1.0,5,2,2,3,7,0xb2d944f8
1350.46,1.0,187,1,2,1,4,0xb2d28b68d
91314.21,2.0,0,3,3,4,10,0xb2d8256a
58505.9,1.0,40,3,2,2,7,0xb2d43550d
50909.66,1.0,92,2,2,1,5,0xb2d2eedcd
23774.15,1.0,2,2,2,4,8,0xb2d606fcd
9124.26,3.0,1,2,4,4,10,0xb2d06add
523.22,1.0,19,1,2,2,5,0xb2d78831
11.04,2.0,81,1,3,1,5,0xb2d0f867
5.16,1.0,23,1,2,2,5,0xb2d46904
563001.55,29.0,1,4,4,4,12,0xb2d06ac1d
6.25,1.0,71,1,2,1,4,0xb2d54fa0
1729.68,1.0,6,1,2,3,6,0xb2d6b62dd
1600872.67,2.0,9,4,3,3,10,0xb2d7864fd
513838.34,4.0,0,4,4,4,12,0xb2d626ab
470.16,1.0,53,1,2,2,5,0xb2d0fd7cd
61412.36,2.0,10,3,3,3,9,0xb2d3e7b4d
4985.47,1.0,0,2,2,4,8,0xb2d9d9a7
600710.42,4.0,2,4,4,4,12,0xb2d6da28d
3710.78,1.0,0,2,2,4,8,0xb2d94a41d
385539.54,4.0,11,4,4,3,11,0xb2d0f7d3d
515.59,1.0,62,1,2,2,5,0xb2d24c9ed
110177.89,6.0,12,3,4,3,10,0xb2d33b97
60729.53,2.0,5,3,3,3,9,0xb2d12279
6050.76,1.0,92,2,2,1,5,0xb2d4118bd
560084.63,11.0,11,4,4,3,11,0xb2d17691d
3053.65,1.0,12,2,2,3,7,0xb2d6e51ad
505142.99,2.0,7,4,3,3,10,0xb2d63494d
631476.05,5.0,41,4,4,2,10,0xb2d1b058d
10000.32,2.0,60,2,3,2,7,0xb2d9b8fa
28280.5,1.0,3,2,2,4,8,0xb2d1cf6bd
357295.44,9.0,14,4,4,3,11,0xb2d6e23b
400000.02,2.0,12,4,3,3,10,0xb2d8e392
1950020.58,2.0,39,4,3,2,9,0xb2d9f239
275859.18,2.0,133,3,3,1,7,0xb2d83c7ed
10751.14,2.0,0,2,3,4,9,0x3b9b257dd
1300039.74,2.0,0,4,3,4,11,0xb2d6f298d
170.93,2.0,67,1,3,1,5,0xb2d07e37
885443.05,3.0,1,4,4,4,12,0xb2d220bf
1500.62,5.0,92,1,4,1,6,0x3b9b115cd
300000.0,2.0,8,3,3,3,9,0xb2da1499
2250.64,1.0,92,1,2,1,4,0xb2d2c193d
1840.69,1.0,3,1,2,4,7,0xb2d973a2
10487.74,2.0,1,2,3,4,9,0xb2d91628d
184005.1,9.0,1,3,4,4,11,0xb2d1d267
113.47,8.0,8,1,4,3,8,0xb2d21060d
38279.97,2.0,4,2,3,4,9,0xb2d6fe36d
1110.99,2.0,296,1,3,1,5,0xb2d53397
10844.33,1.0,92,2,2,1,5,0x3b9ae037d
50001.06,2.0,52,2,3,2,7,0xb2d90abe
300010.01,1.0,2,3,2,4,9,0xb2d8d72ad
1870.53,3.0,182,1,4,1,6,0x3b9b498bd
560011.42,13.0,55,4,4,2,10,0xb2d082cc
220000.0,2.0,12,3,3,3,9,0xb2da48a7
2197.59,1.0,40,1,2,2,5,0xb2d3eb41d
1082.2,2.0,92,1,3,1,5,0x3b9b3aaed
807625.32,5.0,24,4,4,2,10,0xb2d62245
204571.39,1.0,18,3,2,2,7,0xb2d61c3b
149016.79,3.0,60,3,4,2,9,0xb2d21a29
1447.6,1.0,111,1,2,1,4,0xb2d2f063
5081.96,1.0,102,2,2,1,5,0xb2d7c572d
486043.05,3.0,19,4,4,2,10,0xb2d57a5f
410000.35,2.0,24,4,3,2,9,0xb2d90119d
242454.24,8.0,11,3,4,3,10,0xb2d4d837d
36099.75,9.0,0,2,4,4,10,0xb2d109eed
20549.15,4.0,8,2,4,3,9,0xb2d1977bd
300076.19,2.0,74,3,3,1,7,0xb2d11035d
6184.61,1.0,4,2,2,4,8,0xb2d2ebd7
24078.42,1.0,12,2,2,3,7,0xb2d71842d
570715.17,4.0,21,4,4,2,10,0xb2d2ecc8d
3107407.59,4.0,8,4,4,3,11,0xb2d6d274d
1532000.0,3.0,9,4,4,3,11,0xb2d5d829d
0.0,1.0,1,1,2,4,7,0xb2d408c1d
210001.75,7.0,19,3,4,2,9,0xb2d55f64d
456439.63,4.0,8,4,4,3,11,0xb2d718e4d
6347.48,1.0,10,2,2,3,7,0xb2d3ac6bd
6635.21,1.0,3,2,2,4,8,0xb2d8d5fcd
713032.57,3.0,58,4,4,2,10,0xb2d5c1f4
20238.52,2.0,139,2,3,1,6,0xb2d5f5b9d
73343.88,2.0,116,3,3,1,7,0xb2d5be86
723817.09,5.0,58,4,4,2,10,0xb2d24f9bd
14446.92,1.0,0,2,2,4,8,0xb2d2bd9ed
5869.18,1.0,17,2,2,2,6,0xb2d2dd93
750000.66,3.0,25,4,4,2,10,0xb2d9c613
1050000.21,2.0,1,4,3,4,11,0xb2d5ada2d
1092.43,1.0,9,1,2,3,6,0xb2d67e48
765453.95,5.0,193,4,4,1,9,0x3b9b3b77d
62058.4,1.0,3,3,2,4,9,0xb2d16d60
104604.24,2.0,235,3,3,1,7,0xb2d48b54d
4944.73,7.0,42,2,4,2,8,0x3b9ad271d
810872.31,6.0,33,4,4,2,10,0x3b9b437dd
91671.57,2.0,8,3,3,3,9,0xb2d4de83d
30001.44,2.0,101,2,3,1,6,0xb2d5d25fd
877.59,1.0,3,1,2,4,7,0xb2d529f9d
274152.67,3.0,0,3,4,4,11,0xb2d591b4d
40001.27,2.0,92,2,3,1,6,0xb2d97c80d
371551.39,5.0,0,4,4,4,12,0x3b9b2a54d
750710.97,10.0,40,4,4,2,10,0xb2d4b5f9d
154484.0,4.0,0,3,4,4,11,0xb2d1b4c7
494.24,1.0,69,1,2,1,4,0xb2d6214dd
167888.25,4.0,0,3,4,4,11,0xb2d36d21
0.0,1.0,3,1,2,4,7,0xb2d1dd62
493.19,1.0,10,1,2,3,6,0xb2d4d1a8d
881829.61,4.0,18,4,4,2,10,0xb2d064b6d
15372.83,1.0,1,2,2,4,8,0xb2d3829dd
500653.32,2.0,0,4,3,4,11,0xb2d13d15d
204401.1,4.0,0,3,4,4,11,0xb2d0ad9ad
23571.15,1.0,25,2,2,2,6,0xb2d8ee61d
136895.49,2.0,214,3,3,1,7,0xb2d147b1d
3.22,1.0,35,1,2,2,5,0xb2d1d1cb
294428.3,4.0,0,3,4,4,11,0x3b9af25ed
9402.33,1.0,9,2,2,3,7,0xb2d3668cd
602003.0,2.0,1,4,3,4,11,0xb2da6809
723799.37,2.0,102,4,3,1,8,0xb2d1f89dd
200000.0,2.0,1,3,3,4,10,0xb2da5d66
700010.24,4.0,4,4,4,4,12,0xb2d8e34ad
690.31,1.0,24,1,2,2,5,0xb2d970fed
0.54,1.0,71,1,2,1,4,0xb2d63ee7d
170007.18,2.0,56,3,3,2,8,0xb2d9c247
0.82,1.0,1,1,2,4,7,0xb2d99671
303038.9,2.0,54,4,3,2,9,0xb2d22a70d
3884.78,1.0,3,2,2,4,8,0xb2d537d3d
10000.11,2.0,28,2,3,2,7,0xb2da0caa
5395.72,1.0,3,2,2,4,8,0xb2d227d9d
2084.22,1.0,184,1,2,1,4,0xb2d3e843d
200000.0,2.0,27,3,3,2,8,0xb2d946c1d
2566.53,1.0,2,1,2,4,7,0xb2d0f63a
100026.72,3.0,59,3,4,2,9,0xb2d1b3d2d
1553.33,1.0,3,1,2,4,7,0xb2d6c3d5
200031.29,2.0,0,3,3,4,10,0xb2d81d75d
89453.25,1.0,2,3,2,4,9,0xb2d2f9c3
1404107.28,3.0,60,4,4,2,10,0xb2d0ad03
200001.26,3.0,7,3,4,3,10,0xb2d9742ad
89506.81,2.0,24,3,3,2,8,0xb2d396fa
405686.57,2.0,140,4,3,1,8,0xb2d6e845
450006.78,3.0,4,4,4,4,12,0xb2d6c003d
220107.63,4.0,60,3,4,2,9,0xb2d510b2
3.19,1.0,7,1,2,3,6,0xb2d5714a
66014.17,1.0,5,3,2,3,8,0xb2d6836ad
50000.0,1.0,1,2,2,4,8,0xb2da6655
100017.29,2.0,42,3,3,2,8,0xb2d3be06d
243.26,1.0,10,1,2,3,6,0xb2d6aece
31142.93,2.0,73,2,3,1,6,0xb2d36e6d
1.05,1.0,62,1,2,2,5,0xb2d2056a
220025.18,2.0,6,3,3,3,9,0xb2d2314e
160576.5,2.0,32,3,3,2,8,0xb2d5f028d
701608.45,3.0,11,4,4,3,11,0xb2d9c920
1926.01,1.0,147,1,2,1,4,0xb2d8909bd
355.22,1.0,5,1,2,3,6,0xb2d6288a
1951.7,1.0,1,1,2,4,7,0xb2d32dcfd
7312.81,1.0,6,2,2,3,7,0xb2d2a91a
20062.71,2.0,137,2,3,1,6,0xb2d68d2b
2132.17,1.0,184,1,2,1,4,0xb2d34187d
1556.51,3.0,12,1,4,3,8,0xb2d16bb7d
10000.53,1.0,15,2,2,3,7,0xb2da3794
156878.38,5.0,0,3,4,4,11,0x3b9af269d
778740.66,7.0,6,4,4,3,11,0xb2d689a4d
503000.0,5.0,0,4,4,4,12,0xb2d62136
87278.55,2.0,0,3,3,4,10,0xb2d4a31dd
4012.06,1.0,46,2,2,2,6,0xb2d3c748d
200008.46,2.0,92,3,3,1,7,0xb2d66736
1281.45,1.0,92,1,2,1,4,0xb2d38a6fd
100000.05,3.0,68,3,4,1,8,0xb2d94eb9d
355049.23,2.0,4,4,3,4,11,0xb2d20780
4166.42,2.0,15,2,3,3,8,0xb2d09cd9
9563.3,1.0,3,2,2,4,8,0xb2d7872f
360034.37,3.0,92,4,4,1,9,0xb2d4f736d
30151.81,1.0,92,2,2,1,5,0xb2d234f0
600000.16,4.0,5,4,4,3,11,0xb2d60296d
155062.67,2.0,144,3,3,1,7,0xb2d28fb9d
13963.17,1.0,13,2,2,3,7,0xb2d438bd
400128.14,2.0,39,4,3,2,9,0xb2d1ed0c
11247.79,1.0,0,2,2,4,8,0xb2d94a50
200000.0,2.0,12,3,3,3,9,0xb2da3b61
80000.95,4.0,83,3,4,1,8,0xb2d979dfd
394787.73,5.0,34,4,4,2,10,0xb2d0bb13
135036.81,1.0,2,3,2,4,9,0xb2d68180d
10199.3,1.0,280,2,2,1,5,0xb2d5e941d
162787.97,1.0,47,3,2,2,7,0xb2d5a3c6d
41.71,1.0,24,1,2,2,5,0xb2d6a8a3
282936.95,3.0,139,3,4,1,8,0xb2d3a963d
2005.66,1.0,183,1,2,1,4,0xb2d22a8d
2026.06,1.0,184,1,2,1,4,0xb2d11039d
8063.52,1.0,92,2,2,1,5,0xb2d110ecd
558352.05,3.0,82,4,4,1,9,0xb2d8f576d
1881.93,1.0,184,1,2,1,4,0xb2d3c1eb
70000.74,2.0,49,3,3,2,8,0xb2d9d5c2
212032.2,2.0,26,3,3,2,8,0xb2d42250
674.73,1.0,0,1,2,4,7,0xb2d906ae
1104.29,1.0,24,1,2,2,5,0xb2d2e15d
188717.98,4.0,2,3,4,4,11,0xb2d3963ed
1322253.14,2.0,11,4,3,3,10,0xb2d3b953d
84141.32,2.0,4,3,3,4,10,0xb2d2054bd
1190.02,1.0,0,1,2,4,7,0xb2d32c21
4043.89,1.0,11,2,2,3,7,0xb2d8f69c
76.62,1.0,2,1,2,4,7,0xb2d62be6
50470.2,2.0,193,2,3,1,6,0xb2d5f680d
442252.51,4.0,0,4,4,4,12,0xb2d0d67e
1170072.25,7.0,2,4,4,4,12,0xb2d6a19fd
70496.42,3.0,0,3,4,4,11,0xb2d16895d
50635.41,2.0,24,2,3,2,7,0xb2d298b6d
215994.97,2.0,5,3,3,3,9,0xb2d14910d
4009.82,1.0,13,2,2,3,7,0xb2d36900d
2307.78,1.0,6,1,2,3,6,0xb2d96ae8
100009.18,4.0,12,3,4,3,10,0xb2d990eb
3808.07,1.0,3,2,2,4,8,0xb2d93e64
14.57,1.0,32,1,2,2,5,0xb2d6357ed
81.7,1.0,18,1,2,2,5,0xb2d9184b
15596.1,1.0,92,2,2,1,5,0xb2d2bf55d
1346.17,2.0,184,1,3,1,5,0xb2d0793fd
105881.86,1.0,47,3,2,2,7,0xb2d6ad57d
2439000.0,100.0,9,4,4,3,11,0xb2d16921d
6190.48,1.0,36,2,2,2,6,0xb2d2478ed
1305.8,1.0,0,1,2,4,7,0xb2d16ecf
501776.08,2.0,42,4,3,2,9,0xb2d921ced
850144.55,3.0,39,4,4,2,10,0xb2d6faf2d
30002.37,2.0,73,2,3,1,6,0xb2d7a7dbd
30044.56,1.0,64,2,2,2,6,0xb2d18550
2846.94,1.0,2,1,2,4,7,0xb2d510c6d
2100052.27,2.0,48,4,3,2,9,0xb2d38333d
55213.9,1.0,138,3,2,1,6,0xb2d317a3d
325845.65,4.0,1,4,4,4,12,0xb2d3f504d
4785.92,1.0,0,2,2,4,8,0xb2d28617d
300001.0,2.0,8,3,3,3,9,0xb2da01a4
5160.05,1.0,1,2,2,4,8,0xb2d55d2ad
266.49,2.0,7,1,3,3,7,0xb2d52b31
0.0,1.0,1,1,2,4,7,0xb2d936e9
5559.77,1.0,0,2,2,4,8,0xb2d4cb7f
1100031.57,3.0,1,4,4,4,12,0xb2d10b52
430810.98,32.0,27,4,4,2,10,0xb2d0e277d
50002.57,2.0,97,2,3,1,6,0xb2d47de4d
10.65,1.0,184,1,2,1,4,0xb2d2fbbed
478094.3,4.0,21,4,4,2,10,0xb2d4ee0dd
18944.06,1.0,14,2,2,3,7,0xb2d137b6
88.92,1.0,175,1,2,1,4,0xb2d272cbd
292081.72,2.0,0,3,3,4,10,0xb2d0d6eed
1014.51,1.0,92,1,2,1,4,0xb2d105c1d
60041.7,1.0,4,3,2,4,9,0xb2d39ee4d
404313.92,3.0,8,4,4,3,11,0xb2d10b3fd
75078.07,1.0,2,3,2,4,9,0xb2d0d838d
1182695.28,39.0,0,4,4,4,12,0xb2d56d6cd
152035.25,5.0,1,3,4,4,11,0xb2d210f1d
52810.18,1.0,116,3,2,1,6,0xb2d3a9dbd
50002.87,2.0,10,2,3,3,8,0xb2d25861
10.13,1.0,42,1,2,2,5,0xb2d3957a
36599.67,1.0,9,2,2,3,7,0xb2d2e8cad
30057.86,1.0,17,2,2,2,6,0xb2d32a0dd
4.95,1.0,40,1,2,2,5,0xb2d632ec
536819.25,2.0,2,4,3,4,11,0xb2d60cc3d
502106.55,2.0,32,4,3,2,9,0xb2d9237bd
10255.97,2.0,90,2,3,1,6,0xb2d57afbd
61703.33,1.0,19,3,2,2,7,0xb2d6b1cfd
160979.21,4.0,27,3,4,2,9,0xb2d0ab96d
28050.61,2.0,77,2,3,1,6,0xb2d60f80d
5793.91,1.0,92,2,2,1,5,0xb2d178bfd
50201.92,2.0,165,2,3,1,6,0xb2d8db84d
4101003.54,14.0,0,4,4,4,12,0xb2d59ab8
401226.23,2.0,1,4,3,4,11,0xb2d95710d
6746.65,1.0,0,2,2,4,8,0xb2d25782
370.15,1.0,1,1,2,4,7,0xb2d921d1
135890.24,4.0,19,3,4,2,9,0xb2d3d981
0.0,1.0,0,1,2,4,7,0xb2d52fe2
1717795.02,3.0,63,4,4,2,10,0xb2d0ebbfd
908887.09,4.0,0,4,4,4,12,0xb2d40258d
27.93,1.0,1,1,2,4,7,0xb2d6cca1
2554379.31,5.0,98,4,4,1,9,0xb2d6080fd
10000.11,2.0,14,2,3,3,8,0xb2da3808
1600039.37,2.0,10,4,3,3,10,0xb2d0e7b2d
300251.49,2.0,6,4,3,3,10,0xb2d16001
100328.73,2.0,186,3,3,1,7,0xb2d69c50d
27656.86,1.0,213,2,2,1,5,0xb2d2b173d
9204.47,1.0,184,2,2,1,5,0xb2d0d3e3d
392583.81,3.0,35,4,4,2,10,0xb2d20780d
117561.45,3.0,0,3,4,4,11,0xb2d095bfd
14266.94,1.0,19,2,2,2,6,0xb2d92508
520007.82,6.0,0,4,4,4,12,0xb2da04ed
95.12,1.0,0,1,2,4,7,0xb2d2ad0f
100001.06,3.0,35,3,4,2,9,0xb2d9f388
199.59,1.0,3,1,2,4,7,0xb2d6b3f8
45662.83,3.0,12,2,4,3,9,0xb2d5e0d3d
195005.35,8.0,0,3,4,4,11,0xb2d64c80d
250060.24,3.0,164,3,4,1,8,0xb2d5e8ead
50097.42,2.0,4,2,3,4,9,0xb2d47d8c
460059.41,9.0,6,4,4,3,11,0xb2d4f6ebd
366428.95,3.0,0,4,4,4,12,0xb2d5e5c0d
450004.75,2.0,26,4,3,2,9,0xb2da1101
833.39,1.0,8,1,2,3,6,0xb2d5a929
3620.42,1.0,0,2,2,4,8,0xb2d78fc0d
603009.8,4.0,0,4,4,4,12,0xb2d59544d
5777.33,1.0,2,2,2,4,8,0xb2d0affed
241531.42,5.0,33,3,4,2,9,0xb2d1e761d
900044.34,2.0,76,4,3,1,8,0xb2d2aecad
18.16,1.0,41,1,2,2,5,0xb2d91e50d
402257.14,2.0,140,4,3,1,8,0xb2d13c84
131.37,3.0,20,1,4,2,7,0xb2d1a09ed
481666.2,3.0,1,4,4,4,12,0xb2d77893
539204.59,3.0,28,4,4,2,10,0xb2d07f88d
114844.69,3.0,0,3,4,4,11,0xb2d18dd7d
45.34,1.0,9,1,2,3,6,0xb2d28356
36399.81,1.0,19,2,2,2,6,0xb2d277bcd
15001.65,2.0,179,2,3,1,6,0xb2d5ef66d
490.42,1.0,5,1,2,3,6,0xb2d5dcb6d
1225891.77,14.0,4,4,4,4,12,0xb2d2e585d
1701139.46,6.0,4,4,4,4,12,0xb2d5cb30
33.16,1.0,18,1,2,2,5,0xb2d97635
47664.81,1.0,0,2,2,4,8,0xb2d3326cd
101153.77,2.0,90,3,3,1,7,0xb2d5e1ae
1362.54,1.0,3,1,2,4,7,0xb2d99421
557.63,1.0,9,1,2,3,6,0xb2d51dc4
10000.76,2.0,70,2,3,1,6,0xb2d58ca4
286405.48,3.0,77,3,4,1,8,0xb2d950bdd
2846.44,1.0,184,1,2,1,4,0xb2d1531ed
201622.61,2.0,80,3,3,1,7,0xb2d5873a
32106.18,1.0,92,2,2,1,5,0xb2d2af14d
250058.12,4.0,73,3,4,1,8,0xb2d65956d
3252.81,1.0,92,2,2,1,5,0xb2d244dbd
100032.65,2.0,0,3,3,4,10,0xb2d09d69
2054.0,1.0,299,1,2,1,4,0xb2d41323d
396137.14,3.0,1,4,4,4,12,0xb2d5e409
849714.4,20.0,1,4,4,4,12,0x3b9b1914d
2559.81,1.0,184,1,2,1,4,0xb2d54af3d
1318.41,1.0,17,1,2,2,5,0xb2d50dbbd
1.81,1.0,9,1,2,3,6,0xb2d2f67ed
60068.03,2.0,63,3,3,2,8,0xb2d0f669
51003.04,3.0,11,2,4,3,9,0xb2d649cc
10184.9,2.0,132,2,3,1,6,0xb2d5b6f2d
5054.14,1.0,184,2,2,1,5,0xb2d29fadd
101778.32,2.0,18,3,3,2,8,0xb2d60ee0d
46218.85,1.0,4,2,2,4,8,0xb2d43c50d
91123.33,3.0,0,3,4,4,11,0xb2d5f681d
50620.63,1.0,92,2,2,1,5,0xb2d40246
600001.06,3.0,13,4,4,3,11,0xb2d8dccfd
952504.44,6.0,15,4,4,3,11,0xb2d5dc1fd
854157.09,3.0,64,4,4,2,10,0xb2d4108b
554775.66,2.0,111,4,3,1,8,0xb2d0be6dd
1425.31,3.0,184,1,4,1,6,0x3b9ad77bd
17957.81,1.0,184,2,2,1,5,0xb2d34466d
278.64,1.0,12,1,2,3,6,0xb2d973a9
222026.8,2.0,4,3,3,4,10,0xb2d9c566
359373.62,2.0,76,4,3,1,8,0xb2d58574
200000.0,2.0,102,3,3,1,7,0xb2d81d7bd
503553.0,2.0,19,4,3,2,9,0xb2d8db1fd
1550144.11,5.0,69,4,4,1,9,0xb2d2852fd
5005.59,1.0,116,2,2,1,5,0xb2d94d5bd
6548.62,1.0,15,2,2,3,7,0xb2d9c7b7
1584.0,1.0,3,1,2,4,7,0xb2d33a48d
1.33,1.0,25,1,2,2,5,0xb2d5fd01
40001.27,2.0,59,2,3,2,7,0xb2d8fa58
3627.84,1.0,38,2,2,2,6,0xb2d64879d
577476.59,4.0,87,4,4,1,9,0xb2d119aed
559841.25,2.0,151,4,3,1,8,0xb2d11c1c
98.08,1.0,42,1,2,2,5,0xb2d37c35
9414.6,1.0,11,2,2,3,7,0xb2d14bd9
95.94,1.0,16,1,2,2,5,0xb2d488ac
342382.38,2.0,0,4,3,4,11,0xb2d5d263d
3669.71,1.0,92,2,2,1,5,0xb2d3f62cd
5065.27,1.0,92,2,2,1,5,0xb2d16c20d
20032.9,2.0,57,2,3,2,7,0xb2d57872d
27610208.43,2.0,0,4,3,4,11,0xb2d0bca7d
645420.35,8.0,3,4,4,4,12,0xb2d179f5d
291752.06,3.0,1,3,4,4,11,0xb2d5d226d
90235.22,2.0,0,3,3,4,10,0xb2d24881d
6.43,3.0,26,1,4,2,7,0xb2d11d69
4814235.42,5.0,1,4,4,4,12,0xb2d6db3fd
1192.98,1.0,184,1,2,1,4,0xb2d1f81fd
334357.65,1.0,4,4,2,4,10,0xb2d1d90ed
580079.16,4.0,5,4,4,3,11,0xb2d6c7cfd
10080.19,1.0,92,2,2,1,5,0xb2d2fc63
75227.08,3.0,21,3,4,2,9,0xb2d139afd
244041.54,3.0,116,3,4,1,8,0xb2d23f53d
350005.14,3.0,13,4,4,3,11,0xb2d26e70d
3908.35,1.0,20,2,2,2,6,0xb2d2be20
10280.57,2.0,31,2,3,2,7,0xb2d7bd8bd
10052.39,2.0,38,2,3,2,7,0xb2d8cfcf
720.44,1.0,5,1,2,3,6,0xb2d930c0
220006.46,3.0,25,3,4,2,9,0xb2d5bd0fd
214.5,1.0,54,1,2,2,5,0xb2d6f976
201250.97,2.0,13,3,3,3,9,0xb2d645c0
202068.58,3.0,10,3,4,3,10,0xb2d6584d
2.96,1.0,208,1,2,1,4,0xb2d786e4
150018.75,5.0,0,3,4,4,11,0xb2d5e951d
60789.35,2.0,107,3,3,1,7,0xb2d2f864d
15183.39,1.0,17,2,2,2,6,0xb2d8ebb7d
6267.28,1.0,184,2,2,1,5,0xb2d28745d
15157.61,1.0,18,2,2,2,6,0xb2d42b77
50017.25,2.0,193,2,3,1,6,0xb2d6b2a1d
232547.55,2.0,28,3,3,2,8,0xb2d13a8e
110005.25,3.0,92,3,4,1,8,0xb2d4b876
200006.33,2.0,41,3,3,2,8,0xb2d92149d
2016.25,1.0,87,1,2,1,4,0xb2d882f4d
12.1,1.0,12,1,2,3,6,0xb2d568c3d
21522.2,1.0,10,2,2,3,7,0xb2d8d53f
6000.31,1.0,0,2,2,4,8,0xb2d906b2d
100255.13,1.0,251,3,2,1,6,0xb2d683e7d
200404.31,2.0,14,3,3,3,9,0xb2d8ee8dd
2480.85,1.0,6,1,2,3,6,0xb2d5cf50
10.57,1.0,111,1,2,1,4,0xb2d90b42d
72031.59,1.0,0,3,2,4,9,0xb2d25f28
0.0,1.0,1,1,2,4,7,0xb2d56070
297162.91,4.0,47,3,4,2,9,0xb2d6dcc5d
815.67,1.0,0,1,2,4,7,0xb2d2bffc
8944.46,1.0,92,2,2,1,5,0x3b9b26b9d
500099.02,2.0,26,4,3,2,9,0xb2d9495ed
610.11,1.0,9,1,2,3,6,0xb2d6e2afd
82000.0,3.0,48,3,4,2,9,0xb2d5c031d
39291.75,2.0,184,2,3,1,6,0xb2d094e3
609490.54,4.0,9,4,4,3,11,0xb2d63219
667116.98,12.0,0,4,4,4,12,0xb2d5e84bd
5542.43,1.0,10,2,2,3,7,0xb2d6aa8d
50029.72,1.0,0,2,2,4,8,0xb2d920a6
972792.63,5.0,8,4,4,3,11,0xb2d58584d
250000.11,2.0,20,3,3,2,8,0xb2d6fa30
235087.52,4.0,14,3,4,3,10,0xb2d5df7dd
15.62,1.0,12,1,2,3,6,0xb2d3fef0
700285.01,5.0,4,4,4,4,12,0xb2d0dbacd
294937.39,4.0,7,3,4,3,10,0xb2d4291a
401420.86,2.0,42,4,3,2,9,0xb2d9eb68
11100.85,2.0,70,2,3,1,6,0xb2d62995
71607.28,1.0,19,3,2,2,7,0xb2d11dd8d
2300000.0,4.0,3,4,4,4,12,0xb2d65a71d
292304.82,9.0,4,3,4,4,11,0xb2d0e3f0d
192770.06,5.0,1,3,4,4,11,0xb2d682ddd
81046.27,2.0,19,3,3,2,8,0xb2d59486d
14017.4,1.0,14,2,2,3,7,0xb2d6ecc0d
50373.87,3.0,60,2,4,2,8,0xb2d604efd
1002257.7,4.0,0,4,4,4,12,0xb2d102dfd
142370.4,4.0,15,3,4,3,10,0xb2d16275
1001039.44,2.0,14,4,3,3,10,0xb2d919f4d
2688.51,4.0,48,1,4,2,7,0xb2d6a0ddd
1890.81,1.0,224,1,2,1,4,0xb2d5811ed
5170.89,1.0,0,2,2,4,8,0xb2d0c615
3319.27,1.0,0,2,2,4,8,0xb2d97c75
2.24,1.0,12,1,2,3,6,0xb2d392a1d
118031.52,4.0,108,3,4,1,8,0xb2d59558d
202132.2,2.0,112,3,3,1,7,0xb2d78bfdd
1016.2,1.0,184,1,2,1,4,0xb2d105f2d
323122.73,2.0,0,4,3,4,11,0xb2d32fc0d
103603.49,3.0,27,3,4,2,9,0xb2d56ca9
1005.85,1.0,92,1,2,1,4,0xb2d4218cd
729.7,1.0,13,1,2,3,6,0xb2d9118a
1121.29,1.0,92,1,2,1,4,0xb2d1da6fd
20001.9,3.0,19,2,4,2,8,0xb2d2cd3b
100016.91,2.0,185,3,3,1,7,0xb2d23ad5
1013.49,1.0,0,1,2,4,7,0xb2d69ec9
957.54,1.0,82,1,2,1,4,0xb2d187e7d
1100023.71,4.0,0,4,4,4,12,0xb2d63191d
200000.53,2.0,25,3,3,2,8,0xb2d94653d
0.52,1.0,0,1,2,4,7,0xb2d3bf8b
1735.48,2.0,92,1,3,1,5,0x3b9b2638d
1109092.91,11.0,14,4,4,3,11,0xb2d69cf0
113460.92,2.0,63,3,3,2,8,0xb2d2af4ed
50002.11,2.0,147,2,3,1,6,0xb2d900f9d
7299.43,1.0,4,2,2,4,8,0xb2d19429
25001.58,2.0,34,2,3,2,7,0xb2d9f1a5
7020.31,1.0,5,2,2,3,7,0xb2d61ed8
3015776.1,2.0,31,4,3,2,9,0xb2d5e55e
0.0,2.0,29,1,3,2,6,0xb2d5aa8ad
1019.98,1.0,184,1,2,1,4,0xb2d3310bd
250129.95,3.0,93,3,4,1,8,0xb2d410ccd
26444.18,1.0,92,2,2,1,5,0xb2d3befdd
10291.1,1.0,3,2,2,4,8,0xb2d6549cd
2087.46,1.0,10,1,2,3,6,0xb2d8f780
1187.45,1.0,0,1,2,4,7,0xb2d6865bd
5870.95,1.0,21,2,2,2,6,0xb2d46675
10000.11,2.0,130,2,3,1,6,0xb2d5876ad
10997.34,2.0,9,2,3,3,8,0xb2d6f000
517646.99,4.0,2,4,4,4,12,0xb2d421cdd
19288.87,1.0,0,2,2,4,8,0xb2d62d58d
219933.67,6.0,20,3,4,2,9,0xb2d631ecd
605.2,1.0,116,1,2,1,4,0xb2d0b543d
212.2,1.0,23,1,2,2,5,0xb2d63cda
1154.44,2.0,184,1,3,1,5,0x3b9b157cd
500664.12,3.0,6,4,4,3,11,0xb2da1c41
1202.84,1.0,42,1,2,2,5,0xb2d783f9
704346.24,2.0,12,4,3,3,10,0xb2d34cfa
6986.64,2.0,27,2,3,2,7,0xb2d06823d
625434.94,2.0,168,4,3,1,8,0xb2d46299d
200008.98,4.0,55,3,4,2,9,0xb2d989ad
5154.61,1.0,10,2,2,3,7,0xb2d3eb23
1222.05,1.0,7,1,2,3,6,0xb2d6f338
1528.19,1.0,92,1,2,1,4,0xb2d215c3d
2659.62,1.0,184,1,2,1,4,0xb2d1ff96d
45684.51,3.0,12,2,4,3,9,0xb2d5e0cbd
2848.35,1.0,10,1,2,3,6,0xb2d9d165
169739.31,9.0,0,3,4,4,11,0x3b9b0fbc
6.35,1.0,208,1,2,1,4,0xb2d78276d
50002.94,2.0,66,2,3,2,7,0xb2d6ee78
9841.39,1.0,20,2,2,2,6,0xb2d48bf6
292.92,1.0,73,1,2,1,4,0xb2d5acb1
30169.49,1.0,10,2,2,3,7,0xb2d47463d
100915.86,2.0,8,3,3,3,9,0xb2d0f0d9d
728814.08,15.0,2,4,4,4,12,0xb2d18612d
50000.0,1.0,1,2,2,4,8,0xb2d63609
104438.53,2.0,23,3,3,2,8,0xb2d548b2d
364.39,1.0,11,1,2,3,6,0xb2d61e5d
200127.14,2.0,12,3,3,3,9,0xb2d982d9
22716.52,1.0,3,2,2,4,8,0xb2d2ab10
50001.47,4.0,80,2,4,1,7,0xb2d62bff
98410.04,1.0,184,3,2,1,6,0xb2d3620bd
503567.06,2.0,71,4,3,1,8,0xb2d4586bd
9.82,1.0,67,1,2,1,4,0xb2d8d05e
16850.57,1.0,0,2,2,4,8,0xb2d6bf66
118336.23,1.0,203,3,2,1,6,0xb2d445c5
50001.06,2.0,95,2,3,1,6,0xb2d977e3d
135101.23,1.0,1,3,2,4,9,0xb2d0dfd5
3144.07,1.0,205,2,2,1,5,0xb2d4a320
849.56,1.0,5,1,2,3,6,0xb2d96a66
50129.76,2.0,32,2,3,2,7,0xb2d9d57a
52263.47,2.0,143,3,3,1,7,0xb2d41032d
28689.1,1.0,213,2,2,1,5,0xb2d411ab
5964.62,1.0,14,2,2,3,7,0xb2d5fe19
2791.19,1.0,35,1,2,2,5,0xb2d6eb0bd
60353.77,2.0,8,3,3,3,9,0xb2d441bfd
43.64,1.0,73,1,2,1,4,0xb2d50060d
733376.48,4.0,24,4,4,2,10,0xb2d28ce1
3466.8,1.0,92,2,2,1,5,0xb2d41b04d
101.23,1.0,5,1,2,3,6,0xb2d223b5
179375.89,1.0,1,3,2,4,9,0xb2d47a7dd
300051.09,3.0,67,3,4,1,8,0xb2d20261d
1490005.08,7.0,0,4,4,4,12,0xb2d60739d
90000.0,4.0,3,3,4,4,11,0xb2d10f42
430000.0,3.0,7,4,4,3,11,0xb2d92fb5d
23.66,1.0,5,1,2,3,6,0xb2d589d3
139.93,1.0,32,1,2,2,5,0xb2d4977d
200071.67,2.0,6,3,3,3,9,0xb2d24c86d
93326.37,2.0,1,3,3,4,10,0xb2d5e70dd
160015.57,3.0,10,3,4,3,10,0xb2d58064d
903277.61,7.0,67,4,4,1,9,0xb2d0ffd9d
400713.14,3.0,14,4,4,3,11,0xb2d8decbd
1528.47,1.0,8,1,2,3,6,0xb2d9037fd
21096.59,3.0,0,2,4,4,10,0xb2d1f988
47003.12,2.0,18,2,3,2,7,0xb2d9c422
10000.55,2.0,105,2,3,1,6,0xb2d62fefd
900006.64,4.0,4,4,4,4,12,0xb2d34ffcd
302143.28,3.0,34,4,4,2,10,0xb2d88c69
13077.89,1.0,92,2,2,1,5,0xb2d289ced
5.72,2.0,89,1,3,1,5,0xb2d07e7f
4107.63,1.0,92,2,2,1,5,0xb2d35d66d
12983.45,1.0,10,2,2,3,7,0xb2d589bdd
203005.04,2.0,58,3,3,2,8,0xb2d5b0ed
314147.87,13.0,7,4,4,3,11,0xb2d0b39cd
1028.76,1.0,184,1,2,1,4,0xb2d40607d
911579.37,4.0,52,4,4,2,10,0xb2d3808fd
103334.1,3.0,4,3,4,4,11,0xb2d55ed1d
28782.25,1.0,16,2,2,2,6,0xb2d28d32d
15764.1,1.0,15,2,2,3,7,0xb2d4f994
1071.97,1.0,67,1,2,1,4,0xb2d5e8fdd
101241.49,2.0,31,3,3,2,8,0xb2d44a58d
1731.77,1.0,9,1,2,3,6,0xb2d3ba58d
539.9,1.0,11,1,2,3,6,0xb2d5b1f1
20167.82,1.0,92,2,2,1,5,0xb2d2cf25d
623241.37,5.0,0,4,4,4,12,0xb2d2d506
300048.0,2.0,0,3,3,4,10,0xb2d9845dd
4673331.04,4.0,10,4,4,3,11,0xb2d38d64d
205689.41,2.0,126,3,3,1,7,0xb2d6dc0dd
855588.9,5.0,3,4,4,4,12,0xb2d4b198d
550023.07,7.0,8,4,4,3,11,0xb2d1067ed
335001.82,3.0,17,4,4,2,10,0xb2d5d3fbd
2000671.87,5.0,13,4,4,3,11,0xb2d62f58d
4465.4,1.0,184,2,2,1,5,0xb2d43856d
260058.11,2.0,101,3,3,1,7,0xb2d587f5
1250003.19,6.0,11,4,4,3,11,0xb2d78bffd
2.22,1.0,6,1,2,3,6,0xb2d95ecc
1896007.39,11.0,0,4,4,4,12,0xb2d3eb74d
2450.97,1.0,0,1,2,4,7,0xb2d9acc6
15327.53,1.0,184,2,2,1,5,0xb2d30448d
1171231.44,4.0,23,4,4,2,10,0xb2d1c30dd
538272.52,4.0,13,4,4,3,11,0xb2d23ee2
7786.32,1.0,5,2,2,3,7,0xb2d568f8
121305.96,2.0,139,3,3,1,7,0xb2d0c126d
200710.42,2.0,39,3,3,2,8,0xb2d9f65e
110022.34,4.0,1,3,4,4,11,0x3b9b430d
20.06,1.0,48,1,2,2,5,0xb2d99dc3
604045.84,3.0,3,4,4,4,12,0xb2d14333d
20420.84,1.0,184,2,2,1,5,0xb2d54715d
16066.9,1.0,15,2,2,3,7,0xb2d95a42
100378.65,2.0,2,3,3,4,10,0xb2d19741d
319139.32,3.0,4,4,4,4,12,0xb2d5038fd
26574.6,1.0,20,2,2,2,6,0xb2d60aded
5392.24,1.0,214,2,2,1,5,0xb2d607f5d
188915.42,3.0,125,3,4,1,8,0xb2d36387d
714002.34,15.0,19,4,4,2,10,0x3b9b47ed
1346.85,1.0,1,1,2,4,7,0xb2d90d0f
3611.94,1.0,10,2,2,3,7,0xb2d97d19
4068.89,1.0,5,2,2,3,7,0xb2d3d56c
902.06,1.0,184,1,2,1,4,0xb2d1b577d
200735.89,3.0,0,3,4,4,11,0xb2d245c0
508034.96,3.0,5,4,4,3,11,0xb2d2620bd
270011.41,2.0,182,3,3,1,7,0xb2d7b196d
1252954.28,10.0,10,4,4,3,11,0xb2d588f5
60000.0,1.0,9,3,2,3,8,0xb2d6a9c6d
20562.59,1.0,20,2,2,2,6,0xb2d625cc
2506.7,1.0,125,1,2,1,4,0xb2d21633d
1193.37,1.0,8,1,2,3,6,0xb2d32d80d
2436.5,1.0,0,1,2,4,7,0xb2d8d5f5
257.97,1.0,3,1,2,4,7,0xb2d6b46bd
503335.24,2.0,6,4,3,3,10,0xb2d92ba1d
277.15,1.0,43,1,2,2,5,0xb2d6d5e1d
2990.83,1.0,14,2,2,3,7,0xb2d8d2b8
592512.39,2.0,0,4,3,4,11,0xb2d68b2ad
77933.41,1.0,0,3,2,4,9,0xb2d2b151d
83.95,1.0,9,1,2,3,6,0xb2d4d3ff
1100000.0,13.0,1,4,4,4,12,0xb2d22001
150004.89,2.0,66,3,3,2,8,0xb2d507e1d
2000057.78,2.0,25,4,3,2,9,0xb2d5bfebd
11204.13,1.0,184,2,2,1,5,0xb2d2daefd
5249.99,1.0,1,2,2,4,8,0xb2d51ebad
300015.96,2.0,53,3,3,2,8,0xb2d9463bd
9949.55,1.0,0,2,2,4,8,0x3b9b2d76
500006.04,2.0,8,4,3,3,10,0xb2d92bf4
260000.0,1.0,2,3,2,4,9,0xb2da5972
442000.19,14.0,0,4,4,4,12,0xb2d19f50
564747.8,7.0,4,4,4,4,12,0xb2d19ea9d
40083.47,2.0,120,2,3,1,6,0xb2d5d66cd
856929.3,14.0,1,4,4,4,12,0xb2d22f7a
80010.93,4.0,11,3,4,3,10,0xb2d92d5f
255003.98,3.0,3,3,4,4,11,0xb2d10f1cd
1633.71,3.0,184,1,4,1,6,0xb2d0933bd
109.57,2.0,0,1,3,4,8,0xb2d40579
50062.86,2.0,105,2,3,1,6,0xb2d3a6e0
258.11,1.0,39,1,2,2,5,0xb2d6556dd
422133.4,3.0,0,4,4,4,12,0xb2d5a563d
11217.65,1.0,7,2,2,3,7,0xb2d3a128
120164.0,8.0,4,3,4,4,11,0xb2d9a1e6
50000.53,2.0,20,2,3,2,7,0xb2d950a1d
266022.83,6.0,20,3,4,2,9,0xb2d5bd07d
3700564.71,4.0,10,4,4,3,11,0xb2d6470dd
20201.68,1.0,92,2,2,1,5,0xb2d28839d
827.52,1.0,3,1,2,4,7,0xb2d30b65
1358.29,1.0,218,1,2,1,4,0xb2d6eb21d
230284.49,5.0,85,3,4,1,8,0xb2d29211d
85.76,2.0,42,1,3,2,6,0xb2d8fe01
100002.65,3.0,192,3,4,1,8,0xb2d68636d
101229.9,2.0,118,3,3,1,7,0xb2d6b209d
3356869.17,5.0,0,4,4,4,12,0xb2d626e1d
10959.83,1.0,92,2,2,1,5,0x3b9b2436d
4002.27,1.0,19,2,2,2,6,0xb2d6b71cd
255515.15,3.0,94,3,4,1,8,0x3b9b38b1d
415710.69,4.0,3,4,4,4,12,0xb2d654d9d
173586.0,2.0,11,3,3,3,9,0xb2d1af21d
51.43,1.0,63,1,2,2,5,0xb2d61620
831517.26,6.0,17,4,4,2,10,0xb2d0693a
1008.68,1.0,184,1,2,1,4,0xb2d62a3fd
153001.62,2.0,98,3,3,1,7,0xb2d970d3d
30011.91,2.0,140,2,3,1,6,0xb2d6108fd
1545.51,1.0,1,1,2,4,7,0xb2d3ec71
71.54,1.0,3,1,2,4,7,0xb2d5dc7fd
120008.75,2.0,228,3,3,1,7,0xb2d1d646d
260000.0,2.0,1,3,3,4,10,0xb2d93baf
11116.17,1.0,184,2,2,1,5,0xb2d2cb52d
18862.29,3.0,0,2,4,4,10,0x3b9b1a18d
100080.67,2.0,111,3,3,1,7,0xb2d1bdd0d
220053.81,2.0,0,3,3,4,10,0xb2d10e77d
698467.57,4.0,26,4,4,2,10,0xb2d0fb33
333000.45,5.0,19,4,4,2,10,0xb2d91c70d
185006.23,4.0,4,3,4,4,11,0xb2d9d2ff
4295.78,1.0,46,2,2,2,6,0xb2d278a5d
307146.15,2.0,31,4,3,2,9,0xb2d5a173d
212782.19,2.0,92,3,3,1,7,0xb2d4a34bd
30000.11,3.0,4,2,4,4,10,0xb2da4b43
50002.08,2.0,95,2,3,1,6,0xb2d972bb
1129.13,1.0,92,1,2,1,4,0xb2d22745d
3106.18,1.0,95,2,2,1,5,0xb2d5d6ded
239011.63,8.0,16,3,4,2,9,0xb2d191fdd
90795.45,4.0,3,3,4,4,11,0xb2d5bcf0d
230604.34,7.0,0,3,4,4,11,0xb2d626e7d
1034.17,1.0,184,1,2,1,4,0xb2d36d28d
100003.17,3.0,59,3,4,2,9,0xb2d8f9d8d
0.11,1.0,13,1,2,3,6,0xb2d95d8cd
3027.52,1.0,2,2,2,4,8,0xb2d3ea31
30327.63,2.0,92,2,3,1,6,0xb2d638ff
12071.77,1.0,48,2,2,2,6,0xb2d4f943d
445014.1,5.0,27,4,4,2,10,0xb2d9e732
419912.91,3.0,3,4,4,4,12,0xb2d3a550d
555281.22,6.0,22,4,4,2,10,0xb2d11b13d
284.81,1.0,9,1,2,3,6,0xb2d535f1
700375.72,2.0,0,4,3,4,11,0xb2d55710d
10095.02,1.0,184,2,2,1,5,0xb2d2a55cd
400107.99,2.0,66,4,3,2,9,0xb2d5c711d
531497.02,3.0,21,4,4,2,10,0xb2d6fb95d
1074043.46,9.0,26,4,4,2,10,0xb2d1c677
600711.39,2.0,6,4,3,3,10,0xb2d30e62d
10000.32,2.0,221,2,3,1,6,0xb2d6e63a
28398.69,2.0,28,2,3,2,7,0xb2d74507d
300036.95,3.0,13,3,4,3,10,0xb2d1fbcb
5924.12,1.0,92,2,2,1,5,0xb2d3f2ded
47068.39,1.0,9,2,2,3,7,0xb2d249ee
20302.3,2.0,40,2,3,2,7,0xb2d5b3e5d
100008.48,3.0,63,3,4,2,9,0xb2d14c65
641.79,1.0,56,1,2,2,5,0xb2d317f7
3666.39,1.0,4,2,2,4,8,0xb2d52a1ed
1.0,1.0,13,1,2,3,6,0xb2d3ab57d
3248.12,2.0,4,2,3,4,9,0xb2d1bf1f
10293.12,2.0,3,2,3,4,9,0xb2d07928d
520812.38,8.0,18,4,4,2,10,0xb2d0edd9d
902225.07,3.0,32,4,4,2,10,0xb2d258d0
10019.38,1.0,52,2,2,2,6,0xb2d9a2ee
3.8,1.0,3,1,2,4,7,0xb2d94d40
200000.0,3.0,22,3,4,2,9,0xb2da229d
500001.1,3.0,1,4,4,4,12,0xb2d8fa70d
10.41,1.0,15,1,2,3,6,0xb2d6c453
1397.95,1.0,0,1,2,4,7,0xb2d92bc8
18128.83,1.0,252,2,2,1,5,0xb2d2ec6bd
1915.55,1.0,92,1,2,1,4,0xb2d38a8bd
120003.8,2.0,95,3,3,1,7,0xb2d97210d
50099.29,2.0,14,2,3,3,8,0xb2d53cdbd
364.27,1.0,9,1,2,3,6,0xb2d3417f
23602.08,2.0,92,2,3,1,6,0xb2d67c69d
3392986.18,6.0,200,4,4,1,9,0xb2d16fe8d
480002.16,6.0,0,4,4,4,12,0xb2d17911d
1.9,1.0,2,1,2,4,7,0xb2d91f03d
455000.0,2.0,25,4,3,2,9,0xb2da1abe
42001.96,3.0,13,2,4,3,9,0xb2d24e45d
4000.63,1.0,24,2,2,2,6,0xb2d946e8d
10051.71,2.0,87,2,3,1,6,0xb2d5dab4
100000.0,1.0,1,3,2,4,9,0xb2da67cc
1740009.23,8.0,1,4,4,4,12,0xb2d0b6c4d
400313.16,3.0,0,4,4,4,12,0xb2d30f63d
120000.0,2.0,0,3,3,4,10,0xb2d98137d
60680.1,1.0,1,3,2,4,9,0xb2d97131
1292.95,1.0,92,1,2,1,4,0xb2d0c3d2d
287.03,1.0,38,1,2,2,5,0xb2d55b1dd
678461.22,3.0,9,4,4,3,11,0xb2d5759e
9379.8,1.0,0,2,2,4,8,0xb2d1479ed
2130081.97,5.0,3,4,4,4,12,0xb2d58a76
604285.51,2.0,9,4,3,3,10,0xb2d57cc0d
50972.17,2.0,55,2,3,2,7,0xb2d45ef1d
12588.21,1.0,184,2,2,1,5,0xb2d287a5d
100033.58,2.0,143,3,3,1,7,0xb2d1164cd
1824.87,1.0,10,1,2,3,6,0xb2d790fc
31496.09,1.0,21,2,2,2,6,0xb2d28e92d
218021.37,3.0,0,3,4,4,11,0xb2d596f5
1071.78,1.0,92,1,2,1,4,0xb2d36bbdd
229852.44,2.0,30,3,3,2,8,0xb2d60259d
1601.11,1.0,0,1,2,4,7,0xb2d6eaddd
23.84,1.0,174,1,2,1,4,0xb2d2f1bad
200006.33,2.0,80,3,3,1,7,0xb2d8d3dfd
1988.38,1.0,184,1,2,1,4,0xb2d3abe5
323723.91,2.0,42,4,3,2,9,0xb2d261d6d
4557.24,1.0,208,2,2,1,5,0xb2d393a8d
100002.11,2.0,32,3,3,2,8,0xb2da0157
24990.67,1.0,0,2,2,4,8,0xb2d6b975
485975.94,2.0,0,4,3,4,11,0xb2d0da4fd
350001.58,4.0,95,4,4,1,9,0xb2d97354d
4.43,1.0,67,1,2,1,4,0xb2d94d65
131.86,2.0,55,1,3,2,6,0xb2d8edd6
2538.54,1.0,2,1,2,4,7,0xb2d68409d
4736.22,1.0,23,2,2,2,6,0xb2d5a93ad
15739.01,1.0,5,2,2,3,7,0xb2d67b9dd
80917.31,2.0,59,3,3,2,8,0xb2d378b0
0.0,3.0,7,1,4,3,8,0xb2d0b253
50008.13,1.0,25,2,2,2,6,0xb2d9ec5a
94201.06,6.0,5,3,4,3,10,0xb2d56ad9d
1336.97,1.0,184,1,2,1,4,0xb2d2bdb2
195.79,1.0,19,1,2,2,5,0xb2d4b2c4d
590.85,1.0,53,1,2,2,5,0xb2d4d98b
380000.0,2.0,12,4,3,3,10,0xb2d8dacbd
232.93,1.0,15,1,2,3,6,0xb2d23bedd
617055.05,4.0,42,4,4,2,10,0xb2d91246d
2286768.44,7.0,0,4,4,4,12,0xb2d6095cd
1423.87,1.0,0,1,2,4,7,0xb2d138f8
41.49,1.0,0,1,2,4,7,0xb2d9d6a5
8862.0,1.0,11,2,2,3,7,0xb2d8eabf
19742.49,1.0,10,2,2,3,7,0xb2d6b7d1d
115618.8,5.0,32,3,4,2,9,0xb2d55434d
1000005.51,3.0,21,4,4,2,10,0xb2d9860e
646031.94,5.0,4,4,4,4,12,0xb2d3d59dd
5752.19,1.0,184,2,2,1,5,0xb2d196c4d
107.71,1.0,70,1,2,1,4,0xb2d5f603
48028.56,2.0,39,2,3,2,7,0xb2d604f9
12369.33,1.0,10,2,2,3,7,0xb2d3f243d
3002608.35,3.0,18,4,4,2,10,0xb2d57ad8d
470004.96,2.0,20,4,3,2,9,0xb2d94a55d
829.11,1.0,2,1,2,4,7,0xb2d56b27
143133.32,6.0,3,3,4,4,11,0xb2d32869d
1050029.59,4.0,10,4,4,3,11,0xb2d6335a
203282.61,2.0,228,3,3,1,7,0xb2d412d4
127.01,1.0,4,1,2,4,7,0xb2d78bb3
201421.03,2.0,36,3,3,2,8,0xb2d8f564
200051.16,3.0,25,3,4,2,9,0xb2d3e44cd
284569.02,1.0,56,3,2,2,7,0xb2d37101
187115.87,3.0,42,3,4,2,9,0xb2d60a5fd
50000.53,3.0,80,2,4,1,7,0xb2d64776d
532210.12,8.0,13,4,4,3,11,0xb2d09db1
1310.49,2.0,170,1,3,1,5,0xb2d6a646d
736985.35,6.0,0,4,4,4,12,0xb2d109ffd
1785.77,1.0,0,1,2,4,7,0xb2d6af8fd
960054.57,6.0,0,4,4,4,12,0xb2d28967d
12781.8,1.0,0,2,2,4,8,0xb2d0e7cbd
20988.15,1.0,64,2,2,2,6,0xb2d230b1d
362004.06,7.0,31,4,4,2,10,0xb2d5c4d1d
4583.71,1.0,5,2,2,3,7,0xb2d8c8fc
8469.67,1.0,19,2,2,2,6,0xb2d9f676
207015.17,2.0,136,3,3,1,7,0xb2d56e61d
384.77,1.0,0,1,2,4,7,0xb2d6872b
50195.34,2.0,87,2,3,1,6,0xb2d72488d
270081.84,2.0,130,3,3,1,7,0xb2d0a054
50.77,1.0,3,1,2,4,7,0xb2d35429d
15082.51,1.0,184,2,2,1,5,0xb2d50fc2d
987996.64,7.0,0,4,4,4,12,0xb2d5af10d
870000.0,26.0,4,4,4,4,12,0xb2d36e4b
600006.34,2.0,168,4,3,1,8,0xb2d8d9bcd
70091.15,2.0,75,3,3,1,7,0xb2d65a00
540079.27,5.0,15,4,4,3,11,0xb2d316cf
1349247.96,1.0,184,4,2,1,7,0xb2d09d30d
106173.59,2.0,6,3,3,3,9,0xb2d23c9e
2500189.24,6.0,25,4,4,2,10,0xb2d6a7c9d
81167.8,2.0,70,3,3,1,7,0xb2d5e5abd
289154.76,11.0,8,3,4,3,10,0xb2d57b6c
1820.76,1.0,92,1,2,1,4,0xb2d2a340d
337809.85,1.0,70,4,2,1,7,0xb2d6aa4fd
50843.08,4.0,1,2,4,4,10,0xb2d393e1d
765000.0,9.0,8,4,4,3,11,0xb2d53c5cd
10543.13,2.0,80,2,3,1,6,0xb2d29145d
8433.73,1.0,92,2,2,1,5,0xb2d32528
5.51,1.0,10,1,2,3,6,0xb2d368d3d
2475.07,1.0,0,1,2,4,7,0xb2d5211d
12353.41,1.0,0,2,2,4,8,0xb2d2a888d
54729.92,1.0,14,3,2,3,8,0xb2d2d513d
1100000.0,1.0,4,4,2,4,10,0xb2d5f4e0
18084417.66,3.0,87,4,4,1,9,0xb2d3a09b
3894.65,1.0,8,2,2,3,7,0xb2d62cc5d
617.62,1.0,0,1,2,4,7,0xb2d86bd3d
100003.17,2.0,228,3,3,1,7,0xb2d6f165
9354.28,1.0,184,2,2,1,5,0xb2d4d62dd
450031.24,44.0,46,4,4,2,10,0xb2d25ed4d
53984.55,4.0,0,3,4,4,11,0x3b9b2f0bd
676437.84,7.0,10,4,4,3,11,0xb2d22f7ad
51485.62,1.0,92,2,2,1,5,0xb2d626e6d
116477.33,2.0,1,3,3,4,10,0xb2d530b8d
1.22,1.0,272,1,2,1,4,0xb2d5d3d0d
15229.52,1.0,4,2,2,4,8,0xb2d80364d
200510.53,2.0,7,3,3,3,9,0xb2d9cde5
132059.76,2.0,1,3,3,4,10,0xb2d15e0dd
250020.36,2.0,110,3,3,1,7,0xb2d6f477
895106.24,9.0,1,4,4,4,12,0xb2d22c2d
6692.37,1.0,92,2,2,1,5,0xb2d41b05d
20724.85,1.0,75,2,2,1,5,0xb2d63545d
550852.84,3.0,0,4,4,4,12,0xb2d0d7a8d
900028.35,8.0,1,4,4,4,12,0xb2d6fbded
158.97,1.0,7,1,2,3,6,0xb2d4fde1
30269.43,1.0,0,2,2,4,8,0xb2d1b3d7
48248.77,1.0,0,2,2,4,8,0xb2d94f7ed
680008.33,3.0,35,4,4,2,10,0xb2d550f9d
2000000.0,1.0,0,4,2,4,10,0xb2d9b3b2
200142.83,2.0,18,3,3,2,8,0xb2d5f80ed
20879.95,1.0,184,2,2,1,5,0xb2d241c8d
1772189.48,4.0,76,4,4,1,9,0xb2d2f5ded
105940.36,2.0,18,3,3,2,8,0xb2d19803
5143224.14,4.0,59,4,4,2,10,0xb2d2660ed
1450.63,1.0,0,1,2,4,7,0xb2d586dbd
201421.22,2.0,82,3,3,1,7,0xb2d98d52
25800.0,1.0,5,2,2,3,7,0xb2d309cdd
3632.33,1.0,195,2,2,1,5,0xb2d4c93cd
377491.84,2.0,55,4,3,2,9,0xb2d3e214d
5169.7,1.0,0,2,2,4,8,0xb2d3f1d7
938066.5,11.0,38,4,4,2,10,0xb2d563b1
186.25,1.0,32,1,2,2,5,0xb2d60635
14.91,1.0,19,1,2,2,5,0xb2d90508d
545940.19,3.0,11,4,4,3,11,0xb2d0bbbfd
430016.33,8.0,31,4,4,2,10,0xb2d39282d
34460.22,1.0,75,2,2,1,5,0xb2d4c096d
6361.33,1.0,3,2,2,4,8,0xb2d91f49
1392.94,1.0,184,1,2,1,4,0xb2d1ef6ed
10064.68,2.0,6,2,3,3,8,0xb2d95ea0
399016.1,6.0,47,4,4,2,10,0xb2d287dad
3.06,1.0,5,1,2,3,6,0xb2d71749
720000.0,1.0,5,4,2,3,9,0xb2d97302
200088.26,2.0,16,3,3,2,8,0xb2d6f4c4d
55.7,13.0,20,1,4,2,7,0xb2d36302d
842093.07,5.0,3,4,4,4,12,0x3b9b389ad
136.1,1.0,4,1,2,4,7,0xb2d1af51d
213.4,1.0,4,1,2,4,7,0xb2d2dfcb
1000049.3,3.0,4,4,4,4,12,0xb2d6b3f4d
2877818.78,2.0,4,4,3,4,11,0xb2d9603fd
10096.8,1.0,1,2,2,4,8,0xb2d13f58d
60815.29,3.0,18,3,4,2,9,0xb2d5952cd
20773.15,2.0,208,2,3,1,6,0xb2d56e4b
37.45,1.0,0,1,2,4,7,0xb2d29fe7d
1379.9,1.0,184,1,2,1,4,0xb2d35480d
4629.19,1.0,21,2,2,2,6,0xb2d50150d
3599.23,1.0,10,2,2,3,7,0xb2d59435
490094.18,2.0,5,4,3,3,10,0xb2d57a95
183337.22,1.0,38,3,2,2,7,0xb2d395c2d
574287.65,6.0,60,4,4,2,10,0xb2d0d735d
100003.6,2.0,63,3,3,2,8,0xb2d4ff32
300011.68,2.0,123,3,3,1,7,0xb2d622bed
2000.29,1.0,0,1,2,4,7,0xb2d33070d
450001.06,5.0,3,4,4,4,12,0xb2d8d27e
85366.65,6.0,0,3,4,4,11,0x3b9b3b6f
187.99,1.0,25,1,2,2,5,0xb2d1beb8
782841.96,3.0,14,4,4,3,11,0xb2d9c18c
162070.97,2.0,52,3,3,2,8,0xb2d45796
66533.89,1.0,16,3,2,2,7,0xb2d7bd74
14.99,1.0,0,1,2,4,7,0xb2d8dfa7
340152.13,2.0,174,4,3,1,8,0xb2d101aa
400000.18,2.0,13,4,3,3,10,0xb2d6a4abd
33.46,1.0,7,1,2,3,6,0xb2d8c3e9
110009.69,3.0,11,3,4,3,10,0xb2d3f313
30001.37,3.0,8,2,4,3,9,0xb2da38b0
20917.9,2.0,4,2,3,4,9,0xb2d426d8d
15063.19,1.0,184,2,2,1,5,0xb2d5ebabd
10170.03,1.0,55,2,2,2,6,0xb2d6f8a8d
3661.66,1.0,92,2,2,1,5,0xb2d5e61ad
357090.69,2.0,108,4,3,1,8,0xb2d58574d
70028.65,6.0,77,3,4,1,8,0xb2d53d0f
75121.62,1.0,101,3,2,1,6,0xb2d1107f
4705.93,2.0,92,2,3,1,6,0xb2d56bd8d
18.09,1.0,67,1,2,1,4,0xb2d24bf2
20000.84,2.0,216,2,3,1,6,0xb2d68000d
700131.65,2.0,53,4,3,2,9,0xb2d63b83d
19592.29,1.0,0,2,2,4,8,0xb2d4fb48
0.0,1.0,28,1,2,2,5,0xb2d0b0ca
60002.74,2.0,77,3,3,1,7,0xb2d4082f
260066.33,10.0,25,3,4,2,9,0xb2d57cf7d
3432.75,1.0,18,2,2,2,6,0xb2d5d223d
828.33,1.0,1,1,2,4,7,0xb2d6c3d3
120004.33,4.0,31,3,4,2,9,0xb2d58eebd
4695.92,3.0,0,2,4,4,10,0xb2d0af8fd
90936.57,2.0,92,3,3,1,7,0xb2d68dfc
332114.42,3.0,38,4,4,2,10,0xb2d5ede6d
307275.66,19.0,11,4,4,3,11,0xb2d10f56d
1015.85,1.0,184,1,2,1,4,0xb2d12b04d
26320.12,1.0,0,2,2,4,8,0xb2d34cb7
2399.18,1.0,9,1,2,3,6,0xb2d4421bd
283566.35,4.0,48,3,4,2,9,0xb2d142afd
630000.0,2.0,3,4,3,4,11,0xb2d293dad
5226.43,1.0,0,2,2,4,8,0xb2d8f71ad
493243.25,5.0,0,4,4,4,12,0xb2d2fb86d
51580.38,1.0,184,2,2,1,5,0xb2d2d12ed
200000.0,2.0,6,3,3,3,9,0xb2d9f2d8
600064.59,4.0,16,4,4,2,10,0xb2d10c36d
39.87,7.0,10,1,4,3,8,0xb2d12e1d
236198.13,3.0,14,3,4,3,10,0xb2d2a118d
720710.42,4.0,8,4,4,3,11,0xb2d28136d
200001.48,2.0,15,3,3,3,9,0xb2da2255
714741.07,11.0,0,4,4,4,12,0xb2d12f38d
333454.6,3.0,112,4,4,1,9,0xb2d627ac
1200027.92,2.0,27,4,3,2,9,0xb2d07841d
77.77,1.0,45,1,2,2,5,0xb2d30b27d
344004.95,13.0,5,4,4,3,11,0xb2d5349ad
3188563.02,2.0,48,4,3,2,9,0xb2d4279ed
183029.47,2.0,0,3,3,4,10,0xb2d0b2e4d
80975.68,2.0,0,3,3,4,10,0xb2d8cfb1d
100702.72,2.0,235,3,3,1,7,0xb2d3b173
4116.03,1.0,1,2,2,4,8,0xb2d64feed
2048.71,1.0,184,1,2,1,4,0xb2d3abb9d
701082.28,5.0,1,4,4,4,12,0xb2d0c908
284036.93,3.0,60,3,4,2,9,0xb2d3c653d
3567.47,3.0,92,2,4,1,7,0xb2d06457d
213609.72,3.0,83,3,4,1,8,0xb2d6ec6fd
61374.67,1.0,0,3,2,4,9,0xb2d50940d
50179.48,2.0,28,2,3,2,7,0xb2d6a683
40071.74,2.0,46,2,3,2,7,0xb2d6ef16
529064.95,7.0,42,4,4,2,10,0x3b9b28fdd
50836.96,2.0,125,2,3,1,6,0xb2d621cfd
205732.54,2.0,14,3,3,3,9,0xb2d97eb4d
711.8,1.0,2,1,2,4,7,0xb2d6be2f
21079.61,2.0,0,2,3,4,9,0xb2d5ff11
630000.0,3.0,4,4,4,4,12,0xb2d8529b
300000.0,2.0,70,3,3,1,7,0xb2d9a988
300011.08,2.0,80,3,3,1,7,0xb2d98417
979747.13,7.0,6,4,4,3,11,0xb2d11368d
638692.86,3.0,100,4,4,1,9,0xb2d3e74bd
2370059.91,6.0,2,4,4,4,12,0xb2d6bce2d
300003.17,2.0,63,3,3,2,8,0xb2d9b7bf
5093.68,1.0,184,2,2,1,5,0xb2d1e0d9d
490000.98,2.0,7,4,3,3,10,0xb2d63774
550032.42,8.0,25,4,4,2,10,0xb2d1e8ce
654.71,1.0,27,1,2,2,5,0xb2d25bf6
2941.24,8.0,92,2,4,1,7,0xb2d1644ad
36.42,1.0,87,1,2,1,4,0xb2d167b2
200000.0,2.0,20,3,3,2,8,0xb2d39b3cd
114.0,1.0,63,1,2,2,5,0xb2d9551b
130027.18,5.0,26,3,4,2,9,0xb2d699bdd
150747.67,5.0,11,3,4,3,10,0x3b9b38b2d
54630.03,2.0,2,3,3,4,10,0xb2d906a5d
353944.08,3.0,39,4,4,2,10,0xb2d39388d
99163.38,1.0,60,3,2,2,7,0xb2d8d056d
6.17,1.0,50,1,2,2,5,0xb2d28881
158.97,1.0,9,1,2,3,6,0xb2d2f808
23.95,11.0,92,1,4,1,6,0xb2d25699d
55444.36,1.0,0,3,2,4,9,0xb2d59191d
200000.0,2.0,12,3,3,3,9,0xb2da4836
50548.65,1.0,3,2,2,4,8,0xb2d621b2d
19906.28,1.0,182,2,2,1,5,0xb2d10a2ed
15499.65,1.0,92,2,2,1,5,0xb2d34cae
500849.27,3.0,18,4,4,2,10,0xb2d9bc9c
45604.69,1.0,4,2,2,4,8,0xb2d3a33d
282905.42,2.0,2,3,3,4,10,0xb2d6ec3bd
110957.47,4.0,0,3,4,4,11,0xb2d2af22
500000.0,3.0,0,4,4,4,12,0xb2d2507fd
450033.93,6.0,14,4,4,3,11,0xb2d0e1e0d
31.07,1.0,56,1,2,2,5,0xb2d58147d
60170.4,2.0,63,3,3,2,8,0xb2d8e9cdd
1518034.26,15.0,1,4,4,4,12,0xb2d53d2bd
0.0,1.0,1,1,2,4,7,0xb2d69094d
46489.37,1.0,75,2,2,1,5,0xb2d236e1d
5132.85,1.0,92,2,2,1,5,0xb2d2f08fd
7882.9,1.0,9,2,2,3,7,0xb2d69b0ad
328833.89,4.0,4,4,4,4,12,0xb2d111cad
88627.29,2.0,92,3,3,1,7,0xb2d5a077d
60001.69,3.0,22,3,4,2,9,0xb2d986d4
32.38,1.0,49,1,2,2,5,0xb2d6bbd0d
1917.99,1.0,165,1,2,1,4,0xb2d217b0
8973.01,1.0,0,2,2,4,8,0xb2d96227
381182.14,3.0,48,4,4,2,10,0xb2d5e361d
354589.54,7.0,6,4,4,3,11,0xb2d17e9ed
15.57,1.0,26,1,2,2,5,0xb2d8dea7d
356235.87,2.0,172,4,3,1,8,0xb2d6c29f
200064.42,2.0,18,3,3,2,8,0xb2d8690bd
297.72,1.0,2,1,2,4,7,0xb2d69b36
3.65,1.0,72,1,2,1,4,0xb2d63c47d
130003.06,3.0,53,3,4,2,9,0xb2d6cb9e
397006.13,7.0,11,4,4,3,11,0xb2d163d8d
5.59,1.0,27,1,2,2,5,0xb2d3271f
690008.91,8.0,10,4,4,3,11,0xb2d1d0bfd
223002.84,4.0,0,3,4,4,11,0xb2d6aed5d
125902.32,2.0,27,3,3,2,8,0xb2d1c4fad
480007.36,3.0,6,4,4,3,11,0xb2d91535d
1409.09,2.0,184,1,3,1,5,0xb2d2d3ddd
8278.88,2.0,8,2,3,3,8,0xb2d6087f
457223.47,4.0,4,4,4,4,12,0xb2d28417d
100117.85,2.0,35,3,3,2,8,0xb2d5d768d
17497.56,1.0,92,2,2,1,5,0xb2d14ad0
5172.63,1.0,11,2,2,3,7,0xb2d311c8
952736.38,10.0,6,4,4,3,11,0x3b9af216d
103638.16,3.0,48,3,4,2,9,0xb2d5dd41d
56.99,3.0,42,1,4,2,7,0xb2d1eb7a
470633.69,1.0,1,4,2,4,10,0xb2d95286d
150001.58,2.0,69,3,3,1,7,0xb2d8e983
52074.26,2.0,75,2,3,1,6,0xb2d43531d
538349.56,4.0,11,4,4,3,11,0xb2d17ab5d
501776.04,2.0,9,4,3,3,10,0xb2d92b29d
92341.34,2.0,193,3,3,1,7,0xb2d114ccd
16000.17,2.0,92,2,3,1,6,0xb2d64213d
0.0,1.0,187,1,2,1,4,0xb2d0e2ead
2000.84,1.0,6,1,2,3,6,0xb2d6c49f
20000.63,2.0,67,2,3,1,6,0xb2d9aa97
120077.23,2.0,52,3,3,2,8,0xb2d2c618
0.0,1.0,0,1,2,4,7,0xb2d3b483
173528.55,2.0,40,3,3,2,8,0xb2d566b3d
198059.24,1.0,47,3,2,2,7,0xb2d14399d
50419.44,5.0,2,2,4,4,10,0xb2d37797
11025.6,1.0,5,2,2,3,7,0xb2d6448ad
160026.53,20.0,0,3,4,4,11,0xb2d0cf81
773.52,1.0,1,1,2,4,7,0xb2d2f5f9
850456.9,7.0,31,4,4,2,10,0xb2d28b44
7145.19,1.0,0,2,2,4,8,0xb2d6af3d
3424.11,2.0,260,2,3,1,6,0x3b9b30c3d
1615.43,1.0,7,1,2,3,6,0xb2d2395cd
7303.84,1.0,96,2,2,1,5,0xb2d6848ad
170847.28,2.0,74,3,3,1,7,0xb2d25587d
27.91,1.0,63,1,2,2,5,0xb2d2d64ed
4.64,1.0,71,1,2,1,4,0xb2d9a01f
397000.0,4.0,0,4,4,4,12,0xb2d7ada6d
810133.2,5.0,18,4,4,2,10,0xb2d17323
1207.49,1.0,15,1,2,3,6,0xb2d2c8d7
20000662.48,2.0,80,4,3,1,8,0xb2d97ae8d
0.69,1.0,179,1,2,1,4,0xb2d1a211
1046.12,10.0,0,1,4,4,9,0xb2d18680d
209286.74,2.0,130,3,3,1,7,0xb2d559f4
10014.83,3.0,4,2,4,4,10,0xb2d65247d
24823.57,1.0,0,2,2,4,8,0xb2d33a0f
150007.24,2.0,98,3,3,1,7,0xb2d966bfd
614310.02,4.0,101,4,4,1,9,0xb2d63219d
20944.47,1.0,126,2,2,1,5,0xb2d5cea9
260066.72,5.0,21,3,4,2,9,0xb2d10a1f
357207.42,1.0,29,4,2,2,8,0xb2d55ca1d
300080.8,4.0,113,3,4,1,8,0xb2d1b146d
52181.97,2.0,74,3,3,1,7,0xb2d4826ad
84004.19,4.0,6,3,4,3,10,0xb2d3caa3d
15.35,1.0,10,1,2,3,6,0xb2d431da
1000318.94,4.0,10,4,4,3,11,0xb2d0c859d
4037.7,1.0,3,2,2,4,8,0xb2d70884
100004.22,2.0,76,3,3,1,7,0xb2d8d9bd
7454.35,1.0,0,2,2,4,8,0xb2d53591d
51090.77,2.0,6,2,3,3,8,0xb2d6b379d
2609.13,1.0,184,1,2,1,4,0xb2d357a8d
100001.06,2.0,45,3,3,2,8,0xb2d91d94d
200000.0,2.0,1,3,3,4,10,0xb2da6603
324713.09,1.0,0,4,2,4,10,0xb2d91464d
30033.9,3.0,136,2,4,1,7,0xb2d53c2fd
461243.35,4.0,39,4,4,2,10,0xb2d23a76d
758142.91,1.0,0,4,2,4,10,0xb2d87a9fd
200710.42,2.0,39,3,3,2,8,0xb2d9f562
1000000.0,5.0,5,4,4,3,11,0xb2d6565ed
3.46,1.0,19,1,2,2,5,0xb2d6bccfd
38727.47,3.0,18,2,4,2,8,0xb2d23d94d
2.4,1.0,67,1,2,1,4,0xb2d3b397
1003606.42,3.0,11,4,4,3,11,0xb2d655c6
3101.64,1.0,8,2,2,3,7,0xb2d6097dd
11185.97,1.0,0,2,2,4,8,0xb2d964d0
4037.24,1.0,1,2,2,4,8,0xb2d0e894
15151.9,1.0,92,2,2,1,5,0xb2d2199cd
1045.04,1.0,310,1,2,1,4,0xb2d3d99dd
100102.53,2.0,11,3,3,3,9,0xb2da3c49
61.83,1.0,60,1,2,2,5,0xb2d23e62d
0.17,1.0,0,1,2,4,7,0xb2d3a8a1d
82501.04,1.0,41,3,2,2,7,0xb2d68397
33665.44,1.0,101,2,2,1,5,0xb2d517d0d
1.13,1.0,207,1,2,1,4,0xb2d3bc95d
6352.56,1.0,7,2,2,3,7,0xb2d69fd6d
75.85,1.0,18,1,2,2,5,0xb2d2df9a
1173.42,1.0,73,1,2,1,4,0xb2d5f992
350104.06,3.0,10,4,4,3,11,0xb2d21853
194067.97,1.0,28,3,2,2,7,0xb2d30258
189.28,1.0,12,1,2,3,6,0xb2d6e464
95590.67,4.0,0,3,4,4,11,0xb2d58683
21.52,2.0,46,1,3,2,6,0xb2d0a795d
300051.87,2.0,42,3,3,2,8,0xb2d95180d
50.08,1.0,9,1,2,3,6,0xb2d2d045d
705816.02,5.0,0,4,4,4,12,0xb2d07f9bd
100041.94,3.0,3,3,4,4,11,0xb2d21965d
500019.0,3.0,19,4,4,2,10,0xb2d8cd5fd
476009.58,6.0,1,4,4,4,12,0xb2d18381d
17119.07,1.0,1,2,2,4,8,0xb2d382b4d
295567.19,4.0,34,3,4,2,9,0xb2d0bf85
541207.92,3.0,15,4,4,3,11,0xb2d9c817
617243.85,4.0,47,4,4,2,10,0xb2d1226ad
71235.35,8.0,0,3,4,4,11,0xb2d410edd
24136.99,4.0,0,2,4,4,10,0xb2d2be5bd
830062.23,6.0,8,4,4,3,11,0xb2d5d3e5
75202.32,2.0,0,3,3,4,10,0xb2d29e49d
6085.93,1.0,3,2,2,4,8,0xb2d8dac9d
58481.96,2.0,61,3,3,2,8,0xb2d3699bd
2002.92,1.0,19,1,2,2,5,0xb2d6bd8fd
70260.44,1.0,184,3,2,1,6,0xb2d5f373
30000.32,2.0,76,2,3,1,6,0xb2d8dda9d
270959.07,2.0,41,3,3,2,8,0xb2d9ef1a
50729.38,2.0,116,2,3,1,6,0xb2d2248fd
602077.6,3.0,118,4,4,1,9,0xb2d555a9d
70002.32,3.0,77,3,4,1,8,0xb2d5e92ad
50055.39,2.0,3,2,3,4,9,0xb2d4d04dd
760837.09,4.0,70,4,4,1,9,0xb2d21440d
2.69,1.0,77,1,2,1,4,0xb2d22c8f
252356.76,5.0,6,3,4,3,10,0xb2d2a689d
511506.05,4.0,63,4,4,2,10,0xb2d60189d
222048.57,4.0,77,3,4,1,8,0xb2d593cdd
3896.47,1.0,184,2,2,1,5,0xb2d225dfd
90000.0,5.0,0,3,4,4,11,0xb2d8ce30d
1716.97,1.0,184,1,2,1,4,0x3b9b2ea0
160507.65,3.0,1,3,4,4,11,0xb2d94d22d
59010.92,2.0,7,3,3,3,9,0xb2d5cad2d
67.27,1.0,10,1,2,3,6,0xb2d3429d
120.62,1.0,9,1,2,3,6,0xb2d34e9dd
643.63,1.0,8,1,2,3,6,0xb2d31090
505330.72,2.0,57,4,3,2,9,0xb2d94a8cd
850629.42,2.0,10,4,3,3,10,0xb2d65925
3049.49,2.0,242,2,3,1,6,0x3b9addd4d
199899.3,2.0,46,3,3,2,8,0xb2d9070fd
62893.92,2.0,97,3,3,1,7,0xb2d3b6eed
1000024.3,3.0,8,4,4,3,11,0xb2d58b95
30074.48,1.0,245,2,2,1,5,0xb2d68dc7d
1066.68,1.0,10,1,2,3,6,0xb2d52b60
20006.76,1.0,41,2,2,2,6,0xb2d9251b
50001.06,2.0,139,2,3,1,6,0xb2d6eebad
25000.0,1.0,3,2,2,4,8,0xb2d94d5dd
309336.46,1.0,177,4,2,1,7,0xb2d50e78d
105675.81,2.0,92,3,3,1,7,0xb2d282bad
187606.47,3.0,8,3,4,3,10,0xb2d592eed
16.63,1.0,4,1,2,4,7,0xb2d57a2b
32200.4,1.0,0,2,2,4,8,0xb2d31558d
5377.44,1.0,120,2,2,1,5,0xb2d2907cd
3.0,1.0,22,1,2,2,5,0xb2d78674
2786.47,1.0,0,1,2,4,7,0xb2d34059d
220006.97,2.0,80,3,3,1,7,0xb2d988c7
288993.96,4.0,3,3,4,4,11,0xb2d23754d
66835.27,1.0,10,3,2,3,8,0xb2d4712b
500000.33,2.0,26,4,3,2,9,0xb2d903d2d
579.99,1.0,5,1,2,3,6,0xb2d43ea2
232909.32,3.0,8,3,4,3,10,0xb2d2b4d7d
10417.74,1.0,3,2,2,4,8,0xb2d9288fd
85.42,1.0,74,1,2,1,4,0xb2d53171d
2164.07,1.0,9,1,2,3,6,0xb2d37aa4
50001.58,2.0,80,2,3,1,6,0xb2d98906
745.61,1.0,10,1,2,3,6,0xb2d218a1d
5012.05,1.0,20,2,2,2,6,0xb2d28638
202489.76,3.0,16,3,4,2,9,0xb2d65ad6d
0.75,1.0,10,1,2,3,6,0xb2d6f35bd
201195.77,2.0,6,3,3,3,9,0xb2d62694d
904.13,1.0,3,1,2,4,7,0xb2d24175d
2687.92,1.0,9,1,2,3,6,0xb2d8ce1f
430012.97,9.0,4,4,4,4,12,0xb2d4f726
10101.06,1.0,92,2,2,1,5,0xb2d286e3d
951400.12,4.0,20,4,4,2,10,0xb2d3af88d
22877.97,2.0,8,2,3,3,8,0xb2d0e734d
336080.45,1.0,70,4,2,1,7,0xb2d30551
87674.69,2.0,0,3,3,4,10,0x3b9af240d
520.5,1.0,11,1,2,3,6,0xb2d23f57d
559000.0,5.0,0,4,4,4,12,0xb2d1a45d
85235.29,4.0,0,3,4,4,11,0xb2d06c8fd
3685.37,2.0,0,2,3,4,9,0xb2d20666
368020.46,9.0,0,4,4,4,12,0xb2d25393d
12254.37,1.0,31,2,2,2,6,0xb2d14111
79416.05,1.0,0,3,2,4,9,0xb2da59a3
1700.0,1.0,0,1,2,4,7,0xb2d93d0d
450000.0,2.0,18,4,3,2,9,0xb2da21e4
550000.0,3.0,1,4,4,4,12,0xb2d96f62d
47.48,1.0,55,1,2,2,5,0xb2d4731e
1528.48,1.0,92,1,2,1,4,0xb2d09a91
5957.95,1.0,79,2,2,1,5,0xb2d44d42d
3.67,1.0,32,1,2,2,5,0xb2d36c75
769073.06,5.0,0,4,4,4,12,0xb2d26286d
26.78,1.0,9,1,2,3,6,0xb2d1c0e5
773.17,1.0,0,1,2,4,7,0xb2d6d986
507256.69,2.0,139,4,3,1,8,0xb2d4cc23d
2291.04,1.0,96,1,2,1,4,0xb2d23b0ed
770088.93,8.0,21,4,4,2,10,0xb2d90994
0.0,2.0,82,1,3,1,5,0xb2d4de8d
1848.55,1.0,11,1,2,3,6,0xb2d6862b
20227.06,1.0,6,2,2,3,7,0xb2d34816d
7314.46,1.0,21,2,2,2,6,0xb2d60a84
30.69,1.0,23,1,2,2,5,0xb2d88b19d
14411.12,1.0,0,2,2,4,8,0xb2d321dfd
9669.25,1.0,20,2,2,2,6,0xb2d68e55
30387.32,2.0,1,2,3,4,9,0xb2d62f92d
50228.71,1.0,121,2,2,1,5,0xb2d64fc0d
550053.48,3.0,10,4,4,3,11,0xb2d62ddfd
93.7,1.0,22,1,2,2,5,0xb2d424f5d
20068.27,2.0,83,2,3,1,6,0xb2d65216d
5361.96,1.0,184,2,2,1,5,0xb2d2163dd
316868.23,1.0,0,4,2,4,10,0xb2d51a27d
533.83,2.0,38,1,3,2,6,0xb2d52a71
843120.22,5.0,12,4,4,3,11,0xb2d572c7d
50.55,1.0,76,1,2,1,4,0xb2d6b4a9d
74.55,1.0,215,1,2,1,4,0xb2d34571
750023.75,3.0,35,4,4,2,10,0xb2d9d47e
159.58,1.0,7,1,2,3,6,0xb2d30603d
118522.38,1.0,5,3,2,3,8,0xb2d29357
512864.85,2.0,116,4,3,1,8,0xb2d59fb8
510377.71,7.0,0,4,4,4,12,0xb2d54859d
60000.64,3.0,1,3,4,4,11,0xb2d95845
133014.01,2.0,179,3,3,1,7,0xb2d41f83d
2.23,1.0,48,1,2,2,5,0xb2d41b3ad
1086.33,1.0,9,1,2,3,6,0xb2d94e54
27159.18,1.0,42,2,2,2,6,0xb2d0f988d
1565604.49,5.0,15,4,4,3,11,0xb2d775b6d
166070.11,4.0,0,3,4,4,11,0xb2d53807
1235259.89,3.0,11,4,4,3,11,0xb2d2b688d
130040.04,2.0,94,3,3,1,7,0xb2d58695d
3374.52,1.0,25,2,2,2,6,0xb2d2163ed
1143.21,1.0,0,1,2,4,7,0xb2d64a38
200000.0,2.0,5,3,3,3,9,0xb2d975aad
610.12,4.0,0,1,4,4,9,0xb2d3cbab
480607.46,5.0,1,4,4,4,12,0xb2d6b281d
11814.78,1.0,92,2,2,1,5,0xb2d29d30d
502269.18,3.0,0,4,4,4,12,0xb2d16ce3d
1517.44,1.0,92,1,2,1,4,0xb2d20fdfd
6060.51,1.0,92,2,2,1,5,0xb2d200f4d
100034.17,2.0,202,3,3,1,7,0xb2d5b429
1232.24,1.0,6,1,2,3,6,0xb2d993d0
152.85,1.0,0,1,2,4,7,0xb2d96078
450006.33,3.0,80,4,4,1,9,0xb2d8d450
1182.83,1.0,1,1,2,4,7,0xb2d2a87f
2290000.0,11.0,3,4,4,4,12,0xb2d0e682d
100001.59,3.0,70,3,4,1,8,0xb2d94b6bd
196480.29,4.0,94,3,4,1,8,0xb2d31150
50005.06,2.0,74,2,3,1,6,0xb2d59cbd
900013.2,4.0,52,4,4,2,10,0xb2d903a1d
579000.17,5.0,8,4,4,3,11,0xb2d22f62
13299.82,1.0,21,2,2,2,6,0xb2d1f7b6d
632.23,1.0,1,1,2,4,7,0xb2d31189d
10382.66,1.0,0,2,2,4,8,0xb2d6af1ad
35.11,1.0,7,1,2,3,6,0xb2d8df53
15457.58,1.0,116,2,2,1,5,0xb2d5b9bbd
320051.6,4.0,11,4,4,3,11,0xb2d3a930d
40000.42,2.0,76,2,3,1,6,0xb2d274b3d
107640.85,2.0,259,3,3,1,7,0xb2d34f08d
380010.75,3.0,56,4,4,2,10,0xb2d2b53c
443323.64,6.0,63,4,4,2,10,0xb2d3d3fad
262976.17,2.0,66,3,3,2,8,0xb2d5907bd
10076.79,1.0,184,2,2,1,5,0xb2d361d1d
50001.06,2.0,18,2,3,2,7,0xb2da2aea
238886.64,3.0,3,3,4,4,11,0xb2d3faa9d
20514.71,2.0,0,2,3,4,9,0xb2d68238d
475001.39,5.0,23,4,4,2,10,0xb2d40ec2
3.18,1.0,40,1,2,2,5,0xb2d632dd
260006.13,5.0,3,3,4,4,11,0xb2d410a5d
500000.0,2.0,5,4,3,3,10,0xb2da5f85
103007.65,3.0,251,3,4,1,8,0xb2d3d370d
50181.81,2.0,1,2,3,4,9,0xb2d5cb1dd
787033.33,6.0,27,4,4,2,10,0xb2d28c70d
132266.55,2.0,208,3,3,1,7,0xb2d1ca44d
1871.06,1.0,20,1,2,2,5,0xb2d6bb97
610012.31,6.0,14,4,4,3,11,0xb2d8cf1dd
250000.0,2.0,21,3,3,2,8,0xb2d9527dd
8814.14,1.0,1,2,2,4,8,0xb2d2664c
305436.16,2.0,104,4,3,1,8,0xb2d5347ed
200000.0,2.0,1,3,3,4,10,0xb2da5e21
50070.05,2.0,31,2,3,2,7,0xb2d47334d
30256.3,1.0,184,2,2,1,5,0xb2d413c1d
502491.61,1.0,0,4,2,4,10,0xb2d37f5bd
607.54,1.0,0,1,2,4,7,0xb2d6e5bc
35003.16,1.0,0,2,2,4,8,0xb2d4068ed
400026.4,2.0,0,4,3,4,11,0xb2d62df7d
3856218.52,11.0,39,4,4,2,10,0xb2d0697ed
300000.53,3.0,3,3,4,4,11,0xb2d69cc2
4205.15,1.0,0,2,2,4,8,0xb2d717ead
99105.46,2.0,25,3,3,2,8,0xb2d233f6d
50000.42,1.0,4,2,2,4,8,0xb2d56b19
101840.81,1.0,4,3,2,4,9,0xb2d14cbad
2968735.48,11.0,0,4,4,4,12,0xb2d59814
87.63,1.0,35,1,2,2,5,0xb2d237e0d
3424.48,1.0,6,2,2,3,7,0xb2d5e48dd
1331.72,1.0,25,1,2,2,5,0xb2d58e56
0.01,1.0,146,1,2,1,4,0xb2d5a604d
508171.36,4.0,18,4,4,2,10,0xb2d38a85d
121438.07,3.0,31,3,4,2,9,0xb2d35bf9
110004.64,2.0,94,3,3,1,7,0xb2d858fa
1069.14,1.0,173,1,2,1,4,0xb2d5b012d
202850.12,2.0,105,3,3,1,7,0xb2d17f39
140290.91,1.0,3,3,2,4,9,0xb2d78927d
1182.04,1.0,0,1,2,4,7,0xb2d3e981
3770000.0,25.0,0,4,4,4,12,0xb2d0c719
81230.75,3.0,129,3,4,1,8,0xb2d5f770d
501852.31,2.0,43,4,3,2,9,0xb2d9966f
81689.95,3.0,75,3,4,1,8,0xb2d40939d
4646.13,1.0,23,2,2,2,6,0xb2d21664d
1.25,1.0,35,1,2,2,5,0xb2d4b714
6038.74,1.0,92,2,2,1,5,0xb2d3b351d
380089.11,5.0,3,4,4,4,12,0xb2d97cac
1348.26,1.0,184,1,2,1,4,0xb2d2f9e6d
19806.47,1.0,8,2,2,3,7,0xb2d6fdcad
1313.98,1.0,92,1,2,1,4,0xb2d13d26d
60043.66,2.0,193,3,3,1,7,0xb2d1b126d
6301.76,1.0,0,2,2,4,8,0xb2d8a0edd
6421.41,3.0,0,2,4,4,10,0x3b9af28ad
52367.11,1.0,4,3,2,4,9,0xb2d5ce80d
97826.05,1.0,10,3,2,3,8,0xb2d92205d
906.9,1.0,0,1,2,4,7,0xb2d9069dd
4816.78,1.0,92,2,2,1,5,0xb2d0e3e6d
223306.07,5.0,1,3,4,4,11,0xb2d2be1f
2592.36,1.0,13,1,2,3,6,0xb2d81e11
859.37,1.0,10,1,2,3,6,0xb2d91bed
368686.39,2.0,19,4,3,2,9,0xb2d5d42b
390868.2,5.0,60,4,4,2,10,0xb2d193ac
239974.51,7.0,0,3,4,4,11,0x3b9af2dc
1000000.0,2.0,5,4,3,3,10,0xb2da5e4a
8044.18,1.0,92,2,2,1,5,0xb2d3e55cd
8162.76,1.0,21,2,2,2,6,0xb2d282b9d
200316.71,5.0,95,3,4,1,8,0x3b9b453d
20003.91,2.0,18,2,3,2,7,0xb2d5e481
801789.07,3.0,55,4,4,2,10,0xb2d900e6d
27584.03,1.0,1,2,2,4,8,0xb2d3536ad
4858.42,1.0,92,2,2,1,5,0xb2d0e78ad
553211.67,5.0,0,4,4,4,12,0xb2d2d4d0d
3332.76,2.0,113,2,3,1,6,0xb2d54ad0d
16114.49,1.0,2,2,2,4,8,0xb2d8ebdfd
750114.16,4.0,144,4,4,1,9,0xb2d6217cd
511.94,1.0,8,1,2,3,6,0xb2d6cf7b
2664.21,2.0,15,1,3,3,7,0xb2d2b9ccd
50669.25,1.0,184,2,2,1,5,0xb2d40246d
30030.52,1.0,4,2,2,4,8,0xb2d45a41d
150002.12,6.0,0,3,4,4,11,0xb2d41dbed
105004.17,5.0,34,3,4,2,9,0xb2d8c36c
3.92,1.0,0,1,2,4,7,0xb2d320e1d
33588.15,2.0,36,2,3,2,7,0xb2d970c8
10731.95,1.0,1,2,2,4,8,0xb2d6f2e5d
8590.78,9.0,18,2,4,2,8,0xb2d1524e
200036.72,2.0,214,3,3,1,7,0xb2d0d5a1
153133.24,3.0,10,3,4,3,10,0xb2d23320
130017.51,2.0,109,3,3,1,7,0xb2d744cad
386158.85,3.0,24,4,4,2,10,0xb2d37224
1462155.58,12.0,6,4,4,3,11,0xb2d5ce13d
14595.87,1.0,18,2,2,2,6,0xb2d98811
200000.0,2.0,25,3,3,2,8,0xb2da1c01
335.12,1.0,0,1,2,4,7,0xb2d6d347
57038.19,2.0,11,3,3,3,9,0xb2d425a1
4900.56,1.0,5,2,2,3,7,0xb2d8e91ed
180040.53,1.0,24,3,2,2,7,0xb2d91cfed
663411.22,15.0,0,4,4,4,12,0xb2d47669d
204978.52,2.0,87,3,3,1,7,0xb2d6e378
240002.23,3.0,1,3,4,4,11,0xb2d6b315
9111.07,1.0,0,2,2,4,8,0xb2d2fe06d
1327.54,1.0,27,1,2,2,5,0xb2d87ba5
791.1,1.0,0,1,2,4,7,0xb2d3eb52
1702.62,1.0,92,1,2,1,4,0xb2d19e4bd
50001.67,5.0,18,2,4,2,8,0xb2d60f37d
441340.74,3.0,42,4,4,2,10,0xb2d5df02d
770000.0,7.0,1,4,4,4,12,0xb2d59a7ed
530052.14,5.0,193,4,4,1,9,0xb2d06427d
23166.7,1.0,20,2,2,2,6,0xb2d23b26d
528.85,1.0,10,1,2,3,6,0xb2d5d15a
20187.77,3.0,92,2,4,1,7,0xb2d5bcdbd
40292.29,3.0,3,2,4,4,10,0xb2d64df4
5.1,1.0,22,1,2,2,5,0xb2d393ec
10000.11,2.0,74,2,3,1,6,0xb2d0f1b8
1019.08,1.0,0,1,2,4,7,0xb2d223e7d
111.64,1.0,17,1,2,2,5,0xb2d8c946
14093.93,1.0,2,2,2,4,8,0xb2d83ca6
411456.58,2.0,55,4,3,2,9,0xb2d9cc26
0.0,1.0,1,1,2,4,7,0xb2d4264ed
325002.39,9.0,63,4,4,2,10,0xb2d41158d
14186.54,1.0,0,2,2,4,8,0xb2d68cd1d
223072.97,4.0,48,3,4,2,9,0xb2d5552d
4.26,1.0,41,1,2,2,5,0xb2d94a50d
114002.41,2.0,25,3,3,2,8,0xb2da0abd
542.48,1.0,147,1,2,1,4,0xb2d5d0b6d
28870.15,1.0,20,2,2,2,6,0xb2d63469d
1155.82,1.0,10,1,2,3,6,0xb2d90c69
568962.78,3.0,28,4,4,2,10,0xb2d62debd
100000.0,2.0,0,3,3,4,10,0xb2d97f92d
1314.34,1.0,175,1,2,1,4,0xb2d33985d
2808.51,1.0,1,1,2,4,7,0xb2d407ec
428530.87,2.0,27,4,3,2,9,0xb2d3be38d
0.33,1.0,59,1,2,2,5,0xb2d5806cd
3.18,1.0,42,1,2,2,5,0xb2d4f244
1202.44,1.0,90,1,2,1,4,0xb2d3bfa7d
2367.43,1.0,9,1,2,3,6,0xb2d6fac3
36.62,1.0,46,1,2,2,5,0xb2d80dd5
157201.98,4.0,7,3,4,3,10,0xb2d0c139d
951.54,1.0,31,1,2,2,5,0xb2d64034
50000.53,2.0,14,2,3,3,8,0xb2da37f0
658.61,1.0,0,1,2,4,7,0xb2d93da1
8.19,1.0,0,1,2,4,7,0xb2d34831
38000.19,3.0,3,2,4,4,10,0xb2d91290d
80.75,2.0,0,1,3,4,8,0xb2d93597
15394.4,1.0,19,2,2,2,6,0xb2d442fa
1756.63,1.0,8,1,2,3,6,0x3b9b3142
0.46,1.0,41,1,2,2,5,0xb2d6a0a9
100038.73,2.0,31,3,3,2,8,0xb2d58156
140.96,3.0,0,1,4,4,9,0xb2d0947b
1480425.14,4.0,31,4,4,2,10,0xb2d23751d
2485.04,1.0,0,1,2,4,7,0xb2d8b2e9d
0.38,1.0,1,1,2,4,7,0xb2d8349c
1036178.6,10.0,3,4,4,4,12,0xb2d1bd3d
251332.51,3.0,80,3,4,1,8,0xb2d4e639d
340003.06,3.0,25,4,4,2,10,0xb2d6c5bbd
142.05,1.0,87,1,2,1,4,0xb2d1f754
57.9,1.0,1,1,2,4,7,0xb2d4fca5
4135.45,1.0,18,2,2,2,6,0xb2d6b086
51638.53,2.0,56,2,3,2,7,0xb2d63ca8d
340964.98,5.0,13,4,4,3,11,0xb2d5ecf9d
501776.06,2.0,41,4,3,2,9,0xb2d91933d
200000.0,2.0,20,3,3,2,8,0xb2da279e
26922.51,1.0,7,2,2,3,7,0xb2d5afac
40699.35,2.0,171,2,3,1,6,0xb2d5fa98d
80000.0,2.0,3,3,3,4,10,0xb2d9729fd
123535.05,1.0,8,3,2,3,8,0xb2d445ce
533527.32,11.0,1,4,4,4,12,0xb2d22681
8.42,1.0,0,1,2,4,7,0xb2d2f5e6d
194661.12,6.0,0,3,4,4,11,0xb2d08760
665834.68,7.0,5,4,4,3,11,0x3b9b322dd
146.6,1.0,11,1,2,3,6,0xb2d2b002
250000.0,2.0,5,3,3,3,9,0xb2d9491ed
782346.57,4.0,27,4,4,2,10,0xb2d32a41d
462.21,1.0,33,1,2,2,5,0xb2d6595ad
1.02,1.0,4,1,2,4,7,0xb2d83348
97.74,2.0,124,1,3,1,5,0xb2d08db2d
2381.38,1.0,0,1,2,4,7,0xb2d5cf2dd
150194.02,1.0,93,3,2,1,6,0xb2d4f684d
680121.49,2.0,192,4,3,1,8,0xb2d1e634
1000253.74,2.0,174,4,3,1,8,0xb2d3920f
4896.99,2.0,184,2,3,1,6,0xb2d0db82d
2150.48,1.0,4,1,2,4,7,0xb2d2d5f1
10.16,1.0,39,1,2,2,5,0xb2d27744
200122.67,3.0,0,3,4,4,11,0xb2d4b63f
90483.04,2.0,32,3,3,2,8,0xb2d1f280d
120041.68,4.0,55,3,4,2,9,0xb2d49210d
20070.9,1.0,92,2,2,1,5,0xb2d54c50d
1050247.88,3.0,3,4,4,4,12,0xb2d60430d
1987758.3,1.0,2,4,2,4,10,0xb2d3fde2
37270.97,2.0,92,2,3,1,6,0xb2d11da0
220000.0,2.0,21,3,3,2,8,0xb2d951e2d
1.48,2.0,36,1,3,2,6,0xb2d0b81bd
12823.12,1.0,8,2,2,3,7,0xb2d28018d
7054.53,1.0,17,2,2,2,6,0xb2d98725
2.64,1.0,75,1,2,1,4,0xb2d8d9a1
250761.55,3.0,31,3,4,2,9,0xb2d9dd8d
108009.63,3.0,14,3,4,3,10,0xb2d28be4d
745999.36,2.0,0,4,3,4,11,0xb2d6e3f5
100004.22,2.0,35,3,3,2,8,0xb2d9f5dd
104816.22,2.0,25,3,3,2,8,0xb2d0f7c2d
89.11,1.0,30,1,2,2,5,0xb2d6a8dcd
150231.08,2.0,148,3,3,1,7,0xb2d0b4d3
200084.51,2.0,194,3,3,1,7,0xb2d5dd02d
1051.48,1.0,203,1,2,1,4,0xb2d67338d
10221.35,1.0,92,2,2,1,5,0xb2d203f1
4630.36,1.0,4,2,2,4,8,0xb2d5cc4e
7008.78,1.0,1,2,2,4,8,0xb2d68e40
85122.56,4.0,3,3,4,4,11,0xb2d2ba5b
425916.37,5.0,39,4,4,2,10,0xb2d16991d
220506.72,4.0,31,3,4,2,9,0xb2d6ef11d
91486.96,1.0,2,3,2,4,9,0xb2d65972d
330061.95,4.0,130,4,4,1,9,0xb2d5b998
223059.26,7.0,6,3,4,3,10,0xb2d44b12d
3.4,1.0,9,1,2,3,6,0xb2d981cf
1891.64,1.0,92,1,2,1,4,0xb2d3984cd
3306312.39,13.0,5,4,4,3,11,0xb2d79299d
5938.08,1.0,5,2,2,3,7,0xb2d23bc8d
47000.71,2.0,27,2,3,2,7,0xb2d5f081d
0.0,1.0,4,1,2,4,7,0xb2d90d8b
300006.37,2.0,32,3,3,2,8,0xb2d92cebd
110800.37,1.0,3,3,2,4,9,0xb2d2a486d
61111.71,2.0,179,3,3,1,7,0xb2d5a97f
1219247.54,3.0,11,4,4,3,11,0xb2d26c28d
8198.01,1.0,21,2,2,2,6,0xb2da08aa
193009.42,1.0,12,3,2,3,8,0xb2d5ff74d
4355.49,1.0,1,2,2,4,8,0xb2d0b7aed
7209.61,1.0,19,2,2,2,6,0xb2d2b9ac
675.1,1.0,5,1,2,3,6,0xb2d1cbca
7.92,1.0,84,1,2,1,4,0xb2d30b69
4.63,1.0,19,1,2,2,5,0xb2d4f252
7699.06,1.0,0,2,2,4,8,0xb2d5a10fd
3297019.7,8.0,5,4,4,3,11,0xb2d1c34bd
100302.18,2.0,53,3,3,2,8,0xb2d585cf
50001.58,2.0,10,2,3,3,8,0xb2d960e1
2546934.99,4.0,1,4,4,4,12,0xb2d17311
17630.16,1.0,20,2,2,2,6,0xb2d6a574
40001.3,5.0,43,2,4,2,8,0xb2d6657ad
200724.87,2.0,8,3,3,3,9,0xb2d48b4a
2827.14,1.0,7,1,2,3,6,0xb2d6509ed
540238.57,4.0,20,4,4,2,10,0xb2d6271a
460256.59,7.0,46,4,4,2,10,0xb2d0868fd
400710.87,3.0,5,4,4,3,11,0xb2d5c2fc
5692.67,1.0,145,2,2,1,5,0xb2d55f08d
343153.09,7.0,3,4,4,4,12,0xb2d6e23bd
850073.02,4.0,2,4,4,4,12,0xb2d939bf
450062.26,3.0,14,4,4,3,11,0xb2d6940ad
262309.84,5.0,41,3,4,2,9,0xb2d1079e
200140.63,2.0,20,3,3,2,8,0xb2d58140d
18353.92,1.0,2,2,2,4,8,0xb2d653e2d
4162.96,1.0,16,2,2,2,6,0xb2d94f1a
193.56,1.0,1,1,2,4,7,0xb2d69660d
57181.32,2.0,119,3,3,1,7,0xb2d6839ed
501141.78,3.0,15,4,4,3,11,0xb2d8f74b
1000111.62,3.0,11,4,4,3,11,0xb2d5b856
180164.0,5.0,0,3,4,4,11,0xb2d78030d
392.05,1.0,9,1,2,3,6,0xb2d7acd0
1002195.95,8.0,58,4,4,2,10,0xb2d2fa16d
0.0,1.0,1,1,2,4,7,0xb2d503aa
9421.88,1.0,92,2,2,1,5,0xb2d5c7eed
50836.91,4.0,2,2,4,4,10,0x3b9ad6b8d
92001.9,2.0,0,3,3,4,10,0xb2d8de24d
20000.63,2.0,92,2,3,1,6,0xb2d62f3f
496000.0,7.0,3,4,4,4,12,0xb2d9d889
17100.79,1.0,7,2,2,3,7,0xb2d6c689
305000.0,5.0,6,4,4,3,11,0xb2da348e
1449.83,1.0,17,1,2,2,5,0xb2d3137d
446045.34,4.0,0,4,4,4,12,0xb2d3780f
600039.12,3.0,9,4,4,3,11,0xb2d91234d
9722.7,1.0,2,2,2,4,8,0xb2d8c621d
13958.34,1.0,0,2,2,4,8,0xb2d35375
35.71,1.0,8,1,2,3,6,0xb2d69449
6406.68,1.0,0,2,2,4,8,0xb2d6ad26
9.94,1.0,83,1,2,1,4,0xb2d83cb1
650100.61,5.0,87,4,4,1,9,0xb2d249cbd
7531.01,1.0,10,2,2,3,7,0xb2d4daa6d
71367.38,2.0,3,3,3,4,10,0xb2d41146d
1624.33,1.0,184,1,2,1,4,0xb2d21868d
3052.15,1.0,0,2,2,4,8,0xb2d9b08b
257139.88,2.0,7,3,3,3,9,0xb2d64fe8d
200000.0,2.0,14,3,3,3,9,0xb2d92028d
850072.78,4.0,129,4,4,1,9,0xb2d3534bd
35085.49,2.0,104,2,3,1,6,0xb2d08763d
3936.6,1.0,16,2,2,2,6,0xb2d9677b
6.71,1.0,6,1,2,3,6,0xb2d558ecd
167244.8,3.0,3,3,4,4,11,0xb2d4d1a7
4.91,1.0,55,1,2,2,5,0xb2d68acd
150102.18,3.0,70,3,4,1,8,0xb2d25f73d
40044.27,3.0,136,2,4,1,7,0xb2d43d32
101154.88,2.0,182,3,3,1,7,0xb2d5e1aed
345.63,1.0,1,1,2,4,7,0xb2d9129ed
52927.26,1.0,22,3,2,2,7,0xb2d5c7c1
102390.9,2.0,10,3,3,3,9,0xb2d18034
51542.81,2.0,53,2,3,2,7,0xb2d10caed
856.46,1.0,0,1,2,4,7,0xb2d4df1a
311166.18,3.0,20,4,4,2,10,0xb2d9f5e4
6185.49,2.0,11,2,3,3,8,0xb2d2cc43d
150152.97,4.0,34,3,4,2,9,0xb2d6542fd
250953.31,3.0,25,3,4,2,9,0xb2d5a732d
281990.1,4.0,52,3,4,2,9,0xb2d64641d
1944.03,1.0,2,1,2,4,7,0xb2d3f92cd
610801.93,4.0,41,4,4,2,10,0xb2d26ec2d
50002.49,2.0,132,2,3,1,6,0xb2d2ecabd
811167.51,4.0,2,4,4,4,12,0xb2d14c5bd
163171.56,8.0,12,3,4,3,10,0xb2d2b55fd
530017.5,3.0,39,4,4,2,10,0xb2d10491d
208000.0,10.0,9,3,4,3,10,0xb2d2242e
3139.0,1.0,0,2,2,4,8,0xb2d68126d
3.37,1.0,15,1,2,3,6,0xb2d2d156d
390054.41,1.0,4,4,2,4,10,0xb2d4f1d1d
1336566.83,10.0,126,4,4,1,9,0xb2d1eeebd
1941.48,1.0,92,1,2,1,4,0xb2d2e4a0d
22190.24,1.0,19,2,2,2,6,0xb2d6a574d
1560619.42,10.0,0,4,4,4,12,0xb2d5c5bdd
500015.83,2.0,69,4,3,1,8,0xb2d8e90fd
38107.08,2.0,0,2,3,4,9,0xb2d3ed17
29244.31,2.0,112,2,3,1,6,0xb2d59db8
865.13,1.0,9,1,2,3,6,0xb2d82987d
200003.84,2.0,3,3,3,4,10,0xb2d6db7ed
501776.04,2.0,35,4,3,2,9,0xb2d9fc1d
403033.86,6.0,53,4,4,2,10,0xb2d11ea7d
251819.25,2.0,65,3,3,2,8,0xb2d74854
4.91,1.0,10,1,2,3,6,0xb2d396bd
318552.11,1.0,0,4,2,4,10,0xb2d1a9bbd
130002.43,3.0,202,3,4,1,8,0xb2d6863c
352000.0,2.0,21,4,3,2,9,0xb2d78b6dd
1931.29,1.0,92,1,2,1,4,0xb2d0fc67d
1935062.44,20.0,0,4,4,4,12,0xb2d22f84d
200041.75,2.0,7,3,3,3,9,0xb2d90c4ad
62188.58,2.0,4,3,3,4,10,0xb2d1de85d
4259.82,1.0,92,2,2,1,5,0x3b9b4419d
168711.61,3.0,249,3,4,1,8,0xb2d60cd1d
407803.29,9.0,4,4,4,4,12,0xb2d1b630d
36709.62,1.0,1,2,2,4,8,0xb2da126c
276914.38,3.0,7,3,4,3,10,0xb2d5ea47d
83451.9,1.0,28,3,2,2,7,0xb2d4271e
34978.5,2.0,8,2,3,3,8,0xb2d58bd3
1168.47,1.0,12,1,2,3,6,0xb2d6bcad
4849.12,1.0,0,2,2,4,8,0xb2d78e15d
504206.74,2.0,76,4,3,1,8,0xb2d5d4c6d
925090.08,7.0,21,4,4,2,10,0x3b9b3fe6d
8670.33,1.0,92,2,2,1,5,0xb2d3099ed
3.22,1.0,14,1,2,3,6,0xb2d17480d
99.91,1.0,1,1,2,4,7,0xb2d9ca4c
230883.86,14.0,0,3,4,4,11,0xb2d5bd80d
20092.01,2.0,179,2,3,1,6,0xb2d5833d
280009.07,1.0,0,3,2,4,9,0xb2d697ef
401421.1,3.0,1,4,4,4,12,0xb2d9a278
840088.27,3.0,25,4,4,2,10,0xb2d63ef1d
4360.1,1.0,29,2,2,2,6,0xb2d13abc
1675420.83,2.0,92,4,3,1,8,0x3b9b2985d
2760000.0,15.0,1,4,4,4,12,0xb2d56a2ad
108571.46,3.0,108,3,4,1,8,0xb2d0e65fd
1.04,1.0,1,1,2,4,7,0xb2d781ba
30452.08,1.0,0,2,2,4,8,0xb2d2d685
1470.1,4.0,2,1,4,4,9,0xb2d090fed
2608467.99,1.0,26,4,2,2,8,0xb2d93063d
2.8,1.0,0,1,2,4,7,0xb2d68816
437057.45,4.0,13,4,4,3,11,0xb2d622b3d
14683.26,1.0,56,2,2,2,6,0xb2d37522
5981.73,1.0,196,2,2,1,5,0xb2d6f2a1
10006.33,1.0,69,2,2,1,5,0xb2d8ec90d
7206.42,1.0,19,2,2,2,6,0xb2d68551d
100003.37,3.0,55,3,4,2,9,0xb2d53392d
10718.78,1.0,169,2,2,1,5,0xb2d2579dd
4829.01,1.0,92,2,2,1,5,0xb2d3edbbd
133254.4,3.0,0,3,4,4,11,0xb2d10d01d
103.84,1.0,7,1,2,3,6,0xb2d44cf6
2781747.32,7.0,0,4,4,4,12,0xb2d0fc77
19850.46,4.0,6,2,4,3,9,0xb2d34461d
0.05,1.0,33,1,2,2,5,0xb2d34571d
81638.14,1.0,92,3,2,1,6,0xb2d5114e
183553.09,3.0,60,3,4,2,9,0xb2d349b3d
0.45,1.0,0,1,2,4,7,0xb2d32861
7006.2,1.0,14,2,2,3,7,0xb2d628af
100109.65,1.0,0,3,2,4,9,0xb2d54c38
1553.68,1.0,0,1,2,4,7,0xb2d5d267
244.72,1.0,0,1,2,4,7,0xb2d6c2d1
550025.53,10.0,0,4,4,4,12,0xb2d1ffc7d
274073.23,3.0,13,3,4,3,10,0xb2d31768
523107.16,1.0,2,4,2,4,10,0xb2da0310
80075.2,4.0,0,3,4,4,11,0xb2d6d536d
102908.02,1.0,33,3,2,2,7,0xb2d613e6d
13626.88,1.0,3,2,2,4,8,0xb2d6e922d
16586.25,1.0,0,2,2,4,8,0xb2d23e3a
100462.75,1.0,4,3,2,4,9,0xb2d6276ad
1123.54,1.0,10,1,2,3,6,0xb2d1fa1b
383340.97,3.0,5,4,4,3,11,0xb2d0c2c2d
47293.44,1.0,6,2,2,3,7,0xb2d34a39d
505.39,1.0,20,1,2,2,5,0xb2d6920b
103246.31,3.0,32,3,4,2,9,0xb2d0d270
27.47,1.0,27,1,2,2,5,0xb2d5b42ad
514224.48,2.0,103,4,3,1,8,0xb2d6d014d
11436.24,2.0,18,2,3,2,7,0xb2d925ecd
250000.13,2.0,24,3,3,2,8,0xb2d2fb79d
190774.85,3.0,34,3,4,2,9,0xb2d92094d
100006.82,2.0,50,3,3,2,8,0xb2d4c143
60004.46,3.0,200,3,4,1,8,0xb2d0cde9
5.95,1.0,8,1,2,3,6,0xb2d5991f
268727.15,3.0,1,3,4,4,11,0xb2d54f1cd
15983.4,1.0,185,2,2,1,5,0xb2d2983f
36801.64,1.0,0,2,2,4,8,0xb2d3132d
103557.46,2.0,0,3,3,4,10,0xb2d626a4d
20036.08,2.0,6,2,3,3,8,0xb2d5e789d
390010.04,7.0,20,4,4,2,10,0xb2d16bc2d
5727.73,1.0,0,2,2,4,8,0xb2d58e5cd
362780.37,1.0,0,4,2,4,10,0xb2d112fdd
168342.05,2.0,0,3,3,4,10,0xb2d5844ed
3406.8,1.0,4,2,2,4,8,0xb2d0c9ee
40006.22,2.0,200,2,3,1,6,0xb2d15776d
36335.59,4.0,3,2,4,4,10,0xb2d562cf
119001.0,1.0,4,3,2,4,9,0xb2da53e2
300067.78,2.0,7,3,3,3,9,0xb2d92020d
451012.04,4.0,6,4,4,3,11,0xb2d18832d
15.12,1.0,15,1,2,3,6,0x3b9b3f22
520.39,1.0,3,1,2,4,7,0xb2d6b507d
6237.47,3.0,0,2,4,4,10,0x3b9b42df
281004.04,5.0,9,3,4,3,10,0xb2d50426d
100004287.22,5.0,12,4,4,3,11,0xb2da05fb
1941.38,1.0,92,1,2,1,4,0xb2d2b116d
41528.97,1.0,11,2,2,3,7,0xb2d438bb
350021.29,2.0,34,4,3,2,9,0xb2d91248
120002.53,2.0,31,3,3,2,8,0xb2d93920d
674062.16,4.0,4,4,4,4,12,0xb2d6c0e4d
50002.94,2.0,10,2,3,3,8,0xb2d4ee62
0.54,3.0,63,1,4,2,7,0xb2d3bf85d
1490219.15,6.0,11,4,4,3,11,0xb2d6cce5d
330086.54,2.0,6,4,3,3,10,0xb2d92dcad
447568.15,4.0,0,4,4,4,12,0xb2d1eaead
1299025.32,11.0,27,4,4,2,10,0xb2d3ba3fd
560261.01,5.0,21,4,4,2,10,0x3b9ae041d
20959.78,2.0,64,2,3,2,7,0xb2d2b195d
200000.0,2.0,95,3,3,1,7,0xb2d348b4
1593.77,2.0,92,1,3,1,5,0xb2d0b09ad
444004.24,6.0,0,4,4,4,12,0xb2d6c08bd
11251.33,1.0,11,2,2,3,7,0x3b9ada89
77.22,1.0,9,1,2,3,6,0xb2d91e44d
110551.8,4.0,11,3,4,3,10,0xb2d1a67ad
2804868.6,35.0,0,4,4,4,12,0xb2d06f76d
597.16,1.0,71,1,2,1,4,0xb2d5f5f2d
9.91,1.0,13,1,2,3,6,0xb2d6876ed
151743.24,2.0,55,3,3,2,8,0xb2d6cc2e
20001.66,1.0,25,2,2,2,6,0xb2d53523
251491.03,3.0,73,3,4,1,8,0xb2d272c3
1881.12,1.0,184,1,2,1,4,0xb2d0679dd
510664.92,2.0,194,4,3,1,8,0xb2d8149ed
205037.61,2.0,208,3,3,1,7,0xb2d47330d
4203.44,1.0,0,2,2,4,8,0xb2d28b4dd
20994.49,1.0,82,2,2,1,5,0xb2d59f67d
6559.38,1.0,7,2,2,3,7,0xb2da31ff
285000.61,3.0,5,3,4,3,10,0xb2d213ec
91000.0,4.0,0,3,4,4,11,0xb2d5bcbdd
114924.79,1.0,28,3,2,2,7,0xb2d78569d
1088.82,2.0,184,1,3,1,5,0x3b9ae272d
31023.96,1.0,12,2,2,3,7,0xb2d6868ad
411.4,1.0,10,1,2,3,6,0xb2d42aba
20.56,1.0,13,1,2,3,6,0xb2d94f29
235075.23,3.0,1,3,4,4,11,0xb2d0cc27
6214.17,1.0,8,2,2,3,7,0xb2d260b1d
400796.76,3.0,35,4,4,2,10,0xb2d23936d
1138.31,1.0,0,1,2,4,7,0xb2d91f78
450190.06,4.0,21,4,4,2,10,0xb2d59b8bd
20000.0,2.0,0,2,3,4,9,0xb2da56d9
200006.86,5.0,0,3,4,4,11,0xb2d9a7ee
227455.12,5.0,24,3,4,2,9,0xb2d2fa8bd
1065.43,1.0,92,1,2,1,4,0xb2d1a069d
250030.63,2.0,10,3,3,3,9,0xb2d3784cd
1491.0,1.0,4,1,2,4,7,0xb2d55447
389700.0,7.0,0,4,4,4,12,0xb2d06730d
10337.5,1.0,15,2,2,3,7,0xb2d78787d
9.83,1.0,48,1,2,2,5,0xb2d3004d
1352.94,1.0,1,1,2,4,7,0xb2d5a0a6
25268.42,1.0,28,2,2,2,6,0xb2d794ded
14674.27,1.0,0,2,2,4,8,0xb2d54eeed
1023.95,1.0,0,1,2,4,7,0xb2d5d5f8
294179.36,15.0,1,3,4,4,11,0xb2d578c7d
10000.21,2.0,92,2,3,1,6,0xb2d644de
1971.89,1.0,0,1,2,4,7,0xb2d295fbd
230062.28,4.0,99,3,4,1,8,0xb2d27dc6d
20001.13,2.0,28,2,3,2,7,0xb2d94f85
201864.22,2.0,39,3,3,2,8,0xb2d40e29d
50053.08,2.0,171,2,3,1,6,0xb2d5ff06d
355490.6,2.0,123,4,3,1,8,0xb2d5e7c2d
138542.66,1.0,92,3,2,1,6,0x3b9b38c5d
1.9,1.0,54,1,2,2,5,0xb2d9aeb0
1688274.72,17.0,0,4,4,4,12,0xb2d6a8aed
2889.65,1.0,184,2,2,1,5,0xb2d32276d
56000.0,4.0,45,3,4,2,9,0xb2d65404d
669000.48,9.0,1,4,4,4,12,0xb2d5f31cd
0.02,1.0,19,1,2,2,5,0xb2d39aaf
1195.28,1.0,184,1,2,1,4,0xb2d0c9fad
23470.81,3.0,0,2,4,4,10,0xb2d0f376d
130294.68,4.0,28,3,4,2,9,0xb2d589ded
693.26,1.0,49,1,2,2,5,0xb2d21a28
379006.66,2.0,217,4,3,1,8,0xb2d42cdcd
5471539.8,18.0,0,4,4,4,12,0x3b9b12c1d
400000.0,2.0,2,4,3,4,11,0xb2da6597
500007.33,5.0,3,4,4,4,12,0xb2d2889bd
654708.48,3.0,126,4,4,1,9,0xb2d21aadd
1977019.26,4.0,22,4,4,2,10,0xb2d24405d
440055.58,6.0,1,4,4,4,12,0xb2d393e8d
335193.27,4.0,21,4,4,2,10,0xb2d0bd56d
316.41,1.0,9,1,2,3,6,0xb2d6a8cfd
60002.55,2.0,55,3,3,2,8,0xb2d6c155
5.75,1.0,10,1,2,3,6,0xb2d17831d
1101.76,1.0,161,1,2,1,4,0xb2d6ace4
200014.22,3.0,82,3,4,1,8,0xb2d1526c
814.88,1.0,17,1,2,2,5,0xb2d26757d
317101.39,8.0,2,4,4,4,12,0xb2d10e05d
305100.08,5.0,5,4,4,3,11,0xb2d25909d
68335.93,1.0,7,3,2,3,8,0xb2d58062d
433584.48,5.0,20,4,4,2,10,0xb2d61683
16384.13,1.0,2,2,2,4,8,0xb2d601acd
270000.0,2.0,1,3,3,4,10,0xb2da6676
200018.45,2.0,6,3,3,3,9,0xb2d68f40
116443.35,6.0,0,3,4,4,11,0x3b9b3a81d
3717064.31,9.0,0,4,4,4,12,0xb2d11a11
180009.24,3.0,122,3,4,1,8,0xb2d389e9d
805343.46,4.0,24,4,4,2,10,0xb2d90cc4d
400009.08,3.0,9,4,4,3,11,0xb2d298d2
52623.36,1.0,28,3,2,2,7,0xb2d62be8
487328.98,3.0,6,4,4,3,11,0xb2d8e1e6d
1021467.82,13.0,5,4,4,3,11,0xb2d086d1d
850009.93,10.0,28,4,4,2,10,0xb2d5f9a8d
503552.62,2.0,8,4,3,3,10,0xb2d8eccad
12.24,1.0,44,1,2,2,5,0xb2d6b56dd
202403.76,3.0,31,3,4,2,9,0xb2d672db
1558.95,1.0,184,1,2,1,4,0xb2d33c90d
630003.09,13.0,6,4,4,3,11,0xb2d073e1
5185.92,1.0,144,2,2,1,5,0xb2d2d9d6d
545000.01,5.0,1,4,4,4,12,0xb2d57babd
20105.51,1.0,10,2,2,3,7,0xb2d3faeb
548.61,1.0,0,1,2,4,7,0xb2d319ac
686602.43,15.0,0,4,4,4,12,0xb2d0d4b0d
1498.34,1.0,4,1,2,4,7,0xb2d8f012
2742.99,1.0,0,1,2,4,7,0xb2d57f40d
500000.02,3.0,13,4,4,3,11,0xb2d9e77a
100101.98,2.0,10,3,3,3,9,0xb2d95d4fd
8020.34,1.0,21,2,2,2,6,0xb2d69c71d
208520.41,1.0,9,3,2,3,8,0xb2d8d144
85315.8,1.0,0,3,2,4,9,0xb2d43632d
321164.38,15.0,9,4,4,3,11,0xb2d58596d
652338.77,4.0,33,4,4,2,10,0xb2d8f888d
3.31,1.0,39,1,2,2,5,0xb2d170ae
96.92,2.0,0,1,3,4,8,0xb2d30852
3886.95,1.0,20,2,2,2,6,0xb2d6a017d
50007.21,2.0,4,2,3,4,9,0xb2da2e34
84576.79,1.0,9,3,2,3,8,0xb2d901a6
100955.6,3.0,4,3,4,4,11,0xb2d54e3fd
2741.7,1.0,184,1,2,1,4,0xb2d2afc2
224634.67,3.0,0,3,4,4,11,0xb2d12ae6
4036.76,1.0,92,2,2,1,5,0xb2d17f4cd
62310.98,2.0,6,3,3,3,9,0xb2d4ae0a
250079.24,4.0,11,3,4,3,10,0xb2d20ebcd
18.22,1.0,4,1,2,4,7,0xb2d92122d
240074.07,6.0,0,3,4,4,11,0x3b9b2511d
245005.12,4.0,77,3,4,1,8,0xb2d55859d
3610.91,1.0,5,2,2,3,7,0xb2d7ae70d
356516.24,2.0,42,4,3,2,9,0xb2d3e4ead
1715.73,1.0,251,1,2,1,4,0xb2d1ffae
20166.97,1.0,92,2,2,1,5,0xb2d20d3ed
2375.56,1.0,9,1,2,3,6,0xb2d420c7d
551832.99,4.0,3,4,4,4,12,0xb2d9bae8
76000.0,1.0,6,3,2,3,8,0xb2d8d483
245740.91,3.0,52,3,4,2,9,0xb2d558cf
401.29,3.0,33,1,4,2,7,0xb2d07b48d
33622.48,1.0,0,2,2,4,8,0xb2d36783d
8890.83,1.0,0,2,2,4,8,0xb2d15ea7
8633.33,1.0,46,2,2,2,6,0xb2d0a788d
350043.23,2.0,19,4,3,2,9,0xb2d9da11
16522.12,1.0,22,2,2,2,6,0xb2d69494d
85059.4,2.0,31,3,3,2,8,0xb2d43005d
93006.09,4.0,14,3,4,3,10,0xb2d4b6a8d
50005.83,2.0,9,2,3,3,8,0xb2d5d715
51678.1,1.0,184,2,2,1,5,0xb2d2e4e2d
1800840.47,3.0,92,4,4,1,9,0xb2d216add
200094.65,2.0,11,3,3,3,9,0xb2d64201
80294.07,1.0,10,3,2,3,8,0xb2d3e924d
4.15,1.0,29,1,2,2,5,0xb2d2faea
366000.99,5.0,1,4,4,4,12,0xb2d59e6ad
902.34,1.0,0,1,2,4,7,0xb2d1a573d
36692.91,2.0,119,2,3,1,6,0xb2d61fd3d
101006.17,2.0,137,3,3,1,7,0xb2d61235d
575233.34,2.0,90,4,3,1,8,0xb2d1dffe
111309.32,2.0,4,3,3,4,10,0xb2d4d924
140042.08,2.0,171,3,3,1,7,0xb2d5f947
55099.08,2.0,0,3,3,4,10,0xb2d960c4
323.64,1.0,2,1,2,4,7,0xb2d40f41
271016.42,4.0,66,3,4,2,9,0xb2d2ba15d
1123208.85,9.0,32,4,4,2,10,0xb2d1796cd
7005.68,1.0,41,2,2,2,6,0xb2d64c14
500000.0,1.0,0,4,2,4,10,0xb2da6ab1
862053.16,7.0,104,4,4,1,9,0xb2d25676d
306131.08,2.0,1,4,3,4,11,0xb2da0e2c
60001.54,2.0,70,3,3,1,7,0xb2d5aab5
321041.58,5.0,69,4,4,1,9,0xb2d33b16d
30090.73,3.0,27,2,4,2,8,0xb2d992b0
262001.64,2.0,38,3,3,2,8,0xb2d429d9d
11632.86,1.0,10,2,2,3,7,0xb2d2b5e6
7117.31,1.0,92,2,2,1,5,0xb2d24008d
285074.65,4.0,144,3,4,1,8,0xb2d3f255d
2.12,1.0,47,1,2,2,5,0xb2d6d0d6
3033.59,1.0,184,2,2,1,5,0xb2d2ced8d
230006.73,3.0,6,3,4,3,10,0xb2d8d8e6d
8178.36,1.0,4,2,2,4,8,0xb2d6a598
121154.32,4.0,143,3,4,1,8,0xb2d5a54ed
50000.53,2.0,228,2,3,1,6,0xb2d6f6d6
14844.77,1.0,25,2,2,2,6,0xb2d1f0b5d
2420.69,1.0,9,1,2,3,6,0xb2d6aa8dd
107.4,1.0,0,1,2,4,7,0xb2d1e7e7d
1290045.76,5.0,101,4,4,1,9,0xb2d3ad92d
520907.86,3.0,1,4,4,4,12,0xb2d50b4fd
170009.25,3.0,24,3,4,2,9,0xb2d5f9d2d
9605.63,1.0,10,2,2,3,7,0xb2d92d54
26004.26,3.0,39,2,4,2,8,0xb2d4ce27d
1793000.0,10.0,0,4,4,4,12,0xb2d2b768d
361280.53,3.0,32,4,4,2,10,0xb2d5cf05d
950003.69,3.0,0,4,4,4,12,0xb2d922fdd
3150024.0,7.0,0,4,4,4,12,0xb2d3af6bd
133.64,1.0,6,1,2,3,6,0xb2d2c086
100062.48,2.0,217,3,3,1,7,0xb2d2805cd
200004.0,2.0,4,3,3,4,10,0xb2d19291
0.0,1.0,70,1,2,1,4,0xb2d5a548
528879.87,2.0,189,4,3,1,8,0xb2d52713d
50939.7,1.0,0,2,2,4,8,0xb2d60009d
21869.28,2.0,35,2,3,2,7,0xb2d64a94d
25052.55,1.0,1,2,2,4,8,0xb2d3f630d
45083.75,1.0,20,2,2,2,6,0xb2d27dc1d
138711.19,5.0,0,3,4,4,11,0xb2d06724d
1201.81,1.0,1,1,2,4,7,0xb2d78d27
109606.51,2.0,144,3,3,1,7,0xb2d32d7e
220000.48,2.0,8,3,3,3,9,0xb2d96e6ad
2.9,1.0,29,1,2,2,5,0xb2d5d7a5
3586.05,1.0,1,2,2,4,8,0xb2d1ebcad
8050.21,2.0,92,2,3,1,6,0xb2d62518d
1000010.56,2.0,41,4,3,2,9,0xb2d921f1d
987.66,1.0,10,1,2,3,6,0xb2d538a9
2529.78,1.0,0,1,2,4,7,0xb2d96096d
356486.53,7.0,0,4,4,4,12,0xb2d160c1
15.69,1.0,20,1,2,2,5,0xb2d8f965
1312.32,1.0,10,1,2,3,6,0xb2d3c261d
402270.3,3.0,34,4,4,2,10,0xb2d9a781
1650713.64,10.0,12,4,4,3,11,0xb2d24f76d
7.61,1.0,20,1,2,2,5,0xb2d0e48ed
24259.44,2.0,18,2,3,2,7,0xb2d15dbad
1368001.85,2.0,0,4,3,4,11,0xb2d28aa0d
607001.22,4.0,10,4,4,3,11,0xb2d11396d
0.15,1.0,5,1,2,3,6,0xb2d7f54d
90328.66,1.0,19,3,2,2,7,0xb2d22399
430712.97,3.0,55,4,4,2,10,0xb2d903d3
1003499.34,1.0,0,4,2,4,10,0xb2d92268
31008.28,2.0,54,2,3,2,7,0xb2d63769
5879.73,1.0,92,2,2,1,5,0xb2d43d8ad
100616.63,2.0,199,3,3,1,7,0xb2d424d2d
1918.45,1.0,68,1,2,1,4,0xb2d5b997
5707.01,1.0,92,2,2,1,5,0xb2d31264d
500049.6,3.0,114,4,4,1,9,0xb2d3ab92
0.79,1.0,4,1,2,4,7,0xb2d1f435d
1524.05,1.0,184,1,2,1,4,0xb2d11c7ad
51.65,1.0,72,1,2,1,4,0xb2d59f18
106893.01,1.0,17,3,2,2,7,0xb2d6bdaad
48.27,1.0,53,1,2,2,5,0xb2d625e5d
6994.59,1.0,29,2,2,2,6,0xb2d923e3
438000.0,14.0,1,4,4,4,12,0xb2d57ec9d
57868.51,1.0,241,3,2,1,6,0xb2d359d9d
201484.47,2.0,67,3,3,1,7,0xb2d4ee02d
20616.42,2.0,4,2,3,4,9,0xb2d6222ed
13496.57,1.0,2,2,2,4,8,0xb2d6ad49d
350000.01,3.0,3,4,4,4,12,0xb2d43134d
908.29,1.0,0,1,2,4,7,0xb2d382b5d
226346.79,3.0,92,3,4,1,8,0xb2d3954dd
414108.88,3.0,111,4,4,1,9,0xb2d5eecdd
7528.56,1.0,5,2,2,3,7,0xb2d7c6ded
301069.94,2.0,32,4,3,2,9,0xb2d68528d
302174.92,2.0,22,4,3,2,9,0xb2d3c3b0
955066.84,7.0,11,4,4,3,11,0xb2d1b242
490103.46,4.0,80,4,4,1,9,0xb2d069cbd
5633.16,1.0,92,2,2,1,5,0xb2d34f4cd
65.88,1.0,11,1,2,3,6,0xb2d71a45
11318.9,1.0,184,2,2,1,5,0xb2d35061d
5218.75,1.0,189,2,2,1,5,0xb2d691a7
2392.17,1.0,10,1,2,3,6,0xb2d96045
4201207.36,6.0,1,4,4,4,12,0xb2d6cbddd
161701.06,4.0,52,3,4,2,9,0xb2d3d5b6
2.42,1.0,45,1,2,2,5,0xb2d94b28
56682.76,2.0,181,3,3,1,7,0xb2d46370d
5342.84,1.0,92,2,2,1,5,0xb2d4f870
500018.35,3.0,0,4,4,4,12,0xb2d908fdd
8259.29,1.0,0,2,2,4,8,0xb2d6bff4
200038.0,2.0,11,3,3,3,9,0xb2d9e19c
146011.38,3.0,73,3,4,1,8,0xb2d4091e
19107.86,1.0,5,2,2,3,7,0xb2d2fdb0
38084.48,7.0,73,2,4,1,7,0xb2d534f0d
10000.42,2.0,181,2,3,1,6,0xb2d6b222d
560032.58,2.0,12,4,3,3,10,0xb2d67c4e
23.65,1.0,21,1,2,2,5,0xb2d2a4b0
200002.39,3.0,15,3,4,3,10,0xb2d8e067d
100971.53,2.0,3,3,3,4,10,0xb2d569e5d
15598.51,1.0,184,2,2,1,5,0xb2d45eb7d
36200.92,2.0,42,2,3,2,7,0xb2d3fb32
1706.84,1.0,19,1,2,2,5,0xb2d68e39d
13.08,1.0,20,1,2,2,5,0xb2d68737
1110095.18,3.0,224,4,4,1,9,0xb2d64507d
47084.92,3.0,25,2,4,2,8,0xb2d5e086d
7.89,1.0,24,1,2,2,5,0xb2d24336
6.73,1.0,64,1,2,2,5,0xb2d65446d
520057.14,4.0,1,4,4,4,12,0xb2d403c9d
400003.06,3.0,6,4,4,3,11,0xb2da0dbc
809042.96,9.0,9,4,4,3,11,0xb2d3c569d
400000.0,7.0,8,4,4,3,11,0xb2d94129d
3014198.38,2.0,3,4,3,4,11,0xb2d18494
375615.43,3.0,0,4,4,4,12,0xb2d52728d
2264.4,1.0,88,1,2,1,4,0xb2d1df1c
7829.48,1.0,76,2,2,1,5,0xb2d5822e
765432.62,7.0,20,4,4,2,10,0xb2d11014
160013.69,2.0,114,3,3,1,7,0xb2d51375
231.13,1.0,0,1,2,4,7,0xb2d1653bd
994.84,1.0,0,1,2,4,7,0xb2d5c771
1160.04,1.0,13,1,2,3,6,0xb2d0ece9
200265.22,4.0,137,3,4,1,8,0xb2d2d5b6d
0.0,3.0,84,1,4,1,6,0xb2d067e1d
100001.06,2.0,80,3,3,1,7,0xb2d8d774d
50116.38,1.0,143,2,2,1,5,0xb2d8df6cd
697.67,1.0,79,1,2,1,4,0xb2d23949d
8.02,1.0,105,1,2,1,4,0xb2d95545d
21.11,1.0,18,1,2,2,5,0xb2d9572b
220093.36,5.0,32,3,4,2,9,0xb2d23804d
195936.6,10.0,0,3,4,4,11,0xb2d09f85d
12.73,1.0,15,1,2,3,6,0xb2d6452cd
5938568.11,8.0,0,4,4,4,12,0xb2d6c44dd
8073.61,1.0,92,2,2,1,5,0xb2d2a893d
1639.48,1.0,10,1,2,3,6,0xb2d74c75d
6.69,1.0,52,1,2,2,5,0xb2d6afd6
120000.0,4.0,1,3,4,4,11,0xb2d51e7dd
2004.92,1.0,12,1,2,3,6,0xb2d4117e
200000.0,2.0,4,3,3,4,10,0xb2da5901
103865.2,2.0,116,3,3,1,7,0xb2d56bc3d
520277.33,6.0,0,4,4,4,12,0xb2d5b6fcd
552396.43,6.0,12,4,4,3,11,0xb2d0ad6ed
92371.86,2.0,18,3,3,2,8,0xb2d60cae
974412.21,3.0,101,4,4,1,9,0xb2d12d8bd
230004.87,2.0,172,3,3,1,7,0xb2d12f32d
261530.28,3.0,164,3,4,1,8,0xb2d40672d
94698.93,2.0,0,3,3,4,10,0xb2d0ed93d
100003.7,3.0,11,3,4,3,10,0xb2da0657
796043.86,3.0,129,4,4,1,9,0xb2d31fa7
350025.01,4.0,4,4,4,4,12,0xb2d9b072
3057083.2,9.0,10,4,4,3,11,0xb2d32fbcd
204496.15,3.0,13,3,4,3,10,0xb2d0b130d
64000.68,2.0,41,3,3,2,8,0xb2d92379
50070.25,2.0,1,2,3,4,9,0xb2d2824bd
341783.26,4.0,19,4,4,2,10,0xb2d57ce8d
25000.87,2.0,199,2,3,1,6,0xb2d5d082d
771.82,1.0,10,1,2,3,6,0xb2d58901
98.52,1.0,24,1,2,2,5,0xb2d2846dd
6.43,1.0,184,1,2,1,4,0xb2d2bcb3d
4.44,2.0,53,1,3,2,6,0xb2d9d1b0
400068.52,2.0,139,4,3,1,8,0xb2d2d252d
50002.11,2.0,14,2,3,3,8,0xb2da354b
30852.47,2.0,7,2,3,3,8,0xb2d577f4d
285545.46,8.0,28,3,4,2,9,0xb2d5f096d
350085.14,8.0,76,4,4,1,9,0xb2d1535ed
65008.73,4.0,11,3,4,3,10,0xb2d43a02
112774.91,1.0,33,3,2,2,7,0xb2d5cfa2d
302070.61,3.0,11,4,4,3,11,0xb2d12ec6
122134.74,2.0,165,3,3,1,7,0xb2d32af2d
230373.52,4.0,182,3,4,1,8,0xb2d1113dd
20026.6,2.0,11,2,3,3,8,0xb2d1f0d4d
585021.36,4.0,101,4,4,1,9,0xb2d51725d
116948.74,7.0,17,3,4,2,9,0xb2d0bcf3d
100012.14,2.0,95,3,3,1,7,0xb2d4663dd
143209.95,2.0,33,3,3,2,8,0xb2d5af83d
1400000.0,3.0,29,4,4,2,10,0xb2d900d6d
4086.81,1.0,1,2,2,4,8,0xb2d25860
908004.42,2.0,2,4,3,4,11,0x3b9b28abd
2000.84,1.0,0,1,2,4,7,0xb2d701cad
47.86,1.0,0,1,2,4,7,0xb2d8c504
310007.25,2.0,116,4,3,1,8,0xb2d5227fd
1473.17,1.0,0,1,2,4,7,0xb2d5c05f
1004040.54,8.0,27,4,4,2,10,0xb2d1c677d
6160655.13,3.0,53,4,4,2,10,0xb2d5b733d
104939.64,2.0,3,3,3,4,10,0xb2d58ca8
24.34,1.0,61,1,2,2,5,0xb2d7850c
2951832.18,6.0,10,4,4,3,11,0xb2d339c6d
233831.88,2.0,87,3,3,1,7,0xb2d122d7d
210004.43,2.0,25,3,3,2,8,0xb2da10a1
42.31,1.0,81,1,2,1,4,0xb2d3944e
416004.28,4.0,31,4,4,2,10,0xb2d37224d
389701.99,4.0,8,4,4,3,11,0xb2d39868d
302.1,1.0,0,1,2,4,7,0xb2d46562
600959.66,3.0,41,4,4,2,10,0xb2d2e790d
83830.79,2.0,221,3,3,1,7,0xb2d41f30d
973.81,1.0,3,1,2,4,7,0xb2d3239a
3220006.57,4.0,1,4,4,4,12,0xb2d59039
544586.42,5.0,6,4,4,3,11,0xb2d3a2aed
5810.92,1.0,4,2,2,4,8,0xb2d60015
52646.27,2.0,27,3,3,2,8,0xb2d29f5ad
800000.11,3.0,7,4,4,3,11,0xb2d5e43c
332588.31,2.0,0,4,3,4,11,0xb2d31e00
1024.86,1.0,8,1,2,3,6,0xb2d2c3c0d
51494.21,2.0,196,2,3,1,6,0xb2d5aabad
3032.69,1.0,9,2,2,3,7,0xb2d21ef8d
800713.46,5.0,7,4,4,3,11,0xb2d27f6ad
101000.54,3.0,42,3,4,2,9,0xb2d7f230d
295428.42,1.0,7,3,2,3,8,0xb2d93017
985653.46,1.0,0,4,2,4,10,0xb2d65766d
1228.98,1.0,57,1,2,2,5,0xb2d5e58ad
3888.59,1.0,10,2,2,3,7,0xb2d1ddc8d
10289.25,1.0,5,2,2,3,7,0xb2d37c4ad
430021.25,7.0,18,4,4,2,10,0xb2d45c97
21222.0,2.0,66,2,3,2,7,0xb2d6b223d
70017.08,3.0,92,3,4,1,8,0xb2d1d155d
1145.07,2.0,184,1,3,1,5,0xb2d248bdd
215.55,1.0,13,1,2,3,6,0xb2d21ce8
1917272.84,3.0,53,4,4,2,10,0xb2d26156d
5007840.11,2.0,0,4,3,4,11,0xb2d64d2ad
135417.79,6.0,0,3,4,4,11,0xb2d0a942d
7607.92,1.0,6,2,2,3,7,0xb2d1bd99d
312877.75,3.0,184,4,4,1,9,0x3b9b25ded
1404.27,3.0,0,1,4,4,9,0x3b9b18ed
105212.15,4.0,1,3,4,4,11,0xb2d61884d
163.13,1.0,3,1,2,4,7,0xb2d8f065
206668.38,5.0,122,3,4,1,8,0x3b9adb82d
23490.99,1.0,0,2,2,4,8,0xb2d30f56d
47.22,3.0,18,1,4,2,7,0xb2d08e59d
245.95,1.0,40,1,2,2,5,0xb2d6bee0
1192.89,1.0,92,1,2,1,4,0xb2d43245d
830101.08,8.0,19,4,4,2,10,0xb2d8d7ecd
670199.24,3.0,63,4,4,2,10,0xb2d3258cd
54.82,1.0,2,1,2,4,7,0xb2d782b2
49056.65,3.0,104,2,4,1,7,0xb2d4e795d
54.94,1.0,18,1,2,2,5,0xb2d22fdbd
8077.13,1.0,92,2,2,1,5,0xb2d249cdd
70002.96,2.0,195,3,3,1,7,0xb2d69c7b
140000.0,1.0,0,3,2,4,9,0xb2da5c0e
221742.69,6.0,10,3,4,3,10,0xb2d354c2d
4281.71,1.0,7,2,2,3,7,0xb2d5e385d
316009.85,5.0,154,4,4,1,9,0xb2d19e69d
350080.72,2.0,0,4,3,4,11,0xb2d4127dd
1391.18,1.0,3,1,2,4,7,0xb2d99658
20184.1,1.0,1,2,2,4,8,0xb2d308b4
20001.39,3.0,19,2,4,2,8,0xb2d5df81
591.2,1.0,9,1,2,3,6,0xb2d4f5e2
200100.16,2.0,159,3,3,1,7,0xb2d8f0f9d
1678.01,1.0,1,1,2,4,7,0xb2d114a1d
20000.63,2.0,10,2,3,3,8,0xb2d95c1ad
130005.18,3.0,41,3,4,2,9,0xb2d9e70f
0.0,10.0,3,1,4,4,9,0xb2d14e66
60984.58,2.0,0,3,3,4,10,0xb2d967f1d
554274.6,3.0,1,4,4,4,12,0xb2d23a0dd
365031.87,5.0,11,4,4,3,11,0xb2d5911b
535040.37,9.0,0,4,4,4,12,0xb2d3b280
803974.19,4.0,3,4,4,4,12,0xb2d43c42d
89835.24,1.0,128,3,2,1,6,0xb2d41eb0
200083.56,2.0,10,3,3,3,9,0xb2d6d026
25.68,2.0,47,1,3,2,6,0xb2d4463bd
20005.09,1.0,27,2,2,2,6,0xb2d24141d
150003.17,2.0,11,3,3,3,9,0xb2da401a
5761.1,1.0,0,2,2,4,8,0xb2d9d034
1011.73,1.0,92,1,2,1,4,0xb2d0e306d
372049.64,3.0,98,4,4,1,9,0xb2d4ac89d
816828.08,23.0,0,4,4,4,12,0x3b9b0e74d
246547.49,3.0,153,3,4,1,8,0xb2d1db2cd
90022.23,2.0,143,3,3,1,7,0xb2d2158bd
395.35,2.0,9,1,3,3,7,0xb2d6c2f8
1230003.12,4.0,3,4,4,4,12,0xb2d8de5d
30001.58,2.0,125,2,3,1,6,0xb2d914aed
1700316.3,2.0,26,4,3,2,9,0xb2d4f55dd
50003.06,2.0,66,2,3,2,7,0xb2d8ef96
11.74,1.0,59,1,2,2,5,0xb2d367c3d
167111.28,2.0,8,3,3,3,9,0xb2d92319
2357.33,1.0,93,1,2,1,4,0xb2d2f9d7
1935572.83,8.0,14,4,4,3,11,0xb2d6abfbd
31.67,1.0,53,1,2,2,5,0xb2d9c9b8
6057.12,1.0,184,2,2,1,5,0xb2d31e29d
543.7,1.0,34,1,2,2,5,0xb2d2da12
25519.41,1.0,4,2,2,4,8,0xb2d78c63
103043.86,1.0,3,3,2,4,9,0xb2d60e44d
120035.33,2.0,67,3,3,1,7,0xb2d3a2eb
217590.02,3.0,0,3,4,4,11,0xb2d0f450d
1942.33,1.0,7,1,2,3,6,0xb2d2998a
1238.73,1.0,92,1,2,1,4,0xb2d18d02d
687.67,2.0,0,1,3,4,8,0x3b9b26ef
512444.5,2.0,92,4,3,1,8,0xb2d67cbad
1517.42,1.0,0,1,2,4,7,0xb2d21208d
320142.93,5.0,10,4,4,3,11,0xb2d568abd
10.01,1.0,11,1,2,3,6,0xb2d31460
73.6,1.0,6,1,2,3,6,0xb2d3a57ed
200000.0,2.0,25,3,3,2,8,0xb2da0d43
7119.36,1.0,2,2,2,4,8,0xb2d929efd
1291.93,2.0,184,1,3,1,5,0xb2d32ef5d
672.33,1.0,0,1,2,4,7,0xb2d25b73
206502.63,2.0,79,3,3,1,7,0xb2d38a37d
1244132.26,7.0,0,4,4,4,12,0xb2d55249d
2035.95,1.0,14,1,2,3,6,0xb2d2835fd
16663.79,1.0,184,2,2,1,5,0xb2d0da7ad
1096.61,1.0,7,1,2,3,6,0xb2d8d7c4
3911.1,1.0,0,2,2,4,8,0xb2d907ca
398067.6,7.0,0,4,4,4,12,0xb2d0ed14d
30127.58,2.0,55,2,3,2,7,0xb2d6ef16d
9292.02,1.0,15,2,2,3,7,0xb2d9c3d2
853.15,1.0,8,1,2,3,6,0xb2d1da00d
317.0,1.0,2,1,2,4,7,0xb2d3a8aed
1185.12,1.0,198,1,2,1,4,0xb2d5cde1d
1041901.22,6.0,51,4,4,2,10,0x3b9b478a
5282.7,1.0,14,2,2,3,7,0xb2d35e46d
748.78,1.0,59,1,2,2,5,0xb2d1c56f
1059.76,1.0,168,1,2,1,4,0xb2d25209d
327.08,1.0,92,1,2,1,4,0xb2d32bd7
1869.57,1.0,10,1,2,3,6,0xb2d338a8
51855.83,1.0,3,2,2,4,8,0xb2d4c893d
2346.11,1.0,0,1,2,4,7,0xb2d881cd
38567.25,1.0,10,2,2,3,7,0xb2d905d2
216.38,1.0,2,1,2,4,7,0xb2d2b632
1.11,1.0,69,1,2,1,4,0xb2d5408e
1901531.53,7.0,27,4,4,2,10,0xb2d2b9ded
1312021.13,2.0,0,4,3,4,11,0xb2d6cfca
45.34,1.0,40,1,2,2,5,0xb2d1356fd
121296.81,3.0,6,3,4,3,10,0xb2d3f7a4d
2794525.91,14.0,25,4,4,2,10,0x3b9b125e
0.0,2.0,47,1,3,2,6,0xb2d92684d
2011.1,1.0,47,1,2,2,5,0xb2d2a00c
200062.19,2.0,136,3,3,1,7,0xb2d1fce4
684000.0,22.0,0,4,4,4,12,0xb2d1f99cd
10196.34,1.0,184,2,2,1,5,0xb2d3141cd
71361.24,4.0,47,3,4,2,9,0xb2d0ae4a
200710.55,2.0,27,3,3,2,8,0xb2d9033ad
3.38,2.0,2,1,3,4,8,0x3b9af1b7
50524.52,8.0,52,2,4,2,8,0x3b9b3ad8
3690.95,1.0,38,2,2,2,6,0xb2d685cdd
20155.91,1.0,184,2,2,1,5,0xb2d36f9ed
600044.98,2.0,193,4,3,1,8,0xb2d3bba7d
154.79,1.0,10,1,2,3,6,0xb2d1a2b2
500076.18,2.0,21,4,3,2,9,0xb2d63404d
639322.96,10.0,0,4,4,4,12,0xb2d0f89d
300843.68,4.0,22,4,4,2,10,0xb2d69a7dd
240325.83,4.0,6,3,4,3,10,0xb2d6afe0
1233.22,2.0,184,1,3,1,5,0x3b9b2309d
500000.69,3.0,5,4,4,3,11,0xb2d8c782
5390.78,1.0,32,2,2,2,6,0xb2d2748fd
471670.55,2.0,16,4,3,2,9,0xb2d96961d
330.88,1.0,60,1,2,2,5,0xb2d6900e
263501.04,6.0,10,3,4,3,10,0xb2d11c78d
518171.62,2.0,24,4,3,2,9,0xb2d5fe1bd
132329.47,1.0,3,3,2,4,9,0xb2d38ebfd
65466.56,1.0,4,3,2,4,9,0xb2d12948d
113084.72,4.0,52,3,4,2,9,0xb2d35d21d
84327.63,7.0,4,3,4,4,11,0xb2d177ffd
50000.0,2.0,4,2,3,4,9,0xb2da5d34
179624.86,2.0,11,3,3,3,9,0xb2d10d52
102548.59,6.0,18,3,4,2,9,0xb2d57761d
203428.32,1.0,1,3,2,4,9,0xb2d1551c
1372.43,1.0,184,1,2,1,4,0xb2d39f66d
4370.82,1.0,62,2,2,2,6,0xb2d8eb10
1048225.17,6.0,14,4,4,3,11,0xb2d0f9ffd
55.43,1.0,3,1,2,4,7,0xb2d62945
171047.07,2.0,3,3,3,4,10,0xb2d25bc0
80678.89,2.0,0,3,3,4,10,0xb2d45e30d
10071.4,3.0,0,2,4,4,10,0xb2d42e71d
31.91,1.0,0,1,2,4,7,0xb2d69975
21.84,1.0,73,1,2,1,4,0xb2d323c0
14125.74,5.0,0,2,4,4,10,0x3b9af178d
317379.83,4.0,60,4,4,2,10,0xb2d509afd
11124.84,1.0,92,2,2,1,5,0xb2d37c8ad
20006.55,2.0,92,2,3,1,6,0xb2d7003ad
15475.94,1.0,26,2,2,2,6,0xb2d612d8d
501687.92,6.0,10,4,4,3,11,0xb2d633c5
273808.49,1.0,3,3,2,4,9,0xb2d25be0
193428.01,2.0,39,3,3,2,8,0xb2d15367d
11.76,1.0,6,1,2,3,6,0xb2d41672
7133.68,1.0,184,2,2,1,5,0xb2d306dfd
10000.11,2.0,53,2,3,2,7,0xb2d9cffd
810174.59,82.0,27,4,4,2,10,0xb2d24853
201056.42,2.0,14,3,3,3,9,0xb2d61e45d
280403.08,7.0,31,3,4,2,9,0xb2d5e409d
115263.6,2.0,95,3,3,1,7,0xb2d1a618d
379833.89,3.0,111,4,4,1,9,0xb2d40ebbd
400215.11,4.0,13,4,4,3,11,0xb2d82086
218287.65,2.0,83,3,3,1,7,0xb2d3fe11d
377009.56,3.0,0,4,4,4,12,0xb2d17019d
20016.07,3.0,90,2,4,1,7,0xb2d88c51d
4802.85,1.0,21,2,2,2,6,0xb2d91346
107.45,1.0,9,1,2,3,6,0xb2d30a45
750160.7,2.0,1,4,3,4,11,0xb2d0d6e8
301066.26,2.0,36,4,3,2,9,0xb2d9aebe
0.0,1.0,73,1,2,1,4,0xb2d4c918
501811.45,3.0,31,4,4,2,10,0xb2d8c883
300005.28,3.0,25,3,4,2,9,0xb2d9f21d
772464.16,5.0,18,4,4,2,10,0xb2d9498bd
127011.27,3.0,23,3,4,2,9,0xb2d20cf2d
80808.31,1.0,92,3,2,1,6,0xb2d371b9d
1025.86,1.0,0,1,2,4,7,0xb2d6f263
56000.59,2.0,98,3,3,1,7,0xb2d96ef9d
400478.08,2.0,116,4,3,1,8,0xb2d5aa12d
4676613.74,7.0,0,4,4,4,12,0xb2d237a6
7695.26,1.0,9,2,2,3,7,0xb2d5bd65
200012.28,2.0,11,3,3,3,9,0xb2d9675dd
2.06,1.0,5,1,2,3,6,0xb2d3077e
4016.28,1.0,0,2,2,4,8,0xb2d6b8e5d
1180093.7,4.0,5,4,4,3,11,0xb2d1c067
77195.85,3.0,6,3,4,3,10,0xb2d57bc0
184313.03,6.0,8,3,4,3,10,0x3b9af1d9d
1200000.0,2.0,21,4,3,2,9,0xb2d950e6d
101175.05,6.0,13,3,4,3,10,0xb2d57ee9d
10063.33,1.0,184,2,2,1,5,0xb2d2b2b3
160007.71,2.0,154,3,3,1,7,0xb2d261fad
101253.21,1.0,4,3,2,4,9,0xb2d6b045
1156824.09,2.0,0,4,3,4,11,0xb2d3a1c3d
4.97,1.0,81,1,2,1,4,0xb2d25c18d
2010.85,1.0,34,1,2,2,5,0xb2d9d70a
55215.96,1.0,6,3,2,3,8,0xb2d2a92bd
15175.61,1.0,184,2,2,1,5,0xb2d5c581d
2180627.25,5.0,15,4,4,3,11,0xb2d9ccc2
43000.21,2.0,8,2,3,3,8,0xb2d1741ed
200042.23,2.0,22,3,3,2,8,0xb2d6e76b
2362.82,1.0,92,1,2,1,4,0xb2d58a4ad
203156.59,2.0,0,3,3,4,10,0xb2d9b459
30171.55,4.0,76,2,4,1,7,0xb2d5e9b7d
4947.03,1.0,6,2,2,3,7,0xb2d8e041
320026.33,5.0,39,4,4,2,10,0x3b9b2fbbd
130003.4,3.0,94,3,4,1,8,0xb2d8577cd
13892.72,1.0,0,2,2,4,8,0xb2d92716
1112.95,1.0,0,1,2,4,7,0xb2d913c8
153107.41,2.0,66,3,3,2,8,0xb2d5c215d
830094.13,2.0,31,4,3,2,9,0xb2d0de49d
31403.3,3.0,3,2,4,4,10,0xb2d4f952d
20002.66,2.0,11,2,3,3,8,0xb2d9d8a9
3506.13,1.0,0,2,2,4,8,0xb2d122e4
116399.34,5.0,10,3,4,3,10,0xb2d4ac2f
468112.12,4.0,97,4,4,1,9,0x3b9b3b2b
41.21,1.0,59,1,2,2,5,0xb2d22669
100000.0,1.0,0,3,2,4,9,0xb2da6c9a
109258.78,2.0,3,3,3,4,10,0xb2d25089d
1852.75,1.0,184,1,2,1,4,0xb2d291bbd
12726.12,1.0,92,2,2,1,5,0xb2d28731
52.57,1.0,32,1,2,2,5,0xb2d47479
200000.19,2.0,1,3,3,4,10,0xb2d26f06d
667551.98,4.0,80,4,4,1,9,0xb2d1d3ffd
100020.68,2.0,60,3,3,2,8,0xb2d5cdc2d
54200.72,2.0,1,3,3,4,10,0xb2d95d31d
3519.6,1.0,116,2,2,1,5,0xb2d75498
37439.98,1.0,9,2,2,3,7,0xb2d6d4bd
6920.42,1.0,0,2,2,4,8,0xb2d62e23
532005.54,4.0,69,4,4,1,9,0x3b9b320a
2.28,1.0,15,1,2,3,6,0xb2d0906a
4358511.93,3.0,179,4,4,1,9,0x3b9af114d
159.45,1.0,10,1,2,3,6,0xb2d93376
62084.37,2.0,14,3,3,3,9,0xb2d37cd5d
100181.66,2.0,167,3,3,1,7,0xb2d1dd55d
1401.4,1.0,10,1,2,3,6,0xb2d68c25
207535.25,2.0,171,3,3,1,7,0xb2d5099dd
14058.21,1.0,8,2,2,3,7,0xb2d6c099
25124.72,1.0,2,2,2,4,8,0xb2d91953d
60058.12,2.0,23,3,3,2,8,0xb2d5a624
12459.19,1.0,2,2,2,4,8,0xb2d6b815d
2.86,1.0,18,1,2,2,5,0xb2d349f5
550023.13,3.0,6,4,4,3,11,0xb2d6fb84d
9.61,1.0,46,1,2,2,5,0xb2d96dd6
1421956.89,5.0,110,4,4,1,9,0xb2d4b880
300015.84,3.0,62,3,4,2,9,0xb2d9af9e
2278.24,1.0,5,1,2,3,6,0xb2d6c84fd
761.45,1.0,0,1,2,4,7,0xb2d8ea58d
592.21,1.0,8,1,2,3,6,0xb2d4c085
976.08,1.0,0,1,2,4,7,0xb2d65b17
559.4,1.0,1,1,2,4,7,0xb2d9500e
213975.82,2.0,193,3,3,1,7,0xb2d3d3dad
322889.63,4.0,31,4,4,2,10,0xb2d141af
1461.83,1.0,140,1,2,1,4,0xb2d620ecd
253142.65,2.0,39,3,3,2,8,0xb2d108f8d
239897.15,4.0,0,3,4,4,11,0xb2d1877dd
968000.0,5.0,3,4,4,4,12,0xb2d879eed
168000.63,4.0,9,3,4,3,10,0xb2d6ef01
14958.72,1.0,19,2,2,2,6,0xb2d95738
400004.23,3.0,13,4,4,3,11,0xb2d9ba9a
260029.88,11.0,0,3,4,4,11,0xb2d65ed4
1212614.21,5.0,25,4,4,2,10,0xb2d2d011d
285125.02,4.0,26,3,4,2,9,0xb2d10ac1
316473.74,3.0,0,4,4,4,12,0xb2d0e63bd
202966.2,3.0,8,3,4,3,10,0xb2d07a2ad
151045.6,4.0,97,3,4,1,8,0xb2d55a42d
1523.84,1.0,96,1,2,1,4,0xb2d6aaafd
204744.72,2.0,98,3,3,1,7,0xb2d43700d
1445619.66,3.0,32,4,4,2,10,0xb2d40448
5457.68,1.0,107,2,2,1,5,0xb2d16978
104.73,1.0,34,1,2,2,5,0xb2d3831bd
360011.63,9.0,11,4,4,3,11,0xb2d5e376d
16945.46,1.0,9,2,2,3,7,0xb2d8d403d
2476610.52,20.0,6,4,4,3,11,0x3b9b125cd
933162.12,6.0,0,4,4,4,12,0xb2d1bda3
40002.11,2.0,92,2,3,1,6,0xb2d65b38d
4936.78,1.0,67,2,2,1,5,0xb2d5d822
376415.45,2.0,83,4,3,1,8,0xb2d07fd7d
3617.45,1.0,0,2,2,4,8,0xb2d8e6f8d
764924.36,11.0,14,4,4,3,11,0xb2d6073bd
6552.01,1.0,7,2,2,3,7,0xb2d3f88ed
1336986.33,6.0,2,4,4,4,12,0x3b9b3c79
842405.26,4.0,7,4,4,3,11,0xb2d5fdfad
1006.01,1.0,33,1,2,2,5,0xb2d595a0d
25922.13,1.0,15,2,2,3,7,0xb2d3ae61d
90649.81,2.0,46,3,3,2,8,0xb2d38b9ad
155655.98,1.0,0,3,2,4,9,0xb2d5c5c9
5829.79,1.0,3,2,2,4,8,0xb2d14f46d
80000.5,5.0,4,3,4,4,11,0xb2d7e336
500120.59,2.0,14,4,3,3,10,0xb2d40146d
341620.13,5.0,3,4,4,4,12,0xb2d5e495
2117582.72,15.0,0,4,4,4,12,0xb2d45534d
28.87,1.0,81,1,2,1,4,0xb2d62e28
1108.32,1.0,0,1,2,4,7,0xb2d34d4fd
204.74,1.0,0,1,2,4,7,0xb2d59ee1
371340.0,6.0,13,4,4,3,11,0xb2d16e96
21993.44,2.0,14,2,3,3,8,0xb2da3497
200031.56,2.0,82,3,3,1,7,0xb2d15d82d
120106.71,2.0,92,3,3,1,7,0xb2d41c3ed
212407.56,2.0,20,3,3,2,8,0xb2d9faf8
20000.85,3.0,10,2,4,3,9,0xb2d94d14d
691000.27,9.0,6,4,4,3,11,0xb2d069f6
102.73,1.0,17,1,2,2,5,0xb2d5833f
2537.56,1.0,184,1,2,1,4,0xb2d5ddfed
500749.77,4.0,104,4,4,1,9,0xb2d1786ed
302776.84,3.0,10,4,4,3,11,0xb2d10d54d
27.23,1.0,41,1,2,2,5,0xb2d96f15
665.37,1.0,0,1,2,4,7,0xb2d91300d
1014806.32,2.0,0,4,3,4,11,0xb2d0d95c
622000.74,9.0,6,4,4,3,11,0xb2d6447ed
638425.38,7.0,60,4,4,2,10,0xb2d2a02a
20649.58,2.0,66,2,3,2,7,0xb2d5cba6
440000.0,2.0,20,4,3,2,9,0xb2d95504
500081.01,2.0,167,4,3,1,8,0xb2d5f416d
279.97,1.0,0,1,2,4,7,0xb2d18bf6d
2048.86,1.0,92,1,2,1,4,0xb2d308a3d
200710.49,2.0,19,3,3,2,8,0xb2d913eed
33000.35,2.0,92,2,3,1,6,0xb2d65918d
501778.65,2.0,11,4,3,3,10,0xb2d60226d
83495.19,1.0,92,3,2,1,6,0xb2d070cbd
270050.84,4.0,136,3,4,1,8,0xb2d5bf5f
440123.6,14.0,6,4,4,3,11,0xb2d21b38d
209.66,1.0,3,1,2,4,7,0xb2d31f01
1021383.55,3.0,21,4,4,2,10,0xb2d6e4dbd
1418.77,1.0,16,1,2,2,5,0xb2d6ee8f
1009.05,1.0,3,1,2,4,7,0xb2d91080
1446.64,1.0,0,1,2,4,7,0xb2d0b18dd
50899.36,1.0,184,2,2,1,5,0xb2d4e862d
529.58,1.0,6,1,2,3,6,0xb2d2cf43d
2.81,1.0,69,1,2,1,4,0xb2d52b6a
302277.3,10.0,25,4,4,2,10,0xb2d62cd0d
1724000.0,5.0,7,4,4,3,11,0xb2d8ea86
96243.39,1.0,0,3,2,4,9,0xb2d94605
301586.86,2.0,12,4,3,3,10,0xb2d0c212d
21.66,2.0,28,1,3,2,6,0xb2d27652
2108.64,1.0,92,1,2,1,4,0xb2d26deed
627086.51,3.0,3,4,4,4,12,0xb2d54f0ad
36387.57,1.0,2,2,2,4,8,0xb2d0d6f7
4.92,1.0,47,1,2,2,5,0xb2d375d7
10166.99,1.0,218,2,2,1,5,0xb2d39f70d
6.27,1.0,18,1,2,2,5,0xb2d8cffb
21166.3,4.0,0,2,4,4,10,0xb2d93c66
450000.0,2.0,7,4,3,3,10,0xb2d96f4e
212.85,1.0,167,1,2,1,4,0xb2d63da8d
8012.41,1.0,4,2,2,4,8,0xb2d80f13
40001.27,2.0,92,2,3,1,6,0xb2d97cf9d
5363.93,1.0,184,2,2,1,5,0x3b9af4d8d
9132.77,1.0,12,2,2,3,7,0xb2d0b491d
1.07,1.0,20,1,2,2,5,0xb2d0d096
1082769.46,7.0,11,4,4,3,11,0xb2d25a81d
3006.24,1.0,206,2,2,1,5,0xb2d692fcd
50055.43,2.0,221,2,3,1,6,0xb2d2edd7d
10290.2,1.0,7,2,2,3,7,0xb2d64eead
17.57,1.0,60,1,2,2,5,0xb2d43c6dd
2213.14,2.0,92,1,3,1,5,0xb2d1ff8a
367008.43,11.0,0,4,4,4,12,0xb2d321ec
5709.98,3.0,18,2,4,2,8,0x3b9aecbe
1.7,1.0,6,1,2,3,6,0xb2d0ecf6d
5558.23,1.0,3,2,2,4,8,0xb2d553ddd
441254.78,11.0,0,4,4,4,12,0xb2d4f726d
2088.24,2.0,184,1,3,1,5,0xb2d06cd7d
47.3,1.0,44,1,2,2,5,0xb2d37c91
2251.5,1.0,43,1,2,2,5,0xb2d37c71
100035.8,2.0,41,3,3,2,8,0xb2d3c749
106001.12,2.0,8,3,3,3,9,0xb2d97c8c
62449.8,1.0,15,3,2,3,8,0xb2d6a247d
3021.46,2.0,92,2,3,1,6,0xb2d26b16d
2308.72,1.0,10,1,2,3,6,0xb2d2de22
150119.35,2.0,193,3,3,1,7,0xb2d5ed95d
80.33,1.0,44,1,2,2,5,0xb2d57851
11108.63,1.0,171,2,2,1,5,0xb2d39ac7d
10285.88,1.0,33,2,2,2,6,0xb2d38b8ed
10003.17,2.0,46,2,3,2,7,0xb2d9de83
180044.18,3.0,104,3,4,1,8,0xb2d57e5ad
571339.19,4.0,6,4,4,3,11,0xb2d3bb74
565.27,1.0,24,1,2,2,5,0xb2d92918
750000.0,4.0,2,4,4,4,12,0xb2d5c650
80053.41,1.0,3,3,2,4,9,0xb2d8b166d
350018.9,2.0,69,4,3,1,8,0xb2d200e5d
50006.26,2.0,245,2,3,1,6,0xb2d606b4d
15943.25,1.0,168,2,2,1,5,0xb2d3c877d
12.77,3.0,42,1,4,2,7,0x3b9b3232
993061.62,8.0,1,4,4,4,12,0xb2d6c3c3d
634.05,2.0,92,1,3,1,5,0xb2d24897d
78.3,1.0,7,1,2,3,6,0xb2d63c7f
158105.16,3.0,29,3,4,2,9,0xb2d3bcb2d
184.57,1.0,34,1,2,2,5,0xb2d93494d
1905.57,3.0,92,1,4,1,6,0xb2d08c99d
150003.17,2.0,179,3,3,1,7,0xb2d3b726d
140012.03,2.0,105,3,3,1,7,0xb2d3fb69d
1182.61,1.0,3,1,2,4,7,0xb2d6b636
300009.5,2.0,80,3,3,1,7,0xb2d9892b
1689981.14,2.0,92,4,3,1,8,0xb2d52e97
600333.95,4.0,0,4,4,4,12,0xb2d8ead4d
200710.46,2.0,46,3,3,2,8,0xb2d9e665
9973.63,1.0,13,2,2,3,7,0xb2d60daed
628.03,1.0,14,1,2,3,6,0xb2d91389d
604000.0,4.0,3,4,4,4,12,0xb2d2576dd
2565335.05,2.0,4,4,3,4,11,0xb2da1238
20167.84,3.0,0,2,4,4,10,0xb2d0df8b
400775.21,2.0,28,4,3,2,9,0xb2d4013bd
2140717.39,28.0,0,4,4,4,12,0xb2d327a1d
250000.0,2.0,4,3,3,4,10,0xb2d91f70
2570.64,1.0,25,1,2,2,5,0xb2d31ad8
500000.11,4.0,4,4,4,4,12,0xb2d66675
3619.44,1.0,184,2,2,1,5,0xb2d0da53d
324077.99,3.0,11,4,4,3,11,0xb2d158d5
52118.72,4.0,63,2,4,2,8,0xb2d5d4aa
150513.28,2.0,95,3,3,1,7,0xb2d1f020d
2.76,1.0,92,1,2,1,4,0xb2d2d7e8d
308168.86,9.0,3,4,4,4,12,0xb2d108e4d
352271.89,14.0,18,4,4,2,10,0xb2d42930d
700030.0,2.0,2,4,3,4,11,0xb2d96f0b
130191.0,4.0,143,3,4,1,8,0xb2d5e553d
130007.97,5.0,14,3,4,3,10,0xb2d08fa5d
5767.13,1.0,0,2,2,4,8,0xb2d689f3d
1004986.83,2.0,26,4,3,2,9,0xb2d6b157d
301113.77,3.0,50,4,4,2,10,0xb2d54ad9d
4120.01,1.0,19,2,2,2,6,0xb2d2fc87d
203722.5,2.0,0,3,3,4,10,0xb2d17b8a
33327.25,3.0,14,2,4,3,9,0xb2d24dfbd
351846.1,6.0,6,4,4,3,11,0xb2d5599bd
2530.7,1.0,0,1,2,4,7,0xb2d6da35
4215.99,2.0,92,2,3,1,6,0xb2d1fcf1d
446429.29,5.0,0,4,4,4,12,0xb2d0e398d
371000.42,3.0,4,4,4,4,12,0xb2d5e595
40000.09,2.0,25,2,3,2,7,0xb2d609d9
5717.25,1.0,20,2,2,2,6,0xb2d60a52d
30086.22,1.0,92,2,2,1,5,0xb2d60e0cd
1014.97,1.0,92,1,2,1,4,0xb2d12264d
1269.73,1.0,73,1,2,1,4,0xb2d696e5d
15047.23,1.0,92,2,2,1,5,0xb2d5f7aad
31.35,1.0,33,1,2,2,5,0xb2d9aad8
10124.47,1.0,92,2,2,1,5,0xb2d22dbfd
2622.01,1.0,4,1,2,4,7,0xb2d1a16c
511.01,2.0,25,1,3,2,6,0xb2d56630
14707.24,1.0,0,2,2,4,8,0xb2d2123cd
131074.45,3.0,29,3,4,2,9,0xb2d5be28
79771.6,2.0,1,3,3,4,10,0xb2d1566dd
100720.6,3.0,53,3,4,2,9,0xb2d14d1bd
600078.62,4.0,214,4,4,1,9,0xb2d48090d
756074.5,3.0,27,4,4,2,10,0xb2d6dc76d
17121.92,1.0,15,2,2,3,7,0xb2d8d61dd
53149.94,2.0,95,3,3,1,7,0xb2d4da02d
500001.04,2.0,28,4,3,2,9,0xb2d9017ed
713888.65,6.0,5,4,4,3,11,0xb2d32f7c
50113.49,6.0,46,2,4,2,8,0xb2d19843
577732.41,16.0,25,4,4,2,10,0x3b9b291ed
131509.57,3.0,0,3,4,4,11,0xb2d0c9d4
1806028.33,11.0,8,4,4,3,11,0xb2d99c8c
234393.89,4.0,56,3,4,2,9,0xb2d5edb3
390206.27,4.0,125,4,4,1,9,0x3b9b36db
5582.74,1.0,92,2,2,1,5,0xb2d33588d
15.83,1.0,42,1,2,2,5,0xb2d9dff3
51370.96,1.0,1,2,2,4,8,0xb2d54280d
869053.63,3.0,0,4,4,4,12,0xb2d65826d
422000.0,6.0,1,4,4,4,12,0xb2d14cd4d
186204.28,3.0,19,3,4,2,9,0xb2d23447d
331.93,5.0,0,1,4,4,9,0x3b9af231d
5096.38,1.0,26,2,2,2,6,0xb2d96ed7d
261.62,1.0,69,1,2,1,4,0xb2d3c081d
3.07,1.0,6,1,2,3,6,0xb2d21a31
840012.9,3.0,4,4,4,4,12,0xb2d5c5cbd
200839.33,2.0,3,3,3,4,10,0xb2d93b6dd
14.29,2.0,80,1,3,1,5,0xb2d4dfd3
65.0,1.0,0,1,2,4,7,0xb2d6b9f1
75.53,1.0,25,1,2,2,5,0xb2d3847e
363005.61,10.0,3,4,4,4,12,0xb2d51e52d
3744.65,1.0,92,2,2,1,5,0xb2d15da4d
1390049.5,5.0,0,4,4,4,12,0xb2d24409d
600075.66,2.0,5,4,3,3,10,0xb2d632b3d
387003.51,4.0,13,4,4,3,11,0xb2d5b3a4d
3705.94,1.0,4,2,2,4,8,0xb2d129c8
302363.26,3.0,18,4,4,2,10,0xb2d1ed0cd
21373.46,1.0,0,2,2,4,8,0xb2d6cc39
1700040.11,3.0,45,4,4,2,10,0xb2d8ecc9d
180009.35,3.0,21,3,4,2,9,0xb2d9325bd
10199.94,1.0,202,2,2,1,5,0xb2d5d5bbd
501776.04,2.0,31,4,3,2,9,0xb2d93f39
800003.17,3.0,11,4,4,3,11,0xb2da48f3
1340.03,1.0,184,1,2,1,4,0xb2d0fc41d
800165.8,2.0,2,4,3,4,11,0xb2d56dfdd
140.26,1.0,89,1,2,1,4,0xb2d43568d
260909.82,4.0,13,3,4,3,10,0xb2d1a0b2d
350006.97,5.0,31,4,4,2,10,0xb2d6f8e3
205778.59,2.0,4,3,3,4,10,0xb2d0d7b3d
251612.15,6.0,0,3,4,4,11,0xb2d11b2fd
2694.2,1.0,8,1,2,3,6,0xb2d171b7
1197.45,1.0,5,1,2,3,6,0xb2d3e528d
1.62,1.0,43,1,2,2,5,0xb2d37c19
930.94,1.0,10,1,2,3,6,0xb2d23bf0
20710.64,1.0,7,2,2,3,7,0xb2d626cc
2034.55,1.0,0,1,2,4,7,0xb2d1bb14d
89.96,1.0,0,1,2,4,7,0xb2d1acee
549.17,1.0,22,1,2,2,5,0xb2d97d07
50002.11,2.0,92,2,3,1,6,0xb2d66570
392017.92,3.0,11,4,4,3,11,0xb2d5880a
50712.07,2.0,39,2,3,2,7,0xb2d59b17d
19214.5,1.0,12,2,2,3,7,0xb2d66086d
3801.37,1.0,21,2,2,2,6,0xb2d7c073
1023.72,1.0,11,1,2,3,6,0xb2d78c6b
1457.03,1.0,92,1,2,1,4,0xb2d1f923d
124659.38,1.0,102,3,2,1,6,0xb2d5896bd
59105.57,5.0,0,3,4,4,11,0xb2d212a1d
500004.65,3.0,10,4,4,3,11,0xb2d4417b
2360.31,1.0,7,1,2,3,6,0xb2d34386
14294.98,1.0,10,2,2,3,7,0xb2d6ab4e
3717.46,1.0,1,2,2,4,8,0xb2d3c3e9
153136.25,3.0,102,3,4,1,8,0xb2d23320d
231656.36,2.0,63,3,3,2,8,0xb2d68ff6
311161.64,4.0,11,4,4,3,11,0xb2d207ecd
539034.85,3.0,0,4,4,4,12,0x3b9b17ee
3072.92,1.0,92,2,2,1,5,0x3b9b35b9
202424.89,2.0,66,3,3,2,8,0xb2d6c2c9d
55141.8,2.0,179,3,3,1,7,0xb2d654a3d
3931.56,1.0,12,2,2,3,7,0xb2d90157
632950.38,4.0,29,4,4,2,10,0xb2d17034d
89858.79,6.0,0,3,4,4,11,0xb2d407a1d
13925.26,1.0,3,2,2,4,8,0xb2d1e67cd
100000.0,3.0,0,3,4,4,11,0xb2d97cacd
0.61,1.0,7,1,2,3,6,0xb2d2d882
600000.0,3.0,39,4,4,2,10,0xb2d9f520
501097.16,3.0,19,4,4,2,10,0xb2d9477fd
30474.6,1.0,121,2,2,1,5,0xb2d5a951
1010.89,1.0,92,1,2,1,4,0xb2d3d52bd
1063181.77,5.0,0,4,4,4,12,0xb2d64e8b
410082.76,2.0,77,4,3,1,8,0xb2d3ba99d
133397.12,1.0,8,3,2,3,8,0xb2d8c7b9
2203.12,1.0,0,1,2,4,7,0xb2d60031
150001.58,2.0,70,3,3,1,7,0xb2d9a663
250293.67,4.0,98,3,4,1,8,0xb2d1a291d
3147.17,1.0,92,2,2,1,5,0xb2d24946d
671869.64,3.0,0,4,4,4,12,0xb2d0b850d
49.06,1.0,0,1,2,4,7,0xb2d8eb38
913.74,1.0,1,1,2,4,7,0xb2d6429fd
58.92,1.0,88,1,2,1,4,0xb2d4b8fbd
37026.5,3.0,18,2,4,2,8,0xb2d11b15
360080.75,3.0,12,4,4,3,11,0xb2d4ed5dd
565013.51,4.0,3,4,4,4,12,0xb2d7d587d
6528.37,1.0,17,2,2,2,6,0xb2d900f2
148.23,1.0,67,1,2,1,4,0xb2d6d20b
236424.57,2.0,119,3,3,1,7,0xb2d56152d
6889.28,1.0,1,2,2,4,8,0xb2d4b44ed
827.5,2.0,26,1,3,2,6,0xb2d2d060
250008.46,3.0,25,3,4,2,9,0xb2d16786
120447.7,2.0,95,3,3,1,7,0xb2d484ed
100.98,1.0,10,1,2,3,6,0xb2d95a60
52378.1,2.0,34,3,3,2,8,0xb2d24915d
1.02,1.0,117,1,2,1,4,0xb2d6624dd
452732.08,9.0,8,4,4,3,11,0xb2d5a60e
538348.1,5.0,0,4,4,4,12,0xb2d07135d
140014.65,4.0,21,3,4,2,9,0xb2d65944
50686.76,1.0,184,2,2,1,5,0xb2d1d899d
20782.27,1.0,90,2,2,1,5,0xb2d59a80d
580004.12,4.0,9,4,4,3,11,0xb2d93225
202945.02,2.0,22,3,3,2,8,0xb2d6e45b
896158.46,5.0,70,4,4,1,9,0xb2d33a5e
1060967.22,3.0,21,4,4,2,10,0xb2d162f8d
45.81,2.0,5,1,3,3,7,0xb2d236cc
767609.26,6.0,0,4,4,4,12,0xb2d5348cd
100112.14,3.0,5,3,4,3,10,0xb2d5617ed
190030.43,4.0,111,3,4,1,8,0xb2d54a96d
242847.37,6.0,3,3,4,4,11,0xb2d8e510d
759258.48,4.0,5,4,4,3,11,0xb2d245d4d
90002.22,3.0,41,3,4,2,9,0xb2d9da31
381.2,1.0,26,1,2,2,5,0xb2d30c6dd
420513.34,4.0,111,4,4,1,9,0xb2d5d7f8d
155002.74,2.0,1,3,3,4,10,0xb2da40ef
30012.89,2.0,134,2,3,1,6,0xb2d62c5e
183860.92,3.0,25,3,4,2,9,0xb2d5c8f3
942.9,1.0,9,1,2,3,6,0xb2d6bddbd
1000000.0,1.0,0,4,2,4,10,0xb2da54be
238682.19,5.0,4,3,4,4,11,0xb2d12c3dd
30001.27,2.0,28,2,3,2,7,0xb2d5d445
110220.1,7.0,45,3,4,2,9,0xb2d13c15d
2153.16,1.0,5,1,2,3,6,0xb2d8ff8dd
2158.42,2.0,92,1,3,1,5,0x3b9b2b3dd
6412474.84,6.0,3,4,4,4,12,0xb2d755c7d
751003.48,9.0,11,4,4,3,11,0xb2d3a5aad
17100723.93,2.0,91,4,3,1,8,0xb2d2bf75
870265.48,3.0,3,4,4,4,12,0xb2d422efd
807245.95,3.0,30,4,4,2,10,0xb2d5efaed
93039.14,4.0,12,3,4,3,10,0xb2d3002cd
2790.29,1.0,53,1,2,2,5,0xb2d41562d
15262.4,2.0,171,2,3,1,6,0xb2d5d231d
1057.62,1.0,92,1,2,1,4,0xb2d62c0fd
816664.7,7.0,14,4,4,3,11,0xb2d59eaa
552063.44,6.0,9,4,4,3,11,0xb2d4342cd
1018663.44,4.0,39,4,4,2,10,0xb2d11b9fd
22318.53,1.0,184,2,2,1,5,0xb2d1da32d
315117.94,3.0,97,4,4,1,9,0xb2d3b997
10138.31,1.0,0,2,2,4,8,0xb2d3fded
78016.71,4.0,8,3,4,3,10,0xb2d60ec2d
30954.53,2.0,158,2,3,1,6,0xb2d5df29d
25251.05,1.0,1,2,2,4,8,0xb2d5064ad
98001.4,3.0,111,3,4,1,8,0xb2d0dcb9
36754.92,1.0,0,2,2,4,8,0xb2d1f41b
21069.4,1.0,46,2,2,2,6,0xb2d227b3d
11781122.34,7.0,39,4,4,2,10,0xb2d308f3d
38468.44,1.0,21,2,2,2,6,0xb2d64a82d
18.58,1.0,35,1,2,2,5,0xb2d31396
3784.64,1.0,184,2,2,1,5,0xb2d13fd2d
161024.82,4.0,11,3,4,3,10,0xb2d53a8bd
420013.14,3.0,3,4,4,4,12,0xb2d1709e
50003.48,2.0,20,2,3,2,7,0xb2d2cea8
1527.76,2.0,0,1,3,4,8,0xb2d1fdab
97000.65,2.0,31,3,3,2,8,0xb2d3e61ad
1002771.03,2.0,84,4,3,1,8,0xb2d33448d
5000000.0,2.0,0,4,3,4,11,0xb2d978f6
1000157.45,2.0,24,4,3,2,9,0xb2d903dfd
400041.76,3.0,4,4,4,4,12,0xb2d85d01
654028.13,9.0,6,4,4,3,11,0xb2d5dbe0d
137051.84,1.0,184,3,2,1,6,0xb2d1adb2d
6.3,1.0,4,1,2,4,7,0xb2d76e73
16687.42,1.0,0,2,2,4,8,0xb2d6de98d
158868.29,8.0,6,3,4,3,10,0x3b9adb75d
173.41,1.0,82,1,2,1,4,0xb2d5dc4ed
30281.09,1.0,92,2,2,1,5,0xb2d2acfbd
758.18,1.0,0,1,2,4,7,0xb2d857f6
1460567.56,4.0,31,4,4,2,10,0xb2d5a519d
41098.85,3.0,263,2,4,1,7,0xb2d5f7f2d
122392.18,8.0,0,3,4,4,11,0x3b9b3276
230027.14,6.0,39,3,4,2,9,0xb2d57090d
8459.89,1.0,0,2,2,4,8,0xb2d69d22d
40084.97,2.0,56,2,3,2,7,0xb2d625fd
30007.16,3.0,34,2,4,2,8,0xb2d0a589d
6121.01,1.0,11,2,2,3,7,0xb2d2bf94
4064960.2,9.0,13,4,4,3,11,0xb2d0fc77d
2908.1,1.0,1,2,2,4,8,0xb2d69004
388009.1,4.0,7,4,4,3,11,0xb2d972bed
28.69,1.0,36,1,2,2,5,0xb2d784ee
458008.71,4.0,0,4,4,4,12,0xb2d61758d
5.13,1.0,53,1,2,2,5,0xb2d912ce
1.17,1.0,26,1,2,2,5,0xb2d6ad54
904190.04,10.0,0,4,4,4,12,0xb2d64276
1699356.82,7.0,95,4,4,1,9,0xb2d23198d
410710.42,3.0,7,4,4,3,11,0xb2d62fbed
30512.07,2.0,144,2,3,1,6,0xb2d622a3d
420011.66,2.0,0,4,3,4,11,0xb2d63328d
94299.33,1.0,141,3,2,1,6,0xb2d37bf0d
9297.9,1.0,9,2,2,3,7,0xb2d8f2ebd
10714.34,1.0,92,2,2,1,5,0xb2d59a26d
0.11,23.0,0,1,4,4,9,0xb2d0a1e0
387966.22,4.0,0,4,4,4,12,0xb2d5e810
380000.0,2.0,1,4,3,4,11,0xb2da692f
181481.8,4.0,20,3,4,2,9,0xb2d2a21b
237023.2,16.0,11,3,4,3,10,0xb2d59eead
174032.19,4.0,6,3,4,3,10,0xb2d9e997
3851.15,1.0,92,2,2,1,5,0xb2d3f121d
51561.19,2.0,52,2,3,2,7,0xb2d57075
171231.14,2.0,83,3,3,1,7,0xb2d10f01d
202849.25,3.0,9,3,4,3,10,0xb2d5573ed
142.76,1.0,8,1,2,3,6,0xb2d1f15bd
50011.34,2.0,25,2,3,2,7,0xb2d121fc
89.75,1.0,10,1,2,3,6,0xb2d5b8c1d
900002.74,4.0,0,4,4,4,12,0xb2d6a920d
602380.73,1.0,1,4,2,4,10,0xb2d52c5e
31.37,2.0,2,1,3,4,8,0xb2d90809
1077.91,1.0,9,1,2,3,6,0xb2d32e35d
330259.31,4.0,2,4,4,4,12,0xb2d25690d
21.11,1.0,30,1,2,2,5,0xb2d9e1aa
273.94,1.0,12,1,2,3,6,0xb2d68c10
8008.79,1.0,0,2,2,4,8,0xb2d69ebc
2221.84,1.0,1,1,2,4,7,0xb2d2bf6f
110020.45,3.0,30,3,4,2,9,0xb2d6a2dcd
2744.72,2.0,3,1,3,4,8,0xb2d07512
24159.95,1.0,0,2,2,4,8,0xb2d6b5ffd
15.5,1.0,33,1,2,2,5,0xb2d36be4
3003179.91,16.0,1,4,4,4,12,0xb2d826b6d
200000.0,2.0,6,3,3,3,9,0xb2da1479
277841.49,2.0,5,3,3,3,9,0xb2d1b01fd
31207.94,1.0,0,2,2,4,8,0x3b9ad723d
18760.94,1.0,92,2,2,1,5,0xb2d3fb4ed
6253.08,1.0,3,2,2,4,8,0xb2d9ac75
101.86,1.0,67,1,2,1,4,0xb2d6c840
10000.32,2.0,38,2,3,2,7,0xb2d9264ed
10110000.0,2.0,5,4,3,3,10,0xb2d969f3
5424434.01,11.0,9,4,4,3,11,0xb2d10799d
450000.0,3.0,1,4,4,4,12,0xb2d78b10d
14622.17,1.0,2,2,2,4,8,0xb2d95ebc
7505806.17,22.0,0,4,4,4,12,0x3b9ae3f0d
300001.83,2.0,18,3,3,2,8,0xb2d8fd0ed
74334.26,1.0,0,3,2,4,9,0xb2d6bb8ed
183.77,1.0,3,1,2,4,7,0xb2d2f5a9
416058.04,2.0,80,4,3,1,8,0xb2d28433d
1000000.16,2.0,14,4,3,3,10,0xb2d99fbd
500067.97,2.0,39,4,3,2,9,0xb2d11c0f
202878.85,2.0,120,3,3,1,7,0xb2d5961fd
14916.44,1.0,92,2,2,1,5,0xb2d410ecd
35481.1,1.0,0,2,2,4,8,0xb2d8c80f
10001.75,2.0,10,2,3,3,8,0xb2d3ceb0d
77310.98,1.0,21,3,2,2,7,0xb2d5862cd
13379.0,1.0,92,2,2,1,5,0x3b9b1969d
2.64,1.0,89,1,2,1,4,0xb2d8a58ad
59.2,1.0,13,1,2,3,6,0x3b9b34b5d
102029.89,2.0,168,3,3,1,7,0xb2d310fed
59214.65,2.0,0,3,3,4,10,0xb2d52b30d
51653.75,1.0,184,2,2,1,5,0xb2d22116d
10.26,1.0,41,1,2,2,5,0xb2d58f91
14355.61,2.0,174,2,3,1,6,0xb2d6983e
1409.02,1.0,18,1,2,2,5,0xb2d602f3d
35018.18,3.0,19,2,4,2,8,0xb2d63c19d
2627.41,1.0,184,1,2,1,4,0xb2d2277ed
18920.95,1.0,0,2,2,4,8,0xb2d8e87ad
100032.13,2.0,16,3,3,2,8,0xb2d790d0
20001.16,3.0,129,2,4,1,7,0xb2d63e1ad
46317.48,1.0,0,2,2,4,8,0xb2d5ec1e
50000.53,2.0,90,2,3,1,6,0xb2d8c493
7417.5,1.0,9,2,2,3,7,0xb2d2d79c
100004.22,2.0,92,3,3,1,7,0xb2d63ffdd
501444.23,2.0,6,4,3,3,10,0xb2d78b41d
311670.97,1.0,12,4,2,3,9,0xb2d64221d
58137.89,2.0,6,3,3,3,9,0xb2d28396d
1282.4,1.0,184,1,2,1,4,0xb2d14762d
200002.11,3.0,31,3,4,2,9,0xb2d076b9
874144.46,2.0,0,4,3,4,11,0xb2d1e9b0d
12317.67,1.0,10,2,2,3,7,0xb2d2abb6d
505720.8,3.0,3,4,4,4,12,0xb2d0d093
7716.42,1.0,20,2,2,2,6,0xb2d96783
1033231.24,4.0,0,4,4,4,12,0xb2d57aacd
280051.0,2.0,98,3,3,1,7,0xb2d9706ed
261935.53,2.0,26,3,3,2,8,0xb2d605f4d
150009.45,3.0,221,3,4,1,8,0xb2d2e9f7d
110003.48,2.0,206,3,3,1,7,0xb2d5bfaad
362624.61,1.0,0,4,2,4,10,0xb2d9f7ab
297328.44,5.0,0,3,4,4,11,0x3b9b3f1dd
1012.96,1.0,184,1,2,1,4,0xb2d1ddb4d
500000.0,2.0,19,4,3,2,9,0xb2d957b9
6614.86,1.0,0,2,2,4,8,0xb2d37c71d
56312.63,2.0,92,3,3,1,7,0xb2d2cacad
7151.53,1.0,13,2,2,3,7,0xb2d5c3ab
355464.03,5.0,5,4,4,3,11,0xb2d41e7ad
113541.83,1.0,1,3,2,4,9,0xb2d41d88d
55.52,1.0,25,1,2,2,5,0xb2d2d2bd
81825.53,7.0,0,3,4,4,11,0xb2d0aa41
91231.64,4.0,27,3,4,2,9,0xb2d274ccd
700573.77,4.0,4,4,4,4,12,0xb2d4fe42d
15574.41,1.0,30,2,2,2,6,0xb2d13c2bd
1586.74,1.0,92,1,2,1,4,0xb2d0730ad
171733.45,6.0,0,3,4,4,11,0xb2d26e25d
80026.05,3.0,18,3,4,2,9,0xb2d68335d
250000.41,2.0,21,3,3,2,8,0xb2d6eb0cd
269628.77,3.0,134,3,4,1,8,0xb2d583edd
331477.55,3.0,70,4,4,1,9,0xb2d596bdd
422445.06,3.0,4,4,4,4,12,0xb2d4f295
34.52,1.0,1,1,2,4,7,0xb2d6c1be
520.27,1.0,17,1,2,2,5,0xb2d645b7d
20422.11,1.0,15,2,2,3,7,0xb2da373a
3.71,1.0,14,1,2,3,6,0xb2d78d29d
10641.38,1.0,6,2,2,3,7,0xb2d79284d
4760.85,1.0,4,2,2,4,8,0xb2d29b0ed
288012.78,7.0,27,3,4,2,9,0xb2d3e660d
50000.53,2.0,105,2,3,1,6,0xb2d95e90
28070.41,1.0,1,2,2,4,8,0xb2d7f3d0
2500.0,2.0,11,1,3,3,7,0xb2d966ff
40.64,4.0,1,1,4,4,9,0x3b9b3b15d
236970.97,8.0,0,3,4,4,11,0x3b9b3c73d
9939.76,1.0,12,2,2,3,7,0xb2d56a58d
4006.38,1.0,93,2,2,1,5,0x3b9b46fdd
5703.34,1.0,1,2,2,4,8,0xb2d52e16d
82.19,1.0,10,1,2,3,6,0xb2d42d78
11.9,1.0,8,1,2,3,6,0xb2da13b7
272228.28,4.0,2,3,4,4,11,0xb2d0d095d
13.72,1.0,39,1,2,2,5,0xb2d92427
7.7,1.0,10,1,2,3,6,0xb2d6b670d
200621.91,5.0,45,3,4,2,9,0xb2d560afd
51090.12,3.0,6,2,4,3,9,0xb2d613ee
337394.56,3.0,25,4,4,2,10,0xb2d117efd
154065.26,6.0,40,3,4,2,9,0xb2d2894f
235000.0,2.0,0,3,3,4,10,0xb2d983f3d
1612059.44,13.0,14,4,4,3,11,0xb2d20d29d
200001.81,3.0,15,3,4,3,10,0xb2d3e5c0
10007.16,2.0,21,2,3,2,7,0xb2d9fff7
210009.23,8.0,67,3,4,1,8,0xb2d165d6
50001.49,4.0,77,2,4,1,7,0xb2d07fd5d
29689.3,1.0,16,2,2,2,6,0xb2d1d302d
1840.11,1.0,54,1,2,2,5,0xb2d37c2bd
3708.43,1.0,14,2,2,3,7,0xb2d31958d
4609.15,1.0,5,2,2,3,7,0xb2d18d65
100621.36,2.0,0,3,3,4,10,0xb2d09fb4d
5209.94,2.0,184,2,3,1,6,0xb2d28f72d
160005.07,2.0,77,3,3,1,7,0xb2d6fb32
878828.76,3.0,31,4,4,2,10,0xb2d5a95c
900132.63,5.0,10,4,4,3,11,0xb2d11fced
180088.13,5.0,55,3,4,2,9,0xb2d2a5b3d
800000.0,5.0,1,4,4,4,12,0xb2d6a96a
7752.8,1.0,4,2,2,4,8,0xb2d91f75d
265006.07,2.0,14,3,3,3,9,0xb2d9359fd
89.66,1.0,27,1,2,2,5,0xb2d2c937
293965.48,6.0,10,3,4,3,10,0xb2d1938d
11061.82,1.0,1,2,2,4,8,0xb2d2d04fd
6693.23,1.0,18,2,2,2,6,0xb2d9d5df
607522.12,4.0,45,4,4,2,10,0xb2d2bfead
856371.34,3.0,74,4,4,1,9,0xb2d40d38d
1668.65,3.0,0,1,4,4,9,0xb2d539efd
495496.81,4.0,5,4,4,3,11,0xb2d62106
1632.13,1.0,219,1,2,1,4,0xb2d6585bd
8853.45,1.0,18,2,2,2,6,0xb2d1ae54
16206830.59,18.0,0,4,4,4,12,0xb2d171d5d
200004.25,2.0,66,3,3,2,8,0xb2d60620d
2370.12,2.0,184,1,3,1,5,0x3b9ad026d
3549.94,1.0,96,2,2,1,5,0xb2d1bfa4d
173548.55,6.0,0,3,4,4,11,0xb2d1bb16
70091.65,3.0,60,3,4,2,9,0xb2d78938d
1313.13,1.0,19,1,2,2,5,0xb2d6da00d
6052.89,1.0,2,2,2,4,8,0xb2d55133
126.66,1.0,28,1,2,2,5,0xb2d8366e
2660950.37,6.0,53,4,4,2,10,0xb2d41c8ad
441826.39,2.0,23,4,3,2,9,0xb2d98af2
1411.73,1.0,6,1,2,3,6,0xb2d4dfb1
30018.96,3.0,83,2,4,1,7,0xb2d77f70d
9883.78,1.0,0,2,2,4,8,0xb2d3ca8bd
213000.08,6.0,0,3,4,4,11,0xb2d22a59d
149307.63,6.0,3,3,4,4,11,0xb2d613c9
251834.24,9.0,0,3,4,4,11,0xb2d25664
19816.65,1.0,92,2,2,1,5,0xb2d221fed
25931.29,1.0,0,2,2,4,8,0xb2d60663
50028.16,2.0,110,2,3,1,6,0xb2d68bb4d
39981.25,1.0,0,2,2,4,8,0xb2d1870cd
1233.72,1.0,10,1,2,3,6,0xb2d4ebebd
31.14,1.0,40,1,2,2,5,0xb2d910dc
108318.83,2.0,6,3,3,3,9,0xb2d1c8b6
1092.17,1.0,0,1,2,4,7,0xb2d6c266d
189.78,1.0,46,1,2,2,5,0xb2d37b93d
951954.21,4.0,12,4,4,3,11,0xb2d37aa0
1020792.68,1.0,0,4,2,4,10,0xb2d18215d
2068075.23,14.0,76,4,4,1,9,0xb2d3563c
50011.46,2.0,182,2,3,1,6,0xb2d3a01cd
5201.03,1.0,92,2,2,1,5,0xb2d1c68e
5942.48,1.0,0,2,2,4,8,0xb2d4e014d
23904.24,1.0,0,2,2,4,8,0xb2d6b592d
23200.0,1.0,5,2,2,3,7,0xb2d47723
70115.84,1.0,25,3,2,2,7,0xb2d35341d
100583.06,2.0,81,3,3,1,7,0xb2d0b34e
608340.17,4.0,4,4,4,4,12,0xb2d5dd95d
146143.57,3.0,200,3,4,1,8,0xb2d56d94d
176.19,1.0,10,1,2,3,6,0xb2d906abd
348.79,1.0,9,1,2,3,6,0xb2d6979ed
5.55,1.0,0,1,2,4,7,0xb2d08d2bd
1453578.67,9.0,0,4,4,4,12,0xb2d366ef
5082.1,1.0,0,2,2,4,8,0xb2d34913d
4024.11,1.0,184,2,2,1,5,0xb2d1a0c2d
5.3,1.0,75,1,2,1,4,0xb2d27a87
566317.6,6.0,0,4,4,4,12,0x3b9b1861
9065.56,3.0,92,2,4,1,7,0xb2d2c530d
21414.21,3.0,0,2,4,4,10,0x3b9b1819
1128204.83,5.0,7,4,4,3,11,0xb2d16b66
3077.6,1.0,74,2,2,1,5,0xb2d5e15e
247003.3,4.0,0,3,4,4,11,0xb2d0cd56d
128011.01,2.0,14,3,3,3,9,0xb2d210d0d
6.0,1.0,146,1,2,1,4,0xb2d627ffd
820106.58,6.0,1,4,4,4,12,0xb2d6dc64
150411.76,2.0,20,3,3,2,8,0xb2d5b7ead
17688.09,1.0,12,2,2,3,7,0xb2d954f6d
17876.37,1.0,1,2,2,4,8,0xb2d33d98d
10081.56,1.0,92,2,2,1,5,0xb2d31354
20089.71,1.0,0,2,2,4,8,0xb2d91fdfd
839.99,1.0,0,1,2,4,7,0xb2d9c1a3
2551.22,1.0,9,1,2,3,6,0xb2d3d860d
1976.8,1.0,17,1,2,2,5,0xb2d6fdb8
1500600.96,1.0,0,4,2,4,10,0x3b9ad6ba
52870.09,2.0,0,3,3,4,10,0xb2d2d865d
1906.68,1.0,104,1,2,1,4,0xb2d54b31
115.25,1.0,0,1,2,4,7,0xb2d3f80fd
140438.17,6.0,0,3,4,4,11,0xb2d5ae31d
1.94,1.0,5,1,2,3,6,0xb2d6eaa4
335.01,1.0,9,1,2,3,6,0xb2d6dd9a
1934.6,1.0,57,1,2,2,5,0xb2d5ef25
19.01,2.0,84,1,3,1,5,0xb2d87fe5d
1402.08,4.0,92,1,4,1,6,0xb2d3ce9dd
8373.21,2.0,1,2,3,4,9,0xb2d5a45fd
532321.88,4.0,92,4,4,1,9,0xb2d4132ed
19.64,1.0,32,1,2,2,5,0xb2d6e909
200008.44,2.0,90,3,3,1,7,0xb2d6e45f
21274.87,1.0,2,2,2,4,8,0xb2d58b7a
495188.7,6.0,10,4,4,3,11,0xb2d2c5a9d
1047743.99,7.0,39,4,4,2,10,0xb2d1b04cd
740125.1,2.0,83,4,3,1,8,0xb2d5ce4f
72.48,1.0,6,1,2,3,6,0xb2d6f1fbd
2891.78,1.0,1,2,2,4,8,0xb2d6a30b
464221.44,7.0,0,4,4,4,12,0xb2d55c07
30000.32,2.0,80,2,3,1,6,0xb2d8d77a
10352.29,2.0,18,2,3,2,7,0xb2d5e564d
19144.39,1.0,6,2,2,3,7,0xb2d2e880d
132097.88,3.0,11,3,4,3,10,0x3b9b41d2d
149.28,1.0,75,1,2,1,4,0xb2d1fda2d
67.06,1.0,5,1,2,3,6,0xb2d8d547d
10003.5,2.0,21,2,3,2,7,0xb2d285bfd
20233.2,2.0,108,2,3,1,6,0xb2d19862d
500000.06,3.0,10,4,4,3,11,0xb2d9a76b
2000000.0,2.0,0,4,3,4,11,0xb2d98431
2447.73,1.0,0,1,2,4,7,0xb2d42679
52487.79,2.0,0,3,3,4,10,0xb2d56ca9d
330000.46,6.0,21,4,4,2,10,0xb2d559d6d
50.11,1.0,1,1,2,4,7,0xb2d9165a
10856.4,3.0,1,2,4,4,10,0xb2d0b053d
1060000.01,5.0,4,4,4,4,12,0xb2d7edd3d
610000.77,2.0,15,4,3,3,10,0xb2d1b042
290409.6,4.0,4,3,4,4,11,0xb2d3f242d
1742.55,1.0,92,1,2,1,4,0xb2d4dcf3d
912376.34,7.0,13,4,4,3,11,0xb2d2669bd
527020.67,10.0,12,4,4,3,11,0xb2d6d76ed
486029.44,4.0,0,4,4,4,12,0xb2d23fa0d
11.78,1.0,184,1,2,1,4,0xb2d2d459d
6630.31,1.0,184,2,2,1,5,0xb2d48e08
644.62,1.0,9,1,2,3,6,0xb2d6e30ad
10190.49,2.0,101,2,3,1,6,0xb2d649f7d
1.58,1.0,15,1,2,3,6,0xb2d9b32d
31957.46,2.0,4,2,3,4,9,0xb2d2111bd
1758194.32,2.0,3,4,3,4,11,0xb2d39cd8d
100000.0,2.0,6,3,3,3,9,0xb2d97035d
2063.81,1.0,5,1,2,3,6,0xb2d59b51d
263678.43,3.0,101,3,4,1,8,0xb2d426f1d
1967.67,1.0,184,1,2,1,4,0xb2d2968ed
1500000.0,2.0,1,4,3,4,11,0xb2d97e4dd
50001.78,3.0,6,2,4,3,9,0xb2d6af67d
17604.9,1.0,18,2,2,2,6,0xb2d98abd
50011.91,3.0,97,2,4,1,7,0xb2d0c5cad
86.04,1.0,43,1,2,2,5,0xb2d3e83cd
244567.23,2.0,231,3,3,1,7,0xb2d19230
20007.36,1.0,2,2,2,4,8,0xb2d3b397d
3020000.55,5.0,76,4,4,1,9,0xb2d06829
478038.61,2.0,70,4,3,1,8,0xb2d42629d
602068.64,4.0,0,4,4,4,12,0xb2d24e7bd
1341483.82,12.0,0,4,4,4,12,0xb2d69609d
100045.25,2.0,21,3,3,2,8,0xb2d9c491
1011942.46,3.0,25,4,4,2,10,0xb2d65e4ad
202445.28,1.0,10,3,2,3,8,0xb2d563acd
70341.02,2.0,0,3,3,4,10,0xb2d94856d
470065.62,3.0,2,4,4,4,12,0xb2d69420d
202805.3,2.0,10,3,3,3,9,0xb2d9356fd
101080.75,2.0,209,3,3,1,7,0xb2d60a67d
11.92,2.0,47,1,3,2,6,0xb2d5cd03d
500033.67,2.0,23,4,3,2,9,0xb2d6e6ff
420803.41,7.0,77,4,4,1,9,0xb2d10f21d
3539.49,1.0,204,2,2,1,5,0xb2d1e15fd
2584.05,1.0,184,1,2,1,4,0xb2d11ea4d
11315.06,1.0,6,2,2,3,7,0xb2d42e06d
25000.64,2.0,116,2,3,1,6,0xb2d58f51d
280.5,1.0,73,1,2,1,4,0xb2d473ba
14.91,2.0,27,1,3,2,6,0xb2d30687
133302.54,2.0,4,3,3,4,10,0xb2d14ae0d
45995.55,1.0,5,2,2,3,7,0xb2d60797
623130.07,8.0,3,4,4,4,12,0x3b9b2e07d
20000.63,2.0,53,2,3,2,7,0xb2d9cb26
0.87,1.0,2,1,2,4,7,0xb2d3bca8
150006.34,2.0,28,3,3,2,8,0xb2da0409
1457532.17,3.0,4,4,4,4,12,0x3b9b44b6
7633.44,1.0,13,2,2,3,7,0xb2d20d6a
57630.7,1.0,7,3,2,3,8,0xb2d5613bd
51008.14,2.0,42,2,3,2,7,0xb2d9afd7
600367.58,3.0,9,4,4,3,11,0xb2d95146d
130071.18,2.0,53,3,3,2,8,0xb2d170d9d
230005.51,3.0,92,3,4,1,8,0xb2d2ad71d
23.26,1.0,5,1,2,3,6,0xb2d92f8f
1972379.53,9.0,6,4,4,3,11,0x3b9b18f3d
50639.89,2.0,38,2,3,2,7,0xb2d6e053d
103674.86,2.0,129,3,3,1,7,0xb2d550cdd
60000.03,1.0,0,3,2,4,9,0xb2d54882
2000.0,1.0,3,1,2,4,7,0xb2d0c4f1d
1153043.92,6.0,48,4,4,2,10,0xb2d5ff43
2708.63,1.0,0,1,2,4,7,0xb2d34524
1670085.6,6.0,10,4,4,3,11,0xb2d1f897d
48.5,1.0,9,1,2,3,6,0xb2d913c8d
5046.44,2.0,184,2,3,1,6,0xb2d298dfd
1190145.35,1.0,19,4,2,2,8,0xb2d9aa8b
87146.52,1.0,10,3,2,3,8,0xb2d3e83ad
1217497.97,2.0,10,4,3,3,10,0xb2d45b1a
82108.75,1.0,7,3,2,3,8,0xb2d55302d
80000.84,2.0,49,3,3,2,8,0xb2d92124
100695.28,2.0,19,3,3,2,8,0xb2d3657ad
9730.69,8.0,0,2,4,4,10,0x3b9af29f
1300018.0,2.0,10,4,3,3,10,0xb2d91555
650245.98,6.0,63,4,4,2,10,0xb2d15fcb
4710.95,3.0,1,2,4,4,10,0xb2d6d01ed
338.13,1.0,39,1,2,2,5,0xb2d5ac1b
972000.0,4.0,1,4,4,4,12,0xb2d26528
11.29,8.0,12,1,4,3,8,0xb2d11dadd
11931.59,3.0,6,2,4,3,9,0xb2d07efed
200000.0,2.0,6,3,3,3,9,0xb2d972c1d
410207.87,3.0,87,4,4,1,9,0xb2d61e82d
2478475.99,3.0,11,4,4,3,11,0xb2d1bb9f
8568.6,1.0,25,2,2,2,6,0xb2d4df24d
90031.1,2.0,56,3,3,2,8,0xb2d3db72
1440.78,1.0,0,1,2,4,7,0xb2d1a140
6170.11,1.0,3,2,2,4,8,0xb2d2aca2d
550022.4,5.0,1,4,4,4,12,0xb2d0db33d
100078.52,2.0,92,3,3,1,7,0xb2d400e9d
4431.55,1.0,0,2,2,4,8,0xb2d8cfb3d
2424.01,1.0,8,1,2,3,6,0xb2d912cdd
500000.0,2.0,2,4,3,4,11,0xb2da06cf
511779.54,3.0,33,4,4,2,10,0xb2d6d891d
100009.5,1.0,18,3,2,2,7,0xb2d95af4d
5050.97,1.0,1,2,2,4,8,0xb2d1a428d
480031.73,2.0,165,4,3,1,8,0xb2d550e9d
300044.34,2.0,70,3,3,1,7,0xb2d92c40
409751.21,1.0,18,4,2,2,8,0xb2d58e07
2401.01,1.0,0,1,2,4,7,0xb2d70086d
365.35,1.0,62,1,2,2,5,0xb2d8d154d
160.37,1.0,5,1,2,3,6,0xb2d893d1
10566.79,1.0,1,2,2,4,8,0xb2d34362d
9548.87,1.0,184,2,2,1,5,0xb2d1f56ed
50030.44,2.0,24,2,3,2,7,0xb2d7905f
8499.22,1.0,69,2,2,1,5,0xb2d434dbd
100094.67,2.0,90,3,3,1,7,0xb2d21a9a
2188.53,1.0,0,1,2,4,7,0xb2d3f3b3
45.46,1.0,18,1,2,2,5,0xb2d4eb8b
1755.58,1.0,12,1,2,3,6,0xb2d20866d
22123.31,1.0,204,2,2,1,5,0xb2d27754d
10000.96,2.0,77,2,3,1,6,0xb2d42124
63027.45,2.0,11,3,3,3,9,0xb2d2f28ad
1041.34,1.0,0,1,2,4,7,0xb2d3e985
531973.82,2.0,24,4,3,2,9,0xb2d3a8ac
5274.9,1.0,27,2,2,2,6,0xb2d383c9d
7.08,1.0,4,1,2,4,7,0xb2d79296
7.93,1.0,7,1,2,3,6,0xb2d63bbc
224373.88,2.0,273,3,3,1,7,0xb2d0bf93
2760000.77,4.0,5,4,4,3,11,0xb2d95182d
50001.58,2.0,11,2,3,3,8,0xb2da3b7d
4811.31,1.0,277,2,2,1,5,0xb2d2911bd
102736.14,1.0,6,3,2,3,8,0xb2d47390d
8358.45,1.0,0,2,2,4,8,0xb2d43070d
9.63,1.0,11,1,2,3,6,0xb2d6a01cd
63487.09,6.0,0,3,4,4,11,0xb2d06480d
1044.69,1.0,9,1,2,3,6,0xb2d68864
56284.52,2.0,67,3,3,1,7,0xb2d227e0d
634000.0,14.0,0,4,4,4,12,0xb2d2b774d
300028.36,4.0,19,3,4,2,9,0xb2d5a93dd
200002.11,2.0,25,3,3,2,8,0xb2da1486
1014200.67,6.0,0,4,4,4,12,0xb2d2e976
1971.99,1.0,35,1,2,2,5,0xb2d91929
1405268.81,2.0,30,4,3,2,9,0xb2d8ea18d
151423.11,2.0,12,3,3,3,9,0xb2d10ba0
134.36,1.0,8,1,2,3,6,0xb2d48fd0
10521.85,1.0,33,2,2,2,6,0xb2d8ea6c
1040000.0,10.0,3,4,4,4,12,0x3b9af0d6
120084.39,6.0,0,3,4,4,11,0xb2d430c4d
60000.63,2.0,92,3,3,1,7,0xb2d6591dd
79.39,1.0,53,1,2,2,5,0xb2d5e5bdd
801829.16,3.0,28,4,4,2,10,0xb2d83c7cd
8.12,1.0,49,1,2,2,5,0xb2d6a738
22679.2,1.0,6,2,2,3,7,0xb2d34323
160025.86,2.0,53,3,3,2,8,0xb2d1880a
400000.89,2.0,0,4,3,4,11,0xb2d439abd
23576.8,1.0,18,2,2,2,6,0xb2d60950d
798424.43,8.0,13,4,4,3,11,0xb2d2117ad
61783.56,2.0,108,3,3,1,7,0xb2d5bd1ad
1121134.13,10.0,8,4,4,3,11,0xb2d17a5bd
2957.69,1.0,25,2,2,2,6,0x3b9b4126
80068.71,2.0,0,3,3,4,10,0xb2d6e4f6
100003.17,2.0,42,3,3,2,8,0xb2d9e711
101122.06,2.0,62,3,3,2,8,0xb2d8e8bbd
191007.31,8.0,3,3,4,4,11,0xb2d5ea5ad
3467.52,1.0,184,2,2,1,5,0xb2d22b8fd
310027.76,6.0,8,4,4,3,11,0xb2d367e0d
10080.92,1.0,0,2,2,4,8,0xb2d64ef4d
8.66,1.0,1,1,2,4,7,0xb2d85985d
70006.81,2.0,108,3,3,1,7,0xb2d63df0d
30.64,2.0,3,1,3,4,8,0xb2d22cec
102805.1,2.0,80,3,3,1,7,0xb2d632af
200240.36,3.0,24,3,4,2,9,0xb2d5bf24d
5786.51,1.0,0,2,2,4,8,0xb2d2d3c7
259247.19,8.0,0,3,4,4,11,0xb2d0bf94
250046.71,2.0,76,3,3,1,7,0xb2d6eb46
29948.4,1.0,184,2,2,1,5,0xb2d3facfd
61.98,1.0,3,1,2,4,7,0xb2d2e23f
261041.2,2.0,2,3,3,4,10,0xb2d8f44dd
2.64,1.0,98,1,2,1,4,0xb2d96903d
280110.63,2.0,11,3,3,3,9,0xb2d465dc
35568.44,1.0,5,2,2,3,7,0xb2d264b0d
262918.58,3.0,76,3,4,1,8,0xb2d62cfcd
315753.23,3.0,94,4,4,1,9,0xb2d2a73f
50620.51,3.0,27,2,4,2,8,0xb2d6026fd
60053.64,3.0,0,3,4,4,11,0xb2d15a8fd
80041.35,2.0,3,3,3,4,10,0xb2d623ced
9695.97,1.0,0,2,2,4,8,0xb2d3a8a5d
2300.81,1.0,10,1,2,3,6,0xb2d9419b
3077.26,1.0,92,2,2,1,5,0xb2d5d1f9d
150783.9,2.0,4,3,3,4,10,0xb2d59c1dd
5560.93,2.0,92,2,3,1,6,0xb2d16da6d
71826.0,3.0,10,3,4,3,10,0xb2d5f622
8098.08,1.0,10,2,2,3,7,0xb2d9635c
1536.38,1.0,184,1,2,1,4,0xb2d3b9e5d
20037.49,2.0,12,2,3,3,8,0xb2d42490d
140008.49,4.0,4,3,4,4,11,0xb2d6c7bbd
1000.88,1.0,292,1,2,1,4,0xb2d1b722
9854.28,1.0,5,2,2,3,7,0xb2d29ae8d
154728.13,2.0,165,3,3,1,7,0xb2d5d677d
804974.24,3.0,24,4,4,2,10,0xb2d83847d
100012.26,2.0,41,3,3,2,8,0xb2d6d6fed
1600000.0,2.0,20,4,3,2,9,0xb2d98e56
60001.27,2.0,59,3,3,2,8,0xb2d8fe35d
59.98,1.0,122,1,2,1,4,0xb2d2875ad
8486.79,1.0,0,2,2,4,8,0xb2d3291a
740010.81,9.0,31,4,4,2,10,0xb2d432f0d
650020.38,4.0,4,4,4,4,12,0xb2d95fecd
9.53,1.0,32,1,2,2,5,0xb2d9a650
109473.98,2.0,92,3,3,1,7,0xb2d0957fd
1244.4,1.0,27,1,2,2,5,0xb2d2abba
709346.17,4.0,35,4,4,2,10,0xb2d91f91d
272414.07,5.0,0,3,4,4,11,0xb2d592e3
1063.73,2.0,184,1,3,1,5,0xb2d2776fd
600120.35,4.0,18,4,4,2,10,0xb2d41796
1.63,1.0,60,1,2,2,5,0xb2d6cc75
400000.0,3.0,10,4,4,3,11,0xb2d96f4d
6107.47,7.0,0,2,4,4,10,0xb2d6cfc4
13677.79,1.0,92,2,2,1,5,0xb2d102ecd
330003.06,2.0,4,4,3,4,11,0xb2da3492
80016.55,2.0,200,3,3,1,7,0xb2d5aa1ed
688.82,1.0,10,1,2,3,6,0xb2d92ea0
213002.25,2.0,42,3,3,2,8,0xb2d9e83a
1253.08,1.0,92,1,2,1,4,0xb2d5c5a2
2023.2,1.0,92,1,2,1,4,0xb2d233ccd
238338.86,11.0,6,3,4,3,10,0xb2d233bc
101893.81,2.0,34,3,3,2,8,0xb2d31f8e
883.08,1.0,0,1,2,4,7,0xb2d6a1ce
51269.19,2.0,134,2,3,1,6,0xb2d632dbd
60220.05,1.0,92,3,2,1,6,0xb2d5f49ad
107874.96,7.0,0,3,4,4,11,0xb2d61b71d
15.35,1.0,9,1,2,3,6,0xb2d6c4ff
404053.08,4.0,102,4,4,1,9,0xb2d2453dd
2352.55,1.0,0,1,2,4,7,0xb2d26714d
1000052.76,2.0,22,4,3,2,9,0xb2d6928e
154.4,1.0,0,1,2,4,7,0xb2d2b765d
13121.13,1.0,14,2,2,3,7,0xb2d6a559d
50011.17,2.0,0,2,3,4,9,0xb2d63959
1112.55,1.0,68,1,2,1,4,0xb2d65c5ed
772446.62,6.0,0,4,4,4,12,0xb2d08318
6127.3,1.0,27,2,2,2,6,0xb2d0f209d
147306.79,1.0,13,3,2,3,8,0xb2d390a5d
412.05,1.0,74,1,2,1,4,0xb2d3d13cd
2462.52,1.0,98,1,2,1,4,0xb2d3731fd
50259.79,1.0,0,2,2,4,8,0xb2d2f538d
300016.17,2.0,212,3,3,1,7,0xb2d5a786d
55099.7,2.0,92,3,3,1,7,0x3b9b3ad9
80699.58,5.0,38,3,4,2,9,0xb2d59a67d
17672.93,1.0,1,2,2,4,8,0xb2d1f712d
215134.94,2.0,186,3,3,1,7,0xb2d3f5d9d
100003.17,2.0,214,3,3,1,7,0xb2d74be7
7885.73,1.0,92,2,2,1,5,0xb2d1f5edd
100449.8,3.0,122,3,4,1,8,0xb2d10e65
441521.85,3.0,27,4,4,2,10,0xb2d1ec89d
0.23,1.0,1,1,2,4,7,0xb2d69712d
30999.62,1.0,0,2,2,4,8,0xb2d8167cd
200000.0,2.0,0,3,3,4,10,0xb2d97276
100051.83,2.0,27,3,3,2,8,0xb2d8c3f3
327065.73,5.0,0,4,4,4,12,0xb2d56dced
40.22,1.0,1,1,2,4,7,0xb2d23219
350104.94,3.0,23,4,4,2,10,0xb2d6e002
1230006.13,4.0,6,4,4,3,11,0xb2d58a76d
600801.19,5.0,38,4,4,2,10,0xb2d20aecd
44449.75,1.0,0,2,2,4,8,0xb2d61d01d
2190.68,2.0,184,1,3,1,5,0xb2d0aba5
413.63,1.0,5,1,2,3,6,0xb2d10c85
78.77,3.0,78,1,4,1,6,0xb2d5f163d
220004.64,5.0,20,3,4,2,9,0xb2d6ec62d
20800.31,1.0,16,2,2,2,6,0xb2d43ac1d
27409.35,1.0,18,2,2,2,6,0xb2d6c482d
16741.41,1.0,184,2,2,1,5,0xb2d18b5dd
190.38,1.0,6,1,2,3,6,0xb2d5578cd
30001.27,2.0,94,2,3,1,6,0xb2d85ed7d
8093.35,1.0,69,2,2,1,5,0xb2d22ae9d
61868.28,1.0,41,3,2,2,7,0xb2d36c42d
8068.88,1.0,0,2,2,4,8,0xb2d6b7d9
400175.35,3.0,0,4,4,4,12,0xb2d1a177d
1305.91,1.0,1,1,2,4,7,0xb2d964a9
13418.77,2.0,0,2,3,4,9,0xb2d5e779
9445.13,1.0,1,2,2,4,8,0xb2d63b99
55587.83,2.0,62,3,3,2,8,0xb2d1ed05
200031.17,2.0,4,3,3,4,10,0xb2d6788a
335.64,1.0,8,1,2,3,6,0xb2d1c6ae
51454.96,2.0,87,2,3,1,6,0xb2d1f0a7d
845.66,1.0,10,1,2,3,6,0xb2d996c8
2070.38,1.0,184,1,2,1,4,0xb2d56e6cd
356068.58,3.0,0,4,4,4,12,0xb2d9f685
6008.76,5.0,305,2,4,1,7,0xb2d17ecfd
600760.41,3.0,14,4,4,3,11,0xb2d7ecac
51200.33,1.0,53,2,2,2,6,0xb2d53f3cd
470006.4,3.0,4,4,4,4,12,0xb2d233a1
240044.6,2.0,0,3,3,4,10,0xb2d689efd
6349.02,4.0,0,2,4,4,10,0xb2d06774d
505329.75,2.0,99,4,3,1,8,0xb2d96e93d
10000.43,2.0,21,2,3,2,7,0xb2da1c18
221019.75,6.0,27,3,4,2,9,0xb2d6d9efd
720000.0,3.0,1,4,4,4,12,0xb2da4e82
1385.81,1.0,65,1,2,2,5,0xb2d398ebd
4782.32,1.0,0,2,2,4,8,0xb2d906a3d
200085.95,8.0,20,3,4,2,9,0xb2d21b81
104.3,1.0,6,1,2,3,6,0xb2d4b6d8
13266.83,1.0,101,2,2,1,5,0xb2d4061ad
871.99,1.0,0,1,2,4,7,0xb2d8ec14
360532.9,2.0,66,4,3,2,9,0xb2d395f1d
6898.84,1.0,20,2,2,2,6,0xb2d12ae8d
83.55,1.0,3,1,2,4,7,0xb2d53134
61507.99,2.0,48,3,3,2,8,0xb2d6c21cd
250000.0,2.0,53,3,3,2,8,0xb2d9d43f
257591.93,9.0,0,3,4,4,11,0xb2d0c37dd
380461.77,3.0,41,4,4,2,10,0xb2d59022d
1904582.66,20.0,0,4,4,4,12,0x3b9addb5d
50875.3,2.0,235,2,3,1,6,0xb2d62779d
646010.3,5.0,0,4,4,4,12,0xb2d27ce7
536.5,1.0,5,1,2,3,6,0xb2d23eee
207000.72,2.0,8,3,3,3,9,0xb2d9a6f9
830313.91,5.0,11,4,4,3,11,0xb2d41a32d
200027.22,2.0,74,3,3,1,7,0xb2d97494
344941.39,3.0,24,4,4,2,10,0x3b9b3d6dd
4240.67,1.0,184,2,2,1,5,0xb2d21564d
150057.03,3.0,103,3,4,1,8,0xb2d68b5f
50605.79,3.0,11,2,4,3,9,0xb2d0b34ed
1332033.03,8.0,0,4,4,4,12,0xb2d3e7c2d
2017.91,1.0,92,1,2,1,4,0xb2d34ba7d
3475.77,1.0,14,2,2,3,7,0xb2d8cff5
300119.18,2.0,6,4,3,3,10,0xb2d26964
3203396.6,6.0,6,4,4,3,11,0xb2d6471a
92060.76,5.0,18,3,4,2,9,0xb2d2444dd
202132.21,2.0,84,3,3,1,7,0xb2d9519cd
302131.88,2.0,22,4,3,2,9,0xb2d7a719
100981.42,2.0,101,3,3,1,7,0xb2d5f884
100044.37,2.0,249,3,3,1,7,0xb2d6134bd
91.26,1.0,10,1,2,3,6,0xb2d9e8de
2003.46,1.0,116,1,2,1,4,0xb2d43470
287.67,1.0,64,1,2,2,5,0xb2d67cc0d
413033.71,6.0,10,4,4,3,11,0xb2d2a83cd
34031.9,1.0,0,2,2,4,8,0xb2d7055bd
13169.17,1.0,143,2,2,1,5,0xb2d51fa6
2100.95,1.0,46,1,2,2,5,0xb2d9d475
247145.5,3.0,27,3,4,2,9,0xb2d5ce50d
89034.75,2.0,82,3,3,1,7,0xb2d28751d
2000048.81,4.0,38,4,4,2,10,0xb2d44427
3.06,1.0,167,1,2,1,4,0xb2d8cdffd
255078.34,2.0,0,3,3,4,10,0xb2d0d67ed
2372.9,1.0,92,1,2,1,4,0xb2d0cb7b
200252.87,2.0,10,3,3,3,9,0xb2d1ee4fd
49.31,1.0,73,1,2,1,4,0xb2d560a4
505330.25,2.0,17,4,3,2,9,0xb2d7c053d
333310.23,2.0,0,4,3,4,11,0xb2d1c953
557311.95,3.0,28,4,4,2,10,0xb2d4129e
400027.08,3.0,0,4,4,4,12,0xb2d687f0d
3742.06,1.0,7,2,2,3,7,0xb2d94a5dd
112001.43,4.0,18,3,4,2,9,0xb2d8f723d
500000.95,2.0,5,4,3,3,10,0xb2d94ef9d
664137.9,7.0,17,4,4,2,10,0xb2d143d7d
500077.58,2.0,67,4,3,1,8,0xb2d9817b
435004.59,2.0,66,4,3,2,9,0xb2d8f20ed
450002.82,3.0,17,4,4,2,10,0xb2d6e6e0d
55002.9,2.0,13,3,3,3,9,0xb2da309e
1123.49,1.0,92,1,2,1,4,0xb2d20f02d
1341990.69,3.0,1,4,4,4,12,0xb2d53d2e
191086.48,14.0,0,3,4,4,11,0xb2d573b2d
430094.36,6.0,11,4,4,3,11,0xb2d206d2d
5057.78,1.0,92,2,2,1,5,0xb2d3b252d
240477.43,4.0,1,3,4,4,11,0xb2d1a2aad
22889.57,1.0,14,2,2,3,7,0xb2d5b207
250300.16,2.0,21,3,3,2,8,0xb2d9112bd
250007.99,2.0,0,3,3,4,10,0xb2d53ac4d
9678.3,1.0,22,2,2,2,6,0xb2d21a28d
105089.03,4.0,0,3,4,4,11,0xb2d5ec61d
708157.46,4.0,0,4,4,4,12,0xb2d0bb13d
10141541.07,3.0,20,4,4,2,10,0xb2d91979d
3010656.7,2.0,29,4,3,2,9,0xb2d6b350
50182.53,2.0,206,2,3,1,6,0xb2d5bd60d
41.35,1.0,3,1,2,4,7,0xb2d6f609
84.45,1.0,53,1,2,2,5,0xb2d5f22cd
40106.2,2.0,1,2,3,4,9,0xb2d6a4b0
879.72,1.0,55,1,2,2,5,0xb2d5cc03
129345.42,2.0,228,3,3,1,7,0xb2d123c6
6358.38,1.0,92,2,2,1,5,0xb2d2ec4ad
500205.02,7.0,19,4,4,2,10,0xb2d48b5ad
281008.03,6.0,12,3,4,3,10,0xb2d563e8
6217.49,1.0,0,2,2,4,8,0xb2d92d9c
475936.66,1.0,152,4,2,1,7,0xb2d14049d
273117.87,5.0,5,3,4,3,10,0xb2d0e7ccd
318.56,1.0,9,1,2,3,6,0xb2d2d6c8d
277.75,1.0,18,1,2,2,5,0xb2d93c3c
5380.84,1.0,11,2,2,3,7,0xb2d1dc2d
218268.14,2.0,42,3,3,2,8,0xb2d167a4d
830302.5,6.0,41,4,4,2,10,0xb2d14639d
2970.3,1.0,4,2,2,4,8,0xb2d3bd85d
1548.35,1.0,0,1,2,4,7,0xb2d2fd9bd
21.66,1.0,19,1,2,2,5,0xb2d23e24d
225907.45,1.0,184,3,2,1,6,0xb2d5983ad
560069.23,4.0,3,4,4,4,12,0xb2d0f995d
352008.46,3.0,95,4,4,1,9,0xb2d5bd90d
573162.15,5.0,3,4,4,4,12,0xb2d126fad
16993.14,1.0,3,2,2,4,8,0xb2d6e795
804417.02,11.0,40,4,4,2,10,0xb2d34451
24424.75,1.0,20,2,2,2,6,0xb2d68e2dd
10318.54,1.0,20,2,2,2,6,0xb2d6af55
50093.31,1.0,0,2,2,4,8,0xb2d3cf5c
505.92,1.0,48,1,2,2,5,0xb2d42b00d
4639.93,1.0,29,2,2,2,6,0xb2d9be2f
20268.64,1.0,21,2,2,2,6,0xb2d8e25a
1993139.58,7.0,20,4,4,2,10,0xb2d5c085
60010.28,2.0,92,3,3,1,7,0xb2d97f59d
910000.0,5.0,1,4,4,4,12,0xb2d748bc
170083.78,5.0,73,3,4,1,8,0xb2d2b854d
23594.27,1.0,0,2,2,4,8,0xb2d32613
7920.45,2.0,0,2,3,4,9,0x3b9b4686d
8192.04,1.0,92,2,2,1,5,0xb2d0659ed
1048.19,1.0,2,1,2,4,7,0xb2d173cc
168322.35,3.0,0,3,4,4,11,0x3b9b2558d
53004.98,2.0,221,3,3,1,7,0xb2d288a2d
3599.78,1.0,184,2,2,1,5,0xb2d40925d
310.96,1.0,90,1,2,1,4,0xb2d813aa
913946.27,7.0,0,4,4,4,12,0xb2d0a941d
1310000.0,1.0,1,4,2,4,10,0xb2da5d83
0.0,2.0,0,1,3,4,8,0x3b9b1c0b
4439.71,1.0,9,2,2,3,7,0xb2d955c8d
48.22,1.0,0,1,2,4,7,0xb2d5d5f7d
4174.01,1.0,92,2,2,1,5,0xb2d2d9de
9.98,1.0,33,1,2,2,5,0xb2d5d5ddd
307003.32,4.0,21,4,4,2,10,0xb2d26ff8d
2.12,1.0,62,1,2,2,5,0xb2d2a627
2197.99,1.0,70,1,2,1,4,0xb2d2cfca
3032385.6,1.0,6,4,2,3,9,0xb2d3cbeb
169.1,1.0,5,1,2,3,6,0xb2d9086a
210004.44,3.0,6,3,4,3,10,0xb2d96e87d
208307.16,5.0,48,3,4,2,9,0xb2d38697d
1489.38,1.0,9,1,2,3,6,0xb2d68217d
162303.93,2.0,0,3,3,4,10,0xb2d1e6c6d
82439.46,2.0,12,3,3,3,9,0xb2d22ac0
465015.3,2.0,18,4,3,2,9,0xb2d600d6d
40001.27,2.0,80,2,3,1,6,0xb2d98ad9
66105.07,2.0,11,3,3,3,9,0xb2d755ad
800358.87,3.0,60,4,4,2,10,0xb2d3e2b0d
200710.46,2.0,46,3,3,2,8,0xb2d9e527
82120.7,3.0,60,3,4,2,9,0xb2d283d1d
0.0,1.0,0,1,2,4,7,0xb2d0f48ed
202164.02,3.0,6,3,4,3,10,0xb2d5bd2dd
32647.55,1.0,1,2,2,4,8,0xb2d65036
500021.15,2.0,92,4,3,1,8,0xb2d6693cd
65.35,1.0,66,1,2,2,5,0xb2d28760d
400710.51,3.0,5,4,4,3,11,0xb2d8f725d
954.73,1.0,49,1,2,2,5,0xb2d417f7d
1892.87,1.0,9,1,2,3,6,0xb2d4197b
265778.34,3.0,10,3,4,3,10,0xb2d4418ed
627697.8,18.0,3,4,4,4,12,0x3b9b177d
42220.78,1.0,7,2,2,3,7,0xb2d40d54d
190062.61,5.0,3,3,4,4,11,0xb2d0779fd
4.22,1.0,53,1,2,2,5,0xb2d97451
118222.67,1.0,111,3,2,1,6,0xb2d445c5d
537391.17,6.0,0,4,4,4,12,0xb2d09249
1665.53,1.0,92,1,2,1,4,0xb2d2350ed
1872.93,1.0,52,1,2,2,5,0xb2d8d8ecd
1524000.97,4.0,6,4,4,3,11,0xb2d8ea86d
7575.87,1.0,92,2,2,1,5,0xb2d250e2d
4380.44,2.0,29,2,3,2,7,0xb2d067bf
260001.76,5.0,21,3,4,2,9,0xb2d5b54cd
151810.45,3.0,18,3,4,2,9,0xb2d34be7
123110.14,2.0,102,3,3,1,7,0xb2d2532bd
7585.72,1.0,92,2,2,1,5,0xb2d0c057d
250033.11,3.0,76,3,4,1,8,0xb2d16786d
277857.92,2.0,0,3,3,4,10,0xb2d27c75
3903.42,1.0,0,2,2,4,8,0xb2d8f23f
1334.25,1.0,0,1,2,4,7,0xb2d553c3
50988.16,1.0,0,2,2,4,8,0xb2d61eced
450000.0,3.0,1,4,4,4,12,0xb2d983dfd
203743.23,3.0,78,3,4,1,8,0x3b9b2f77d
0.0,2.0,60,1,3,2,6,0xb2d4fa1e
701.61,3.0,1,1,4,4,9,0xb2d0d971
677.6,3.0,0,1,4,4,9,0x3b9b259f
322985.36,2.0,0,4,3,4,11,0xb2d1523cd
7.21,1.0,81,1,2,1,4,0xb2d62ed3d
61162.8,2.0,0,3,3,4,10,0xb2d48a92
352324.27,5.0,11,4,4,3,11,0xb2d5ae3d
20000.21,2.0,80,2,3,1,6,0xb2d8d782d
688300.56,4.0,27,4,4,2,10,0xb2d10db0d
3840.08,1.0,2,2,2,4,8,0xb2d3bd4a
366006.37,9.0,3,4,4,4,12,0xb2d5df44d
219001.37,5.0,9,3,4,3,10,0xb2d5b068
1195.93,1.0,92,1,2,1,4,0xb2d2a52a
311085.57,7.0,11,4,4,3,11,0xb2d563e8d
3453.5,1.0,0,2,2,4,8,0xb2d416c2
500000.0,2.0,11,4,3,3,10,0xb2da4a4f
1114355.92,2.0,11,4,3,3,10,0xb2d6b939d
70875.26,4.0,185,3,4,1,8,0xb2d5e5e7
1091256.74,1.0,0,4,2,4,10,0xb2d6f4c7
505235.23,3.0,0,4,4,4,12,0xb2d6324dd
14.48,1.0,17,1,2,2,5,0xb2d57bcb
220002.64,3.0,6,3,4,3,10,0xb2d69813
201476.72,3.0,28,3,4,2,9,0xb2d0b85cd
342880.8,2.0,217,4,3,1,8,0xb2d0f83bd
429326.46,6.0,7,4,4,3,11,0xb2d08da4
4079531.25,8.0,2,4,4,4,12,0xb2d221e8d
1648.98,2.0,92,1,3,1,5,0xb2d193db
1403967.49,2.0,27,4,3,2,9,0xb2d1a4edd
2576.67,1.0,1,1,2,4,7,0xb2d6c8b1
5072.03,1.0,25,2,2,2,6,0xb2d6da6d
1.82,1.0,184,1,2,1,4,0xb2d2e90ad
10067.91,1.0,11,2,2,3,7,0xb2d17857
20093.04,3.0,11,2,4,3,9,0xb2d65c44
70362.12,3.0,18,3,4,2,9,0xb2d530c9
157668.77,1.0,76,3,2,1,6,0xb2d3f78ad
10167.65,2.0,10,2,3,3,8,0xb2d86a8ad
10.63,1.0,41,1,2,2,5,0xb2d40e1d
52696.63,1.0,92,3,2,1,6,0xb2d140e3d
19062.6,2.0,167,2,3,1,6,0xb2d5a961
285851.08,5.0,3,3,4,4,11,0xb2d26769
704.97,1.0,39,1,2,2,5,0xb2d16e0dd
2070.13,2.0,9,1,3,3,7,0xb2d19bc0d
900076.08,4.0,11,4,4,3,11,0xb2d9e7ba
361695.06,1.0,11,4,2,3,9,0xb2d08f5ad
1.0,1.0,184,1,2,1,4,0xb2d29f93d
40032.44,1.0,39,2,2,2,6,0xb2d46eda
1140713.46,6.0,8,4,4,3,11,0xb2d8dff3d
6176.48,1.0,8,2,2,3,7,0xb2d3b568d
560002.46,4.0,63,4,4,2,10,0xb2d5cc96d
412737.52,4.0,9,4,4,3,11,0xb2d48bd3
390426.12,8.0,18,4,4,2,10,0xb2d3a4bdd
90000.95,2.0,18,3,3,2,8,0xb2d949bed
471463.75,5.0,6,4,4,3,11,0x3b9af129
12151.69,1.0,2,2,2,4,8,0xb2d200bcd
13894.9,1.0,92,2,2,1,5,0xb2d08eabd
31858.93,1.0,11,2,2,3,7,0xb2d2b5f4d
190000.0,8.0,0,3,4,4,11,0xb2d5b4c6d
2.32,1.0,1,1,2,4,7,0xb2d386cb
3050.73,3.0,0,2,4,4,10,0x3b9b45af
300207.4,5.0,41,4,4,2,10,0xb2d21e0ad
230040.9,3.0,6,3,4,3,10,0xb2d51bc2d
746612.35,4.0,21,4,4,2,10,0xb2d4d916d
400001.0,2.0,7,4,3,3,10,0xb2d96858d
84982.23,1.0,0,3,2,4,9,0xb2d6962fd
500015.83,2.0,92,4,3,1,8,0xb2d97d42d
70042.23,2.0,21,3,3,2,8,0xb2d11c91d
486976.03,4.0,6,4,4,3,11,0xb2d170cc
314.7,1.0,88,1,2,1,4,0xb2d53645d
200046.44,2.0,80,3,3,1,7,0xb2d821cad
710002.31,3.0,14,4,4,3,11,0xb2d9d7ec
50088.37,4.0,125,2,4,1,7,0xb2d5a191d
430024.93,9.0,20,4,4,2,10,0xb2d6ed4ed
300089.66,2.0,96,3,3,1,7,0xb2d7549cd
39.88,1.0,7,1,2,3,6,0xb2d21f17
303804.02,4.0,11,4,4,3,11,0xb2d163a8d
1703436.0,4.0,0,4,4,4,12,0xb2d37081d
1165.3,1.0,0,1,2,4,7,0xb2d6a567d
1831.36,1.0,53,1,2,2,5,0xb2d8cc93
66.72,1.0,16,1,2,2,5,0xb2d38fa9
34121.66,2.0,101,2,3,1,6,0xb2d0cfa8d
100280.99,2.0,4,3,3,4,10,0xb2d69c7bd
230017.09,2.0,63,3,3,2,8,0xb2d9b097
701407.28,11.0,5,4,4,3,11,0xb2d59063d
77534.99,1.0,30,3,2,2,7,0xb2d63c33d
600978.38,11.0,0,4,4,4,12,0xb2d18b2dd
4311.41,1.0,7,2,2,3,7,0xb2d6bc91
50000.5,2.0,3,2,3,4,9,0xb2d972bbd
88.45,1.0,0,1,2,4,7,0xb2d2bce1
686.04,1.0,19,1,2,2,5,0xb2d37cd6
337955.73,13.0,0,4,4,4,12,0xb2d1a8fd
2737.61,1.0,9,1,2,3,6,0xb2d2e78bd
20124.68,1.0,184,2,2,1,5,0xb2d439b1d
288975.59,3.0,4,3,4,4,11,0xb2d1be9d
82069.43,2.0,52,3,3,2,8,0xb2d6d6a5d
60197.73,1.0,103,3,2,1,6,0xb2d33d9ad
1511.32,1.0,29,1,2,2,5,0xb2d5b986
10000.0,2.0,1,2,3,4,9,0xb2d96a7e
1730080.04,7.0,1,4,4,4,12,0xb2d5ebe1d
127.04,1.0,10,1,2,3,6,0xb2d9e0d7
1872.84,1.0,0,1,2,4,7,0xb2d6cedf
550000.0,2.0,0,4,3,4,11,0xb2d5e487d
102000.11,2.0,5,3,3,3,9,0xb2d68871d
321662.88,52.0,8,4,4,3,11,0xb2d224dad
410089.56,3.0,143,4,4,1,9,0xb2d1c6f5
461634.06,2.0,17,4,3,2,9,0xb2d9e4c9
6153.96,1.0,3,2,2,4,8,0xb2d311add
436941.78,3.0,165,4,4,1,9,0xb2d1a35fd
205168.28,2.0,3,3,3,4,10,0xb2d4f6b2d
450000.0,2.0,13,4,3,3,10,0xb2da3fdd
6048.44,1.0,12,2,2,3,7,0xb2d2fcd2d
12.0,2.0,19,1,3,2,6,0xb2d1f988d
1841734.43,8.0,42,4,4,2,10,0xb2d230ff
739040.64,4.0,60,4,4,2,10,0xb2d1b15a
0.0,1.0,3,1,2,4,7,0xb2d8f84c
510934.01,2.0,7,4,3,3,10,0xb2d5e25bd
13837.64,1.0,0,2,2,4,8,0xb2d916e4
354727.41,5.0,110,4,4,1,9,0xb2d25b0dd
132314.87,1.0,11,3,2,3,8,0xb2d38990d
2601.06,1.0,0,1,2,4,7,0xb2d6fee1d
1714.89,1.0,184,1,2,1,4,0xb2d2419ed
894.34,1.0,1,1,2,4,7,0xb2d9638b
118.12,1.0,46,1,2,2,5,0xb2d62179d
0.0,1.0,6,1,2,3,6,0xb2d9c635
1055.07,1.0,184,1,2,1,4,0x3b9b0e0ad
507892.62,4.0,1,4,4,4,12,0x3b9b40ae
1318.06,1.0,77,1,2,1,4,0xb2d767b9d
3886044.19,5.0,19,4,4,2,10,0xb2d21284d
739643.44,3.0,87,4,4,1,9,0xb2d22f27
550231.3,25.0,4,4,4,4,12,0xb2d104d8d
1406044.68,7.0,6,4,4,3,11,0xb2d11877d
200126.97,2.0,92,3,3,1,7,0xb2d36311d
50058.51,3.0,42,2,4,2,8,0xb2d51f6fd
1115348.91,13.0,1,4,4,4,12,0xb2d0c210d
262912.95,1.0,12,3,2,3,8,0xb2d39665d
23037.08,1.0,26,2,2,2,6,0xb2d8f09ed
62470.09,2.0,136,3,3,1,7,0xb2d2c54ed
362593.18,1.0,0,4,2,4,10,0xb2d24e20
468351.25,2.0,172,4,3,1,8,0xb2d25017d
1000092.43,3.0,24,4,4,2,10,0xb2d6dd3ad
20000.78,2.0,249,2,3,1,6,0xb2d69a9a
102570.34,2.0,10,3,3,3,9,0xb2d41111d
1016.17,1.0,184,1,2,1,4,0xb2d2ebabd
4113.94,1.0,33,2,2,2,6,0xb2d0e012
1616.18,1.0,0,1,2,4,7,0xb2d32c15d
500722.47,2.0,143,4,3,1,8,0xb2d62660d
673.82,1.0,6,1,2,3,6,0xb2d2541f
33178.71,1.0,1,2,2,4,8,0xb2d8d3abd
5186.53,1.0,39,2,2,2,6,0xb2d6a7d4d
317187.54,3.0,0,4,4,4,12,0xb2d6d803d
9.74,1.0,6,1,2,3,6,0xb2d8693b
230048.9,2.0,13,3,3,3,9,0xb2d6fa9bd
25125.94,1.0,3,2,2,4,8,0xb2d8dc20d
1505.19,1.0,0,1,2,4,7,0xb2d3465cd
515728.6,3.0,14,4,4,3,11,0xb2d10ffbd
2480412.05,4.0,27,4,4,2,10,0xb2d1bb9fd
568182.06,3.0,18,4,4,2,10,0xb2d22df8d
903065.09,14.0,0,4,4,4,12,0xb2d5ad92d
200000.01,2.0,16,3,3,2,8,0xb2d5bd41d
455890.85,3.0,0,4,4,4,12,0xb2d57281d
10035.1,1.0,92,2,2,1,5,0xb2d5c2f5d
382915.82,5.0,22,4,4,2,10,0xb2d58a50d
28.2,1.0,1,1,2,4,7,0xb2d3dc8ed
2203.38,1.0,32,1,2,2,5,0xb2d9cc0f
350866.94,4.0,13,4,4,3,11,0xb2d193acd
1691212.23,15.0,6,4,4,3,11,0xb2d15150d
66.75,1.0,12,1,2,3,6,0xb2d6844b
254883.28,2.0,34,3,3,2,8,0xb2d35df4d
462677.89,11.0,0,4,4,4,12,0x3b9b46bc
113028.7,2.0,77,3,3,1,7,0xb2d24519d
80002.74,3.0,92,3,4,1,8,0xb2d57f3a
734447.48,7.0,6,4,4,3,11,0xb2d0da07
868.61,1.0,0,1,2,4,7,0xb2d40904
23111.14,2.0,0,2,3,4,9,0xb2d3479fd
383617.1,5.0,3,4,4,4,12,0xb2d2488dd
319.24,1.0,0,1,2,4,7,0xb2d6f631
2151.15,1.0,3,1,2,4,7,0xb2d85cbb
211900.67,3.0,50,3,4,2,9,0xb2d2c32c
35013.68,5.0,47,2,4,2,8,0x3b9b26ebd
236156.54,3.0,12,3,4,3,10,0xb2d0f817d
200495.19,2.0,0,3,3,4,10,0xb2d2bc2b
1098.11,1.0,1,1,2,4,7,0xb2d2cc34
870671.21,5.0,1,4,4,4,12,0xb2d2732ed
2198.01,1.0,0,1,2,4,7,0xb2d50371d
280180.43,5.0,11,3,4,3,10,0xb2d33ae2
21315.63,1.0,3,2,2,4,8,0xb2d2c3ac
55576.52,1.0,8,3,2,3,8,0xb2d640ffd
159795.38,2.0,21,3,3,2,8,0xb2d4dc22d
85139.1,5.0,1,3,4,4,11,0xb2d0f5ecd
19089685.75,7.0,3,4,4,4,12,0xb2d06ac3d
130739.76,2.0,104,3,3,1,7,0xb2d606d5d
1001000.0,3.0,9,4,4,3,11,0xb2d6be62
36657.05,3.0,73,2,4,1,7,0xb2d1c503d
120411.06,3.0,184,3,4,1,8,0xb2d08e29d
3458.79,1.0,4,2,2,4,8,0xb2d6cec6d
300003.17,3.0,102,3,4,1,8,0xb2d960c8d
34.46,1.0,34,1,2,2,5,0xb2d2a3f5d
24548.91,1.0,11,2,2,3,7,0xb2d3404dd
283.95,1.0,11,1,2,3,6,0xb2d93bb5
431708.9,2.0,83,4,3,1,8,0xb2d1258dd
726040.92,4.0,0,4,4,4,12,0xb2d13f15d
569130.28,5.0,83,4,4,1,9,0xb2d24460d
50004.33,2.0,74,2,3,1,6,0xb2d660e7
1946.25,1.0,0,1,2,4,7,0xb2d485bdd
306226.53,6.0,18,4,4,2,10,0xb2d63d1ad
20866.7,1.0,2,2,2,4,8,0xb2d29dce
260013.51,2.0,11,3,3,3,9,0xb2d53a88
617027.08,2.0,26,4,3,2,9,0xb2d566ced
6036.75,1.0,11,2,2,3,7,0xb2d8b3c1d
261418.36,2.0,36,3,3,2,8,0xb2d6a9fd
2760000.0,6.0,2,4,4,4,12,0xb2d636eb
254029.26,4.0,12,3,4,3,10,0xb2d13267d
9.22,1.0,5,1,2,3,6,0xb2d6e271
5286.85,1.0,184,2,2,1,5,0xb2d3c071d
150020.53,2.0,108,3,3,1,7,0xb2d6ec5c
40256.57,4.0,18,2,4,2,8,0xb2d7827ad
18462.09,1.0,13,2,2,3,7,0xb2d6ebd9d
5000000.0,1.0,0,4,2,4,10,0xb2da6a4e
20000.21,2.0,18,2,3,2,7,0xb2d95845d
0.77,1.0,74,1,2,1,4,0xb2d6446bd
430569.36,4.0,193,4,4,1,9,0x3b9b2cc3d
4.24,1.0,157,1,2,1,4,0xb2d57c23d
860884.61,7.0,4,4,4,4,12,0xb2d1a1d4d
1353.42,1.0,37,1,2,2,5,0xb2d5da0fd
200002.11,2.0,11,3,3,3,9,0xb2da4694
202926.51,2.0,136,3,3,1,7,0xb2d552c7
100488.12,2.0,1,3,3,4,10,0xb2d5fbd9d
1003.42,1.0,184,1,2,1,4,0xb2d65573d
275274.64,5.0,19,3,4,2,9,0x3b9b4639
303209.5,2.0,74,4,3,1,8,0xb2d420d8d
50351.65,2.0,61,2,3,2,7,0xb2d62408
1431.99,1.0,39,1,2,2,5,0xb2d69088
409591.65,6.0,22,4,4,2,10,0xb2d59f36d
103.7,1.0,1,1,2,4,7,0xb2d42b65
1.01,1.0,0,1,2,4,7,0xb2d6bf28d
7058.88,1.0,0,2,2,4,8,0xb2d91b6c
1450.74,1.0,10,1,2,3,6,0xb2d3f37cd
711438.75,4.0,1,4,4,4,12,0xb2d3cc71d
1614.16,1.0,9,1,2,3,6,0xb2d2da6f
154059.73,2.0,118,3,3,1,7,0xb2d564c8d
299599.64,5.0,111,3,4,1,8,0xb2d2b9ff
52.92,1.0,9,1,2,3,6,0xb2d178d4
3500000.6,5.0,0,4,4,4,12,0xb2d54f78d
50875.03,2.0,263,2,3,1,6,0xb2d50d46
450098.44,2.0,3,4,3,4,11,0xb2da02f5
2128.09,1.0,0,1,2,4,7,0xb2d66663
30340.07,2.0,116,2,3,1,6,0xb2d6fbecd
15021.45,2.0,0,2,3,4,9,0xb2d31d68
135002.51,2.0,4,3,3,4,10,0xb2d1fb29
2264.81,1.0,32,1,2,2,5,0xb2d6e098
0.01,1.0,65,1,2,2,5,0xb2d20aded
29467.14,4.0,0,2,4,4,10,0xb2d53039
300018.42,3.0,39,3,4,2,9,0xb2d988e3
192081.15,4.0,12,3,4,3,10,0xb2d07d92
500000.0,2.0,0,4,3,4,11,0xb2d98409d
200000.53,2.0,13,3,3,3,9,0xb2d959b9d
16216.13,2.0,13,2,3,3,8,0xb2d3e021d
10681.13,1.0,2,2,2,4,8,0xb2d21bded
280011.96,2.0,53,3,3,2,8,0xb2d9d0dc
46664.16,1.0,10,2,2,3,7,0xb2d9856c
1162.66,1.0,92,1,2,1,4,0xb2d39923d
201913.11,2.0,0,3,3,4,10,0xb2d5f90fd
1488.54,1.0,24,1,2,2,5,0xb2d2d472d
275133.71,7.0,0,3,4,4,11,0xb2d59812d
31483.47,1.0,135,2,2,1,5,0xb2d4e78cd
362772.06,3.0,6,4,4,3,11,0xb2d940d9d
80000.63,3.0,7,3,4,3,10,0xb2d68b36
10044.87,2.0,26,2,3,2,7,0xb2d14378d
341436.43,11.0,0,4,4,4,12,0xb2d26b6bd
6657.76,1.0,1,2,2,4,8,0xb2d52c35
121.76,1.0,4,1,2,4,7,0xb2d62536d
1000010.56,3.0,83,4,4,1,9,0xb2d8d177
1001.19,1.0,153,1,2,1,4,0xb2d8faa8
2370.04,1.0,8,1,2,3,6,0xb2d425f0
362004.95,10.0,13,4,4,3,11,0xb2d1b00fd
640976.68,7.0,4,4,4,4,12,0xb2d2b4b7d
6619.34,2.0,92,2,3,1,6,0xb2d073edd
121518.73,2.0,35,3,3,2,8,0xb2d67eaa
18065.99,1.0,28,2,2,2,6,0xb2d3a847d
1.06,1.0,112,1,2,1,4,0xb2d94b7dd
205069.97,2.0,0,3,3,4,10,0xb2d802db
500000.0,2.0,28,4,3,2,9,0xb2da0dc7
50005.06,4.0,62,2,4,2,8,0xb2d15b84d
28146.19,2.0,14,2,3,3,8,0xb2d53fd1
210.63,7.0,0,1,4,4,9,0xb2d19dddd
2032.47,2.0,9,1,3,3,7,0xb2d56993
1010929.66,3.0,58,4,4,2,10,0xb2d92507d
54695.32,2.0,8,3,3,3,9,0xb2d23601
150000.0,3.0,5,3,4,3,10,0xb2d40f60d
603069.67,3.0,47,4,4,2,10,0xb2d18834d
250015.95,7.0,48,3,4,2,9,0x3b9b3124
200000.0,1.0,7,3,2,3,8,0xb2da2323
20205.69,1.0,12,2,2,3,7,0xb2d2d798d
66121.53,1.0,6,3,2,3,8,0xb2d38a51d
1000000.0,1.0,6,4,2,3,9,0xb2da4c75
638.2,2.0,21,1,3,2,6,0xb2d56bf8
166132.07,8.0,7,3,4,3,10,0xb2d597ced
352.47,1.0,92,1,2,1,4,0xb2d22d43d
243051.37,3.0,2,3,4,4,11,0xb2d2765e
734235.1,3.0,31,4,4,2,10,0xb2d11defd
21.3,1.0,27,1,2,2,5,0xb2d4a448
663009.21,3.0,82,4,4,1,9,0xb2d6428ad
2565.25,1.0,60,1,2,2,5,0xb2d43298d
50105.66,2.0,18,2,3,2,7,0xb2d9df6c
10205.96,1.0,92,2,2,1,5,0xb2d5bc49d
50001.58,2.0,39,2,3,2,7,0xb2d9ec04
304751.23,2.0,30,4,3,2,9,0xb2d4b313d
1905.14,1.0,25,1,2,2,5,0xb2d2ee5b
300069.88,5.0,14,3,4,3,10,0xb2d23e79
216108.61,2.0,83,3,3,1,7,0xb2d3c750d
3003068.72,6.0,83,4,4,1,9,0xb2d0c90ad
1451.01,3.0,92,1,4,1,6,0x3b9adf46d
0.5,1.0,11,1,2,3,6,0xb2d614cc
21.22,1.0,194,1,2,1,4,0xb2d34236d
9655.74,1.0,11,2,2,3,7,0xb2d3f726d
45.32,1.0,15,1,2,3,6,0xb2d37cd0
40187.88,1.0,206,2,2,1,5,0xb2d1fbd9d
2943.25,1.0,19,2,2,2,6,0xb2d6d13bd
1111.43,1.0,106,1,2,1,4,0xb2d8cd1d
288.56,1.0,56,1,2,2,5,0xb2d564fa
280713.71,3.0,6,3,4,3,10,0xb2d9050ad
1740.22,1.0,4,1,2,4,7,0xb2d6a6b8d
193507.48,4.0,11,3,4,3,10,0xb2d4e826d
446166.09,4.0,0,4,4,4,12,0xb2d3612a
3.7,6.0,43,1,4,2,7,0x3b9ad060d
9008263.89,2.0,0,4,3,4,11,0xb2d92960d
400000.0,3.0,3,4,4,4,12,0xb2d97e0ed
303077.35,1.0,11,4,2,3,9,0xb2d50e61
2574.65,1.0,6,1,2,3,6,0xb2d2ea1e
492236.93,5.0,1,4,4,4,12,0xb2d6584e
12150589.65,1.0,3,4,2,4,10,0xb2d3b8b4
687384.16,1.0,22,4,2,2,8,0xb2d3dd26d
132331.96,3.0,132,3,4,1,8,0xb2d59684
55890.27,3.0,3,3,4,4,11,0xb2d29707d
12188.88,1.0,17,2,2,2,6,0xb2d99d82
43002.64,4.0,31,2,4,2,8,0xb2d37338
11299.65,1.0,7,2,2,3,7,0xb2d8c51e
154944.54,1.0,0,3,2,4,9,0xb2d1ec42d
2035.93,1.0,92,1,2,1,4,0xb2d3dfbcd
2409.93,1.0,14,1,2,3,6,0xb2d17ed1
294235.85,4.0,4,3,4,4,11,0xb2d94b2d
191.21,1.0,8,1,2,3,6,0xb2d2457ad
3210045.26,5.0,0,4,4,4,12,0xb2d59039d
500000.0,3.0,8,4,4,3,11,0xb2d958d4d
110192.18,2.0,32,3,3,2,8,0xb2d201c1
82.1,1.0,0,1,2,4,7,0xb2d31195d
4217.37,1.0,0,2,2,4,8,0xb2d989e7
2298.36,1.0,1,1,2,4,7,0xb2d1c127
4649.68,1.0,148,2,2,1,5,0xb2d2b935d
93.65,1.0,15,1,2,3,6,0xb2d609ae
83.71,1.0,19,1,2,2,5,0xb2d68a48d
100011.08,2.0,172,3,3,1,7,0xb2d8d742d
170001.59,3.0,0,3,4,4,11,0xb2da0233
182717.71,2.0,113,3,3,1,7,0xb2d6be03d
4778.84,1.0,184,2,2,1,5,0xb2d128e5d
10409.23,2.0,111,2,3,1,6,0xb2d251bad
5403.29,1.0,5,2,2,3,7,0xb2d2085bd
451689.6,3.0,35,4,4,2,10,0xb2d5af38d
9967.96,2.0,166,2,3,1,6,0xb2d6059fd
308101.01,2.0,94,4,3,1,8,0xb2d10817
20.55,2.0,34,1,3,2,6,0xb2d2bc4e
64.29,1.0,9,1,2,3,6,0xb2d3429dd
364500.62,5.0,42,4,4,2,10,0xb2d581aad
4139.08,1.0,10,2,2,3,7,0xb2d2a31fd
97806.55,1.0,162,3,2,1,6,0xb2d5fbbcd
6406.92,1.0,184,2,2,1,5,0xb2d24ca6d
350000.0,2.0,3,4,3,4,11,0xb2d9fdee
50676.06,2.0,214,2,3,1,6,0xb2d0c00cd
190008.03,2.0,125,3,3,1,7,0xb2d71a0fd
200806.25,2.0,17,3,3,2,8,0xb2d6321cd
670051.17,5.0,12,4,4,3,11,0xb2d68707d
8606.65,1.0,20,2,2,2,6,0xb2d337b3d
20218.61,2.0,216,2,3,1,6,0xb2d5ec54d
447724.75,2.0,32,4,3,2,9,0xb2d27417
1620166.33,3.0,2,4,4,4,12,0xb2d22a7a
954.58,1.0,81,1,2,1,4,0xb2d27ecad
101623.82,3.0,21,3,4,2,9,0xb2d598f1
80001.53,3.0,98,3,4,1,8,0xb2d9312ed
774.77,1.0,0,1,2,4,7,0xb2d6a8e1d
151117.76,3.0,136,3,4,1,8,0xb2d3a94dd
300070.55,4.0,0,3,4,4,11,0xb2d14fc8d
0.0,1.0,92,1,2,1,4,0xb2d2844ed
414657.98,2.0,11,4,3,3,10,0xb2d63e79d
250150.25,2.0,31,3,3,2,8,0xb2d5e3a6
11121.82,1.0,10,2,2,3,7,0xb2d99ec1
114407.16,2.0,92,3,3,1,7,0xb2d2e9f0d
2441449.47,1.0,143,4,2,1,7,0xb2d6edc3
55.76,1.0,48,1,2,2,5,0xb2d1116b
144917.88,1.0,49,3,2,2,7,0xb2d2f0ea
836.27,2.0,2,1,3,4,8,0x3b9b19fdd
4565.93,1.0,0,2,2,4,8,0xb2d0d9dc
75962.25,2.0,12,3,3,3,9,0xb2d5ddf2
12114.08,1.0,184,2,2,1,5,0xb2d238f9d
13676.6,1.0,92,2,2,1,5,0xb2d3e93ad
1296.8,1.0,92,1,2,1,4,0xb2d39ab6d
1017596.08,35.0,0,4,4,4,12,0xb2d0dc0dd
83381.46,3.0,168,3,4,1,8,0xb2d49f85d
200004.22,2.0,94,3,3,1,7,0xb2d881e6
18140.97,1.0,2,2,2,4,8,0xb2d62671
6727.79,1.0,132,2,2,1,5,0xb2d57934d
291424.99,4.0,8,3,4,3,10,0xb2d695c5d
40008.35,2.0,171,2,3,1,6,0xb2d5b12bd
500044.42,3.0,21,4,4,2,10,0xb2d43d75d
1054304.26,3.0,7,4,4,3,11,0xb2d08558d
3542.87,2.0,124,2,3,1,6,0x3b9b47c0
1050.08,1.0,250,1,2,1,4,0xb2d2ea3ed
240037.27,2.0,129,3,3,1,7,0xb2d5c55cd
516276.14,4.0,38,4,4,2,10,0xb2d1e103d
309041.83,3.0,14,4,4,3,11,0xb2d5585bd
150064.13,2.0,188,3,3,1,7,0xb2d420d6d
744.4,1.0,0,1,2,4,7,0xb2d41053d
240062.68,5.0,10,3,4,3,10,0xb2d57101
420025.0,10.0,19,4,4,2,10,0xb2d6dec8
83079.12,3.0,11,3,4,3,10,0xb2d55c3dd
75000.0,6.0,0,3,4,4,11,0xb2d5c945
27626.06,2.0,67,2,3,1,6,0xb2d2d231d
1477.28,1.0,92,1,2,1,4,0xb2d40853d
207114.1,2.0,127,3,3,1,7,0xb2d685efd
600819.18,5.0,73,4,4,1,9,0xb2d65067d
1021973.06,5.0,46,4,4,2,10,0xb2d0d436d
10.56,1.0,60,1,2,2,5,0xb2d8f465
33587.29,1.0,87,2,2,1,5,0xb2d2b45a
500000.0,3.0,1,4,4,4,12,0xb2d98248d
99.01,5.0,10,1,4,3,8,0x3b9af158
7910.64,1.0,60,2,2,2,6,0xb2d1c89ed
2241.32,1.0,0,1,2,4,7,0xb2d341c4
208283.59,1.0,118,3,2,1,6,0xb2d44119d
494000.0,5.0,0,4,4,4,12,0xb2d1772b
41119.44,1.0,0,2,2,4,8,0xb2d6f728
11180.55,1.0,1,2,2,4,8,0xb2d0b43f
15569.12,1.0,9,2,2,3,7,0xb2d9082ad
90001.9,2.0,94,3,3,1,7,0xb2d879bed
1703.59,1.0,0,1,2,4,7,0xb2d70218d
8272.99,1.0,0,2,2,4,8,0xb2d43c13
350033.26,6.0,13,4,4,3,11,0xb2d254b8
4632.67,1.0,1,2,2,4,8,0xb2d23c40d
257.34,1.0,8,1,2,3,6,0xb2d6cbd7d
1.07,1.0,6,1,2,3,6,0xb2d0b8a9
854395.13,7.0,14,4,4,3,11,0x3b9b3998d
121342.08,3.0,40,3,4,2,9,0xb2d91fa3d
25233.27,2.0,165,2,3,1,6,0xb2d58e01d
75767.75,2.0,92,3,3,1,7,0xb2d51518d
500000.0,2.0,13,4,3,3,10,0xb2d9608d
222.58,4.0,0,1,4,4,9,0x3b9b2cbb
437484.7,3.0,24,4,4,2,10,0xb2d10aafd
71240.4,2.0,206,3,3,1,7,0xb2d5c1c3
342212.43,6.0,11,4,4,3,11,0xb2d579e5d
259.98,1.0,3,1,2,4,7,0xb2d2a135
191142.3,5.0,66,3,4,2,9,0xb2d3b356d
1610233.93,5.0,3,4,4,4,12,0xb2d99f79
2477.08,2.0,260,1,3,1,5,0xb2d2644cd
6817.02,1.0,0,2,2,4,8,0xb2d0bc64
536346.78,5.0,5,4,4,3,11,0xb2d0bc3fd
602623.6,2.0,0,4,3,4,11,0xb2d9da68
23931.87,1.0,0,2,2,4,8,0xb2d5c5a5d
1506.73,1.0,0,1,2,4,7,0xb2d8ea4d
1310000.0,3.0,7,4,4,3,11,0xb2da5190
170102.68,3.0,62,3,4,2,9,0xb2d6e881d
1056088.87,2.0,0,4,3,4,11,0xb2d5866cd
155719.67,3.0,25,3,4,2,9,0xb2d2903bd
309.65,6.0,6,1,4,3,8,0x3b9b29da
648039.92,7.0,55,4,4,2,10,0xb2d20505
175.14,1.0,43,1,2,2,5,0xb2d2eec4
2111.27,1.0,120,1,2,1,4,0xb2d74458
18.48,1.0,18,1,2,2,5,0xb2d93c7c
2222.58,1.0,1,1,2,4,7,0xb2d963ea
1605.66,1.0,143,1,2,1,4,0xb2d4c0b4
600211.11,7.0,0,4,4,4,12,0xb2d3a1d6
211504.73,3.0,26,3,4,2,9,0xb2d437fbd
50307.86,2.0,9,2,3,3,8,0xb2d09a42
190007.24,2.0,2,3,3,4,10,0xb2d23247
66859.48,1.0,141,3,2,1,6,0xb2d37cf2d
311900.09,3.0,12,4,4,3,11,0xb2d1a0aa
30045.38,2.0,4,2,3,4,9,0xb2d5a681d
120000.0,2.0,3,3,3,4,10,0xb2d628e6d
3254.71,1.0,237,2,2,1,5,0xb2d4889cd
282008.84,6.0,3,3,4,4,11,0xb2d45c54d
2.68,3.0,35,1,4,2,7,0xb2d08f6d
10344.88,2.0,28,2,3,2,7,0xb2d9d8f6
55733.6,2.0,164,3,3,1,7,0xb2d142b8d
3627.94,1.0,17,2,2,2,6,0xb2d1c3d2d
501776.09,3.0,42,4,4,2,10,0xb2d923f8d
72487.7,2.0,3,3,3,4,10,0xb2d60968d
20001.69,2.0,11,2,3,3,8,0xb2d9d816
81.01,1.0,35,1,2,2,5,0xb2d17506d
416377.08,3.0,18,4,4,2,10,0xb2d4219bd
450025.96,6.0,83,4,4,1,9,0xb2d61a18d
0.03,1.0,5,1,2,3,6,0xb2d59f78
650448.06,6.0,41,4,4,2,10,0xb2d56c93d
20000.63,2.0,32,2,3,2,7,0xb2d9fdef
1000031.67,2.0,31,4,3,2,9,0xb2d936e0
15536.26,1.0,13,2,2,3,7,0xb2d5d2e3d
401420.89,3.0,29,4,4,2,10,0xb2d8fb9ad
40007.24,3.0,71,2,4,1,7,0xb2d3db72d
924453.1,5.0,13,4,4,3,11,0xb2d2eac0d
2356.12,1.0,17,1,2,2,5,0xb2d222cb
1261.15,1.0,92,1,2,1,4,0xb2d43e24
341314.08,8.0,8,4,4,3,11,0xb2d5b4d6d
1001.32,1.0,10,1,2,3,6,0xb2d37075d
303809.46,3.0,41,4,4,2,10,0xb2d680cad
5034.94,1.0,256,2,2,1,5,0xb2d251e5d
441918.81,4.0,92,4,4,1,9,0xb2d2af6ad
62091.69,2.0,92,3,3,1,7,0xb2d47ba0d
1010000.0,39.0,3,4,4,4,12,0xb2d5621c
81035.35,2.0,104,3,3,1,7,0xb2d5f20ad
38.51,1.0,11,1,2,3,6,0xb2d627ba
20457.26,1.0,0,2,2,4,8,0xb2d55413d
370839.58,3.0,4,4,4,4,12,0xb2d97c90d
321020.35,2.0,143,4,3,1,8,0xb2d34efcd
155083.09,3.0,101,3,4,1,8,0xb2d229c1
13447989.88,8.0,0,4,4,4,12,0xb2d0a1e9d
100103.79,2.0,108,3,3,1,7,0xb2d63242d
276786.63,6.0,0,3,4,4,11,0xb2d212f3d
616496.71,5.0,0,4,4,4,12,0xb2d34ef3d
39.16,1.0,39,1,2,2,5,0xb2d8edf0
51.99,1.0,6,1,2,3,6,0xb2d2ec3d
46482.06,2.0,0,2,3,4,9,0xb2d0a76ed
344462.42,4.0,4,4,4,4,12,0xb2d2b397d
11125.93,1.0,5,2,2,3,7,0xb2d33db7d
2459016.67,33.0,1,4,4,4,12,0xb2d1be8bd
2819.14,2.0,92,1,3,1,5,0x3b9b0f6f
51706.03,4.0,27,2,4,2,8,0xb2d9fed3
211193.74,1.0,67,3,2,1,6,0xb2d3ba9c
9.03,1.0,17,1,2,2,5,0xb2d2c5ed
247020.88,2.0,18,3,3,2,8,0xb2d576e9
33500.94,1.0,5,2,2,3,7,0xb2d2a91fd
200098.49,4.0,75,3,4,1,8,0xb2d4107fd
507201.86,8.0,11,4,4,3,11,0xb2d4b2ebd
115.98,1.0,22,1,2,2,5,0xb2d38cf9
454.31,2.0,18,1,3,2,6,0xb2d24cb9d
556552.8,4.0,19,4,4,2,10,0xb2d29b66d
10000.21,2.0,80,2,3,1,6,0xb2d98dcd
2.64,1.0,25,1,2,2,5,0xb2d4b981
14276.85,3.0,184,2,4,1,7,0x3b9b380d
400730.51,3.0,14,4,4,3,11,0xb2d93472
207210.39,12.0,0,3,4,4,11,0x3b9b4622d
220115.19,8.0,13,3,4,3,10,0xb2d5f78b
26907.06,1.0,1,2,2,4,8,0xb2d3ab6ad
460078.31,6.0,21,4,4,2,10,0xb2d4f35cd
695356.94,8.0,0,4,4,4,12,0xb2d3dba1d
3106.73,3.0,169,2,4,1,7,0xb2d37f0ad
12949.29,1.0,5,2,2,3,7,0xb2d240c9
3284.59,1.0,28,2,2,2,6,0xb2d1b287d
8218.11,1.0,12,2,2,3,7,0xb2d5eb2b
204109.78,4.0,24,3,4,2,9,0xb2d2ef66
1092.19,1.0,92,1,2,1,4,0xb2d30bb8d
95.0,1.0,29,1,2,2,5,0xb2d93e62
1620.62,1.0,92,1,2,1,4,0xb2d1ce13d
179016.16,6.0,18,3,4,2,9,0xb2d617c4d
100002.59,3.0,263,3,4,1,8,0xb2d07cd1
5327.3,1.0,184,2,2,1,5,0xb2d169abd
11055.04,2.0,0,2,3,4,9,0xb2d09e09d
679621.09,5.0,8,4,4,3,11,0xb2d4195dd
117.34,1.0,10,1,2,3,6,0xb2d7185ed
3600.19,1.0,92,2,2,1,5,0xb2d5729bd
666682.8,3.0,21,4,4,2,10,0xb2d41964d
102174.16,2.0,12,3,3,3,9,0xb2d648e7
10.98,1.0,75,1,2,1,4,0xb2d8d7dbd
800055.06,3.0,90,4,4,1,9,0xb2d36fa3d
1560000.62,6.0,5,4,4,3,11,0xb2d22bd4d
120002.53,2.0,116,3,3,1,7,0xb2d9493bd
100005.28,2.0,20,3,3,2,8,0xb2da1a88
260000.0,2.0,19,3,3,2,8,0xb2d95838
10685.05,1.0,259,2,2,1,5,0xb2d23921d
400044.91,3.0,0,4,4,4,12,0xb2d900e0d
56001.23,2.0,0,3,3,4,10,0xb2d1713b
250000.0,2.0,21,3,3,2,8,0xb2da251a
230014.18,5.0,59,3,4,2,9,0xb2d07e67d
1276.01,1.0,184,1,2,1,4,0xb2d29fe3d
105014.99,3.0,53,3,4,2,9,0xb2d08529d
2846.83,1.0,221,1,2,1,4,0xb2d58d09d
50000.53,2.0,92,2,3,1,6,0xb2d646b3
151398.8,1.0,0,3,2,4,9,0xb2d94605d
109475.95,1.0,0,3,2,4,9,0xb2d90c7a
1217.28,1.0,92,1,2,1,4,0xb2d152e6d
350000.0,2.0,14,4,3,3,10,0xb2d95f32d
0.86,1.0,25,1,2,2,5,0xb2d87bedd
50002.11,2.0,217,2,3,1,6,0xb2d717a3
603364.38,3.0,47,4,4,2,10,0xb2d0fb3dd
1715715.42,3.0,15,4,4,3,11,0xb2d6c814d
6112.06,1.0,0,2,2,4,8,0xb2d58a2bd
214088.4,3.0,25,3,4,2,9,0xb2d2a02c
554602.5,2.0,6,4,3,3,10,0xb2d13f36d
12715.99,1.0,92,2,2,1,5,0xb2d3a4abd
26110.87,1.0,157,2,2,1,5,0xb2d6c3d4
414864.8,1.0,184,4,2,1,7,0xb2d25be2d
770666.01,5.0,39,4,4,2,10,0xb2d3b631d
260265.99,4.0,0,3,4,4,11,0xb2d2ad04d
5069.43,1.0,184,2,2,1,5,0xb2d3239c
70002.43,3.0,35,3,4,2,9,0xb2d9844b
2305.61,1.0,92,1,2,1,4,0xb2d0e686d
284615.57,3.0,0,3,4,4,11,0xb2d410e8d
349442.18,4.0,1,4,4,4,12,0xb2d5007cd
72.77,1.0,60,1,2,2,5,0xb2d653a9
90001.96,4.0,59,3,4,2,9,0xb2d8c91ed
22363.82,1.0,92,2,2,1,5,0xb2d39d39d
52.95,1.0,2,1,2,4,7,0xb2d19f97
306097.34,13.0,0,4,4,4,12,0xb2d09cfad
1218.36,1.0,184,1,2,1,4,0xb2d22350d
1637875.03,5.0,11,4,4,3,11,0xb2d179f4d
50.78,30.0,22,1,4,2,7,0xb2d212d0d
1020223.85,1.0,12,4,2,3,9,0xb2d5a829
7.8,1.0,0,1,2,4,7,0xb2d956f3
1144.05,1.0,92,1,2,1,4,0xb2d5a0b2d
255401.35,1.0,19,3,2,2,7,0xb2d26be9
30009.02,2.0,70,2,3,1,6,0xb2d5b05dd
203251.68,5.0,5,3,4,3,10,0xb2d2506ed
1698.9,1.0,3,1,2,4,7,0xb2d6cd48
400000.83,2.0,9,4,3,3,10,0xb2d92821
1010.52,1.0,184,1,2,1,4,0xb2d235bbd
35039.93,1.0,0,2,2,4,8,0xb2d6d2afd
143407.62,4.0,3,3,4,4,11,0xb2d26bced
377213.65,1.0,92,4,2,1,7,0xb2d2f60ad
751166.48,3.0,2,4,4,4,12,0xb2d1c78fd
250000.11,2.0,21,3,3,2,8,0xb2d8d4b6d
493269.96,9.0,40,4,4,2,10,0xb2d102c5
30001.27,2.0,21,2,3,2,7,0xb2da1c43
10110.61,2.0,3,2,3,4,9,0xb2da162c
167214.07,3.0,12,3,4,3,10,0xb2d43444d
928.78,1.0,1,1,2,4,7,0xb2d95276d
370.86,1.0,88,1,2,1,4,0xb2d1df25d
105025.36,3.0,196,3,4,1,8,0xb2d441bcd
18393.65,1.0,159,2,2,1,5,0xb2d1f376d
21374.59,2.0,39,2,3,2,7,0xb2d5a9e9
4243.52,1.0,10,2,2,3,7,0xb2d716c2
922415.68,4.0,196,4,4,1,9,0xb2d0a6c2d
820771.98,5.0,0,4,4,4,12,0xb2d5fb62d
22829.14,1.0,49,2,2,2,6,0xb2d6e0f2d
451310.4,3.0,6,4,4,3,11,0xb2d2d688d
35429.92,1.0,24,2,2,2,6,0xb2d2ec8bd
16216.82,1.0,0,2,2,4,8,0xb2d36a08
52610.85,2.0,74,3,3,1,7,0xb2d55ecfd
520011.87,4.0,5,4,4,3,11,0xb2d684b4d
50057.99,3.0,143,2,4,1,7,0x3b9b452a
5001456.84,4.0,168,4,4,1,9,0xb2d639afd
2862.26,1.0,0,1,2,4,7,0xb2d06486
840051.16,4.0,57,4,4,2,10,0xb2d15348d
43314.96,1.0,5,2,2,3,7,0xb2d416bf
50000.41,3.0,6,2,4,3,9,0xb2d1700cd
847196.44,20.0,0,4,4,4,12,0x3b9b48a9d
480052.3,4.0,3,4,4,4,12,0xb2d49d8dd
270138.02,2.0,5,3,3,3,9,0xb2d5b62d
455081.32,5.0,116,4,4,1,9,0xb2d51866d
0.0,2.0,27,1,3,2,6,0xb2d52e1b
7.89,1.0,67,1,2,1,4,0xb2d2ea10
692757.49,4.0,80,4,4,1,9,0xb2d1ee2fd
307200.15,5.0,25,4,4,2,10,0xb2d18c69d
867324.6,4.0,5,4,4,3,11,0xb2d5cb62d
557724.94,6.0,41,4,4,2,10,0xb2d46d99d
29.62,1.0,5,1,2,3,6,0xb2d2aae5
1075669.68,5.0,208,4,4,1,9,0xb2d1032cd
400010.06,3.0,14,4,4,3,11,0xb2da20cc
2582.23,1.0,0,1,2,4,7,0xb2d4b72d
100276.95,4.0,13,3,4,3,10,0xb2d0dbc2d
0.36,1.0,0,1,2,4,7,0xb2d6b183
870.58,3.0,0,1,4,4,9,0xb2d06a19
96002.83,4.0,14,3,4,3,10,0xb2d5e3dd
67.4,1.0,9,1,2,3,6,0xb2d8f100
100019.54,3.0,3,3,4,4,11,0xb2d58259
0.42,1.0,81,1,2,1,4,0xb2d5a7be
100005.68,2.0,62,3,3,2,8,0xb2d9a15a
306064.56,3.0,67,4,4,1,9,0xb2d13269d
6000000.0,1.0,0,4,2,4,10,0xb2da6c4f
950017.82,4.0,0,4,4,4,12,0xb2d107f8d
1313865.79,2.0,11,4,3,3,10,0xb2d25636d
2087.24,1.0,92,1,2,1,4,0xb2d1a56fd
200025.33,2.0,5,3,3,3,9,0xb2d94b61
50003.41,2.0,20,2,3,2,7,0xb2d566e6
8406.4,1.0,17,2,2,2,6,0xb2d0f434d
5046.38,1.0,92,2,2,1,5,0xb2d29131d
220049.36,6.0,0,3,4,4,11,0xb2d6e2c6d
500000.83,1.0,4,4,2,4,10,0xb2d0d293
8944.61,1.0,47,2,2,2,6,0xb2d14fe7
10001.46,2.0,8,2,3,3,8,0xb2d6a9b8d
2096325.27,2.0,19,4,3,2,9,0xb2d33393
5038.48,1.0,0,2,2,4,8,0xb2d6500b
130468.59,3.0,21,3,4,2,9,0xb2d8d61cd
927466.67,6.0,31,4,4,2,10,0xb2d09a94d
1488.13,1.0,184,1,2,1,4,0xb2d21d45d
104160.17,1.0,112,3,2,1,6,0xb2d201f8
736479.2,3.0,204,4,4,1,9,0xb2d50619
320000.0,7.0,3,4,4,4,12,0xb2d58d33d
20920.63,1.0,21,2,2,2,6,0xb2da07cd
3556613.36,1.0,92,4,2,1,7,0xb2d0dbc3d
1250188.83,5.0,6,4,4,3,11,0xb2d54de7
1072923.58,1.0,0,4,2,4,10,0xb2d55db0
15.28,1.0,4,1,2,4,7,0xb2d564d9
5982.29,1.0,10,2,2,3,7,0xb2d6d690d
20.58,1.0,43,1,2,2,5,0xb2d8cbbe
53035.81,2.0,81,3,3,1,7,0xb2d23725d
655392.0,5.0,0,4,4,4,12,0xb2d38d61
263126.92,5.0,32,3,4,2,9,0xb2d1079ed
813.15,1.0,15,1,2,3,6,0xb2d38d7cd
8763.63,1.0,0,2,2,4,8,0xb2d6b52e
10274.3,1.0,9,2,2,3,7,0xb2d37c17
4806.33,1.0,1,2,2,4,8,0xb2d6fff2
1952010.21,5.0,0,4,4,4,12,0x3b9b1b74d
4489.36,1.0,94,2,2,1,5,0xb2d39771d
10609.08,1.0,1,2,2,4,8,0xb2d408bd
28.38,1.0,71,1,2,1,4,0xb2d6a209d
1835.97,1.0,0,1,2,4,7,0xb2d6c3f0
6760.3,1.0,3,2,2,4,8,0xb2d8226cd
1330540.55,3.0,0,4,4,4,12,0xb2d412c0
3899.07,1.0,1,2,2,4,8,0xb2d8cf15
15538.54,1.0,3,2,2,4,8,0xb2d62d83
50091.7,2.0,95,2,3,1,6,0xb2d10821
320100.49,3.0,25,4,4,2,10,0xb2d518efd
100000.0,3.0,7,3,4,3,10,0xb2d0b566
10115.18,1.0,29,2,2,2,6,0xb2d92d2a
4237.51,1.0,4,2,2,4,8,0xb2d2b7abd
148.91,1.0,11,1,2,3,6,0xb2d9d5f6
1639.75,1.0,0,1,2,4,7,0xb2d36b27d
410069.04,1.0,0,4,2,4,10,0xb2d37988d
0.53,1.0,208,1,2,1,4,0xb2d786d1
258047.77,10.0,24,3,4,2,9,0xb2d416f2d
78949.6,13.0,18,3,4,2,9,0xb2d5249c
50002.7,2.0,192,2,3,1,6,0xb2d11608d
150503.04,3.0,168,3,4,1,8,0xb2d3f6f5d
1099.96,1.0,113,1,2,1,4,0xb2d129bdd
10075.54,3.0,9,2,4,3,9,0x3b9ada91d
7672.97,1.0,22,2,2,2,6,0xb2d632c5
1506.59,2.0,92,1,3,1,5,0xb2d32f3bd
1112.14,2.0,8,1,3,3,7,0xb2d2d84cd
160023.96,3.0,95,3,4,1,8,0xb2d2d6c6d
661871.78,3.0,8,4,4,3,11,0xb2d30997d
136820.4,8.0,0,3,4,4,11,0xb2d31d6c
29328.71,1.0,20,2,2,2,6,0xb2d60a36
446574.24,4.0,13,4,4,3,11,0xb2d3864e
70057.9,2.0,70,3,3,1,7,0xb2d65714d
609256.98,4.0,3,4,4,4,12,0xb2d24387d
6235.33,1.0,10,2,2,3,7,0xb2d4461cd
505339.11,2.0,95,4,3,1,8,0xb2d95f03
1302.13,1.0,0,1,2,4,7,0xb2d91303
67001.71,4.0,32,3,4,2,9,0xb2d63b28d
10000.11,2.0,41,2,3,2,7,0xb2d9221dd
4231.28,1.0,12,2,2,3,7,0xb2d2953ed
20203.84,1.0,191,2,2,1,5,0xb2d6181bd
32.73,1.0,11,1,2,3,6,0xb2d98c9b
2030349.3,9.0,83,4,4,1,9,0xb2d65857d
72105.76,2.0,200,3,3,1,7,0xb2d36c23d
3574.11,1.0,0,2,2,4,8,0xb2d29d35d
6334.2,1.0,0,2,2,4,8,0xb2d3aaccd
9102.93,2.0,12,2,3,3,8,0xb2d07504d
3316120.74,9.0,0,4,4,4,12,0xb2d10a3cd
140000.0,3.0,5,3,4,3,10,0xb2d07742d
948082.11,4.0,0,4,4,4,12,0xb2d1ada2d
60000.63,3.0,53,3,4,2,9,0xb2d0b9e5
30000.71,4.0,45,2,4,2,8,0xb2d6d012
260007.6,7.0,69,3,4,1,8,0xb2d144c2
12015.05,3.0,0,2,4,4,10,0x3b9b2baed
207.82,2.0,0,1,3,4,8,0xb2d4f93d
23553.24,1.0,162,2,2,1,5,0xb2d41c92d
101207.89,1.0,39,3,2,2,7,0xb2d1fa38d
130002.75,3.0,122,3,4,1,8,0xb2d6acdcd
10421.95,1.0,102,2,2,1,5,0xb2d3bc2fd
579312.22,6.0,19,4,4,2,10,0xb2d56e57d
2200000.79,1.0,1,4,2,4,10,0xb2d9c22f
50024.47,2.0,153,2,3,1,6,0xb2d0cd57
131946.92,2.0,8,3,3,3,9,0xb2d15074d
170053.84,4.0,47,3,4,2,9,0x3b9b2c17d
1334.55,1.0,10,1,2,3,6,0xb2d279dc
40001.29,2.0,70,2,3,1,6,0xb2d9a5ac
551388.52,7.0,107,4,4,1,9,0xb2d08908
83.56,1.0,9,1,2,3,6,0xb2d4c7a0
1.81,1.0,12,1,2,3,6,0xb2d5be69d
83953.55,2.0,80,3,3,1,7,0xb2d17d90
653034.45,3.0,8,4,4,3,11,0xb2d5ad42d
410125.82,3.0,0,4,4,4,12,0xb2d8fc95
2233.81,1.0,20,1,2,2,5,0xb2d2e2c4d
155153.49,2.0,12,3,3,3,9,0xb2d56862d
340011.4,3.0,11,4,4,3,11,0xb2da1b13
389971.97,1.0,2,4,2,4,10,0xb2d338ddd
800053.84,5.0,1,4,4,4,12,0xb2d6dc22d
69885.57,4.0,3,3,4,4,11,0xb2d1163bd
220000.42,3.0,5,3,4,3,10,0xb2da38dc
71000.88,2.0,7,3,3,3,9,0xb2d39ef7
316.79,1.0,10,1,2,3,6,0xb2d8fbd4
20001.69,2.0,60,2,3,2,7,0xb2d9af84
72.01,1.0,9,1,2,3,6,0xb2d33ebb
253843.64,3.0,39,3,4,2,9,0xb2d576c5d
150003.31,4.0,112,3,4,1,8,0xb2d593c1
500608.14,3.0,83,4,4,1,9,0xb2d15c16d
360023.64,4.0,83,4,4,1,9,0xb2d15660
365.64,1.0,3,1,2,4,7,0xb2d2a9f7d
50012.93,2.0,186,2,3,1,6,0xb2d24544d
32827.79,1.0,10,2,2,3,7,0xb2d2b7a2
7.24,1.0,74,1,2,1,4,0xb2d5a640
1260.2,1.0,92,1,2,1,4,0xb2d071ecd
375.25,1.0,41,1,2,2,5,0xb2d9652f
147206.89,3.0,160,3,4,1,8,0xb2d50f9a
1161.32,1.0,7,1,2,3,6,0xb2d41266
10133.3,2.0,0,2,3,4,9,0xb2d54b39d
14774.61,1.0,21,2,2,2,6,0xb2d96484
155241.26,1.0,0,3,2,4,9,0xb2d6223fd
100040.14,4.0,82,3,4,1,8,0xb2d6c600
521694.36,5.0,4,4,4,4,12,0xb2d5eab3d
14253.98,1.0,184,2,2,1,5,0xb2d14cbed
1411.33,1.0,184,1,2,1,4,0xb2d5ddd3d
311546.67,4.0,3,4,4,4,12,0xb2d3dc29d
1029.2,1.0,92,1,2,1,4,0xb2d33b01d
105001.7,4.0,63,3,4,2,9,0x3b9b2af1d
1000054.42,1.0,0,4,2,4,10,0xb2d3512b
204416.59,10.0,4,3,4,4,11,0xb2d1d27ed
1069634.95,10.0,0,4,4,4,12,0xb2d23ffa
60001.89,2.0,111,3,3,1,7,0xb2d78431
10001.48,2.0,18,2,3,2,7,0xb2da14d2
13000.14,2.0,47,2,3,2,7,0xb2d91225
861794.99,5.0,63,4,4,2,10,0xb2d20246d
379.62,1.0,13,1,2,3,6,0xb2d3ea35d
2112560.1,2.0,60,4,3,2,9,0xb2d46e30d
5925.27,1.0,0,2,2,4,8,0xb2d28405
50363.19,3.0,11,2,4,3,9,0xb2d6c198d
115472.38,3.0,60,3,4,2,9,0xb2d39cdfd
21.13,1.0,101,1,2,1,4,0xb2d80fd3d
6146.06,1.0,0,2,2,4,8,0xb2d69a4fd
60026.89,2.0,21,3,3,2,8,0xb2d2927ad
250005.07,5.0,60,3,4,2,9,0xb2d580bdd
3002818.33,1.0,99,4,2,1,7,0xb2d96fb2d
440033.83,5.0,1,4,4,4,12,0xb2d815c7
5076.68,1.0,92,2,2,1,5,0xb2d42822d
534771.04,6.0,0,4,4,4,12,0xb2d45f6ad
228189.89,7.0,4,3,4,4,11,0xb2d4ac2fd
41002.9,3.0,3,2,4,4,10,0xb2d1c806d
1225.8,1.0,184,1,2,1,4,0xb2d35e13d
10355.32,1.0,4,2,2,4,8,0xb2d62c3ed
1430.44,1.0,184,1,2,1,4,0xb2d23d6ed
3549.3,1.0,34,2,2,2,6,0xb2d926b0
65.12,1.0,28,1,2,2,5,0xb2d93cfa
1074006.11,6.0,10,4,4,3,11,0xb2d6b92b
2461.76,1.0,94,1,2,1,4,0xb2d6a63ad
554045.29,3.0,0,4,4,4,12,0xb2d299afd
2037.31,2.0,0,1,3,4,8,0xb2d184ccd
100503.87,1.0,0,3,2,4,9,0xb2d06a36d
93.63,1.0,21,1,2,2,5,0xb2d900c8
3.24,1.0,231,1,2,1,4,0xb2d5094c
264800.79,2.0,35,3,3,2,8,0xb2d6da06d
3190003.02,2.0,77,4,3,1,8,0xb2d3535dd
50002.66,2.0,104,2,3,1,6,0xb2d4f6e0d
5.33,1.0,56,1,2,2,5,0xb2d1c267
1104.5,1.0,92,1,2,1,4,0xb2d60d52d
105008.58,2.0,6,3,3,3,9,0xb2d30f8ed
8608.55,1.0,13,2,2,3,7,0xb2d348e3d
1.49,1.0,13,1,2,3,6,0xb2d910c6d
50002.11,2.0,21,2,3,2,7,0xb2da1729
282330.66,3.0,9,3,4,3,10,0xb2d416ab
1519644.52,4.0,103,4,4,1,9,0xb2d643d1
503839.29,2.0,39,4,3,2,9,0xb2d764b8
620.28,1.0,26,1,2,2,5,0xb2d3be61
400001.69,3.0,3,4,4,4,12,0xb2d78c02d
70884.54,2.0,27,3,3,2,8,0xb2d5893ad
1399.42,2.0,92,1,3,1,5,0xb2d0b346d
103119.33,2.0,129,3,3,1,7,0xb2d3b40bd
0.01,4.0,5,1,4,3,8,0xb2d681f1d
52.86,1.0,124,1,2,1,4,0xb2d5839c
1004.98,1.0,184,1,2,1,4,0xb2d50db8d
144213.0,2.0,1,3,3,4,10,0xb2d5f595
488316.18,3.0,2,4,4,4,12,0xb2d1b567
4385.91,1.0,1,2,2,4,8,0xb2d92fe9
14051.57,1.0,7,2,2,3,7,0xb2d0bcafd
400006.88,2.0,13,4,3,3,10,0xb2d6488ad
1025.47,3.0,92,1,4,1,6,0xb2d274d2
100000.0,1.0,0,3,2,4,9,0xb2da6b1c
7.09,1.0,14,1,2,3,6,0xb2d6bff0
1.44,1.0,52,1,2,2,5,0xb2d5ba12
1036557.1,5.0,46,4,4,2,10,0xb2d41585
1014.72,1.0,184,1,2,1,4,0xb2d0dd02
86371.32,1.0,10,3,2,3,8,0xb2d8f2c9d
7310.35,1.0,19,2,2,2,6,0xb2d58c2cd
119.76,1.0,8,1,2,3,6,0xb2d6dc42
69.69,1.0,6,1,2,3,6,0xb2d8e85a
1033.52,1.0,25,1,2,2,5,0xb2d9707f
243404.83,4.0,97,3,4,1,8,0xb2d507e0d
5264.82,1.0,92,2,2,1,5,0xb2d298bb
846.75,3.0,84,1,4,1,6,0xb2d9791bd
102946.07,2.0,6,3,3,3,9,0xb2d26c93
5210.52,1.0,5,2,2,3,7,0xb2d3a128d
532292.51,9.0,8,4,4,3,11,0xb2d09249d
190.04,1.0,11,1,2,3,6,0xb2d8fd74d
407251.71,5.0,24,4,4,2,10,0xb2d26c48d
1726.04,1.0,0,1,2,4,7,0xb2d6298cd
5508.17,1.0,9,2,2,3,7,0xb2d65212
349.72,1.0,35,1,2,2,5,0xb2d19a0f
450000.0,2.0,1,4,3,4,11,0xb2d22739d
500176.38,2.0,7,4,3,3,10,0xb2d81385
380025.3,5.0,6,4,4,3,11,0xb2d08600d
12907.21,1.0,32,2,2,2,6,0xb2d53567
404961.46,5.0,57,4,4,2,10,0xb2d069dc
2959.66,1.0,92,2,2,1,5,0x3b9b402cd
116873.59,3.0,1,3,4,4,11,0xb2da047d
57.93,3.0,23,1,4,2,7,0x3b9b2d07d
167875.85,7.0,18,3,4,2,9,0xb2d602c7d
90000.0,3.0,3,3,4,4,11,0xb2d973aa
400183.79,1.0,1,4,2,4,10,0xb2d99eb2
2129.86,1.0,184,1,2,1,4,0xb2d0c97ad
439588.23,6.0,87,4,4,1,9,0xb2d59a55
1968.4,1.0,1,1,2,4,7,0xb2d33805d
102390.58,2.0,40,3,3,2,8,0xb2d5633ed
50000.53,2.0,35,2,3,2,7,0xb2d9fa1d
214093.11,2.0,266,3,3,1,7,0xb2d46568d
77100.0,5.0,0,3,4,4,11,0xb2d35121
50000.56,2.0,14,2,3,3,8,0xb2da29e1
81143.46,3.0,21,3,4,2,9,0xb2d605c4d
232.85,1.0,35,1,2,2,5,0xb2d1c3b5
442022.5,4.0,31,4,4,2,10,0xb2d0b06ed
200031.34,2.0,22,3,3,2,8,0xb2d786a7
1163.94,1.0,84,1,2,1,4,0xb2d3528a
3511.72,1.0,26,2,2,2,6,0xb2d43504
410000.0,3.0,7,4,4,3,11,0xb2d06702d
79001.69,2.0,213,3,3,1,7,0xb2d68383
2181.56,1.0,115,1,2,1,4,0xb2d5e950d
52539.76,1.0,104,3,2,1,6,0xb2d4f392d
1527.83,2.0,116,1,3,1,5,0x3b9b2cfdd
255198.67,2.0,19,3,3,2,8,0xb2d5fd09d
1000026.39,3.0,39,4,4,2,10,0xb2d9e0b0
0.0,1.0,145,1,2,1,4,0xb2d2495b
10121.67,2.0,147,2,3,1,6,0xb2d63305d
1299.09,1.0,92,1,2,1,4,0xb2d27a39d
63.33,1.0,42,1,2,2,5,0xb2d49f05d
2300199.35,5.0,11,4,4,3,11,0xb2d50e66d
5468.28,2.0,184,2,3,1,6,0xb2d074d0d
1168.04,1.0,19,1,2,2,5,0xb2d6039cd
18015.11,2.0,92,2,3,1,6,0x3b9b18fdd
231130.56,3.0,21,3,4,2,9,0xb2d4739bd
412375.51,6.0,2,4,4,4,12,0xb2d6f8e3d
302146.61,2.0,81,4,3,1,8,0xb2d8c749
461009.99,12.0,1,4,4,4,12,0xb2d0e9a6d
196.97,2.0,0,1,3,4,8,0xb2d0d75cd
1408.11,1.0,92,1,2,1,4,0xb2d25501d
3761.09,1.0,15,2,2,3,7,0xb2d8edc8d
4230.29,1.0,8,2,2,3,7,0xb2d6c2c1
2.12,1.0,29,1,2,2,5,0xb2d8cfb6
300000.78,2.0,4,3,3,4,10,0xb2d647ccd
100001.06,2.0,73,3,3,1,7,0xb2d8e580
51274.75,2.0,73,2,3,1,6,0xb2d60e78d
2529.63,1.0,184,1,2,1,4,0xb2d33d2ed
120071.91,2.0,92,3,3,1,7,0xb2d55771
1132460.73,4.0,18,4,4,2,10,0xb2d10c3ad
60857.28,14.0,0,3,4,4,11,0xb2d0673fd
0.9,1.0,13,1,2,3,6,0xb2d69c38
200062.8,2.0,7,3,3,3,9,0xb2da57ae
50081.7,2.0,146,2,3,1,6,0xb2d6f199d
90811.44,5.0,0,3,4,4,11,0xb2d291a7d
26389.59,1.0,38,2,2,2,6,0xb2d4f334d
4834.42,1.0,184,2,2,1,5,0xb2d1ef2dd
48.59,1.0,82,1,2,1,4,0xb2d36ffad
8050.66,1.0,14,2,2,3,7,0xb2d8d2ebd
3955.47,1.0,7,2,2,3,7,0xb2d6c722d
1.2,1.0,69,1,2,1,4,0xb2d5a52d
0.68,1.0,0,1,2,4,7,0xb2d65240
1130000.09,4.0,1,4,4,4,12,0xb2d3c53fd
1386.32,1.0,0,1,2,4,7,0xb2d3f838d
224089.36,7.0,6,3,4,3,10,0xb2d551abd
958683.24,10.0,13,4,4,3,11,0xb2d4386dd
51.82,1.0,12,1,2,3,6,0xb2d1253e
34891.66,1.0,0,2,2,4,8,0xb2d21288
200000.0,2.0,29,3,3,2,8,0xb2da0a28
2003.54,1.0,12,1,2,3,6,0xb2d4adb7
535114.08,2.0,48,4,3,2,9,0xb2d2633a
182825.64,3.0,87,3,4,1,8,0xb2d2730cd
960046.72,3.0,1,4,4,4,12,0xb2d1c236d
512443.38,2.0,216,4,3,1,8,0xb2d76a7bd
2000018.91,2.0,19,4,3,2,9,0xb2d104c9
35134.7,1.0,7,2,2,3,7,0xb2d6bb56d
200025.26,3.0,14,3,4,3,10,0xb2d60167d
2916135.29,6.0,87,4,4,1,9,0xb2d23e5ed
301425.19,4.0,61,4,4,2,10,0xb2d7862fd
100063.72,5.0,45,3,4,2,9,0x3b9adbe8d
5369.62,6.0,158,2,4,1,7,0xb2d087edd
3411.57,1.0,0,2,2,4,8,0xb2d1d841d
18170.66,1.0,4,2,2,4,8,0xb2d3bd3fd
2384.77,6.0,20,1,4,2,7,0xb2d0c720d
7613.0,1.0,0,2,2,4,8,0xb2d91299d
57.42,1.0,3,1,2,4,7,0xb2d1fcbd
5939.16,1.0,305,2,2,1,5,0xb2d3fa01d
9915.77,1.0,2,2,2,4,8,0xb2d5b7b5d
1598.05,1.0,7,1,2,3,6,0xb2d6bfebd
540297.5,11.0,6,4,4,3,11,0xb2d25553d
517124.14,7.0,126,4,4,1,9,0xb2d11bfad
300003.17,2.0,228,3,3,1,7,0xb2d6f6b3
290057.54,3.0,12,3,4,3,10,0xb2d32485d
3340.71,1.0,2,2,2,4,8,0xb2d39579d
1046.4,1.0,92,1,2,1,4,0xb2d5c030d
592.87,1.0,9,1,2,3,6,0xb2d35c3a
6115.0,1.0,47,2,2,2,6,0xb2d6581a
82082.16,3.0,140,3,4,1,8,0xb2d2022cd
322004.43,7.0,63,4,4,2,10,0xb2d18a51
117102.23,3.0,168,3,4,1,8,0xb2d1243cd
1697.84,1.0,2,1,2,4,7,0xb2d2f459
160024.35,5.0,0,3,4,4,11,0xb2d5a214d
570.54,1.0,111,1,2,1,4,0xb2d5b61fd
300006.65,3.0,14,3,4,3,10,0xb2d3af5cd
200861.8,2.0,16,3,3,2,8,0xb2d65a33d
3000.0,2.0,14,2,3,3,8,0xb2da3d90
300093.13,2.0,9,3,3,3,9,0xb2d56b87
522499.97,3.0,98,4,4,1,9,0xb2d28730d
84428.95,2.0,14,3,3,3,9,0xb2d1441c
675068.02,4.0,35,4,4,2,10,0xb2d18370d
26010.4,4.0,0,2,4,4,10,0x3b9af0f7
131678.14,3.0,90,3,4,1,8,0xb2d4155fd
163.4,1.0,1,1,2,4,7,0xb2d212a5d
200000.0,3.0,4,3,4,4,11,0xb2d97984d
52340.33,1.0,0,3,2,4,9,0xb2d77f1c
645078.5,3.0,0,4,4,4,12,0xb2d5ef6ed
2020085.19,16.0,0,4,4,4,12,0xb2d0b392d
4378.75,1.0,8,2,2,3,7,0xb2d5ccaad
0.0,1.0,2,1,2,4,7,0xb2d1e2a4
101127.68,2.0,11,3,3,3,9,0xb2d29e72d
133110.94,3.0,3,3,4,4,11,0xb2d29fc8d
6600.3,2.0,92,2,3,1,6,0xb2d5e95ed
1021.34,1.0,93,1,2,1,4,0xb2d5d3dcd
21902.94,1.0,23,2,2,2,6,0xb2d28bc1
163481.9,3.0,60,3,4,2,9,0xb2d5bbdcd
330050.24,3.0,3,4,4,4,12,0xb2d3ba45d
512626.68,2.0,66,4,3,2,9,0xb2d622afd
1060.09,3.0,216,1,4,1,6,0xb2d1cca1d
200000.0,2.0,13,3,3,3,9,0xb2da4373
260.01,1.0,28,1,2,2,5,0xb2d0d226
50028.2,2.0,199,2,3,1,6,0xb2d22cf0d
300821.55,2.0,4,4,3,4,11,0xb2d98581
3381.2,1.0,4,2,2,4,8,0xb2da0f17
232908.4,1.0,0,3,2,4,9,0xb2d6b17ad
1910000.0,10.0,2,4,4,4,12,0xb2d27e5b
150018.58,2.0,67,3,3,1,7,0xb2d2e311
5285.74,1.0,1,2,2,4,8,0xb2d7a6c8
140812.1,1.0,3,3,2,4,9,0xb2d133c1d
2620098.89,5.0,6,4,4,3,11,0xb2d4cbf5d
323008.67,8.0,76,4,4,1,9,0xb2d39e63
111.62,1.0,26,1,2,2,5,0xb2d55768
10023984.57,2.0,3,4,3,4,11,0xb2d4f1a9
1820.41,1.0,249,1,2,1,4,0xb2d4b45fd
121.31,1.0,67,1,2,1,4,0xb2d2a870
1480.82,1.0,0,1,2,4,7,0xb2d6438ad
50012.4,2.0,214,2,3,1,6,0xb2d103ccd
1000000.0,2.0,1,4,3,4,11,0xb2da663a
3.62,1.0,55,1,2,2,5,0xb2d681e5
429886.97,4.0,0,4,4,4,12,0xb2d0f4edd
1735.18,1.0,1,1,2,4,7,0xb2d517e9d
42.19,1.0,2,1,2,4,7,0xb2d3d141d
2106050.57,8.0,0,4,4,4,12,0xb2d22c9d
40008.01,2.0,92,2,3,1,6,0xb2d60b7d
541054.67,9.0,0,4,4,4,12,0xb2d564c2d
548156.95,5.0,6,4,4,3,11,0xb2d37743d
2122.37,1.0,22,1,2,2,5,0xb2d234b2
160049.18,3.0,95,3,4,1,8,0xb2d5eb18d
1389.28,1.0,19,1,2,2,5,0xb2d92995
310532.04,6.0,8,4,4,3,11,0xb2d630b9d
0.0,1.0,92,1,2,1,4,0xb2d2a5eed
242278.0,3.0,1,3,4,4,11,0xb2d6afe0d
10695.08,2.0,184,2,3,1,6,0xb2d1c1a6d
18556.72,1.0,19,2,2,2,6,0xb2d23b1ad
31985.03,2.0,4,2,3,4,9,0xb2d6125ed
4.4,1.0,133,1,2,1,4,0xb2d62568d
726024.62,12.0,18,4,4,2,10,0xb2d6dec8d
726213.68,5.0,4,4,4,4,12,0xb2d2f881d
2013.24,3.0,0,1,4,4,9,0xb2d09f7fd
11947.96,1.0,29,2,2,2,6,0xb2d938c7
14954.51,1.0,12,2,2,3,7,0xb2d96264d
1811.78,1.0,92,1,2,1,4,0xb2d3e8e6
2000098.5,3.0,92,4,4,1,9,0xb2d0cc7cd
7345.57,1.0,2,2,2,4,8,0xb2d2e7d4d
5145.25,1.0,4,2,2,4,8,0xb2d3ee22
201888.88,2.0,6,3,3,3,9,0xb2d9c568
255107.92,3.0,173,3,4,1,8,0xb2d0913fd
150000.0,1.0,0,3,2,4,9,0xb2da6b12
200434.49,5.0,1,3,4,4,11,0xb2d575f7d
1380166.99,4.0,69,4,4,1,9,0xb2d0ad03d
198.91,1.0,0,1,2,4,7,0xb2d16ea4
2493.02,1.0,10,1,2,3,6,0xb2d4baa6
550078.96,3.0,21,4,4,2,10,0xb2d0b91fd
107056.59,2.0,116,3,3,1,7,0xb2d3b389d
140839.69,1.0,184,3,2,1,6,0xb2d28017d
70004.83,2.0,27,3,3,2,8,0xb2d57c94
712.76,2.0,0,1,3,4,8,0x3b9af1de
213479.55,2.0,92,3,3,1,7,0xb2d310d5d
120065.72,2.0,13,3,3,3,9,0xb2d60869d
406.39,1.0,47,1,2,2,5,0xb2d6c8e9
575000.19,3.0,13,4,4,3,11,0xb2d4f286
400024.7,3.0,5,4,4,3,11,0xb2d968ccd
3539.79,1.0,0,2,2,4,8,0xb2d5a497
1261214.44,6.0,3,4,4,4,12,0xb2d23944d
2469.61,1.0,1,1,2,4,7,0xb2d6ada1d
1454.29,1.0,6,1,2,3,6,0xb2d2cbf8
331000.64,12.0,27,4,4,2,10,0xb2d10e21d
240000.0,2.0,0,3,3,4,10,0xb2d28426
1358.8,1.0,44,1,2,2,5,0xb2d5b7ab
20000.84,2.0,55,2,3,2,7,0xb2d901c1d
5.57,1.0,34,1,2,2,5,0xb2d11ff9d
800035.13,2.0,10,4,3,3,10,0xb2d2cfc7
40581.97,1.0,18,2,2,2,6,0xb2d6bfd9d
83095.04,2.0,200,3,3,1,7,0xb2d56d85d
4.88,1.0,46,1,2,2,5,0xb2d6aa31
50.75,1.0,47,1,2,2,5,0xb2d5c8b8
607413.25,3.0,5,4,4,3,11,0xb2d58146d
70003.65,3.0,77,3,4,1,8,0xb2d19d53d
0.12,1.0,4,1,2,4,7,0xb2d77f7d
569561.07,3.0,21,4,4,2,10,0xb2d42e49d
229626.29,3.0,5,3,4,3,10,0xb2d2224fd
3153.89,3.0,92,2,4,1,7,0x3b9b128d
120281.58,2.0,256,3,3,1,7,0xb2d24368d
287.5,1.0,0,1,2,4,7,0xb2d92fd3d
90270.51,2.0,41,3,3,2,8,0xb2d386ead
8262.27,1.0,5,2,2,3,7,0xb2d2b457d
307072.29,3.0,0,4,4,4,12,0xb2d1ba74
1602156.97,13.0,60,4,4,2,10,0xb2d0b964d
102.0,1.0,30,1,2,2,5,0xb2d3ede4
4554.47,1.0,0,2,2,4,8,0xb2d9fa2b
11476.61,1.0,4,2,2,4,8,0xb2d5ac5f
5966.6,1.0,0,2,2,4,8,0xb2d58bf6
444429.65,1.0,3,4,2,4,10,0xb2d52a52d
519082.08,3.0,104,4,4,1,9,0xb2d19565d
4848.0,1.0,2,2,2,4,8,0xb2d33f3ed
101028.63,2.0,11,3,3,3,9,0xb2d35f33
200042.88,2.0,25,3,3,2,8,0xb2d505f3
24475.07,1.0,21,2,2,2,6,0xb2d62d84
0.0,1.0,184,1,2,1,4,0xb2d35d60
204273.1,2.0,120,3,3,1,7,0xb2d65ec5d
3867.24,1.0,108,2,2,1,5,0xb2d2f23f
3382.66,1.0,118,2,2,1,5,0xb2d6299bd
8275.99,1.0,8,2,2,3,7,0xb2d5822fd
341894.3,6.0,18,4,4,2,10,0xb2d438d5d
524.35,1.0,25,1,2,2,5,0xb2d24cd9
100041.49,3.0,0,3,4,4,11,0xb2d25861d
356239.53,7.0,1,4,4,4,12,0xb2d1938dd
5807.29,1.0,62,2,2,2,6,0xb2d434ee
30001.67,2.0,46,2,3,2,7,0xb2d90468
9.51,2.0,76,1,3,1,5,0xb2d99ac5
50020.49,2.0,35,2,3,2,7,0xb2d5943e
5698.72,4.0,84,2,4,1,7,0xb2d1436cd
142000.0,3.0,0,3,4,4,11,0xb2d3510f
1017038.27,6.0,11,4,4,3,11,0xb2d16bfbd
24461.21,1.0,1,2,2,4,8,0xb2d3275a
8529.09,1.0,20,2,2,2,6,0xb2d60ad5d
2014.17,1.0,16,1,2,2,5,0xb2d0b493
150077.92,2.0,26,3,3,2,8,0xb2d24418d
207804.32,2.0,239,3,3,1,7,0xb2d454b2d
60753.33,2.0,101,3,3,1,7,0xb2d59899d
3258.14,1.0,184,2,2,1,5,0xb2d15b70d
10965.47,1.0,0,2,2,4,8,0xb2d1f4bbd
519092.38,5.0,0,4,4,4,12,0x3b9b3365d
1005.06,1.0,92,1,2,1,4,0xb2d3133fd
7053.96,2.0,11,2,3,3,8,0x3b9b29add
8635456.25,24.0,0,4,4,4,12,0xb2d653bbd
1.3,2.0,62,1,3,2,6,0xb2d515b8
216015.62,2.0,41,3,3,2,8,0xb2d3f184d
1005.36,1.0,92,1,2,1,4,0xb2d24248d
1677030.9,4.0,0,4,4,4,12,0xb2d21babd
2530007.48,2.0,8,4,3,3,10,0xb2d70021d
81835.49,2.0,122,3,3,1,7,0xb2d56d6f
12345.15,1.0,15,2,2,3,7,0xb2d5b78c
641.33,1.0,0,1,2,4,7,0xb2d41478
10013.78,1.0,13,2,2,3,7,0xb2d9079bd
140.77,1.0,18,1,2,2,5,0xb2d1c769
1681.11,1.0,19,1,2,2,5,0xb2d6c18e
2451.26,1.0,0,1,2,4,7,0xb2d7f68a
201015.23,4.0,136,3,4,1,8,0xb2d5b397d
150002.51,8.0,0,3,4,4,11,0xb2d3d04d
201.03,1.0,0,1,2,4,7,0xb2d242b4
189.56,1.0,10,1,2,3,6,0xb2d9dd77
5456.27,1.0,0,2,2,4,8,0xb2d906d7
2667553.15,13.0,4,4,4,4,12,0xb2d24205d
331.7,1.0,13,1,2,3,6,0xb2d18f5ad
220909.97,2.0,3,3,3,4,10,0xb2d61c3bd
510065.76,10.0,27,4,4,2,10,0xb2d605f7d
30000.63,2.0,108,2,3,1,6,0xb2d7900ad
150020.97,4.0,51,3,4,2,9,0xb2d59ab2d
1008.02,1.0,92,1,2,1,4,0xb2d30db5d
5058.88,1.0,6,2,2,3,7,0xb2d1b26c
3062.6,1.0,10,2,2,3,7,0xb2d994ec
1591.63,1.0,164,1,2,1,4,0xb2d56ee2
200047.43,3.0,111,3,4,1,8,0xb2d23a18d
51023.36,2.0,11,2,3,3,8,0xb2d60f11d
140006.69,3.0,4,3,4,4,11,0xb2d1713bd
680082.4,3.0,41,4,4,2,10,0xb2d302d9d
5390.57,1.0,103,2,2,1,5,0xb2d6e7e4d
301076.62,7.0,4,4,4,4,12,0xb2d4f3d2d
38863.65,2.0,37,2,3,2,7,0xb2d68782d
50148.45,1.0,92,2,2,1,5,0xb2d61564d
21612.4,1.0,0,2,2,4,8,0xb2d47d58
151744.91,2.0,147,3,3,1,7,0xb2d6cc2ed
500052.13,2.0,21,4,3,2,9,0xb2d8d075d
1000021.11,2.0,95,4,3,1,8,0xb2d97857d
3000302.35,4.0,18,4,4,2,10,0xb2d8ce7bd
1000032.94,2.0,123,4,3,1,8,0xb2d359b4d
20601.6,1.0,1,2,2,4,8,0xb2d2d516d
206764.3,2.0,6,3,3,3,9,0xb2d0a916d
255839.99,4.0,49,3,4,2,9,0xb2d26769d
113252.11,1.0,1,3,2,4,9,0xb2d24660d
1194937.42,6.0,0,4,4,4,12,0x3b9b1328d
12.47,1.0,13,1,2,3,6,0xb2d69d99
120055.45,2.0,34,3,3,2,8,0xb2d306e3
439969.2,2.0,184,4,3,1,8,0xb2d4b8bb
135013.45,3.0,167,3,4,1,8,0xb2d1beb6d
100031.0,2.0,11,3,3,3,9,0xb2d1112cd
3899.81,1.0,0,2,2,4,8,0xb2d2233ed
1005083.85,8.0,20,4,4,2,10,0xb2d17e65d
207136.21,3.0,31,3,4,2,9,0xb2d62d01d
50642.03,2.0,132,2,3,1,6,0xb2d31aba
45000.95,2.0,67,2,3,1,6,0xb2d9ae9a
190033.88,3.0,143,3,4,1,8,0xb2d1df54d
2110.62,1.0,19,1,2,2,5,0xb2d3906e
7759.03,1.0,4,2,2,4,8,0xb2d5d60ad
3040.47,1.0,0,2,2,4,8,0xb2d6ceb9d
342926.64,5.0,66,4,4,2,10,0xb2d6149fd
58014.01,3.0,156,3,4,1,8,0xb2d16c63d
900056.03,3.0,0,4,4,4,12,0xb2d30d85d
28434.26,1.0,2,2,2,4,8,0xb2d62998
600110.19,5.0,12,4,4,3,11,0xb2d592f4d
2905.67,1.0,184,2,2,1,5,0xb2d374d2d
1353093.07,2.0,11,4,3,3,10,0xb2d3631c
1990153.6,10.0,34,4,4,2,10,0x3b9adb4ed
200107.45,3.0,73,3,4,1,8,0xb2d52590
50767.78,2.0,4,2,3,4,9,0xb2d90abed
6113777.69,2.0,0,4,3,4,11,0xb2d10a6cd
100725.63,3.0,18,3,4,2,9,0xb2d4147ed
71.43,1.0,14,1,2,3,6,0xb2d292b4
600895.86,2.0,12,4,3,3,10,0xb2d6d3b5d
190995.08,1.0,18,3,2,2,7,0xb2d90ca7
1029.37,1.0,92,1,2,1,4,0xb2d16626d
500010.56,3.0,53,4,4,2,10,0xb2d9cc53
20890.53,1.0,0,2,2,4,8,0xb2d287af
11559.6,1.0,1,2,2,4,8,0xb2d23312
30517.67,1.0,5,2,2,3,7,0xb2d5c7bb
2605.42,1.0,20,1,2,2,5,0xb2d42a3c
1880.83,1.0,0,1,2,4,7,0xb2d30549d
2588.4,1.0,9,1,2,3,6,0xb2d34ab1
7725.2,1.0,10,2,2,3,7,0xb2d7f4d7d
1025.15,1.0,184,1,2,1,4,0xb2d0d027d
707806.78,4.0,127,4,4,1,9,0xb2d5ba9d
110208.36,2.0,0,3,3,4,10,0xb2d185bcd
1091.38,1.0,92,1,2,1,4,0xb2d34d6cd
331862.01,3.0,3,4,4,4,12,0xb2d64d16d
206411.32,2.0,111,3,3,1,7,0xb2d17e1ad
240015.68,5.0,52,3,4,2,9,0xb2d5799b
1214.97,1.0,43,1,2,2,5,0xb2d6c2f7d
1032487.16,4.0,11,4,4,3,11,0xb2d972c2d
110021.18,3.0,34,3,4,2,9,0xb2d915b7d
445373.33,6.0,2,4,4,4,12,0xb2d2ac8d
500099.75,2.0,209,4,3,1,8,0xb2d2dd72
180808.22,1.0,25,3,2,2,7,0xb2d1be4ed
400015.72,5.0,25,4,4,2,10,0xb2d54fc1d
1157473.0,6.0,40,4,4,2,10,0xb2d67f09d
600.3,1.0,18,1,2,2,5,0xb2d6b7e2d
81.47,1.0,37,1,2,2,5,0xb2d86866
10628.41,1.0,0,2,2,4,8,0xb2d37194d
51393.27,1.0,0,2,2,4,8,0xb2d28d24d
50087.91,2.0,3,2,3,4,9,0xb2d19d31d
4057.33,1.0,134,2,2,1,5,0xb2d57708d
1320312.1,7.0,41,4,4,2,10,0xb2d2c199d
150590.88,2.0,0,3,3,4,10,0xb2d9ab36
34.42,1.0,7,1,2,3,6,0xb2d2127ed
16392.41,2.0,0,2,3,4,9,0xb2d68a7fd
65000.0,2.0,3,3,3,4,10,0xb2d65c4ad
5008.24,1.0,166,2,2,1,5,0xb2d8e57bd
14719.4,1.0,92,2,2,1,5,0xb2d4edf0d
112889.65,1.0,2,3,2,4,9,0xb2d4c9d5d
645676.43,4.0,42,4,4,2,10,0xb2d416abd
1524256.23,3.0,73,4,4,1,9,0xb2d406cbd
3110.27,1.0,5,2,2,3,7,0xb2d5e6a9
460006.58,8.0,27,4,4,2,10,0xb2d19424
20086.71,3.0,90,2,4,1,7,0xb2d56af8d
635439.23,5.0,0,4,4,4,12,0xb2d58dde
63886.39,2.0,26,3,3,2,8,0xb2d3a7fbd
550021.17,2.0,55,4,3,2,9,0xb2d0da45
30452.95,2.0,172,2,3,1,6,0xb2d61b9bd
360010.83,3.0,39,4,4,2,10,0xb2d6c155d
242015.25,2.0,27,3,3,2,8,0xb2da01fa
200710.54,2.0,56,3,3,2,8,0xb2d904d4d
400760.22,3.0,1,4,4,4,12,0xb2d94bdad
390000.0,3.0,89,4,4,1,9,0xb2d620f2d
19.16,2.0,6,1,3,3,7,0xb2d5a7d0
20000.21,2.0,21,2,3,2,7,0xb2da1e58
1012.18,1.0,92,1,2,1,4,0xb2d28e13d
110950.87,2.0,0,3,3,4,10,0xb2d50513d
290367.34,6.0,0,3,4,4,11,0xb2d2613fd
900084.84,2.0,41,4,3,2,9,0xb2d19968
0.0,1.0,0,1,2,4,7,0xb2da57c6
1110047.0,4.0,6,4,4,3,11,0xb2d22ef6d
222268.39,2.0,14,3,3,3,9,0xb2d8dc99d
551.38,2.0,17,1,3,2,6,0xb2d9193bd
800037.87,4.0,10,4,4,3,11,0xb2d2c6c3
1289349.86,7.0,4,4,4,4,12,0xb2d570dfd
410095.77,5.0,1,4,4,4,12,0xb2d33139d
23314.67,1.0,0,2,2,4,8,0xb2d3054d
1589.47,1.0,184,1,2,1,4,0xb2d17a9c
350000.53,7.0,0,4,4,4,12,0xb2d51f4a
205828.47,3.0,31,3,4,2,9,0xb2d383b4
581.82,1.0,20,1,2,2,5,0xb2d6fe76
1119.81,1.0,92,1,2,1,4,0xb2d6150fd
200000.0,2.0,4,3,3,4,10,0xb2da6457
2.87,1.0,46,1,2,2,5,0xb2d6afebd
34614.2,1.0,49,2,2,2,6,0xb2d37c38d
0.0,1.0,0,1,2,4,7,0xb2d4d486
107231.53,7.0,0,3,4,4,11,0xb2d33917d
104173.62,2.0,154,3,3,1,7,0xb2d2b9ebd
100007.42,3.0,18,3,4,2,9,0xb2d6bf1cd
100088.65,2.0,10,3,3,3,9,0xb2d2f3c5d
4002.59,1.0,13,2,2,3,7,0xb2d6c8cfd
3795.32,1.0,12,2,2,3,7,0xb2d0d7bfd
2.06,1.0,35,1,2,2,5,0xb2d38899
18004.09,1.0,199,2,2,1,5,0xb2d0e129
154642.65,1.0,184,3,2,1,6,0xb2d11083d
228273.59,4.0,14,3,4,3,10,0xb2d3fa57d
912.42,1.0,17,1,2,2,5,0xb2d56332
1300013.72,2.0,24,4,3,2,9,0xb2d94c64d
3412.58,1.0,10,2,2,3,7,0xb2d2e548d
76447.09,1.0,8,3,2,3,8,0xb2d55be7d
6274.97,1.0,7,2,2,3,7,0xb2d93732
500007.92,2.0,0,4,3,4,11,0xb2da5f07
100.26,1.0,1,1,2,4,7,0xb2d2cad1
500000.0,2.0,1,4,3,4,11,0xb2d8f755d
529.13,1.0,39,1,2,2,5,0xb2d54c66
13579.0,1.0,0,2,2,4,8,0xb2d681ced
220001.43,5.0,20,3,4,2,9,0xb2d0f9b1
5.19,2.0,0,1,3,4,8,0xb2d06bcad
320041.57,3.0,60,4,4,2,10,0xb2d66613d
381345.91,1.0,12,4,2,3,9,0xb2d06d23d
4721.03,1.0,0,2,2,4,8,0xb2d6272c
3.8,1.0,23,1,2,2,5,0xb2d5cc55d
33.8,1.0,13,1,2,3,6,0xb2d534d2
4003.69,1.0,1,2,2,4,8,0xb2d80161
120077.55,2.0,119,3,3,1,7,0xb2d41418d
114435.15,3.0,66,3,4,2,9,0xb2d3e675
50242.07,1.0,22,2,2,2,6,0xb2d32fc8
0.0,1.0,4,1,2,4,7,0xb2d3ce22
42993.56,9.0,0,2,4,4,10,0x3b9b464a
29.34,1.0,5,1,2,3,6,0xb2d34492
9349.01,1.0,2,2,2,4,8,0xb2d0dab1d
6321.49,1.0,84,2,2,1,5,0xb2d2f197
174592.54,4.0,3,3,4,4,11,0xb2d14985d
2.19,1.0,0,1,2,4,7,0xb2d6f2cb
4722.33,1.0,208,2,2,1,5,0xb2d21dc3d
280017.42,5.0,1,3,4,4,11,0xb2d22bbe
217976.43,3.0,1,3,4,4,11,0xb2d56275
517996.29,9.0,0,4,4,4,12,0xb2d14d5ad
815060.29,31.0,0,4,4,4,12,0xb2d0a237d
200344.94,3.0,153,3,4,1,8,0xb2d61b92d
502582.48,3.0,48,4,4,2,10,0xb2d5ad17d
67.29,1.0,32,1,2,2,5,0xb2d5d5e8
100000.0,2.0,3,3,3,4,10,0xb2d97a30d
30000.95,2.0,102,2,3,1,6,0xb2d961f8d
882000.0,2.0,0,4,3,4,11,0xb2d98020d
0.82,1.0,1,1,2,4,7,0xb2d8a2ecd
435417.56,1.0,9,4,2,3,9,0xb2d6f87bd
70001.46,2.0,80,3,3,1,7,0xb2d64be5d
301209.35,3.0,1,4,4,4,12,0xb2d3d3bb
2749.18,1.0,184,1,2,1,4,0xb2d3a81c
7102512.38,18.0,0,4,4,4,12,0x3b9b354ad
379040.46,6.0,18,4,4,2,10,0xb2d28520d
5912.59,1.0,0,2,2,4,8,0xb2d3e44a
2.64,1.0,47,1,2,2,5,0xb2d9d2d1
1203.09,2.0,92,1,3,1,5,0x3b9b2bf7d
273.6,1.0,18,1,2,2,5,0xb2d8cb1a
360157.77,3.0,21,4,4,2,10,0xb2d2e9ec
3787.12,1.0,2,2,2,4,8,0xb2d24561d
106956.46,3.0,0,3,4,4,11,0xb2d0d813
217.06,1.0,84,1,2,1,4,0xb2d97622d
66.67,3.0,13,1,4,3,8,0xb2d95199d
200031.65,2.0,0,3,3,4,10,0xb2d94d1ed
454907.97,4.0,24,4,4,2,10,0xb2d649f1d
205689.63,2.0,92,3,3,1,7,0xb2d62f20
10465.0,1.0,0,2,2,4,8,0xb2d8d806d
25000.9,3.0,21,2,4,2,8,0xb2d9156cd
200003.61,2.0,35,3,3,2,8,0xb2d953ae
5196.12,1.0,92,2,2,1,5,0xb2d131a4d
200.95,1.0,0,1,2,4,7,0xb2d1e0dd
210975.11,3.0,10,3,4,3,10,0xb2d5b5e7d
769.85,1.0,296,1,2,1,4,0xb2d34cc7
703667.69,5.0,18,4,4,2,10,0xb2d9969b
600006.35,2.0,221,4,3,1,8,0xb2d704cad
0.0,1.0,9,1,2,3,6,0xb2d1c9e3
70003.69,2.0,111,3,3,1,7,0xb2d25e9dd
42.04,1.0,5,1,2,3,6,0xb2d690aa
207236.72,4.0,24,3,4,2,9,0xb2d699edd
25440.72,1.0,140,2,2,1,5,0xb2d63824d
4234.46,1.0,0,2,2,4,8,0xb2d87ad1d
318214.75,2.0,92,4,3,1,8,0xb2d50a30d
3011327.3,2.0,24,4,3,2,9,0xb2d5dda0d
46.06,1.0,10,1,2,3,6,0xb2d41a7d
7024.57,1.0,92,2,2,1,5,0xb2d5b04bd
56.05,1.0,74,1,2,1,4,0xb2d63ec1d
50009.7,2.0,67,2,3,1,6,0xb2d65d7ad
0.0,1.0,7,1,2,3,6,0xb2d6f351
3992.02,1.0,9,2,2,3,7,0xb2d8eab9
797.02,1.0,16,1,2,2,5,0xb2d35465
60804.41,2.0,0,3,3,4,10,0xb2d0a0a8d
3286296.31,12.0,0,4,4,4,12,0xb2d074e1d
80.02,1.0,85,1,2,1,4,0xb2d22285
2001.2,1.0,66,1,2,2,5,0xb2d8f626d
2940.07,1.0,3,2,2,4,8,0xb2d3aac4
63002.68,2.0,136,3,3,1,7,0xb2d3c5ef
62126.66,3.0,53,3,4,2,9,0xb2d5715cd
7011.13,1.0,15,2,2,3,7,0xb2d6beb3
99.08,1.0,36,1,2,2,5,0xb2d358aad
532036.03,7.0,13,4,4,3,11,0xb2d68e3fd
50280.48,1.0,92,2,2,1,5,0xb2d45f77
9197.95,3.0,49,2,4,2,8,0x3b9b3fe8d
24125.76,1.0,2,2,2,4,8,0xb2d329c2d
79022.9,3.0,20,3,4,2,9,0xb2d55777d
4385.62,5.0,0,2,4,4,10,0xb2d2c6e3d
70.46,1.0,0,1,2,4,7,0xb2d6933c
2029454.37,7.0,95,4,4,1,9,0xb2d06d21d
1101.59,6.0,17,1,4,2,7,0x3b9b38a4
469021.11,3.0,92,4,4,1,9,0xb2d28155d
22179.58,1.0,3,2,2,4,8,0xb2d6899d
233028.0,4.0,63,3,4,2,9,0x3b9b3d32d
211204.13,3.0,172,3,4,1,8,0xb2d2f134d
103431.61,3.0,3,3,4,4,11,0xb2d4b443d
400000.0,2.0,28,4,3,2,9,0xb2d941d1d
4144.13,1.0,0,2,2,4,8,0xb2d68e82
275693.01,3.0,14,3,4,3,10,0xb2d64670d
308199.46,3.0,14,4,4,3,11,0xb2d1a110
31178.64,1.0,0,2,2,4,8,0xb2d3b26fd
1780218.86,4.0,12,4,4,3,11,0xb2d64825
305037.52,5.0,17,4,4,2,10,0xb2d19807d
1427123.01,3.0,9,4,4,3,11,0xb2d6c132
56.07,1.0,25,1,2,2,5,0xb2d68472d
60002.76,3.0,21,3,4,2,9,0xb2d917c1d
114496.52,1.0,14,3,2,3,8,0xb2d56218d
41755.29,2.0,1,2,3,4,9,0xb2d68555d
5592.75,1.0,7,2,2,3,7,0xb2d2a6d9d
4569.87,7.0,0,2,4,4,10,0xb2d09c87d
310009.2,2.0,0,4,3,4,11,0xb2d9f6f3
73694.6,3.0,14,3,4,3,10,0xb2d22259d
465010.3,3.0,27,4,4,2,10,0xb2d11679
23105.57,1.0,92,2,2,1,5,0xb2d3f5b8d
390954.02,6.0,56,4,4,2,10,0xb2d81635d
1078.62,1.0,6,1,2,3,6,0xb2d60833
115037.29,2.0,199,3,3,1,7,0xb2d57a28d
63.33,1.0,13,1,2,3,6,0xb2d1f698d
1000060.59,2.0,0,4,3,4,11,0xb2d8fd6ed
50002.71,2.0,76,2,3,1,6,0xb2d43e10
3.98,1.0,13,1,2,3,6,0xb2d6a192
111370.78,5.0,0,3,4,4,11,0xb2d6d324d
16534.22,1.0,0,2,2,4,8,0xb2d6a9d6d
4933.42,1.0,49,2,2,2,6,0xb2d8e5d5
2564.66,1.0,0,1,2,4,7,0xb2d9161dd
175232.85,2.0,23,3,3,2,8,0xb2d5cc49d
111092.15,8.0,1,3,4,4,11,0xb2d418fcd
960114.6,5.0,4,4,4,4,12,0xb2d637f7
1.42,1.0,6,1,2,3,6,0xb2d9a2e7
230888.77,2.0,17,3,3,2,8,0xb2d0b6bfd
500000.0,2.0,8,4,3,3,10,0xb2da4123
35250.39,1.0,15,2,2,3,7,0x3b9aeffd
390028.65,3.0,30,4,4,2,10,0xb2d957afd
11.92,1.0,77,1,2,1,4,0xb2d294f2
4928.07,1.0,2,2,2,4,8,0xb2d1e763d
1.93,1.0,2,1,2,4,7,0xb2d652e6
32753.62,1.0,1,2,2,4,8,0xb2d30034d
3.71,1.0,22,1,2,2,5,0xb2d6279ad
400081.28,1.0,1,4,2,4,10,0xb2d8678e
358.03,1.0,25,1,2,2,5,0xb2d37bf9
100048.23,1.0,7,3,2,3,8,0xb2d55e71
1100062.22,2.0,139,4,3,1,8,0xb2d17a8cd
23.15,1.0,2,1,2,4,7,0xb2d38fe6
1590000.0,4.0,0,4,4,4,12,0xb2d97a9d
1978.54,1.0,21,1,2,2,5,0xb2d5ee5bd
100002.11,2.0,158,3,3,1,7,0xb2d8f018
10000.95,2.0,19,2,3,2,7,0xb2da1b7c
661096.19,6.0,53,4,4,2,10,0xb2d12f18d
300000.0,2.0,15,3,3,3,9,0xb2da3887
106000.55,8.0,63,3,4,2,9,0xb2d5750d
540706.62,4.0,0,4,4,4,12,0xb2d0d107d
1723416.9,9.0,11,4,4,3,11,0xb2d1838fd
4782.4,1.0,10,2,2,3,7,0xb2d2b549d
875.8,1.0,10,1,2,3,6,0xb2d7fc57
40000955.21,3.0,104,4,4,1,9,0xb2d4aa67d
20.61,2.0,165,1,3,1,5,0xb2d31f77
1845.09,1.0,184,1,2,1,4,0xb2d34668d
1470.88,1.0,0,1,2,4,7,0xb2d64278
452910.39,1.0,0,4,2,4,10,0xb2d205d8d
575643.36,13.0,1,4,4,4,12,0xb2d15044
1415.37,1.0,9,1,2,3,6,0xb2d7906bd
64.93,1.0,19,1,2,2,5,0xb2d63155
103047.67,1.0,0,3,2,4,9,0xb2d6a56bd
89222.15,13.0,0,3,4,4,11,0xb2d09646d
33048.44,4.0,12,2,4,3,9,0xb2d62ee6d
292415.2,5.0,76,3,4,1,8,0xb2d2fc52d
120010.87,2.0,111,3,3,1,7,0xb2d52e52d
151857.9,3.0,125,3,4,1,8,0xb2d6d3a8d
70044.37,2.0,49,3,3,2,8,0xb2d107a9d
10000.11,2.0,69,2,3,1,6,0xb2d8ea04
500495.3,3.0,8,4,4,3,11,0xb2d18225
252728.07,2.0,42,3,3,2,8,0xb2d6bb0ad
32.83,1.0,19,1,2,2,5,0xb2d5bc67
83419.58,3.0,5,3,4,3,10,0xb2d584bd
350017.66,12.0,12,4,4,3,11,0xb2d24d28d
759.08,1.0,1,1,2,4,7,0xb2d26a06
4.76,1.0,1,1,2,4,7,0xb2d3482ed
11663.93,1.0,7,2,2,3,7,0xb2d68769
1069.09,1.0,92,1,2,1,4,0xb2d34a9ed
400017.53,2.0,136,4,3,1,8,0xb2d63a72
20305.55,2.0,59,2,3,2,7,0xb2d65e28d
2.77,1.0,14,1,2,3,6,0xb2d4eca2
2401.29,1.0,14,1,2,3,6,0xb2d8ca7bd
706.23,1.0,24,1,2,2,5,0xb2d4d342d
450007.22,3.0,59,4,4,2,10,0xb2d8b042d
50001.01,2.0,4,2,3,4,9,0xb2d62859d
448249.87,7.0,14,4,4,3,11,0xb2d14f94d
1067048.23,12.0,0,4,4,4,12,0xb2d11fffd
583062.76,7.0,80,4,4,1,9,0xb2d520edd
3121069.52,4.0,1,4,4,4,12,0xb2d0b9ccd
179117.08,5.0,0,3,4,4,11,0xb2d0a0ded
26370.98,1.0,12,2,2,3,7,0xb2d43591
3622.58,1.0,74,2,2,1,5,0xb2d5cc8f
59.82,1.0,11,1,2,3,6,0xb2d13fa4
300009.91,3.0,9,3,4,3,10,0xb2d64c0ed
456254.8,4.0,0,4,4,4,12,0xb2d1b111
380.88,1.0,19,1,2,2,5,0xb2d2ce0ad
1478167.46,24.0,0,4,4,4,12,0x3b9b2604d
22999.66,1.0,102,2,2,1,5,0xb2d54baad
374.15,1.0,11,1,2,3,6,0xb2d34c33
0.0,1.0,6,1,2,3,6,0xb2d69449d
11587.17,1.0,0,2,2,4,8,0xb2d52aebd
60002.5,4.0,18,3,4,2,9,0xb2d61f92d
100001.06,2.0,21,3,3,2,8,0xb2da210a
502698.78,1.0,92,4,2,1,7,0xb2d2b6d5d
250000.0,2.0,6,3,3,3,9,0xb2da541d
121614.6,2.0,0,3,3,4,10,0xb2d23a78d
2904.29,1.0,2,2,2,4,8,0xb2d96e99
150030.07,4.0,89,3,4,1,8,0xb2d24befd
1399493.46,8.0,18,4,4,2,10,0x3b9b3c4fd
642097.4,4.0,7,4,4,3,11,0xb2d56e8ed
501828.87,2.0,18,4,3,2,9,0xb2d7a8d7d
0.09,1.0,5,1,2,3,6,0xb2d757b9
5932.7,1.0,29,2,2,2,6,0xb2d8e315d
54805.62,1.0,10,3,2,3,8,0xb2d5cf79d
407111.88,3.0,91,4,4,1,9,0xb2d8c3fbd
1177460.0,2.0,92,4,3,1,8,0xb2d5bd83d
110227.95,2.0,133,3,3,1,7,0xb2d0bd5c
322273.3,2.0,25,4,3,2,9,0xb2d4a9b0d
50.77,2.0,8,1,3,3,7,0x3b9b279a
310005.63,3.0,82,4,4,1,9,0xb2d4f90a
720.72,1.0,23,1,2,2,5,0xb2d2b53ad
2.11,1.0,20,1,2,2,5,0xb2d94d2a
150185.02,6.0,6,3,4,3,10,0xb2d99609
250040.7,2.0,1,3,3,4,10,0xb2d68276d
70230.16,3.0,10,3,4,3,10,0xb2d65a42d
28.61,1.0,13,1,2,3,6,0xb2d922e7
513.65,3.0,184,1,4,1,6,0xb2d2bf8fd
5356.9,1.0,92,2,2,1,5,0xb2d0eff1d
250006.86,2.0,11,3,3,3,9,0xb2da2e42
16109.06,1.0,15,2,2,3,7,0xb2d94c20
33.01,1.0,5,1,2,3,6,0xb2d6bdcb
93347.58,3.0,1,3,4,4,11,0xb2d12215d
250000.0,1.0,0,3,2,4,9,0xb2da6c7f
50002.11,2.0,42,2,3,2,7,0xb2d9dd4e
1202987.28,13.0,0,4,4,4,12,0xb2d06eabd
200005.07,2.0,3,3,3,4,10,0xb2d62f03
198.23,1.0,10,1,2,3,6,0xb2d350e0
100702.05,2.0,143,3,3,1,7,0xb2d3b173d
1012.78,1.0,184,1,2,1,4,0xb2d1cce7d
25071.44,1.0,16,2,2,2,6,0xb2d69e9ed
385.26,1.0,10,1,2,3,6,0xb2d2ec01
11.17,1.0,23,1,2,2,5,0xb2da1a1f
257687.31,3.0,17,3,4,2,9,0xb2d6182ad
228600.91,1.0,5,3,2,3,8,0xb2d17897
20791492.24,2.0,14,4,3,3,10,0xb2d6d1fbd
26000.42,3.0,48,2,4,2,8,0xb2d52661
702.12,1.0,21,1,2,2,5,0xb2d5b33dd
234715.89,1.0,77,3,2,1,6,0xb2d5b96ad
150009.33,2.0,136,3,3,1,7,0xb2d3df86d
5008.19,3.0,0,2,4,4,10,0x3b9b1571d
80000.0,2.0,1,3,3,4,10,0xb2da62e7
5357.64,1.0,49,2,2,2,6,0xb2d5f14bd
94307.66,2.0,6,3,3,3,9,0xb2d61036d
92002.87,3.0,25,3,4,2,9,0xb2d9a2ac
622207.84,6.0,27,4,4,2,10,0xb2d60b6ed
1570100.03,3.0,34,4,4,2,10,0xb2d6e057
1229.26,1.0,19,1,2,2,5,0xb2d2b231d
323002.33,3.0,6,4,4,3,11,0xb2d1fd9d
6838458.26,6.0,27,4,4,2,10,0x3b9adeead
45411.57,1.0,24,2,2,2,6,0xb2d623ddd
8914.71,1.0,145,2,2,1,5,0xb2d41b1cd
5.24,1.0,10,1,2,3,6,0xb2d51ce8d
22485.67,1.0,21,2,2,2,6,0xb2d2fdb0d
7.47,1.0,12,1,2,3,6,0xb2d53f5c
9701.09,1.0,90,2,2,1,5,0xb2d0d26cd
200003.79,2.0,35,3,3,2,8,0xb2d6c772
94986.22,1.0,8,3,2,3,8,0xb2d6a58ed
920.94,1.0,11,1,2,3,6,0xb2d6c3fcd
24498.58,1.0,113,2,2,1,5,0xb2d62d84d
20000.84,2.0,62,2,3,2,7,0xb2d8f5e8d
2938676.28,7.0,0,4,4,4,12,0xb2d206f8d
189.87,1.0,20,1,2,2,5,0xb2d2d939
433036.08,4.0,35,4,4,2,10,0xb2d90388d
140024.8,2.0,111,3,3,1,7,0xb2d2fe70d
141094.05,2.0,0,3,3,4,10,0xb2d30702d
180928.12,4.0,3,3,4,4,11,0xb2d576cad
25457.66,1.0,3,2,2,4,8,0xb2d30268
600010.57,5.0,13,4,4,3,11,0xb2d9613a
380000.0,4.0,3,4,4,4,12,0xb2d30f8ad
1030117.33,3.0,21,4,4,2,10,0xb2d8d43cd
50075.03,2.0,239,2,3,1,6,0xb2d65a72d
5.29,1.0,8,1,2,3,6,0xb2d9838e
560000.7,2.0,14,4,3,3,10,0xb2d17787d
3.07,1.0,13,1,2,3,6,0xb2d58337
70010.87,2.0,48,3,3,2,8,0xb2d91060
540971.63,5.0,14,4,4,3,11,0xb2d5cc5ed
106184.5,2.0,92,3,3,1,7,0x3b9b27b9d
201272.99,2.0,22,3,3,2,8,0xb2d4a257d
1033.81,1.0,92,1,2,1,4,0xb2d08910d
1070424.74,2.0,74,4,3,1,8,0xb2d594c4d
73626.59,4.0,0,3,4,4,11,0xb2d167b0d
105495.36,2.0,105,3,3,1,7,0xb2d526bcd
500710.42,3.0,19,4,4,2,10,0xb2d9283cd
103653.89,2.0,80,3,3,1,7,0xb2d62011
100032.75,2.0,132,3,3,1,7,0xb2d6c712
734.62,1.0,53,1,2,2,5,0xb2d68494
200031.69,2.0,27,3,3,2,8,0xb2d9572bd
6251.3,1.0,92,2,2,1,5,0xb2d200d7
40.94,1.0,11,1,2,3,6,0xb2d233f1
500001.98,3.0,26,4,4,2,10,0xb2d68bc1d
270175.85,2.0,92,3,3,1,7,0xb2d5b02bd
170419.6,3.0,0,3,4,4,11,0xb2d54744
609844.07,4.0,16,4,4,2,10,0xb2d6a895d
160078.42,2.0,132,3,3,1,7,0xb2d22241
2809479.15,6.0,4,4,4,4,12,0xb2d6898ed
948484.91,4.0,0,4,4,4,12,0xb2d2aadcd
3528.86,1.0,184,2,2,1,5,0xb2d44284d
10378.31,2.0,92,2,3,1,6,0xb2d105b3
4080.71,1.0,6,2,2,3,7,0xb2d1f242
9636.97,1.0,10,2,2,3,7,0xb2d8dfea
219.1,1.0,0,1,2,4,7,0xb2d1d615d
3172.13,1.0,92,2,2,1,5,0xb2d34647d
712.47,1.0,12,1,2,3,6,0xb2d547f5
52207.95,2.0,33,3,3,2,8,0xb2d1ea9d
10484.87,2.0,49,2,3,2,7,0xb2d564d5d
50023.02,2.0,166,2,3,1,6,0xb2d2986dd
82940.64,1.0,10,3,2,3,8,0xb2d248ffd
3.17,1.0,3,1,2,4,7,0xb2d95114
6057.57,1.0,92,2,2,1,5,0xb2d2b730d
90002.88,4.0,4,3,4,4,11,0xb2d5b13ed
63025.28,1.0,1,3,2,4,9,0xb2d5a97fd
20001.06,2.0,125,2,3,1,6,0xb2d92f60d
790137.4,2.0,48,4,3,2,9,0xb2d5738dd
10000.72,2.0,92,2,3,1,6,0xb2d97c61
3738.53,1.0,9,2,2,3,7,0xb2d9a55b
102936.1,1.0,74,3,2,1,6,0xb2d32970d
1040971.58,7.0,6,4,4,3,11,0xb2d38164d
2547999.4,11.0,4,4,4,4,12,0xb2d50655
291535.16,3.0,181,3,4,1,8,0xb2d3d3bbd
287.23,9.0,54,1,4,2,7,0xb2d21ac7
1930.04,1.0,10,1,2,3,6,0xb2d5bca4
5434.64,1.0,15,2,2,3,7,0xb2d1cea0d
10000.53,2.0,97,2,3,1,6,0xb2d96a89d
300252.6,3.0,90,4,4,1,9,0xb2d36809d
164590.49,2.0,193,3,3,1,7,0xb2d12489d
32.48,1.0,12,1,2,3,6,0xb2d22fbfd
210082.43,2.0,11,3,3,3,9,0xb2d1536c
30602.48,1.0,84,2,2,1,5,0xb2d5f603d
460092.81,5.0,0,4,4,4,12,0xb2d5709bd
10004.53,2.0,185,2,3,1,6,0xb2d5e528
254.39,1.0,125,1,2,1,4,0xb2d56872d
244021.05,4.0,69,3,4,1,8,0xb2d5c0d5d
21027.6,1.0,12,2,2,3,7,0xb2d16b31
500125.83,3.0,14,4,4,3,11,0xb2d1a63ed
40.24,1.0,5,1,2,3,6,0xb2d6c64ad
2975.73,1.0,12,2,2,3,7,0xb2d91ec7
128243.11,2.0,66,3,3,2,8,0xb2d16a07
70045.07,2.0,95,3,3,1,7,0xb2d62548
111507.0,2.0,10,3,3,3,9,0xb2d3c4c8d
12036.18,1.0,9,2,2,3,7,0xb2d5c1fed
205080.06,2.0,23,3,3,2,8,0xb2d6e45bd
1277128.47,7.0,4,4,4,4,12,0xb2d4385cd
290007.76,8.0,14,3,4,3,10,0xb2d0b422
170003.51,3.0,70,3,4,1,8,0xb2d16fb3
500075.33,4.0,26,4,4,2,10,0xb2d781d3d
20000.42,2.0,214,2,3,1,6,0xb2d7695e
18.57,1.0,68,1,2,1,4,0xb2d5b2b1
7684.77,1.0,10,2,2,3,7,0xb2d5bdd2d
1612.81,1.0,184,1,2,1,4,0xb2d1892fd
181631.64,3.0,4,3,4,4,11,0xb2d16c7c
130001.37,2.0,49,3,3,2,8,0xb2d9d8a2
537.27,1.0,2,1,2,4,7,0xb2d118f1
1217.42,1.0,92,1,2,1,4,0xb2d2e002d
45046.74,3.0,210,2,4,1,7,0xb2d63441d
100036.27,5.0,7,3,4,3,10,0xb2d06acbd
11696.61,1.0,8,2,2,3,7,0xb2d96561
3990.39,1.0,0,2,2,4,8,0xb2d3a33bd
2980.66,1.0,9,2,2,3,7,0xb2d3a1af
141067.69,14.0,6,3,4,3,10,0xb2d339eed
20080.34,1.0,184,2,2,1,5,0xb2d45870d
200002.23,2.0,16,3,3,2,8,0xb2d59109d
21.48,1.0,50,1,2,2,5,0xb2d598fe
18257.65,1.0,133,2,2,1,5,0xb2d6d131d
1713300.0,12.0,0,4,4,4,12,0xb2d5856ed
394741.48,5.0,5,4,4,3,11,0x3b9b4120d
2702.43,1.0,1,1,2,4,7,0xb2d4ba91
4800.92,1.0,10,2,2,3,7,0xb2d21c8b
185.56,2.0,19,1,3,2,6,0xb2d06d33d
4562.01,1.0,16,2,2,2,6,0xb2d8c5a5d
505758.98,2.0,74,4,3,1,8,0xb2d28e6cd
20000.74,3.0,38,2,4,2,8,0xb2d7d54bd
11743.07,1.0,3,2,2,4,8,0xb2da0b44
1693.65,1.0,0,1,2,4,7,0xb2d939a5
12026.72,1.0,49,2,2,2,6,0xb2d1a296
66.42,1.0,43,1,2,2,5,0xb2d69088d
3079040.99,6.0,80,4,4,1,9,0xb2d101d7d
487093.24,3.0,3,4,4,4,12,0xb2d30e66d
3378179.04,1.0,0,4,2,4,10,0xb2d9f0c9
288447.8,11.0,0,3,4,4,11,0x3b9ad799d
301016.59,10.0,31,4,4,2,10,0xb2d0b5f5d
1016.98,1.0,19,1,2,2,5,0xb2d23f38d
8190.49,1.0,1,2,2,4,8,0xb2d6b862d
154597.18,1.0,0,3,2,4,9,0xb2d3838c
20286.13,1.0,242,2,2,1,5,0xb2d630bdd
655.6,1.0,49,1,2,2,5,0xb2d784b9
116911.5,3.0,55,3,4,2,9,0xb2d2b32bd
50588.79,1.0,15,2,2,3,7,0xb2d3192c
64.18,1.0,48,1,2,2,5,0xb2d2bb24
261425.49,1.0,6,3,2,3,8,0xb2d38019d
1000103.09,3.0,11,4,4,3,11,0xb2d81034d
8339.78,1.0,184,2,2,1,5,0xb2d2aae1d
320000.37,2.0,8,4,3,3,10,0xb2d6cf7ed
1090024.72,4.0,11,4,4,3,11,0xb2d20901d
501785.21,2.0,27,4,3,2,9,0xb2d1c09cd
172.48,1.0,16,1,2,2,5,0xb2d8d964
50055.5,2.0,0,2,3,4,9,0xb2d65490d
121002.77,3.0,39,3,4,2,9,0xb2d9723c
2.36,1.0,1,1,2,4,7,0xb2d320fc
3247.2,1.0,184,2,2,1,5,0xb2d206f6d
12400130.97,2.0,10,4,3,3,10,0xb2d63602d
50007.12,3.0,27,2,4,2,8,0xb2d3a065d
680003.79,8.0,3,4,4,4,12,0xb2d07eb2d
5028.94,1.0,0,2,2,4,8,0xb2d3f4d8
273725.36,4.0,0,3,4,4,11,0xb2d19b21d
1.82,1.0,10,1,2,3,6,0xb2d92e91
3827.73,1.0,6,2,2,3,7,0xb2d5c574d
190645.42,1.0,10,3,2,3,8,0xb2d22981d
1475004.25,3.0,3,4,4,4,12,0xb2d57287d
1015.78,1.0,92,1,2,1,4,0xb2d0e5f6d
349235.63,5.0,20,4,4,2,10,0xb2d6149bd
453023.92,4.0,18,4,4,2,10,0xb2d9242cd
1039.15,1.0,184,1,2,1,4,0xb2d29a18d
71942.64,2.0,214,3,3,1,7,0xb2d567c0
408.58,1.0,0,1,2,4,7,0xb2d4189c
50119.11,4.0,3,2,4,4,10,0xb2d92079d
183.53,1.0,17,1,2,2,5,0xb2d219ca
25825.24,1.0,8,2,2,3,7,0xb2d7849ed
20000.21,2.0,90,2,3,1,6,0xb2d8c393
17428.0,1.0,98,2,2,1,5,0xb2d1a390
125.02,2.0,1,1,3,4,8,0xb2d08d8ad
5.5,1.0,0,1,2,4,7,0xb2d53038
412448.71,4.0,1,4,4,4,12,0xb2d357e9
443.79,1.0,10,1,2,3,6,0xb2d33ac5
2054000.0,6.0,0,4,4,4,12,0xb2d3c3d7d
105681.33,2.0,27,3,3,2,8,0xb2d63265d
480776.69,2.0,4,4,3,4,11,0xb2d5c8d7d
216.78,2.0,0,1,3,4,8,0xb2d1e58f
80558.71,3.0,48,3,4,2,9,0xb2d432cfd
50001.16,3.0,13,2,4,3,9,0xb2d925aed
51160.09,3.0,0,2,4,4,10,0x3b9b466a
0.46,1.0,80,1,2,1,4,0xb2d263e6d
5711.37,1.0,2,2,2,4,8,0xb2d3a5c1d
1007.58,1.0,92,1,2,1,4,0xb2d44af2d
0.15,2.0,59,1,3,2,6,0xb2d51e42
8778.0,2.0,60,2,3,2,7,0xb2d8ff58
502579.98,5.0,19,4,4,2,10,0xb2d192ffd
6503.98,2.0,92,2,3,1,6,0xb2d08c98
1318.87,1.0,92,1,2,1,4,0xb2d26d10d
9018.52,1.0,158,2,2,1,5,0xb2d2c84ad
6518.31,1.0,10,2,2,3,7,0xb2d6f922d
334009.32,4.0,10,4,4,3,11,0xb2d104e7d
576.71,1.0,0,1,2,4,7,0xb2d19852d
10042.56,1.0,19,2,2,2,6,0xb2d4df11d
1657.19,2.0,184,1,3,1,5,0xb2d18ac4d
558.3,1.0,0,1,2,4,7,0xb2d18054d
50001.06,2.0,11,2,3,3,8,0xb2da41e5
688.84,1.0,67,1,2,1,4,0xb2d10b01d
303603.33,3.0,1,4,4,4,12,0xb2d63beed
200013.83,3.0,11,3,4,3,10,0xb2d5f3f5
600000.0,2.0,13,4,3,3,10,0xb2d951fad
2013.62,2.0,25,1,3,2,6,0xb2d28641d
50029.77,2.0,51,2,3,2,7,0xb2d6b43ed
312609.38,2.0,28,4,3,2,9,0xb2d57f8ad
113255.22,3.0,17,3,4,2,9,0xb2d3b58fd
50000.0,2.0,0,2,3,4,9,0xb2d93f71d
753109.17,4.0,24,4,4,2,10,0xb2d4410e
19.85,1.0,0,1,2,4,7,0xb2d2af72
1141.55,1.0,92,1,2,1,4,0xb2d0ead0d
200000.0,2.0,26,3,3,2,8,0xb2da14cc
6.68,1.0,30,1,2,2,5,0xb2d69ac6d
643887.48,17.0,0,4,4,4,12,0x3b9b18f7d
7825.31,1.0,184,2,2,1,5,0xb2d38da2d
10005.21,2.0,18,2,3,2,7,0xb2da2c02
210047.5,3.0,209,3,4,1,8,0x3b9b47b9d
280611.76,1.0,11,3,2,3,8,0xb2d202b1d
552854.33,3.0,8,4,4,3,11,0xb2d23a57
11182.42,1.0,33,2,2,2,6,0xb2d2a5b8d
726.11,1.0,23,1,2,2,5,0xb2d3e284d
4.9,1.0,26,1,2,2,5,0xb2d91354
406569.64,3.0,1,4,4,4,12,0xb2d5d838d
100002.11,1.0,12,3,2,3,8,0xb2da3de4
100417.3,3.0,124,3,4,1,8,0xb2d53faa
95469.74,2.0,132,3,3,1,7,0xb2d47679d
104193.61,1.0,4,3,2,4,9,0xb2d428a0
965252.46,5.0,21,4,4,2,10,0xb2d5fc2fd
1.22,1.0,73,1,2,1,4,0xb2d1d545
8872.83,1.0,3,2,2,4,8,0xb2d6d72bd
200027.4,2.0,10,3,3,3,9,0xb2d5bfee
562147.96,3.0,167,4,4,1,9,0xb2d07d30d
7213.09,1.0,3,2,2,4,8,0xb2d342f2d
523843.07,2.0,76,4,3,1,8,0xb2d339a8d
1429.34,1.0,184,1,2,1,4,0xb2d177f9d
2.06,1.0,9,1,2,3,6,0xb2d7f6c5
4324.83,1.0,13,2,2,3,7,0xb2d43cc9
220005.49,3.0,26,3,4,2,9,0xb2d9217ad
2096.26,1.0,6,1,2,3,6,0xb2d57bc5d
1208936.69,3.0,13,4,4,3,11,0xb2d6cc2ad
320588.03,4.0,19,4,4,2,10,0xb2d3ca4bd
381.99,1.0,65,1,2,2,5,0xb2d97279
6.18,1.0,14,1,2,3,6,0xb2d99c0e
73332.26,2.0,18,3,3,2,8,0xb2d2fdfa
3545.17,1.0,18,2,2,2,6,0xb2d69b85d
500000.08,2.0,22,4,3,2,9,0xb2d98964
42138.87,1.0,210,2,2,1,5,0xb2d303e9d
994914.59,5.0,11,4,4,3,11,0xb2d3d134d
0.0,1.0,0,1,2,4,7,0xb2d1ebc8d
288335.34,3.0,17,3,4,2,9,0xb2d1528bd
350068.16,4.0,55,4,4,2,10,0xb2d33d01d
9.51,13.0,48,1,4,2,7,0xb2d6e418d
530022.2,5.0,52,4,4,2,10,0xb2d3d40cd
85027.71,3.0,80,3,4,1,8,0xb2d5c32cd
53445.28,2.0,10,3,3,3,9,0xb2d44cecd
57315.56,2.0,27,3,3,2,8,0xb2d0f8d3d
600071.48,2.0,14,4,3,3,10,0xb2d62900d
9956.12,2.0,4,2,3,4,9,0xb2d0b1a4d
551513.91,6.0,70,4,4,1,9,0xb2d10edad
680000.02,3.0,156,4,4,1,9,0xb2d135a6
595.6,1.0,1,1,2,4,7,0xb2d454dd
3638.9,1.0,184,2,2,1,5,0xb2d311a4d
357812.57,4.0,59,4,4,2,10,0xb2d178e2
555981.07,4.0,105,4,4,1,9,0xb2d208ccd
190004.01,2.0,6,3,3,3,9,0xb2d966b2d
65845.44,2.0,0,3,3,4,10,0xb2d2d733
2462175.41,8.0,56,4,4,2,10,0xb2d10504d
50067.41,2.0,10,2,3,3,8,0xb2d6c4d8d
621218.92,6.0,28,4,4,2,10,0xb2d473aed
4411.93,1.0,9,2,2,3,7,0xb2d2b3c0
1656.96,1.0,92,1,2,1,4,0xb2d22fb1d
6891.82,1.0,0,2,2,4,8,0xb2d5837ed
4131.04,1.0,92,2,2,1,5,0xb2d300c9d
341000.11,3.0,5,4,4,3,11,0xb2d695cb
329180.36,5.0,5,4,4,3,11,0xb2d5484dd
6916.91,1.0,1,2,2,4,8,0xb2d9ca2e
84.22,1.0,7,1,2,3,6,0xb2d932aa
323024.2,11.0,19,4,4,2,10,0xb2d3cc3fd
209.95,1.0,1,1,2,4,7,0xb2d7f528
145067.76,3.0,1,3,4,4,11,0xb2d415b7
917186.7,4.0,39,4,4,2,10,0xb2d51316d
3013.35,1.0,184,2,2,1,5,0xb2d5c958d
8855.38,2.0,3,2,3,4,9,0xb2d0f5ce
383.36,1.0,23,1,2,2,5,0xb2d25c49
8198.05,1.0,0,2,2,4,8,0xb2d527ab
123048.52,2.0,59,3,3,2,8,0xb2d12daad
497.51,1.0,6,1,2,3,6,0xb2d9357fd
170254.1,9.0,0,3,4,4,11,0xb2d52e1f
813008.74,14.0,6,4,4,3,11,0xb2d5e93ad
51074.04,4.0,74,2,4,1,7,0xb2d652e7d
10102.01,4.0,1,2,4,4,10,0x3b9b16fa
65988.36,2.0,168,3,3,1,7,0xb2d26193d
500006.65,2.0,4,4,3,4,11,0xb2d8df4ed
281415.12,4.0,0,3,4,4,11,0xb2d1cc2ad
374838.95,8.0,4,4,4,4,12,0xb2d5b40bd
85004.17,2.0,228,3,3,1,7,0xb2d50cd0
386008.65,9.0,4,4,4,4,12,0xb2d3780fd
12509.86,1.0,27,2,2,2,6,0xb2d69a43d
1003.52,1.0,15,1,2,3,6,0xb2d5dcf9
601.39,1.0,8,1,2,3,6,0xb2d1aeb1
161.08,1.0,24,1,2,2,5,0xb2d56062d
1924.56,1.0,7,1,2,3,6,0xb2d3ba05d
0.0,1.0,6,1,2,3,6,0xb2d18910d
150041.96,2.0,59,3,3,2,8,0xb2d25c98d
60004.45,3.0,0,3,4,4,11,0xb2d0779cd
44.86,1.0,62,1,2,2,5,0xb2d362fed
34033.64,2.0,15,2,3,3,8,0xb2d9693cd
1453837.02,6.0,0,4,4,4,12,0xb2d26233
1543.7,1.0,0,1,2,4,7,0xb2d505ff
100001.06,2.0,38,3,3,2,8,0xb2d92d4fd
4545.37,1.0,184,2,2,1,5,0xb2d37d37d
10125.87,1.0,56,2,2,2,6,0xb2d6d4e5d
2.6,1.0,2,1,2,4,7,0xb2d6cecf
300728.81,2.0,19,4,3,2,9,0xb2d52de7d
1003198.71,4.0,90,4,4,1,9,0xb2d52b54d
133.88,1.0,55,1,2,2,5,0xb2d78cc0
20343.15,1.0,17,2,2,2,6,0xb2d6f368d
10014.44,1.0,119,2,2,1,5,0xb2d4491f
125.43,1.0,10,1,2,3,6,0xb2d9f063
149380.6,1.0,5,3,2,3,8,0xb2d1c479
278095.04,1.0,0,3,2,4,9,0xb2d2f1acd
340040.45,6.0,60,4,4,2,10,0xb2d5bc4bd
36683.46,3.0,9,2,4,3,9,0x3b9b1819d
5449.19,3.0,63,2,4,2,8,0xb2d95fd7d
140027.04,2.0,249,3,3,1,7,0xb2d5f8ded
287.3,1.0,7,1,2,3,6,0xb2d654c5
340005.94,6.0,3,4,4,4,12,0x3b9b32b4d
160763.71,3.0,5,3,4,3,10,0xb2d94806d
500025.8,2.0,210,4,3,1,8,0xb2d50670d
9551.91,1.0,15,2,2,3,7,0xb2d99129
2211.48,1.0,21,1,2,2,5,0xb2d12227
427526.05,4.0,200,4,4,1,9,0xb2d1b9dbd
12.54,1.0,82,1,2,1,4,0xb2d3a95a
658977.12,3.0,0,4,4,4,12,0xb2d657d4
6058.45,1.0,92,2,2,1,5,0xb2d29065d
2170100.13,4.0,29,4,4,2,10,0xb2d6e057d
2554.06,1.0,157,1,2,1,4,0xb2d297c0d
520107.69,3.0,1,4,4,4,12,0xb2d5ee29
301130.92,2.0,40,4,3,2,9,0xb2d7a719d
820005.19,5.0,17,4,4,2,10,0xb2d3af47d
100049.5,3.0,53,3,4,2,9,0xb2d4f17fd
3468.56,1.0,1,2,2,4,8,0xb2d9140bd
202152.48,2.0,37,3,3,2,8,0xb2d6ccecd
80082.22,2.0,62,3,3,2,8,0xb2d2c2d0d
9271.18,1.0,1,2,2,4,8,0xb2d28faed
200053.66,2.0,76,3,3,1,7,0xb2d14fdad
0.94,1.0,47,1,2,2,5,0xb2d5f8b8
19616.08,1.0,3,2,2,4,8,0xb2d52f06
350000.05,6.0,0,4,4,4,12,0xb2d20578d
200000.0,2.0,24,3,3,2,8,0xb2d94d2ed
128243.34,2.0,158,3,3,1,7,0xb2d16a07d
1008.67,1.0,92,1,2,1,4,0xb2d1b942d
814.07,1.0,18,1,2,2,5,0xb2d63538
50629.36,1.0,56,2,2,2,6,0xb2d6d47ed
7085560.36,11.0,0,4,4,4,12,0xb2d07bfcd
5.37,1.0,10,1,2,3,6,0xb2d2a563d
958681.64,5.0,48,4,4,2,10,0xb2d14b22d
110004.69,2.0,228,3,3,1,7,0xb2d54173
3420.65,1.0,10,2,2,3,7,0xb2d40df2d
67001.41,2.0,10,3,3,3,9,0xb2d9641ed
723455.33,3.0,6,4,4,3,11,0xb2d5911ed
400057.38,2.0,19,4,3,2,9,0xb2d5bde8
4881.65,1.0,29,2,2,2,6,0xb2d91f80
245081.5,4.0,11,3,4,3,10,0xb2d5e103d
24549.54,1.0,0,2,2,4,8,0xb2d6ab4ed
3335.61,3.0,1,2,4,4,10,0x3b9af254d
147.79,1.0,10,1,2,3,6,0xb2d1408dd
4205.65,1.0,9,2,2,3,7,0xb2d443e6d
498451.34,4.0,95,4,4,1,9,0xb2d5e13bd
10.12,1.0,21,1,2,2,5,0xb2d2a6c2
100101.48,2.0,110,3,3,1,7,0xb2d5cf2e
12776.82,1.0,0,2,2,4,8,0xb2d327ee
68.52,2.0,0,1,3,4,8,0xb2d0a457
57.85,1.0,0,1,2,4,7,0xb2d78d42d
100003.48,4.0,54,3,4,2,9,0xb2d07b15d
136008.4,2.0,24,3,3,2,8,0xb2d58de7
332227.53,3.0,20,4,4,2,10,0xb2d56e48d
304174.98,3.0,0,4,4,4,12,0xb2d60641
965.48,1.0,10,1,2,3,6,0xb2d3065a
352504.72,2.0,21,4,3,2,9,0xb2d61bdcd
31734.47,1.0,44,2,2,2,6,0xb2d64a7a
10790.66,1.0,87,2,2,1,5,0xb2d57971d
200000.0,2.0,29,3,3,2,8,0xb2da0bb5
7786.78,1.0,112,2,2,1,5,0xb2d2ed8fd
230006.98,2.0,26,3,3,2,8,0xb2d9cb6a
1301.8,1.0,184,1,2,1,4,0xb2d370f1d
6.62,1.0,22,1,2,2,5,0xb2d60bb4d
3001.26,1.0,18,2,2,2,6,0xb2d22c09d
50009.93,5.0,0,2,4,4,10,0xb2d0e330
100004.31,3.0,25,3,4,2,9,0xb2d21ac0d
17144411.59,4.0,3,4,4,4,12,0xb2d51341
74642.8,2.0,11,3,3,3,9,0xb2d2f1a4
210005.12,6.0,52,3,4,2,9,0xb2d1542bd
210050.39,2.0,4,3,3,4,10,0xb2d9e694
1014239.19,2.0,97,4,3,1,8,0xb2d92799d
579.2,1.0,7,1,2,3,6,0xb2d67d78
1272.17,1.0,0,1,2,4,7,0xb2d58057d
435053.73,5.0,63,4,4,2,10,0xb2d2b99ad
44046.62,1.0,145,2,2,1,5,0x3b9b2d1a
16332.66,1.0,0,2,2,4,8,0xb2d790af
140199.32,1.0,6,3,2,3,8,0xb2d388c1d
226565.03,2.0,41,3,3,2,8,0x3b9b3eacd
574777.08,3.0,14,4,4,3,11,0xb2d3bb37
3.29,1.0,75,1,2,1,4,0xb2d59a0c
10029.7,1.0,22,2,2,2,6,0xb2d607d0d
942337.58,9.0,60,4,4,2,10,0xb2d288aed
3419.37,1.0,10,2,2,3,7,0xb2d36c12d
542074.63,6.0,182,4,4,1,9,0xb2d45078d
161009.89,4.0,73,3,4,1,8,0xb2d117a8d
419884.48,2.0,23,4,3,2,9,0xb2d24ddcd
9.06,1.0,12,1,2,3,6,0xb2d9f2d3
499404.22,5.0,0,4,4,4,12,0xb2d1131ad
74799.53,1.0,4,3,2,4,9,0xb2d3a327d
2083.41,1.0,24,1,2,2,5,0xb2d55af3d
1161.38,1.0,10,1,2,3,6,0xb2d35c3ad
199.5,1.0,57,1,2,2,5,0xb2d999e9
1811415.44,6.0,10,4,4,3,11,0x3b9b2b5ad
1499897.04,1.0,5,4,2,3,9,0xb2d633e3d
2510223.1,5.0,18,4,4,2,10,0xb2d5521fd
167033.76,3.0,4,3,4,4,11,0xb2d358a0
500000.0,2.0,14,4,3,3,10,0xb2d96086d
4608635.39,3.0,153,4,4,1,9,0xb2d1dcffd
350040.84,4.0,6,4,4,3,11,0xb2d4369dd
137032.13,2.0,14,3,3,3,9,0xb2d58de7d
7114.88,1.0,19,2,2,2,6,0xb2d1bbeb
916.07,1.0,12,1,2,3,6,0xb2d93557
252749.4,3.0,1,3,4,4,11,0xb2d167add
6728.23,1.0,4,2,2,4,8,0xb2d3581c
92.17,1.0,4,1,2,4,7,0xb2d5d162d
320537.6,6.0,0,4,4,4,12,0xb2d0e10ad
50000.0,1.0,6,2,2,3,7,0xb2d9d0ab
230000.02,2.0,26,3,3,2,8,0xb2d8ca93d
1312000.85,15.0,0,4,4,4,12,0xb2d64f2b
5412.5,1.0,57,2,2,2,6,0xb2d96c57
50002.74,2.0,6,2,3,3,8,0xb2d961b0
277992.02,1.0,0,3,2,4,9,0xb2d12ec6d
291.4,3.0,92,1,4,1,6,0x3b9b16db
1209856.15,9.0,0,4,4,4,12,0xb2d212e9d
219.36,1.0,37,1,2,2,5,0xb2d62938
33786.06,1.0,202,2,2,1,5,0xb2d300dad
600054.32,3.0,12,4,4,3,11,0xb2d68ab1d
250008.76,2.0,82,3,3,1,7,0xb2d8ef5d
1560202.46,3.0,25,4,4,2,10,0xb2d308acd
20001.9,1.0,19,2,2,2,6,0xb2da0d5f
3514042.22,2.0,3,4,3,4,11,0xb2d92190d
176536.26,8.0,5,3,4,3,10,0x3b9b3ad8d
50002.64,2.0,20,2,3,2,7,0xb2da1b6d
10151498.34,3.0,3,4,4,4,12,0xb2d3f827
4981.17,1.0,9,2,2,3,7,0xb2d1d915
0.16,2.0,84,1,3,1,5,0xb2d893ffd
11849.86,1.0,7,2,2,3,7,0xb2d8c51ed
120000.97,2.0,39,3,3,2,8,0xb2d2850dd
195015.34,2.0,83,3,3,1,7,0xb2d186c0d
21519.9,1.0,15,2,2,3,7,0xb2d95c45
53003.86,2.0,3,3,3,4,10,0xb2d78438d
105.82,1.0,4,1,2,4,7,0xb2d1c28c
72169.26,1.0,143,3,2,1,6,0xb2d36556
156.01,1.0,10,1,2,3,6,0xb2d6b36bd
1903529.68,3.0,0,4,4,4,12,0xb2d9a47f
39724.93,1.0,184,2,2,1,5,0xb2d3dbc7d
35574.8,1.0,4,2,2,4,8,0xb2d43bfc
295.1,1.0,9,1,2,3,6,0xb2d3c15fd
259.93,1.0,9,1,2,3,6,0xb2d2b5ef
159018.15,3.0,4,3,4,4,11,0xb2d18107d
40000.84,3.0,10,2,4,3,9,0xb2d6f60ed
223922.42,4.0,52,3,4,2,9,0xb2d28a84d
0.0,1.0,0,1,2,4,7,0xb2d90d00
2982.32,1.0,1,2,2,4,8,0xb2d2cde4d
22.46,1.0,61,1,2,2,5,0xb2d1880ad
900000.34,1.0,0,4,2,4,10,0xb2d3d8d9d
106961.45,2.0,94,3,3,1,7,0xb2d40ff2d
830043.81,2.0,70,4,3,1,8,0xb2d8c5f7
93.36,3.0,3,1,4,4,9,0xb2d068ffd
220057.39,3.0,0,3,4,4,11,0xb2d5a61bd
400091.67,6.0,10,4,4,3,11,0xb2d5be29
827.79,1.0,0,1,2,4,7,0xb2d92c24
4.91,1.0,18,1,2,2,5,0xb2d58ee0
6120.94,1.0,20,2,2,2,6,0xb2d326d9
196018.86,3.0,0,3,4,4,11,0xb2d0c104
193884.08,3.0,94,3,4,1,8,0xb2d0ee84d
20268.97,2.0,66,2,3,2,7,0xb2d6b198d
1000604.43,2.0,14,4,3,3,10,0xb2d99c14
400001.75,2.0,4,4,3,4,11,0xb2d87b61d
0.0,1.0,0,1,2,4,7,0xb2da581e
1.87,1.0,20,1,2,2,5,0xb2d90a0f
1028530.56,3.0,79,4,4,1,9,0xb2d36621d
1543274.02,13.0,46,4,4,2,10,0xb2d4e165
150015.93,3.0,20,3,4,2,9,0xb2d8da7bd
30006.72,2.0,122,2,3,1,6,0xb2d63340d
466199.92,3.0,1,4,4,4,12,0xb2d16bb2
690611.24,15.0,3,4,4,4,12,0xb2d343dd
88464.85,4.0,11,3,4,3,10,0xb2d628b3d
39908.17,1.0,0,2,2,4,8,0xb2d9bf23
100005.3,2.0,55,3,3,2,8,0xb2d2cb71
1082.93,1.0,72,1,2,1,4,0xb2d5ce7fd
51478.91,2.0,4,2,3,4,9,0xb2d15662d
3371.53,1.0,9,2,2,3,7,0xb2d69841d
831001.69,13.0,0,4,4,4,12,0x3b9add59d
140010.11,3.0,3,3,4,4,11,0xb2d2c33ad
9884.91,1.0,184,2,2,1,5,0xb2d21385
230035.31,5.0,32,3,4,2,9,0xb2d1cf87d
10000.61,2.0,41,2,3,2,7,0xb2d91f28
55001.74,3.0,59,3,4,2,9,0xb2d8df57d
310050.36,5.0,73,4,4,1,9,0xb2d603b8d
200712.53,2.0,4,3,3,4,10,0xb2d93264
52586.44,1.0,4,3,2,4,9,0xb2d27078d
6189.82,1.0,184,2,2,1,5,0xb2d205a8d
9782.46,1.0,2,2,2,4,8,0xb2d6f049d
478035.97,3.0,8,4,4,3,11,0xb2d3604f
300000.0,2.0,1,3,3,4,10,0xb2da6622
117564.59,3.0,18,3,4,2,9,0xb2d23eaad
68035.81,3.0,102,3,4,1,8,0xb2d591f4d
19121.15,1.0,3,2,2,4,8,0xb2d5f91cd
3518.06,1.0,92,2,2,1,5,0xb2d11d4ad
110647.82,2.0,125,3,3,1,7,0xb2d15dd1
399688.78,2.0,1,4,3,4,11,0xb2d682cfd
61647.22,2.0,144,3,3,1,7,0xb2d5e42cd
143005.26,3.0,25,3,4,2,9,0xb2d6ac02d
802074.0,5.0,0,4,4,4,12,0xb2d126b8d
130003.28,3.0,31,3,4,2,9,0xb2d6fab0d
10768.51,2.0,60,2,3,2,7,0xb2d63c67d
300076.81,2.0,19,3,3,2,8,0xb2d4f2a4
3635.5,1.0,0,2,2,4,8,0xb2d69129
71.85,1.0,6,1,2,3,6,0xb2d2c21a
10278.88,1.0,184,2,2,1,5,0xb2d2d9b6
250005.63,2.0,15,3,3,3,9,0xb2d6c690
181516.5,2.0,8,3,3,3,9,0xb2d10d52d
1304.64,1.0,17,1,2,2,5,0xb2d6eb60
500017.33,2.0,27,4,3,2,9,0xb2d938ff
90003.8,2.0,49,3,3,2,8,0xb2d6b173
50000.53,2.0,76,2,3,1,6,0xb2d8dcdb
20004.21,2.0,41,2,3,2,7,0xb2d27c1fd
20001.45,2.0,189,2,3,1,6,0xb2d638dcd
501689.41,3.0,0,4,4,4,12,0xb2d9a346
1406.31,1.0,2,1,2,4,7,0xb2d3f248
90250.83,2.0,206,3,3,1,7,0xb2d4f8a8d
30181.34,3.0,92,2,4,1,7,0xb2d573add
5.32,1.0,101,1,2,1,4,0xb2d6249ed
91.76,1.0,4,1,2,4,7,0xb2d25d51d
100017.89,2.0,196,3,3,1,7,0xb2d5f58dd
41.9,1.0,0,1,2,4,7,0xb2d1db5ad
170108.18,4.0,8,3,4,3,10,0xb2d94114d
10043.06,1.0,184,2,2,1,5,0xb2d5de7a
111003.76,5.0,25,3,4,2,9,0xb2d638ded
37406.59,1.0,55,2,2,2,6,0xb2d56056
550102.45,6.0,14,4,4,3,11,0xb2d636dad
211.79,1.0,10,1,2,3,6,0xb2d60fe5
3863.53,1.0,16,2,2,2,6,0xb2d2f23fd
90012.56,3.0,49,3,4,2,9,0xb2d62f28d
23161.94,2.0,0,2,3,4,9,0xb2d0f49fd
1818.52,1.0,184,1,2,1,4,0xb2d54926d
201556.21,5.0,5,3,4,3,10,0xb2d591b2
6697.81,1.0,7,2,2,3,7,0xb2d4e893
5089.19,1.0,0,2,2,4,8,0xb2d12f8cd
200003.69,3.0,8,3,4,3,10,0xb2d97a94d
523123.83,2.0,107,4,3,1,8,0xb2d5b0e5d
100003.99,2.0,98,3,3,1,7,0xb2d575a4
15028.93,2.0,54,2,3,2,7,0xb2d4e286
890068.75,8.0,0,4,4,4,12,0xb2d6001cd
137.89,1.0,1,1,2,4,7,0xb2d7c03b
400353.42,8.0,26,4,4,2,10,0xb2d68bdbd
300003.17,3.0,10,3,4,3,10,0xb2d95ef8
1632.81,3.0,0,1,4,4,9,0xb2d1c233
1003.51,2.0,217,1,3,1,5,0x3b9b3fc7d
209008.13,5.0,3,3,4,4,11,0xb2d1793cd
289357.58,10.0,0,3,4,4,11,0xb2d0687bd
6.95,1.0,184,1,2,1,4,0xb2d2a5f8
8028.22,1.0,49,2,2,2,6,0xb2d37c6dd
501776.04,2.0,36,4,3,2,9,0xb2d9fb0d
79003.84,8.0,14,3,4,3,10,0xb2d53f17d
200000.0,2.0,22,3,3,2,8,0xb2d95064d
141527.89,2.0,11,3,3,3,9,0xb2d2611fd
172128.87,4.0,78,3,4,1,8,0xb2d2c722
15.56,1.0,82,1,2,1,4,0xb2d596a7d
24.39,1.0,48,1,2,2,5,0xb2d9a980
210718.5,2.0,0,3,3,4,10,0xb2d12b3fd
200033.41,2.0,195,3,3,1,7,0xb2d41fc2d
12000.63,2.0,92,2,3,1,6,0xb2d647add
1123.08,1.0,92,1,2,1,4,0xb2d06b53
190285.35,6.0,62,3,4,2,9,0xb2d568c6d
524012.19,5.0,6,4,4,3,11,0xb2d1dfbed
2108338.85,2.0,10,4,3,3,10,0xb2d37a69d
2959.68,1.0,2,2,2,4,8,0xb2d62c44d
85008.91,3.0,0,3,4,4,11,0xb2d68e83d
400060.3,2.0,0,4,3,4,11,0xb2d61b8ad
1592.47,1.0,92,1,2,1,4,0xb2d4c69bd
4582.16,1.0,1,2,2,4,8,0xb2d2b5d5
20235.09,2.0,115,2,3,1,6,0xb2d56deb
26093.79,1.0,192,2,2,1,5,0xb2d3b6f3
500000.04,2.0,13,4,3,3,10,0xb2d9e974
4.26,1.0,0,1,2,4,7,0xb2d4b64fd
190005.32,4.0,3,3,4,4,11,0xb2d1c971d
220008.22,2.0,19,3,3,2,8,0xb2d58db1
1301.56,1.0,75,1,2,1,4,0xb2d68dded
3271.32,1.0,0,2,2,4,8,0xb2d23bb4
40488.29,1.0,47,2,2,2,6,0xb2d8cc4b
180029.58,4.0,6,3,4,3,10,0xb2d5d54ad
20028.6,1.0,92,2,2,1,5,0x3b9b2d05d
177.24,1.0,10,1,2,3,6,0xb2d5a5a1d
4096.77,1.0,216,2,2,1,5,0xb2d3d29dd
203600.0,4.0,0,3,4,4,11,0xb2d96fc1d
20009.45,3.0,62,2,4,2,8,0xb2d6e201
50029.18,2.0,164,2,3,1,6,0xb2d50fb0
20355.5,1.0,4,2,2,4,8,0xb2d9518a
426905.09,3.0,4,4,4,4,12,0xb2d64d4ed
544488.66,5.0,5,4,4,3,11,0xb2d29ca6d
70003.99,3.0,83,3,4,1,8,0xb2d78b0ed
71457.81,1.0,1,3,2,4,9,0xb2d4201cd
89.04,1.0,5,1,2,3,6,0xb2d69076d
51033.18,5.0,2,2,4,4,10,0xb2d0afb0
46.45,1.0,14,1,2,3,6,0xb2d6e96a
50033.49,2.0,19,2,3,2,7,0xb2d62408d
2986.92,1.0,0,2,2,4,8,0xb2d4852c
8618.1,3.0,0,2,4,4,10,0x3b9b0e4fd
341987.97,3.0,4,4,4,4,12,0xb2d63144d
552429.6,4.0,74,4,4,1,9,0xb2d29438d
122163.78,2.0,108,3,3,1,7,0xb2d27bfbd
607936.75,7.0,25,4,4,2,10,0x3b9b2932d
100172.31,1.0,3,3,2,4,9,0xb2d6bf54d
1120973.92,3.0,22,4,4,2,10,0xb2d68547
112941.87,1.0,11,3,2,3,8,0xb2d80536d
286029.37,2.0,17,3,3,2,8,0xb2d244bc
214117.78,2.0,8,3,3,3,9,0xb2d3a32ed
711198.28,2.0,7,4,3,3,10,0xb2d0afa7d
37.5,1.0,67,1,2,1,4,0xb2d78ecbd
100000.0,2.0,6,3,3,3,9,0xb2da4f1b
823.28,1.0,21,1,2,2,5,0xb2d5005fd
200012.24,2.0,32,3,3,2,8,0xb2d33129d
342.96,1.0,0,1,2,4,7,0xb2d17588
3954.85,1.0,154,2,2,1,5,0xb2d4f8fdd
115.99,1.0,0,1,2,4,7,0xb2d33e04
0.0,1.0,4,1,2,4,7,0xb2d9c24d
201421.78,2.0,48,3,3,2,8,0xb2d95df0d
96090030.56,12.0,6,4,4,3,11,0xb2d07933d
241139.27,2.0,4,3,3,4,10,0xb2d71886
448621.86,2.0,235,4,3,1,8,0xb2d14df4d
10198.32,2.0,10,2,3,3,8,0xb2d95d0cd
146578.69,1.0,0,3,2,4,9,0xb2d063c8d
3431.62,1.0,6,2,2,3,7,0xb2d1e693d
411013.79,3.0,63,4,4,2,10,0xb2d6579b
182247.41,5.0,0,3,4,4,11,0x3b9af124
1511355.06,1.0,0,4,2,4,10,0xb2d441c5d
1.04,1.0,41,1,2,2,5,0xb2d5867d
212.49,3.0,13,1,4,3,8,0xb2d06f66d
2517000.0,17.0,1,4,4,4,12,0xb2d1c422d
107654.39,3.0,116,3,4,1,8,0xb2d1ae02d
1200060.96,6.0,1,4,4,4,12,0xb2d68482d
172066.16,3.0,67,3,4,1,8,0xb2d68420
1644.99,1.0,92,1,2,1,4,0x3b9b0f34d
267868.9,7.0,87,3,4,1,8,0xb2d23a6cd
120006.35,4.0,41,3,4,2,9,0xb2d075ead
251022.24,2.0,10,3,3,3,9,0xb2d6d4e9d
5004486.59,3.0,29,4,4,2,10,0x3b9b2d46d
3.64,1.0,28,1,2,2,5,0xb2d69223d
100810.81,4.0,27,3,4,2,9,0xb2d2a97fd
290111.06,4.0,3,3,4,4,11,0xb2d5b6c4
11286.79,1.0,11,2,2,3,7,0xb2d2d3cdd
181442.43,5.0,6,3,4,3,10,0xb2d4a3d1d
1617.2,1.0,1,1,2,4,7,0xb2d6cf25d
100019.83,2.0,40,3,3,2,8,0xb2d0d084
521280.95,6.0,3,4,4,4,12,0xb2d14c57d
799.41,1.0,31,1,2,2,5,0xb2d388eb
3241.37,1.0,0,2,2,4,8,0xb2d92c9b
896.13,1.0,2,1,2,4,7,0xb2d1a3bfd
18304.06,1.0,14,2,2,3,7,0xb2d6845cd
73197.3,1.0,15,3,2,3,8,0xb2d627b3
5000193.47,2.0,123,4,3,1,8,0xb2d407fed
4886.94,1.0,184,2,2,1,5,0xb2d16186
590024.92,2.0,98,4,3,1,8,0xb2d96a6ed
300000.0,2.0,5,3,3,3,9,0xb2d92230d
89265.57,3.0,11,3,4,3,10,0xb2d26463
180029.06,4.0,9,3,4,3,10,0xb2d68c32d
5219.01,2.0,66,2,3,2,7,0xb2d334ded
250006.22,3.0,11,3,4,3,10,0xb2d90143d
450000.66,2.0,5,4,3,3,10,0xb2d9d2d2
31222.46,1.0,211,2,2,1,5,0xb2d56e53d
102370.52,3.0,0,3,4,4,11,0xb2d6a536
7.08,1.0,5,1,2,3,6,0xb2d609a3
200006.07,5.0,18,3,4,2,9,0xb2d92a65
148443.47,2.0,42,3,3,2,8,0xb2d576bbd
10707.13,1.0,92,2,2,1,5,0xb2d396ead
21688.03,1.0,131,2,2,1,5,0xb2d35b51d
100001.66,2.0,59,3,3,2,8,0xb2d17f23d
4940.61,1.0,9,2,2,3,7,0xb2d9c636
341331.97,2.0,0,4,3,4,11,0xb2d17686d
102535.72,3.0,32,3,4,2,9,0xb2d4f040
500047.66,2.0,83,4,3,1,8,0xb2d0e38a
532582.21,4.0,25,4,4,2,10,0xb2d5c7afd
190008.03,2.0,98,3,3,1,7,0xb2d96bcfd
145.64,1.0,24,1,2,2,5,0xb2d9ffbb
1250201.3,2.0,53,4,3,2,9,0xb2d5e855d
1106.11,1.0,37,1,2,2,5,0xb2d11531
3745.61,2.0,184,2,3,1,6,0xb2d0a64ed
8783.83,1.0,0,2,2,4,8,0xb2d96384
4937.72,1.0,102,2,2,1,5,0xb2d2f765
224.92,1.0,8,1,2,3,6,0xb2d9214f
13895.91,1.0,0,2,2,4,8,0xb2d28405d
80001.82,4.0,45,3,4,2,9,0xb2d2ad90d
903369.82,5.0,14,4,4,3,11,0xb2d5ae6ed
6999.03,1.0,92,2,2,1,5,0xb2d3126cd
100010.56,2.0,25,3,3,2,8,0xb2d9ea27
1916.67,1.0,184,1,2,1,4,0xb2d2c465d
890179.55,5.0,22,4,4,2,10,0xb2d4b2e4d
150014.78,3.0,179,3,4,1,8,0xb2d5e754d
65000.0,2.0,34,3,3,2,8,0xb2d9ffde
8.59,1.0,13,1,2,3,6,0xb2d31ed8
4473.17,1.0,6,2,2,3,7,0xb2d6bd1e
402010.27,7.0,83,4,4,1,9,0x3b9b3126
3735.43,1.0,0,2,2,4,8,0xb2d6f226
3611.0,1.0,10,2,2,3,7,0xb2d5abdc
2.67,1.0,80,1,2,1,4,0xb2d4fc33
250004.35,4.0,18,3,4,2,9,0xb2d192b5
445254.55,5.0,1,4,4,4,12,0xb2d3f19ed
199145.95,3.0,21,3,4,2,9,0xb2d31150d
2000184.61,2.0,48,4,3,2,9,0xb2d121f2d
60000.63,2.0,55,3,3,2,8,0xb2d90391
397000.0,6.0,6,4,4,3,11,0xb2d1c6b6
2875.41,1.0,14,1,2,3,6,0xb2d79046d
50002.36,2.0,77,2,3,1,6,0xb2d10e58
7027.72,1.0,12,2,2,3,7,0xb2d58589d
76.26,2.0,4,1,3,4,8,0xb2d5377d
9862.49,1.0,3,2,2,4,8,0xb2d2540dd
1000000.36,3.0,0,4,4,4,12,0xb2d1b69cd
325276.87,3.0,62,4,4,2,10,0xb2d227dbd
1222.34,1.0,8,1,2,3,6,0xb2d91a6d
245081.03,3.0,3,3,4,4,11,0xb2d5eb36d
1010681.04,2.0,37,4,3,2,9,0xb2d15f06d
200024.46,4.0,11,3,4,3,10,0xb2d704d8
526001.43,4.0,81,4,4,1,9,0xb2d113b5
500331.43,2.0,1,4,3,4,11,0xb2d98017d
69.92,1.0,2,1,2,4,7,0xb2d62985d
848860.14,11.0,1,4,4,4,12,0xb2d5efd6d
85015.48,8.0,0,3,4,4,11,0xb2d5ddd6d
200022.59,3.0,32,3,4,2,9,0xb2d0c83c
255.18,1.0,1,1,2,4,7,0xb2d781b8d
1570000.69,7.0,14,4,4,3,11,0xb2d17ef1d
160042.22,2.0,13,3,3,3,9,0xb2d8f0e8d
200000.0,2.0,28,3,3,2,8,0xb2da0fc6
17744.33,1.0,0,2,2,4,8,0xb2d2b3a8d
1100750.16,2.0,16,4,3,2,9,0xb2d3f16ad
7254.07,1.0,21,2,2,2,6,0xb2d9ca53
1017.35,1.0,184,1,2,1,4,0xb2d232cdd
573521.12,4.0,1,4,4,4,12,0xb2d1bc14
210000.0,2.0,1,3,3,4,10,0xb2da685c
500000.0,2.0,5,4,3,3,10,0xb2d97629d
500113.83,2.0,92,4,3,1,8,0xb2d143dcd
2282.95,1.0,8,1,2,3,6,0xb2d2fd76d
22171.31,1.0,12,2,2,3,7,0xb2d8d387d
377018.57,3.0,11,4,4,3,11,0xb2d3cf0bd
1134.25,1.0,45,1,2,2,5,0xb2d2c8c0d
1350157.3,2.0,195,4,3,1,8,0xb2d69d62
614804.1,3.0,8,4,4,3,11,0xb2d123b1d
1420.44,1.0,184,1,2,1,4,0xb2d1b596d
51428.53,2.0,90,2,3,1,6,0xb2d5e150d
103765.27,1.0,92,3,2,1,6,0xb2d24688d
90125.56,3.0,47,3,4,2,9,0xb2d62902
1000000.0,13.0,0,4,4,4,12,0xb2d5d41cd
1210.78,1.0,54,1,2,2,5,0xb2d30fbbd
930436.03,6.0,60,4,4,2,10,0xb2d0dcd2d
44.53,1.0,15,1,2,3,6,0xb2d62f09
301065.63,2.0,32,4,3,2,9,0xb2da0612
38042.27,1.0,19,2,2,2,6,0xb2d6a835
1486.1,1.0,9,1,2,3,6,0xb2d2ce4e
12446.9,1.0,15,2,2,3,7,0xb2d44ca8
186001.59,7.0,18,3,4,2,9,0xb2d193fd
935002.68,10.0,95,4,4,1,9,0xb2d14d3c
50001.81,2.0,31,2,3,2,7,0xb2d2d42b
90019.74,4.0,20,3,4,2,9,0xb2d2b2e2d
460545.45,3.0,1,4,4,4,12,0xb2d0d823d
67162.1,7.0,0,3,4,4,11,0xb2d56f30d
125085.07,3.0,18,3,4,2,9,0xb2d51266d
660313.38,3.0,47,4,4,2,10,0xb2d56069d
60002.53,2.0,70,3,3,1,7,0xb2d9a33f
50697.38,3.0,0,2,4,4,10,0xb2d632b5d
100230.57,3.0,29,3,4,2,9,0xb2d77354d
2967134.6,20.0,18,4,4,2,10,0xb2d5c5bed
631093.98,5.0,1,4,4,4,12,0x3b9af1b0d
280000.58,2.0,20,3,3,2,8,0xb2d9d661
312.7,1.0,8,1,2,3,6,0xb2d263a9
111.34,1.0,25,1,2,2,5,0xb2d9383dd
5172.41,1.0,5,2,2,3,7,0xb2d69239d
277.48,1.0,25,1,2,2,5,0xb2d64cabd
497.52,1.0,17,1,2,2,5,0xb2d2a008d
500000.0,2.0,80,4,3,1,8,0xb2d8db18
21351.41,2.0,1,2,3,4,9,0xb2d41724d
12719.62,1.0,29,2,2,2,6,0xb2d92c13
141.54,1.0,12,1,2,3,6,0xb2d5b59dd
509104.66,2.0,166,4,3,1,8,0xb2d268bdd
30000001.0,3.0,92,4,4,1,9,0xb2d51b6a
1448.01,1.0,19,1,2,2,5,0xb2d68fe2
202132.37,2.0,91,3,3,1,7,0xb2d94374d
1735.2,1.0,92,1,2,1,4,0xb2d3a57ad
452677.37,1.0,1,4,2,4,10,0xb2d3b0abd
39.26,2.0,28,1,3,2,6,0xb2d9403d
10124.7,2.0,3,2,3,4,9,0xb2d9190bd
132.01,1.0,0,1,2,4,7,0xb2d57510
50739.2,4.0,10,2,4,3,9,0xb2d0fc4ad
80102.12,2.0,6,3,3,3,9,0xb2d99358
127484.99,2.0,108,3,3,1,7,0xb2d1242f
1350904.35,3.0,1,4,4,4,12,0xb2d12649d
893.32,11.0,184,1,4,1,6,0xb2d28de7d
2007.58,1.0,36,1,2,2,5,0xb2d4f166
3653.7,1.0,12,2,2,3,7,0xb2d112ecd
9498.16,1.0,14,2,2,3,7,0xb2d2e9aed
400031.76,4.0,19,4,4,2,10,0xb2d63bae
50093.68,2.0,35,2,3,2,7,0xb2d2cc32d
255659.62,4.0,25,3,4,2,9,0xb2d4170ed
10032.88,2.0,4,2,3,4,9,0xb2d60600d
270042.47,4.0,70,3,4,1,8,0xb2d13401d
150003.96,4.0,6,3,4,3,10,0xb2d58259d
60.41,1.0,1,1,2,4,7,0xb2d22ffe
400012.78,3.0,8,4,4,3,11,0xb2d52e4ed
27001.78,1.0,5,2,2,3,7,0xb2d553cad
106491.38,5.0,0,3,4,4,11,0xb2d2210c
56.12,1.0,17,1,2,2,5,0xb2d6c2b0d
227.28,1.0,0,1,2,4,7,0xb2d3ed92d
4542.11,3.0,20,2,4,2,8,0x3b9ae85ad
202846.3,2.0,146,3,3,1,7,0xb2d42381d
3.15,1.0,2,1,2,4,7,0xb2d910d4d
300038.37,3.0,21,3,4,2,9,0xb2d4b8a7d
775198.23,9.0,3,4,4,4,12,0xb2d4112fd
30001.32,2.0,14,2,3,3,8,0xb2da02fd
415546.14,6.0,0,4,4,4,12,0xb2d33592
500065.6,2.0,95,4,3,1,8,0xb2d64e6c
253030.03,3.0,13,3,4,3,10,0xb2d9527ad
6556.07,1.0,10,2,2,3,7,0xb2d539ba
1020960.32,81.0,15,4,4,3,11,0xb2d0a706
0.0,1.0,5,1,2,3,6,0xb2d5cc0e
1003592.68,2.0,12,4,3,3,10,0xb2d64cfc
105717.5,4.0,22,3,4,2,9,0xb2d62381d
102004.49,6.0,48,3,4,2,9,0xb2d93c1fd
72243.98,9.0,0,3,4,4,11,0x3b9b4591
11376.75,1.0,59,2,2,2,6,0xb2d2cc49d
199.21,1.0,47,1,2,2,5,0xb2d657d3
1389.8,1.0,102,1,2,1,4,0xb2d62498d
50000.53,2.0,92,2,3,1,6,0xb2d40494d
613.15,1.0,15,1,2,3,6,0x3b9b2791
558103.18,5.0,33,4,4,2,10,0xb2d659b6d
440584.42,5.0,1,4,4,4,12,0xb2d2bba0d
350060.99,7.0,53,4,4,2,10,0xb2d6b7b9d
200084.35,5.0,13,3,4,3,10,0xb2d39fb4d
300009.5,2.0,59,3,3,2,8,0xb2d8fba3d
16183.63,4.0,92,2,4,1,7,0xb2d1862ed
13537.43,1.0,7,2,2,3,7,0xb2d573f0d
2565.33,1.0,0,1,2,4,7,0xb2d621d6
252045.74,23.0,0,3,4,4,11,0x3b9b3985d
31116.32,1.0,42,2,2,2,6,0xb2d78565d
100106.43,2.0,185,3,3,1,7,0xb2d52af0d
480000.0,2.0,4,4,3,4,11,0xb2da63fe
400015.02,3.0,92,4,4,1,9,0xb2d1bfe1d
409000.0,4.0,1,4,4,4,12,0xb2da097b
543557.46,6.0,1,4,4,4,12,0xb2d35d52d
1494.43,1.0,0,1,2,4,7,0xb2d63ba7
410004.23,7.0,0,4,4,4,12,0xb2d23b6dd
1000044.77,3.0,0,4,4,4,12,0xb2d700e1d
67760.0,1.0,0,3,2,4,9,0xb2da4d36
2121.05,1.0,184,1,2,1,4,0xb2d40a5dd
30001.05,3.0,11,2,4,3,9,0xb2d61a2cd
100022.69,2.0,11,3,3,3,9,0xb2d98b63
70822.44,1.0,12,3,2,3,8,0xb2d0e47e
1527.04,1.0,92,1,2,1,4,0xb2d32bead
1000000.0,21.0,0,4,4,4,12,0xb2d1bd4d
54735.96,3.0,0,3,4,4,11,0xb2d6e7c0d
130.18,1.0,61,1,2,2,5,0xb2d37c8cd
454166.46,6.0,31,4,4,2,10,0xb2d23db4d
4330039.09,14.0,25,4,4,2,10,0xb2d0fa98d
20000.21,2.0,14,2,3,3,8,0xb2da3832
161632.41,3.0,27,3,4,2,9,0xb2d14c5ed
10122.45,2.0,55,2,3,2,7,0xb2d6d02fd
99978.5,1.0,184,3,2,1,6,0xb2d07e3fd
7705.52,1.0,24,2,2,2,6,0xb2d43526
160825.87,4.0,1,3,4,4,11,0xb2d547e2
4728.63,1.0,273,2,2,1,5,0xb2d67ce1d
50021.63,2.0,186,2,3,1,6,0xb2d58956d
2828.76,1.0,9,1,2,3,6,0xb2d4f256d
650748.29,4.0,34,4,4,2,10,0xb2d1cdb0
30000.0,1.0,3,2,2,4,8,0xb2da6578
3889.81,1.0,1,2,2,4,8,0xb2d951ae
29612.62,1.0,162,2,2,1,5,0xb2d0ced1
90004.75,2.0,56,3,3,2,8,0xb2d9c160
686.99,1.0,9,1,2,3,6,0xb2d6fffa
200044.08,2.0,63,3,3,2,8,0xb2d0b668d
23.73,1.0,58,1,2,2,5,0xb2d6d011
460731.27,6.0,6,4,4,3,11,0xb2d5f456d
700011.61,3.0,20,4,4,2,10,0xb2d9f3b5
12314.86,1.0,1,2,2,4,8,0xb2d31316
200020.49,2.0,6,3,3,3,9,0xb2d422a7d
70100.04,2.0,228,3,3,1,7,0xb2d63b10d
220743.76,3.0,32,3,4,2,9,0xb2d6ad61d
16964.92,1.0,11,2,2,3,7,0xb2d2e549
502672.74,3.0,92,4,4,1,9,0xb2d97802d
14769.85,1.0,0,2,2,4,8,0xb2d8d181d
45.87,1.0,58,1,2,2,5,0xb2d6b71d
50000.0,2.0,0,2,3,4,9,0xb2d28a95d
5433.77,1.0,3,2,2,4,8,0xb2d22ab7d
591887.48,2.0,182,4,3,1,8,0xb2d0b81ad
500015.83,3.0,67,4,4,1,9,0xb2d9ab6b
16287.04,1.0,184,2,2,1,5,0xb2d309a8d
2539.63,1.0,10,1,2,3,6,0xb2d4d3bbd
42240.98,1.0,20,2,2,2,6,0xb2d56d8a
0.49,1.0,1,1,2,4,7,0xb2d651b5
4441.69,3.0,0,2,4,4,10,0x3b9b46d0
2098.87,1.0,22,1,2,2,5,0xb2d1faf4d
1771.69,5.0,0,1,4,4,9,0x3b9b3e95d
100096.22,3.0,10,3,4,3,10,0xb2d1a9c2d
2595193.37,20.0,0,4,4,4,12,0xb2d5137ed
2.46,1.0,20,1,2,2,5,0xb2d6e2c7
60002.48,2.0,80,3,3,1,7,0xb2d416e0
160512.5,3.0,80,3,4,1,8,0xb2d0eb9dd
1011.84,1.0,175,1,2,1,4,0xb2d2f52c
2641.78,1.0,0,1,2,4,7,0xb2d25347d
6.19,1.0,46,1,2,2,5,0xb2d9803a
8452.16,4.0,28,2,4,2,8,0xb2d11ed9d
4489780.93,20.0,0,4,4,4,12,0xb2d09fded
5686.07,1.0,28,2,2,2,6,0xb2d6d30c
4.09,1.0,4,1,2,4,7,0xb2d63f9d
3807.75,1.0,16,2,2,2,6,0xb2d60f98
4646.8,1.0,4,2,2,4,8,0xb2d1dab0d
12004.22,5.0,0,2,4,4,10,0x3b9b2453d
641.5,1.0,27,1,2,2,5,0xb2d92735d
247771.82,3.0,0,3,4,4,11,0xb2d5abbed
385051.85,3.0,175,4,4,1,9,0xb2d263fc
1528.37,1.0,92,1,2,1,4,0xb2d0ec2bd
818024.24,4.0,14,4,4,3,11,0xb2d12b6ed
0.0,1.0,6,1,2,3,6,0xb2da4cc5
151316.88,3.0,34,3,4,2,9,0xb2d11808d
0.2,1.0,0,1,2,4,7,0xb2d64e60
160438.55,5.0,0,3,4,4,11,0xb2d6071cd
10128.77,1.0,3,2,2,4,8,0xb2d2da17
601288.19,9.0,0,4,4,4,12,0xb2d19828
701037.37,3.0,3,4,4,4,12,0xb2d69cc2d
313788.62,2.0,25,4,3,2,9,0xb2d10817d
1597.88,1.0,92,1,2,1,4,0xb2d3292ed
50025.33,2.0,76,2,3,1,6,0xb2d27e36d
182.12,2.0,92,1,3,1,5,0xb2d0d27fd
19538.99,1.0,0,2,2,4,8,0xb2d83d19
619525.06,1.0,8,4,2,3,9,0xb2d6a59ad
8163.81,1.0,70,2,2,1,5,0xb2d6b91ed
19379.76,2.0,0,2,3,4,9,0x3b9b35cfd
325053.85,3.0,105,4,4,1,9,0xb2d23a79d
7894.31,1.0,0,2,2,4,8,0xb2d2cee0
150000.75,3.0,4,3,4,4,11,0xb2d2079f
200002.0,2.0,4,3,3,4,10,0xb2d99074
1801.19,1.0,20,1,2,2,5,0xb2d6c882
601.0,3.0,0,1,4,4,9,0xb2d0b49ed
60030.35,3.0,167,3,4,1,8,0xb2d06f7bd
164360.41,3.0,10,3,4,3,10,0xb2d20024d
2738.79,2.0,208,1,3,1,5,0xb2d0ca40d
2088.98,1.0,9,1,2,3,6,0xb2d67fe6
25139.58,1.0,10,2,2,3,7,0xb2d6ec53
430785.3,3.0,5,4,4,3,11,0xb2d6abb2
5.86,1.0,76,1,2,1,4,0xb2d5ec10
447.88,1.0,0,1,2,4,7,0xb2d95a0e
463805.56,22.0,0,4,4,4,12,0x3b9af0c9
1000500.3,3.0,20,4,4,2,10,0xb2d60ea8
1270045.5,6.0,6,4,4,3,11,0xb2d13378d
1650.0,1.0,0,1,2,4,7,0xb2d94920
6257.38,1.0,10,2,2,3,7,0xb2d93a1f
358.09,1.0,2,1,2,4,7,0xb2d8db45
172799.68,3.0,104,3,4,1,8,0xb2d1d1edd
14571.35,1.0,15,2,2,3,7,0xb2d63159d
102311.36,2.0,0,3,3,4,10,0xb2d68971d
794.39,2.0,84,1,3,1,5,0xb2d277c0d
61498.28,1.0,20,3,2,2,7,0xb2d6a3a9d
103924.14,2.0,217,3,3,1,7,0xb2d41677d
360029.24,12.0,4,4,4,4,12,0xb2d3c3f9
715155.69,7.0,39,4,4,2,10,0xb2d5c4c2d
260000.0,2.0,21,3,3,2,8,0xb2d950bb
2000097.88,1.0,12,4,2,3,9,0xb2d62997
51063.01,2.0,6,2,3,3,8,0xb2d5fe57d
6787.78,1.0,14,2,2,3,7,0xb2d6bbe4d
20486.04,2.0,61,2,3,2,7,0xb2d54c48d
658014.82,12.0,3,4,4,4,12,0xb2d28d08
276990.53,2.0,0,3,3,4,10,0xb2d58e49d
1857.61,2.0,92,1,3,1,5,0x3b9b3fd9d
789455.88,3.0,0,4,4,4,12,0xb2d17ae2d
4644571.03,12.0,14,4,4,3,11,0xb2d2e1dad
2246.86,1.0,184,1,2,1,4,0xb2d35bc7d
24.37,2.0,21,1,3,2,6,0xb2d5f029
8.87,1.0,4,1,2,4,7,0xb2d7edba
2348.54,1.0,41,1,2,2,5,0xb2d9051fd
1903.98,1.0,105,1,2,1,4,0xb2d57fd3d
349.79,1.0,13,1,2,3,6,0xb2d4ae34
2161.85,1.0,92,1,2,1,4,0xb2d21197d
190989.73,2.0,8,3,3,3,9,0xb2d98431d
385493.0,9.0,0,4,4,4,12,0xb2d0da60d
136966.24,2.0,1,3,3,4,10,0xb2d8f9d1d
443.4,1.0,15,1,2,3,6,0xb2d2b49c
201421.16,2.0,77,3,3,1,7,0xb2d8dd99d
200000.0,2.0,12,3,3,3,9,0xb2d960eed
7013.73,1.0,10,2,2,3,7,0xb2d94e86d
383012.69,6.0,66,4,4,2,10,0xb2d10b63d
1629.34,1.0,8,1,2,3,6,0xb2d269b4d
21180.45,1.0,92,2,2,1,5,0xb2d2a69cd
370008.98,2.0,0,4,3,4,11,0xb2da2e8d
10642.75,1.0,0,2,2,4,8,0xb2d9e8f6
186000.06,2.0,14,3,3,3,9,0xb2d19800d
497016.02,3.0,55,4,4,2,10,0xb2d3633c
10137.61,1.0,92,2,2,1,5,0xb2d5e56ed
3162.42,1.0,10,2,2,3,7,0xb2da0721
430137.24,5.0,22,4,4,2,10,0xb2d0aa29d
64.5,1.0,40,1,2,2,5,0xb2d6d7ee
205784.85,2.0,41,3,3,2,8,0xb2d802dbd
4682.82,1.0,0,2,2,4,8,0xb2d944c6
231568.02,2.0,92,3,3,1,7,0xb2d1dc51d
33480.07,1.0,92,2,2,1,5,0xb2d10a79d
1088.86,1.0,1,1,2,4,7,0xb2d31ea8d
321093.35,2.0,4,4,3,4,11,0xb2d0b78c
6370.88,1.0,6,2,2,3,7,0xb2d1cbcad
904916.82,9.0,14,4,4,3,11,0x3b9af17dd
537750.13,8.0,11,4,4,3,11,0xb2d0d4bad
2695.05,1.0,1,1,2,4,7,0xb2d56807d
116.36,1.0,19,1,2,2,5,0xb2d20251
1588.92,1.0,0,1,2,4,7,0xb2d78c98d
2256.27,1.0,0,1,2,4,7,0xb2d88a72
6327.4,1.0,10,2,2,3,7,0xb2d27c43d
150000.0,3.0,5,3,4,3,10,0xb2d5bd7e
303961.21,2.0,0,4,3,4,11,0xb2d36073d
682.02,1.0,9,1,2,3,6,0xb2d4ad88
280000.0,5.0,4,3,4,4,11,0xb2d5bbd0
202928.02,2.0,32,3,3,2,8,0xb2d77155
15745.77,1.0,132,2,2,1,5,0xb2d316c1
1004131.12,3.0,0,4,4,4,12,0xb2d6fe2fd
200000.0,3.0,78,3,4,1,8,0xb2d217c3
190049.05,1.0,4,3,2,4,9,0xb2d34affd
1101.54,1.0,184,1,2,1,4,0xb2d13121d
150066.87,2.0,171,3,3,1,7,0xb2d24be8d
3.19,1.0,60,1,2,2,5,0xb2d24551d
6799.67,1.0,6,2,2,3,7,0xb2d75650d
842.59,1.0,2,1,2,4,7,0xb2d68a57
1115226.51,3.0,195,4,4,1,9,0xb2d24b9ed
2370.11,1.0,217,1,2,1,4,0xb2d1befed
82577.61,2.0,36,3,3,2,8,0xb2d6fdfc
20067.54,2.0,80,2,3,1,6,0xb2d5c86ed
82332.5,2.0,77,3,3,1,7,0xb2d65b7cd
3701.28,1.0,7,2,2,3,7,0xb2d1fd60d
753103.57,3.0,22,4,4,2,10,0xb2d1c4c1d
30098.0,2.0,3,2,3,4,9,0xb2d970e5d
1904.6,1.0,10,1,2,3,6,0x3b9b30c4
140010.33,4.0,13,3,4,3,10,0xb2d56bdcd
8448.33,1.0,53,2,2,2,6,0xb2d4286a
50025.39,2.0,6,2,3,3,8,0xb2d1b3d7d
55831.64,2.0,202,3,3,1,7,0x3b9b4704d
100005.22,3.0,44,3,4,2,9,0xb2d5ffc7d
100006.33,2.0,16,3,3,2,8,0xb2d95e52
6600185.96,2.0,0,4,3,4,11,0xb2d3bef7
811773.09,2.0,49,4,3,2,9,0xb2d07ac7d
1.58,1.0,54,1,2,2,5,0xb2d906e2d
25981456.39,34.0,8,4,4,3,11,0x3b9ae3ec
657.72,1.0,6,1,2,3,6,0xb2d6fa48d
81.13,1.0,21,1,2,2,5,0xb2d313b1d
1005000.0,2.0,1,4,3,4,11,0xb2d2b882d
36003.55,1.0,9,2,2,3,7,0xb2d3e46bd
407124.08,2.0,166,4,3,1,8,0xb2d6c99dd
10591.48,2.0,173,2,3,1,6,0xb2d4df15
70038.78,2.0,6,3,3,3,9,0xb2d58952d
0.64,1.0,33,1,2,2,5,0xb2d2244dd
3354.83,1.0,184,2,2,1,5,0xb2d13ffed
1787.44,2.0,184,1,3,1,5,0xb2d19269d
531292.88,2.0,73,4,3,1,8,0xb2d5543ed
1016.18,1.0,184,1,2,1,4,0xb2d0ed1cd
482259.44,9.0,1,4,4,4,12,0xb2d22145d
750000.0,7.0,0,4,4,4,12,0xb2d41065d
2040.88,1.0,14,1,2,3,6,0xb2d3193ad
170099.19,4.0,32,3,4,2,9,0xb2d62b5fd
200710.42,2.0,40,3,3,2,8,0xb2d9f3f8
1117135.43,6.0,6,4,4,3,11,0xb2d1ddbdd
420005.66,3.0,10,4,4,3,11,0xb2d1fc5b
50005.35,2.0,175,2,3,1,6,0xb2d61e9e
1253.08,1.0,92,1,2,1,4,0xb2d21456d
3151173.96,13.0,6,4,4,3,11,0xb2d0dcb7d
260057.14,4.0,70,3,4,1,8,0xb2d4a567d
153.06,1.0,67,1,2,1,4,0xb2d8e5b3
60601.13,2.0,0,3,3,4,10,0xb2d56165d
436960.99,6.0,0,4,4,4,12,0xb2d1fd0dd
4500122.46,4.0,25,4,4,2,10,0xb2d261b1d
37504.43,6.0,8,2,4,3,9,0xb2d12787d
215427.13,1.0,46,3,2,2,7,0xb2d5971ad
180028.79,3.0,3,3,4,4,11,0xb2d50cbfd
0.33,1.0,1,1,2,4,7,0xb2d4b89cd
2935875.1,16.0,0,4,4,4,12,0x3b9ae40ed
160873.66,1.0,0,3,2,4,9,0xb2d2c582d
254.68,1.0,11,1,2,3,6,0xb2d2caf4
2000045.7,4.0,15,4,4,3,11,0xb2d58e62
20000.42,2.0,200,2,3,1,6,0xb2d790be
5672.97,1.0,13,2,2,3,7,0xb2d31564d
50410.66,2.0,203,2,3,1,6,0xb2d6af72d
292.94,1.0,82,1,2,1,4,0xb2d47c6dd
420072.15,2.0,158,4,3,1,8,0xb2d60408d
200504.4,2.0,14,3,3,3,9,0xb2d5b71dd
253.95,1.0,19,1,2,2,5,0xb2d3b917
5330.48,1.0,3,2,2,4,8,0xb2d6c0c2d
2446.36,1.0,14,1,2,3,6,0xb2d6beb3d
2510054.96,7.0,83,4,4,1,9,0xb2d1b590d
10005.46,2.0,182,2,3,1,6,0xb2d88c6cd
168.44,1.0,4,1,2,4,7,0xb2d6ad4c
26000.27,2.0,35,2,3,2,7,0xb2d9fb17
500005.21,2.0,20,4,3,2,9,0xb2d6e2bed
180044.41,4.0,200,3,4,1,8,0xb2d1f7e6
210094.9,2.0,95,3,3,1,7,0xb2d14ffad
1273.86,1.0,97,1,2,1,4,0xb2d17589
3539.47,2.0,32,2,3,2,7,0x3b9b47c0d
3182.56,1.0,6,2,2,3,7,0xb2d56498d
260001.92,14.0,1,3,4,4,11,0xb2d54e66d
230059.61,2.0,6,3,3,3,9,0xb2d51699d
101.85,1.0,10,1,2,3,6,0xb2d9060b
70012.36,3.0,181,3,4,1,8,0xb2d10bf7d
810100.55,6.0,0,4,4,4,12,0xb2d0cb04d
4178.02,1.0,184,2,2,1,5,0xb2d2d9ded
5405.41,1.0,1,2,2,4,8,0xb2d27cda
17492.56,2.0,18,2,3,2,7,0xb2d657c9
60520.31,2.0,186,3,3,1,7,0xb2d43363d
200000.0,2.0,3,3,3,4,10,0xb2d9613ad
651705.13,5.0,63,4,4,2,10,0xb2d1a2cad
350760.45,4.0,12,4,4,3,11,0xb2d0c9fdd
226088.28,2.0,6,3,3,3,9,0xb2d58ec9d
40016.35,3.0,25,2,4,2,8,0xb2d13273d
500000.6,4.0,1,4,4,4,12,0xb2da1258
1003562.3,12.0,11,4,4,3,11,0xb2d35c52d
1008.23,1.0,184,1,2,1,4,0x3b9b43afd
140.09,1.0,4,1,2,4,7,0xb2d16a50d
3828.82,1.0,184,2,2,1,5,0xb2d49035d
41000.0,2.0,62,2,3,2,7,0xb2d5e0cfd
1049.44,1.0,92,1,2,1,4,0x3b9b2325d
400200.52,3.0,3,4,4,4,12,0xb2d3b1d6d
10.34,1.0,77,1,2,1,4,0xb2d95087
250102.15,2.0,26,3,3,2,8,0xb2d9cac9
462021.32,2.0,2,4,3,4,11,0xb2d55597d
50000.53,2.0,92,2,3,1,6,0xb2d9804ad
1412.37,1.0,92,1,2,1,4,0xb2d2d1bdd
40.88,1.0,14,1,2,3,6,0xb2d25301
504595.07,5.0,80,4,4,1,9,0xb2d0979e
0.0,1.0,4,1,2,4,7,0xb2da505e
247769.66,4.0,11,3,4,3,10,0xb2d7753cd
65553.79,1.0,3,3,2,4,9,0xb2d93bee
64368.11,2.0,3,3,3,4,10,0xb2d3eae4d
20278.15,1.0,19,2,2,2,6,0xb2d534a0d
270164.48,2.0,65,3,3,2,8,0xb2d8ededd
1647780.86,27.0,0,4,4,4,12,0xb2d3b239d
11554.88,1.0,184,2,2,1,5,0xb2d20954
7.83,1.0,62,1,2,2,5,0xb2d2ff20d
2604.02,1.0,0,1,2,4,7,0xb2d69004d
18382.52,1.0,18,2,2,2,6,0xb2d5cf29
180023.46,3.0,10,3,4,3,10,0xb2d11287d
216002.71,3.0,0,3,4,4,11,0xb2d28169d
444879.12,5.0,60,4,4,2,10,0xb2d10f80d
928.72,1.0,3,1,2,4,7,0xb2d8f21fd
4071.1,1.0,15,2,2,3,7,0xb2d9c3aa
130335.05,2.0,143,3,3,1,7,0xb2d3a1e3d
711.3,1.0,10,1,2,3,6,0xb2d4f7a6
246.58,1.0,117,1,2,1,4,0xb2d507e8d
1517581.99,24.0,3,4,4,4,12,0xb2d0e97ad
29.0,1.0,57,1,2,2,5,0xb2d96950
10.01,1.0,53,1,2,2,5,0xb2d9966d
18518.72,1.0,184,2,2,1,5,0xb2d316d4d
0.0,1.0,1,1,2,4,7,0xb2d26a0a
726000.0,3.0,0,4,4,4,12,0xb2d97078
2489.83,1.0,8,1,2,3,6,0xb2d452f1d
1079634.92,8.0,18,4,4,2,10,0xb2d69cf0d
0.0,2.0,20,1,3,2,6,0xb2d9526e
5615.14,1.0,173,2,2,1,5,0xb2d5f05fd
1465707.64,4.0,0,4,4,4,12,0xb2d6cebdd
540009.6,6.0,22,4,4,2,10,0xb2d085f3d
905.96,1.0,0,1,2,4,7,0xb2d904bfd
671324.44,5.0,32,4,4,2,10,0xb2d5e9dbd
1353.63,1.0,184,1,2,1,4,0xb2d2655ed
220000.42,4.0,6,3,4,3,10,0xb2da39bc
8144.71,1.0,15,2,2,3,7,0xb2d6b99fd
251665.2,3.0,3,3,4,4,11,0xb2d4e650
50000.0,1.0,6,2,2,3,7,0xb2d9d645
30896.17,1.0,0,2,2,4,8,0xb2d4fb2f
300048.67,3.0,157,3,4,1,8,0xb2d0780f
9726.3,1.0,18,2,2,2,6,0xb2d717c6
357373.16,4.0,133,4,4,1,9,0xb2d8a04bd
303002.72,5.0,1,4,4,4,12,0xb2d3ae56
43443.29,1.0,9,2,2,3,7,0xb2d4fcce
1210.05,1.0,92,1,2,1,4,0xb2d17808d
125328.59,2.0,60,3,3,2,8,0xb2d5a7df
250041.71,3.0,15,3,4,3,10,0xb2d8f69ed
25001.2,3.0,53,2,4,2,8,0xb2d62140d
501778.83,3.0,23,4,4,2,10,0xb2d56071d
340022.55,4.0,98,4,4,1,9,0xb2d3e78dd
0.39,1.0,2,1,2,4,7,0xb2d6f293d
234.16,1.0,4,1,2,4,7,0xb2d394c9d
1200002.32,6.0,3,4,4,4,12,0xb2d15459d
7212.91,2.0,10,2,3,3,8,0xb2d3edcc
221.96,1.0,84,1,2,1,4,0xb2d32751d
505000.61,2.0,13,4,3,3,10,0xb2d1632c
5745372.75,3.0,3,4,4,4,12,0x3b9b455dd
300000.0,2.0,22,3,3,2,8,0xb2da224f
558.13,1.0,56,1,2,2,5,0xb2d8d4efd
12909.53,1.0,19,2,2,2,6,0xb2d38cadd
1313.32,1.0,10,1,2,3,6,0xb2d2f7b1
2545300.87,17.0,0,4,4,4,12,0xb2d1b750d
0.0,1.0,1,1,2,4,7,0xb2d62f21d
776.02,1.0,10,1,2,3,6,0xb2d717ad
746.16,1.0,77,1,2,1,4,0xb2d209b8
6.22,1.0,34,1,2,2,5,0xb2d68bcbd
200882.34,2.0,1,3,3,4,10,0xb2d6b622d
153547.49,2.0,0,3,3,4,10,0xb2d144ab
57285.93,1.0,60,3,2,2,7,0xb2d21831d
81009.29,2.0,104,3,3,1,7,0xb2d68397d
31692.92,2.0,184,2,3,1,6,0xb2d23bde
720061.48,10.0,40,4,4,2,10,0xb2d48060d
70588.46,7.0,0,3,4,4,11,0xb2d6a9eed
1120.97,1.0,92,1,2,1,4,0xb2d20f37d
990094.94,6.0,63,4,4,2,10,0xb2d440ebd
3838.83,1.0,10,2,2,3,7,0xb2d57b61
512821.19,4.0,48,4,4,2,10,0xb2d6188bd
50002.64,2.0,69,2,3,1,6,0xb2d99f94
224720.65,4.0,27,3,4,2,9,0xb2d09ad2d
50417.35,2.0,69,2,3,1,6,0xb2d59cd8d
0.0,1.0,2,1,2,4,7,0xb2d363ab
73000.0,3.0,46,3,4,2,9,0xb2d23db0
25118.77,1.0,0,2,2,4,8,0xb2d34448d
65000.0,1.0,8,3,2,3,8,0xb2d4fea1d
12903.12,1.0,11,2,2,3,7,0xb2d959c3d
1723.09,1.0,184,1,2,1,4,0xb2d2be4ed
784.39,1.0,0,1,2,4,7,0xb2d250dcd
450009.5,3.0,42,4,4,2,10,0xb2d9d2be
213571.05,2.0,1,3,3,4,10,0xb2d1b1c4d
210045.38,4.0,45,3,4,2,9,0xb2d50922d
300162.39,3.0,121,4,4,1,9,0xb2d6d8d5
500000.0,2.0,7,4,3,3,10,0xb2d96e59
2308.92,1.0,184,1,2,1,4,0xb2d1b906d
22.36,1.0,87,1,2,1,4,0xb2d58b40
81063.53,1.0,92,3,2,1,6,0xb2d198f7d
864.04,1.0,28,1,2,2,5,0xb2d58215
200003.17,3.0,4,3,4,4,11,0xb2da28f5
574792.35,3.0,23,4,4,2,10,0xb2d562bb
30100.05,1.0,3,2,2,4,8,0xb2d99260
24.38,1.0,7,1,2,3,6,0xb2d2b615d
63559.2,1.0,38,3,2,2,7,0xb2d1dcfad
1276.89,1.0,92,1,2,1,4,0xb2d2cddbd
20129.43,1.0,0,2,2,4,8,0xb2d8d2b1
60001.27,2.0,80,3,3,1,7,0xb2d8c51a
545.01,1.0,2,1,2,4,7,0xb2d3ce44d
823600.45,9.0,14,4,4,3,11,0xb2d22a69d
993412.25,4.0,0,4,4,4,12,0xb2da5bf0
32685.17,1.0,0,2,2,4,8,0xb2d6b482d
213.72,1.0,10,1,2,3,6,0xb2d2ece3
1889236.58,4.0,34,4,4,2,10,0xb2d22f27d
1950097.04,4.0,6,4,4,3,11,0xb2d5b7b6d
38.95,1.0,44,1,2,2,5,0xb2d967a4
343050.54,1.0,9,4,2,3,9,0xb2d2b362d
598.74,1.0,0,1,2,4,7,0xb2d97200d
143020.43,3.0,7,3,4,3,10,0xb2d50f44d
50000.53,2.0,34,2,3,2,7,0xb2d933f7d
47190.08,1.0,0,2,2,4,8,0xb2d286afd
20000.42,2.0,74,2,3,1,6,0xb2d99e02
222626.24,4.0,0,3,4,4,11,0xb2d29fa9d
1300573.55,5.0,6,4,4,3,11,0xb2d50619d
50285.77,2.0,24,2,3,2,7,0xb2d9f2d6
114925.49,4.0,104,3,4,1,8,0xb2d43402d
1084.81,1.0,161,1,2,1,4,0xb2d520b7
3.77,1.0,79,1,2,1,4,0xb2d576df
40022.41,3.0,1,2,4,4,10,0xb2d19a36d
5413.41,1.0,92,2,2,1,5,0xb2d1a5ded
20146.33,2.0,34,2,3,2,7,0x3b9b13f4d
143156.63,1.0,11,3,2,3,8,0xb2d3bf9cd
35066.68,2.0,21,2,3,2,7,0xb2d56b87d
200025.92,2.0,8,3,3,3,9,0xb2d70185d
13460.34,2.0,83,2,3,1,6,0xb2d5f828d
67558.55,4.0,0,3,4,4,11,0xb2d6c7ead
27161.67,1.0,37,2,2,2,6,0xb2d18c01
202235.2,2.0,42,3,3,2,8,0xb2d6d39c
106.28,1.0,2,1,2,4,7,0xb2d2da20
4348.51,1.0,231,2,2,1,5,0xb2d33530d
241014.86,6.0,62,3,4,2,9,0xb2d60dc8d
2741.04,1.0,44,1,2,2,5,0xb2d8dc60
0.42,1.0,25,1,2,2,5,0xb2d94490
1315.67,1.0,184,1,2,1,4,0xb2d19404d
500063.43,3.0,5,4,4,3,11,0xb2d933a6
1920.18,4.0,184,1,4,1,6,0xb2d22f72d
201431.46,2.0,64,3,3,2,8,0xb2d97a79d
100000.0,1.0,1,3,2,4,9,0xb2d5c0df
228938.82,4.0,77,3,4,1,8,0xb2d0fcdfd
200097.16,2.0,14,3,3,3,9,0xb2d138c9
6025.49,1.0,250,2,2,1,5,0xb2d5d9bed
3886.21,1.0,92,2,2,1,5,0xb2d0e27dd
157177.32,9.0,0,3,4,4,11,0xb2d5dbd6d
68.55,2.0,57,1,3,2,6,0xb2d58bb2d
13.19,1.0,56,1,2,2,5,0xb2d6908cd
1340861.22,2.0,125,4,3,1,8,0xb2d65309d
0.0,1.0,1,1,2,4,7,0xb2d0e547d
0.43,1.0,40,1,2,2,5,0xb2d992e1
275149.16,3.0,52,3,4,2,9,0xb2d560ccd
5707.36,1.0,0,2,2,4,8,0xb2d6ab1e
7822.16,1.0,184,2,2,1,5,0xb2d0c087
89.07,1.0,0,1,2,4,7,0xb2d7d30ad
70003.07,2.0,39,3,3,2,8,0xb2d568b1d
246740.86,2.0,74,3,3,1,7,0xb2d9a4a4
5000.84,1.0,11,2,2,3,7,0xb2d9a699
110000.0,1.0,0,3,2,4,9,0xb2d8f641d
110431.91,3.0,80,3,4,1,8,0xb2d10d5ed
721686.9,13.0,3,4,4,4,12,0xb2d0da1b
334534.9,5.0,0,4,4,4,12,0xb2d1b01cd
6700.42,1.0,184,2,2,1,5,0xb2d2b458d
81236.97,2.0,4,3,3,4,10,0xb2d0c505
10292.23,2.0,95,2,3,1,6,0xb2d64bd8d
9535.57,1.0,8,2,2,3,7,0xb2d0c036d
53258.19,2.0,189,3,3,1,7,0xb2d4256f
350074.39,7.0,6,4,4,3,11,0xb2d5e8fcd
86.94,1.0,23,1,2,2,5,0xb2d94bd3d
300048.72,3.0,249,3,4,1,8,0xb2d0780fd
1512.01,1.0,0,1,2,4,7,0xb2d965f6
7084.98,1.0,5,2,2,3,7,0xb2d6b01fd
143.79,1.0,9,1,2,3,6,0xb2d8cb7b
117.46,1.0,32,1,2,2,5,0xb2d3cbf6
280.68,1.0,0,1,2,4,7,0xb2d505ffd
330196.99,5.0,3,4,4,4,12,0xb2d65054
814142.44,3.0,112,4,4,1,9,0xb2d35432d
202333.28,2.0,31,3,3,2,8,0xb2d8db5ed
4845.19,1.0,33,2,2,2,6,0xb2d59df5
2996.64,1.0,0,2,2,4,8,0xb2d6d457
1278.32,1.0,184,1,2,1,4,0xb2d25599d
600200.61,1.0,0,4,2,4,10,0xb2d9dbcd
162876.41,21.0,6,3,4,3,10,0xb2d09fe3d
0.0,1.0,4,1,2,4,7,0xb2d6286bd
200093.94,2.0,12,3,3,3,9,0xb2d6a1edd
1332.34,1.0,0,1,2,4,7,0xb2d968ee
55909.67,2.0,228,3,3,1,7,0xb2d21e98d
11.22,1.0,10,1,2,3,6,0xb2d10674
563651.86,3.0,27,4,4,2,10,0xb2d62db9
30434.3,1.0,27,2,2,2,6,0xb2d5d3e9d
380203.21,2.0,18,4,3,2,9,0xb2d8db9a
1362.77,1.0,30,1,2,2,5,0xb2d3cbe6d
3590.24,1.0,273,2,2,1,5,0xb2d5cf76d
4362.11,1.0,0,2,2,4,8,0xb2d3ac35d
60000.0,2.0,0,3,3,4,10,0xb2d92141
140000.0,3.0,1,3,4,4,11,0xb2d135aa
113761.72,3.0,158,3,4,1,8,0xb2d0887ad
202131.99,2.0,103,3,3,1,7,0xb2d7ec20
1.73,1.0,37,1,2,2,5,0xb2d36aca
15917.14,5.0,54,2,4,2,8,0xb2d082f6
270246.02,2.0,175,3,3,1,7,0xb2d1043dd
4423.86,1.0,184,2,2,1,5,0xb2d1673dd
20584.95,2.0,83,2,3,1,6,0xb2d623e3d
240713.85,3.0,21,3,4,2,9,0xb2d5931ad
39.85,1.0,28,1,2,2,5,0xb2d6c626
520016.54,4.0,6,4,4,3,11,0xb2d4ea2dd
5979.26,1.0,1,2,2,4,8,0xb2d6b71dd
262755.08,2.0,26,3,3,2,8,0xb2d56fafd
1176242.67,10.0,53,4,4,2,10,0xb2d0f29dd
20000.0,1.0,3,2,2,4,8,0xb2d927b8d
51894.99,2.0,59,2,3,2,7,0xb2d2a7f0d
23138.26,1.0,11,2,2,3,7,0xb2d951d1
150006.33,2.0,56,3,3,2,8,0xb2d9c3c9
113002.16,2.0,0,3,3,4,10,0xb2d645bad
390.84,1.0,5,1,2,3,6,0xb2d95783
87.47,1.0,131,1,2,1,4,0xb2d6f02bd
791579.01,6.0,0,4,4,4,12,0xb2d93205d
90064.52,2.0,20,3,3,2,8,0xb2d11eefd
1120060.77,5.0,56,4,4,2,10,0xb2d56812d
200031.28,2.0,7,3,3,3,9,0xb2d97092d
271.25,1.0,9,1,2,3,6,0xb2d2ea79
3665.58,1.0,5,2,2,3,7,0xb2d5f0c5
21312.55,1.0,2,2,2,4,8,0xb2d31199d
5844.87,1.0,92,2,2,1,5,0xb2d2e783d
201465.52,2.0,16,3,3,2,8,0xb2d5eec0d
31686.4,2.0,2,2,3,4,9,0xb2d34e58d
8818.52,1.0,10,2,2,3,7,0xb2d82238d
28909.34,1.0,1,2,2,4,8,0xb2d24d88
37052.95,1.0,9,2,2,3,7,0xb2d99168
4597.21,1.0,0,2,2,4,8,0xb2d3159fd
210102.76,2.0,5,3,3,3,9,0xb2d6c2f8d
1444.85,1.0,78,1,2,1,4,0xb2d97a09
339912.54,5.0,0,4,4,4,12,0xb2d3a69ed
2900069.61,9.0,13,4,4,3,11,0xb2d1b138
213116.69,2.0,55,3,3,2,8,0xb2d3ba9fd
4427.27,1.0,184,2,2,1,5,0x3b9b393ad
8783.64,1.0,184,2,2,1,5,0xb2d3ca6dd
719080.0,6.0,3,4,4,4,12,0xb2d5b071d
50170.65,9.0,22,2,4,2,8,0xb2d1524ed
2000208.89,3.0,13,4,4,3,11,0xb2d98fed
5530.53,2.0,92,2,3,1,6,0xb2d2dab4d
20775.17,2.0,139,2,3,1,6,0xb2d526c9d
1014.92,1.0,92,1,2,1,4,0xb2d60fc4d
3105.34,1.0,1,2,2,4,8,0xb2d3ab67
500001.1,3.0,1,4,4,4,12,0xb2d8ef9d
7166.61,1.0,0,2,2,4,8,0xb2d564fad
1003.27,1.0,153,1,2,1,4,0xb2d85d4c
1613753.41,18.0,1,4,4,4,12,0xb2d58250d
442843.26,3.0,46,4,4,2,10,0xb2d99354
82997.76,1.0,103,3,2,1,6,0xb2d1dbf5d
2565.5,1.0,1,1,2,4,7,0xb2d6e815
166744.81,3.0,0,3,4,4,11,0xb2d16a27d
2.45,1.0,39,1,2,2,5,0xb2d63f31
379890.09,9.0,7,4,4,3,11,0xb2d6cbad
301065.63,2.0,36,4,3,2,9,0xb2d9f8e7
397912.06,6.0,0,4,4,4,12,0xb2d0e657d
10033.42,1.0,92,2,2,1,5,0xb2d5de7ad
11.59,1.0,5,1,2,3,6,0xb2d2a6f2
708.65,2.0,0,1,3,4,8,0x3b9b0e2b
461000.0,7.0,8,4,4,3,11,0xb2d1bca6
2018.95,1.0,10,1,2,3,6,0xb2d53505
202074.13,4.0,87,3,4,1,8,0xb2d2ba34d
60173.18,7.0,0,3,4,4,11,0xb2d0874e
100000.0,3.0,4,3,4,4,11,0xb2d24fd1
4.97,1.0,41,1,2,2,5,0xb2d42ae5d
508930.51,3.0,27,4,4,2,10,0xb2d5d69ed
7059.87,1.0,92,2,2,1,5,0xb2d38b55
696.7,1.0,9,1,2,3,6,0xb2d27c46
2720000.0,5.0,1,4,4,4,12,0xb2d58ca9d
111.05,5.0,0,1,4,4,9,0xb2d20be4d
204135.85,3.0,5,3,4,3,10,0xb2d294a6d
1236.11,1.0,0,1,2,4,7,0xb2d37c5f
2979.59,1.0,4,2,2,4,8,0xb2d40ad0d
27.13,1.0,4,1,2,4,7,0xb2d9340f
97.11,1.0,0,1,2,4,7,0xb2d13762
330.87,1.0,231,1,2,1,4,0xb2d5e0bfd
500000.0,2.0,5,4,3,3,10,0xb2da5ecf
1350182.74,1.0,6,4,2,3,9,0xb2d412c0d
420125.65,2.0,32,4,3,2,9,0xb2d258f5d
307.46,1.0,10,1,2,3,6,0xb2d58465
801008.26,6.0,19,4,4,2,10,0xb2d62050d
623205.3,2.0,0,4,3,4,11,0xb2d54fbad
1010660.21,2.0,106,4,3,1,8,0xb2d95e64d
63.37,1.0,4,1,2,4,7,0xb2d6efbf
154503.51,3.0,31,3,4,2,9,0xb2d5f8f1d
667.44,1.0,19,1,2,2,5,0xb2d31a46d
4045814.61,5.0,0,4,4,4,12,0xb2d39b36d
4731.9,2.0,102,2,3,1,6,0xb2d42c47
302133.66,3.0,27,4,4,2,10,0xb2d56f5f
84033.61,3.0,245,3,4,1,8,0xb2d08750d
473.57,1.0,1,1,2,4,7,0xb2d40b84d
790.02,1.0,10,1,2,3,6,0xb2d8fefe
286674.79,2.0,0,3,3,4,10,0xb2d4162ad
630477.84,8.0,3,4,4,4,12,0xb2d10580d
24.26,1.0,293,1,2,1,4,0xb2d3a63ed
160022.9,5.0,38,3,4,2,9,0xb2d0de29d
820023.64,4.0,28,4,4,2,10,0xb2d78521d
196565.25,1.0,10,3,2,3,8,0xb2d6c6ba
25211.91,1.0,0,2,2,4,8,0xb2d2ac90d
616911.23,2.0,41,4,3,2,9,0xb2d6a383d
11168.78,1.0,13,2,2,3,7,0xb2d2ac66d
32900.0,1.0,3,2,2,4,8,0xb2da6560
1442.22,1.0,14,1,2,3,6,0xb2d2c241d
50002.95,4.0,62,2,4,2,8,0xb2d944fbd
14631.12,1.0,9,2,2,3,7,0xb2d2a0eed
102885.0,1.0,92,3,2,1,6,0xb2d0cc5ed
0.0,2.0,56,1,3,2,6,0xb2d35b55
598.13,1.0,5,1,2,3,6,0xb2d2db2a
18.47,1.0,49,1,2,2,5,0xb2d9047b
2455.15,1.0,9,1,2,3,6,0xb2d8d9a2d
10027.87,2.0,63,2,3,2,7,0xb2d5c351d
50000.0,1.0,0,2,2,4,8,0xb2d97f7ed
1353.78,1.0,92,1,2,1,4,0xb2d379ccd
1681.95,1.0,104,1,2,1,4,0xb2d24107
1758.16,1.0,1,1,2,4,7,0xb2d5d597
1934.95,1.0,9,1,2,3,6,0xb2d57ceed
109983.46,3.0,137,3,4,1,8,0xb2d235ffd
1020.33,1.0,10,1,2,3,6,0xb2d6b0eb
30976.78,1.0,8,2,2,3,7,0xb2d62545d
628421.01,3.0,3,4,4,4,12,0xb2d5aa85d
102370.52,1.0,0,3,2,4,9,0xb2d54f38d
150006.33,2.0,98,3,3,1,7,0xb2d94261d
50001.59,2.0,35,2,3,2,7,0xb2d11d6f
104283.35,1.0,0,3,2,4,9,0xb2d78740d
112272.9,2.0,237,3,3,1,7,0xb2d46589d
390142.45,5.0,77,4,4,1,9,0xb2d19ef3d
81.73,1.0,3,1,2,4,7,0xb2d5b453
144722.95,2.0,4,3,3,4,10,0xb2d2121bd
5215.12,1.0,92,2,2,1,5,0xb2d12199d
61313.99,1.0,78,3,2,1,6,0xb2d6c0c4d
9933.87,1.0,51,2,2,2,6,0xb2d68d6d
604941.99,4.0,0,4,4,4,12,0xb2d0d486d
36668.77,1.0,5,2,2,3,7,0xb2d67ec0d
80058.38,2.0,188,3,3,1,7,0xb2d645e3d
2000100.0,6.0,11,4,4,3,11,0xb2da4180
200000.2,3.0,1,3,4,4,11,0xb2d5d3edd
40535.38,2.0,92,2,3,1,6,0xb2d69a7ad
8144.92,1.0,184,2,2,1,5,0xb2d5a8a3d
610.56,1.0,10,1,2,3,6,0xb2d4b51fd
370245.5,2.0,49,4,3,2,9,0xb2d8deabd
130.03,1.0,2,1,2,4,7,0xb2d5b5ac
1100000.0,13.0,0,4,4,4,12,0xb2d105a2d
20100.63,2.0,0,2,3,4,9,0xb2d99906
4596.7,1.0,184,2,2,1,5,0xb2d33075d
148.03,1.0,82,1,2,1,4,0xb2d4104ad
10059.71,1.0,76,2,2,1,5,0xb2d0aca9d
50007.2,2.0,53,2,3,2,7,0xb2d6a303
43.87,1.0,81,1,2,1,4,0xb2d11e4e
204.9,1.0,9,1,2,3,6,0xb2d3b462
5.05,1.0,76,1,2,1,4,0xb2d51fbf
65952.09,2.0,161,3,3,1,7,0xb2d1192d
26494.85,2.0,0,2,3,4,9,0xb2d2f8a5d
464006.93,3.0,24,4,4,2,10,0xb2d5ff65d
6200.89,1.0,9,2,2,3,7,0xb2d2280ad
1680090.87,9.0,3,4,4,4,12,0xb2d45068d
167240.6,1.0,2,3,2,4,9,0xb2d924bf
105957.71,3.0,67,3,4,1,8,0xb2d4957bd
500000.16,2.0,6,4,3,3,10,0xb2d71a2ad
58789.05,1.0,18,3,2,2,7,0xb2d5d609d
25.33,1.0,31,1,2,2,5,0xb2d34526
40020.06,3.0,11,2,4,3,9,0xb2d5d3a3d
5414.56,1.0,184,2,2,1,5,0xb2d11bf5d
2347.75,2.0,0,1,3,4,8,0xb2d0bf01d
63758.41,1.0,184,3,2,1,6,0x3b9b26e7d
320273.64,4.0,3,4,4,4,12,0xb2d11560
806785.57,14.0,0,4,4,4,12,0xb2d083e7d
290000.0,2.0,6,3,3,3,9,0xb2d96cc6d
140002.51,3.0,21,3,4,2,9,0xb2d6e689d
30240.61,1.0,1,2,2,4,8,0xb2d5bfa5
3.22,1.0,10,1,2,3,6,0xb2d6c130d
400074.1,3.0,11,4,4,3,11,0xb2d40c7ad
72238.58,1.0,235,3,2,1,6,0xb2d36556d
1623.14,1.0,6,1,2,3,6,0xb2d5c9aad
7336.91,1.0,7,2,2,3,7,0xb2d2f8f7d
4751.54,1.0,1,2,2,4,8,0xb2d56b94d
370010.99,9.0,39,4,4,2,10,0xb2d8c93dd
100009.57,2.0,4,3,3,4,10,0xb2d18648
154627.62,3.0,47,3,4,2,9,0xb2d54b3cd
10820.46,1.0,12,2,2,3,7,0xb2d62e27
100005.28,2.0,76,3,3,1,7,0xb2d3c57b
2.62,1.0,9,1,2,3,6,0xb2d789d9
1480027.06,3.0,14,4,4,3,11,0xb2d6e255d
10.72,1.0,76,1,2,1,4,0xb2d696d5
4231.4,1.0,0,2,2,4,8,0xb2d6c2de
1106.82,1.0,184,1,2,1,4,0xb2d610b7d
8469.12,1.0,0,2,2,4,8,0xb2d1beb8d
81031.78,3.0,95,3,4,1,8,0xb2d4fbf7d
4288810.9,4.0,165,4,4,1,9,0xb2d27685d
200000.0,2.0,3,3,3,4,10,0xb2d97bd5d
1006.4,1.0,92,1,2,1,4,0xb2d3fb4fd
500197.56,3.0,1,4,4,4,12,0xb2d9822cd
8922.65,1.0,3,2,2,4,8,0xb2d2c287d
778.24,1.0,0,1,2,4,7,0xb2d91bc3d
5.84,1.0,4,1,2,4,7,0xb2d5518fd
55217.8,2.0,0,3,3,4,10,0xb2d49167d
5192.69,1.0,0,2,2,4,8,0xb2d42126
604127.33,7.0,1,4,4,4,12,0xb2d415d7
100001.06,2.0,105,3,3,1,7,0xb2d95ceed
655000.0,10.0,0,4,4,4,12,0xb2d1c6cc
62019.71,3.0,0,3,4,4,11,0xb2d63b65
269248.98,3.0,135,3,4,1,8,0xb2d678fd
310801.36,2.0,77,4,3,1,8,0xb2d132b8d
1026602.7,1.0,12,4,2,3,9,0xb2d55387d
401294.15,3.0,4,4,4,4,12,0xb2d9e4b8
441220.89,6.0,0,4,4,4,12,0x3b9b3836d
94077.52,2.0,23,3,3,2,8,0xb2d1794ed
3380082.91,32.0,0,4,4,4,12,0xb2d22a7fd
83939.93,3.0,143,3,4,1,8,0x3b9b25b4d
486416.74,8.0,0,4,4,4,12,0xb2d20681d
50002.64,3.0,235,2,4,1,7,0xb2d16f59
107.78,1.0,24,1,2,2,5,0xb2d98fca
0.0,1.0,6,1,2,3,6,0xb2d910e2d
138611.61,2.0,69,3,3,1,7,0xb2d0d02fd
501794.09,2.0,40,4,3,2,9,0xb2d1bcce
100001.59,3.0,18,3,4,2,9,0xb2d90363
453322.02,3.0,6,4,4,3,11,0xb2d2302fd
30000.0,2.0,3,2,3,4,9,0xb2d8eca8
358530.58,5.0,143,4,4,1,9,0xb2d231c2
2453.96,1.0,0,1,2,4,7,0xb2d83947d
9082.55,3.0,161,2,4,1,7,0xb2d64ec7
4592.61,1.0,9,2,2,3,7,0xb2d4daee
1.0,2.0,18,1,3,2,6,0xb2d51b6ad
1752358.94,12.0,14,4,4,3,11,0xb2d4f1f8d
1982.15,1.0,1,1,2,4,7,0xb2d918ddd
500021.11,2.0,55,4,3,2,9,0xb2d90273d
2066.69,1.0,3,1,2,4,7,0xb2d24bd1d
306015.1,2.0,90,4,3,1,8,0xb2d3052fd
13037.39,1.0,20,2,2,2,6,0xb2d56a3fd
62.63,1.0,2,1,2,4,7,0xb2d62718d
314561.21,8.0,0,4,4,4,12,0xb2d07d07
616.16,1.0,34,1,2,2,5,0xb2d6d476d
336738.54,3.0,56,4,4,2,10,0xb2d57b86d
30.03,1.0,9,1,2,3,6,0xb2d3955e
3370.24,1.0,0,2,2,4,8,0xb2d1f329
300006.33,2.0,38,3,3,2,8,0xb2d43141
440000.0,16.0,7,4,4,3,11,0xb2d5af1fd
0.0,1.0,4,1,2,4,7,0xb2d68c5c
153692.89,2.0,80,3,3,1,7,0xb2d610fcd
5903.1,1.0,4,2,2,4,8,0xb2d60a4fd
12084.36,1.0,6,2,2,3,7,0xb2d31872
50002.11,2.0,41,2,3,2,7,0xb2d91f9ad
3809.62,1.0,0,2,2,4,8,0xb2d805db
25009.67,1.0,30,2,2,2,6,0xb2d99c99
8886.63,1.0,9,2,2,3,7,0xb2d35d41
253612.04,4.0,0,3,4,4,11,0xb2d64ac4
1806.92,1.0,205,1,2,1,4,0xb2d3a4dcd
2417.92,1.0,92,1,2,1,4,0xb2d31308d
1500036.82,4.0,11,4,4,3,11,0xb2d69f38
2010.67,1.0,92,1,2,1,4,0xb2d62d45
501776.21,3.0,49,4,4,2,10,0xb2d9d7d2
2131.91,1.0,17,1,2,2,5,0xb2d2b291
102666.84,1.0,18,3,2,2,7,0xb2d5cee9
500076.04,2.0,9,4,3,3,10,0xb2d9835d
200063.03,2.0,26,3,3,2,8,0xb2d64201d
2543.06,1.0,10,1,2,3,6,0xb2d7bfbcd
500000.53,3.0,27,4,4,2,10,0xb2d86769
10000.21,2.0,67,2,3,1,6,0xb2d9ae67
2188.58,2.0,92,1,3,1,5,0xb2d0aba5d
690057.12,8.0,1,4,4,4,12,0x3b9af10dd
10419.48,1.0,106,2,2,1,5,0xb2d6be71d
160019.41,3.0,18,3,4,2,9,0xb2d3d171
11109.42,1.0,16,2,2,2,6,0xb2d35004d
1796.89,1.0,233,1,2,1,4,0xb2d29ae1d
20122.34,2.0,33,2,3,2,7,0xb2d6a4bbd
507000.0,7.0,7,4,4,3,11,0xb2d1c6b6d
818077.41,6.0,0,4,4,4,12,0xb2d240c2d
7773.99,2.0,3,2,3,4,9,0xb2d31a7cd
320091.51,5.0,23,4,4,2,10,0xb2d3833dd
50005.27,3.0,8,2,4,3,9,0xb2d07198
620733.94,4.0,0,4,4,4,12,0xb2d1c327d
4385.72,2.0,3,2,3,4,9,0xb2d16edfd
311011.1,3.0,8,4,4,3,11,0xb2d53f73d
93.9,1.0,1,1,2,4,7,0xb2d62835
2254218.5,11.0,13,4,4,3,11,0xb2d1c70cd
1.23,1.0,1,1,2,4,7,0xb2d66913
252152.38,2.0,14,3,3,3,9,0xb2d988b7
18242.35,1.0,18,2,2,2,6,0xb2d2ba37d
97.25,1.0,10,1,2,3,6,0xb2d942c0
7.25,1.0,0,1,2,4,7,0xb2d63155d
500000.82,2.0,5,4,3,3,10,0xb2d68209
51281.55,1.0,24,2,2,2,6,0xb2d61e5ad
591.1,1.0,26,1,2,2,5,0xb2d920a9d
1072.06,1.0,157,1,2,1,4,0xb2d199acd
2400.83,1.0,14,1,2,3,6,0xb2d8cd38d
13.72,1.0,167,1,2,1,4,0xb2d5c64a
2207774.74,4.0,0,4,4,4,12,0xb2d09d97
8441.12,1.0,41,2,2,2,6,0xb2d6b62b
62656.9,3.0,171,3,4,1,8,0xb2d2aacfd
49974.76,2.0,0,2,3,4,9,0xb2d9b849
15000.16,2.0,179,2,3,1,6,0xb2d8cb3bd
10000.16,2.0,118,2,3,1,6,0xb2d6fd3f
3968.66,1.0,10,2,2,3,7,0xb2d1f047
10210.62,1.0,92,2,2,1,5,0xb2d563c4d
350099.6,4.0,83,4,4,1,9,0xb2d6349dd
28.45,1.0,61,1,2,2,5,0xb2d6ca4a
570003.04,3.0,4,4,4,4,12,0xb2d8f43ad
4103.41,3.0,0,2,4,4,10,0x3b9b3e2e
20.79,1.0,42,1,2,2,5,0xb2d90e96
1123014.47,9.0,20,4,4,2,10,0xb2d1bb0ad
211014.18,2.0,259,3,3,1,7,0xb2d363c8d
14542.18,1.0,0,2,2,4,8,0xb2d6c158d
19022.63,1.0,92,2,2,1,5,0xb2d62407
0.05,1.0,1,1,2,4,7,0xb2d58036d
3.14,1.0,69,1,2,1,4,0xb2d23143
500082.8,3.0,221,4,4,1,9,0x3b9b25e8d
1500015.83,3.0,45,4,4,2,10,0xb2d219e3d
250000.0,2.0,3,3,3,4,10,0xb2d97b73d
5.5,1.0,116,1,2,1,4,0xb2d41001d
1850.07,2.0,9,1,3,3,7,0x3b9aed24d
50003.17,2.0,208,2,3,1,6,0xb2d76a7a
3064.78,2.0,92,2,3,1,6,0xb2d2c8c7d
10003.45,1.0,0,2,2,4,8,0xb2d8eb8ad
5.54,1.0,11,1,2,3,6,0xb2d6bfa3
3222.16,1.0,5,2,2,3,7,0xb2d3a66c
3029.05,1.0,9,2,2,3,7,0xb2d8d963
800008.45,3.0,130,4,4,1,9,0xb2d107f7d
3314.23,1.0,4,2,2,4,8,0xb2d6c246d
800019.55,6.0,67,4,4,1,9,0xb2d1b580d
111230.75,3.0,92,3,4,1,8,0xb2d15d22d
5632.56,5.0,0,2,4,4,10,0x3b9af232
500000.1,2.0,6,4,3,3,10,0xb2d8ef3ad
1550000.0,4.0,3,4,4,4,12,0xb2d23f7ad
4424.8,1.0,17,2,2,2,6,0xb2d90157d
480872.6,3.0,164,4,4,1,9,0xb2d10d6ed
515553.21,3.0,12,4,4,3,11,0xb2d305b6
41.54,1.0,8,1,2,3,6,0xb2d2bdcad
6.12,1.0,67,1,2,1,4,0xb2d8ef5dd
1466658.88,2.0,53,4,3,2,9,0xb2d337d2d
4004000.67,8.0,7,4,4,3,11,0xb2d0a652
180100.0,1.0,4,3,2,4,9,0xb2d96ad8d
22381.37,1.0,20,2,2,2,6,0xb2d60a7ed
218.46,1.0,69,1,2,1,4,0xb2d374f8
130035.01,5.0,40,3,4,2,9,0xb2d451ddd
1080028.9,3.0,25,4,4,2,10,0xb2d64428d
26844.02,1.0,0,2,2,4,8,0xb2d27c32d
68.87,1.0,6,1,2,3,6,0xb2d39b55
141.96,1.0,74,1,2,1,4,0xb2d57ae5
480013.11,10.0,11,4,4,3,11,0xb2d19424d
643.96,1.0,0,1,2,4,7,0xb2d2af76d
290013.32,2.0,228,3,3,1,7,0xb2d63791d
24667.42,1.0,5,2,2,3,7,0xb2d23d9fd
1040397.13,7.0,18,4,4,2,10,0xb2d16e1a
9.13,1.0,0,1,2,4,7,0xb2d1d105
117641.45,3.0,4,3,4,4,11,0xb2d323e6d
1838264.85,10.0,6,4,4,3,11,0x3b9b44cd
250031.11,3.0,92,3,4,1,8,0xb2d5ba34
20000.0,3.0,3,2,4,4,10,0xb2d60d3c
20255.04,1.0,167,2,2,1,5,0xb2d1ca9b
443364.41,11.0,0,4,4,4,12,0xb2d1a939d
250.81,4.0,0,1,4,4,9,0xb2d06815d
3810.15,1.0,47,2,2,2,6,0xb2d43df5
16.13,1.0,14,1,2,3,6,0xb2d2645ad
214792.67,2.0,25,3,3,2,8,0xb2d1f384d
1800000.53,6.0,4,4,4,4,12,0xb2da12d7
10894.0,2.0,25,2,3,2,7,0xb2d650e4
5000.0,1.0,24,2,2,2,6,0xb2d94ef4
242124.83,2.0,5,3,3,3,9,0xb2d335a5
21035.41,1.0,76,2,2,1,5,0xb2d312c1
319.82,1.0,131,1,2,1,4,0xb2d6457ed
1042656.9,4.0,30,4,4,2,10,0xb2d5dea2
4.49,1.0,53,1,2,2,5,0xb2d3b483d
20000.42,2.0,92,2,3,1,6,0xb2d97bcc
1558.85,1.0,57,1,2,2,5,0xb2d8f7f3d
1066.74,1.0,184,1,2,1,4,0xb2d078cdd
676002.97,12.0,15,4,4,3,11,0xb2d1be23d
0.95,1.0,73,1,2,1,4,0xb2d67cc1d
340020.16,2.0,24,4,3,2,9,0xb2d121a6d
0.9,1.0,0,1,2,4,7,0xb2d594ce
7021975.46,3.0,40,4,4,2,10,0xb2d35d01d
56291.4,2.0,28,3,3,2,8,0xb2d2d004
30128.36,1.0,8,2,2,3,7,0xb2d39913d
1016021.26,7.0,0,4,4,4,12,0xb2d23f41
303007.82,3.0,14,4,4,3,11,0xb2d7066e
1109711.08,4.0,95,4,4,1,9,0x3b9af3b6
570123.62,3.0,92,4,4,1,9,0xb2d4f402d
45162.62,1.0,14,2,2,3,7,0xb2d4668d
2261.66,3.0,8,1,4,3,8,0xb2d0ad01
501776.12,3.0,41,4,4,2,10,0xb2d9dd26
40065.63,2.0,101,2,3,1,6,0xb2d38775d
10.36,1.0,8,1,2,3,6,0xb2d2f1e8
463.59,2.0,0,1,3,4,8,0x3b9af0dad
150005.32,3.0,49,3,4,2,9,0xb2d6099bd
511881.73,2.0,0,4,3,4,11,0xb2d3f89fd
3.39,1.0,1,1,2,4,7,0xb2d289add
1579.12,1.0,0,1,2,4,7,0xb2d5c910
10052.88,1.0,184,2,2,1,5,0xb2d539d4d
23448.21,1.0,9,2,2,3,7,0xb2d32835d
674024.79,4.0,34,4,4,2,10,0xb2d9f79e
250001.79,3.0,2,3,4,4,11,0xb2d88b7b
649.55,1.0,3,1,2,4,7,0xb2d2b7a5
1000000.0,2.0,1,4,3,4,11,0xb2da3d7f
312154.78,2.0,26,4,3,2,9,0xb2d5b725
1188.01,1.0,7,1,2,3,6,0xb2d225cdd
336107.82,2.0,0,4,3,4,11,0xb2d7814fd
374.79,1.0,0,1,2,4,7,0xb2d3475f
1856051.33,6.0,31,4,4,2,10,0xb2d17c79
625957.53,6.0,0,4,4,4,12,0xb2d5b3ef
10019.81,2.0,25,2,3,2,7,0xb2d9dab8
704998.34,3.0,39,4,4,2,10,0xb2d400bed
840094.37,1.0,1,4,2,4,10,0xb2d9c6af
260000.0,2.0,5,3,3,3,9,0xb2da5cea
88.87,1.0,26,1,2,2,5,0xb2d64986d
50187.36,1.0,0,2,2,4,8,0xb2d92071d
860098.24,7.0,0,4,4,4,12,0xb2d24500d
12083.04,1.0,3,2,2,4,8,0xb2d6ab97d
1886.21,1.0,48,1,2,2,5,0xb2d43438
3614.49,1.0,2,2,2,4,8,0xb2d754b9d
10020.24,2.0,18,2,3,2,7,0xb2d248e1d
369618.02,3.0,25,4,4,2,10,0xb2d3663e
100013.48,2.0,92,3,3,1,7,0xb2d1b9d5
52001.1,2.0,31,2,3,2,7,0xb2d54815d
0.0,1.0,10,1,2,3,6,0xb2d92d83
50000.29,2.0,15,2,3,3,8,0xb2d6b95ed
38628.14,1.0,19,2,2,2,6,0xb2d913fe
465486.99,3.0,5,4,4,3,11,0xb2d59c5d
130666.78,4.0,24,3,4,2,9,0xb2d59b0cd
680.89,1.0,0,1,2,4,7,0xb2d653d6d
53313.31,2.0,39,3,3,2,8,0xb2d415b7d
2842.07,2.0,5,1,3,3,7,0xb2d31b5ad
70059.96,2.0,92,3,3,1,7,0xb2d68484d
146.47,1.0,8,1,2,3,6,0xb2d9071b
5513.46,1.0,101,2,2,1,5,0xb2d65212d
48.7,1.0,31,1,2,2,5,0xb2d9302e
3221.2,1.0,9,2,2,3,7,0xb2d58d08
2883.69,1.0,4,1,2,4,7,0xb2d5fc12
14.07,1.0,6,1,2,3,6,0xb2d601e0d
680067.04,6.0,36,4,4,2,10,0xb2d12791d
275170.33,2.0,0,3,3,4,10,0xb2d0dbf7d
4035.58,3.0,184,2,4,1,7,0xb2d5faefd
1054116.0,11.0,38,4,4,2,10,0xb2d0c860
350029.08,6.0,3,4,4,4,12,0xb2d1b24ad
100973.25,1.0,92,3,2,1,6,0xb2d24834d
688000.0,9.0,0,4,4,4,12,0xb2d6a0ed
450084.21,7.0,38,4,4,2,10,0xb2d57939d
80337.08,1.0,92,3,2,1,6,0xb2d5a9f6
4704.01,1.0,15,2,2,3,7,0xb2d8ca75d
19980.31,2.0,10,2,3,3,8,0x3b9b22f7d
500000.0,2.0,13,4,3,3,10,0xb2da3fd5
400000.0,2.0,18,4,3,2,9,0xb2da356b
13688.0,1.0,2,2,2,4,8,0xb2d2595ed
0.48,1.0,7,1,2,3,6,0xb2d5edf2
281136.84,5.0,6,3,4,3,10,0xb2d3b1ecd
100468.32,3.0,11,3,4,3,10,0xb2d0fb0cd
190049.72,2.0,208,3,3,1,7,0xb2d56bfcd
7083.46,1.0,4,2,2,4,8,0xb2d24bb7d
964823.8,4.0,48,4,4,2,10,0x3b9b3e31d
111.32,1.0,42,1,2,2,5,0xb2d254edd
350184.24,5.0,7,4,4,3,11,0xb2d5e76ad
163021.77,2.0,92,3,3,1,7,0xb2d10921d
66667.95,2.0,136,3,3,1,7,0xb2d28a8ad
560780.66,3.0,11,4,4,3,11,0xb2d906e1d
501020.02,4.0,1,4,4,4,12,0xb2d63638
20080.13,1.0,184,2,2,1,5,0xb2d2ed25d
60001.17,3.0,8,3,4,3,10,0xb2d96700d
8371.47,1.0,18,2,2,2,6,0xb2d3404e
15354.32,2.0,56,2,3,2,7,0xb2d4adc8d
100004.22,2.0,14,3,3,3,9,0xb2da352f
34.31,1.0,17,1,2,2,5,0xb2da1c14
500005.28,2.0,34,4,3,2,9,0xb2d931d8d
500000.84,3.0,15,4,4,3,11,0xb2d65c69d
1178.99,1.0,184,1,2,1,4,0xb2d2e0b0d
30000.63,2.0,228,2,3,1,6,0xb2d6f47c
10002.55,2.0,18,2,3,2,7,0xb2da252c
100003.86,2.0,123,3,3,1,7,0xb2d1ef50
50103.78,2.0,60,2,3,2,7,0xb2d626da
32542.09,1.0,184,2,2,1,5,0xb2d19fd9
41410.61,3.0,17,2,4,2,8,0xb2d271a1
2051710.5,3.0,12,4,4,3,11,0xb2d3ad7bd
40683.5,1.0,0,2,2,4,8,0xb2d436b6d
100780.8,2.0,35,3,3,2,8,0xb2d921eed
81417.42,2.0,0,3,3,4,10,0xb2d50865d
8000.96,4.0,0,2,4,4,10,0x3b9b4269d
25829.67,1.0,19,2,2,2,6,0xb2d68c5ed
200000.0,2.0,13,3,3,3,9,0xb2d7f1acd
4218287.44,8.0,13,4,4,3,11,0xb2d128b7
100036.38,1.0,1,3,2,4,9,0xb2d27596
0.14,1.0,1,1,2,4,7,0xb2d28978
10893.94,2.0,55,2,3,2,7,0xb2d656b6
1251.99,2.0,0,1,3,4,8,0x3b9b18f8d
99257.43,1.0,1,3,2,4,9,0xb2d41007d
1460510.02,8.0,17,4,4,2,10,0xb2d1c0c5d
4642.27,1.0,92,2,2,1,5,0xb2d4517ad
0.24,1.0,6,1,2,3,6,0xb2d594ced
82045.88,2.0,200,3,3,1,7,0xb2d5f0a6d
510327.36,2.0,57,4,3,2,9,0xb2d3b339d
50252.67,3.0,116,2,4,1,7,0xb2d2d758
1200072.53,4.0,11,4,4,3,11,0xb2d9cb0d
51041.38,2.0,266,2,3,1,6,0xb2d5dbcb
41495.61,1.0,47,2,2,2,6,0xb2d59dfdd
200000.42,2.0,5,3,3,3,9,0xb2d9fcfd
9080.83,1.0,92,2,2,1,5,0xb2d1b556d
2570.16,1.0,4,1,2,4,7,0xb2d790d1d
1.12,1.0,77,1,2,1,4,0xb2d357fc
8080.49,2.0,6,2,3,3,8,0xb2d38f8e
110019.76,3.0,124,3,4,1,8,0xb2d1af80
253289.45,3.0,77,3,4,1,8,0xb2d36f2bd
2755.03,1.0,0,1,2,4,7,0xb2d8d09cd
311244.7,3.0,122,4,4,1,9,0xb2d33edad
550242.51,4.0,179,4,4,1,9,0xb2d432ae
68046.81,4.0,7,3,4,3,10,0xb2d4796fd
11033.81,5.0,10,2,4,3,9,0x3b9af158d
904521.69,5.0,0,4,4,4,12,0xb2d1e1b0d
503942.62,4.0,14,4,4,3,11,0xb2d2009e
787548.33,4.0,0,4,4,4,12,0xb2d5b306d
89101.46,1.0,0,3,2,4,9,0xb2d0d2afd
125568.23,8.0,0,3,4,4,11,0xb2d08df5d
0.0,13.0,6,1,4,3,8,0xb2d689dfd
37.27,1.0,124,1,2,1,4,0xb2d2d244
22728.76,1.0,12,2,2,3,7,0xb2d96c31
325295.06,3.0,4,4,4,4,12,0xb2d62638d
1410.91,1.0,10,1,2,3,6,0xb2d87d31d
27649.57,1.0,95,2,2,1,5,0xb2d17959d
278.33,1.0,9,1,2,3,6,0xb2d4f872d
160162.65,2.0,47,3,3,2,8,0xb2d209b8d
1323.77,1.0,9,1,2,3,6,0xb2d6ec5ed
13623.37,1.0,0,2,2,4,8,0xb2d69f4c
1.4,1.0,70,1,2,1,4,0xb2d43d32d
96.3,1.0,52,1,2,2,5,0xb2d302fd
11088.96,1.0,0,2,2,4,8,0xb2da4bc8
864012.67,7.0,15,4,4,3,11,0xb2d10781d
394728.96,6.0,10,4,4,3,11,0xb2d5c75fd
50399.15,2.0,97,2,3,1,6,0xb2d5f403d
1.07,1.0,74,1,2,1,4,0xb2d6439ad
2622.14,1.0,9,1,2,3,6,0xb2d3a234
31041.81,1.0,0,2,2,4,8,0xb2d9b91c
220038.82,3.0,116,3,4,1,8,0xb2d59e47d
200506.4,3.0,9,3,4,3,10,0xb2d8c88bd
3463179.83,5.0,0,4,4,4,12,0xb2d69a0fd
590007.95,4.0,6,4,4,3,11,0xb2d68294d
149.87,1.0,0,1,2,4,7,0xb2d68af3
11218.88,2.0,182,2,3,1,6,0xb2d57095d
10001.06,2.0,8,2,3,3,8,0xb2da46da
55445.14,1.0,184,3,2,1,6,0xb2d3a292d
310138.66,4.0,18,4,4,2,10,0xb2d6072dd
3458834.36,10.0,0,4,4,4,12,0xb2d250efd
300000.0,2.0,20,3,3,2,8,0xb2d9538cd
100003.52,2.0,67,3,3,1,7,0xb2d242b2
2307.79,1.0,21,1,2,2,5,0xb2d30bc5d
3323.57,1.0,0,2,2,4,8,0xb2d23273
267828.4,1.0,3,3,2,4,9,0xb2d1dc5b
60309.73,4.0,0,3,4,4,11,0xb2d5b07d
3192.76,1.0,21,2,2,2,6,0xb2d92d65d
5.31,1.0,32,1,2,2,5,0xb2d50fab
56972.46,2.0,14,3,3,3,9,0xb2d10aad
10000.11,2.0,73,2,3,1,6,0xb2d8e43e
5052.92,1.0,92,2,2,1,5,0xb2d2d75bd
500000.0,3.0,26,4,4,2,10,0xb2d90313d
10002.21,2.0,31,2,3,2,7,0xb2d935f3d
50014.87,2.0,140,2,3,1,6,0xb2d6dd9f
51144.93,2.0,6,2,3,3,8,0xb2d681e0d
3064.61,1.0,19,2,2,2,6,0xb2d992f9
105004.45,2.0,92,3,3,1,7,0xb2d2652ed
1723.17,1.0,0,1,2,4,7,0xb2d40243
51305.04,3.0,2,2,4,4,10,0xb2d06806d
0.0,1.0,0,1,2,4,7,0xb2d8f2f0
60.85,1.0,184,1,2,1,4,0xb2d2cadad
60309.62,2.0,4,3,3,4,10,0xb2d68979d
491425.86,4.0,0,4,4,4,12,0xb2d58077d
5096.66,1.0,5,2,2,3,7,0x3b9b2ef5d
7134.78,1.0,184,2,2,1,5,0xb2d14600d
131.7,1.0,0,1,2,4,7,0xb2d6d4f1d
250939.13,2.0,35,3,3,2,8,0xb2d5ea87d
1060213.21,7.0,26,4,4,2,10,0xb2d12e9c
585404.83,4.0,47,4,4,2,10,0xb2d42ffbd
30000.1,3.0,1,2,4,4,10,0xb2d5a3e4
368814.42,33.0,1,4,4,4,12,0x3b9b0e21d
269951.39,1.0,120,3,2,1,6,0xb2d38c24
132.57,1.0,1,1,2,4,7,0xb2d5f19a
182319.1,7.0,6,3,4,3,10,0xb2d5ab46d
1962.51,1.0,1,1,2,4,7,0xb2d67544d
10000.11,2.0,35,2,3,2,7,0xb2d9f983
20000.84,2.0,92,2,3,1,6,0xb2d63a83d
7158.83,2.0,116,2,3,1,6,0xb2d09b5e
90293.04,5.0,10,3,4,3,10,0xb2d62e00d
522137.91,5.0,27,4,4,2,10,0xb2d65adbd
37379.41,1.0,9,2,2,3,7,0xb2d787ebd
88.32,1.0,10,1,2,3,6,0xb2d4f8d2
350001.58,3.0,1,4,4,4,12,0xb2d9610cd
200002.11,3.0,83,3,4,1,8,0xb2d95d73d
400093.09,6.0,11,4,4,3,11,0xb2d32a14d
335430.38,4.0,38,4,4,2,10,0xb2d15b61d
4020.16,1.0,2,2,2,4,8,0xb2d90109
30011.29,2.0,110,2,3,1,6,0xb2d60f74d
93328.59,3.0,19,3,4,2,9,0xb2d228bad
25.86,1.0,22,1,2,2,5,0xb2d98754
500000.02,3.0,15,4,4,3,11,0xb2d6987ad
19080.67,1.0,28,2,2,2,6,0xb2d58165d
206397.96,3.0,97,3,4,1,8,0xb2d2fb8fd
32.76,1.0,0,1,2,4,7,0xb2d85161d
184395.86,3.0,1,3,4,4,11,0xb2d4324d
8812.14,1.0,6,2,2,3,7,0xb2d2d3b9d
481716.51,4.0,4,4,4,4,12,0xb2d62984d
1349.25,1.0,184,1,2,1,4,0x3b9b381dd
295000.0,21.0,0,3,4,4,11,0xb2d2242ed
110776.3,3.0,56,3,4,2,9,0xb2d65111d
739556.59,7.0,3,4,4,4,12,0xb2d43fcad
199.59,1.0,7,1,2,3,6,0xb2d7690cd
106880.7,4.0,118,3,4,1,8,0xb2d5df74
175015.69,3.0,0,3,4,4,11,0xb2d1b1b8d
460000.0,9.0,1,4,4,4,12,0xb2d222e4d
190162.12,3.0,0,3,4,4,11,0xb2d2265ed
101220.72,2.0,47,3,3,2,8,0xb2d5925ed
1176.62,1.0,92,1,2,1,4,0xb2d29fdbd
1802.22,1.0,10,1,2,3,6,0xb2d9ffb8
50015.25,2.0,249,2,3,1,6,0xb2d0fa29d
240017.76,3.0,157,3,4,1,8,0xb2d3d265d
51034.34,2.0,8,2,3,3,8,0xb2d148fad
10038.08,1.0,10,2,2,3,7,0xb2d78c73d
1860000.0,5.0,26,4,4,2,10,0xb2d949b4d
2803.68,1.0,10,1,2,3,6,0xb2d6b6fa
88.9,1.0,12,1,2,3,6,0xb2d83aab
750.26,1.0,0,1,2,4,7,0xb2d36e49d
39.05,1.0,68,1,2,1,4,0xb2d45e36
1983.47,1.0,1,1,2,4,7,0xb2d445f5
10004.6,1.0,43,2,2,2,6,0xb2d90002d
980.07,1.0,18,1,2,2,5,0xb2d5d722
75006.86,2.0,74,3,3,1,7,0xb2d33e46d
35687.87,1.0,10,2,2,3,7,0xb2d93dd0
400088.28,2.0,21,4,3,2,9,0xb2d6672d
501.13,1.0,5,1,2,3,6,0xb2d6ee8b
501.66,1.0,74,1,2,1,4,0xb2d598ab
50001.58,2.0,102,2,3,1,6,0xb2d95ff9d
426.36,1.0,9,1,2,3,6,0xb2d9c54d
458350.52,4.0,90,4,4,1,9,0xb2d5d458d
50013.62,2.0,52,2,3,2,7,0xb2d191cfd
3267.81,1.0,7,2,2,3,7,0xb2d2db2e
303608.24,3.0,11,4,4,3,11,0xb2d5f1b3d
150006.87,3.0,94,3,4,1,8,0xb2d389b0
537.33,1.0,46,1,2,2,5,0xb2d29c1c
150035.78,1.0,0,3,2,4,9,0xb2d2e743d
379515.72,5.0,11,4,4,3,11,0xb2d56d2e
200000.02,2.0,22,3,3,2,8,0xb2d60346
3883.6,1.0,52,2,2,2,6,0xb2d2f713d
100031.6,6.0,4,3,4,4,11,0xb2d70405d
350712.64,3.0,53,4,4,2,10,0xb2d9cdd9
41415.33,3.0,46,2,4,2,8,0xb2d60f36d
967.43,1.0,10,1,2,3,6,0xb2d2db8b
998594.96,4.0,1,4,4,4,12,0xb2d217e9d
386.56,1.0,12,1,2,3,6,0xb2d1b50e
200528.38,2.0,0,3,3,4,10,0xb2d9c075
21238.85,1.0,184,2,2,1,5,0xb2d17badd
529279.55,2.0,13,4,3,3,10,0xb2d2bdadd
3890.33,1.0,49,2,2,2,6,0xb2d2bdddd
12021.74,4.0,18,2,4,2,8,0xb2d9f72c
104531.33,3.0,60,3,4,2,9,0xb2d5a59cd
270000.05,4.0,1,3,4,4,11,0xb2d76358d
3346.95,2.0,195,2,3,1,6,0xb2d34425d
79507.5,6.0,3,3,4,4,11,0xb2d54f3c
410001.48,5.0,12,4,4,3,11,0xb2d7a65cd
933939.1,2.0,4,4,3,4,11,0xb2d45476
508920.18,2.0,25,4,3,2,9,0xb2d27294d
39080.22,2.0,80,2,3,1,6,0xb2d541a0d
1804.22,1.0,92,1,2,1,4,0xb2d30b33d
517551.64,5.0,1,4,4,4,12,0xb2d78702d
4719.68,1.0,3,2,2,4,8,0xb2d6a1f2d
1715.32,1.0,92,1,2,1,4,0x3b9b2ea0d
300001.08,8.0,52,3,4,2,9,0xb2d61bc1
318749.04,1.0,24,4,2,2,8,0xb2d17722
500000.18,2.0,9,4,3,3,10,0xb2d92bf4d
14.19,1.0,167,1,2,1,4,0xb2d29f34d
263013.42,7.0,32,3,4,2,9,0xb2d2a473d
366732.65,2.0,29,4,3,2,9,0xb2d93882
395.02,1.0,74,1,2,1,4,0xb2d6019a
520000.0,3.0,13,4,4,3,11,0xb2d9495f
0.95,1.0,75,1,2,1,4,0xb2d99673
1955693.86,3.0,18,4,4,2,10,0xb2d2bce2d
322006.21,7.0,59,4,4,2,10,0xb2d18a51d
350285.86,1.0,0,4,2,4,10,0xb2d41ea9d
20764.24,1.0,8,2,2,3,7,0xb2d1ec39d
480376.4,5.0,11,4,4,3,11,0xb2d3e92dd
10001.13,2.0,27,2,3,2,7,0xb2d103b3
3735.15,1.0,298,2,2,1,5,0xb2d60a59d
1030.21,1.0,4,1,2,4,7,0xb2d10963
344667.33,9.0,1,4,4,4,12,0xb2d41031d
1135.84,2.0,76,1,3,1,5,0xb2d43959d
7503.23,1.0,184,2,2,1,5,0xb2d3a4e3d
2198.54,1.0,184,1,2,1,4,0xb2d42bc9d
16869.54,1.0,9,2,2,3,7,0xb2d8c935d
20028.76,2.0,18,2,3,2,7,0xb2d903cd
7763.61,1.0,8,2,2,3,7,0xb2d60a75
338013.28,8.0,20,4,4,2,10,0xb2d166efd
74.41,1.0,10,1,2,3,6,0xb2d9d967
501776.14,3.0,4,4,4,4,12,0xb2d9123ad
38.65,1.0,0,1,2,4,7,0xb2d6b3f3d
1421.88,1.0,184,1,2,1,4,0xb2d271c8d
200731.6,2.0,38,3,3,2,8,0xb2d60e82
504978.15,3.0,17,4,4,2,10,0xb2d65c45
223936.36,2.0,58,3,3,2,8,0xb2d8c7f2d
72071.12,2.0,73,3,3,1,7,0xb2d1b2b4d
170002.22,3.0,0,3,4,4,11,0xb2d96128d
501020.1,2.0,11,4,3,3,10,0xb2d20de5
50875.02,2.0,263,2,3,1,6,0xb2d5fc0fd
213445.77,4.0,5,3,4,3,10,0xb2d2c185
115091.53,2.0,19,3,3,2,8,0xb2d22709d
300068.44,2.0,80,3,3,1,7,0xb2d5ef75d
2.64,1.0,92,1,2,1,4,0xb2d2aef1d
125969.88,2.0,90,3,3,1,7,0xb2d3f290d
2695934.56,37.0,0,4,4,4,12,0xb2d5a907d
2002.94,1.0,11,1,2,3,6,0xb2d68bf7
51923.65,1.0,56,2,2,2,6,0xb2d31373d
1309.43,1.0,184,1,2,1,4,0x3b9b3b32d
7.5,1.0,58,1,2,2,5,0xb2d5523ed
2517766.11,3.0,58,4,4,2,10,0xb2d947ead
726.77,1.0,16,1,2,2,5,0xb2d6817e
113365.64,2.0,0,3,3,4,10,0xb2d1a2dad
2502.73,1.0,0,1,2,4,7,0xb2d42b1ed
159641.82,3.0,196,3,4,1,8,0xb2d3cc8ed
21.22,1.0,19,1,2,2,5,0xb2d30c33
200744.82,2.0,42,3,3,2,8,0xb2d908b6d
1188.59,1.0,92,1,2,1,4,0xb2d2818ed
100031.05,3.0,68,3,4,1,8,0xb2d33d68
64.87,1.0,14,1,2,3,6,0xb2d6e4a3d
130004.46,5.0,27,3,4,2,9,0xb2d3ccf1d
4342.89,1.0,21,2,2,2,6,0xb2d390f7d
3722.34,1.0,192,2,2,1,5,0xb2d6ec6dd
336554.44,7.0,18,4,4,2,10,0xb2d6cbadd
221257.94,5.0,18,3,4,2,9,0xb2d5cbb7d
511498.96,2.0,60,4,3,2,9,0xb2d8d177d
8265.28,1.0,92,2,2,1,5,0x3b9b268fd
70763.03,1.0,0,3,2,4,9,0xb2d69c26d
60000.11,3.0,3,3,4,4,11,0xb2d9568e
1123.56,2.0,92,1,3,1,5,0xb2d0fe42
18132.99,1.0,5,2,2,3,7,0xb2d6227c
153441.4,2.0,18,3,3,2,8,0xb2d12115d
713202.18,4.0,0,4,4,4,12,0xb2d86aa4
1212124.72,2.0,39,4,3,2,9,0xb2d3a04bd
3427.54,1.0,57,2,2,2,6,0xb2d434f9d
110497.36,6.0,0,3,4,4,11,0xb2d59251d
443556.8,8.0,3,4,4,4,12,0xb2d61b43
61049.71,2.0,34,3,3,2,8,0xb2d4f1f3
1002615.39,5.0,11,4,4,3,11,0xb2d69d7bd
302165.09,2.0,49,4,3,2,9,0xb2d8d579d
41.09,1.0,10,1,2,3,6,0xb2d97266
662263.17,6.0,0,4,4,4,12,0xb2d4f09ad
5000105.56,2.0,46,4,3,2,9,0xb2d9dd4c
132446.16,2.0,6,3,3,3,9,0xb2d067dbd
15025.27,2.0,27,2,3,2,7,0xb2d4e2f0
40000.42,3.0,13,2,4,3,9,0xb2d91d6a
892181.58,4.0,59,4,4,2,10,0xb2d5880ad
49476.25,2.0,0,2,3,4,9,0xb2d30deed
189.42,1.0,1,1,2,4,7,0xb2d654cdd
9263.0,3.0,92,2,4,1,7,0x3b9b3285d
11625.85,1.0,9,2,2,3,7,0xb2d3ebdf
3789.48,1.0,0,2,2,4,8,0xb2d553ad
110000.0,3.0,0,3,4,4,11,0xb2d9802b
25.33,1.0,28,1,2,2,5,0xb2d93ca8
3091107.46,5.0,6,4,4,3,11,0xb2d6e6cfd
200037.77,2.0,27,3,3,2,8,0xb2d39f9f
1010660.17,2.0,105,4,3,1,8,0xb2d7ef3d
10000.11,2.0,7,2,3,3,8,0xb2d81e6cd
60101.38,2.0,110,3,3,1,7,0xb2d95093d
2548.04,1.0,92,1,2,1,4,0xb2d35a50d
400715.1,3.0,11,4,4,3,11,0xb2d6fb19d
2.34,1.0,61,1,2,2,5,0xb2d1bdeed
402974.58,3.0,5,4,4,3,11,0xb2d6d93ed
1492952.7,61.0,1,4,4,4,12,0x3b9b0e70d
1416.34,1.0,0,1,2,4,7,0xb2d4aa1f
433104.15,8.0,31,4,4,2,10,0xb2d076fa
794881.61,7.0,25,4,4,2,10,0xb2d077a5d
10960.3,1.0,1,2,2,4,8,0xb2d553ae
72.13,1.0,0,1,2,4,7,0xb2d2fb75
6025.0,1.0,15,2,2,3,7,0xb2d9b45a
49335.82,1.0,0,2,2,4,8,0xb2d348e0d
620.16,1.0,17,1,2,2,5,0xb2d34cbd
200000.13,2.0,0,3,3,4,10,0xb2d6e008d
5940.79,1.0,0,2,2,4,8,0xb2d62344
79902.84,3.0,0,3,4,4,11,0x3b9af136
535675.36,7.0,45,4,4,2,10,0xb2d153be
200018.58,3.0,39,3,4,2,9,0xb2d06fa9d
55495.04,2.0,1,3,3,4,10,0xb2d9c2b2
5882.15,1.0,6,2,2,3,7,0xb2d43c7dd
532951.23,2.0,0,4,3,4,11,0xb2d0c4ded
203746.63,2.0,125,3,3,1,7,0xb2d39395d
1266868.85,10.0,3,4,4,4,12,0xb2d12e27d
4995.9,1.0,12,2,2,3,7,0xb2d9afb3
240873.09,2.0,30,3,3,2,8,0xb2d8e910d
2689.17,1.0,9,1,2,3,6,0xb2d4bb20
11213.73,1.0,18,2,2,2,6,0xb2d7184ad
50000.53,2.0,35,2,3,2,7,0xb2d9f934
3984.48,1.0,20,2,2,2,6,0xb2d2fd6fd
71003.73,3.0,12,3,4,3,10,0xb2d8fd92d
3.06,1.0,49,1,2,2,5,0xb2d52f59
4597.37,4.0,0,2,4,4,10,0xb2d63157
1564427.2,3.0,189,4,4,1,9,0xb2d24399d
168.12,2.0,57,1,3,2,6,0xb2d5e7d7d
2259463.55,1.0,12,4,2,3,9,0xb2d4be61d
304069.94,4.0,80,4,4,1,9,0xb2d3418ed
420023.42,5.0,14,4,4,3,11,0xb2d9792ad
105079.77,2.0,181,3,3,1,7,0xb2d227a3d
54994.36,1.0,140,3,2,1,6,0xb2d36b08d
73059.12,3.0,39,3,4,2,9,0xb2d56ccfd
200459.04,4.0,0,3,4,4,11,0xb2d25f78d
275003.74,9.0,0,3,4,4,11,0xb2d642f6d
79.39,1.0,6,1,2,3,6,0xb2d5d4fe
12760.28,1.0,2,2,2,4,8,0xb2d34550d
70275.81,5.0,0,3,4,4,11,0xb2d38271d
37.19,1.0,36,1,2,2,5,0xb2d56ba9d
358205.26,6.0,26,4,4,2,10,0xb2d61683d
7814.65,1.0,92,2,2,1,5,0xb2d0c087d
75337.91,1.0,19,3,2,2,7,0xb2d5b981
382002.9,9.0,14,4,4,3,11,0xb2d1e0bc
637.02,1.0,24,1,2,2,5,0xb2d90827
265227.62,1.0,12,3,2,3,8,0xb2d301fdd
211492.05,2.0,61,3,3,2,8,0xb2d9c05f
201421.13,2.0,75,3,3,1,7,0xb2d8e2f2d
62.34,1.0,42,1,2,2,5,0xb2d59184
100084.32,2.0,189,3,3,1,7,0xb2d58f7ad
315860.01,3.0,18,4,4,2,10,0xb2d2def1d
1519002.93,13.0,15,4,4,3,11,0x3b9b30bfd
852487.39,5.0,6,4,4,3,11,0xb2d1af38d
440325.32,5.0,11,4,4,3,11,0xb2d22b3dd
1816.98,1.0,0,1,2,4,7,0xb2d69480
21390.54,1.0,0,2,2,4,8,0xb2d0d759d
310000.0,2.0,7,4,3,3,10,0xb2d96ec2d
20000.56,1.0,0,2,2,4,8,0xb2d5d77f
200008.22,2.0,19,3,3,2,8,0xb2d9dab0
335.98,1.0,81,1,2,1,4,0xb2d6f718d
550023.03,4.0,6,4,4,3,11,0xb2d1286fd
210077.44,6.0,52,3,4,2,9,0xb2d1a4a3
816653.6,4.0,27,4,4,2,10,0xb2d0f321
111.92,1.0,70,1,2,1,4,0xb2d98ec9
80008.4,3.0,10,3,4,3,10,0xb2d1010ad
100003.18,2.0,25,3,3,2,8,0xb2d5474d
1549.33,1.0,12,1,2,3,6,0xb2d17c88d
370008.68,3.0,10,4,4,3,11,0xb2d2dbcdd
2.0,1.0,25,1,2,2,5,0xb2d4ec4d
7045.89,1.0,10,2,2,3,7,0xb2d5d124
26.11,1.0,7,1,2,3,6,0xb2d60e4e
2000.92,1.0,15,1,2,3,6,0xb2d9129c
100900.0,2.0,0,3,3,4,10,0xb2d9814b
266.52,1.0,32,1,2,2,5,0xb2d8e449
90598.63,2.0,66,3,3,2,8,0xb2d6bbd6d
19000.85,2.0,251,2,3,1,6,0xb2d5fb6a
423269.65,6.0,11,4,4,3,11,0xb2d6f31cd
1005.84,1.0,92,1,2,1,4,0xb2d40da0d
10000.21,2.0,59,2,3,2,7,0xb2d8fc90
420092.3,3.0,13,4,4,3,11,0xb2d10fb0
237407.64,2.0,74,3,3,1,7,0xb2d135f2d
465046.55,5.0,20,4,4,2,10,0xb2d9a29d
0.0,2.0,7,1,3,3,7,0xb2d5d7c2
827212.11,5.0,34,4,4,2,10,0xb2d1ac7bd
475.15,1.0,10,1,2,3,6,0xb2d9f483
90.9,1.0,9,1,2,3,6,0xb2d6a991
452.06,1.0,10,1,2,3,6,0xb2d8e285d
5322.45,4.0,223,2,4,1,7,0x3b9b194ed
100035.95,2.0,245,3,3,1,7,0xb2d17b98
202074.0,4.0,7,3,4,3,10,0xb2d96e5ad
94061.17,2.0,11,3,3,3,9,0xb2d5738e
55775.2,2.0,18,3,3,2,8,0xb2d235cdd
2.76,1.0,4,1,2,4,7,0xb2d5bc2c
888357.83,7.0,11,4,4,3,11,0xb2d17ce1d
95.89,1.0,9,1,2,3,6,0xb2d24b3dd
5.5,1.0,8,1,2,3,6,0xb2d8e742
836097.67,3.0,7,4,4,3,11,0xb2d14e97
1021.45,1.0,184,1,2,1,4,0xb2d5d507d
480015.81,3.0,94,4,4,1,9,0xb2d117e1d
200001.35,2.0,15,3,3,3,9,0xb2d95806d
570065.37,3.0,53,4,4,2,10,0xb2d140eed
5606.05,1.0,21,2,2,2,6,0xb2d6dd65d
1389829.67,6.0,6,4,4,3,11,0xb2d0fb69
807913.48,7.0,24,4,4,2,10,0xb2d305b6d
926.22,1.0,2,1,2,4,7,0xb2d91839
40000.0,2.0,184,2,3,1,6,0xb2d2aa4d
22391.2,2.0,199,2,3,1,6,0xb2d5cc7ad
80001.06,3.0,5,3,4,3,10,0xb2d5dbcd
6491.42,1.0,153,2,2,1,5,0xb2d5dbf4d
176.03,1.0,21,1,2,2,5,0xb2d3985cd
10064.43,1.0,194,2,2,1,5,0xb2d1040ed
165.03,1.0,2,1,2,4,7,0xb2d44797
62304.34,5.0,8,3,4,3,10,0x3b9b0f1cd
1300000.99,4.0,6,4,4,3,11,0xb2d93ed8d
352668.19,1.0,1,4,2,4,10,0xb2d38adcd
160621.78,11.0,21,3,4,2,9,0xb2d67e1b
976.61,2.0,0,1,3,4,8,0x3b9af2a0d
120699.23,3.0,5,3,4,3,10,0xb2d57857d
23640.81,2.0,137,2,3,1,6,0xb2d6f6e1
6173.29,1.0,1,2,2,4,8,0xb2d68e75
629737.32,3.0,24,4,4,2,10,0xb2d14fbed
1588.86,3.0,122,1,4,1,6,0xb2d2440f
200031.28,2.0,10,3,3,3,9,0xb2d81e4cd
51021.85,3.0,0,2,4,4,10,0xb2d1773bd
20427.78,1.0,92,2,2,1,5,0xb2d31273d
20303.0,2.0,34,2,3,2,7,0xb2d60bbcd
1014.47,1.0,92,1,2,1,4,0xb2d10351
1.15,1.0,83,1,2,1,4,0xb2d29845
50519.07,2.0,3,2,3,4,9,0xb2d68494d
167889.32,4.0,92,3,4,1,8,0xb2d36d21d
1.58,1.0,92,1,2,1,4,0xb2d4ac31d
353630.93,8.0,1,4,4,4,12,0xb2d6a0d4d
4000.2,1.0,4,2,2,4,8,0xb2d2565ed
23441.35,1.0,184,2,2,1,5,0xb2d0fee3d
8542.39,1.0,92,2,2,1,5,0xb2d0f810d
25159.59,1.0,5,2,2,3,7,0xb2d939cc
25009.97,3.0,3,2,4,4,10,0xb2d64d6cd
710117.33,18.0,7,4,4,3,11,0xb2d2554ad
100002.68,40.0,0,3,4,4,11,0xb2d4747b
1863.17,1.0,4,1,2,4,7,0xb2d6e409
350000.0,4.0,3,4,4,4,12,0xb2d3abcdd
36.84,1.0,84,1,2,1,4,0xb2d28c08
313054.58,5.0,0,4,4,4,12,0xb2d5b96f
16800.29,2.0,13,2,3,3,8,0xb2da1fe7
45.1,1.0,7,1,2,3,6,0xb2d5d500d
10000.11,2.0,49,2,3,2,7,0xb2d9d5cb
255912.64,6.0,33,3,4,2,9,0xb2d3a689d
275292.15,5.0,55,3,4,2,9,0xb2d3a44ad
10377.34,2.0,53,2,3,2,7,0xb2d5c98bd
3002.79,1.0,4,2,2,4,8,0xb2d8e208
80051.18,4.0,0,3,4,4,11,0xb2d642ced
1932746.76,2.0,63,4,3,2,9,0xb2d1d192d
5347.97,1.0,184,2,2,1,5,0xb2d4f870d
517821.12,6.0,11,4,4,3,11,0x3b9ace80d
475067.28,5.0,20,4,4,2,10,0xb2d40ec2d
440209.15,17.0,6,4,4,3,11,0xb2d65e53d
586187.96,2.0,83,4,3,1,8,0xb2d2a751d
1774000.0,4.0,0,4,4,4,12,0xb2d7f1d3d
500000.04,2.0,17,4,3,2,9,0xb2d9e146
60013.96,2.0,60,3,3,2,8,0xb2d4b61ed
1379.55,1.0,10,1,2,3,6,0xb2d6f2e1
100004.22,2.0,48,3,3,2,8,0xb2d90f93
1050.1,1.0,92,1,2,1,4,0xb2d062b1d
201065.73,9.0,0,3,4,4,11,0xb2d5dd77d
48.62,1.0,36,1,2,2,5,0xb2d58912
1101387.15,12.0,49,4,4,2,10,0xb2d07bacd
320120.07,3.0,139,4,4,1,9,0xb2d41d35d
201251.94,2.0,4,3,3,4,10,0xb2d63098
287393.47,2.0,10,3,3,3,9,0xb2d23d78d
3575.45,1.0,92,2,2,1,5,0xb2d22024
501776.42,2.0,5,4,3,3,10,0xb2d87cc5
600.91,1.0,10,1,2,3,6,0xb2d9543b
387014.78,3.0,0,4,4,4,12,0xb2da64be
163038.18,4.0,0,3,4,4,11,0x3b9b45c2d
510665.38,3.0,135,4,4,1,9,0xb2d7a70fd
10000.11,2.0,11,2,3,3,8,0xb2da4904
201046.65,11.0,0,3,4,4,11,0x3b9b46a7
11501.4,2.0,186,2,3,1,6,0xb2d69201d
6730.75,1.0,0,2,2,4,8,0xb2d9b759
40000.47,1.0,9,2,2,3,7,0xb2d5d14bd
473007.37,13.0,18,4,4,2,10,0xb2d3cdf1d
505004.09,7.0,0,4,4,4,12,0xb2d20bd3d
660.38,1.0,3,1,2,4,7,0xb2d6e7b5d
200009.96,3.0,28,3,4,2,9,0xb2d59cf5d
102119.28,3.0,97,3,4,1,8,0xb2d08429
4.98,1.0,17,1,2,2,5,0xb2d07d39d
1934.88,1.0,0,1,2,4,7,0xb2d55e26
176298.81,4.0,93,3,4,1,8,0xb2d4fcb5
52261.36,2.0,8,3,3,3,9,0xb2d4b376d
200000.0,2.0,3,3,3,4,10,0xb2d975ded
200000.0,2.0,0,3,3,4,10,0xb2d4ec45d
21.06,2.0,34,1,3,2,6,0xb2d91d5ad
2500103.41,3.0,8,4,4,3,11,0xb2d69d62d
51497.36,1.0,67,2,2,1,5,0xb2d115a1d
6257.3,1.0,184,2,2,1,5,0xb2d200d7d
6217.66,1.0,0,2,2,4,8,0xb2d09d81d
405015.69,4.0,0,4,4,4,12,0xb2d23d6cd
3811.7,1.0,0,2,2,4,8,0xb2d68315d
400720.84,3.0,7,4,4,3,11,0xb2d8faabd
500065.52,2.0,136,4,3,1,8,0xb2d1f44fd
2.29,1.0,75,1,2,1,4,0xb2d98d4a
50000.0,2.0,4,2,3,4,9,0xb2da56e8
1603.49,1.0,1,1,2,4,7,0xb2d376a5
2056.18,1.0,18,1,2,2,5,0xb2d17accd
9.62,1.0,37,1,2,2,5,0xb2d25538
1646.25,1.0,208,1,2,1,4,0xb2d185dad
500000.03,2.0,1,4,3,4,11,0xb2da3150
104.63,2.0,1,1,3,4,8,0xb2d6583cd
50064.75,2.0,161,2,3,1,6,0xb2d5addd
300000.01,3.0,15,3,4,3,10,0xb2d94d3b
2998.02,1.0,28,2,2,2,6,0xb2d4d017
264957.65,2.0,68,3,3,1,7,0xb2d29688d
7448.71,1.0,10,2,2,3,7,0xb2d9014cd
1065.35,1.0,92,1,2,1,4,0xb2d06db9d
442023.96,5.0,105,4,4,1,9,0xb2d6275cd
400063.86,3.0,102,4,4,1,9,0xb2d1ca3e
1057.54,1.0,2,1,2,4,7,0xb2d68756
251061.23,15.0,6,3,4,3,10,0xb2d10d3fd
242441.17,5.0,39,3,4,2,9,0xb2d6a037
3075.87,1.0,184,2,2,1,5,0x3b9b35b9d
1046.55,1.0,219,1,2,1,4,0xb2d0c91b
2894.2,1.0,1,2,2,4,8,0xb2d39583
381374.2,6.0,11,4,4,3,11,0xb2d6c4fbd
5568.34,1.0,21,2,2,2,6,0xb2d965e0
51491.45,2.0,1,2,3,4,9,0xb2d606ded
29.56,1.0,74,1,2,1,4,0xb2d5f13d
50072.8,2.0,179,2,3,1,6,0xb2d588bdd
38429.81,3.0,0,2,4,4,10,0xb2d08c1ed
654587.07,2.0,31,4,3,2,9,0xb2d6d0d3
13.98,1.0,63,1,2,2,5,0xb2d39a3ad
120021.94,2.0,188,3,3,1,7,0xb2d40c5cd
20177.18,1.0,184,2,2,1,5,0xb2d2efe1d
17416.21,1.0,18,2,2,2,6,0xb2d578bfd
20000.21,2.0,41,2,3,2,7,0xb2d90ba6d
1.97,1.0,44,1,2,2,5,0xb2d4f58f
0.74,1.0,91,1,2,1,4,0xb2d9490ed
300098.75,2.0,6,3,3,3,9,0xb2d68275
160027.3,4.0,139,3,4,1,8,0xb2d36161
100002.1,8.0,10,3,4,3,10,0xb2d5750dd
300010.69,2.0,33,3,3,2,8,0xb2d0c1d8
7977.92,1.0,0,2,2,4,8,0xb2d6ad4cd
1062.97,1.0,184,1,2,1,4,0xb2d298ddd
1088.46,1.0,21,1,2,2,5,0xb2d57dafd
661.43,1.0,10,1,2,3,6,0xb2d7ac63d
60029.99,3.0,0,3,4,4,11,0x3b9ae180d
16130.8,1.0,0,2,2,4,8,0xb2d91f5bd
17426.3,2.0,155,2,3,1,6,0xb2d52bf1
1457.28,1.0,10,1,2,3,6,0xb2d6338a
76912.43,10.0,1,3,4,4,11,0x3b9af29fd
1117115.83,6.0,66,4,4,2,10,0xb2d6bbe2d
250003.76,4.0,0,3,4,4,11,0xb2d434f3d
160923.33,3.0,6,3,4,3,10,0xb2d2a7ef
149.83,1.0,82,1,2,1,4,0xb2d57abad
480603.51,5.0,8,4,4,3,11,0xb2d67d7bd
70003.25,2.0,34,3,3,2,8,0xb2d1f2b9d
861.78,2.0,10,1,3,3,7,0xb2d23303d
1379.53,1.0,0,1,2,4,7,0xb2d6f393
812.19,1.0,0,1,2,4,7,0xb2d8b19bd
7395.11,1.0,92,2,2,1,5,0xb2d21689d
244717.01,5.0,2,3,4,4,11,0xb2d78978
50084.82,2.0,41,2,3,2,7,0xb2d64a74d
5.29,1.0,117,1,2,1,4,0xb2d946b2d
946.56,1.0,9,1,2,3,6,0xb2d45177d
8251.46,1.0,0,2,2,4,8,0xb2d2b6c0d
250005.63,3.0,8,3,4,3,10,0xb2d8d4ea
102688.2,3.0,123,3,4,1,8,0xb2d09d4a
1240784.7,4.0,14,4,4,3,11,0xb2d4a378
2340026.31,3.0,20,4,4,2,10,0xb2d81ebbd
30001.27,2.0,98,2,3,1,6,0xb2d96d05d
370013.35,9.0,3,4,4,4,12,0xb2d0e05fd
299188.42,1.0,10,3,2,3,8,0xb2d91027
775.51,1.0,17,1,2,2,5,0xb2d26019
6.33,1.0,89,1,2,1,4,0xb2d8a92d
0.54,1.0,64,1,2,2,5,0xb2d684a1d
22228.99,1.0,7,2,2,3,7,0xb2d2d3b7
1977.82,1.0,1,1,2,4,7,0xb2d236df
3003.16,1.0,109,2,2,1,5,0xb2d75743
50001.06,2.0,46,2,3,2,7,0xb2d9dfc8
17121.62,1.0,184,2,2,1,5,0xb2d35464d
557.64,1.0,2,1,2,4,7,0xb2d2f99a
8.22,1.0,14,1,2,3,6,0xb2d48eb4
481735.91,2.0,3,4,3,4,11,0xb2d9d5c5
1068.04,1.0,92,1,2,1,4,0xb2d33c51d
424577.97,3.0,0,4,4,4,12,0xb2d6ebbbd
200011.19,3.0,0,3,4,4,11,0xb2d99fe9
1300000.04,5.0,4,4,4,4,12,0xb2d6c026d
762.99,1.0,1,1,2,4,7,0xb2d8f9b2
10388.28,2.0,184,2,3,1,6,0xb2d105b3d
456533.03,9.0,0,4,4,4,12,0x3b9af171d
5017.96,1.0,92,2,2,1,5,0xb2d1a36cd
9822.55,1.0,2,2,2,4,8,0xb2d23b18
120076.73,2.0,74,3,3,1,7,0xb2d59c17
9045.02,1.0,92,2,2,1,5,0xb2d552a4
2764.15,1.0,15,1,2,3,6,0xb2d4d0dad
20001.13,2.0,102,2,3,1,6,0xb2d81504d
25641.92,1.0,15,2,2,3,7,0xb2d996d5
434687.95,11.0,3,4,4,4,12,0xb2d6ffbfd
85003.59,2.0,21,3,3,2,8,0xb2d9f51f
2195.59,1.0,1,1,2,4,7,0xb2d0bd27d
472.0,1.0,10,1,2,3,6,0xb2d4cd71
2071663.7,3.0,32,4,4,2,10,0xb2d130b0d
3111.47,1.0,1,2,2,4,8,0xb2d68e26d
154.1,1.0,0,1,2,4,7,0xb2d40a15d
500000.06,2.0,11,4,3,3,10,0xb2d9c414
1301552.66,7.0,0,4,4,4,12,0xb2d5d95b
546.39,1.0,0,1,2,4,7,0xb2d45750
15.3,1.0,42,1,2,2,5,0xb2d5bd62
1734.72,1.0,4,1,2,4,7,0xb2d8d221
504394.37,7.0,3,4,4,4,12,0xb2d5edc5
1034.48,1.0,120,1,2,1,4,0xb2d115e0
30272.22,1.0,184,2,2,1,5,0xb2d3589ad
379964.57,1.0,6,4,2,3,9,0xb2d2db6ed
60819.52,1.0,10,3,2,3,8,0xb2d5d5c8d
524382.75,4.0,53,4,4,2,10,0xb2d688f9d
7636.43,1.0,92,2,2,1,5,0x3b9b3462d
12458.9,1.0,10,2,2,3,7,0xb2d8fec7d
29559.77,2.0,0,2,3,4,9,0xb2d20666d
500005.28,3.0,18,4,4,2,10,0xb2d7436e
7648.03,1.0,0,2,2,4,8,0xb2d91326d
440000.92,3.0,18,4,4,2,10,0xb2d91230d
94.46,1.0,2,1,2,4,7,0xb2d941f2
3646.42,1.0,72,2,2,1,5,0xb2d64ecdd
70276.86,3.0,12,3,4,3,10,0xb2d5a9e9d
396009.65,11.0,39,4,4,2,10,0xb2d40ff7d
11150.79,1.0,1,2,2,4,8,0xb2d6cf38d
418723.57,3.0,179,4,4,1,9,0xb2d0d07cd
1409.62,2.0,92,1,3,1,5,0xb2d06b01d
3186.96,1.0,4,2,2,4,8,0xb2d2b5ced
17916.69,1.0,0,2,2,4,8,0xb2d6b545
300058.28,2.0,165,3,3,1,7,0xb2d06929d
80034.75,3.0,3,3,4,4,11,0xb2d5cc56
597039.5,4.0,14,4,4,3,11,0xb2d30d3dd
0.0,1.0,6,1,2,3,6,0xb2d1a77f
822.52,1.0,4,1,2,4,7,0xb2d6ea69
0.0,2.0,3,1,3,4,8,0xb2d4815ed
2071.86,1.0,23,1,2,2,5,0xb2d23929d
4161.36,1.0,1,2,2,4,8,0xb2d3745cd
80000.0,3.0,56,3,4,2,9,0xb2d30cdfd
280005.92,2.0,140,3,3,1,7,0xb2d91204d
10141.19,1.0,184,2,2,1,5,0xb2d1f1f7d
390000.0,2.0,24,4,3,2,9,0xb2d933b5d
209414.26,1.0,20,3,2,2,7,0xb2d37a91d
4803.76,1.0,184,2,2,1,5,0xb2d1c703d
253917.73,2.0,4,3,3,4,10,0xb2d58f3dd
1081.55,1.0,76,1,2,1,4,0xb2d5db93d
710117.79,16.0,0,4,4,4,12,0x3b9af246d
904.48,1.0,9,1,2,3,6,0xb2d32098d
5621.63,1.0,17,2,2,2,6,0xb2d6a8e3d
363.5,1.0,48,1,2,2,5,0xb2d31027
146005.09,2.0,73,3,3,1,7,0xb2d5f390
1380060.14,14.0,1,4,4,4,12,0xb2d12af5d
53516.49,2.0,137,3,3,1,7,0xb2d62f55d
957015.33,14.0,0,4,4,4,12,0xb2d167e4
210000.0,9.0,4,3,4,4,11,0xb2d5e541d
615034.9,4.0,0,4,4,4,12,0xb2d99f49
300609.22,3.0,2,4,4,4,12,0xb2d8e148d
10592.73,1.0,184,2,2,1,5,0xb2d26dead
354494.45,6.0,7,4,4,3,11,0xb2d61c0ad
52365.85,3.0,42,3,4,2,9,0x3b9b2cb5d
553042.94,9.0,49,4,4,2,10,0xb2d5568dd
1176177.53,7.0,67,4,4,1,9,0xb2d43630d
101374.3,1.0,204,3,2,1,6,0xb2d4cec8d
150002.53,2.0,2,3,3,4,10,0xb2d96c90
99636.92,1.0,49,3,2,2,7,0xb2d391f6d
6407.53,1.0,1,2,2,4,8,0xb2d523e1d
150008.99,4.0,6,3,4,3,10,0xb2d6a8f5
1558.39,1.0,16,1,2,2,5,0xb2d2739dd
312000.67,4.0,0,4,4,4,12,0xb2d085c5
16457.12,1.0,5,2,2,3,7,0xb2d8eb74d
21201.04,2.0,0,2,3,4,9,0xb2d4e286d
137.81,1.0,10,1,2,3,6,0xb2d10231
132453.4,3.0,39,3,4,2,9,0xb2d64a16d
73.97,1.0,10,1,2,3,6,0xb2d69aa5
2359.79,1.0,296,1,2,1,4,0xb2d1ab7bd
5003.77,1.0,0,2,2,4,8,0xb2d2fd90d
104258.13,3.0,13,3,4,3,10,0xb2d56377d
400092.84,3.0,18,4,4,2,10,0xb2d9b9a0
2914.3,1.0,10,2,2,3,7,0xb2d6efdc
220012.21,4.0,41,3,4,2,9,0xb2d207ced
85001.28,5.0,56,3,4,2,9,0xb2d6372ed
20186.34,1.0,184,2,2,1,5,0xb2d204e7d
100027.1,2.0,102,3,3,1,7,0xb2d5f271d
110004.51,3.0,32,3,4,2,9,0xb2d60738d
1091.81,1.0,184,1,2,1,4,0xb2d35173d
3716.57,1.0,4,2,2,4,8,0xb2d20bb9d
50002.45,2.0,98,2,3,1,6,0xb2d96b26d
45450.53,2.0,0,2,3,4,9,0x3b9af2c2d
68856.74,3.0,0,3,4,4,11,0x3b9af19dd
6540.29,1.0,2,2,2,4,8,0xb2d1a47cd
2455950.13,10.0,0,4,4,4,12,0x3b9b2f66d
30330.21,3.0,244,2,4,1,7,0x3b9b3aced
100013.79,2.0,77,3,3,1,7,0xb2d38cec
530128.73,2.0,256,4,3,1,8,0xb2d1daadd
2415.4,1.0,9,1,2,3,6,0xb2d64d1fd
8071.69,1.0,10,2,2,3,7,0xb2d30e40d
31143.07,2.0,165,2,3,1,6,0xb2d36e6dd
1266.52,1.0,117,1,2,1,4,0xb2d6ee8d
2.75,1.0,23,1,2,2,5,0xb2d235f2d
401093.18,33.0,13,4,4,3,11,0x3b9b2ccf
13713.39,1.0,14,2,2,3,7,0xb2d91f7d
120496.76,4.0,1,3,4,4,11,0xb2d4d894d
320943.09,3.0,0,4,4,4,12,0xb2d3b238
170.65,1.0,43,1,2,2,5,0xb2d9cdde
20929.28,2.0,0,2,3,4,9,0xb2d9aba6
34.07,1.0,4,1,2,4,7,0xb2d51df1d
49.19,1.0,39,1,2,2,5,0xb2d3cbf6d
320622.9,18.0,0,4,4,4,12,0xb2d16cd5d
39421.06,1.0,235,2,2,1,5,0xb2d3a8a0d
7.75,1.0,70,1,2,1,4,0xb2d36533d
1933.91,1.0,0,1,2,4,7,0xb2d37cdb
0.38,1.0,1,1,2,4,7,0xb2d627a3d
204279.99,2.0,87,3,3,1,7,0xb2d6b8f5d
630010.42,3.0,4,4,4,4,12,0xb2d9f8ff
953672.76,4.0,33,4,4,2,10,0xb2d4559bd
207972.78,1.0,174,3,2,1,6,0xb2d5a601d
690092.41,5.0,6,4,4,3,11,0xb2d657d4d
23.48,1.0,14,1,2,3,6,0xb2d5c7b5
2221100.91,11.0,0,4,4,4,12,0xb2d3c3abd
302005.93,5.0,25,4,4,2,10,0xb2d61ca8d
200036.68,2.0,122,3,3,1,7,0xb2d0d5a1d
11271.63,1.0,184,2,2,1,5,0xb2d2acf8d
100006.34,3.0,24,3,4,2,9,0xb2d932b0d
10192.72,1.0,0,2,2,4,8,0xb2d90ba0
2807.34,1.0,15,1,2,3,6,0xb2d7ed97
865043.85,10.0,11,4,4,3,11,0xb2d1110ad
558752.89,13.0,0,4,4,4,12,0xb2d06916d
50001.58,2.0,102,2,3,1,6,0xb2d960e1d
4217.78,1.0,6,2,2,3,7,0xb2d323a3d
1133.82,1.0,9,1,2,3,6,0xb2d310fcd
155044.68,3.0,3,3,4,4,11,0xb2d44135
100008.24,3.0,59,3,4,2,9,0xb2d10ee0d
1054822.04,4.0,104,4,4,1,9,0xb2d271be
3398.97,1.0,0,2,2,4,8,0xb2d89fcc
361719.29,3.0,32,4,4,2,10,0xb2d11e8ed
490081.05,2.0,10,4,3,3,10,0xb2d99f70
1000089.72,3.0,15,4,4,3,11,0xb2d5e33e
1473005.23,9.0,1,4,4,4,12,0x3b9b44cdd
57717.82,1.0,4,3,2,4,9,0xb2d69f88d
1195.88,1.0,184,1,2,1,4,0xb2d2ae45d
100002.11,3.0,24,3,4,2,9,0xb2d9478fd
3311.64,1.0,140,2,2,1,5,0xb2d6f701
469816.94,2.0,25,4,3,2,9,0xb2d14f33d
293029.37,4.0,69,3,4,1,8,0xb2d17765d
150001.58,2.0,95,3,3,1,7,0xb2d97ac4d
1447.55,1.0,72,1,2,1,4,0xb2d56f6ed
66052.39,1.0,9,3,2,3,8,0xb2d4dcd0
278.92,1.0,21,1,2,2,5,0xb2d2deaf
30000.32,2.0,31,2,3,2,7,0xb2d939f1
7013.52,1.0,45,2,2,2,6,0xb2d6bda0
400005.48,4.0,3,4,4,4,12,0xb2d9b7e2
325333.48,2.0,125,4,3,1,8,0xb2d6242dd
201865.8,2.0,0,3,3,4,10,0xb2d42480d
144.08,1.0,11,1,2,3,6,0xb2d8cba3
3.66,1.0,20,1,2,2,5,0xb2d5e76ed
200012.94,3.0,20,3,4,2,9,0xb2d1bff0d
380047.17,3.0,49,4,4,2,10,0xb2d13718d
15509.12,1.0,7,2,2,3,7,0xb2d6f1f9
400.42,1.0,10,1,2,3,6,0xb2d90d9b
129345.09,2.0,136,3,3,1,7,0xb2d123c6d
107.71,1.0,1,1,2,4,7,0xb2d188a3d
6382.07,1.0,21,2,2,2,6,0xb2d963a9
142705.59,2.0,14,3,3,3,9,0xb2d6b5f0d
5825.5,1.0,0,2,2,4,8,0xb2d2b5fd
121053.32,1.0,4,3,2,4,9,0xb2d666c1
100003.2,2.0,80,3,3,1,7,0xb2d8ccaed
0.71,1.0,69,1,2,1,4,0xb2d5dcc1
1690.18,1.0,0,1,2,4,7,0xb2d57df4
28.15,1.0,6,1,2,3,6,0xb2d8d53fd
520060.9,3.0,27,4,4,2,10,0xb2d6419c
3882.34,1.0,2,2,2,4,8,0xb2d309acd
8029.05,1.0,92,2,2,1,5,0xb2d55c31d
253080.19,5.0,18,3,4,2,9,0xb2d383bbd
110006.67,5.0,5,3,4,3,10,0xb2d61230
0.2,1.0,2,1,2,4,7,0xb2d586de
667754.39,4.0,53,4,4,2,10,0xb2d4e927d
400937.64,7.0,0,4,4,4,12,0xb2d5fdb6
3311.43,2.0,10,2,3,3,8,0xb2d4dbcd
426000.01,32.0,1,4,4,4,12,0xb2d0f814d
1045.88,1.0,245,1,2,1,4,0xb2d3e900d
100002.11,2.0,66,3,3,2,8,0xb2d8f018d
70084.71,2.0,181,3,3,1,7,0xb2d10d94d
156721.29,2.0,62,3,3,2,8,0xb2d4286ad
6558.07,1.0,19,2,2,2,6,0xb2d9d628
16195.36,4.0,6,2,4,3,9,0xb2d68279
120004.54,3.0,42,3,4,2,9,0xb2d6811dd
350029.76,7.0,1,4,4,4,12,0xb2d1491dd
1130.76,1.0,39,1,2,2,5,0xb2d77812d
26962.45,1.0,10,2,2,3,7,0xb2d4b664d
27044.66,1.0,10,2,2,3,7,0xb2d5d5e9
5298320.72,13.0,0,4,4,4,12,0xb2d51cf5d
830947.12,5.0,0,4,4,4,12,0xb2d46e3fd
42.65,1.0,46,1,2,2,5,0xb2d6fc61
6.33,1.0,12,1,2,3,6,0xb2d95afed
1815.86,1.0,92,1,2,1,4,0xb2d0b8fcd
20001278.45,2.0,203,4,3,1,8,0xb2d5b446d
3351.36,1.0,4,2,2,4,8,0xb2d62164d
200023.02,2.0,23,3,3,2,8,0xb2d2bff4d
0.0,1.0,6,1,2,3,6,0xb2d283c9d
1293.12,1.0,0,1,2,4,7,0xb2d34d85d
10164.18,1.0,151,2,2,1,5,0xb2d6aaabd
20000.11,2.0,0,2,3,4,9,0xb2d96b35d
7181.85,1.0,0,2,2,4,8,0xb2d6a744d
80220.71,1.0,0,3,2,4,9,0xb2d20fbf
237.92,1.0,11,1,2,3,6,0xb2d33430d
543372.05,4.0,59,4,4,2,10,0xb2d0aac6
1017.89,1.0,92,1,2,1,4,0xb2d3890bd
10219.34,1.0,92,2,2,1,5,0xb2d2c458d
1144392.91,4.0,123,4,4,1,9,0xb2d5a4dbd
30001.58,2.0,98,2,3,1,6,0xb2d9685bd
8685.46,1.0,13,2,2,3,7,0xb2d343e8
12581.41,1.0,92,2,2,1,5,0xb2d1a4d3d
2325.42,1.0,0,1,2,4,7,0xb2d31de4
271962.6,9.0,0,3,4,4,11,0xb2d22681d
91003.08,3.0,21,3,4,2,9,0xb2d0ba4bd
9.14,1.0,25,1,2,2,5,0xb2d9a749
3.17,1.0,60,1,2,2,5,0xb2d8f83cd
250000.0,2.0,4,3,3,4,10,0xb2d97a44
1463.03,1.0,184,1,2,1,4,0xb2d4d0c3d
100094.76,2.0,182,3,3,1,7,0xb2d21a9ad
1922052.12,11.0,82,4,4,1,9,0xb2d0ddd8d
1484993.23,14.0,0,4,4,4,12,0xb2d0fc55d
90.65,1.0,0,1,2,4,7,0xb2d8695c
203030.97,3.0,41,3,4,2,9,0xb2d5b2dfd
27.69,1.0,10,1,2,3,6,0xb2d607d6d
340301.52,3.0,24,4,4,2,10,0xb2d2c297
16366.62,1.0,169,2,2,1,5,0xb2d2137dd
452.78,1.0,19,1,2,2,5,0xb2d74484
508048.05,2.0,129,4,3,1,8,0xb2d4a678d
207294.04,2.0,126,3,3,1,7,0xb2d33ed9d
3060.67,1.0,92,2,2,1,5,0xb2d2aa76
338.67,1.0,0,1,2,4,7,0xb2d11531d
8371.87,1.0,15,2,2,3,7,0xb2d9c41c
9776.07,1.0,0,2,2,4,8,0xb2d8ebb0d
10311051.97,2.0,5,4,3,3,10,0xb2d2c38e
37301.7,1.0,3,2,2,4,8,0xb2d34dd3d
1370.19,1.0,184,1,2,1,4,0x3b9b0f9bd
108976.42,1.0,37,3,2,2,7,0xb2d1d75c
117934.89,2.0,224,3,3,1,7,0xb2d3e4a0d
51561.96,1.0,92,2,2,1,5,0xb2d0d6a7d
93012.8,4.0,25,3,4,2,9,0xb2d38230d
15906.48,1.0,3,2,2,4,8,0xb2d2da05d
212568.7,1.0,28,3,2,2,7,0xb2d411d0d
469010.43,9.0,10,4,4,3,11,0xb2d58710d
21.37,1.0,66,1,2,2,5,0xb2d6c012
452172.26,3.0,13,4,4,3,11,0xb2d23e33d
557.73,1.0,5,1,2,3,6,0xb2d87fe7d
6047.64,1.0,13,2,2,3,7,0xb2d8cab1
121521.29,10.0,83,3,4,1,8,0xb2d5279ed
1121.82,1.0,14,1,2,3,6,0xb2d2f42a
3112000.01,2.0,86,4,3,1,8,0xb2d5c472d
64040.31,2.0,139,3,3,1,7,0xb2d3ac22d
322232.52,2.0,10,4,3,3,10,0xb2d6bb39d
24000.25,2.0,14,2,3,3,8,0xb2da3962
14157.78,1.0,0,2,2,4,8,0xb2d3e92ad
100151.89,2.0,21,3,3,2,8,0xb2d180bdd
10000.11,2.0,10,2,3,3,8,0xb2d967b8d
56012.0,2.0,8,3,3,3,9,0xb2d94054d
8486.89,1.0,0,2,2,4,8,0xb2d6bd13
1000015.84,2.0,59,4,3,2,9,0xb2d8fb25
83533.27,3.0,25,3,4,2,9,0xb2d5c1c3d
897563.74,6.0,20,4,4,2,10,0xb2d5e996
400010.16,2.0,21,4,3,2,9,0xb2d21f2ad
15156.97,1.0,47,2,2,2,6,0xb2d6b545d
50876.06,2.0,200,2,3,1,6,0xb2d3a69cd
50001.06,2.0,73,2,3,1,6,0xb2d8e126
930.75,1.0,4,1,2,4,7,0xb2d272bdd
723169.29,18.0,1,4,4,4,12,0xb2d5b118d
226.07,1.0,4,1,2,4,7,0xb2d57ac6d
122.49,1.0,11,1,2,3,6,0xb2da26b3
111.99,1.0,11,1,2,3,6,0xb2d3194b
10027157.59,5.0,19,4,4,2,10,0xb2d6e016d
240493.89,3.0,18,3,4,2,9,0xb2d3ff50
4005448.18,1.0,138,4,2,1,7,0xb2d6f49fd
4004.42,1.0,71,2,2,1,5,0xb2d5c891d
200048.32,4.0,3,3,4,4,11,0xb2d337e4d
5217.73,1.0,0,2,2,4,8,0xb2d4bdbdd
2500516.76,4.0,1,4,4,4,12,0xb2d13bc9d
255774.64,7.0,0,3,4,4,11,0xb2d187fbd
28964.41,1.0,28,2,2,2,6,0xb2d99428
1547.46,1.0,18,1,2,2,5,0xb2d1c1fbd
405105.65,3.0,80,4,4,1,9,0xb2d184a7d
51741.72,2.0,82,2,3,1,6,0xb2d621dfd
200023.69,2.0,1,3,3,4,10,0xb2d6d88bd
790769.4,13.0,13,4,4,3,11,0xb2d625f1d
599.72,1.0,19,1,2,2,5,0xb2d2d98c
2514015.44,8.0,4,4,4,4,12,0xb2d9b7e5
40575.06,1.0,7,2,2,3,7,0xb2d939d9
100005.28,2.0,139,3,3,1,7,0xb2d5e66dd
140005.91,3.0,13,3,4,3,10,0xb2d95877d
29584.17,1.0,8,2,2,3,7,0xb2d85b80d
712333.89,8.0,49,4,4,2,10,0xb2d8c6a1d
319797.4,3.0,4,4,4,4,12,0xb2d63334d
230964.19,5.0,3,3,4,4,11,0xb2d13eefd
260002.74,3.0,73,3,4,1,8,0xb2d69314d
126.13,1.0,46,1,2,2,5,0xb2d37c40
4.34,1.0,0,1,2,4,7,0xb2d6c020
1393504.79,16.0,4,4,4,4,12,0xb2d69605d
987448.91,6.0,0,4,4,4,12,0xb2d54b22d
50003.93,3.0,6,2,4,3,9,0x3b9aef53d
1000005.36,3.0,22,4,4,2,10,0xb2d6f2dcd
10001.35,2.0,6,2,3,3,8,0xb2da3bd2
515101.74,10.0,26,4,4,2,10,0x3b9af6b9d
167150.75,1.0,0,3,2,4,9,0xb2d23be8d
900477.74,2.0,62,4,3,2,9,0xb2d4fef9d
3082.71,1.0,0,2,2,4,8,0xb2d3337c
331827.4,7.0,4,4,4,4,12,0xb2d56362d
80079.28,2.0,0,3,3,4,10,0xb2d9ad69
100004.22,2.0,69,3,3,1,7,0xb2d8e7d6
9997797.6,14.0,1,4,4,4,12,0xb2d11472d
670023.32,5.0,13,4,4,3,11,0xb2d95458d
269033.54,10.0,18,3,4,2,9,0x3b9af2b2d
2104057.52,8.0,1,4,4,4,12,0xb2d62fb6d
904041.96,3.0,1,4,4,4,12,0xb2d9a563
8811.8,1.0,137,2,2,1,5,0xb2d8de57d
105831.21,2.0,55,3,3,2,8,0xb2d5cc5fd
291773.93,2.0,2,3,3,4,10,0xb2d4a625d
0.88,1.0,0,1,2,4,7,0xb2d5c2b3
1460502.4,10.0,0,4,4,4,12,0xb2d26b87d
100013.14,4.0,4,3,4,4,11,0xb2d17767
2.48,1.0,85,1,2,1,4,0xb2d91bfc
411379.08,2.0,37,4,3,2,9,0xb2d65060
661.73,1.0,26,1,2,2,5,0xb2d5f5c1d
329.85,1.0,47,1,2,2,5,0xb2d3e9e6d
3596.03,1.0,184,2,2,1,5,0xb2d1ec9cd
22935.49,1.0,56,2,2,2,6,0xb2d67eaad
0.0,1.0,1,1,2,4,7,0xb2d97771d
316903.74,5.0,165,4,4,1,9,0xb2d17c30d
1960.54,1.0,2,1,2,4,7,0xb2d609cfd
450084.62,3.0,19,4,4,2,10,0xb2d0cef4d
6000000.0,1.0,0,4,2,4,10,0xb2da6b02
122.87,1.0,67,1,2,1,4,0xb2d24bf3d
212354.97,2.0,0,3,3,4,10,0xb2d64967d
1393.48,1.0,1,1,2,4,7,0xb2d9256a
53993.84,1.0,2,3,2,4,9,0xb2d22ea1d
20455.77,2.0,7,2,3,3,8,0xb2d4e8e3d
1227180.84,9.0,29,4,4,2,10,0xb2d08640
155328.83,2.0,0,3,3,4,10,0xb2d41eb2
6191.93,10.0,0,2,4,4,10,0xb2d0f874
1.06,1.0,110,1,2,1,4,0xb2d956e8d
14.96,1.0,84,1,2,1,4,0xb2d10036d
14000.41,1.0,184,2,2,1,5,0xb2d1e869d
372151.52,3.0,80,4,4,1,9,0xb2d08876d
3784.76,1.0,270,2,2,1,5,0xb2d208e3d
25.82,1.0,10,1,2,3,6,0xb2d2d3ce
150161.3,3.0,3,3,4,4,11,0xb2d6c96bd
130000.0,1.0,0,3,2,4,9,0xb2d9424fd
50333.78,2.0,21,2,3,2,7,0xb2d1fea7d
50105.88,2.0,0,2,3,4,9,0xb2d46f8a
20025.98,1.0,133,2,2,1,5,0xb2d9251bd
103632.61,1.0,5,3,2,3,8,0xb2d62011d
200002.11,2.0,87,3,3,1,7,0xb2d6280e
401420.86,2.0,42,4,3,2,9,0xb2d9221fd
174.67,1.0,3,1,2,4,7,0xb2d8a922
10269.02,1.0,92,2,2,1,5,0xb2d2d9b6d
282213.95,4.0,31,3,4,2,9,0xb2d6229fd
1682.11,1.0,21,1,2,2,5,0xb2d5f934d
11202.88,1.0,21,2,2,2,6,0xb2d964c4
350093.07,2.0,122,4,3,1,8,0xb2d598c9d
2.74,1.0,6,1,2,3,6,0xb2d8f47ad
7473.98,11.0,92,2,4,1,7,0xb2d104b1d
613.29,1.0,21,1,2,2,5,0xb2d6a24c
5254.26,1.0,14,2,2,3,7,0xb2d6bddfd
34.7,1.0,69,1,2,1,4,0xb2d36a66d
100011.67,2.0,95,3,3,1,7,0xb2d553a8d
50020.49,2.0,208,2,3,1,6,0xb2d3a1b5d
90051.64,2.0,0,3,3,4,10,0xb2d5d1f5d
50073.89,1.0,130,2,2,1,5,0xb2d92d84d
6176528.53,6.0,6,4,4,3,11,0xb2d1297dd
19683.72,1.0,18,2,2,2,6,0xb2d53056d
28021.13,1.0,184,2,2,1,5,0x3b9af46cd
400000.0,3.0,0,4,4,4,12,0xb2d915aa
31473.8,1.0,49,2,2,2,6,0xb2d37d12
58.58,1.0,10,1,2,3,6,0xb2d49097d
330007.09,8.0,25,4,4,2,10,0xb2d59444d
10155.77,1.0,184,2,2,1,5,0xb2d14452d
551243.4,3.0,19,4,4,2,10,0xb2d9d297
200000.1,2.0,17,3,3,2,8,0xb2d78f09d
28745.82,1.0,0,2,2,4,8,0xb2d2a864
200000.76,2.0,6,3,3,3,9,0xb2d64245d
203282.34,2.0,136,3,3,1,7,0xb2d412d4d
30000.63,2.0,46,2,3,2,7,0xb2d9dfa1
1900022.63,6.0,4,4,4,4,12,0xb2d12d12d
1172.61,1.0,2,1,2,4,7,0xb2d2bb75
1250.35,1.0,1,1,2,4,7,0xb2d5dc59d
18570.27,1.0,217,2,2,1,5,0xb2d61ba0d
999.0,1.0,0,1,2,4,7,0xb2d9226ad
210538.08,2.0,216,3,3,1,7,0xb2d24b6ad
500228.27,2.0,18,4,3,2,9,0xb2d78d81d
319840.01,8.0,3,4,4,4,12,0xb2d4461f
50095.81,2.0,76,2,3,1,6,0xb2d5b7e6d
550000.0,4.0,0,4,4,4,12,0xb2d975b4d
271035.92,15.0,3,3,4,4,11,0xb2d3f507
6033.35,1.0,8,2,2,3,7,0xb2d52775
86009.23,2.0,249,3,3,1,7,0xb2d1645ed
0.65,1.0,33,1,2,2,5,0xb2d1c84e
4132.32,1.0,4,2,2,4,8,0xb2d3239ad
801064.42,8.0,4,4,4,4,12,0xb2d216eb
6.58,1.0,47,1,2,2,5,0xb2d393e7d
823.15,1.0,14,1,2,3,6,0xb2d0cea0
3035.1,2.0,0,2,3,4,9,0xb2d0790fd
101908.31,2.0,111,3,3,1,7,0xb2d637f5d
1102301.43,3.0,12,4,4,3,11,0xb2d890efd
230006.12,3.0,4,3,4,4,11,0xb2da2283
785.17,1.0,43,1,2,2,5,0xb2d3c4bad
438030.33,7.0,0,4,4,4,12,0xb2d211ba
80003.4,2.0,48,3,3,2,8,0xb2d6db52d
4389.67,1.0,5,2,2,3,7,0xb2d5d4f6
400785.15,3.0,3,4,4,4,12,0x3b9b2e0cd
190415.87,1.0,10,3,2,3,8,0xb2d6b30bd
400004.23,3.0,42,4,4,2,10,0xb2d9741fd
1298.34,1.0,9,1,2,3,6,0xb2d57affd
300012.69,2.0,92,3,3,1,7,0xb2d63ffcd
120070.16,5.0,11,3,4,3,10,0xb2d16b8a
118827.57,5.0,11,3,4,3,10,0xb2d6477fd
7157.37,1.0,3,2,2,4,8,0xb2d33bad
18.16,1.0,78,1,2,1,4,0xb2d4d94b
2012.61,1.0,97,1,2,1,4,0xb2d90c57
41515.33,2.0,22,2,3,2,7,0xb2d69cbcd
1856.25,1.0,92,1,2,1,4,0xb2d32a30d
990000.0,3.0,60,4,4,2,10,0xb2d8ff52
100000.0,1.0,4,3,2,4,9,0xb2d95b16d
1387351.11,6.0,8,4,4,3,11,0xb2d3c610d
380000.81,8.0,5,4,4,3,11,0xb2d07d8d
230.92,1.0,23,1,2,2,5,0xb2d29b73d
1068.84,1.0,92,1,2,1,4,0xb2d2e77ad
200010.42,2.0,20,3,3,2,8,0xb2d9cdc7
180000.83,3.0,0,3,4,4,11,0xb2d3547ed
350327.51,4.0,20,4,4,2,10,0xb2d67eed
126324.14,3.0,76,3,4,1,8,0xb2d437efd
3566.97,1.0,10,2,2,3,7,0xb2d31826d
450303.49,3.0,0,4,4,4,12,0xb2d6abfad
144250.91,7.0,11,3,4,3,10,0x3b9b265bd
347209.13,4.0,28,4,4,2,10,0xb2d45c58
708087.87,4.0,16,4,4,2,10,0xb2d3ae52d
0.0,1.0,77,1,2,1,4,0xb2d4840e
1403.21,1.0,184,1,2,1,4,0xb2d1313ed
11388.52,1.0,5,2,2,3,7,0xb2d30258d
3413.01,1.0,0,2,2,4,8,0xb2d6ed89d
25007.82,3.0,33,2,4,2,8,0xb2d3e99cd
180028.38,2.0,14,3,3,3,9,0xb2d69014
202140.76,2.0,41,3,3,2,8,0xb2d074fa
811373.79,2.0,23,4,3,2,9,0xb2d6e860d
270000.0,5.0,0,3,4,4,11,0xb2d1bb54d
118.72,1.0,0,1,2,4,7,0xb2d6b610d
262755.55,6.0,1,3,4,4,11,0x3b9b3b13
40000.63,4.0,6,2,4,3,9,0xb2d94db8d
297173.16,3.0,4,3,4,4,11,0xb2d3fb4cd
210531.4,6.0,4,3,4,4,11,0xb2d075a7d
150048.13,3.0,61,3,4,2,9,0xb2d484e0
1551.44,1.0,11,1,2,3,6,0xb2d1f748d
50021.73,2.0,92,2,3,1,6,0xb2d3711dd
200000.0,2.0,1,3,3,4,10,0xb2d981d5d
400074.1,3.0,118,4,4,1,9,0xb2d4f188
30.78,1.0,0,1,2,4,7,0xb2d270ded
60003.8,2.0,40,3,3,2,8,0xb2d5b2bbd
46987.92,8.0,1,2,4,4,10,0xb2d23b6c
411114.3,5.0,10,4,4,3,11,0xb2d23dbb
50606.13,2.0,52,2,3,2,7,0xb2d6d791d
73.93,1.0,69,1,2,1,4,0xb2d29a89
50191.11,2.0,184,2,3,1,6,0xb2d1bdbcd
12.81,1.0,4,1,2,4,7,0xb2d92b7f
23.11,1.0,92,1,2,1,4,0xb2d31377
10133.89,2.0,4,2,3,4,9,0xb2d07a72d
1215.47,1.0,25,1,2,2,5,0xb2d6e746
100093.94,1.0,99,3,2,1,6,0xb2d96f83d
17500926.5,2.0,55,4,3,2,9,0xb2d2bf75d
257040.82,6.0,3,3,4,4,11,0xb2d5c1bbd
3593.41,1.0,39,2,2,2,6,0xb2d2a79dd
7.75,2.0,5,1,3,3,7,0x3b9b46fad
16021.1,1.0,2,2,2,4,8,0xb2d6de91d
892012.0,8.0,0,4,4,4,12,0xb2d272ccd
150003.31,4.0,20,3,4,2,9,0xb2d593c1d
12456.07,1.0,13,2,2,3,7,0xb2d64c55
200062.99,2.0,4,3,3,4,10,0xb2d94b61d
1060.15,1.0,23,1,2,2,5,0xb2d9861e
50000.0,1.0,1,2,2,4,8,0xb2da68ee
232836.12,4.0,1,3,4,4,11,0xb2d0c265d
84.77,1.0,26,1,2,2,5,0xb2d2df2c
136556.05,3.0,1,3,4,4,11,0xb2d79172d
16633.39,1.0,9,2,2,3,7,0xb2d3870dd
1008.33,1.0,92,1,2,1,4,0xb2d2c8c6d
109605.93,2.0,52,3,3,2,8,0xb2d32d7ed
723098.76,4.0,18,4,4,2,10,0xb2d23cf1d
20170.77,1.0,19,2,2,2,6,0xb2d57aa4d
404274.33,3.0,8,4,4,3,11,0xb2d6d3e6d
75.36,1.0,11,1,2,3,6,0xb2d5d4ebd
56367.22,2.0,47,3,3,2,8,0xb2d12857
33296.81,1.0,16,2,2,2,6,0xb2d8f23dd
407.31,1.0,9,1,2,3,6,0xb2d137c6
2.03,5.0,67,1,4,1,6,0xb2d193fdd
58000.81,6.0,28,3,4,2,9,0xb2d5be4ed
408247.49,17.0,1,4,4,4,12,0xb2d210e4d
980076.4,4.0,14,4,4,3,11,0xb2d6eef2d
457439.56,5.0,46,4,4,2,10,0xb2d08069d
796.59,2.0,4,1,3,4,8,0xb2d59efd
15.64,1.0,68,1,2,1,4,0xb2d4bd48d
2.81,1.0,32,1,2,2,5,0xb2d0dc36
4676.59,1.0,92,2,2,1,5,0xb2d1d8d8d
254035.05,3.0,14,3,4,3,10,0xb2d3e6b9d
2881.25,1.0,19,1,2,2,5,0xb2d756a6
9704.85,1.0,92,2,2,1,5,0xb2d11b2dd
4914.92,1.0,116,2,2,1,5,0xb2d2fd1ad
2415889.96,14.0,5,4,4,3,11,0xb2d2d317d
366.76,1.0,1,1,2,4,7,0xb2d8e728
2.91,1.0,15,1,2,3,6,0xb2d5ec92
92999.94,3.0,0,3,4,4,11,0x3b9b1800d
5763.51,5.0,184,2,4,1,7,0xb2d2c56ed
20820.48,1.0,1,2,2,4,8,0xb2d642ba
20001.36,2.0,245,2,3,1,6,0xb2d6221c
974.12,1.0,34,1,2,2,5,0xb2d80330
30003.72,3.0,18,2,4,2,8,0x3b9b31bcd
18176.3,1.0,10,2,2,3,7,0xb2d6f1f9d
1030.17,1.0,92,1,2,1,4,0xb2d16437d
641420.2,6.0,37,4,4,2,10,0xb2d15fcbd
5258.78,1.0,184,2,2,1,5,0x3b9b2c92d
6.62,1.0,39,1,2,2,5,0xb2d22ef7d
531974.67,2.0,23,4,3,2,9,0xb2d3a8acd
100047.35,2.0,83,3,3,1,7,0xb2d3c5f6
345262.15,4.0,1,4,4,4,12,0xb2d22225d
122318.61,2.0,27,3,3,2,8,0xb2d34ef4d
9422.55,1.0,1,2,2,4,8,0xb2d2ac1cd
700711.57,5.0,4,4,4,4,12,0xb2d5fc16d
166034.79,4.0,31,3,4,2,9,0xb2d53807d
302145.11,2.0,28,4,3,2,9,0xb2d92f72d
1021.2,1.0,54,1,2,2,5,0xb2d62564
60007.04,2.0,92,3,3,1,7,0xb2d61880d
46423.2,1.0,5,2,2,3,7,0xb2d23913d
11290.99,1.0,9,2,2,3,7,0xb2d3db09d
81164.54,7.0,40,3,4,2,9,0xb2d08fb5
932.69,1.0,2,1,2,4,7,0xb2d1bcbcd
373012.78,3.0,41,4,4,2,10,0xb2d6452dd
1655.87,1.0,16,1,2,2,5,0xb2d3642ed
150379.39,4.0,22,3,4,2,9,0xb2d6e007d
19508.32,3.0,0,2,4,4,10,0xb2d3bb37d
28173.02,1.0,1,2,2,4,8,0xb2d58939d
89492.17,1.0,92,3,2,1,6,0xb2d3c242d
50001.06,2.0,214,2,3,1,6,0xb2d76456
500344.44,8.0,0,4,4,4,12,0xb2d96be8
101001.66,2.0,19,3,3,2,8,0xb2d5ec27d
157503.59,2.0,1,3,3,4,10,0xb2d3496ed
50006.35,4.0,101,2,4,1,7,0xb2d528d0d
361855.88,5.0,16,4,4,2,10,0xb2d5c1c6d
141815.63,1.0,4,3,2,4,9,0xb2d95414d
2021.85,1.0,184,1,2,1,4,0xb2d29f75d
544000.49,4.0,4,4,4,4,12,0xb2d67ee2
2547736.26,6.0,0,4,4,4,12,0xb2d406f9
288708.58,7.0,0,3,4,4,11,0xb2d63291d
12225.88,1.0,8,2,2,3,7,0xb2d685c0d
150007.9,3.0,5,3,4,3,10,0xb2d5f8d6d
51332.76,1.0,184,2,2,1,5,0xb2d38062d
442348.35,8.0,17,4,4,2,10,0xb2d153e5d
857000.45,6.0,10,4,4,3,11,0xb2d19202d
645333.51,4.0,95,4,4,1,9,0xb2d3b89bd
30051.49,1.0,133,2,2,1,5,0xb2d78d1dd
1041.34,1.0,9,1,2,3,6,0xb2d68c95
50006.3,2.0,235,2,3,1,6,0xb2d5e59fd
324514.06,4.0,104,4,4,1,9,0xb2d56d2ed
502171.73,3.0,3,4,4,4,12,0xb2d96099d
10007.89,1.0,14,2,2,3,7,0xb2d4f8cf
20425.47,1.0,19,2,2,2,6,0xb2d46e00d
360071.44,5.0,196,4,4,1,9,0xb2d0dcd3d
50015.75,2.0,1,2,3,4,9,0xb2d6235e
386163.55,5.0,39,4,4,2,10,0xb2d0e007d
21136.23,6.0,3,2,4,4,10,0xb2d1a3e1
904645.74,8.0,18,4,4,2,10,0xb2d38753d
1474.21,1.0,271,1,2,1,4,0xb2d3a92bd
1015.11,1.0,92,1,2,1,4,0xb2d112fad
816350.27,5.0,97,4,4,1,9,0xb2d12896d
1128.36,1.0,184,1,2,1,4,0xb2d5279ad
350011.21,4.0,102,4,4,1,9,0xb2d57b67d
312960.34,4.0,122,4,4,1,9,0xb2d32491d
3503.08,1.0,1,2,2,4,8,0xb2d7010ad
200011.05,2.0,11,3,3,3,9,0xb2d5f173
1268.99,1.0,139,1,2,1,4,0xb2d54fb5
9790.0,1.0,0,2,2,4,8,0xb2d90060
502108.0,3.0,19,4,4,2,10,0xb2d4f6da
3002.92,1.0,1,2,2,4,8,0xb2d78341
10000.92,2.0,70,2,3,1,6,0xb2d61b21
53648.24,1.0,16,3,2,2,7,0xb2d2ffdfd
556430.11,5.0,50,4,4,2,10,0xb2d0d225d
550034.64,6.0,24,4,4,2,10,0xb2d0f852d
1500009.3,2.0,20,4,3,2,9,0xb2d134a0d
200341.18,2.0,231,3,3,1,7,0xb2d56379d
1952.95,1.0,209,1,2,1,4,0xb2d5b313d
353.86,1.0,0,1,2,4,7,0xb2d99e57
5075.47,1.0,92,2,2,1,5,0xb2d10199d
111.41,1.0,47,1,2,2,5,0xb2d570efd
320010.14,3.0,0,4,4,4,12,0xb2d77fb5d
5975.99,1.0,104,2,2,1,5,0xb2d6f2a1d
40000.63,3.0,18,2,4,2,8,0xb2d954b5d
337382.01,2.0,53,4,3,2,9,0xb2d76431d
237000.0,2.0,10,3,3,3,9,0xb2d82621d
50007.87,2.0,94,2,3,1,6,0xb2d57553d
200004.22,2.0,35,3,3,2,8,0xb2d9f569
684001.75,6.0,0,4,4,4,12,0xb2d4c272d
50003.41,2.0,15,2,3,3,8,0xb2d76474d
261119.75,2.0,200,3,3,1,7,0xb2d5b593d
7505.78,1.0,11,2,2,3,7,0xb2d8b1f3d
3081.97,1.0,19,2,2,2,6,0xb2d18708
1021.66,1.0,92,1,2,1,4,0xb2d31617d
1080047.19,7.0,42,4,4,2,10,0xb2d06918d
316794.42,3.0,106,4,4,1,9,0xb2d4ff71d
683.86,1.0,2,1,2,4,7,0xb2d8d533d
85.42,1.0,48,1,2,2,5,0xb2d78f19d
280086.27,2.0,59,3,3,2,8,0xb2d5d154d
10000.11,2.0,56,2,3,2,7,0xb2d9c650
100036.7,2.0,0,3,3,4,10,0xb2d584ab
355552.65,5.0,3,4,4,4,12,0x3b9af109d
230004.63,7.0,0,3,4,4,11,0xb2d60626d
501152.29,3.0,18,4,4,2,10,0xb2d9911d
432622.14,7.0,0,4,4,4,12,0xb2d33ae2d
298000.21,4.0,13,3,4,3,10,0xb2d5eb9ad
133689.9,2.0,235,3,3,1,7,0xb2d4c60b
252015.25,6.0,0,3,4,4,11,0xb2d5e5b3d
1059.47,2.0,92,1,3,1,5,0xb2d06ce3d
1826.17,1.0,6,1,2,3,6,0xb2d95cf1
104654.0,1.0,11,3,2,3,8,0xb2d64a88
2679.61,1.0,0,1,2,4,7,0xb2d8cd46
4801.63,2.0,7,2,3,3,8,0xb2da2f13
28830.91,1.0,0,2,2,4,8,0xb2d25f28d
140.49,1.0,8,1,2,3,6,0xb2d98fa6
18.25,1.0,9,1,2,3,6,0xb2d3450a
550242.28,4.0,87,4,4,1,9,0xb2d432aed
40.19,1.0,3,1,2,4,7,0xb2d78cfcd
605419.76,3.0,84,4,4,1,9,0xb2d60c07
763037.93,11.0,0,4,4,4,12,0xb2d14ee0d
281489.51,3.0,92,3,4,1,8,0xb2d5a0f0d
51945.03,2.0,14,2,3,3,8,0xb2d60d4fd
1447141.04,2.0,39,4,3,2,9,0xb2d9601cd
11897.6,1.0,15,2,2,3,7,0xb2d152d2d
3133.05,2.0,0,2,3,4,9,0xb2d1b02bd
160547.0,2.0,1,3,3,4,10,0xb2d4fb48d
800068.09,5.0,11,4,4,3,11,0xb2d26e5dd
14.15,1.0,11,1,2,3,6,0xb2d3480cd
69586.51,9.0,85,3,4,1,8,0x3b9b4371d
2276.44,1.0,4,1,2,4,7,0xb2da0894
1003.86,1.0,184,1,2,1,4,0xb2d4265d
180055.11,4.0,0,3,4,4,11,0xb2d39482d
500868.35,2.0,0,4,3,4,11,0xb2d51bce
34.44,1.0,9,1,2,3,6,0xb2d301e0d
8049.48,1.0,10,2,2,3,7,0xb2d34074d
8949.84,1.0,1,2,2,4,8,0xb2d6501dd
4098.02,1.0,2,2,2,4,8,0xb2d40fc6
220009.69,11.0,0,3,4,4,11,0xb2d6200ed
374.52,1.0,39,1,2,2,5,0xb2d10546
405240.08,2.0,8,4,3,3,10,0xb2d58e07d
300007.3,5.0,92,3,4,1,8,0xb2d61635d
2514.77,1.0,92,1,2,1,4,0xb2d41cc1d
1926.72,1.0,92,1,2,1,4,0xb2d16c4dd
190677.86,2.0,12,3,3,3,9,0xb2d15284d
212881.88,5.0,41,3,4,2,9,0xb2d10d5dd
537035.07,2.0,116,4,3,1,8,0xb2d3a58dd
1015.57,1.0,92,1,2,1,4,0xb2d0f508
200611.0,6.0,10,3,4,3,10,0xb2d06b59
14.73,2.0,9,1,3,3,7,0xb2d0aef6d
13322.48,1.0,0,2,2,4,8,0xb2d2bcf4d
11543.79,1.0,92,2,2,1,5,0xb2d20954d
61822.77,2.0,47,3,3,2,8,0xb2d5efad
34885.95,5.0,92,2,4,1,7,0xb2d32472d
1622.7,1.0,184,1,2,1,4,0xb2d36d31d
2012.28,1.0,92,1,2,1,4,0xb2d6115cd
1656.08,1.0,3,1,2,4,7,0xb2d803a7d
182000.0,3.0,1,3,4,4,11,0xb2da658a
4835.65,1.0,53,2,2,2,6,0xb2d8c606
78071.15,9.0,1,3,4,4,11,0xb2d1a3e1d
26086.87,1.0,32,2,2,2,6,0xb2d38289d
211.11,1.0,17,1,2,2,5,0xb2da26ce
530048.39,3.0,9,4,4,3,11,0xb2d6d481d
56314.43,1.0,1,3,2,4,9,0xb2d6e802d
60001.9,2.0,32,3,3,2,8,0xb2d9fe17
202132.03,2.0,76,3,3,1,7,0xb2d960c6d
82195.37,1.0,0,3,2,4,9,0xb2d21252
3418.66,1.0,0,2,2,4,8,0xb2d6c828d
868.16,1.0,67,1,2,1,4,0xb2d5a630d
23.31,1.0,0,1,2,4,7,0xb2d6bd36
224966.43,3.0,53,3,4,2,9,0xb2d16deed
1785.25,1.0,10,1,2,3,6,0xb2d3250e
130013.08,1.0,0,3,2,4,9,0xb2d81d34
910000.26,5.0,1,4,4,4,12,0xb2d748bcd
10111.38,1.0,184,2,2,1,5,0xb2d2e253d
324.71,1.0,31,1,2,2,5,0xb2d34593d
360504.05,3.0,123,4,4,1,9,0xb2d38df7d
242563.62,3.0,6,3,4,3,10,0xb2d515dfd
220000.0,2.0,8,3,3,3,9,0xb2da502d
50000.53,2.0,38,2,3,2,7,0xb2d92b30d
900008.49,6.0,10,4,4,3,11,0xb2d1cde4d
780111.92,5.0,7,4,4,3,11,0xb2d8e7c2d
7787.91,2.0,4,2,3,4,9,0xb2d30e48d
3700039.06,2.0,80,4,3,1,8,0xb2d98f5c
410028.55,4.0,46,4,4,2,10,0xb2d68bf2
315404.56,4.0,41,4,4,2,10,0xb2d3d9d3d
27214.97,1.0,0,2,2,4,8,0xb2d6d338
72225.4,3.0,143,3,4,1,8,0xb2d496c6d
761.73,1.0,46,1,2,2,5,0xb2d42e52d
100004.22,2.0,139,3,3,1,7,0xb2d6ec32d
24.9,2.0,78,1,3,1,5,0xb2d0a806d
6384.09,1.0,0,2,2,4,8,0xb2d21245
210249.39,3.0,132,3,4,1,8,0xb2d60930d
1.96,1.0,5,1,2,3,6,0xb2d90382
653280.4,3.0,0,4,4,4,12,0xb2d86eb1
893344.74,4.0,1,4,4,4,12,0xb2d1181bd
20003.09,2.0,80,2,3,1,6,0xb2d5d77fd
2004.18,1.0,208,1,2,1,4,0xb2d783dbd
10024.44,1.0,0,2,2,4,8,0xb2d6ab64
57647.75,1.0,9,3,2,3,8,0xb2d2eccf
4245.15,1.0,1,2,2,4,8,0xb2d38294
166058.04,5.0,89,3,4,1,8,0xb2d0f87b
6675.64,4.0,14,2,4,3,9,0xb2d900f3d
500000.0,2.0,4,4,3,4,11,0xb2d97941d
305614.99,4.0,92,4,4,1,9,0xb2d336fad
29129.92,1.0,39,2,2,2,6,0xb2d8fe52d
100010.01,5.0,76,3,4,1,8,0xb2d625c4d
20.77,1.0,9,1,2,3,6,0xb2d3a45b
50000.53,2.0,14,2,3,3,8,0xb2da378b
155008.72,4.0,10,3,4,3,10,0xb2d5d4f7d
110000.0,2.0,1,3,3,4,10,0xb2da62f5
311681.05,5.0,1,4,4,4,12,0xb2d4292bd
3544.48,1.0,1,2,2,4,8,0xb2d69b4c
1890018.86,17.0,1,4,4,4,12,0xb2d5a1f5
500006.11,3.0,5,4,4,3,11,0xb2d9ea2e
60042.15,3.0,29,3,4,2,9,0xb2d62f4cd
50645.53,1.0,8,2,2,3,7,0xb2d94b93d
70003.17,4.0,18,3,4,2,9,0xb2d92671d
100003.78,2.0,18,3,3,2,8,0xb2d1bde3
510002.32,3.0,34,4,4,2,10,0xb2d931b2d
9400.44,1.0,7,2,2,3,7,0xb2d78768
18265.27,1.0,0,2,2,4,8,0xb2d17d9fd
202132.01,2.0,75,3,3,1,7,0xb2d96360d
30525.62,2.0,179,2,3,1,6,0xb2d5e776d
235194.48,3.0,144,3,4,1,8,0xb2d1e676d
300011.28,2.0,13,3,3,3,9,0xb2d6f8ac
310987.58,4.0,38,4,4,2,10,0xb2d52909
1375013.68,6.0,5,4,4,3,11,0xb2d11eafd
95484.82,3.0,0,3,4,4,11,0x3b9b4217d
96169.69,1.0,0,3,2,4,9,0xb2d151a5
432.75,1.0,139,1,2,1,4,0xb2d5e962d
8207.43,1.0,184,2,2,1,5,0xb2d15f65d
100219.42,1.0,2,3,2,4,9,0xb2d3b625
74.69,1.0,52,1,2,2,5,0xb2d6d3d3
217199.76,2.0,0,3,3,4,10,0xb2d54e40d
109608.71,2.0,92,3,3,1,7,0xb2d0f976d
948387.68,4.0,0,4,4,4,12,0xb2d3153bd
241.76,1.0,0,1,2,4,7,0xb2d20e5d
31944.63,2.0,1,2,3,4,9,0xb2d28b37d
10222.01,1.0,293,2,2,1,5,0xb2d5b5f2d
596.06,1.0,10,1,2,3,6,0xb2d4282d
3733.08,1.0,30,2,2,2,6,0xb2d29f7ad
50001.6,2.0,10,2,3,3,8,0xb2d54b02d
180263.22,2.0,80,3,3,1,7,0xb2d6d9c7d
22374.86,1.0,5,2,2,3,7,0xb2d78777d
40000.63,2.0,0,2,3,4,9,0xb2d1aefed
590012.46,2.0,39,4,3,2,9,0xb2d9f046
2681.37,1.0,0,1,2,4,7,0xb2d6f015
861603.57,3.0,17,4,4,2,10,0xb2d5a502
1620191.14,16.0,0,4,4,4,12,0xb2d0eac6
441449.56,3.0,3,4,4,4,12,0xb2d2c515d
125001.32,2.0,80,3,3,1,7,0xb2d5e9e5d
2514857.11,1.0,13,4,2,3,9,0xb2d3f86ed
2791.56,1.0,23,1,2,2,5,0xb2d61432
601.34,1.0,4,1,2,4,7,0xb2d1d86a
50098.56,2.0,60,2,3,2,7,0xb2d59060d
1008682.26,5.0,0,4,4,4,12,0xb2d2cebdd
204009.4,4.0,40,3,4,2,9,0xb2d451bcd
15389.69,1.0,9,2,2,3,7,0xb2d2928fd
105449.42,2.0,18,3,3,2,8,0xb2d43bb4d
1549.49,1.0,92,1,2,1,4,0xb2d41eb1d
245846.4,6.0,38,3,4,2,9,0xb2d5067dd
500010.01,2.0,25,4,3,2,9,0xb2d93c17
6942.14,1.0,15,2,2,3,7,0xb2d613d1
352486.85,2.0,71,4,3,1,8,0xb2d9a6b2
200022.76,2.0,133,3,3,1,7,0xb2d30bbdd
5534.97,1.0,7,2,2,3,7,0xb2d9e661
480008.5,5.0,6,4,4,3,11,0xb2d172fad
155758.91,2.0,83,3,3,1,7,0xb2d2d4f9d
17361.02,1.0,0,2,2,4,8,0xb2d688f3
230024.1,3.0,6,3,4,3,10,0xb2d109f2d
1774.58,1.0,1,1,2,4,7,0xb2d15a54d
2452.86,1.0,10,1,2,3,6,0xb2d713ded
207114.58,2.0,11,3,3,3,9,0xb2d5f085d
232562.16,3.0,0,3,4,4,11,0xb2d610bad
400002.1,3.0,8,4,4,3,11,0xb2d8db07d
1395918.2,7.0,76,4,4,1,9,0x3b9b3b7d
220014.83,2.0,69,3,3,1,7,0xb2d38649d
1222.95,1.0,0,1,2,4,7,0xb2d407dad
252673.85,2.0,99,3,3,1,7,0xb2d956a6d
301422.07,3.0,42,4,4,2,10,0xb2d9ac54
9143.17,2.0,125,2,3,1,6,0xb2d0a312d
272.41,1.0,19,1,2,2,5,0xb2d32cea
132154.07,3.0,13,3,4,3,10,0xb2d5e426d
316111.27,13.0,0,4,4,4,12,0x3b9ae60dd
121000.0,2.0,0,3,3,4,10,0xb2d4311ad
2752.92,1.0,3,1,2,4,7,0xb2d3e47ed
2701.04,1.0,14,1,2,3,6,0xb2d170d2
16012.29,1.0,0,2,2,4,8,0xb2d6235d
1353971.65,7.0,4,4,4,4,12,0xb2d3baa4d
1.09,1.0,21,1,2,2,5,0xb2d34a71d
2981.31,1.0,5,2,2,3,7,0xb2d53dbe
1085615.01,17.0,0,4,4,4,12,0xb2d14d98d
1134323.87,10.0,3,4,4,4,12,0xb2d13dd1d
130.47,1.0,6,1,2,3,6,0xb2d8eca4
565.32,1.0,9,1,2,3,6,0xb2d40295d
748.62,1.0,0,1,2,4,7,0xb2d8f501
257113.51,2.0,90,3,3,1,7,0xb2d6b771d
2928.57,1.0,184,2,2,1,5,0x3b9aec3fd
75341.01,2.0,0,3,3,4,10,0xb2d1d651d
127.14,1.0,8,1,2,3,6,0xb2d8cfa5
9901.05,1.0,14,2,2,3,7,0xb2d9c793
22075.45,1.0,10,2,2,3,7,0xb2d5cf29d
643117.27,14.0,1,4,4,4,12,0xb2d59b14d
301947.56,1.0,9,4,2,3,9,0xb2d3b696d
50231.88,3.0,0,2,4,4,10,0xb2d69e12d
340000.0,1.0,0,4,2,4,10,0xb2d9833bd
44.51,1.0,88,1,2,1,4,0xb2d5d3f6d
450002.27,3.0,13,4,4,3,11,0xb2d5e3a9d
500048.46,2.0,206,4,3,1,8,0xb2d64c4bd
1671.21,1.0,11,1,2,3,6,0xb2d27541
537740.85,5.0,2,4,4,4,12,0xb2d2c8a7
4760.65,1.0,0,2,2,4,8,0xb2d6b4a8d
0.0,2.0,1,1,3,4,8,0xb2da4bbe
486979.66,4.0,98,4,4,1,9,0xb2d170ccd
7472.94,6.0,0,2,4,4,10,0x3b9b1859
1130765.08,6.0,27,4,4,2,10,0xb2d6378bd
240057.9,2.0,6,3,3,3,9,0xb2d6d327d
114.14,1.0,1,1,2,4,7,0xb2d5c89f
7356.22,1.0,17,2,2,2,6,0xb2d998cd
211.09,1.0,60,1,2,2,5,0xb2d62d43
3300.01,2.0,7,2,3,3,8,0xb2d96c68
43.94,1.0,20,1,2,2,5,0xb2d64dec
1520216.79,1.0,0,4,2,4,10,0xb2d39494d
40000.85,5.0,20,2,4,2,8,0xb2d572d0d
2527.34,1.0,3,1,2,4,7,0xb2d60abf
100022.58,3.0,18,3,4,2,9,0xb2d5cbe4d
143564.74,4.0,0,3,4,4,11,0xb2d435a8
4374.45,1.0,258,2,2,1,5,0xb2d41f33d
400016.74,2.0,27,4,3,2,9,0xb2d5d15d
29227.39,1.0,0,2,2,4,8,0xb2d6894dd
111710.16,1.0,21,3,2,2,7,0xb2d1d0d2d
2943.7,1.0,14,2,2,3,7,0xb2d241d9
9404.06,1.0,1,2,2,4,8,0xb2d2829f
100017.17,2.0,5,3,3,3,9,0xb2d2e749d
1601452.89,8.0,9,4,4,3,11,0xb2d62b7a
22086.15,1.0,0,2,2,4,8,0xb2d69a78d
200000.0,2.0,13,3,3,3,9,0xb2da3f52
6028.78,1.0,92,2,2,1,5,0xb2d5891fd
4264.54,1.0,13,2,2,3,7,0xb2d48919
3261806.24,10.0,1,4,4,4,12,0xb2d5d87a
37562.32,1.0,13,2,2,3,7,0xb2d6a061d
20310.69,2.0,80,2,3,1,6,0xb2d68d02d
5649.94,1.0,0,2,2,4,8,0xb2d69e9c
14577.83,1.0,14,2,2,3,7,0xb2d3191fd
372328.97,2.0,174,4,3,1,8,0xb2d12e76
967.27,2.0,24,1,3,2,6,0xb2d3525ad
50086.9,2.0,59,2,3,2,7,0xb2d58e97d
2.01,1.0,77,1,2,1,4,0xb2d91f5dd
35006.61,3.0,13,2,4,3,9,0xb2d25674
101741.18,3.0,41,3,4,2,9,0xb2d60b24
695779.69,7.0,4,4,4,4,12,0xb2d2d229d
2.11,1.0,0,1,2,4,7,0xb2d39746
100006.23,2.0,139,3,3,1,7,0xb2d61042d
50003.16,2.0,98,2,3,1,6,0xb2d9655bd
373936.64,6.0,1,4,4,4,12,0xb2d64012
5561.94,1.0,184,2,2,1,5,0xb2d3fb4a
352054.76,4.0,36,4,4,2,10,0xb2d0f860d
499.71,1.0,9,1,2,3,6,0xb2d4ab5f
13850.21,1.0,0,2,2,4,8,0xb2d6a9da
400004.22,2.0,92,4,3,1,8,0xb2d4a98cd
515620.99,8.0,21,4,4,2,10,0xb2d0e3e9d
587422.88,4.0,18,4,4,2,10,0xb2d9d842
3.58,1.0,13,1,2,3,6,0xb2d4d4a6
201490.51,2.0,19,3,3,2,8,0xb2d5873ad
215.73,1.0,2,1,2,4,7,0xb2d96ebc
143794.67,3.0,5,3,4,3,10,0x3b9b25d9d
14797.69,1.0,20,2,2,2,6,0xb2d2d62ed
4630.74,1.0,10,2,2,3,7,0xb2d202c0d
50584.24,1.0,13,2,2,3,7,0xb2d3b5be
104963.45,2.0,116,3,3,1,7,0xb2d48e56d
465005.2,1.0,13,4,2,3,9,0xb2d3a227
101529.35,3.0,24,3,4,2,9,0xb2d5cee9d
544914.32,1.0,3,4,2,4,10,0xb2d4edf7d
10000.95,1.0,18,2,2,2,6,0xb2d95bf5d
50002.01,2.0,80,2,3,1,6,0xb2d63316d
7.0,1.0,27,1,2,2,5,0xb2d90f68d
4999.36,1.0,22,2,2,2,6,0xb2d12144d
1173843.05,2.0,74,4,3,1,8,0xb2d6a4b1d
133177.87,3.0,6,3,4,3,10,0xb2d56193
30000.63,2.0,53,2,3,2,7,0xb2d63bfe
200002.11,2.0,48,3,3,2,8,0xb2d6d39cd
1.79,1.0,38,1,2,2,5,0xb2d29562d
194.84,1.0,21,1,2,2,5,0xb2d19a84
252051.01,3.0,63,3,4,2,9,0xb2d24cafd
416042.7,5.0,3,4,4,4,12,0xb2d1b62ed
100100.8,2.0,79,3,3,1,7,0xb2d255ab
790466.36,8.0,11,4,4,3,11,0xb2d3179d
10450.53,1.0,3,2,2,4,8,0xb2d5401c
10076.48,1.0,92,2,2,1,5,0xb2d22ba3d
3380.77,1.0,14,2,2,3,7,0xb2d642e4d
91529.53,1.0,117,3,2,1,6,0xb2d650f0d
500188.96,2.0,10,4,3,3,10,0xb2d64511
19.65,1.0,17,1,2,2,5,0xb2d3225e
211560.13,4.0,11,3,4,3,10,0xb2d346b8
208251.13,13.0,80,3,4,1,8,0xb2d456f7d
164180.6,4.0,42,3,4,2,9,0xb2d3d5b6d
388715.74,1.0,32,4,2,2,8,0xb2d3bca8d
41.31,1.0,8,1,2,3,6,0xb2d7abb5d
29.72,1.0,14,1,2,3,6,0xb2d594a7d
1290.53,1.0,92,1,2,1,4,0xb2d37d45d
856415.92,2.0,0,4,3,4,11,0xb2d0d6e8d
7.38,2.0,69,1,3,1,5,0xb2d1336f
60001.9,2.0,60,3,3,2,8,0xb2d9b939
932000.86,5.0,0,4,4,4,12,0xb2d2394fd
110003.28,3.0,11,3,4,3,10,0xb2d950add
4508.38,1.0,184,2,2,1,5,0xb2d11312d
80532.56,4.0,11,3,4,3,10,0xb2d6dd58d
300000.0,2.0,27,3,3,2,8,0xb2d945b4d
858.28,1.0,1,1,2,4,7,0xb2d5109a
840003.91,3.0,5,4,4,3,11,0xb2d93200d
1192490.42,7.0,4,4,4,4,12,0xb2d3c055d
28406.3,3.0,1,2,4,4,10,0xb2d24ac0d
4000001.3,1.0,1,4,2,4,10,0xb2d97740d
190083.02,4.0,3,3,4,4,11,0xb2d1598ed
1457.75,1.0,2,1,2,4,7,0xb2d29475
275981.57,2.0,0,3,3,4,10,0xb2d1a17fd
1294.34,1.0,184,1,2,1,4,0xb2d263cad
9043.48,1.0,0,2,2,4,8,0xb2d2f6dbd
300710.46,4.0,42,4,4,2,10,0xb2d80ef7d
891083.61,7.0,0,4,4,4,12,0xb2d5b4c1
329226.98,8.0,0,4,4,4,12,0x3b9af1d1d
10025.41,39.0,14,2,4,3,9,0xb2d0fe25d
240053.68,4.0,5,3,4,3,10,0xb2d40f48d
21411.2,1.0,4,2,2,4,8,0xb2d6280cd
244851.95,4.0,0,3,4,4,11,0xb2d0a22ed
10882.11,1.0,38,2,2,2,6,0xb2d57d29d
6000.22,1.0,2,2,2,4,8,0xb2d40bd2d
121.25,1.0,15,1,2,3,6,0xb2d8f59e
116604.5,2.0,14,3,3,3,9,0xb2d6fce8
1.89,1.0,79,1,2,1,4,0xb2d5cfc8
5458.81,1.0,168,2,2,1,5,0xb2d2064ad
160004.01,3.0,32,3,4,2,9,0xb2d97cddd
1761.03,1.0,19,1,2,2,5,0xb2d5d1d3
51965.32,2.0,108,2,3,1,6,0xb2d422a6d
7070.21,1.0,21,2,2,2,6,0xb2d7c079d
504389.93,2.0,76,4,3,1,8,0xb2d60442d
10499.6,1.0,9,2,2,3,7,0xb2d4ec1e
380032.11,2.0,111,4,3,1,8,0xb2d57066d
3726.48,1.0,0,2,2,4,8,0xb2d69165d
967003.44,4.0,84,4,4,1,9,0xb2d07af3d
52.68,47.0,6,1,4,3,8,0xb2d40843
120007.38,4.0,18,3,4,2,9,0xb2d421afd
180001.9,2.0,20,3,3,2,8,0xb2d95107d
320012.55,5.0,143,4,4,1,9,0xb2d4ce56d
74436.77,1.0,14,3,2,3,8,0xb2d2654e
14004.95,1.0,0,2,2,4,8,0xb2d6c0d6d
10.56,1.0,12,1,2,3,6,0xb2d94d23
200026.56,5.0,4,3,4,4,11,0xb2d1227ed
455333.49,4.0,108,4,4,1,9,0xb2d8dca7d
150039.18,2.0,11,3,3,3,9,0xb2d54c6e
2830.01,1.0,0,1,2,4,7,0xb2d6c213
4.9,2.0,4,1,3,4,8,0xb2d247eb
1149.03,1.0,9,1,2,3,6,0xb2d700c5d
400008.44,2.0,59,4,3,2,9,0xb2d8fc95d
10000.26,2.0,31,2,3,2,7,0xb2d92d04d
600000.19,4.0,6,4,4,3,11,0xb2d90c51d
1.76,1.0,36,1,2,2,5,0xb2d8c6e4
101835.45,2.0,8,3,3,3,9,0xb2d2aaced
230950.55,2.0,59,3,3,2,8,0xb2d275b0d
4601.81,1.0,2,2,2,4,8,0xb2d62d82
100000.0,5.0,0,3,4,4,11,0xb2d5eb84
18000105.56,3.0,0,4,4,4,12,0xb2d9572ad
200928.55,2.0,20,3,3,2,8,0xb2d61e32
121271.56,2.0,10,3,3,3,9,0x3b9aef17
1507253.59,9.0,0,4,4,4,12,0xb2d69606d
51004.54,2.0,217,2,3,1,6,0xb2d557c9d
15.79,1.0,63,1,2,2,5,0xb2d37cbc
579.43,1.0,10,1,2,3,6,0xb2d6e6bad
58104.31,2.0,21,3,3,2,8,0xb2d37c7cd
138194.68,3.0,32,3,4,2,9,0xb2d5f561d
33434.69,1.0,4,2,2,4,8,0xb2d9f3e5
3001.71,1.0,9,2,2,3,7,0xb2d8dc1ad
1637.12,1.0,184,1,2,1,4,0xb2d31145d
270021.34,2.0,3,3,3,4,10,0xb2d259b2d
50000.53,2.0,188,2,3,1,6,0xb2d6aa1cd
2.12,1.0,34,1,2,2,5,0xb2d8691bd
0.64,1.0,41,1,2,2,5,0xb2d8d449
50097.31,2.0,136,2,3,1,6,0xb2d6937fd
1187.99,1.0,1,1,2,4,7,0xb2d9398cd
12111.36,1.0,92,2,2,1,5,0xb2d24785
4786.82,1.0,0,2,2,4,8,0xb2d2ebbdd
750743.14,1.0,21,4,2,2,8,0xb2d688d6d
606329.47,5.0,102,4,4,1,9,0xb2d3e7d6d
0.0,1.0,4,1,2,4,7,0xb2d58f9ed
0.0,1.0,8,1,2,3,6,0xb2d97beb
10298.05,1.0,74,2,2,1,5,0xb2d67cebd
121090.54,2.0,35,3,3,2,8,0xb2d95a83
8.57,1.0,3,1,2,4,7,0xb2d459d0d
0.0,1.0,4,1,2,4,7,0xb2da50a9
2121067.37,7.0,0,4,4,4,12,0xb2d160d6d
140003.67,5.0,3,3,4,4,11,0xb2d0eaac
18967.38,1.0,0,2,2,4,8,0xb2d34cfcd
5864.55,1.0,196,2,2,1,5,0xb2d62af2d
360296.26,7.0,13,4,4,3,11,0xb2d51295d
1090013.12,8.0,4,4,4,4,12,0xb2d6eaf4d
30058.18,1.0,92,2,2,1,5,0xb2d8fadd
521181.53,2.0,11,4,3,3,10,0xb2d1b018d
3013.95,1.0,7,2,2,3,7,0xb2d20dc7
5895.84,1.0,92,2,2,1,5,0xb2d33e92d
289062.69,3.0,4,3,4,4,11,0xb2d5a961d
1001085.03,6.0,5,4,4,3,11,0xb2d25fbfd
11076.97,1.0,0,2,2,4,8,0xb2d16687
280013.95,4.0,20,3,4,2,9,0xb2d0f939d
203808.72,2.0,92,3,3,1,7,0xb2d0c609d
40000.84,2.0,59,2,3,2,7,0xb2d8fd12
979723.16,4.0,28,4,4,2,10,0xb2d1fe67
570096.91,4.0,6,4,4,3,11,0xb2d682d3d
166.99,1.0,10,1,2,3,6,0xb2d3ad38
460178.84,11.0,1,4,4,4,12,0xb2d5f6cad
1754803.18,5.0,18,4,4,2,10,0xb2d5cc08
376221.25,8.0,0,4,4,4,12,0xb2d18dcad
1008.69,1.0,184,1,2,1,4,0xb2d35726d
270043.49,2.0,0,3,3,4,10,0xb2d27d95d
15.94,1.0,10,1,2,3,6,0xb2d43c8e
1008.35,1.0,184,1,2,1,4,0xb2d23ff1d
390116.19,9.0,0,4,4,4,12,0xb2d20c0bd
6262.04,1.0,0,2,2,4,8,0xb2d6ad3ad
1417.31,1.0,285,1,2,1,4,0xb2d4d411d
200153.47,2.0,94,3,3,1,7,0xb2d688d7d
304870.49,4.0,1,4,4,4,12,0xb2d3c14f
500150.26,2.0,10,4,3,3,10,0xb2d23ddfd
400004.22,2.0,31,4,3,2,9,0xb2d93851d
15348446.44,2.0,42,4,3,2,9,0xb2d2e73fd
400006.0,2.0,1,4,3,4,11,0xb2d9b7d0
210000.0,3.0,12,3,4,3,10,0xb2d93ef2d
182.55,1.0,4,1,2,4,7,0xb2d2fbe9
80395.92,1.0,144,3,2,1,6,0xb2d6c49a
3200.22,1.0,184,2,2,1,5,0xb2d29094d
28895.13,1.0,0,2,2,4,8,0xb2d3bd14d
130002.02,2.0,0,3,3,4,10,0xb2d81255
50000.53,2.0,27,2,3,2,7,0xb2d942ee
70.36,1.0,32,1,2,2,5,0xb2d9787f
500125.28,2.0,89,4,3,1,8,0xb2d407f3d
3168.31,1.0,10,2,2,3,7,0xb2d6cab5
3000063.33,2.0,8,4,3,3,10,0xb2da4132
17.84,1.0,7,1,2,3,6,0xb2d69f0dd
500108.8,3.0,11,4,4,3,11,0xb2d62799
738010.56,6.0,76,4,4,1,9,0xb2d60ed8d
38.62,1.0,265,1,2,1,4,0xb2d28b13d
10053.67,1.0,92,2,2,1,5,0xb2d2b2b3d
314.17,1.0,22,1,2,2,5,0xb2d6a992d
873.54,1.0,13,1,2,3,6,0xb2d6fb3f
53775.5,1.0,33,3,2,2,7,0xb2d1d8c0d
32.04,1.0,42,1,2,2,5,0xb2d6b4f8
553212.44,5.0,8,4,4,3,11,0xb2d16a48d
7377.59,1.0,18,2,2,2,6,0xb2d63985d
0.0,1.0,14,1,2,3,6,0xb2d61974d
36834.6,2.0,4,2,3,4,9,0xb2d95a48
16.11,1.0,0,1,2,4,7,0xb2d95af1
945018.69,8.0,16,4,4,2,10,0xb2d59408d
26100.0,1.0,0,2,2,4,8,0xb2d55a0f
3223.19,1.0,10,2,2,3,7,0xb2d568dcd
90299.97,2.0,172,3,3,1,7,0xb2d20767d
36037.32,4.0,55,2,4,2,8,0xb2d562cfd
100506.13,2.0,97,3,3,1,7,0xb2d4919ad
911697.12,2.0,139,4,3,1,8,0xb2d1befbd
200019.29,2.0,0,3,3,4,10,0xb2d6788ad
10000.0,1.0,2,2,2,4,8,0xb2d2debe
275.15,1.0,67,1,2,1,4,0xb2d688a0d
832.94,1.0,2,1,2,4,7,0xb2d5dde1d
1763.5,1.0,1,1,2,4,7,0xb2d98373
98002.25,2.0,32,3,3,2,8,0xb2d1c303
3216.95,1.0,7,2,2,3,7,0xb2d643ff
190122.31,2.0,70,3,3,1,7,0xb2d0bb60d
80004.9,2.0,66,3,3,2,8,0xb2d2284cd
303003.2,2.0,45,4,3,2,9,0xb2d90cd9d
10476.47,1.0,188,2,2,1,5,0xb2d2b023d
200961.97,2.0,27,3,3,2,8,0xb2d102bf
460.81,1.0,28,1,2,2,5,0xb2d2ce0e
302.96,2.0,21,1,3,2,6,0xb2d18336
9168.15,1.0,1,2,2,4,8,0xb2d51e77d
2337.77,1.0,19,1,2,2,5,0xb2d2be20d
18552.76,1.0,92,2,2,1,5,0xb2d1228ad
17378.24,1.0,15,2,2,3,7,0xb2d6b845d
2110000.0,11.0,3,4,4,4,12,0xb2d27e5bd
193338.27,2.0,74,3,3,1,7,0xb2d35437d
3272.06,1.0,29,2,2,2,6,0xb2d9254d
1016.24,1.0,184,1,2,1,4,0xb2d108cbd
318066.1,4.0,24,4,4,2,10,0xb2d19780d
107573.11,3.0,228,3,4,1,8,0xb2d07400d
1491863.36,4.0,83,4,4,1,9,0x3b9b2a4cd
1536116.94,7.0,25,4,4,2,10,0xb2d20c06d
100007.68,2.0,24,3,3,2,8,0xb2d2905cd
110018.26,3.0,20,3,4,2,9,0xb2d6badbd
340294.51,5.0,25,4,4,2,10,0xb2d3f5b3d
431122.32,3.0,1,4,4,4,12,0xb2d1fffad
2509.29,1.0,17,1,2,2,5,0xb2d6fa0cd
30827.98,2.0,27,2,3,2,7,0xb2d5ffbfd
2861.33,1.0,184,1,2,1,4,0xb2d19cffd
2.69,1.0,75,1,2,1,4,0xb2d59609d
500036.06,3.0,14,4,4,3,11,0xb2d7ecc0d
303591.9,3.0,5,4,4,3,11,0xb2d5e3be
0.0,1.0,2,1,2,4,7,0xb2d1b675
1172.55,1.0,15,1,2,3,6,0xb2d3231ed
2669.54,1.0,0,1,2,4,7,0xb2d4965e
202068.65,3.0,102,3,4,1,8,0xb2d6584dd
1010.21,1.0,120,1,2,1,4,0xb2d6803ad
1214.52,5.0,34,1,4,2,7,0xb2d16c13d
146082.83,2.0,1,3,3,4,10,0xb2da24dd
7644.15,1.0,92,2,2,1,5,0xb2d3d702d
4.48,1.0,73,1,2,1,4,0xb2d5d0c1
1522.28,1.0,42,1,2,2,5,0xb2d60c08d
36.45,1.0,19,1,2,2,5,0xb2d57eb7d
2.32,1.0,76,1,2,1,4,0xb2d997e7
5213.74,1.0,97,2,2,1,5,0xb2d691a7d
261908.5,4.0,25,3,4,2,9,0xb2d6bb49d
42701.18,2.0,6,2,3,3,8,0xb2d563a1
400063.92,3.0,194,4,4,1,9,0xb2d1ca3ed
351563.24,3.0,12,4,4,3,11,0xb2d07781
8.01,1.0,17,1,2,2,5,0xb2d7f1b7
270044.08,7.0,111,3,4,1,8,0xb2d2b8b0d
405609.71,5.0,7,4,4,3,11,0xb2d4eade
300000.0,2.0,18,3,3,2,8,0xb2da3348
200002.11,3.0,48,3,4,2,9,0xb2d1e300
95003.96,6.0,0,3,4,4,11,0x3b9b1815d
50050.7,2.0,147,2,3,1,6,0xb2d5e407d
19816.26,1.0,4,2,2,4,8,0xb2d0abaf
10001.06,2.0,46,2,3,2,7,0xb2d9dd82
3819.54,1.0,92,2,2,1,5,0xb2d2928ed
27537.01,5.0,0,2,4,4,10,0xb2d51f3c
100001.06,2.0,66,3,3,2,8,0xb2d8f2b2
80080.54,3.0,4,3,4,4,11,0xb2d57358
1131972.55,6.0,0,4,4,4,12,0xb2d2f303
365160.58,4.0,0,4,4,4,12,0xb2d1e0dbd
929216.08,25.0,27,4,4,2,10,0xb2d0b1e8d
217.89,1.0,0,1,2,4,7,0xb2d60a4ed
6818.27,1.0,5,2,2,3,7,0xb2d94ed6
2680088.52,3.0,28,4,4,2,10,0xb2d2ffa9d
39.13,1.0,48,1,2,2,5,0xb2d3a573d
131.55,1.0,34,1,2,2,5,0xb2d5d167d
13162.72,1.0,184,2,2,1,5,0xb2d30f5c
5259.35,1.0,1,2,2,4,8,0xb2d0eb09
300004.01,3.0,12,3,4,3,10,0xb2d94d3bd
550003.35,3.0,137,4,4,1,9,0xb2d62b50
100003.17,2.0,66,3,3,2,8,0xb2d8ecdad
1673.3,1.0,184,1,2,1,4,0xb2d324bfd
1797.49,1.0,10,1,2,3,6,0xb2d63362
266000.0,2.0,0,3,3,4,10,0xb2da6748
507577.04,2.0,46,4,3,2,9,0xb2d3f955
4785.19,1.0,9,2,2,3,7,0xb2d44397
21152.19,1.0,6,2,2,3,7,0xb2d2f7e7d
300000.0,2.0,29,3,3,2,8,0xb2d9ef69
45000.89,3.0,179,2,4,1,7,0xb2d6ac19d
242.06,1.0,10,1,2,3,6,0xb2d92d26
12.57,1.0,12,1,2,3,6,0xb2d62a3a
1020157.37,2.0,92,4,3,1,8,0xb2d59901d
3593.94,2.0,184,2,3,1,6,0x3b9b159ed
571024.35,4.0,0,4,4,4,12,0xb2d601d2d
200019.65,3.0,103,3,4,1,8,0xb2d0862c
317.11,1.0,27,1,2,2,5,0xb2d614b1
1.17,1.0,21,1,2,2,5,0xb2d6a6fa
2127.45,1.0,26,1,2,2,5,0xb2d1289dd
100001.59,3.0,203,3,4,1,8,0xb2d788ea
919038.24,10.0,0,4,4,4,12,0xb2d0fb9bd
1040638.38,4.0,60,4,4,2,10,0xb2d17ed0d
966.14,1.0,55,1,2,2,5,0xb2d6b9eed
1218.12,1.0,9,1,2,3,6,0xb2d68a2dd
50575.15,2.0,46,2,3,2,7,0xb2d90b94d
6276.93,1.0,92,2,2,1,5,0xb2d14e4ed
324761.8,3.0,3,4,4,4,12,0xb2d14b08d
411144.99,5.0,5,4,4,3,11,0xb2d61056
2983.07,1.0,3,2,2,4,8,0xb2d2bc48d
8410.51,1.0,76,2,2,1,5,0xb2d6bea2d
2067.01,1.0,1,1,2,4,7,0xb2d8e7a4d
265057.72,8.0,9,3,4,3,10,0xb2d3dd78d
267.08,1.0,17,1,2,2,5,0xb2d3133dd
210006.94,2.0,0,3,3,4,10,0xb2d57c1fd
266471.2,3.0,43,3,4,2,9,0xb2d678fdd
2139575.74,7.0,0,4,4,4,12,0xb2d5fe55d
30171.24,2.0,185,2,3,1,6,0xb2d5eb26d
240472.8,4.0,4,3,4,4,11,0xb2d58ddc
31018.17,2.0,25,2,3,2,7,0xb2d682aad
2240.82,5.0,0,1,4,4,9,0x3b9b186cd
100001.06,2.0,98,3,3,1,7,0xb2d97062d
501911.95,3.0,6,4,4,3,11,0xb2d07b6d
2562.56,1.0,35,1,2,2,5,0xb2d64407d
2880.97,1.0,92,1,2,1,4,0xb2d2fa27d
772965.8,6.0,66,4,4,2,10,0xb2d1dc8ad
211137.62,2.0,38,3,3,2,8,0xb2d69820d
500000.2,2.0,28,4,3,2,9,0xb2d8c7f8d
4103.55,1.0,1,2,2,4,8,0xb2d6ffb3d
110035.99,2.0,1,3,3,4,10,0xb2d9ca88
4034.02,1.0,3,2,2,4,8,0xb2d6bb6c
74.7,1.0,0,1,2,4,7,0xb2d941f1
12119.85,1.0,92,2,2,1,5,0xb2d28eded
332536.2,4.0,3,4,4,4,12,0xb2d2d09ad
430000.0,2.0,3,4,3,4,11,0xb2d94534d
1000.8,2.0,184,1,3,1,5,0x3b9b142bd
297086.21,3.0,89,3,4,1,8,0xb2d6328dd
67.65,2.0,0,1,3,4,8,0x3b9af23bd
3983933.46,33.0,4,4,4,4,12,0xb2d09ed9d
2574.31,1.0,4,1,2,4,7,0xb2d23a1bd
1.53,1.0,18,1,2,2,5,0xb2d2dbcc
92056.02,4.0,0,3,4,4,11,0xb2d87e7cd
40044.24,1.0,6,2,2,3,7,0xb2d754a9d
1.56,1.0,15,1,2,3,6,0xb2d6a1f8d
284.86,1.0,89,1,2,1,4,0xb2d10103
110003.95,2.0,179,3,3,1,7,0xb2d5ebeed
502.58,1.0,26,1,2,2,5,0xb2d4feabd
531033.2,3.0,11,4,4,3,11,0xb2d5a722d
90.39,1.0,0,1,2,4,7,0xb2d2f27c
312.67,2.0,35,1,3,2,6,0x3b9b4782d
2041.93,1.0,3,1,2,4,7,0xb2d926a9
8384.74,1.0,0,2,2,4,8,0xb2d5c88e
420500.0,1.0,0,4,2,4,10,0xb2d959fbd
1197322.6,5.0,147,4,4,1,9,0xb2d0be5cd
768429.2,9.0,48,4,4,2,10,0xb2d08fb0
100578.02,3.0,18,3,4,2,9,0xb2d1ad97
1826.26,1.0,21,1,2,2,5,0xb2d48cd0
113.52,1.0,14,1,2,3,6,0xb2d32b6d
116.74,1.0,32,1,2,2,5,0xb2d68a12
429019.08,5.0,13,4,4,3,11,0xb2d075dfd
35021.12,2.0,134,2,3,1,6,0xb2d7c743
2861050.22,13.0,0,4,4,4,12,0xb2d3ea51d
1262.72,1.0,92,1,2,1,4,0xb2d27119d
3371.64,1.0,120,2,2,1,5,0xb2d3afa7
1902773.49,2.0,6,4,3,3,10,0xb2d5c391
1724.64,1.0,84,1,2,1,4,0xb2d1fbfbd
236018.83,3.0,67,3,4,1,8,0xb2d53d22d
116.64,1.0,62,1,2,2,5,0xb2d68c6f
2.05,1.0,55,1,2,2,5,0xb2d8f61e
2.72,2.0,42,1,3,2,6,0xb2d14d03
602.91,2.0,0,1,3,4,8,0xb2d0d5c6
80069.03,2.0,154,3,3,1,7,0xb2d4f700
1426606.41,17.0,0,4,4,4,12,0x3b9af221
443000.0,3.0,4,4,4,4,12,0xb2d9fd85
130077.65,3.0,161,3,4,1,8,0xb2d58f9d
163398.33,3.0,14,3,4,3,10,0xb2d61babd
322.3,1.0,50,1,2,2,5,0xb2d8cf80
111187.32,2.0,18,3,3,2,8,0xb2d34559d
0.0,2.0,8,1,3,3,7,0xb2d56af6
286304.47,14.0,0,3,4,4,11,0xb2d3f507d
716666.66,12.0,0,4,4,4,12,0xb2d9992f
331649.6,3.0,75,4,4,1,9,0xb2d33e3cd
6136.51,1.0,7,2,2,3,7,0xb2d6ebced
65519.44,1.0,10,3,2,3,8,0xb2d30ea8d
41.7,1.0,56,1,2,2,5,0xb2d23403
30275.54,1.0,92,2,2,1,5,0xb2d0eeaad
100004.35,3.0,154,3,4,1,8,0xb2d57927d
2187.08,1.0,56,1,2,2,5,0xb2d4df5cd
100297.56,3.0,2,3,4,4,11,0xb2d25b1ad
1634.7,1.0,9,1,2,3,6,0xb2d9417b
1.06,1.0,74,1,2,1,4,0xb2d8e1c7d
1254.28,1.0,184,1,2,1,4,0xb2d5c5a2d
503552.73,3.0,5,4,4,3,11,0xb2d8e19cd
5047.64,5.0,16,2,4,2,8,0xb2d38e87
242023.84,7.0,0,3,4,4,11,0xb2d33400d
16.9,1.0,1,1,2,4,7,0xb2d771a0
9846.77,1.0,15,2,2,3,7,0xb2d9b2e6
2385.84,1.0,5,1,2,3,6,0xb2d2c715d
500000.04,2.0,27,4,3,2,9,0xb2d9bc92
3103.91,1.0,238,2,2,1,5,0xb2d2e742d
2357.01,2.0,46,1,3,2,6,0xb2d3281ad
202217.02,1.0,0,3,2,4,9,0xb2d26eea
314393.8,6.0,42,4,4,2,10,0xb2d10b60d
3713.36,1.0,9,2,2,3,7,0xb2d8c6d9
200753.54,5.0,38,3,4,2,9,0xb2d64281d
726090.89,2.0,231,4,3,1,8,0xb2d53c62d
18821.55,2.0,0,2,3,4,9,0x3b9af27f
50874.19,2.0,171,2,3,1,6,0xb2d50d46d
1244.92,1.0,184,1,2,1,4,0xb2d2c8ef
1761.92,1.0,2,1,2,4,7,0xb2d838da
404917.89,4.0,41,4,4,2,10,0xb2d2b676d
30450.14,2.0,165,2,3,1,6,0xb2d644f5d
790007.78,7.0,29,4,4,2,10,0xb2d520fbd
67.18,1.0,5,1,2,3,6,0xb2d3c115d
992.13,1.0,9,1,2,3,6,0xb2d698f3d
266.04,1.0,5,1,2,3,6,0xb2d6be14d
14161.79,1.0,10,2,2,3,7,0xb2d90040d
524008.03,9.0,4,4,4,4,12,0xb2d3c5edd
200111.08,2.0,56,3,3,2,8,0xb2d59168
230332.83,3.0,0,3,4,4,11,0xb2d579c6d
0.09,2.0,24,1,3,2,6,0xb2d181d4d
261527.94,3.0,6,3,4,3,10,0xb2d6ce1dd
1739.59,1.0,92,1,2,1,4,0xb2d34cecd
315509.1,2.0,129,4,3,1,8,0xb2d8f1a2d
21841.12,1.0,0,2,2,4,8,0xb2d4aa3ed
4562.7,1.0,20,2,2,2,6,0xb2d6ba80
2741.09,2.0,0,1,3,4,8,0xb2d8cd62
36914.13,2.0,4,2,3,4,9,0xb2d0c1f3d
1119.28,4.0,0,1,4,4,9,0xb2d09de8
2256.3,1.0,23,1,2,2,5,0xb2d3b81e
35187.27,1.0,0,2,2,4,8,0xb2d34216d
1016.37,1.0,92,1,2,1,4,0xb2d31d9cd
104517.29,2.0,168,3,3,1,7,0xb2d388e1d
550888.36,3.0,26,4,4,2,10,0xb2d651a0d
4.44,1.0,36,1,2,2,5,0xb2d593fc
1120000.25,4.0,0,4,4,4,12,0xb2d956c5
159015.03,2.0,136,3,3,1,7,0xb2d1867bd
120003.59,3.0,92,3,4,1,8,0xb2d64627d
3733.57,1.0,293,2,2,1,5,0xb2d3ed94d
170094.56,4.0,11,3,4,3,10,0xb2d0c143d
200752.3,2.0,14,3,3,3,9,0xb2d6dbbad
274.9,1.0,0,1,2,4,7,0xb2d906ced
550001.12,3.0,2,4,4,4,12,0xb2d916d0d
250094.48,2.0,0,3,3,4,10,0xb2d6269cd
5394.97,1.0,25,2,2,2,6,0xb2d93995d
51387.95,2.0,6,2,3,3,8,0xb2d5d49ad
748.58,1.0,31,1,2,2,5,0xb2d32ce2d
2503.38,1.0,8,1,2,3,6,0xb2d2da6fd
95.66,1.0,2,1,2,4,7,0xb2d24a13
29.77,1.0,25,1,2,2,5,0xb2d92f4e
80004.22,2.0,27,3,3,2,8,0xb2d93b7ed
107.92,1.0,29,1,2,2,5,0xb2d49e82
34072.36,1.0,18,2,2,2,6,0xb2d5cef0d
8165.19,2.0,184,2,3,1,6,0x3b9b17f0d
31022.74,2.0,34,2,3,2,7,0xb2d24c7ad
1907953.82,6.0,28,4,4,2,10,0xb2d63309d
1252.6,1.0,38,1,2,2,5,0xb2d2d6ddd
1561016.5,2.0,172,4,3,1,8,0xb2d8d799d
141057.51,5.0,18,3,4,2,9,0xb2d62760d
700005.49,10.0,0,4,4,4,12,0xb2d57a92d
15000.32,2.0,38,2,3,2,7,0xb2d9282bd
19.42,1.0,0,1,2,4,7,0xb2d6f09c
450079.26,5.0,0,4,4,4,12,0xb2d90d3ad
200710.42,2.0,31,3,3,2,8,0xb2d93ef0d
2477.16,1.0,27,1,2,2,5,0xb2d2d316d
70026.33,4.0,6,3,4,3,10,0xb2d918ecd
3233473.47,70.0,1,4,4,4,12,0xb2d24852
553144.49,6.0,0,4,4,4,12,0xb2d5f0b5d
73314.97,3.0,0,3,4,4,11,0xb2d08a57d
660000.38,4.0,3,4,4,4,12,0xb2d937b5d
2270692.34,1.0,0,4,2,4,10,0xb2d2f872
2879.5,2.0,92,1,3,1,5,0xb2d104a9d
110000.0,2.0,1,3,3,4,10,0xb2d938ea
85506.41,4.0,13,3,4,3,10,0xb2d0ca6ad
1017.05,1.0,184,1,2,1,4,0xb2d1b8fdd
60744.86,1.0,6,3,2,3,8,0xb2d3c1be
987479.75,8.0,6,4,4,3,11,0xb2d1e92dd
110082.84,3.0,0,3,4,4,11,0xb2d5cb58d
245010.34,3.0,97,3,4,1,8,0xb2d69014d
300000.63,2.0,9,3,3,3,9,0xb2d92855d
50000.95,2.0,1,2,3,4,9,0xb2d6f6ff
251164.4,5.0,13,3,4,3,10,0xb2d1b886d
440.14,1.0,22,1,2,2,5,0xb2d1d440
116704.56,3.0,0,3,4,4,11,0xb2d2113b
1451.63,1.0,184,1,2,1,4,0xb2d3676cd
5064.57,1.0,92,2,2,1,5,0xb2d3239cd
833.8,1.0,4,1,2,4,7,0xb2d081fad
10945.72,1.0,13,2,2,3,7,0xb2d34815
7000849.72,2.0,21,4,3,2,9,0xb2d93d8ed
1537244.03,8.0,6,4,4,3,11,0xb2d0d404d
142188.94,2.0,84,3,3,1,7,0x3b9af6ead
760119.19,6.0,6,4,4,3,11,0xb2d28c7dd
27.31,1.0,5,1,2,3,6,0xb2d15676
305155.08,3.0,28,4,4,2,10,0xb2d41719d
11455.0,1.0,1,2,2,4,8,0xb2d91cc7d
3401.24,1.0,13,2,2,3,7,0xb2d27393d
305818.12,3.0,46,4,4,2,10,0xb2d0adb0d
1483.39,1.0,8,1,2,3,6,0xb2d6f50d
3175.9,2.0,184,2,3,1,6,0xb2d55401
538979.59,3.0,0,4,4,4,12,0xb2d62135d
130004.22,1.0,2,3,2,4,9,0xb2d9384bd
400140.02,3.0,16,4,4,2,10,0xb2d56dd3
460034.01,4.0,3,4,4,4,12,0xb2d93140
233712.29,1.0,0,3,2,4,9,0xb2d90f9bd
602131.3,4.0,42,4,4,2,10,0xb2d91b7dd
209533.7,3.0,8,3,4,3,10,0x3b9b0fa6d
250088.02,2.0,4,3,3,4,10,0xb2d93068d
23000.73,2.0,31,2,3,2,7,0xb2d936fbd
14505.65,1.0,92,2,2,1,5,0xb2d24423d
121.05,1.0,25,1,2,2,5,0xb2d34983d
5648.56,1.0,92,2,2,1,5,0xb2d275bed
500076.13,2.0,15,4,3,3,10,0xb2d911c6
10014.14,1.0,7,2,2,3,7,0xb2d912efd
939614.58,3.0,4,4,4,4,12,0xb2d20e23d
270014.27,3.0,209,3,4,1,8,0xb2d0e9f1d
128764.64,3.0,104,3,4,1,8,0xb2d57f1bd
405618.71,3.0,8,4,4,3,11,0xb2d772c4d
150396.08,1.0,3,3,2,4,9,0xb2d1e8b8d
112.92,1.0,33,1,2,2,5,0xb2d91e5c
103254.62,1.0,8,3,2,3,8,0xb2d1afbc
37.9,1.0,21,1,2,2,5,0xb2d2d244d
500042.65,2.0,70,4,3,1,8,0xb2d2130ad
487023.95,7.0,5,4,4,3,11,0xb2d10643d
3417.56,2.0,92,2,3,1,6,0xb2d09501d
207336.0,4.0,49,3,4,2,9,0xb2d439efd
0.0,1.0,0,1,2,4,7,0xb2d53809d
6405.25,1.0,19,2,2,2,6,0xb2d904afd
3001.38,1.0,0,2,2,4,8,0xb2d78341d
1000010.15,3.0,0,4,4,4,12,0xb2d7842c
524091.7,17.0,0,4,4,4,12,0x3b9ae469d
3.56,1.0,6,1,2,3,6,0xb2d5cc31d
482373.55,4.0,0,4,4,4,12,0xb2d1cd57d
200000.06,2.0,3,3,3,4,10,0xb2d8f297d
100002.21,4.0,6,3,4,3,10,0xb2d92411d
19.62,1.0,17,1,2,2,5,0xb2d6d8ca
102004.99,2.0,1,3,3,4,10,0xb2d6aedbd
17113.3,1.0,15,2,2,3,7,0xb2d3ef5e
10100.73,1.0,92,2,2,1,5,0xb2d28881d
23.17,1.0,18,1,2,2,5,0xb2d174b1d
66.27,1.0,10,1,2,3,6,0xb2d63aa2
1530000.0,1.0,5,4,2,3,9,0xb2d9017ad
321124.89,9.0,0,4,4,4,12,0x3b9b1867d
170089.08,3.0,0,3,4,4,11,0xb2d93927d
72.83,1.0,76,1,2,1,4,0xb2d070a5
133513.29,2.0,92,3,3,1,7,0xb2d34d50d
142917.24,2.0,116,3,3,1,7,0xb2d122ecd
17.94,1.0,80,1,2,1,4,0xb2d8571f
40608.83,1.0,25,2,2,2,6,0xb2d92508d
110002.32,2.0,45,3,3,2,8,0xb2d91926
1006.31,1.0,0,1,2,4,7,0xb2d8eabc
16181.18,1.0,5,2,2,3,7,0xb2d935f7d
1410.41,1.0,92,1,2,1,4,0xb2d165ead
1590.59,1.0,9,1,2,3,6,0xb2d306d1
28001.1,3.0,116,2,4,1,7,0xb2d6c36ad
80085.52,3.0,52,3,4,2,9,0xb2d59124d
530000.0,4.0,6,4,4,3,11,0xb2d0e707
0.11,1.0,46,1,2,2,5,0xb2d2bf5fd
250005.29,3.0,101,3,4,1,8,0xb2d075c0d
790650.49,5.0,18,4,4,2,10,0xb2d8d37cd
6110.14,1.0,5,2,2,3,7,0xb2d787b0
33.24,1.0,48,1,2,2,5,0xb2d5e5b5d
1.63,1.0,47,1,2,2,5,0xb2d16d7ad
34932.44,1.0,10,2,2,3,7,0xb2d52c56d
500005.28,2.0,45,4,3,2,9,0xb2d91b72d
314.13,1.0,14,1,2,3,6,0xb2d93c6f
183072.63,2.0,256,3,3,1,7,0xb2d52b18d
200003.17,2.0,41,3,3,2,8,0xb2d9107dd
7031.22,2.0,53,2,3,2,7,0xb2d90d77d
301179.03,6.0,32,4,4,2,10,0x3b9b29cbd
8096.75,1.0,206,2,2,1,5,0xb2d411fbd
3203.39,1.0,184,2,2,1,5,0xb2d0f0dfd
62.72,1.0,2,1,2,4,7,0xb2d8fa78d
100004.22,2.0,47,3,3,2,8,0xb2d911bed
200732.47,2.0,4,3,3,4,10,0xb2d62ea8d
50003.34,2.0,188,2,3,1,6,0xb2d62a21d
2003.74,1.0,91,1,2,1,4,0xb2d22a8dd
402131.49,3.0,32,4,4,2,10,0xb2d8fba4d
20230.53,2.0,67,2,3,1,6,0xb2d8e09e
16.41,3.0,27,1,4,2,7,0xb2d90879
808252.74,9.0,0,4,4,4,12,0xb2d069e9d
2215.27,2.0,184,1,3,1,5,0xb2d1ff8ad
1734.16,1.0,92,1,2,1,4,0xb2d162c0d
420000.0,7.0,3,4,4,4,12,0xb2d5c4c8
69060.91,1.0,140,3,2,1,6,0xb2d43570
245667.01,3.0,39,3,4,2,9,0xb2d558cfd
1600791.73,4.0,5,4,4,3,11,0xb2d43a70
15.83,1.0,34,1,2,2,5,0xb2d92c40d
10098.19,1.0,92,2,2,1,5,0xb2d2a43e
0.0,2.0,28,1,3,2,6,0xb2d93f93
50073.45,2.0,27,2,3,2,7,0xb2d0fd9ad
182848.86,22.0,0,3,4,4,11,0xb2d1d88cd
102044.0,2.0,20,3,3,2,8,0xb2d459c7d
501776.04,2.0,4,4,3,4,11,0xb2d9349bd
349149.3,1.0,0,4,2,4,10,0xb2d9155a
500002.65,3.0,19,4,4,2,10,0xb2d65a0ad
1693.18,1.0,288,1,2,1,4,0xb2d42ba9d
100004.22,2.0,48,3,3,2,8,0xb2d91023d
100017.77,2.0,41,3,3,2,8,0xb2d6e03fd
1004891.49,3.0,4,4,4,4,12,0xb2d655c6d
37003.61,3.0,6,2,4,3,9,0xb2d2236ed
580105.71,2.0,4,4,3,4,11,0xb2d69c1f
1093.45,3.0,92,1,4,1,6,0x3b9ae146
35000654.78,3.0,27,4,4,2,10,0xb2d93bfad
120008.93,2.0,52,3,3,2,8,0xb2d8fedad
52824.36,1.0,1,3,2,4,9,0xb2d1b53ed
648626.26,3.0,0,4,4,4,12,0xb2d90183
9522.68,1.0,10,2,2,3,7,0xb2d6c5a1
145012.22,3.0,4,3,4,4,11,0xb2d1273ed
21.78,1.0,0,1,2,4,7,0xb2d557c4d
171238.41,5.0,0,3,4,4,11,0xb2d0d2a2
5239.51,1.0,39,2,2,2,6,0xb2d54836d
2898.72,1.0,77,2,2,1,5,0xb2d3b8b4d
198.42,1.0,9,1,2,3,6,0xb2d2f1add
8556.5,1.0,13,2,2,3,7,0xb2d6b997d
272001.24,3.0,63,3,4,2,9,0xb2d5bf8cd
1136718.96,7.0,4,4,4,4,12,0x3b9ae933
412955.23,2.0,72,4,3,1,8,0xb2d6b668d
4.43,1.0,28,1,2,2,5,0xb2d33f0cd
9794.89,1.0,3,2,2,4,8,0xb2d92cc7d
41.17,1.0,29,1,2,2,5,0xb2d8fb1f
300015.96,3.0,217,3,4,1,8,0xb2d1801f
417566.89,6.0,3,4,4,4,12,0xb2d178f4d
4249.7,1.0,10,2,2,3,7,0xb2d8ee60d
501072.06,3.0,16,4,4,2,10,0xb2d6e58ad
138592.48,7.0,4,3,4,4,11,0xb2d124d8d
1009.27,1.0,25,1,2,2,5,0xb2d58b93d
11425.11,1.0,0,2,2,4,8,0xb2d907add
50002.64,2.0,26,2,3,2,7,0xb2d93f12d
100.17,1.0,10,1,2,3,6,0xb2d93a8f
100000.0,1.0,2,3,2,4,9,0xb2d924f6
31.45,1.0,19,1,2,2,5,0xb2d937a7
1837.58,1.0,10,1,2,3,6,0xb2d68072d
350000.01,8.0,0,4,4,4,12,0xb2d59ebed
365000.0,2.0,8,4,3,3,10,0xb2d91b2ad
30481.46,2.0,4,2,3,4,9,0xb2d5cb81
454227.71,4.0,67,4,4,1,9,0xb2d5f157d
2.11,1.0,9,1,2,3,6,0xb2d92be9
10000.11,2.0,55,2,3,2,7,0xb2d90468d
146277.1,3.0,3,3,4,4,11,0xb2d50eac
2654.38,1.0,2,1,2,4,7,0xb2d8caccd
7108.95,1.0,5,2,2,3,7,0xb2d27030d
200044.83,2.0,1,3,3,4,10,0xb2d1d454d
6301.49,1.0,26,2,2,2,6,0xb2d75ac6d
726043.54,13.0,0,4,4,4,12,0xb2d0cd5ed
28.0,2.0,39,1,3,2,6,0xb2d8de13
311199.16,2.0,19,4,3,2,9,0xb2d938cd
61.32,1.0,0,1,2,4,7,0xb2d5e93b
1031049.98,23.0,1,4,4,4,12,0xb2d16b79d
136979.18,3.0,8,3,4,3,10,0xb2d196b6d
28016.16,1.0,20,2,2,2,6,0xb2d60aced
2959004.9,12.0,0,4,4,4,12,0xb2d59814d
165710.15,1.0,0,3,2,4,9,0xb2d92319d
324217.82,2.0,0,4,3,4,11,0xb2d210a8d
445650.16,3.0,0,4,4,4,12,0xb2d26703d
380000.0,2.0,3,4,3,4,11,0xb2d91d2ed
360799.37,4.0,0,4,4,4,12,0xb2d0b600d
47.15,2.0,14,1,3,3,7,0xb2d0b883
702266.29,1.0,4,4,2,4,10,0xb2d5ad31d
3.28,1.0,32,1,2,2,5,0xb2d92b59
88.67,1.0,62,1,2,2,5,0xb2d43520
1029.63,1.0,13,1,2,3,6,0xb2d33b6ed
254007.25,6.0,31,3,4,2,9,0xb2d28062d
993540.38,1.0,4,4,2,4,10,0xb2d438bdd
208.34,1.0,10,1,2,3,6,0xb2d8c419d
70002.22,2.0,31,3,3,2,8,0xb2d9355b
1200753.06,16.0,1,4,4,4,12,0xb2d428a6d
1015.44,1.0,184,1,2,1,4,0xb2d10351d
100001.06,2.0,52,3,3,2,8,0xb2d90c8a
167.83,1.0,13,1,2,3,6,0xb2d90d0e
813027.6,4.0,1,4,4,4,12,0xb2d5ac81
2062.14,1.0,56,1,2,2,5,0xb2d1fcd3d
379.51,1.0,1,1,2,4,7,0xb2d3f15b
4276.37,1.0,21,2,2,2,6,0xb2d51c2dd
1401.4,1.0,10,1,2,3,6,0xb2d68bf7d
10.12,1.0,39,1,2,2,5,0xb2d11f13
453198.14,3.0,26,4,4,2,10,0xb2d6b973
50456.41,1.0,120,2,2,1,5,0xb2d1c717d
6028.9,1.0,0,2,2,4,8,0xb2d36be4d
80051.8,2.0,24,3,3,2,8,0xb2d2a975d
947620.57,4.0,25,4,4,2,10,0xb2d113d0d
62019.86,3.0,92,3,4,1,8,0xb2d63b65d
2.43,1.0,32,1,2,2,5,0xb2d93882d
1993067.57,8.0,10,4,4,3,11,0xb2d11832d
3487.73,1.0,14,2,2,3,7,0xb2d6dd13d
453985.47,13.0,0,4,4,4,12,0xb2d1fc85d
278.49,1.0,0,1,2,4,7,0xb2d90786d
1267.74,1.0,209,1,2,1,4,0xb2d6ee8dd
220063.8,2.0,19,3,3,2,8,0xb2d58db1d
1485.5,1.0,219,1,2,1,4,0xb2d46ffdd
46811.03,1.0,184,2,2,1,5,0xb2d2b3c2d
5667.79,1.0,43,2,2,2,6,0xb2d6d4cbd
200310.99,5.0,0,3,4,4,11,0xb2d5bd1cd
20000.84,2.0,34,2,3,2,7,0xb2d930c6d
3601.14,1.0,39,2,2,2,6,0xb2d92cfa
3668.58,1.0,9,2,2,3,7,0xb2d6ffb9
500052.78,1.0,19,4,2,2,8,0xb2d93ec4d
602132.59,3.0,22,4,4,2,10,0xb2d90cc6
953.72,1.0,76,1,2,1,4,0xb2d697add
0.0,1.0,6,1,2,3,6,0xb2d93daa
293825.57,1.0,0,3,2,4,9,0xb2d20658d
180000.9,2.0,28,3,3,2,8,0xb2d6543f
300.19,1.0,82,1,2,1,4,0xb2d17730
160022.84,4.0,102,3,4,1,8,0xb2d6013ed
2.02,1.0,62,1,2,2,5,0xb2d53527
8927.09,1.0,5,2,2,3,7,0xb2d32839
5649.3,1.0,92,2,2,1,5,0xb2d0b5fe
120601.69,2.0,25,3,3,2,8,0xb2d26b65d
879.56,1.0,139,1,2,1,4,0xb2d0b741d
500076.06,2.0,13,4,3,3,10,0xb2d91f86
200019.67,4.0,118,3,4,1,8,0xb2d5aa26d
216951.8,5.0,73,3,4,1,8,0xb2d154ad
170007.18,3.0,20,3,4,2,9,0xb2d91e3cd
401420.83,2.0,4,4,3,4,11,0xb2d93798d
1674.01,1.0,6,1,2,3,6,0xb2d289aed
616656.91,4.0,90,4,4,1,9,0xb2d21fe7d
437999.35,2.0,9,4,3,3,10,0xb2d91572
101554.94,1.0,10,3,2,3,8,0xb2d39a12
303020.0,8.0,3,4,4,4,12,0xb2d410e2
257094.82,3.0,153,3,4,1,8,0xb2d60383d
4233.2,1.0,23,2,2,2,6,0xb2d2e439d
0.58,1.0,25,1,2,2,5,0xb2d10fa7
12.6,1.0,39,1,2,2,5,0xb2d48699d
12.17,1.0,26,1,2,2,5,0xb2d6c2a0
1279669.98,8.0,25,4,4,2,10,0xb2d283ead
97938.31,3.0,0,3,4,4,11,0xb2d4ac4ed
102.01,2.0,29,1,3,2,6,0xb2d1266ed
15422.29,2.0,92,2,3,1,6,0x3b9b19ccd
1035.57,1.0,237,1,2,1,4,0xb2d5f641d
200715.12,2.0,147,3,3,1,7,0xb2d617e2d
2756.31,1.0,1,1,2,4,7,0xb2d9197b
20000.42,2.0,47,2,3,2,7,0xb2d9134b
50.58,1.0,12,1,2,3,6,0xb2d1d66dd
342522.8,5.0,19,4,4,2,10,0xb2d5c35bd
0.0,1.0,4,1,2,4,7,0xb2d6f257
202843.51,2.0,147,3,3,1,7,0xb2d6e378d
70547.11,1.0,4,3,2,4,9,0xb2d288a3d
701079.76,5.0,6,4,4,3,11,0xb2d627ddd
100001.01,3.0,20,3,4,2,9,0x3b9b0e52
1010.38,1.0,92,1,2,1,4,0xb2d45e8dd
23245.31,2.0,102,2,3,1,6,0xb2d538ccd
7965868.22,3.0,11,4,4,3,11,0xb2d5519ad
15035.87,1.0,25,2,2,2,6,0xb2d336dcd
499018.3,4.0,3,4,4,4,12,0xb2d5b7a9
623936.27,2.0,1,4,3,4,11,0xb2d3bb51
2662176.86,6.0,43,4,4,2,10,0xb2d59702d
0.27,1.0,0,1,2,4,7,0xb2d92e5ad
3800.96,1.0,33,2,2,2,6,0xb2d93ab7d
31800.28,2.0,13,2,3,3,8,0xb2d42be2
500000.01,3.0,4,4,4,4,12,0xb2d94049
200000.42,2.0,24,3,3,2,8,0xb2d90688d
250104.25,2.0,1,3,3,4,10,0xb2d8ffa4d
1004.73,1.0,184,1,2,1,4,0xb2d58cddd
82.82,1.0,25,1,2,2,5,0xb2d9325dd
52050.37,2.0,119,2,3,1,6,0xb2d40fa1d
91068.45,2.0,25,3,3,2,8,0xb2d39a0e
2035355.68,4.0,10,4,4,3,11,0x3b9b44b6d
120012.07,3.0,74,3,4,1,8,0xb2d919d0d
200007.12,5.0,73,3,4,1,8,0xb2d6496bd
802842.66,2.0,11,4,3,3,10,0xb2d8e424d
3154.01,1.0,5,2,2,3,7,0xb2d902a2
260650.16,6.0,18,3,4,2,9,0xb2d1dd56
72.39,1.0,42,1,2,2,5,0xb2d93d88
301052.01,2.0,29,4,3,2,9,0xb2d928f7d
550468.0,4.0,0,4,4,4,12,0xb2d6e2b3d
10590.11,1.0,7,2,2,3,7,0xb2d28424d
9141.55,1.0,92,2,2,1,5,0xb2d39b9cd
181655.47,3.0,27,3,4,2,9,0xb2d921bfd
1950.64,1.0,25,1,2,2,5,0xb2d5730bd
9466.11,1.0,4,2,2,4,8,0xb2d65e37d
10254.43,2.0,18,2,3,2,7,0xb2d937ded
1170014.63,7.0,27,4,4,2,10,0xb2d12e9cd
70805.83,2.0,32,3,3,2,8,0xb2d9287fd
284004.75,3.0,66,3,4,2,9,0xb2d5a765d
10008.32,2.0,0,2,3,4,9,0xb2d90787d
161071.6,2.0,53,3,3,2,8,0xb2d3aeb1
250116.28,2.0,55,3,3,2,8,0xb2d2df42d
257112.4,2.0,105,3,3,1,7,0xb2d6cd1dd
288761.41,6.0,90,3,4,1,8,0x3b9b247ed
643002.79,7.0,55,4,4,2,10,0xb2d1bc62
166266.09,2.0,42,3,3,2,8,0xb2d2cb5cd
17.31,1.0,33,1,2,2,5,0xb2d92bb4
1194052.53,4.0,48,4,4,2,10,0xb2d5366dd
255152.26,1.0,0,3,2,4,9,0xb2d65282d
11079.89,1.0,5,2,2,3,7,0xb2d3155cd
150609.51,2.0,6,3,3,3,9,0xb2d90f73
4868.38,1.0,12,2,2,3,7,0xb2d92fb6
7093.65,1.0,1,2,2,4,8,0xb2d91fc7
260170.83,2.0,8,3,3,3,9,0xb2d834f9d
401359.86,6.0,4,4,4,4,12,0xb2d90227d
0.0,1.0,3,1,2,4,7,0xb2d25f8f
501776.04,2.0,31,4,3,2,9,0xb2d92d28d
152.83,1.0,0,1,2,4,7,0xb2d1a385d
3025.43,1.0,11,2,2,3,7,0xb2d1a880d
472289.71,6.0,11,4,4,3,11,0xb2d0d7d3d
3158.44,1.0,5,2,2,3,7,0xb2d938e4
551126.81,3.0,25,4,4,2,10,0xb2d91208
100002.11,2.0,38,3,3,2,8,0xb2d92983d
100002.12,2.0,66,3,3,2,8,0xb2d8ea9c
380070.73,4.0,132,4,4,1,9,0xb2d113dbd
2044.62,1.0,7,1,2,3,6,0xb2d31c35d
1338074.34,3.0,25,4,4,2,10,0xb2d53c37
862.9,1.0,24,1,2,2,5,0xb2d26dc8
351243.23,2.0,31,4,3,2,9,0xb2d93f19d
170381.09,7.0,48,3,4,2,9,0xb2d0ff7dd
12000.0,1.0,7,2,2,3,7,0xb2d93535
0.0,1.0,3,1,2,4,7,0xb2d9325f
290060.56,4.0,12,3,4,3,10,0xb2d92036d
2295.22,1.0,9,1,2,3,6,0xb2d91f46
3485.44,1.0,5,2,2,3,7,0xb2d90c5b
141616.29,3.0,0,3,4,4,11,0xb2d93f2fd
134001.64,3.0,10,3,4,3,10,0xb2d92b81
26.92,1.0,10,1,2,3,6,0xb2d93e74
400586.0,6.0,6,4,4,3,11,0xb2d22b0cd
3040.87,1.0,1,2,2,4,8,0xb2d90d4bd
7550.88,1.0,20,2,2,2,6,0xb2d92836d
195083.06,5.0,76,3,4,1,8,0xb2d2c190d
128.43,1.0,32,1,2,2,5,0xb2d7bfc3d
7425.14,1.0,15,2,2,3,7,0xb2d181b6d
128871.87,1.0,8,3,2,3,8,0xb2d3fde2d
90000.95,2.0,139,3,3,1,7,0xb2d91532d
1323.48,2.0,92,1,3,1,5,0xb2d1db8fd
1132720.17,3.0,23,4,4,2,10,0xb2d68547d
2911081.82,4.0,0,4,4,4,12,0xb2d5adf7d
1879.82,1.0,10,1,2,3,6,0xb2d908d2d
80068.78,2.0,122,3,3,1,7,0xb2d19b89
10115.86,2.0,27,2,3,2,7,0xb2d92495d
500022.19,2.0,118,4,3,1,8,0xb2d778ef
14105.46,1.0,18,2,2,2,6,0xb2d4da51d
26512.54,1.0,0,2,2,4,8,0xb2d51b66d
3127.53,1.0,15,2,2,3,7,0xb2d909e3
441.26,2.0,73,1,3,1,5,0xb2d4c15e
701758.09,3.0,37,4,4,2,10,0xb2d6271b
8.63,1.0,40,1,2,2,5,0xb2d1b05a
70574.34,4.0,1,3,4,4,11,0xb2d80160d
61747.23,2.0,0,3,3,4,10,0xb2d65343d
200763.66,3.0,10,3,4,3,10,0xb2d06417d
250002.64,2.0,97,3,3,1,7,0xb2d85881d
540000.8,2.0,7,4,3,3,10,0xb2d91964
200710.42,2.0,31,3,3,2,8,0xb2d93f55d
1295723.87,4.0,8,4,4,3,11,0xb2d145b3d
52425.1,2.0,19,3,3,2,8,0xb2d6bf37
520005.63,4.0,0,4,4,4,12,0xb2d933d3
14172.69,3.0,0,2,4,4,10,0xb2d08df0d
2249.89,1.0,1,1,2,4,7,0xb2d31c31
452188.18,4.0,0,4,4,4,12,0xb2d4cb4dd
90079.65,2.0,118,3,3,1,7,0xb2d42ba5d
14.06,1.0,28,1,2,2,5,0xb2d6bafcd
283078.81,5.0,172,3,4,1,8,0xb2d1052a
211155.45,6.0,32,3,4,2,9,0xb2d92a65d
1184.16,1.0,33,1,2,2,5,0xb2d91352d
50524.14,2.0,130,2,3,1,6,0xb2d6f777
31.14,1.0,36,1,2,2,5,0xb2d91bb8
707.89,1.0,21,1,2,2,5,0xb2d6d40dd
54000.99,3.0,19,3,4,2,9,0xb2d94021d
155566.02,3.0,14,3,4,3,10,0xb2d94004d
1.47,1.0,4,1,2,4,7,0xb2d6bde1
32510.86,1.0,92,2,2,1,5,0xb2d19fd9d
67024.38,1.0,257,3,2,1,6,0xb2d36cff
6009.78,1.0,124,2,2,1,5,0xb2d70578d
4.35,1.0,45,1,2,2,5,0xb2d6e22c
260000.05,2.0,25,3,3,2,8,0xb2d9394cd
201422.05,2.0,30,3,3,2,8,0xb2d8ff83
3421748.01,6.0,20,4,4,2,10,0xb2d8d086d
14274.71,1.0,223,2,2,1,5,0xb2d69027d
81007.66,2.0,21,3,3,2,8,0xb2d20822d
500005.63,3.0,1,4,4,4,12,0xb2d93295
20000.74,3.0,18,2,4,2,8,0xb2d91e4ad
105281.72,3.0,2,3,4,4,11,0xb2d655dad
3172.62,1.0,11,2,2,3,7,0xb2d903ce
1685.1,1.0,91,1,2,1,4,0xb2d37d13d
120.7,1.0,25,1,2,2,5,0xb2d61764
335017.12,9.0,2,4,4,4,12,0xb2d9404b
1517.78,1.0,92,1,2,1,4,0xb2d15ac7d
123877.2,8.0,3,3,4,4,11,0xb2d60b84d
60235.53,2.0,92,3,3,1,7,0xb2d0ed5dd
60055.85,2.0,1,3,3,4,10,0xb2d0d2d1
17.95,1.0,55,1,2,2,5,0xb2d91739d
7372.12,1.0,0,2,2,4,8,0xb2d8fec9d
10000.11,2.0,45,2,3,2,7,0xb2d91d92
142.55,1.0,30,1,2,2,5,0xb2d43e27
12717467.56,36.0,0,4,4,4,12,0x3b9adcc4d
10114.61,3.0,10,2,4,3,9,0xb2d62ef2
1250029.96,4.0,94,4,4,1,9,0xb2d4f874d
480339.92,4.0,14,4,4,3,11,0xb2d9361ad
4072302.83,4.0,6,4,4,3,11,0xb2d3551c
107494.55,1.0,9,3,2,3,8,0xb2d1d5f5d
301065.63,2.0,5,4,3,3,10,0xb2d933a6d
230817.0,2.0,42,3,3,2,8,0xb2d92428d
70038.13,3.0,73,3,4,1,8,0xb2d26f8ad
0.87,1.0,44,1,2,2,5,0xb2d6d5f2
1.16,1.0,215,1,2,1,4,0xb2d59a12d
1000000.0,2.0,21,4,3,2,9,0xb2d9177ad
826.02,1.0,30,1,2,2,5,0xb2d91ebf
200072.09,2.0,4,3,3,4,10,0xb2d5ff33
450004.75,2.0,34,4,3,2,9,0xb2d93253
500000.08,3.0,3,4,4,4,12,0xb2d93280d
696.48,1.0,0,1,2,4,7,0xb2d6e7f6
14979.61,1.0,67,2,2,1,5,0xb2d39519d
178.75,1.0,11,1,2,3,6,0xb2d91f85
2245.22,1.0,4,1,2,4,7,0xb2d90ef0
604145.6,2.0,4,4,3,4,11,0xb2d4f992d
212001.58,3.0,3,3,4,4,11,0xb2d95ea0d
693908.89,12.0,3,4,4,4,12,0xb2d64a15d
162009.62,6.0,11,3,4,3,10,0xb2d92d5fd
120000.0,1.0,1,3,2,4,9,0xb2d94e26d
1001.16,1.0,120,1,2,1,4,0xb2d919df
100000.0,1.0,0,3,2,4,9,0xb2d98483d
14.97,2.0,109,1,3,1,5,0xb2d1b16ed
3412.54,1.0,1,2,2,4,8,0xb2d3b2aad
20000.42,2.0,18,2,3,2,7,0xb2d95480d
80073.01,3.0,10,3,4,3,10,0xb2d4167ed
1023.41,1.0,174,1,2,1,4,0xb2d2f68ed
440202.52,1.0,7,4,2,3,9,0xb2d92b5ed
60000.0,2.0,3,3,3,4,10,0xb2d970a3d
80000.0,2.0,3,3,3,4,10,0xb2d9734cd
1.66,1.0,46,1,2,2,5,0xb2d1371e
1000000.0,2.0,14,4,3,3,10,0xb2d95ccf
67426.03,4.0,92,3,4,1,8,0x3b9add2a
9094.65,1.0,0,2,2,4,8,0xb2d16f88
10000.11,1.0,10,2,2,3,7,0xb2d96cb9d
120632.79,3.0,4,3,4,4,11,0xb2d93080d
77064.18,4.0,5,3,4,3,10,0xb2d0e5d9d
50018.55,2.0,87,2,3,1,6,0xb2d923ded
60114.17,2.0,33,3,3,2,8,0xb2d93281d
1058.26,1.0,8,1,2,3,6,0xb2d2764b
232572.55,2.0,6,3,3,3,9,0xb2d2ce35
8177.48,1.0,9,2,2,3,7,0xb2d5a57c
140018.55,8.0,24,3,4,2,9,0xb2d33b97d
217.69,1.0,10,1,2,3,6,0xb2d26a2ad
4055.69,1.0,10,2,2,3,7,0xb2d905a2
400000.0,3.0,19,4,4,2,10,0xb2d95237
58.3,1.0,14,1,2,3,6,0xb2d6fa26
51698.14,2.0,181,2,3,1,6,0xb2d4f59fd
10492.74,1.0,13,2,2,3,7,0xb2d8da11d
6017.46,1.0,10,2,2,3,7,0xb2d58476d
119.7,1.0,68,1,2,1,4,0xb2d0deed
74437.17,1.0,1,3,2,4,9,0xb2d96f4dd
60698.89,2.0,11,3,3,3,9,0xb2d93b72d
1029.04,1.0,8,1,2,3,6,0xb2d6b75a
5958.36,1.0,7,2,2,3,7,0xb2d58ba2d
40175.07,2.0,117,2,3,1,6,0xb2d37bffd
150033.09,3.0,139,3,4,1,8,0xb2d39c20d
530000.0,2.0,17,4,3,2,9,0xb2d95c7ed
500000.0,3.0,0,4,4,4,12,0xb2d775be
150004.0,2.0,46,3,3,2,8,0xb2d179a6d
3200014.04,4.0,13,4,4,3,11,0xb2d8fb5fd
4810129.94,3.0,21,4,4,2,10,0x3b9aeddfd
101137.43,3.0,34,3,4,2,9,0xb2d91868d
769.11,1.0,204,1,2,1,4,0xb2d34cc7d
224.81,1.0,5,1,2,3,6,0xb2d93d49
54.3,1.0,23,1,2,2,5,0xb2d93d4c
503270.86,3.0,0,4,4,4,12,0xb2d2cecbd
1160.57,1.0,28,1,2,2,5,0xb2d59dded
2.64,1.0,18,1,2,2,5,0xb2d958cad
5739.37,1.0,7,2,2,3,7,0xb2d0ce37
40001.27,2.0,10,2,3,3,8,0xb2d9600b
300009.5,2.0,10,3,3,3,9,0xb2d95fded
1001.17,1.0,121,1,2,1,4,0xb2d919ac
420011.44,4.0,92,4,4,1,9,0xb2d0eaf9
300185.32,3.0,76,4,4,1,9,0xb2d59efbd
18.48,4.0,1,1,4,4,9,0xb2d90809d
32.29,1.0,1,1,2,4,7,0xb2d385cb
85000.0,2.0,0,3,3,4,10,0xb2d97c9d
200000.0,2.0,10,3,3,3,9,0xb2d96b90d
800000.0,4.0,0,4,4,4,12,0xb2d6f68fd
13796.7,1.0,0,2,2,4,8,0xb2d9272c
300003.17,2.0,10,3,3,3,9,0xb2d9686cd
38854.18,1.0,12,2,2,3,7,0xb2d37e33
3746.09,1.0,5,2,2,3,7,0xb2d92276d
50000.53,2.0,27,2,3,2,7,0xb2d942ef
8251.53,1.0,0,2,2,4,8,0xb2d6378e
154361.37,2.0,10,3,3,3,9,0xb2d93e8dd
200000.0,2.0,6,3,3,3,9,0xb2d97277d
667067.72,6.0,11,4,4,3,11,0xb2d63ed9d
582045.69,4.0,4,4,4,4,12,0xb2d5e54ed
32746.76,6.0,20,2,4,2,8,0xb2d6a3b2d
31561.68,1.0,0,2,2,4,8,0xb2d91850
6066.67,1.0,184,2,2,1,5,0xb2d27b76d
174878.87,1.0,1,3,2,4,9,0xb2d9288ed
30000.0,2.0,6,2,3,3,8,0xb2d5fc28
180000.0,2.0,6,3,3,3,9,0xb2d13f71d
111844.42,2.0,6,3,3,3,9,0xb2d33729d
108497.08,2.0,167,3,3,1,7,0xb2d2d083d
300000.0,2.0,1,3,3,4,10,0xb2d97826
400105.98,2.0,1,4,3,4,11,0xb2d946e2d
450019.85,2.0,1,4,3,4,11,0xb2d95006
3005.79,2.0,54,2,3,2,7,0xb2d90bb1d
260000.0,2.0,3,3,3,4,10,0xb2d956f9d
12613.83,1.0,2,2,2,4,8,0xb2d4047c
707.59,1.0,10,1,2,3,6,0xb2d9210e
250094.77,2.0,6,3,3,3,9,0xb2d91f70d
58549.5,2.0,18,3,3,2,8,0xb2d625f7d
100016.89,1.0,25,3,2,2,7,0xb2d94ae1d
9079.95,1.0,0,2,2,4,8,0xb2d94ecbd
200842.67,2.0,30,3,3,2,8,0xb2d922acd
1215.08,1.0,184,1,2,1,4,0xb2d27117d
800121.38,2.0,24,4,3,2,9,0xb2d12c3ed
130000.87,4.0,0,3,4,4,11,0xb2d94b23d
171124.12,3.0,1,3,4,4,11,0xb2d95819
50118.35,2.0,0,2,3,4,9,0xb2d776ead
9920000.0,2.0,4,4,3,4,11,0xb2d94847d
217.8,2.0,18,1,3,2,6,0xb2d95699
201422.38,2.0,82,3,3,1,7,0xb2d6b475d
1126303.77,8.0,32,4,4,2,10,0xb2d08640d
102522.05,1.0,92,3,2,1,6,0xb2d1540bd
410886.75,2.0,140,4,3,1,8,0xb2d5d476d
1174.8,1.0,10,1,2,3,6,0xb2d91140
256034.99,3.0,0,3,4,4,11,0xb2d58ccbd
100002.11,2.0,24,3,3,2,8,0xb2d948fbd
1.06,1.0,184,1,2,1,4,0xb2d1a388d
25020.48,1.0,1,2,2,4,8,0xb2d9131dd
170002.54,3.0,73,3,4,1,8,0xb2d8d1d6
250581.53,3.0,46,3,4,2,9,0xb2d90225d
1300045.43,3.0,112,4,4,1,9,0xb2d8e6dad
200000.0,2.0,18,3,3,2,8,0xb2d956fcd
3.07,1.0,46,1,2,2,5,0xb2d91011d
80000.84,2.0,20,3,3,2,8,0xb2d950db
181185.19,2.0,10,3,3,3,9,0xb2d9346b
50001.58,2.0,172,2,3,1,6,0xb2d8d36fd
7087.16,1.0,14,2,2,3,7,0xb2d919bf
200002.11,3.0,5,3,4,3,10,0xb2d96aac
500000.0,2.0,24,4,3,2,9,0xb2d94f22
378045.38,5.0,14,4,4,3,11,0xb2d90891d
155001.0,1.0,0,3,2,4,9,0xb2d97337d
34869.86,1.0,92,2,2,1,5,0xb2d40562d
220996.02,4.0,46,3,4,2,9,0xb2d41058d
200000.0,2.0,20,3,3,2,8,0xb2d95483
800419.76,3.0,13,4,4,3,11,0xb2d8e4f1d
78.33,1.0,1,1,2,4,7,0xb2d404ed
50002.64,2.0,13,2,3,3,8,0xb2d95a83d
569157.6,5.0,84,4,4,1,9,0xb2d3cc9fd
97.41,1.0,45,1,2,2,5,0xb2d62600
5488.15,1.0,1,2,2,4,8,0xb2d35d02d
500009.0,2.0,3,4,3,4,11,0xb2d95f03d
51143.02,4.0,27,2,4,2,8,0xb2d57516d
603.35,1.0,0,1,2,4,7,0xb2d92c64
500099.0,2.0,2,4,3,4,11,0xb2d963e3
100098.0,2.0,0,3,3,4,10,0xb2d979fdd
3.0,1.0,81,1,2,1,4,0xb2d0e7d8d
4290.04,1.0,92,2,2,1,5,0xb2d12761d
6391.71,1.0,0,2,2,4,8,0xb2d2f811
19912.09,1.0,10,2,2,3,7,0xb2d956bad
29149.44,2.0,0,2,3,4,9,0xb2d0689c
4.01,1.0,60,1,2,2,5,0xb2d8fbb3
285395.73,5.0,0,3,4,4,11,0x3b9af260
274700.73,3.0,5,3,4,3,10,0xb2d60cd2
104.08,1.0,14,1,2,3,6,0xb2d95600
50004.5,2.0,92,2,3,1,6,0xb2d593e4
321009.96,9.0,0,4,4,4,12,0xb2d503b7d
590.62,1.0,3,1,2,4,7,0xb2d1fa37
180000.17,1.0,1,3,2,4,9,0xb2d63927
41486.34,1.0,92,2,2,1,5,0xb2d35742d
490438.69,3.0,63,4,4,2,10,0xb2d598bcd
54210.11,4.0,1,3,4,4,11,0xb2d473a3d
100586.78,3.0,10,3,4,3,10,0xb2d4fc38d
50000.0,2.0,6,2,3,3,8,0xb2d96f23d
3000155.56,2.0,0,4,3,4,11,0xb2d976d0
95984.63,1.0,7,3,2,3,8,0xb2d93792
720000.0,4.0,6,4,4,3,11,0xb2d90147d
7601.73,1.0,0,2,2,4,8,0xb2d27036d
7007.28,1.0,18,2,2,2,6,0xb2d6b6cad
25105.77,1.0,0,2,2,4,8,0xb2d558dbd
101002.14,2.0,32,3,3,2,8,0xb2d92565d
500000.0,3.0,6,4,4,3,11,0xb2d92400d
54593.53,1.0,91,3,2,1,6,0xb2d12134d
30532.01,1.0,54,2,2,2,6,0xb2d6ce10d
15407.51,2.0,119,2,3,1,6,0xb2d5e9a6d
50000.0,2.0,0,2,3,4,9,0xb2d981e3d
35696.39,1.0,184,2,2,1,5,0xb2d08fcdd
485985.44,6.0,10,4,4,3,11,0xb2d1772cd
82.11,1.0,2,1,2,4,7,0xb2d958c1d
82331.75,3.0,27,3,4,2,9,0xb2d61958
3328.28,1.0,0,2,2,4,8,0xb2d8fee0d
12782.19,1.0,5,2,2,3,7,0xb2d94f37d
300003.17,3.0,82,3,4,1,8,0xb2d92d9fd
170.2,2.0,6,1,3,3,7,0xb2d3720c
713.28,1.0,10,1,2,3,6,0xb2d925b0
43347.2,1.0,7,2,2,3,7,0xb2d926a3
89.77,1.0,19,1,2,2,5,0xb2d9257dd
20000.75,3.0,7,2,4,3,9,0xb2d928dad
6981.19,4.0,92,2,4,1,7,0xb2d0c701d
10464.04,1.0,13,2,2,3,7,0xb2d3482f
5012.78,1.0,92,2,2,1,5,0xb2d645e6d
3119000.0,10.0,0,4,4,4,12,0xb2d5c3bad
1527.96,1.0,10,1,2,3,6,0xb2d91e5a
120086.29,1.0,9,3,2,3,8,0xb2d8d762
25001.67,1.0,0,2,2,4,8,0xb2d43a49d
1060000.0,1.0,0,4,2,4,10,0xb2d98382d
300000.0,2.0,6,3,3,3,9,0xb2d97401
525160.03,1.0,0,4,2,4,10,0xb2d9155ad
21.45,1.0,111,1,2,1,4,0xb2d92e50d
350003.69,2.0,10,4,3,3,10,0xb2d95604d
40107.88,2.0,20,2,3,2,7,0xb2d93207d
63581.04,2.0,77,3,3,1,7,0xb2d1c02cd
200000.0,1.0,0,3,2,4,9,0xb2d97e78d
110009.49,2.0,0,3,3,4,10,0xb2d4ea91d
10000.0,2.0,6,2,3,3,8,0xb2d95091d
549352.62,2.0,52,4,3,2,9,0xb2d10b38
200004.22,2.0,18,3,3,2,8,0xb2d953acd
244.56,1.0,7,1,2,3,6,0xb2d92dab
244562.85,2.0,139,3,3,1,7,0xb2d19230d
1815.82,1.0,10,1,2,3,6,0xb2d427a1d
20295.38,3.0,6,2,4,3,9,0xb2d64c32
10.34,1.0,18,1,2,2,5,0xb2d94bde
6103.35,1.0,29,2,2,2,6,0xb2d92bdd
881027.18,5.0,9,4,4,3,11,0xb2d104c4d
6001.33,1.0,14,2,2,3,7,0xb2d8cb32d
560000.0,1.0,5,4,2,3,9,0xb2d9744cd
104872.03,1.0,175,3,2,1,6,0xb2d3e2afd
60.28,3.0,20,1,4,2,7,0xb2d945c3d
500000.0,2.0,19,4,3,2,9,0xb2d95574
85367.14,4.0,0,3,4,4,11,0xb2d6b6b5d
200000.0,2.0,19,3,3,2,8,0xb2d9584dd
5500.11,2.0,7,2,3,3,8,0xb2d95694d
1171.97,2.0,184,1,3,1,5,0xb2d1c8f0
44407.45,1.0,0,2,2,4,8,0xb2d5e6afd
10000.01,4.0,7,2,4,3,9,0xb2d96720d
200000.0,2.0,7,3,3,3,9,0xb2d96fab
50000.0,2.0,0,2,3,4,9,0xb2d98148d
338004.83,6.0,4,4,4,4,12,0xb2d3fc54d
162831.7,3.0,1,3,4,4,11,0xb2d62cebd
1048256.63,2.0,24,4,3,2,9,0xb2d34ccbd
2006696.78,11.0,0,4,4,4,12,0xb2d2cdc6d
7436.24,1.0,16,2,2,2,6,0xb2d92289
66.29,1.0,14,1,2,3,6,0xb2d94a79
1569.93,1.0,14,1,2,3,6,0xb2d2c1b4
1020.25,1.0,10,1,2,3,6,0xb2d91164d
12.15,1.0,11,1,2,3,6,0xb2d90f1e
4463.59,1.0,2,2,2,4,8,0xb2d906ccd
150007.92,2.0,13,3,3,3,9,0xb2d95b71d
101153.24,2.0,2,3,3,4,10,0xb2d96870d
604292.47,2.0,71,4,3,1,8,0xb2d5f1ea
50003.17,2.0,48,2,3,2,7,0xb2d6598ed
250000.0,1.0,1,3,2,4,9,0xb2d975cc
4999.29,3.0,184,2,4,1,7,0xb2d5a11ad
130086.88,1.0,1,3,2,4,9,0xb2d95724d
200010.43,3.0,21,3,4,2,9,0xb2d8f547d
37957.69,1.0,14,2,2,3,7,0xb2d3192cd
3.98,1.0,0,1,2,4,7,0xb2d51edc
40.97,1.0,0,1,2,4,7,0xb2d91a4f
810000.0,3.0,18,4,4,2,10,0xb2d95097
250000.08,3.0,5,3,4,3,10,0xb2d93459d
2059.96,1.0,92,1,2,1,4,0xb2d11e89
205118.64,3.0,213,3,4,1,8,0xb2d3ba9cd
500000.0,2.0,13,4,3,3,10,0xb2d961fbd
24504.42,2.0,19,2,3,2,7,0xb2d36dc8d
14263.15,3.0,92,2,4,1,7,0x3b9b380dd
130254.89,2.0,0,3,3,4,10,0xb2d5646cd
11485.13,1.0,0,2,2,4,8,0xb2d6b621
0.0,1.0,4,1,2,4,7,0xb2d97131d
20195.92,1.0,274,2,2,1,5,0xb2d651ead
14023.03,83.0,1,2,4,4,10,0xb2d36fb0d
44000.19,3.0,3,2,4,4,10,0xb2d94b2dd
5248.18,1.0,2,2,2,4,8,0xb2d9428ad
600014.34,2.0,129,4,3,1,8,0xb2d90e13d
40009.63,2.0,20,2,3,2,7,0xb2d5bb0ed
13843.72,2.0,251,2,3,1,6,0xb2d09ee2d
500000.0,2.0,6,4,3,3,10,0xb2d97323d
356409.48,4.0,6,4,4,3,11,0xb2d2a647d
39.27,1.0,68,1,2,1,4,0xb2d918e4
256122.82,2.0,0,3,3,4,10,0xb2d6ebb8d
50000.0,1.0,0,2,2,4,8,0xb2d88004d
50001.06,2.0,18,2,3,2,7,0xb2d9551ad
819.32,1.0,4,1,2,4,7,0xb2d93bc4
2443794.62,1.0,235,4,2,1,7,0xb2d6edc3d
1204.95,1.0,17,1,2,2,5,0xb2d1bef0
2004.45,1.0,92,1,2,1,4,0xb2d0f198d
1016.0,1.0,184,1,2,1,4,0xb2d11d42d
6735.69,1.0,5,2,2,3,7,0xb2d9603cd
50006.89,2.0,144,2,3,1,6,0xb2d6d2f0
100186.82,6.0,21,3,4,2,9,0xb2d9213f
7498.13,1.0,184,2,2,1,5,0xb2d0f003d
380000.99,3.0,25,4,4,2,10,0xb2d908acd
16559.66,1.0,10,2,2,3,7,0xb2d6f206d
4406.76,1.0,143,2,2,1,5,0xb2d40f0ed
100000.0,2.0,3,3,3,4,10,0xb2d97a8bd
97014.93,2.0,107,3,3,1,7,0xb2d304e6d
20000.0,2.0,6,2,3,3,8,0xb2d96fffd
343000.0,6.0,0,4,4,4,12,0xb2d07d07d
905101.33,4.0,18,4,4,2,10,0xb2d41b8fd
4053.75,2.0,30,2,3,2,7,0x3b9b36a0d
105004.88,2.0,6,3,3,3,9,0xb2d5b1a0d
500000.0,2.0,2,4,3,4,11,0xb2d97ea2d
504521.16,1.0,13,4,2,3,9,0xb2d928d7
96101.87,3.0,41,3,4,2,9,0xb2d5b038d
1520000.0,2.0,2,4,3,4,11,0xb2d978ff
159521.87,2.0,17,3,3,2,8,0xb2d926e2d
4403.11,1.0,184,2,2,1,5,0xb2d4cd7cd
8073.61,1.0,92,2,2,1,5,0xb2d2a887d
80004.22,2.0,132,3,3,1,7,0xb2d5c0a9d
3404.13,1.0,125,2,2,1,5,0xb2d93ac8d
100075.69,1.0,64,3,2,2,7,0xb2d91950
1229.95,1.0,0,1,2,4,7,0xb2d90e40
21481.46,2.0,3,2,3,4,9,0xb2d90528
148.25,1.0,29,1,2,2,5,0xb2d34bbdd
2739.07,1.0,92,1,2,1,4,0xb2d2afc2d
173000.0,4.0,0,3,4,4,11,0xb2d68df8d
9.31,1.0,14,1,2,3,6,0xb2d57597d
262073.91,2.0,1,3,3,4,10,0xb2d32d69
70003.35,2.0,53,3,3,2,8,0xb2d6f6ffd
170007.18,2.0,20,3,3,2,8,0xb2d94d6dd
200000.22,3.0,8,3,4,3,10,0xb2d92e29d
3514.03,1.0,92,2,2,1,5,0xb2d42f60d
1320825.94,5.0,3,4,4,4,12,0xb2d173d8d
50000.0,2.0,3,2,3,4,9,0xb2d97881d
2091003.32,11.0,14,4,4,3,11,0xb2d0ffc0d
451434.44,2.0,1,4,3,4,11,0xb2d9554dd
168.89,1.0,73,1,2,1,4,0xb2d92649
100049.88,2.0,46,3,3,2,8,0xb2d90c8ad
2801286.49,5.0,0,4,4,4,12,0xb2d815c7d
340191.01,4.0,34,4,4,2,10,0xb2d34c6bd
0.09,1.0,10,1,2,3,6,0xb2d629d3d
90018.03,4.0,34,3,4,2,9,0xb2d62cc9d
55000.58,2.0,38,3,3,2,8,0xb2d5c2f7
50001.06,2.0,10,2,3,3,8,0xb2d6233d
731.1,1.0,12,1,2,3,6,0xb2d5e2c2
132374.01,2.0,83,3,3,1,7,0xb2d323aed
671764.0,8.0,34,4,4,2,10,0xb2d10eb4d
1324.87,1.0,6,1,2,3,6,0xb2d5029b
1098.38,1.0,184,1,2,1,4,0xb2d293d0d
30000001.0,2.0,112,4,3,1,8,0xb2d907e0d
5136.48,1.0,14,2,2,3,7,0xb2d9320d
81535.44,2.0,136,3,3,1,7,0xb2d3f49dd
5892.08,1.0,29,2,2,2,6,0xb2d9259e
80003.37,3.0,11,3,4,3,10,0xb2d34d49d
51028.21,2.0,184,2,3,1,6,0xb2d153e7d
156.96,1.0,11,1,2,3,6,0xb2d9362d
71739.98,3.0,75,3,4,1,8,0xb2d59325d
52057.32,2.0,20,2,3,2,7,0xb2d1414d
100012.18,2.0,55,3,3,2,8,0xb2d6ce2ad
120002.53,2.0,10,3,3,3,9,0xb2d9632d
100006.57,3.0,3,3,4,4,11,0xb2d5512bd
200003.86,2.0,17,3,3,2,8,0xb2d952fb
2.26,1.0,62,1,2,2,5,0xb2d89ee9d
250010.57,2.0,132,3,3,1,7,0xb2d6f824
20000.21,2.0,20,2,3,2,7,0xb2d9509ad
60038.24,2.0,59,3,3,2,8,0xb2d14e67d
2482.15,1.0,29,1,2,2,5,0xb2d928e6
241766.67,5.0,1,3,4,4,11,0xb2d581a3d
500000.0,2.0,10,4,3,3,10,0xb2d96abc
12250.28,1.0,1,2,2,4,8,0xb2d1fa79
406968.83,5.0,3,4,4,4,12,0xb2d3c165d
1001.17,1.0,121,1,2,1,4,0xb2d9198f
3746.23,1.0,49,2,2,2,6,0xb2d9395a
1365183.93,4.0,23,4,4,2,10,0xb2d2dd07
2882.85,1.0,24,1,2,2,5,0xb2d8df35d
200003.3,2.0,7,3,3,3,9,0xb2d9508ed
150045.18,3.0,70,3,4,1,8,0xb2d0cb7f
500004.31,2.0,15,4,3,3,10,0xb2d91f86d
500048.54,1.0,33,4,2,2,8,0xb2d8ff22
1013.0,1.0,1,1,2,4,7,0xb2d68e80
260000.0,3.0,0,3,4,4,11,0xb2d3fe7f
355395.83,4.0,0,4,4,4,12,0xb2d6b20dd
1825786.73,6.0,77,4,4,1,9,0xb2d60474d
3838.08,1.0,7,2,2,3,7,0xb2d35478d
50000.53,2.0,18,2,3,2,7,0xb2d954a5d
157015.36,2.0,6,3,3,3,9,0xb2d5d0d4d
23.38,1.0,54,1,2,2,5,0xb2d8fe17d
94.37,1.0,12,1,2,3,6,0xb2d28cd7
150004.23,3.0,11,3,4,3,10,0xb2d94798
104.7,1.0,49,1,2,2,5,0xb2d93eb8
51534.1,1.0,0,2,2,4,8,0xb2d9317bd
44031.19,4.0,26,2,4,2,8,0xb2d3489fd
6106.81,1.0,14,2,2,3,7,0xb2d32420d
14128.38,1.0,92,2,2,1,5,0xb2d2d509d
1100000.0,2.0,1,4,3,4,11,0xb2d97e70
250000.0,2.0,24,3,3,2,8,0xb2d94d4ad
85000.0,2.0,5,3,3,3,9,0xb2d96ec8d
290000.0,2.0,18,3,3,2,8,0xb2d95b6cd
1009.92,1.0,92,1,2,1,4,0xb2d29369d
362824.2,3.0,2,4,4,4,12,0xb2d1948ed
100220.72,3.0,52,3,4,2,9,0xb2d57815d
3.44,1.0,9,1,2,3,6,0xb2d31eb7d
1345613.54,5.0,27,4,4,2,10,0xb2d5a723d
10107.89,1.0,184,2,2,1,5,0xb2d2a43ed
41100.49,2.0,64,2,3,2,7,0xb2d88adfd
10001.63,2.0,6,2,3,3,8,0xb2d959e3d
11297.02,1.0,29,2,2,2,6,0xb2d938d1
2310718.14,5.0,0,4,4,4,12,0xb2d60bfad
30443.05,1.0,68,2,2,1,5,0xb2d75498d
19.53,1.0,32,1,2,2,5,0xb2d9202cd
310003.61,2.0,1,4,3,4,11,0xb2d16e8dd
30934.63,1.0,0,2,2,4,8,0xb2d226d1d
200000.0,2.0,13,3,3,3,9,0xb2d953ced
200000.0,3.0,3,3,4,4,11,0xb2d97327d
134472.76,2.0,0,3,3,4,10,0xb2d5a813d
50000.0,2.0,3,2,3,4,9,0xb2d973ead
260000.0,2.0,14,3,3,3,9,0xb2d95ea8d
237072.83,3.0,7,3,4,3,10,0xb2d36332d
151461.32,4.0,0,3,4,4,11,0xb2d633fed
1074.87,2.0,92,1,3,1,5,0xb2d0ab35
500000.0,2.0,13,4,3,3,10,0xb2d9607cd
1101821.04,2.0,0,4,3,4,11,0xb2d6c045
1925.47,1.0,33,1,2,2,5,0xb2d6c5ebd
200400.97,2.0,21,3,3,2,8,0xb2d94789
950075.01,4.0,7,4,4,3,11,0xb2d37aa0d
3691.33,1.0,11,2,2,3,7,0xb2d9196f
30024.9,2.0,69,2,3,1,6,0xb2d602b4d
400096.16,3.0,0,4,4,4,12,0xb2d6d752d
23.66,1.0,23,1,2,2,5,0xb2d2a4b0d
9918.08,1.0,27,2,2,2,6,0xb2d2585dd
3579.31,1.0,94,2,2,1,5,0xb2d2b9b9d
181423.56,11.0,0,3,4,4,11,0xb2d4d3b2d
63802.32,3.0,0,3,4,4,11,0xb2d0b321d
10064.08,1.0,0,2,2,4,8,0xb2d911ad
300000.0,2.0,25,3,3,2,8,0xb2d94ab6
251005.46,2.0,24,3,3,2,8,0xb2d9477ad
101000.87,3.0,91,3,4,1,8,0xb2d470b8d
3927.86,1.0,0,2,2,4,8,0xb2d90178
13985.61,1.0,9,2,2,3,7,0xb2d1dfeed
0.0,1.0,4,1,2,4,7,0xb2d953ec
10.45,1.0,10,1,2,3,6,0xb2d06cc6
5107.52,1.0,23,2,2,2,6,0xb2d91e8ed
112.47,1.0,53,1,2,2,5,0xb2d52e36d
52534.93,2.0,31,3,3,2,8,0xb2d1181fd
333.06,1.0,12,1,2,3,6,0xb2d1eb03d
65003.52,3.0,0,3,4,4,11,0xb2d65c49d
365.92,1.0,24,1,2,2,5,0xb2d0b6d3
0.0,1.0,3,1,2,4,7,0xb2d17f24
3814.54,1.0,4,2,2,4,8,0xb2d923da
50000.53,2.0,13,2,3,3,8,0xb2d95e90d
130001.06,3.0,0,3,4,4,11,0xb2d95e0fd
15502.92,1.0,192,2,2,1,5,0xb2d398a0d
2013436.15,3.0,1,4,4,4,12,0xb2d90394d
2315.76,1.0,45,1,2,2,5,0xb2d8ff4ad
470001.12,3.0,11,4,4,3,11,0xb2d91e40d
499988.61,3.0,95,4,4,1,9,0xb2d4b89ad
150789.03,3.0,70,3,4,1,8,0xb2d41067d
470004.05,4.0,98,4,4,1,9,0xb2d1c55d
4718.23,1.0,29,2,2,2,6,0xb2d92c05
3200.81,1.0,20,2,2,2,6,0xb2d48a5ed
0.0,1.0,3,1,2,4,7,0xb2d97177
600000.0,2.0,0,4,3,4,11,0xb2d97df8d
551960.25,2.0,30,4,3,2,9,0xb2d8ff53d
2000.0,1.0,1,1,2,4,7,0xb2d975d6d
12706.54,1.0,29,2,2,2,6,0xb2d92224
1000000.0,1.0,0,4,2,4,10,0xb2d978f7
580096.93,2.0,12,4,3,3,10,0x3b9b31d1d
14802.74,1.0,20,2,2,2,6,0xb2d609c0
803735.22,2.0,75,4,3,1,8,0xb2d2e44cd
1.46,1.0,25,1,2,2,5,0xb2d8ddd1d
121.06,1.0,17,1,2,2,5,0xb2d92e84
4168.48,1.0,9,2,2,3,7,0xb2d41edfd
50240.08,2.0,3,2,3,4,9,0xb2d29bd9d
1000000.0,2.0,0,4,3,4,11,0xb2d97f57d
45.22,1.0,1,1,2,4,7,0xb2d0d6f7d
17425.75,1.0,4,2,2,4,8,0xb2d363abd
250020.38,2.0,202,3,3,1,7,0xb2d6f477d
5.92,1.0,21,1,2,2,5,0xb2d90f3ad
28004.4,3.0,19,2,4,2,8,0xb2d10253d
154.3,1.0,28,1,2,2,5,0xb2d5f0ab
200000.0,2.0,5,3,3,3,9,0xb2d975e2d
11.82,1.0,27,1,2,2,5,0xb2d93664
250000.0,2.0,14,3,3,3,9,0xb2d95df4d
3809.26,1.0,9,2,2,3,7,0xb2d95281
31963.99,1.0,1,2,2,4,8,0xb2d39aefd
9.59,1.0,20,1,2,2,5,0xb2d953b6d
441220.01,4.0,6,4,4,3,11,0xb2d61166d
9.82,1.0,74,1,2,1,4,0xb2d9327a
1180000.0,4.0,0,4,4,4,12,0xb2d9747ad
11054.26,1.0,4,2,2,4,8,0xb2d8364bd
14648.66,2.0,1,2,3,4,9,0x3b9b46ddd
40000.97,1.0,0,2,2,4,8,0xb2d92686d
129426.16,1.0,29,3,2,2,7,0xb2d42bc1
20000.42,2.0,18,2,3,2,7,0xb2d9543a
238.21,1.0,50,1,2,2,5,0xb2d39753
200000.0,2.0,28,3,3,2,8,0xb2d942f7d
1220.32,1.0,92,1,2,1,4,0xb2d2aec3d
1579.65,1.0,9,1,2,3,6,0xb2d3beb3d
1396000.0,3.0,3,4,4,4,12,0xb2d97a71d
1231526.79,4.0,37,4,4,2,10,0xb2d69855
1949.96,1.0,1,1,2,4,7,0xb2d6ab69
308.68,1.0,0,1,2,4,7,0xb2d17730d
1325.46,1.0,92,1,2,1,4,0x3b9b3606d
4.63,1.0,17,1,2,2,5,0xb2d92947
10000.11,2.0,137,2,3,1,6,0xb2d91d02d
200008.81,23.0,12,3,4,3,10,0xb2d4e96fd
5654.73,1.0,184,2,2,1,5,0xb2d0b5fed
174609.51,18.0,0,3,4,4,11,0x3b9af128
600792.77,5.0,18,4,4,2,10,0xb2d3b1ded
10141.78,1.0,30,2,2,2,6,0xb2d925b1
20000.69,3.0,0,2,4,4,10,0xb2d6e201d
80000.84,2.0,20,3,3,2,8,0xb2d95092
96.02,1.0,5,1,2,3,6,0xb2d15b16d
11600.61,1.0,14,2,2,3,7,0xb2d941add
140.86,1.0,4,1,2,4,7,0xb2d937d2d
16217.59,1.0,52,2,2,2,6,0xb2d2a1e5d
44390.85,1.0,0,2,2,4,8,0xb2d3f9e1d
50660.53,1.0,8,2,2,3,7,0xb2d93f82
1100020.56,6.0,7,4,4,3,11,0xb2d943a2d
21884.94,1.0,89,2,2,1,5,0xb2d1eb07d
380000.0,2.0,4,4,3,4,11,0xb2d97939d
16080.82,1.0,125,2,2,1,5,0xb2d59bc8
335059.88,2.0,9,4,3,3,10,0xb2d9186dd
30083.08,4.0,76,2,4,1,7,0xb2d206a3
6218.11,1.0,0,2,2,4,8,0xb2d9454cd
200000.0,2.0,27,3,3,2,8,0xb2d945a6d
60001.9,2.0,11,3,3,3,9,0xb2d95e8ad
400000.0,3.0,6,4,4,3,11,0xb2d96fc4d
380027.66,3.0,53,4,4,2,10,0xb2d913d5d
7438.09,1.0,12,2,2,3,7,0xb2d95f29
170011.03,4.0,168,3,4,1,8,0xb2d6fbfad
111.3,1.0,46,1,2,2,5,0xb2d208fe
688316.81,6.0,1,4,4,4,12,0xb2d2019bd
172379.35,1.0,76,3,2,1,6,0xb2d63b24d
222045.73,2.0,181,3,3,1,7,0xb2d0bf93d
600029.08,2.0,18,4,3,2,9,0xb2d91525d
625.66,1.0,5,1,2,3,6,0xb2d1d86ad
100.0,1.0,0,1,2,4,7,0xb2d3c4f4
59132.72,2.0,25,3,3,2,8,0xb2d12bf6d
216688.39,2.0,27,3,3,2,8,0xb2d40f59d
1232.22,1.0,0,1,2,4,7,0xb2d272f4d
50003.52,2.0,168,2,3,1,6,0xb2d58b2fd
810059.4,4.0,24,4,4,2,10,0xb2d26c4cd
200000.59,2.0,25,3,3,2,8,0xb2d6e1e0
74404.21,3.0,165,3,4,1,8,0xb2d52e09d
52729.88,1.0,6,3,2,3,8,0xb2d729aa
615896.27,8.0,13,4,4,3,11,0xb2d3bd63d
10597.4,2.0,92,2,3,1,6,0xb2d192a1
150022.3,2.0,145,3,3,1,7,0xb2d5e0e9
51699.89,2.0,80,2,3,1,6,0xb2d621a7d
907152.21,11.0,0,4,4,4,12,0xb2d455ccd
4.02,1.0,25,1,2,2,5,0xb2d55ec5
2074078.96,3.0,0,4,4,4,12,0xb2d1460d
50072.28,5.0,24,2,4,2,8,0xb2d596fcd
16887.13,1.0,6,2,2,3,7,0xb2d91c9c
0.43,1.0,8,1,2,3,6,0xb2d5b7a9d
1107.18,1.0,23,1,2,2,5,0xb2d30e19d
8.01,1.0,0,1,2,4,7,0xb2d7915ed
205399.85,2.0,33,3,3,2,8,0xb2d630cbd
120007.21,2.0,76,3,3,1,7,0xb2d30563d
8024.0,1.0,2,2,2,4,8,0xb2d92806
788033.57,10.0,11,4,4,3,11,0xb2d680a3d
300018.08,2.0,164,3,3,1,7,0xb2d528ccd
5760.47,2.0,184,2,3,1,6,0xb2d42f33d
460.14,1.0,11,1,2,3,6,0xb2d2adacd
110096.74,1.0,10,3,2,3,8,0xb2d8e5b0
118798.79,1.0,0,3,2,4,9,0xb2d2753ad
350027.87,3.0,18,4,4,2,10,0xb2d92b78d
31830.83,2.0,105,2,3,1,6,0xb2d42be2d
101885.18,2.0,19,3,3,2,8,0xb2d20927d
60001.89,2.0,92,3,3,1,7,0xb2d22f82d
201421.35,2.0,90,3,3,1,7,0xb2d8c42cd
12174.26,1.0,184,2,2,1,5,0xb2d38886d
102304.91,3.0,80,3,4,1,8,0xb2d93f9ad
230076.8,2.0,161,3,3,1,7,0xb2d48ba3d
16926.93,1.0,8,2,2,3,7,0xb2d93bd7
70799.57,1.0,0,3,2,4,9,0xb2d3f0aad
1158178.37,6.0,38,4,4,2,10,0xb2d18645d
347655.74,6.0,6,4,4,3,11,0xb2d1fc2cd
2896.41,1.0,184,2,2,1,5,0xb2d1e09ed
15389.83,1.0,18,2,2,2,6,0xb2d91717
785.46,1.0,35,1,2,2,5,0xb2d3c1bed
196373.13,1.0,0,3,2,4,9,0xb2d541dcd
0.01,3.0,98,1,4,1,6,0xb2d2f13ed
427.2,1.0,18,1,2,2,5,0xb2d10c7cd
630053.53,2.0,119,4,3,1,8,0xb2d58e65d
350813.51,3.0,14,4,4,3,11,0xb2d8ff83d
383.07,3.0,92,1,4,1,6,0x3b9ade6b
283000.0,17.0,4,3,4,4,11,0xb2d12a07d
50740.2,1.0,1,2,2,4,8,0xb2d2047d
152.65,1.0,21,1,2,2,5,0xb2d1a855d
1700082.78,1.0,0,4,2,4,10,0xb2d18be4d
36.98,2.0,7,1,3,3,7,0xb2d62cf4
28.58,1.0,27,1,2,2,5,0xb2d38f03
100311.75,3.0,39,3,4,2,9,0xb2d60ce1d
8737.17,1.0,18,2,2,2,6,0xb2d1045dd
22745.37,2.0,129,2,3,1,6,0xb2d45b18d
6904.64,1.0,92,2,2,1,5,0xb2d30492d
12416.76,1.0,92,2,2,1,5,0xb2d24ab9
962624.58,22.0,0,4,4,4,12,0xb2d6a925d
1170.84,2.0,92,1,3,1,5,0x3b9b1536
200031.28,2.0,27,3,3,2,8,0xb2d6efa5d
90392.08,3.0,129,3,4,1,8,0xb2d479ba
1033859.39,19.0,1,4,4,4,12,0xb2d5b5cfd
674503.61,12.0,3,4,4,4,12,0xb2d181cb
110442.83,2.0,10,3,3,3,9,0xb2d6472dd
86198.53,4.0,10,3,4,3,10,0xb2d58fa0
5013.2,1.0,92,2,2,1,5,0xb2d4164bd
3852.92,1.0,29,2,2,2,6,0xb2d91bcd
523015.54,5.0,25,4,4,2,10,0xb2d630a7d
10200.05,1.0,287,2,2,1,5,0xb2d5dc29d
689882.77,6.0,45,4,4,2,10,0xb2d1083ed
103.17,2.0,53,1,3,2,6,0xb2d8fee4d
66474.74,1.0,11,3,2,3,8,0xb2d9225d
137.77,1.0,35,1,2,2,5,0xb2d5d7e5
52528.11,2.0,11,3,3,3,9,0xb2d62a0cd
809843.95,3.0,2,4,4,4,12,0xb2d640aad
304282.45,4.0,25,4,4,2,10,0xb2d92c71d
188974.04,11.0,0,3,4,4,11,0x3b9b46a7d
103271.5,6.0,3,3,4,4,11,0xb2d5587ad
504105.5,2.0,63,4,3,2,9,0xb2d90376d
10098.08,2.0,123,2,3,1,6,0xb2d597bc
28716.66,1.0,305,2,2,1,5,0xb2d411abd
10377.12,1.0,72,2,2,1,5,0xb2d6892ed
50010.08,2.0,102,2,3,1,6,0xb2d78e48d
207111.27,2.0,1,3,3,4,10,0xb2d1c8bcd
112399.23,3.0,0,3,4,4,11,0xb2d0feaed
231183.35,5.0,4,3,4,4,11,0xb2d11f15d
30065.54,1.0,10,2,2,3,7,0xb2d92a0dd
1034927.29,6.0,10,4,4,3,11,0xb2d49d54d
5024.94,2.0,0,2,3,4,9,0xb2d15ab0
521372.73,3.0,30,4,4,2,10,0xb2d6a8f3d
256904.75,1.0,0,3,2,4,9,0xb2d93c7cd
1996.72,1.0,184,1,2,1,4,0xb2d2a73ed
8.23,1.0,84,1,2,1,4,0xb2d69ddd
210796.04,2.0,3,3,3,4,10,0xb2d6a571
235445.33,3.0,10,3,4,3,10,0xb2d6b018d
620019.79,4.0,40,4,4,2,10,0xb2d09633d
149308.12,2.0,11,3,3,3,9,0xb2d39612
999.13,1.0,2,1,2,4,7,0xb2d0bdde
33015.45,1.0,0,2,2,4,8,0xb2d43a30d
10646.77,1.0,14,2,2,3,7,0xb2d5e48b
55094.93,2.0,116,3,3,1,7,0xb2d50990d
2296.8,1.0,9,1,2,3,6,0xb2d376bbd
28.87,1.0,3,1,2,4,7,0xb2d40fd3d
3.48,1.0,61,1,2,2,5,0xb2d96a91
704.47,1.0,7,1,2,3,6,0xb2d8ca84d
660000.52,6.0,4,4,4,4,12,0xb2d18468d
150063.21,3.0,18,3,4,2,9,0xb2d34376d
0.63,1.0,116,1,2,1,4,0xb2d78648d
27716.25,1.0,7,2,2,3,7,0xb2d46edad
703.83,1.0,104,1,2,1,4,0xb2d69a0ad
19679.14,1.0,0,2,2,4,8,0xb2d74b1a
1000038.04,3.0,49,4,4,2,10,0xb2d778efd
123711.13,3.0,0,3,4,4,11,0xb2d09f18
4.75,1.0,80,1,2,1,4,0xb2d969ad
444091.76,12.0,25,4,4,2,10,0xb2d3b6c0d
130002.22,4.0,98,3,4,1,8,0xb2d8df3cd
2028239.92,3.0,9,4,4,3,11,0xb2d4348ad
207.09,1.0,0,1,2,4,7,0xb2d2e5ad
225004.27,6.0,3,3,4,4,11,0xb2d6507e
55595.78,1.0,67,3,2,1,6,0xb2d0f744d
900017.0,5.0,118,4,4,1,9,0xb2d4003dd
805557.17,1.0,63,4,2,2,8,0xb2d953cc
214978.7,3.0,88,3,4,1,8,0xb2d6e1d5d
40666.33,1.0,92,2,2,1,5,0xb2d2067fd
7438.89,1.0,0,2,2,4,8,0xb2d44c1ed
337.69,1.0,10,1,2,3,6,0xb2d271e5
441.88,1.0,3,1,2,4,7,0xb2d9541a
50022.78,2.0,48,2,3,2,7,0xb2d4421ad
101161.89,2.0,168,3,3,1,7,0xb2d42b73d
2027.94,1.0,3,1,2,4,7,0xb2d6e85e
100004.96,2.0,92,3,3,1,7,0xb2d39f93d
21.96,1.0,55,1,2,2,5,0xb2d305edd
252015.12,3.0,12,3,4,3,10,0xb2d6289bd
13250.65,1.0,181,2,2,1,5,0xb2d12734d
500003.51,11.0,74,4,4,1,9,0xb2d5c4c8d
100005.29,2.0,189,3,3,1,7,0xb2d65346d
10302.18,1.0,4,2,2,4,8,0xb2d6b2afd
50007.03,2.0,55,2,3,2,7,0xb2d6d0d6d
2784.02,3.0,92,1,4,1,6,0x3b9b1b5ad
271552.41,4.0,83,3,4,1,8,0xb2d155c0
100004.23,2.0,98,3,3,1,7,0xb2d96c41d
20001.16,2.0,77,2,3,1,6,0xb2d982d3
145300.63,1.0,0,3,2,4,9,0x3b9ada89d
421.28,1.0,50,1,2,2,5,0xb2d146d3
459428.57,3.0,43,4,4,2,10,0xb2d67a1fd
258341.69,2.0,63,3,3,2,8,0xb2d12b19
104400.0,2.0,1,3,3,4,10,0xb2d10ef6
527185.01,2.0,0,4,3,4,11,0xb2d0cc5dd
24.01,1.0,9,1,2,3,6,0xb2d6bf90
3137.12,1.0,97,2,2,1,5,0xb2d5e6a9d
400200.73,2.0,19,4,3,2,9,0xb2d645f2d
1093.85,3.0,184,1,4,1,6,0x3b9ae146d
21020.38,4.0,12,2,4,3,9,0xb2d0c2e8d
200099.3,2.0,167,3,3,1,7,0xb2d1130cd
1884902.02,10.0,33,4,4,2,10,0x3b9b3858d
660027.87,2.0,92,4,3,1,8,0xb2d97ba7d
15.52,2.0,22,1,3,2,6,0xb2d249a1
10000.53,2.0,97,2,3,1,6,0xb2d96a70d
2101.8,1.0,224,1,2,1,4,0xb2d2f301d
0.0,1.0,7,1,2,3,6,0xb2d979ca
328148.42,13.0,8,4,4,3,11,0xb2d621f3d
31639.12,3.0,67,2,4,1,7,0x3b9b425bd
367143.94,6.0,14,4,4,3,11,0x3b9adc01d
349.2,2.0,1,1,3,4,8,0x3b9b40d4
1000220.78,2.0,105,4,3,1,8,0xb2d95d7dd
75831.82,6.0,27,3,4,2,9,0xb2d37797d
100001.06,2.0,98,3,3,1,7,0xb2d96e60d
248.25,1.0,13,1,2,3,6,0xb2d326ba
500000.0,3.0,7,4,4,3,11,0xb2d97238d
483.14,8.0,0,1,4,4,9,0xb2d09d8bd
60004.23,2.0,87,3,3,1,7,0xb2d1b348
80105.27,3.0,0,3,4,4,11,0xb2d57b57d
2497.66,2.0,211,1,3,1,5,0xb2d509dfd
50003.59,3.0,42,2,4,2,8,0xb2d6e688d
6000.65,1.0,4,2,2,4,8,0xb2d5d5d6d
1022337.86,5.0,18,4,4,2,10,0xb2d1a627d
390206.07,4.0,33,4,4,2,10,0x3b9b36dbd
584337.72,4.0,25,4,4,2,10,0xb2d68ea6d
7284.53,1.0,15,2,2,3,7,0xb2d6e7f6d
1040035.47,2.0,39,4,3,2,9,0xb2d8d1a1d
17579.86,1.0,10,2,2,3,7,0xb2d97c58
68.62,1.0,48,1,2,2,5,0xb2d4878cd
4682.13,1.0,9,2,2,3,7,0xb2d8d372d
25215.17,1.0,0,2,2,4,8,0xb2d6bf5bd
303197.71,2.0,92,4,3,1,8,0xb2d98351d
203044.56,14.0,0,3,4,4,11,0xb2d6503dd
13128.19,1.0,0,2,2,4,8,0xb2d9840e
470110.33,9.0,20,4,4,2,10,0xb2d10ac1d
70001.48,2.0,221,3,3,1,7,0xb2d6ff77
1103968.23,3.0,13,4,4,3,11,0xb2d6fa6bd
150056.58,5.0,0,3,4,4,11,0xb2d44336
85003.22,2.0,92,3,3,1,7,0xb2d97c9dd
530083.59,2.0,14,4,3,3,10,0xb2d242fcd
1240.8,1.0,45,1,2,2,5,0xb2d940e8d
875823.82,7.0,20,4,4,2,10,0xb2d23706
10000.82,2.0,92,2,3,1,6,0xb2d97349
67001.41,2.0,92,3,3,1,7,0xb2d64629d
0.68,1.0,0,1,2,4,7,0xb2d1db4ad
521946.0,3.0,34,4,4,2,10,0xb2d6cbc1d
36003.25,2.0,76,2,3,1,6,0xb2d63750d
1558741.32,7.0,4,4,4,4,12,0xb2d2cb2c
0.0,1.0,10,1,2,3,6,0xb2d95a11d
100015.93,2.0,31,3,3,2,8,0xb2d3f281d
34.53,1.0,35,1,2,2,5,0xb2d3a431d
1012013.11,38.0,0,4,4,4,12,0xb2d23e9ad
500628.31,3.0,0,4,4,4,12,0xb2d598c7d
101220.18,1.0,31,3,2,2,7,0xb2d12d07d
1401.4,1.0,10,1,2,3,6,0xb2d68c1ed
82833.0,3.0,6,3,4,3,10,0xb2d12b45
175605.66,5.0,13,3,4,3,10,0xb2d2e3d7d
3779.13,1.0,12,2,2,3,7,0xb2d963f8
305.5,1.0,66,1,2,2,5,0xb2d941c6d
4.37,1.0,0,1,2,4,7,0xb2d1f758d
250000.8,5.0,0,3,4,4,11,0xb2d1a75d
5016.49,1.0,92,2,2,1,5,0xb2d55cf4d
508192.31,2.0,157,4,3,1,8,0xb2d2a083d
363038.02,6.0,11,4,4,3,11,0xb2d2045c
14.12,1.0,31,1,2,2,5,0xb2d95108
11662.19,1.0,6,2,2,3,7,0xb2d947ff
272515.46,2.0,20,3,3,2,8,0xb2d3a31cd
186176.77,8.0,0,3,4,4,11,0xb2d52ed2d
70105.27,3.0,13,3,4,3,10,0xb2d420c2
3343.86,1.0,10,2,2,3,7,0xb2d6c8bdd
971.6,1.0,3,1,2,4,7,0xb2d2a2a6
60.44,2.0,81,1,3,1,5,0xb2d06866d
1208.63,1.0,19,1,2,2,5,0xb2d6c18ed
60451.82,2.0,92,3,3,1,7,0xb2d34919d
3.51,1.0,77,1,2,1,4,0xb2d67dd2d
20593.61,1.0,15,2,2,3,7,0xb2d6e7e1d
10745.91,1.0,184,2,2,1,5,0xb2d65796d
331393.32,7.0,22,4,4,2,10,0xb2d4dfeed
2191.63,1.0,184,1,2,1,4,0xb2d0bee0d
170001.8,3.0,25,3,4,2,9,0xb2d956a2d
715636.85,9.0,0,4,4,4,12,0xb2d67cac
5415.87,1.0,9,2,2,3,7,0xb2d32384d
15096.62,1.0,84,2,2,1,5,0xb2d4a9afd
70849.67,2.0,136,3,3,1,7,0xb2d27687
71762.68,2.0,62,3,3,2,8,0xb2d5a9c9d
33705.49,1.0,20,2,2,2,6,0xb2d60ad0d
401228.8,3.0,1,4,4,4,12,0xb2d6becdd
40302.46,3.0,74,2,4,1,7,0xb2d6588ed
100002.53,4.0,10,3,4,3,10,0xb2d64500d
450000.74,5.0,1,4,4,4,12,0xb2d3fbdcd
204268.95,1.0,0,3,2,4,9,0xb2d28f4fd
120098.04,2.0,123,3,3,1,7,0xb2d10ec5d
7766.47,1.0,0,2,2,4,8,0xb2d6aa7cd
91950.56,3.0,103,3,4,1,8,0xb2d06632d
1037242.0,1.0,5,4,2,3,9,0xb2d4da96d
422.22,1.0,84,1,2,1,4,0xb2d9622ad
464029.82,11.0,10,4,4,3,11,0xb2d560b7d
13510.52,2.0,45,2,3,2,7,0xb2d65703d
314.98,1.0,1,1,2,4,7,0xb2d8faff
465000.0,3.0,1,4,4,4,12,0xb2d6230dd
20613.47,2.0,166,2,3,1,6,0x3b9b2b57d
50016.74,1.0,33,2,2,2,6,0xb2d98063
505329.88,2.0,102,4,3,1,8,0xb2d96b1bd
2323.19,1.0,92,1,2,1,4,0xb2d2dd19d
807937.02,4.0,111,4,4,1,9,0xb2d94d0fd
84.13,1.0,22,1,2,2,5,0xb2d2f57f
1225617.76,4.0,0,4,4,4,12,0xb2d6b32dd
609.0,1.0,11,1,2,3,6,0xb2d964b5
831031.67,3.0,18,4,4,2,10,0xb2d429ccd
500000.1,2.0,25,4,3,2,9,0xb2d94f22d
770004.13,7.0,27,4,4,2,10,0xb2d60ecad
7348.34,1.0,46,2,2,2,6,0xb2d97817
21893.34,3.0,184,2,4,1,7,0xb2d0943a
21712.04,1.0,92,2,2,1,5,0xb2d19400d
7672.02,1.0,13,2,2,3,7,0xb2d1f545d
1378010.8,5.0,15,4,4,3,11,0xb2d95504d
103672.27,3.0,0,3,4,4,11,0x3b9b0e52d
898454.46,4.0,29,4,4,2,10,0xb2d63fe4d
2173.13,1.0,13,1,2,3,6,0xb2d970e2
602.78,1.0,13,1,2,3,6,0xb2d94b32
40848.29,1.0,0,2,2,4,8,0xb2d2dfb0d
735.33,1.0,4,1,2,4,7,0xb2d6a7d5d
6507.91,1.0,0,2,2,4,8,0xb2d681e1d
3121.62,8.0,184,2,4,1,7,0x3b9ad208d
11010.13,1.0,6,2,2,3,7,0xb2d5b2f6
12139.7,1.0,32,2,2,2,6,0xb2d9496d
111135.6,3.0,1,3,4,4,11,0xb2d94accd
268473.81,2.0,76,3,3,1,7,0xb2d3b3c4d
3930.07,1.0,0,2,2,4,8,0xb2d1eac1d
240942.23,1.0,2,3,2,4,9,0xb2d2894ad
7172.0,1.0,11,2,2,3,7,0xb2d56195
206190.53,3.0,1,3,4,4,11,0xb2d06816
1733.56,1.0,8,1,2,3,6,0xb2d223e2d
120112.86,3.0,80,3,4,1,8,0xb2d5a55ad
3871.13,1.0,159,2,2,1,5,0xb2d5fd1ed
1140259.81,4.0,59,4,4,2,10,0xb2d18989d
237.5,1.0,20,1,2,2,5,0xb2d81263d
472.14,1.0,14,1,2,3,6,0x3b9aef29
414874.08,5.0,82,4,4,1,9,0xb2d48bd3d
500327.3,2.0,13,4,3,3,10,0xb2d963e3d
31061.78,1.0,19,2,2,2,6,0xb2d69d31d
1002.41,1.0,184,1,2,1,4,0xb2d41684d
25247195.45,32.0,73,4,4,1,9,0x3b9ae3ecd
100194.03,2.0,95,3,3,1,7,0xb2d97943d
208.47,1.0,3,1,2,4,7,0xb2d2bfb3d
32701.91,1.0,0,2,2,4,8,0xb2d2b7a2d
301071.66,2.0,4,4,3,4,11,0xb2d8fb6e
780.69,1.0,11,1,2,3,6,0xb2d56558d
501852.18,2.0,27,4,3,2,9,0xb2d8e7a3d
13150.09,1.0,92,2,2,1,5,0xb2d30f5cd
505329.64,2.0,96,4,3,1,8,0xb2d97940d
5395.09,1.0,12,2,2,3,7,0xb2d5cb9a
2009.57,1.0,217,1,2,1,4,0xb2d29793d
30719.0,1.0,175,2,2,1,5,0xb2d4fe1ed
5378.81,1.0,12,2,2,3,7,0xb2d316ad
50362.76,2.0,27,2,3,2,7,0xb2d94be3d
581815.6,2.0,0,4,3,4,11,0xb2d683d5d
360040.64,2.0,217,4,3,1,8,0xb2d49382d
110002.88,2.0,55,3,3,2,8,0xb2d16fb3d
8.99,1.0,4,1,2,4,7,0xb2d4c691
188021.03,2.0,111,3,3,1,7,0xb2d1cddfd
818014.47,7.0,31,4,4,2,10,0xb2d242c9d
1895237.92,9.0,3,4,4,4,12,0xb2d1a447d
430000.0,3.0,3,4,4,4,12,0xb2d1d45a
1823137.78,15.0,14,4,4,3,11,0xb2d42135
2252.9,1.0,12,1,2,3,6,0xb2d1c953d
753.13,1.0,0,1,2,4,7,0xb2d68f13d
480887.11,4.0,29,4,4,2,10,0xb2d56214d
835001.11,26.0,48,4,4,2,10,0xb2d36e4bd
20972.24,2.0,10,2,3,3,8,0x3b9b298cd
700000.6,3.0,19,4,4,2,10,0xb2d95a6ed
302664.49,2.0,217,4,3,1,8,0xb2d230e8d
19.42,1.0,67,1,2,1,4,0xb2d9571d
100292.12,1.0,1,3,2,4,9,0xb2d37136d
25655.22,1.0,0,2,2,4,8,0xb2d9741e
400011.61,4.0,20,4,4,2,10,0xb2d781b2d
177.5,1.0,0,1,2,4,7,0xb2d2ec41
657017.32,9.0,11,4,4,3,11,0xb2d1bc62d
500028.37,2.0,11,4,3,3,10,0xb2d9634ad
252191.95,2.0,76,3,3,1,7,0xb2d42dbf
8263.2,1.0,10,2,2,3,7,0xb2d5179d
20001.66,3.0,27,2,4,2,8,0xb2d951c2d
2260.76,1.0,120,1,2,1,4,0xb2d3fd35
10103.2,1.0,184,2,2,1,5,0xb2d200c7d
4605.08,1.0,21,2,2,2,6,0xb2d2c790d
200004.97,4.0,18,3,4,2,9,0xb2d971f6d
281.91,1.0,10,1,2,3,6,0xb2d6ec3cd
2029.94,1.0,184,1,2,1,4,0xb2d38b79d
316534.06,1.0,1,4,2,4,10,0xb2d1c325
19107.52,1.0,26,2,2,2,6,0xb2d97e41d
450221.63,4.0,12,4,4,3,11,0xb2d6453bd
300303.94,5.0,5,4,4,3,11,0xb2d455c7
6044.23,1.0,1,2,2,4,8,0xb2d26d48
20000.32,3.0,25,2,4,2,8,0xb2d94833
10167.33,2.0,27,2,3,2,7,0xb2d8cfcfd
1313.16,1.0,0,1,2,4,7,0xb2d51edcd
108514.15,3.0,12,3,4,3,10,0x3b9b30a5d
2061.94,1.0,184,1,2,1,4,0xb2d11e89d
5977.94,1.0,9,2,2,3,7,0xb2d2c051
500002.35,3.0,10,4,4,3,11,0xb2d8fe25d
2393.55,1.0,11,1,2,3,6,0xb2d55166d
4321.86,1.0,1,2,2,4,8,0xb2d56690
370694.0,10.0,0,4,4,4,12,0xb2d09e5ad
500328.8,2.0,8,4,3,3,10,0xb2d966a2d
3188.24,1.0,8,2,2,3,7,0xb2d20f8dd
842.11,1.0,12,1,2,3,6,0xb2d15f7e
98.63,1.0,92,1,2,1,4,0xb2d95ebfd
367000.0,19.0,0,4,4,4,12,0xb2d55d7fd
3483.78,1.0,92,2,2,1,5,0xb2d3c422d
140921.21,3.0,25,3,4,2,9,0xb2d584abd
74641.76,2.0,164,3,3,1,7,0xb2d2f1a4d
97976.51,2.0,0,3,3,4,10,0xb2d19b89d
2.44,1.0,11,1,2,3,6,0xb2d63333
181715.35,1.0,27,3,2,2,7,0xb2d3609f
92082.49,1.0,0,3,2,4,9,0xb2d95dde
651077.45,2.0,10,4,3,3,10,0xb2d639a2d
0.67,1.0,3,1,2,4,7,0xb2d603e9d
510266.37,4.0,47,4,4,2,10,0xb2d96e9ad
52803.74,7.0,0,3,4,4,11,0x3b9af0d9
50027.78,2.0,60,2,3,2,7,0xb2d3682e
220067.2,2.0,11,3,3,3,9,0xb2d1de4fd
20002.42,3.0,27,2,4,2,8,0xb2d94794d
416.29,1.0,78,1,2,1,4,0xb2d96c2dd
327062.18,9.0,69,4,4,1,9,0xb2d249fed
776.49,1.0,0,1,2,4,7,0xb2d31c31d
40.17,1.0,71,1,2,1,4,0xb2d240dbd
250000.64,2.0,7,3,3,3,9,0xb2d94a4f
787693.15,10.0,3,4,4,4,12,0xb2d69e3ad
642878.35,5.0,53,4,4,2,10,0xb2d6c8f6d
10.39,1.0,47,1,2,2,5,0xb2d98322
388063.38,2.0,0,4,3,4,11,0xb2d1a29a
200.98,1.0,15,1,2,3,6,0xb2d94623
680.0,1.0,3,1,2,4,7,0xb2d5d22dd
98046.14,3.0,0,3,4,4,11,0xb2d0d872d
3.44,1.0,1,1,2,4,7,0xb2d951ed
643845.71,8.0,29,4,4,2,10,0xb2d5ba1ed
210015.5,3.0,7,3,4,3,10,0xb2d6e7abd
404358.53,3.0,70,4,4,1,9,0xb2d42c54d
2033.98,1.0,102,1,2,1,4,0xb2d58fa6d
1.96,1.0,20,1,2,2,5,0xb2d31503
20.56,1.0,10,1,2,3,6,0xb2d3023cd
1486848.46,6.0,40,4,4,2,10,0xb2d50655d
20734.56,2.0,11,2,3,3,8,0xb2d68b98d
1700.68,1.0,0,1,2,4,7,0xb2d3e862
5671.94,1.0,184,2,2,1,5,0xb2d2744fd
57414.72,2.0,80,3,3,1,7,0xb2d0f440d
620392.46,4.0,40,4,4,2,10,0xb2d17d2d
38587.39,1.0,0,2,2,4,8,0xb2d60518
1367.24,1.0,5,1,2,3,6,0xb2d95d69
800304.92,3.0,21,4,4,2,10,0xb2d18284d
3024932.6,20.0,3,4,4,4,12,0xb2d17c76d
95041.92,2.0,203,3,3,1,7,0xb2d1b3f6d
3801.54,1.0,195,2,2,1,5,0xb2d573b1d
1.56,1.0,1,1,2,4,7,0xb2d1f5de
1091.54,1.0,9,1,2,3,6,0xb2d3b81fd
2.16,1.0,92,1,2,1,4,0xb2d23117d
7.29,1.0,73,1,2,1,4,0xb2d962f4
582.79,1.0,82,1,2,1,4,0xb2d55c5cd
20000.84,2.0,14,2,3,3,8,0xb2d63da1
282073.79,5.0,0,3,4,4,11,0xb2d11d35d
10000.11,2.0,95,2,3,1,6,0xb2d97b21
140029.35,3.0,53,3,4,2,9,0xb2d3b945d
3006.04,1.0,201,2,2,1,5,0xb2d75743d
81290.23,2.0,210,3,3,1,7,0xb2d64427d
972024.4,5.0,4,4,4,4,12,0xb2d10fb0d
801168.99,3.0,6,4,4,3,11,0xb2d19c3b
2105.5,1.0,0,1,2,4,7,0xb2d96bb8
81917.62,1.0,46,3,2,2,7,0xb2d2a972d
286343.41,1.0,9,3,2,3,8,0xb2d5b4f1d
4067917.3,3.0,0,4,4,4,12,0xb2d3551cd
30000.67,2.0,170,2,3,1,6,0xb2d8123c
309123.71,2.0,21,4,3,2,9,0xb2d8c490
551978.1,9.0,0,4,4,4,12,0xb2d12830d
2715.33,1.0,3,1,2,4,7,0xb2d94dd6d
10147.8,1.0,5,2,2,3,7,0xb2d6d419d
200025.03,1.0,2,3,2,4,9,0xb2d5bd19
100003.17,3.0,110,3,4,1,8,0xb2d6e591d
603.52,1.0,86,1,2,1,4,0xb2d978f6d
201210.39,2.0,12,3,3,3,9,0xb2d5ff33d
270023.69,5.0,25,3,4,2,9,0xb2d209e5d
8903.04,1.0,14,2,2,3,7,0xb2d68ccad
450.35,2.0,18,1,3,2,6,0xb2d06915d
0.0,1.0,8,1,2,3,6,0xb2d98310d
922083.01,5.0,56,4,4,2,10,0xb2d330c5d
3183.85,1.0,18,2,2,2,6,0xb2d6a6d4
108.77,2.0,21,1,3,2,6,0xb2d6605c
100002.64,3.0,18,3,4,2,9,0xb2d6233dd
5938.15,1.0,0,2,2,4,8,0xb2d96801
401485.09,2.0,36,4,3,2,9,0xb2d0f242
2000.35,1.0,8,1,2,3,6,0xb2d6ed98d
7021.28,1.0,48,2,2,2,6,0xb2d1b86cd
0.0,1.0,6,1,2,3,6,0xb2d77684
6322.63,1.0,14,2,2,3,7,0xb2d8c855
601084.96,3.0,4,4,4,4,12,0xb2d8d045d
450039.8,4.0,20,4,4,2,10,0xb2d62d3bd
1735049.91,12.0,0,4,4,4,12,0xb2d5272bd
43.83,1.0,13,1,2,3,6,0xb2d0717e
10172.18,1.0,92,2,2,1,5,0xb2d0b55ed
27119.4,1.0,56,2,2,2,6,0xb2d3f9ddd
1631.79,1.0,0,1,2,4,7,0xb2d6d778d
205.02,1.0,8,1,2,3,6,0xb2d6b642d
1311.85,1.0,74,1,2,1,4,0xb2d20e01
120061.86,1.0,32,3,2,2,7,0xb2d979b6
7.59,1.0,1,1,2,4,7,0xb2d955dad
1684565.43,26.0,8,4,4,3,11,0x3b9b386ad
5892.49,2.0,184,2,3,1,6,0xb2d59eecd
333447.54,2.0,0,4,3,4,11,0xb2d32d53d
10156.69,1.0,184,2,2,1,5,0xb2d1362ed
520010.67,6.0,18,4,4,2,10,0xb2d8d27ed
6086.19,1.0,0,2,2,4,8,0xb2d9508b
32.19,1.0,5,1,2,3,6,0x3b9b435c
88353.74,3.0,12,3,4,3,10,0xb2d3a058
305071.44,3.0,42,4,4,2,10,0xb2d32f69
140726.07,2.0,25,3,3,2,8,0xb2d12ac1d
1428609.54,13.0,2,4,4,4,12,0xb2d63eebd
54520.02,8.0,0,3,4,4,11,0x3b9b4591d
180560.93,4.0,122,3,4,1,8,0xb2d1c6ecd
460007.12,4.0,46,4,4,2,10,0xb2d3fe7fd
62325.99,1.0,0,3,2,4,9,0xb2d1edc5
271247.16,4.0,112,3,4,1,8,0xb2d29a98d
270083.85,2.0,2,3,3,4,10,0xb2d96ff3d
1.78,1.0,46,1,2,2,5,0xb2d6ea4e
262771.85,2.0,23,3,3,2,8,0xb2d950bbd
110001.16,3.0,92,3,4,1,8,0xb2d9802bd
526.64,1.0,54,1,2,2,5,0xb2d96f2dd
896636.16,7.0,14,4,4,3,11,0xb2d574a1d
39.85,1.0,46,1,2,2,5,0xb2d5da6a
217009.51,4.0,95,3,4,1,8,0xb2d968fad
1.16,1.0,8,1,2,3,6,0xb2d2a53d
313857.73,5.0,0,4,4,4,12,0x3b9b4639d
1332282.28,8.0,0,4,4,4,12,0x3b9b396dd
1095.88,1.0,92,1,2,1,4,0xb2d20abad
3500000.0,2.0,92,4,3,1,8,0xb2d5dac2d
567055.16,5.0,14,4,4,3,11,0xb2d95df6d
143000.0,10.0,6,3,4,3,10,0xb2d0b41ed
560000.99,3.0,1,4,4,4,12,0xb2d66675d
157000.09,5.0,1,3,4,4,11,0xb2d8d27cd
600106.38,4.0,6,4,4,3,11,0xb2d975f9d
1286109.82,13.0,0,4,4,4,12,0xb2d53480
3.27,1.0,69,1,2,1,4,0xb2d95277
20120.54,2.0,12,2,3,3,8,0xb2d4ad65d
10013.61,2.0,56,2,3,2,7,0xb2d64437d
403127.52,4.0,6,4,4,3,11,0xb2d2965ed
120013.81,4.0,11,3,4,3,10,0xb2d95ca3d
5383.86,1.0,92,2,2,1,5,0xb2d59d30d
473049.66,17.0,10,4,4,3,11,0xb2d30075d
435025.38,3.0,179,4,4,1,9,0xb2d50ab6d
610097.41,2.0,32,4,3,2,9,0xb2d19968d
16000406.55,163.0,5,4,4,3,11,0xb2d155d0d
120389.5,8.0,8,3,4,3,10,0xb2d3ce58
2903.3,1.0,10,2,2,3,7,0xb2d68b35d
600019.04,3.0,48,4,4,2,10,0xb2d98055
1003.42,1.0,184,1,2,1,4,0xb2d5b4b5d
0.0,1.0,0,1,2,4,7,0xb2d5f156
380002.37,2.0,26,4,3,2,9,0xb2d94bdbd
18521.59,1.0,15,2,2,3,7,0xb2d6a196d
900009.9,4.0,0,4,4,4,12,0xb2d242f9d
2305.47,1.0,184,1,2,1,4,0xb2d202fbd
140000.07,1.0,1,3,2,4,9,0xb2d94e30d
1037523.8,11.0,0,4,4,4,12,0xb2d23ffad
34185.82,2.0,6,2,3,3,8,0x3b9b3adbd
12696.28,1.0,1,2,2,4,8,0xb2d65fc0d
6683.61,1.0,24,2,2,2,6,0xb2d6f764d
12.02,1.0,11,1,2,3,6,0xb2d24c30d
846738.59,1.0,0,4,2,4,10,0xb2d8638ad
50000.0,1.0,1,2,2,4,8,0xb2d96780
282.15,1.0,9,1,2,3,6,0xb2d2a67dd
480575.84,8.0,8,4,4,3,11,0xb2d0d4acd
77115.03,5.0,1,3,4,4,11,0xb2d9568ed
76464.42,5.0,6,3,4,3,10,0xb2d242f0d
1188.86,1.0,92,1,2,1,4,0xb2d17e97d
280006.79,2.0,11,3,3,3,9,0xb2d8e188d
202706.49,2.0,2,3,3,4,10,0xb2d656dcd
7066.65,1.0,184,2,2,1,5,0xb2d38b55d
35.36,1.0,2,1,2,4,7,0xb2d568d1
2016.11,1.0,1,1,2,4,7,0xb2d967dd
166656.24,1.0,10,3,2,3,8,0xb2d5386bd
10277.77,1.0,92,2,2,1,5,0xb2d2d5dcd
500298.41,3.0,6,4,4,3,11,0xb2d8fc64d
63.1,1.0,4,1,2,4,7,0xb2d61019d
57.02,1.0,78,1,2,1,4,0xb2d26315
1.24,1.0,10,1,2,3,6,0xb2d952a1
1003552.11,4.0,13,4,4,3,11,0xb2d6dc40d
107.35,1.0,47,1,2,2,5,0xb2d96024
910552.11,5.0,21,4,4,2,10,0xb2d5f661
30000.95,2.0,102,2,3,1,6,0xb2d95fdcd
61326.5,5.0,0,3,4,4,11,0xb2d5d482
520010.98,2.0,80,4,3,1,8,0xb2d8d4c7d
4.24,1.0,0,1,2,4,7,0xb2d1c50e
400731.28,3.0,7,4,4,3,11,0xb2d98346d
28004.0,3.0,4,2,4,4,10,0xb2d0cf59d
1558383.3,9.0,5,4,4,3,11,0xb2d5ee30d
0.0,2.0,7,1,3,3,7,0xb2d09a49
100000.0,2.0,92,3,3,1,7,0xb2d259afd
801054.97,5.0,47,4,4,2,10,0xb2d8a06c
159928.36,2.0,9,3,3,3,9,0xb2d4f6e9
1088.81,1.0,95,1,2,1,4,0xb2d5f981d
40359.02,2.0,83,2,3,1,6,0xb2d632ffd
209336.68,2.0,10,3,3,3,9,0xb2d2910cd
27.52,1.0,22,1,2,2,5,0xb2d5ae8e
260015.1,4.0,14,3,4,3,10,0xb2d1c560
220007.7,20.0,0,3,4,4,11,0xb2d1944ed
499000.1,3.0,1,4,4,4,12,0xb2d981f0d
6278.82,1.0,21,2,2,2,6,0xb2d9498c
43163.29,1.0,13,2,2,3,7,0xb2d150ddd
100084.14,5.0,13,3,4,3,10,0xb2d5edc7d
2265.55,1.0,104,1,2,1,4,0xb2d5f39cd
92491.4,2.0,34,3,3,2,8,0xb2d22ac0d
420711.74,5.0,17,4,4,2,10,0xb2d5f5fed
20182.09,1.0,184,2,2,1,5,0xb2d2ec58d
133689.24,2.0,143,3,3,1,7,0xb2d4c60bd
36959.43,1.0,147,2,2,1,5,0xb2d1d73c
55585.84,3.0,0,3,4,4,11,0xb2d47e47d
430004.02,11.0,39,4,4,2,10,0xb2d5725ed
2593.34,1.0,3,1,2,4,7,0xb2d959a0
52180.3,1.0,20,3,2,2,7,0xb2d64e87d
6016.1,1.0,10,2,2,3,7,0xb2d9667e
10009.83,1.0,92,2,2,1,5,0xb2d1420bd
1286121.86,3.0,117,4,4,1,9,0xb2d4968bd
305375.32,2.0,84,4,3,1,8,0xb2d3c3b0d
166723.46,4.0,3,3,4,4,11,0xb2d28e96d
37.57,1.0,5,1,2,3,6,0xb2d6b93f
6226.36,1.0,2,2,2,4,8,0xb2d944af
1787.68,1.0,20,1,2,2,5,0xb2d303c3
15309.47,1.0,8,2,2,3,7,0xb2d1b8a5d
48000.51,2.0,30,2,3,2,7,0xb2d295f5d
2075.93,1.0,92,1,2,1,4,0xb2d15dfbd
0.03,1.0,2,1,2,4,7,0xb2d64850
118.63,1.0,9,1,2,3,6,0xb2d68082d
18051.64,1.0,0,2,2,4,8,0xb2d6bd3ed
78.98,1.0,0,1,2,4,7,0xb2d78f12
15674.02,1.0,21,2,2,2,6,0xb2d9635a
100006.17,4.0,39,3,4,2,9,0xb2d61958d
69414.44,3.0,0,3,4,4,11,0xb2d2ed61d
216.49,1.0,27,1,2,2,5,0xb2d447c9
137390.37,2.0,1,3,3,4,10,0xb2d2b317d
500001.9,4.0,6,4,4,3,11,0xb2d8d531d
520076.04,5.0,8,4,4,3,11,0xb2d95fc4d
26.6,1.0,19,1,2,2,5,0xb2d8ddce
1067.28,1.0,22,1,2,2,5,0xb2d637d1d
500028.53,2.0,0,4,3,4,11,0xb2d9846cd
370084.16,3.0,104,4,4,1,9,0xb2d5d074
1122.37,1.0,92,1,2,1,4,0xb2d3ffbdd
2515.82,1.0,2,1,2,4,7,0xb2d1fa0ad
600519.68,2.0,108,4,3,1,8,0xb2d68885d
29.59,1.0,111,1,2,1,4,0xb2d948a5d
252397.91,3.0,0,3,4,4,11,0xb2d622a4
780035.33,3.0,0,4,4,4,12,0xb2d954aed
33029.68,4.0,0,2,4,4,10,0xb2d6d6afd
12.87,1.0,2,1,2,4,7,0xb2d8d4e5
295254.9,3.0,0,3,4,4,11,0xb2d0ab80d
742.8,1.0,3,1,2,4,7,0xb2d3a15ad
123721.71,3.0,48,3,4,2,9,0xb2d96cedd
466.34,1.0,5,1,2,3,6,0xb2d632ead
306264.93,3.0,6,4,4,3,11,0xb2d59927d
217833.1,2.0,95,3,3,1,7,0xb2d3ba1dd
55.04,1.0,18,1,2,2,5,0xb2d3bc85
650.96,1.0,44,1,2,2,5,0xb2d8dc39
3625.93,2.0,92,2,3,1,6,0xb2d3d4d3d
64.45,1.0,9,1,2,3,6,0xb2d68735
301197.36,2.0,34,4,3,2,9,0xb2d9702cd
152501.11,1.0,0,3,2,4,9,0xb2d5c147d
44690.13,1.0,6,2,2,3,7,0xb2d68c72d
210014.75,2.0,21,3,3,2,8,0xb2d94c5c
1007699.59,14.0,0,4,4,4,12,0xb2d196b8d
656931.79,2.0,99,4,3,1,8,0xb2d95f19d
72584.42,7.0,0,3,4,4,11,0xb2d0f2c4d
249243.15,3.0,4,3,4,4,11,0xb2d06575
500075.55,2.0,11,4,3,3,10,0xb2d96abcd
503072.03,3.0,8,4,4,3,11,0xb2d488cfd
1201.19,1.0,103,1,2,1,4,0xb2d94ca7
595207.87,6.0,4,4,4,4,12,0xb2d39a38d
1474.83,1.0,3,1,2,4,7,0xb2d2cf0fd
3164.28,1.0,160,2,2,1,5,0xb2d3a001d
184.45,1.0,211,1,2,1,4,0xb2d781fbd
77.07,1.0,77,1,2,1,4,0xb2d40b53
15182.76,1.0,21,2,2,2,6,0xb2d964f2
617003.34,5.0,0,4,4,4,12,0xb2d3ffcbd
182132.48,2.0,0,3,3,4,10,0xb2d94194d
810001.48,4.0,17,4,4,2,10,0xb2d6b6e2d
15028.02,2.0,9,2,3,3,8,0xb2d6e232d
207.33,1.0,8,1,2,3,6,0xb2d9492f
25000.09,3.0,8,2,4,3,9,0xb2d94230d
100009.07,2.0,156,3,3,1,7,0xb2d570c9
500000.0,3.0,4,4,4,4,12,0xb2d96537d
28484.43,3.0,8,2,4,3,9,0xb2d42a2ed
343.74,1.0,21,1,2,2,5,0xb2d3b345
480514.33,2.0,216,4,3,1,8,0xb2d1bb0cd
472742.06,4.0,10,4,4,3,11,0xb2d10affd
522648.5,4.0,4,4,4,4,12,0xb2d96786d
563.12,1.0,110,1,2,1,4,0xb2d22853d
27.57,2.0,7,1,3,3,7,0xb2d212ffd
1188.83,1.0,118,1,2,1,4,0xb2d286ced
3093.21,1.0,92,2,2,1,5,0xb2d0c779d
20000.0,2.0,0,2,3,4,9,0xb2d25710
0.0,1.0,101,1,2,1,4,0xb2d55653d
27.54,1.0,21,1,2,2,5,0xb2d4909dd
1001.5,1.0,184,1,2,1,4,0xb2d23853d
31.12,1.0,6,1,2,3,6,0xb2d974ce
190043.09,3.0,55,3,4,2,9,0xb2d65114d
542780.69,4.0,17,4,4,2,10,0xb2d63534d
2156.17,1.0,297,1,2,1,4,0xb2d6479cd
514641.69,3.0,81,4,4,1,9,0xb2d95f5fd
500.6,2.0,5,1,3,3,7,0x3b9b2856
4841488.37,2.0,73,4,3,1,8,0xb2d547ec
6955.92,1.0,0,2,2,4,8,0xb2d94537
123.91,1.0,69,1,2,1,4,0xb2d96c16
0.0,1.0,8,1,2,3,6,0xb2d4f7a6d
3904.75,1.0,20,2,2,2,6,0xb2d95fc8
90016.93,2.0,48,3,3,2,8,0xb2d5e0e9d
498.21,1.0,30,1,2,2,5,0xb2d97e70d
2762.45,3.0,2,1,4,4,9,0x3b9af1e2d
1000077.84,2.0,77,4,3,1,8,0xb2d97de0
260599.06,3.0,42,3,4,2,9,0xb2d17b0dd
2459.28,1.0,11,1,2,3,6,0xb2d68efdd
187401.46,3.0,3,3,4,4,11,0xb2d38c8dd
5033.81,1.0,96,2,2,1,5,0xb2d55863
3241.22,1.0,92,2,2,1,5,0xb2d2b33ed
25318.99,1.0,32,2,2,2,6,0xb2d32df3d
400009.68,2.0,8,4,3,3,10,0xb2d6836cd
112521.34,2.0,10,3,3,3,9,0xb2d975b2
0.0,1.0,1,1,2,4,7,0xb2d7ee3a
602132.06,2.0,40,4,3,2,9,0xb2d6fbf0
14607.01,1.0,11,2,2,3,7,0xb2d2bb75d
857020.5,12.0,4,4,4,4,12,0xb2d07b4dd
764.08,1.0,33,1,2,2,5,0xb2d68c57
300000.03,2.0,12,3,3,3,9,0xb2d96148d
23.75,1.0,46,1,2,2,5,0xb2d961c0
574977.77,4.0,60,4,4,2,10,0xb2d4129ed
14.0,1.0,0,1,2,4,7,0xb2d55157
364.25,1.0,8,1,2,3,6,0xb2d548a6
132768.78,2.0,0,3,3,4,10,0xb2d25076
1719.9,1.0,184,1,2,1,4,0xb2d23877d
13884.26,2.0,6,2,3,3,8,0xb2d95e6f
61139.68,1.0,3,3,2,4,9,0xb2d2e007d
173.39,1.0,60,1,2,2,5,0xb2d984b2
601780.26,3.0,9,4,4,3,11,0xb2d8ebe3d
190.9,1.0,92,1,2,1,4,0xb2d424a7d
3426.5,1.0,16,2,2,2,6,0xb2d78c74
3021.95,1.0,92,2,2,1,5,0xb2d34eccd
127211.2,2.0,60,3,3,2,8,0xb2d31166d
2814771.02,9.0,42,4,4,2,10,0xb2d69fc6
356012.14,2.0,221,4,3,1,8,0xb2d2aa23d
1953.87,1.0,2,1,2,4,7,0xb2d5e437d
3155778.61,7.0,10,4,4,3,11,0xb2d44af6d
52000.0,4.0,3,2,4,4,10,0xb2d5d4aad
2258010.02,14.0,4,4,4,4,12,0xb2d16f29d
213843.74,2.0,4,3,3,4,10,0xb2d60b24d
12428.69,1.0,184,2,2,1,5,0xb2d24ab9d
270002.9,5.0,0,3,4,4,11,0xb2d1cb32d
200020.86,2.0,18,3,3,2,8,0xb2d86d4ad
4404.65,1.0,7,2,2,3,7,0xb2d977dd
318770.74,4.0,41,4,4,2,10,0xb2d36762d
17721.13,1.0,0,2,2,4,8,0xb2d69a74
10129.3,1.0,24,2,2,2,6,0xb2d8c966d
1573.72,1.0,184,1,2,1,4,0xb2d114a4d
1913.26,1.0,0,1,2,4,7,0xb2d6a9b0
578704.57,8.0,1,4,4,4,12,0xb2d3b280d
5360.66,1.0,5,2,2,3,7,0xb2d94d50
310.38,1.0,10,1,2,3,6,0xb2d332d8
780089.44,3.0,101,4,4,1,9,0xb2d40136d
2224.79,1.0,184,1,2,1,4,0xb2d51729d
1005657.91,3.0,0,4,4,4,12,0xb2d28a85d
15.57,1.0,41,1,2,2,5,0xb2d0fc32
107012.54,2.0,266,3,3,1,7,0xb2d2c81cd
4696.37,1.0,184,2,2,1,5,0xb2d33327d
400033.96,3.0,18,4,4,2,10,0xb2d94789d
22694.57,1.0,6,2,2,3,7,0xb2d9756d
77147.18,1.0,191,3,2,1,6,0xb2d85230d
11004.38,1.0,77,2,2,1,5,0xb2d40b8dd
3195.2,1.0,0,2,2,4,8,0xb2d688e8d
1319.3,1.0,6,1,2,3,6,0xb2d517dfd
200006.53,2.0,77,3,3,1,7,0xb2d95089d
55731.82,2.0,4,3,3,4,10,0xb2d53042d
202404.15,3.0,123,3,4,1,8,0xb2d672dbd
263733.63,6.0,1,3,4,4,11,0x3b9b1861d
4628.48,1.0,4,2,2,4,8,0xb2d2b79ad
1031828.21,6.0,66,4,4,2,10,0xb2d41585d
200035.03,2.0,4,3,3,4,10,0xb2d16ee0
837.91,1.0,9,1,2,3,6,0xb2d2f016
5222.39,1.0,13,2,2,3,7,0xb2d6872d
238.76,1.0,47,1,2,2,5,0xb2d95815
310059.76,5.0,34,4,4,2,10,0xb2d98425
3980000.0,31.0,4,4,4,4,12,0xb2d0c719d
20071.31,1.0,92,2,2,1,5,0xb2d3a0cbd
12.76,1.0,43,1,2,2,5,0xb2d2309f
657384.03,3.0,8,4,4,3,11,0xb2d94504d
392011.59,7.0,56,4,4,2,10,0xb2d15657d
146776.98,2.0,92,3,3,1,7,0xb2d33c11d
86036.86,3.0,14,3,4,3,10,0xb2d1414dd
263164.53,3.0,3,3,4,4,11,0xb2d62c2bd
4.24,1.0,22,1,2,2,5,0xb2d97978d
103058.82,2.0,122,3,3,1,7,0xb2d56432d
4861.42,1.0,134,2,2,1,5,0xb2d458e5d
70562.89,1.0,123,3,2,1,6,0xb2d37ccdd
58.91,1.0,133,1,2,1,4,0xb2d31b68
200000.44,2.0,22,3,3,2,8,0xb2d5dcc2
51199.52,2.0,10,2,3,3,8,0xb2d5b014d
83.41,1.0,61,1,2,2,5,0xb2d9414d
4878.28,1.0,21,2,2,2,6,0xb2d96517
14048.66,1.0,6,2,2,3,7,0xb2d6d095
16534.3,1.0,0,2,2,4,8,0xb2d8fb46d
200031.42,2.0,27,3,3,2,8,0xb2d941b3d
2903.02,1.0,5,2,2,3,7,0xb2d64ccb
232072.46,2.0,4,3,3,4,10,0xb2d954cad
454.69,1.0,10,1,2,3,6,0xb2d972df
202723.15,2.0,36,3,3,2,8,0xb2d39956
0.17,1.0,3,1,2,4,7,0xb2d3c65d
13.09,1.0,18,1,2,2,5,0xb2d6827fd
13615.66,1.0,0,2,2,4,8,0xb2d85ce2d
14007.56,1.0,9,2,2,3,7,0xb2d8cb70d
70069.05,2.0,171,3,3,1,7,0xb2d5e4a6d
10082.38,1.0,215,2,2,1,5,0xb2d28a15d
5482.01,1.0,8,2,2,3,7,0xb2d2a6ded
364673.55,2.0,25,4,3,2,9,0xb2d6478ad
129.99,2.0,0,1,3,4,8,0x3b9b2751
317.11,1.0,15,1,2,3,6,0xb2d28502
10242.84,1.0,115,2,2,1,5,0xb2d37271d
24310.25,4.0,256,2,4,1,7,0xb2d0b169d
6327.04,1.0,13,2,2,3,7,0xb2d2156dd
1027002.43,2.0,25,4,3,2,9,0xb2d1ad80
1169.1,1.0,104,1,2,1,4,0xb2d39321
400000.0,3.0,1,4,4,4,12,0xb2d62ecb
113161.37,2.0,76,3,3,1,7,0xb2d433af
68.56,1.0,27,1,2,2,5,0xb2d97d3b
1091.75,1.0,18,1,2,2,5,0xb2d2b55d
23074.11,1.0,9,2,2,3,7,0xb2d95a49
172164.83,3.0,18,3,4,2,9,0xb2d6e693d
10935.7,1.0,9,2,2,3,7,0xb2d965bf
135057.87,4.0,20,3,4,2,9,0xb2d3e744d
20804.34,1.0,8,2,2,3,7,0xb2d95284
2522.41,1.0,81,1,2,1,4,0xb2d4ad7dd
36766.27,1.0,2,2,2,4,8,0xb2d54e9dd
1350017.57,3.0,18,4,4,2,10,0xb2d17a44d
541.23,1.0,0,1,2,4,7,0xb2d1439d
207360.08,4.0,0,3,4,4,11,0xb2d956a4d
34.76,1.0,0,1,2,4,7,0xb2d6d7e7
304347.31,6.0,27,4,4,2,10,0xb2d0ca58d
169181.29,4.0,7,3,4,3,10,0xb2d17820
402842.26,3.0,3,4,4,4,12,0xb2d97ed9
101168.74,2.0,179,3,3,1,7,0xb2d5d591d
79.8,1.0,54,1,2,2,5,0xb2d95d79
1178.71,1.0,0,1,2,4,7,0xb2d170acd
737575.39,3.0,1,4,4,4,12,0xb2d34bbad
805.35,1.0,0,1,2,4,7,0xb2d95e69
1149.1,1.0,9,1,2,3,6,0xb2d1f9c2
104.86,1.0,3,1,2,4,7,0xb2d97cc6
390000.0,20.0,4,4,4,4,12,0xb2d23d7ad
65002.58,4.0,55,3,4,2,9,0xb2d95fe6d
8264.22,1.0,0,2,2,4,8,0xb2d9689b
8018.8,1.0,0,2,2,4,8,0xb2d9622f
204689.99,2.0,24,3,3,2,8,0xb2d6c62fd
25010.61,2.0,129,2,3,1,6,0xb2d46d90d
50001.06,2.0,28,2,3,2,7,0xb2d95e48d
4.37,1.0,32,1,2,2,5,0xb2d97ea3
1074.8,1.0,1,1,2,4,7,0xb2d3e84a
200002.0,5.0,4,3,4,4,11,0xb2d227e7d
1145.43,1.0,184,1,2,1,4,0xb2d2660dd
1441.98,1.0,10,1,2,3,6,0xb2d97d3e
32341.73,3.0,0,2,4,4,10,0xb2d6b03dd
1010661.67,2.0,119,4,3,1,8,0xb2d94552d
132.11,1.0,83,1,2,1,4,0xb2d96c52d
1335.69,1.0,92,1,2,1,4,0xb2d2bdb2d
0.0,46.0,8,1,4,3,8,0xb2d126f0d
12639.3,2.0,172,2,3,1,6,0x3b9b0f6ad
13.27,1.0,3,1,2,4,7,0xb2d97855
699928.91,8.0,70,4,4,1,9,0xb2d19b92d
16.56,1.0,6,1,2,3,6,0xb2d6c1f4
11281.11,1.0,6,2,2,3,7,0xb2d9648a
10.48,1.0,59,1,2,2,5,0xb2d28a72
270000.07,7.0,3,3,4,4,11,0xb2d14f9c
7076.52,1.0,7,2,2,3,7,0xb2d965a7
9.46,1.0,11,1,2,3,6,0xb2d50622
59.48,1.0,5,1,2,3,6,0xb2d8e422d
633208.34,6.0,4,4,4,4,12,0xb2d64d67d
4.54,1.0,18,1,2,2,5,0xb2d8e4c1
593.81,2.0,20,1,3,2,6,0xb2d9543dd
4926.44,1.0,8,2,2,3,7,0xb2d6b7e1d
370020.72,3.0,5,4,4,3,11,0xb2d1ba1a
300000.0,2.0,5,3,3,3,9,0xb2d96481d
7.22,1.0,92,1,2,1,4,0xb2d976f3d
0.11,1.0,14,1,2,3,6,0xb2d95bd5d
239580.5,1.0,40,3,2,2,7,0xb2d29921d
10032.82,2.0,0,2,3,4,9,0xb2d973e4
210020.76,3.0,55,3,4,2,9,0xb2d5f8cd
3417.36,1.0,10,2,2,3,7,0xb2d30039
4000041.45,2.0,17,4,3,2,9,0xb2d78c14d
5895.83,1.0,7,2,2,3,7,0xb2d96835
10105.01,1.0,34,2,2,2,6,0xb2d96f8b
28.61,1.0,3,1,2,4,7,0xb2d2b1e4
54200.15,3.0,0,3,4,4,11,0xb2d6e0d2d
63235.53,2.0,209,3,3,1,7,0xb2d222fbd
80.62,1.0,1,1,2,4,7,0xb2d970db
70000.74,3.0,98,3,4,1,8,0xb2d958b1d
26.78,1.0,14,1,2,3,6,0xb2d5b32bd
25942.25,1.0,14,2,2,3,7,0xb2d45a07
5124.78,1.0,92,2,2,1,5,0xb2d3b8c8
0.33,1.0,11,1,2,3,6,0xb2d60711d
180009.07,3.0,59,3,4,2,9,0xb2d9723dd
253797.65,3.0,95,3,4,1,8,0xb2d4e650d
1565324.13,9.0,20,4,4,2,10,0xb2d2cb2cd
3524.4,1.0,0,2,2,4,8,0xb2d4f53fd
5198.81,1.0,0,2,2,4,8,0xb2d8fd4dd
354000.15,8.0,0,4,4,4,12,0xb2d54e25d
2.59,1.0,30,1,2,2,5,0xb2d775ca
803.03,1.0,7,1,2,3,6,0xb2d335d0
20761.0,7.0,0,2,4,4,10,0xb2d0a287
340068.35,4.0,70,4,4,1,9,0xb2d621d5d
1212803.32,2.0,91,4,3,1,8,0xb2d98065d
1826.96,1.0,39,1,2,2,5,0xb2d59217d
815.63,1.0,3,1,2,4,7,0xb2d8cab1d
130006.63,2.0,158,3,3,1,7,0xb2d6bfb7
0.38,1.0,1,1,2,4,7,0xb2d363ba
90002.75,9.0,13,3,4,3,10,0xb2d9802fd
77303.89,5.0,0,3,4,4,11,0xb2d8ceefd
84425.01,1.0,92,3,2,1,6,0xb2d0f1ecd
1.64,1.0,42,1,2,2,5,0x3b9b4849
901233.25,5.0,33,4,4,2,10,0xb2d0a5b9
140002.55,4.0,174,3,4,1,8,0xb2d17c57d
100001.06,2.0,92,3,3,1,7,0xb2d64052d
93.17,1.0,7,1,2,3,6,0xb2d9450dd
3017.72,1.0,92,2,2,1,5,0xb2d28683d
0.11,1.0,92,1,2,1,4,0xb2d0ef72d
200000.0,2.0,27,3,3,2,8,0xb2d8f7e7
2014084.89,2.0,32,4,3,2,9,0xb2d97933d
72.08,1.0,10,1,2,3,6,0xb2d96862
3293.03,1.0,0,2,2,4,8,0xb2d96796
100003.17,2.0,200,3,3,1,7,0xb2d78d91
34.25,1.0,0,1,2,4,7,0xb2d42b4bd
6.03,2.0,59,1,3,2,6,0x3b9b2533d
221053.74,9.0,4,3,4,4,11,0xb2d21b81d
1211683.14,18.0,0,4,4,4,12,0x3b9b0e1fd
1000465.01,1.0,0,4,2,4,10,0xb2d45681
569454.13,6.0,19,4,4,2,10,0xb2d22e57
69.35,1.0,19,1,2,2,5,0xb2d604e2d
3064.66,2.0,9,2,3,3,8,0xb2d5c3d6d
12000.53,1.0,8,2,2,3,7,0xb2d9537a
2690.37,1.0,11,1,2,3,6,0xb2d68e34d
370000.42,2.0,0,4,3,4,11,0xb2d95092d
13278.42,1.0,9,2,2,3,7,0xb2d4ad3f
3905.42,1.0,184,2,2,1,5,0xb2d433c5d
70120.55,5.0,3,3,4,4,11,0xb2d5c453
3269.34,1.0,16,2,2,2,6,0xb2d7c1aed
0.29,1.0,3,1,2,4,7,0xb2d944b3d
53881.83,2.0,2,3,3,4,10,0xb2d62f79
780276.34,6.0,13,4,4,3,11,0xb2d959ced
7070.25,1.0,0,2,2,4,8,0xb2d9654d
266009.8,3.0,27,3,4,2,9,0xb2d96094
209277.83,2.0,38,3,3,2,8,0xb2d559f4d
107.78,1.0,30,1,2,2,5,0xb2d4116fd
56972.08,2.0,92,3,3,1,7,0xb2d252cfd
8117.73,2.0,14,2,3,3,8,0xb2d8c885
5001.99,1.0,16,2,2,2,6,0xb2d8a16d
135875.7,1.0,24,3,2,2,7,0xb2d24465d
1436.57,1.0,9,1,2,3,6,0xb2d2c61cd
500018.17,4.0,25,4,4,2,10,0xb2d94e34d
505329.49,2.0,92,4,3,1,8,0xb2d9837ad
10065.64,1.0,184,2,2,1,5,0xb2d3fe0ad
18725.77,3.0,0,2,4,4,10,0xb2d54e01
975021.17,26.0,18,4,4,2,10,0xb2d1c53ed
9620.69,1.0,21,2,2,2,6,0xb2d9567a
40002.11,2.0,70,2,3,1,6,0xb2d98380
30.7,1.0,54,1,2,2,5,0xb2d39009d
402189.47,10.0,0,4,4,4,12,0xb2d64814d
500004.0,3.0,13,4,4,3,11,0xb2d9651ad
180070.66,2.0,192,3,3,1,7,0xb2d1536cd
105211.73,1.0,4,3,2,4,9,0xb2d3c114d
50001.58,2.0,59,2,3,2,7,0xb2d8faf3d
4.86,1.0,55,1,2,2,5,0xb2d5487cd
4254.25,1.0,0,2,2,4,8,0xb2d95f29d
8674.47,1.0,3,2,2,4,8,0xb2d7ad0ed
607132.4,2.0,10,4,3,3,10,0xb2d57aa6
207114.58,2.0,11,3,3,3,9,0xb2d5f037d
12738.34,1.0,184,2,2,1,5,0xb2d28731d
183052.12,2.0,14,3,3,3,9,0xb2d38c48d
506383.57,2.0,104,4,3,1,8,0xb2d1b9ead
210439.89,3.0,67,3,4,1,8,0xb2d98fb4
15013.29,2.0,41,2,3,2,7,0xb2d98585
21025.28,2.0,0,2,3,4,9,0x3b9af2c0d
23.4,1.0,45,1,2,2,5,0xb2d0efd8
2903446.14,6.0,6,4,4,3,11,0xb2d16f47d
92.93,4.0,4,1,4,4,9,0x3b9af209
50033.38,2.0,26,2,3,2,7,0xb2d5c712d
150004.06,3.0,47,3,4,2,9,0xb2d6b582
200164.61,2.0,5,3,3,3,9,0xb2d644dbd
212012.92,5.0,136,3,4,1,8,0xb2d086bb
5525.7,2.0,48,2,3,2,7,0xb2d07067d
553.68,1.0,4,1,2,4,7,0xb2d474abd
10093.9,2.0,70,2,3,1,6,0xb2d5da46
3410.04,2.0,0,2,3,4,9,0xb2d68a8c
5000.0,1.0,0,2,2,4,8,0xb2d3ae86d
760001.16,2.0,7,4,3,3,10,0xb2d9b0ff
358242.66,2.0,0,4,3,4,11,0xb2d32a1dd
6381.95,1.0,1,2,2,4,8,0xb2d85bffd
1100104.5,10.0,14,4,4,3,11,0xb2d5e57b
3.06,1.0,40,1,2,2,5,0xb2d9a45a
1080162.51,22.0,0,4,4,4,12,0xb2d35327d
240000.18,3.0,9,3,4,3,10,0xb2d9a751
1713491.77,20.0,0,4,4,4,12,0xb2d299c4d
915631.44,12.0,0,4,4,4,12,0x3b9af0f2d
30177.36,3.0,73,2,4,1,7,0xb2d59055d
117817.4,1.0,3,3,2,4,9,0xb2d658a6d
64305.89,1.0,2,3,2,4,9,0xb2d29d2ad
934989.23,4.0,20,4,4,2,10,0xb2d0cfadd
60032.79,2.0,154,3,3,1,7,0xb2d470a8d
110005.81,2.0,56,3,3,2,8,0xb2d9c0e0
10.56,1.0,71,1,2,1,4,0xb2d99e87
200000.0,4.0,0,3,4,4,11,0xb2d24077d
2994472.91,2.0,14,4,3,3,10,0xb2d8da1ad
50163.58,3.0,1,2,4,4,10,0xb2d12741d
201554.01,2.0,56,3,3,2,8,0xb2d8ce0bd
119938.45,1.0,1,3,2,4,9,0xb2d566e8d
21424.91,2.0,0,2,3,4,9,0x3b9b3dead
0.45,2.0,69,1,3,1,5,0xb2d14234d
250080.54,1.0,12,3,2,3,8,0xb2d9b000
570006.34,7.0,11,4,4,3,11,0xb2d9976d
0.0,1.0,9,1,2,3,6,0xb2d99611
7914.44,1.0,11,2,2,3,7,0xb2d8da68
1319.17,1.0,10,1,2,3,6,0xb2d9a211
619841.76,8.0,15,4,4,3,11,0xb2d53c25d
300118.34,6.0,0,4,4,4,12,0xb2d9858e
50.93,1.0,15,1,2,3,6,0xb2d9a6fa
76163.4,1.0,117,3,2,1,6,0xb2d3fc9bd
9287.42,1.0,11,2,2,3,7,0xb2d28a39d
20508.77,2.0,55,2,3,2,7,0x3b9b3b46d
1323126.79,3.0,8,4,4,3,11,0xb2d40f9dd
1977141.0,10.0,2,4,4,4,12,0x3b9aeaecd
1412.33,1.0,184,1,2,1,4,0xb2d219a5d
61136.06,2.0,111,3,3,1,7,0xb2d5727cd
450098.9,3.0,5,4,4,3,11,0xb2d9ae26
181000.78,2.0,0,3,3,4,10,0xb2d9bddd
1180.56,1.0,3,1,2,4,7,0xb2d098db
5053.29,1.0,92,2,2,1,5,0xb2d0dc17d
59118.38,1.0,117,3,2,1,6,0xb2d31149d
65594.01,3.0,19,3,4,2,9,0xb2d63384d
100002.11,2.0,11,3,3,3,9,0xb2d5f8fd
44594.73,1.0,7,2,2,3,7,0xb2d5ee6ed
1464.78,1.0,179,1,2,1,4,0xb2d611e2
127394.02,4.0,42,3,4,2,9,0xb2d479bad
14490.83,1.0,11,2,2,3,7,0xb2d1e087d
21.47,1.0,44,1,2,2,5,0xb2d309e3
100009.97,2.0,47,3,3,2,8,0xb2d379f1d
185017.03,3.0,73,3,4,1,8,0xb2d5f592
47.46,2.0,47,1,3,2,6,0xb2d1bbae
0.68,1.0,92,1,2,1,4,0xb2d283a6d
10067.37,1.0,92,2,2,1,5,0xb2d63ed0
61389.76,4.0,4,3,4,4,11,0xb2d68154
8000155.31,2.0,55,4,3,2,9,0xb2d64f92d
404695.52,5.0,34,4,4,2,10,0xb2d417fcd
3024.72,1.0,0,2,2,4,8,0xb2d6951e
5031.74,1.0,15,2,2,3,7,0xb2d9b41a
69125.34,2.0,0,3,3,4,10,0xb2d63fc2d
128038.76,3.0,46,3,4,2,9,0xb2d22afd
431533.42,4.0,0,4,4,4,12,0xb2d5bbd1d
404358.93,9.0,45,4,4,2,10,0xb2d40dabd
165005.09,2.0,206,3,3,1,7,0xb2d5c32dd
70001.16,3.0,39,3,4,2,9,0xb2d9bc51
100003289.81,3.0,3,4,4,4,12,0xb2d5f57fd
1250668.58,2.0,24,4,3,2,9,0xb2d4d08ed
10178.25,2.0,206,2,3,1,6,0xb2d5b6d9d
1965.63,1.0,0,1,2,4,7,0xb2d426b1
210053.74,2.0,46,3,3,2,8,0xb2d21ef7
3183.13,1.0,248,2,2,1,5,0xb2d428b7d
82000.0,2.0,2,3,3,4,10,0xb2d9b438
1006.91,1.0,128,1,2,1,4,0xb2d58143d
14.85,1.0,53,1,2,2,5,0xb2d24303d
204744.94,1.0,184,3,2,1,6,0xb2d2345cd
370913.4,1.0,11,4,2,3,9,0xb2d9b7ec
355679.12,2.0,1,4,3,4,11,0xb2d6b3bdd
673.0,1.0,11,1,2,3,6,0xb2d9af6a
1291724.44,3.0,21,4,4,2,10,0xb2d29c0ad
20001.6,2.0,77,2,3,1,6,0xb2d56942d
2314.26,1.0,92,1,2,1,4,0xb2d159fed
8141.85,1.0,3,2,2,4,8,0xb2d98e61
400512.95,2.0,53,4,3,2,9,0xb2d9b951
50001.06,2.0,60,2,3,2,7,0xb2d9bd20
26522.79,1.0,0,2,2,4,8,0xb2d6dfe3
156500.99,4.0,179,3,4,1,8,0xb2d3df56d
101304.13,1.0,68,3,2,1,6,0xb2d22eb1d
186465.5,12.0,0,3,4,4,11,0x3b9b37bdd
1101599.69,9.0,4,4,4,4,12,0xb2d35ac6d
300009.19,4.0,11,3,4,3,10,0xb2d63f39
1014.58,1.0,92,1,2,1,4,0xb2d0ea7dd
13.19,1.0,24,1,2,2,5,0xb2d98c12
1750093.19,6.0,38,4,4,2,10,0xb2d6840b
40001.75,1.0,0,2,2,4,8,0xb2d557b5d
821315.53,1.0,154,4,2,1,7,0xb2d5909cd
31761.34,1.0,0,2,2,4,8,0xb2d8ea6ad
1209.95,1.0,63,1,2,2,5,0xb2d418cd
0.11,1.0,69,1,2,1,4,0xb2d6bc85
166734.27,1.0,4,3,2,4,9,0xb2d441f5
510665.45,2.0,198,4,3,1,8,0xb2d69e2e
2355422.22,2.0,11,4,3,3,10,0xb2d392a5d
831955.07,6.0,8,4,4,3,11,0xb2d4ae22d
10134.67,1.0,117,2,2,1,5,0xb2d6911cd
38449.04,1.0,10,2,2,3,7,0xb2d17802d
117108.46,5.0,13,3,4,3,10,0xb2d8e325d
745578.21,2.0,1,4,3,4,11,0xb2d22c88d
126008.07,2.0,173,3,3,1,7,0xb2d22a1b
8311.21,1.0,0,2,2,4,8,0xb2d2d5f1d
214031.66,5.0,28,3,4,2,9,0xb2d0a61dd
160225.82,5.0,6,3,4,3,10,0xb2d581f0d
50002.11,2.0,60,2,3,2,7,0xb2d9b70e
50076.09,2.0,0,2,3,4,9,0xb2d62dbdd
4939.33,1.0,184,2,2,1,5,0xb2d36d46d
200008.44,2.0,70,3,3,1,7,0xb2d9a4f6
154158.19,2.0,49,3,3,2,8,0xb2d392acd
1269.15,1.0,6,1,2,3,6,0xb2d5ae75d
100074.21,2.0,107,3,3,1,7,0xb2d3b5d0
2235.72,1.0,0,1,2,4,7,0xb2d3832ed
0.14,3.0,70,1,4,1,6,0xb2d08ed7d
229.05,1.0,77,1,2,1,4,0xb2d24b57d
303116.42,2.0,31,4,3,2,9,0xb2d6c195d
3320.0,1.0,0,2,2,4,8,0xb2d6b71ad
4459.65,1.0,0,2,2,4,8,0xb2d42c63d
2637007.37,9.0,6,4,4,3,11,0xb2d118d4d
3358.06,1.0,184,2,2,1,5,0xb2d4ce1dd
38.63,1.0,64,1,2,2,5,0xb2d9a121
434163.06,6.0,0,4,4,4,12,0xb2d06cedd
416000.01,29.0,0,4,4,4,12,0xb2d160ee
37003.3,2.0,14,2,3,3,8,0xb2d9a3be
258.25,1.0,0,1,2,4,7,0xb2d986db
151121.48,4.0,12,3,4,3,10,0xb2d5f62e
34702.28,1.0,0,2,2,4,8,0xb2d315c0d
12237.47,1.0,8,2,2,3,7,0xb2d6da60d
1503.3,1.0,9,1,2,3,6,0xb2d5e830
160375.59,4.0,0,3,4,4,11,0xb2d5ac60d
2378.26,1.0,8,1,2,3,6,0xb2d2d42cd
40122.46,3.0,31,2,4,2,8,0xb2d62f33
370790.0,4.0,24,4,4,2,10,0xb2d64422d
200039.44,3.0,10,3,4,3,10,0xb2d614c4d
317017.1,15.0,16,4,4,2,10,0xb2d0ebb9d
3451.31,1.0,26,2,2,2,6,0xb2d68c49d
6574.97,1.0,3,2,2,4,8,0xb2d9ad09
8545.71,1.0,0,2,2,4,8,0xb2d0c6c8
1002301.74,7.0,1,4,4,4,12,0xb2d0b44bd
4229.36,1.0,4,2,2,4,8,0xb2d48bd5d
0.71,1.0,57,1,2,2,5,0xb2d5b898
453023.26,2.0,189,4,3,1,8,0xb2d07e5ad
279691.97,4.0,80,3,4,1,8,0xb2d31e02d
507849.57,20.0,4,4,4,4,12,0x3b9b44f1d
1.11,1.0,15,1,2,3,6,0xb2d99ff2
14.36,1.0,75,1,2,1,4,0xb2d9931d
24565.55,1.0,0,2,2,4,8,0xb2d4170bd
500052.71,2.0,12,4,3,3,10,0xb2d9a0c7
500097.93,5.0,6,4,4,3,11,0xb2d65baad
100845.3,3.0,4,3,4,4,11,0xb2d1e665d
90881.13,2.0,158,3,3,1,7,0xb2d6a0e8d
13928.09,1.0,0,2,2,4,8,0xb2d48656
810094.74,5.0,52,4,4,2,10,0xb2d101a0
3936.09,1.0,6,2,2,3,7,0xb2d06f8cd
291753.93,2.0,1,3,3,4,10,0xb2d27353d
48895.56,2.0,0,2,3,4,9,0x3b9b45e2
726352.46,6.0,1,4,4,4,12,0xb2d0e1f5d
6615.7,1.0,20,2,2,2,6,0xb2d99d67
2092.48,1.0,10,1,2,3,6,0xb2d4a973d
400037.27,3.0,12,4,4,3,11,0xb2d8dd11
12249.09,1.0,132,2,2,1,5,0xb2d219f0d
317381.31,3.0,8,4,4,3,11,0xb2d1e5d9d
84.41,1.0,14,1,2,3,6,0xb2d6ec63
503552.49,2.0,62,4,3,2,9,0xb2d8fb82d
812775.16,3.0,10,4,4,3,11,0xb2d6c845d
1004.02,1.0,196,1,2,1,4,0xb2d62733d
3527.2,1.0,92,2,2,1,5,0xb2d3bb23d
151603.93,2.0,0,3,3,4,10,0xb2d29b8ed
56856.25,1.0,0,3,2,4,9,0xb2d1edc5d
19280.3,1.0,17,2,2,2,6,0xb2d2d510d
1002.9,1.0,92,1,2,1,4,0xb2d4265dd
1003568.62,2.0,136,4,3,1,8,0xb2d56e68d
38787.17,3.0,39,2,4,2,8,0xb2d5c4c6d
154532.19,2.0,143,3,3,1,7,0xb2d206a6d
2399.44,1.0,11,1,2,3,6,0xb2d990b9
1563.12,1.0,62,1,2,2,5,0xb2d2bd07
510014.57,4.0,94,4,4,1,9,0xb2d637ebd
207826.43,2.0,122,3,3,1,7,0xb2d656b7d
200052.15,2.0,26,3,3,2,8,0xb2d8cd6fd
80047.9,2.0,0,3,3,4,10,0xb2d9aead
251289.59,3.0,5,3,4,3,10,0xb2d12b45d
123098.86,3.0,7,3,4,3,10,0xb2d41879d
5.7,1.0,39,1,2,2,5,0xb2d22ac9
126338.19,4.0,11,3,4,3,10,0xb2d5e3b3d
554813.33,3.0,7,4,4,3,11,0xb2d070cad
7.87,15.0,3,1,4,4,9,0xb2d57348
20397.57,1.0,254,2,2,1,5,0xb2d5ef19d
266.33,1.0,9,1,2,3,6,0xb2d62ec2
6.86,1.0,47,1,2,2,5,0xb2d997a4
993193.79,14.0,0,4,4,4,12,0xb2d37f3e
1751.81,2.0,184,1,3,1,5,0xb2d264e7d
1862.27,1.0,197,1,2,1,4,0xb2d29d24
90.95,1.0,32,1,2,2,5,0xb2d9aafd
100098.01,3.0,147,3,4,1,8,0xb2d54e46d
1007105.8,2.0,78,4,3,1,8,0xb2d996f6
291.0,1.0,0,1,2,4,7,0xb2d6ba6cd
100004.22,2.0,70,3,3,1,7,0xb2d9a34a
450282.75,3.0,2,4,4,4,12,0xb2d178d9d
2225.08,1.0,9,1,2,3,6,0xb2d390e0d
450143.71,4.0,34,4,4,2,10,0xb2d064f2d
646.37,1.0,0,1,2,4,7,0xb2d5de5e
508886.99,2.0,173,4,3,1,8,0xb2d6bd08d
20000.84,2.0,60,2,3,2,7,0xb2d9b727
2800.36,1.0,11,1,2,3,6,0xb2d989eb
9930.68,1.0,19,2,2,2,6,0xb2d31412d
0.0,1.0,5,1,2,3,6,0xb2d6bd0bd
2415537.84,7.0,5,4,4,3,11,0xb2d57a8bd
88364.77,1.0,12,3,2,3,8,0xb2d3921fd
2569.98,1.0,184,1,2,1,4,0xb2d0ba68d
35876.17,1.0,67,2,2,1,5,0xb2d6136dd
1138.01,2.0,184,1,3,1,5,0x3b9b26a9d
320070.11,5.0,7,4,4,3,11,0xb2d42afad
12.76,1.0,37,1,2,2,5,0xb2d52e6e
10.19,1.0,54,1,2,2,5,0xb2d6d19f
532761.03,7.0,0,4,4,4,12,0xb2d5a72fd
62053.19,2.0,203,3,3,1,7,0xb2d68102d
38.35,1.0,41,1,2,2,5,0xb2d49523
2137.96,1.0,184,1,2,1,4,0xb2d26b2fd
151161.83,1.0,0,3,2,4,9,0xb2d6e325
240058.79,7.0,3,3,4,4,11,0xb2d3f356d
2636.87,1.0,0,1,2,4,7,0xb2d2f27cd
167029.76,2.0,245,3,3,1,7,0xb2d2274ed
1062.97,1.0,1,1,2,4,7,0xb2d8d819
60001.9,2.0,77,3,3,1,7,0xb2d992a9
508729.45,7.0,3,4,4,4,12,0xb2d12e43d
19914.85,1.0,104,2,2,1,5,0xb2d4103dd
68957.28,1.0,96,3,2,1,6,0xb2d4245f
973.66,1.0,15,1,2,3,6,0x3b9b2790
80019.97,2.0,92,3,3,1,7,0xb2d36089d
7985.35,1.0,184,2,2,1,5,0xb2d2653ad
1300049.31,4.0,6,4,4,3,11,0xb2d0d679d
81.76,1.0,42,1,2,2,5,0xb2d63a8ed
461.12,1.0,4,1,2,4,7,0xb2d34faf
203554.48,2.0,43,3,3,2,8,0xb2d6ce18d
192173.5,2.0,119,3,3,1,7,0xb2d1b8d2d
3.63,1.0,10,1,2,3,6,0xb2d6a2f9
180007.6,2.0,63,3,3,2,8,0xb2d9b352
300000.26,2.0,23,3,3,2,8,0xb2d98703
502152.51,4.0,14,4,4,3,11,0xb2d9a13a
411875.78,6.0,5,4,4,3,11,0xb2d24cf8d
4.77,1.0,34,1,2,2,5,0xb2d9967e
320003.38,2.0,87,4,3,1,8,0xb2d8cab4
200021.1,2.0,20,3,3,2,8,0xb2d985bc
46087.75,1.0,9,2,2,3,7,0xb2d99bd3
8005.47,1.0,82,2,2,1,5,0xb2d361c2d
665344.84,5.0,0,4,4,4,12,0xb2d17c3fd
380013.83,4.0,0,4,4,4,12,0xb2d40b83d
421.85,1.0,101,1,2,1,4,0xb2d6511bd
40012.78,1.0,9,2,2,3,7,0xb2d1e111d
2.64,1.0,60,1,2,2,5,0xb2d9ae2d
1020020.62,6.0,52,4,4,2,10,0xb2d1868ad
327402.93,2.0,80,4,3,1,8,0xb2d22aabd
0.0,1.0,8,1,2,3,6,0xb2d304e3
300131.28,2.0,5,4,3,3,10,0xb2d8f054d
99809.99,1.0,0,3,2,4,9,0xb2d86e64d
170010.8,2.0,53,3,3,2,8,0xb2d39f95
622610.28,6.0,94,4,4,1,9,0xb2d5ce1ad
36994.93,1.0,239,2,2,1,5,0xb2d1d73cd
392175.47,4.0,0,4,4,4,12,0xb2d1c4bed
1638.14,1.0,0,1,2,4,7,0xb2d454cd
303201.35,2.0,106,4,3,1,8,0xb2d19d07d
501852.14,2.0,29,4,3,2,9,0xb2d9bd3f
1090061.11,4.0,143,4,4,1,9,0xb2d3b303d
35098.07,1.0,6,2,2,3,7,0xb2d2d306d
1826771.94,2.0,1,4,3,4,11,0xb2d5fd98
601284.26,4.0,53,4,4,2,10,0xb2d19169d
200002.11,2.0,108,3,3,1,7,0xb2d78ec3d
28365.01,1.0,1,2,2,4,8,0xb2d2b947d
200004.22,2.0,74,3,3,1,7,0xb2d99cfc
127.61,1.0,17,1,2,2,5,0xb2d40aca
50029.58,2.0,180,2,3,1,6,0xb2d6b28cd
8.44,1.0,41,1,2,2,5,0xb2d9a5f9
3039.8,1.0,92,2,2,1,5,0xb2d24bf7d
201421.03,2.0,67,3,3,1,7,0xb2d99d23
172657.36,3.0,161,3,4,1,8,0xb2d1a62ed
487.19,1.0,53,1,2,2,5,0xb2d30e0dd
55660.8,2.0,67,3,3,1,7,0xb2d66570d
100003.17,2.0,59,3,3,2,8,0xb2d8f9c0
282608.17,6.0,12,3,4,3,10,0xb2d13bbcd
105721.72,2.0,1,3,3,4,10,0xb2d4f953
1000008.44,2.0,1,4,3,4,11,0xb2d9bc7c
3407.6,1.0,6,2,2,3,7,0xb2d98ff1
1943057.63,22.0,25,4,4,2,10,0xb2d34b96d
80009.86,2.0,82,3,3,1,7,0xb2d2d42bd
1087.88,1.0,28,1,2,2,5,0xb2d1583c
2800.39,1.0,92,1,2,1,4,0xb2d1e288d
70002.22,1.0,13,3,2,3,8,0xb2d9b913
80069.92,4.0,104,3,4,1,8,0xb2d06f50d
503553.05,2.0,22,4,3,2,9,0xb2d98e0e
5669.53,1.0,146,2,2,1,5,0xb2d42ec0d
7381.59,1.0,147,2,2,1,5,0xb2d2ea99
0.0,1.0,2,1,2,4,7,0xb2d60c27d
31463.01,1.0,0,2,2,4,8,0xb2d58989d
54.91,1.0,71,1,2,1,4,0xb2d20993
2916672.56,10.0,0,4,4,4,12,0xb2d3e049d
51747.67,2.0,67,2,3,1,6,0xb2d3eaedd
1959.44,1.0,92,1,2,1,4,0xb2d09ac5d
120011.78,3.0,118,3,4,1,8,0xb2d556fdd
300065.66,2.0,21,3,3,2,8,0xb2d64295
25017.94,1.0,78,2,2,1,5,0xb2d99672
62.1,1.0,8,1,2,3,6,0xb2d7072ed
160488.94,1.0,25,3,2,2,7,0xb2d53594d
3149.13,1.0,2,2,2,4,8,0xb2d31de1d
500000.21,2.0,5,4,3,3,10,0xb2d99a5f
3120.7,1.0,92,2,2,1,5,0xb2d39cecd
0.9,2.0,47,1,3,2,6,0xb2d9c135
120074.47,2.0,104,3,3,1,7,0xb2d5c1edd
570271.96,5.0,35,4,4,2,10,0xb2d1bc14d
1913.4,1.0,10,1,2,3,6,0xb2d988f2
210359.68,4.0,10,3,4,3,10,0xb2d60989d
703305.13,3.0,41,4,4,2,10,0xb2d8fd14d
1007.94,1.0,92,1,2,1,4,0xb2d1aa1ed
2190.7,1.0,2,1,2,4,7,0xb2d31ae5
135001.43,2.0,70,3,3,1,7,0xb2d98709
1424.25,1.0,219,1,2,1,4,0xb2d13104d
170113.17,2.0,249,3,3,1,7,0xb2d5fbc1d
36.01,1.0,4,1,2,4,7,0xb2d3c5d5
3984.59,1.0,1,2,2,4,8,0xb2d8e70ad
388783.71,15.0,0,4,4,4,12,0xb2d1ebeed
35051.79,1.0,8,2,2,3,7,0xb2d2b5d4d
203004.9,5.0,8,3,4,3,10,0xb2d87e63d
8726.2,1.0,6,2,2,3,7,0xb2d99df5
642518.44,4.0,4,4,4,4,12,0xb2d6e5cbd
100000.43,3.0,173,3,4,1,8,0xb2d23f5dd
786.29,1.0,14,1,2,3,6,0xb2d5969a
551439.29,9.0,0,4,4,4,12,0xb2d09759d
1012.31,1.0,184,1,2,1,4,0xb2d3a908d
50100.24,2.0,39,2,3,2,7,0xb2d3ccf2d
5786.78,1.0,171,2,2,1,5,0xb2d34d03
8499.3,1.0,22,2,2,2,6,0xb2d6084f
402903.96,3.0,19,4,4,2,10,0xb2d9b0be
229124.28,13.0,0,3,4,4,11,0xb2d0b4e3d
10070.63,1.0,265,2,2,1,5,0xb2d45b28d
2630.04,1.0,146,1,2,1,4,0xb2d60b88d
14331.73,1.0,0,2,2,4,8,0xb2d6ad2bd
717793.56,9.0,0,4,4,4,12,0x3b9adb31d
202345.56,2.0,97,3,3,1,7,0xb2d642a8d
500888.02,3.0,11,4,4,3,11,0xb2d992d0
1000078.56,2.0,164,4,3,1,8,0xb2d1d3c7d
76006.99,2.0,111,3,3,1,7,0xb2d1cbead
33005.25,2.0,168,2,3,1,6,0xb2d28794d
370099.08,3.0,6,4,4,3,11,0xb2d1b89d
33000.35,2.0,70,2,3,1,6,0xb2d9a67d
122940.62,2.0,146,3,3,1,7,0xb2d084c9d
250975.42,3.0,63,3,4,2,9,0xb2d171e1d
1300.81,1.0,3,1,2,4,7,0xb2d685a7
200088.48,2.0,0,3,3,4,10,0xb2d98b14
1134000.89,12.0,1,4,4,4,12,0xb2d3eafed
1.58,1.0,47,1,2,2,5,0xb2d9bdd2
214.13,1.0,4,1,2,4,7,0xb2d6b717
10006.06,1.0,20,2,2,2,6,0xb2d6dda5d
200720.86,2.0,28,3,3,2,8,0xb2d9be8f
300089.62,3.0,28,3,4,2,9,0xb2d68bb5
869018.56,5.0,61,4,4,2,10,0xb2d248bad
73766.58,2.0,168,3,3,1,7,0xb2d3ab86d
10.56,2.0,70,1,3,1,5,0xb2d99b07
6002.47,1.0,49,2,2,2,6,0xb2d99d6b
60028.7,2.0,76,3,3,1,7,0xb2d378bcd
250020.58,4.0,32,3,4,2,9,0xb2d9b1a8
110284.02,3.0,10,3,4,3,10,0xb2d1922cd
1.23,1.0,56,1,2,2,5,0xb2d4a75cd
51815.25,1.0,5,2,2,3,7,0xb2d6236c
388088.01,2.0,92,4,3,1,8,0xb2d1a29ad
310000.27,3.0,1,4,4,4,12,0xb2d65a17d
251172.24,6.0,4,3,4,4,11,0xb2d78e27d
200036.27,2.0,16,3,3,2,8,0xb2d98ec2
1073069.78,19.0,1,4,4,4,12,0xb2d42eb7d
530006.39,4.0,4,4,4,4,12,0xb2d6d4c9d
1752975.52,4.0,9,4,4,3,11,0xb2d6fb15
10000.21,2.0,74,2,3,1,6,0xb2d99eaf
20830.95,1.0,10,2,2,3,7,0xb2d9a5b1
204948.17,3.0,0,3,4,4,11,0xb2d4f4dc
5745.38,1.0,0,2,2,4,8,0xb2d3fe43d
50006.57,2.0,67,2,3,1,6,0xb2d8d9e7d
500000.8,3.0,97,4,4,1,9,0xb2d109ad
21.11,1.0,62,1,2,2,5,0xb2d9a6e9
1500079.16,2.0,8,4,3,3,10,0xb2d98928
479149.21,9.0,0,4,4,4,12,0xb2d0b355d
1004556.11,3.0,0,4,4,4,12,0x3b9b24cdd
5012.08,1.0,104,2,2,1,5,0xb2d348add
20000.21,2.0,83,2,3,1,6,0xb2d9866a
14151.98,1.0,0,2,2,4,8,0xb2d551a5d
10231.17,1.0,184,2,2,1,5,0xb2d203f1d
2400052.43,5.0,5,4,4,3,11,0xb2d6c74fd
1071924.94,8.0,3,4,4,4,12,0xb2d1bda3d
92023.69,1.0,3,3,2,4,9,0xb2d99eee
883967.89,7.0,24,4,4,2,10,0xb2d4ff85d
50000.71,2.0,4,2,3,4,9,0xb2d0a7d6
1.9,1.0,85,1,2,1,4,0xb2d1bd5b
2110123.08,3.0,90,4,4,1,9,0xb2d56324d
31053.49,2.0,0,2,3,4,9,0xb2d8f6c1d
128155.31,3.0,0,3,4,4,11,0xb2d426ced
12443.14,1.0,14,2,2,3,7,0xb2d552b9d
200421.08,2.0,15,3,3,3,9,0xb2d99d1d
8228.01,1.0,107,2,2,1,5,0xb2d14bc7d
52185.72,1.0,15,3,2,3,8,0xb2d32cc4d
6451.29,1.0,20,2,2,2,6,0xb2d60a8c
700455.63,9.0,1,4,4,4,12,0xb2d1336ed
288005.21,4.0,0,3,4,4,11,0xb2d0d058d
80006.79,3.0,59,3,4,2,9,0xb2d61044d
402088.24,4.0,29,4,4,2,10,0xb2d484e0d
10177.07,2.0,206,2,3,1,6,0xb2d5cbbed
411000.0,6.0,2,4,4,4,12,0xb2d510c9d
143109.86,2.0,203,3,3,1,7,0xb2d2e2edd
166.76,1.0,24,1,2,2,5,0xb2d6dbe0d
57.97,2.0,12,1,3,3,7,0xb2d227e1d
499.87,1.0,25,1,2,2,5,0xb2d8e9a3d
1110073.5,2.0,68,4,3,1,8,0xb2d5211ed
494.66,3.0,0,1,4,4,9,0xb2d09c7b
121005.07,3.0,66,3,4,2,9,0xb2d69501
517784.96,2.0,126,4,3,1,8,0xb2d686a3d
200084.29,2.0,15,3,3,3,9,0xb2d54df1d
3.96,1.0,14,1,2,3,6,0xb2d98a88
906019.96,11.0,14,4,4,3,11,0xb2d4adc9d
622402.89,9.0,29,4,4,2,10,0xb2d1dd99
1978.94,1.0,92,1,2,1,4,0xb2d06b96d
110005.07,3.0,46,3,4,2,9,0xb2d99ea7
184.64,1.0,10,1,2,3,6,0xb2d99346
321247.79,2.0,28,4,3,2,9,0xb2d6b0d2d
66.26,1.0,14,1,2,3,6,0xb2d71802
1009.86,1.0,29,1,2,2,5,0xb2d9b4a3
302131.52,2.0,64,4,3,2,9,0xb2d9b632
101.88,1.0,34,1,2,2,5,0xb2d558f9
1542.71,1.0,111,1,2,1,4,0xb2d58eccd
302131.54,2.0,66,4,3,2,9,0xb2d9b560
38166.0,1.0,1,2,2,4,8,0xb2d987d3
161734.16,4.0,3,3,4,4,11,0xb2d2a4cdd
500005.28,2.0,90,4,3,1,8,0xb2d8c3f0d
300065.33,2.0,175,3,3,1,7,0xb2d244a9
1043861.55,6.0,8,4,4,3,11,0xb2d2c898d
50.42,1.0,115,1,2,1,4,0xb2d2f6cad
10072.0,1.0,184,2,2,1,5,0xb2d3504ed
242963.31,3.0,139,3,4,1,8,0xb2d06acd
17581.33,1.0,1,2,2,4,8,0xb2d31919
1.15,1.0,10,1,2,3,6,0xb2d9881b
700000.28,4.0,4,4,4,4,12,0xb2d9ae4f
227210.01,3.0,147,3,4,1,8,0xb2d3abe6d
110824.19,3.0,27,3,4,2,9,0xb2d0fa0dd
82866.27,11.0,0,3,4,4,11,0xb2d09e4cd
114.01,1.0,7,1,2,3,6,0xb2d24185
1736.84,1.0,92,1,2,1,4,0xb2d0dec2d
100151.02,2.0,80,3,3,1,7,0xb2d6b66fd
1270048.73,3.0,52,4,4,2,10,0xb2d495a7d
1.58,1.0,74,1,2,1,4,0xb2d99a2d
0.0,1.0,2,1,2,4,7,0xb2d0e2f7
1092.8,1.0,110,1,2,1,4,0xb2d2b55dd
20021.11,1.0,54,2,2,2,6,0xb2d6c6a7
130042.28,2.0,62,3,3,2,8,0xb2d48552d
2062.94,1.0,0,1,2,4,7,0xb2d53037d
410.73,1.0,10,1,2,3,6,0xb2d67fe6d
687401.96,8.0,4,4,4,4,12,0xb2d29b9ed
665186.89,6.0,32,4,4,2,10,0xb2d094f2
4750.71,1.0,7,2,2,3,7,0xb2d434d9d
21.43,1.0,40,1,2,2,5,0xb2d988de
425188.46,3.0,28,4,4,2,10,0xb2d780c3d
5.22,1.0,76,1,2,1,4,0xb2d13871
5567.88,1.0,0,2,2,4,8,0xb2d99bef
37051.02,3.0,52,2,4,2,8,0xb2d623f3
7.09,1.0,106,1,2,1,4,0xb2d2b32fd
6110.39,1.0,1,2,2,4,8,0xb2d9b5e4
0.0,1.0,10,1,2,3,6,0xb2d1d955d
477009.4,10.0,5,4,4,3,11,0xb2d41ea3
769.18,2.0,0,1,3,4,8,0xb2d59efdd
2.53,1.0,60,1,2,2,5,0xb2d9b662
710014.99,2.0,60,4,3,2,9,0xb2d9b8f9
0.0,1.0,1,1,2,4,7,0xb2d5ebcb
1150.2,1.0,101,1,2,1,4,0xb2d1f9c2d
1862.86,1.0,224,1,2,1,4,0xb2d5536ed
24222.42,1.0,10,2,2,3,7,0xb2d6bd39d
107364.62,2.0,38,3,3,2,8,0xb2d2bbfed
32.38,1.0,10,1,2,3,6,0xb2d3c1c4
0.01,1.0,15,1,2,3,6,0xb2d5f156d
271748.61,4.0,19,3,4,2,9,0xb2d65576
100.0,1.0,5,1,2,3,6,0xb2d17c04d
34417.17,1.0,0,2,2,4,8,0xb2d99feb
2259.02,1.0,49,1,2,2,5,0xb2d9ab25
34798.96,1.0,7,2,2,3,7,0xb2d6b5eed
200014.19,2.0,15,3,3,3,9,0xb2d99901
10.82,1.0,6,1,2,3,6,0xb2d5b5cbd
610.78,1.0,0,1,2,4,7,0xb2d985f6
25137.0,6.0,132,2,4,1,7,0x3b9b294fd
2113.02,1.0,19,1,2,2,5,0xb2d60495
30010.64,2.0,60,2,3,2,7,0xb2d9bcad
33334.73,1.0,18,2,2,2,6,0xb2d98a76
112515.79,4.0,0,3,4,4,11,0xb2d36138d
8056.55,1.0,0,2,2,4,8,0xb2d3702e
256264.39,2.0,101,3,3,1,7,0xb2d41fc9d
12120.37,1.0,92,2,2,1,5,0xb2d283afd
33136.4,2.0,10,2,3,3,8,0xb2d9ad0b
224006.69,5.0,25,3,4,2,9,0xb2d695b2
949417.08,6.0,0,4,4,4,12,0xb2d33a5ed
1412.9,1.0,0,1,2,4,7,0xb2d2adaa
390.43,1.0,22,1,2,2,5,0xb2d9a3f0
40001.69,2.0,63,2,3,2,7,0xb2d9b26f
81097.13,3.0,133,3,4,1,8,0xb2d624ead
75000.0,3.0,184,3,4,1,8,0xb2d2a60c
8.97,1.0,77,1,2,1,4,0xb2d98ce9
111799.03,3.0,0,3,4,4,11,0xb2d2bc7fd
60001.27,2.0,92,3,3,1,7,0xb2d6568bd
476774.66,1.0,0,4,2,4,10,0xb2d991c3
6614.17,1.0,41,2,2,2,6,0xb2d1a1c2
51427.94,6.0,3,2,4,4,10,0xb2d22436d
300038.6,3.0,28,3,4,2,9,0xb2d60f7ad
100439.26,3.0,0,3,4,4,11,0xb2d31599d
175.53,1.0,53,1,2,2,5,0xb2d26aec
600050.52,2.0,83,4,3,1,8,0xb2d640f4
106.88,1.0,21,1,2,2,5,0xb2d2fc0dd
2140611.96,9.0,14,4,4,3,11,0xb2d6141fd
42.56,1.0,35,1,2,2,5,0xb2d2c70f
419075.77,3.0,83,4,4,1,9,0xb2d063c5d
2562.49,1.0,10,1,2,3,6,0xb2d6e34f
5506.1,2.0,0,2,3,4,9,0xb2d08c31d
100001.06,2.0,35,3,3,2,8,0xb2d995fe
50009.11,2.0,46,2,3,2,7,0xb2d9b398
7820.96,1.0,95,2,2,1,5,0xb2d5f41bd
281560.56,2.0,125,3,3,1,7,0xb2d40ff8d
60001.27,2.0,179,3,3,1,7,0xb2d6b478d
256.86,2.0,124,1,3,1,5,0xb2d2f7b3
3802.65,1.0,6,2,2,3,7,0xb2d3431fd
23180.17,1.0,1,2,2,4,8,0xb2d6bf3f
330021.67,6.0,5,4,4,3,11,0xb2d9b563
1200037.98,2.0,26,4,3,2,9,0xb2d6e24d
5129.7,1.0,184,2,2,1,5,0xb2d3b8c8d
22742.64,1.0,5,2,2,3,7,0xb2d9b78b
1496276.32,9.0,0,4,4,4,12,0xb2d1bc36d
53002.38,3.0,62,3,4,2,9,0xb2d9ac81
338004.25,5.0,176,4,4,1,9,0xb2d28373d
106.1,1.0,66,1,2,2,5,0xb2d1949a
51000.98,1.0,0,2,2,4,8,0xb2d2f9afd
1529.95,1.0,184,1,2,1,4,0xb2d09a91d
301071.27,3.0,30,4,4,2,10,0xb2d9bdf7
96.66,1.0,33,1,2,2,5,0xb2d9a38d
3671.05,1.0,7,2,2,3,7,0xb2d2cbf8d
1161367.67,4.0,45,4,4,2,10,0xb2d3edaed
1243190.35,7.0,1,4,4,4,12,0xb2d43da6d
271109.78,2.0,12,3,3,3,9,0xb2d9b749
49.61,1.0,25,1,2,2,5,0xb2d69fc5
7044.53,1.0,184,2,2,1,5,0xb2d1100fd
200091.83,1.0,41,3,2,2,7,0xb2d5e122
335211.23,3.0,91,4,4,1,9,0xb2d5b9f1
1551.18,1.0,61,1,2,2,5,0xb2d4a96c
470658.25,6.0,0,4,4,4,12,0xb2d3bd78d
1073485.17,7.0,3,4,4,4,12,0xb2d4f175d
400011.08,8.0,5,4,4,3,11,0xb2d61f28
400024.56,3.0,11,4,4,3,11,0xb2d5d074d
50555.87,2.0,209,2,3,1,6,0xb2d5db7b
500012.0,2.0,87,4,3,1,8,0xb2d8b2ffd
500000.35,2.0,16,4,3,2,9,0xb2d98797
5453.52,1.0,4,2,2,4,8,0xb2d6fdb8d
20040.28,2.0,144,2,3,1,6,0xb2d58cb9d
10118.82,2.0,87,2,3,1,6,0xb2d68210d
10.13,1.0,74,1,2,1,4,0xb2d98c20
10137.5,1.0,92,2,2,1,5,0xb2d5e7b7d
23569.41,2.0,51,2,3,2,7,0xb2d6b055d
43382.33,1.0,24,2,2,2,6,0xb2d5a063d
4.27,1.0,60,1,2,2,5,0xb2d8ef35d
240000.63,3.0,4,3,4,4,11,0xb2d9936a
1511575.56,2.0,32,4,3,2,9,0xb2d4d09f
573705.69,5.0,53,4,4,2,10,0xb2d22e57d
0.0,1.0,6,1,2,3,6,0xb2d17562d
3746.59,1.0,6,2,2,3,7,0xb2d9bdd9
1204531.04,10.0,0,4,4,4,12,0xb2d10e8cd
90001.69,2.0,74,3,3,1,7,0xb2d99d12
500000.0,2.0,16,4,3,2,9,0xb2d69864
565.63,1.0,9,1,2,3,6,0xb2d34935d
1015.44,1.0,184,1,2,1,4,0xb2d14e32d
10005.32,2.0,25,2,3,2,7,0xb2d99016
500010.25,5.0,80,4,4,1,9,0xb2d6c977d
10006.06,2.0,181,2,3,1,6,0xb2d606ced
10406.22,2.0,1,2,3,4,9,0xb2d59885d
52034.46,2.0,0,2,3,4,9,0xb2d548bad
500000.22,2.0,10,4,3,3,10,0xb2d9a582
0.0,2.0,60,1,3,2,6,0xb2d5043e
111763.78,2.0,136,3,3,1,7,0xb2d554dfd
100003.17,2.0,18,3,3,2,8,0xb2d9b896
50011.42,2.0,83,2,3,1,6,0xb2d0bea7d
33777.48,1.0,4,2,2,4,8,0xb2d9b6a4
375014.8,4.0,80,4,4,1,9,0xb2d5a05fd
529165.1,3.0,13,4,4,3,11,0xb2d9b90e
100458.37,2.0,70,3,3,1,7,0xb2d5f5ddd
350.59,1.0,9,1,2,3,6,0xb2d99d4b
500002.29,2.0,21,4,3,2,9,0xb2d985ae
209.78,1.0,104,1,2,1,4,0xb2d6b3c9d
5926.0,1.0,46,2,2,2,6,0xb2d99196
4.22,1.0,67,1,2,1,4,0xb2d9a7d7
108.98,1.0,26,1,2,2,5,0xb2d998bc
2932.21,1.0,11,2,2,3,7,0xb2d6b69fd
61519.06,1.0,31,3,2,2,7,0xb2d59298d
493490.83,1.0,0,4,2,4,10,0xb2d55e7d
309000.65,13.0,1,4,4,4,12,0xb2d19f50d
32.18,1.0,29,1,2,2,5,0xb2d8f736d
210007.47,3.0,52,3,4,2,9,0xb2d13902d
520045.4,3.0,20,4,4,2,10,0xb2d63699d
1511862.69,6.0,0,4,4,4,12,0xb2d080f6
44.04,1.0,33,1,2,2,5,0xb2d63828
2457490.28,3.0,53,4,4,2,10,0xb2d6d0d3d
198021.48,6.0,0,3,4,4,11,0xb2d0f2f7d
200156.96,2.0,8,3,3,3,9,0xb2d11cb8d
201421.13,2.0,76,3,3,1,7,0xb2d99aa5
201400.9,2.0,43,3,3,2,8,0xb2d60ee4
12339.89,1.0,10,2,2,3,7,0xb2d99ea1
320000.63,3.0,28,4,4,2,10,0xb2d9ab52
13.51,1.0,60,1,2,2,5,0xb2d9b734
35.87,1.0,78,1,2,1,4,0xb2d8d6aad
22934.17,2.0,27,2,3,2,7,0xb2d4242e
35.67,1.0,5,1,2,3,6,0xb2d9863e
0.0,1.0,1,1,2,4,7,0xb2d6cbd9
147700.0,4.0,1,3,4,4,11,0xb2d2aabe
65058.27,2.0,200,3,3,1,7,0xb2d10d42d
2994.03,1.0,15,2,2,3,7,0xb2d9a4ef
5577.02,1.0,18,2,2,2,6,0xb2d9b755
600000.56,2.0,4,4,3,4,11,0xb2d991a5
163.07,1.0,70,1,2,1,4,0xb2d86855
103825.22,2.0,193,3,3,1,7,0xb2d56a35d
1853.59,1.0,16,1,2,2,5,0xb2d45cab
2471.53,1.0,0,1,2,4,7,0xb2d0d2d5d
90001.69,3.0,199,3,4,1,8,0xb2d69872d
496055.13,3.0,12,4,4,3,11,0xb2d10d49d
101048.71,3.0,87,3,4,1,8,0xb2d2be9bd
40001.27,2.0,32,2,3,2,7,0xb2d9fc14
310027.46,3.0,38,4,4,2,10,0xb2d68bf2d
2422.02,1.0,0,1,2,4,7,0xb2d85ae4d
600012.67,4.0,32,4,4,2,10,0xb2d9fb66
786068.82,8.0,13,4,4,3,11,0xb2d3179dd
300000.0,2.0,3,3,3,4,10,0xb2da0349
7824.4,1.0,92,2,2,1,5,0xb2d1679dd
1588885.5,4.0,0,4,4,4,12,0x3b9af1bdd
869355.52,7.0,19,4,4,2,10,0xb2d58cadd
0.7,2.0,75,1,3,1,5,0xb2d695f3
61797.78,2.0,2,3,3,4,10,0xb2d5984dd
10000.0,2.0,56,2,3,2,7,0xb2d9ca97
76369.88,1.0,0,3,2,4,9,0xb2d2d91ed
1090115.06,2.0,31,4,3,2,9,0xb2d4ebcfd
300066.65,5.0,41,3,4,2,9,0xb2d267fcd
5000.0,1.0,9,2,2,3,7,0xb2d50267
200000.0,2.0,4,3,3,4,10,0xb2d9daf6
14.08,1.0,14,1,2,3,6,0xb2d1faf1
5909.94,1.0,18,2,2,2,6,0xb2d9e021
1388.55,1.0,1,1,2,4,7,0xb2d647e4
451774.0,2.0,293,4,3,1,8,0xb2d5cd36d
37791.27,1.0,11,2,2,3,7,0xb2d6b120d
1023.09,1.0,92,1,2,1,4,0xb2d1bffe
7481.45,1.0,20,2,2,2,6,0xb2d1d73ed
9.5,1.0,33,1,2,2,5,0xb2d9f5a2
8.97,1.0,24,1,2,2,5,0xb2d9d841
23181.53,1.0,0,2,2,4,8,0xb2d6cc35
13448.13,1.0,20,2,2,2,6,0xb2d55439d
20000.21,2.0,32,2,3,2,7,0xb2da04e4
30028.38,3.0,1,2,4,4,10,0xb2d9f431
1658.63,1.0,184,1,2,1,4,0xb2d2d9a7d
44.9,1.0,60,1,2,2,5,0xb2d86d96
4758.66,1.0,309,2,2,1,5,0xb2d26e5fd
280000.0,2.0,0,3,3,4,10,0xb2d9d0df
3179.82,1.0,260,2,2,1,5,0xb2d58727d
8266.82,3.0,0,2,4,4,10,0x3b9b27ab
2526.81,1.0,19,1,2,2,5,0xb2d5be2ad
45237.61,1.0,0,2,2,4,8,0xb2d33a02d
10000.43,2.0,2,2,3,4,9,0xb2d37359d
281053.29,2.0,0,3,3,4,10,0xb2d5f90a
3501144.76,9.0,5,4,4,3,11,0xb2d9f9e9
18185.47,1.0,0,2,2,4,8,0xb2d5cef4
20999.86,2.0,19,2,3,2,7,0xb2d1c25ad
3079.35,1.0,1,2,2,4,8,0xb2d43aac
130008.24,4.0,76,3,4,1,8,0xb2d412d9d
101776.82,2.0,164,3,3,1,7,0xb2d1061c
7.92,1.0,25,1,2,2,5,0xb2d9e41d
10077.04,1.0,184,2,2,1,5,0xb2d63ed0d
0.0,1.0,2,1,2,4,7,0xb2d9c2c9
6059.3,1.0,92,2,2,1,5,0xb2d29e88d
100004.22,2.0,49,3,3,2,8,0xb2d9d415
60003.01,3.0,21,3,4,2,9,0xb2d9d055
250012.12,3.0,13,3,4,3,10,0xb2d22770d
215006.03,7.0,21,3,4,2,9,0xb2d5a689d
1225.4,1.0,0,1,2,4,7,0xb2d9e2d0
250000.02,2.0,10,3,3,3,9,0xb2d9f39e
2893038.08,8.0,0,4,4,4,12,0xb2d211bc
282310.36,2.0,11,3,3,3,9,0xb2d1ba92d
914000.51,10.0,4,4,4,4,12,0xb2d5fa62d
280058.06,2.0,69,3,3,1,7,0xb2d625fdd
99.08,1.0,3,1,2,4,7,0xb2d69bafd
501007.4,3.0,53,4,4,2,10,0xb2d9c5db
10000.74,2.0,55,2,3,2,7,0xb2d8e94f
50000.0,1.0,2,2,2,4,8,0xb2d9da0c
21500.43,1.0,82,2,2,1,5,0xb2d5c94fd
105164.44,3.0,8,3,4,3,10,0xb2d2a29ad
8.55,1.0,21,1,2,2,5,0xb2d4785e
50012.4,2.0,108,2,3,1,6,0xb2d62a24d
6494.78,1.0,6,2,2,3,7,0xb2d6bc19d
50128.49,5.0,11,2,4,3,9,0xb2d108a5d
1081.98,1.0,0,1,2,4,7,0xb2d4cc46d
282.92,1.0,16,1,2,2,5,0xb2d2ee9e
620012.25,10.0,4,4,4,4,12,0xb2d580eed
50269.37,2.0,206,2,3,1,6,0xb2d42b79
44700.63,1.0,253,2,2,1,5,0xb2d42e5bd
7693.13,1.0,0,2,2,4,8,0xb2d9ca52
4538.71,1.0,0,2,2,4,8,0xb2d43425
512.73,2.0,7,1,3,3,7,0xb2d9d346
469729.71,12.0,11,4,4,3,11,0xb2d4cf17d
320120.02,4.0,18,4,4,2,10,0xb2d11f39d
400010.42,3.0,1,4,4,4,12,0xb2d9cc02
5807.67,1.0,250,2,2,1,5,0xb2d69c6fd
1009241.84,12.0,15,4,4,3,11,0xb2d068b7d
1683464.46,1.0,0,4,2,4,10,0xb2d3f189d
200836.58,3.0,21,3,4,2,9,0x3b9b2b7ad
245003.45,3.0,80,3,4,1,8,0xb2d10c7dd
10216.55,2.0,0,2,3,4,9,0xb2d5dc3cd
200000.44,2.0,21,3,3,2,8,0xb2d9cf4d
170025.85,2.0,174,3,3,1,7,0xb2d18f71
100487.68,2.0,0,3,3,4,10,0xb2d0bc3ad
130713.45,3.0,26,3,4,2,9,0xb2d59f8bd
50000.0,2.0,7,2,3,3,8,0xb2d57b78
4701.07,2.0,25,2,3,2,7,0xb2d2f7b4d
230016.98,2.0,19,3,3,2,8,0xb2d9d736
200004.04,2.0,28,3,3,2,8,0xb2da0949
60000.0,2.0,4,3,3,4,10,0xb2d9ef42
353347.0,6.0,15,4,4,3,11,0xb2d4cbd8d
2917.57,1.0,0,2,2,4,8,0xb2d6c0b9d
130005.49,3.0,14,3,4,3,10,0xb2d9f800
100034.79,2.0,95,3,3,1,7,0xb2d61e06
60.71,1.0,74,1,2,1,4,0xb2d3e847d
516005.79,2.0,290,4,3,1,8,0xb2d69e2ed
293032.08,4.0,1,3,4,4,11,0xb2d0f894
50162.69,2.0,6,2,3,3,8,0xb2da068e
200710.49,2.0,50,3,3,2,8,0xb2d9d757
1671.85,1.0,0,1,2,4,7,0xb2d675fc
110031.48,5.0,18,3,4,2,9,0xb2d61c71d
10147.08,2.0,13,2,3,3,8,0xb2d21aa9
67019.67,2.0,6,3,3,3,9,0xb2d3868ed
100006.61,2.0,143,3,3,1,7,0xb2d39546d
104091.88,2.0,10,3,3,3,9,0xb2d5c26ed
1713177.8,8.0,0,4,4,4,12,0xb2d1c26e
80009.92,3.0,15,3,4,3,10,0xb2d9f350
1381.45,1.0,31,1,2,2,5,0xb2d38f2b
201249.43,2.0,17,3,3,2,8,0xb2d5d0d8d
9507.79,1.0,3,2,2,4,8,0xb2d9e300
200002.11,2.0,49,3,3,2,8,0xb2d9d673
10000.32,2.0,172,2,3,1,6,0xb2d8d2e2d
901785.01,4.0,8,4,4,3,11,0xb2d9f5ba
36289.18,2.0,9,2,3,3,8,0xb2d6187ed
301.0,1.0,0,1,2,4,7,0xb2d5ccac
612104.18,3.0,18,4,4,2,10,0xb2d9cb12
113.8,1.0,24,1,2,2,5,0xb2d17a00d
200000.0,2.0,27,3,3,2,8,0xb2d9cf14
100006.5,2.0,38,3,3,2,8,0xb2d5b0a7d
139967.21,4.0,5,3,4,3,10,0xb2d57332
350006.86,2.0,27,4,3,2,9,0xb2d6482a
2600.87,1.0,11,1,2,3,6,0xb2d9e0e1
10089.87,1.0,184,2,2,1,5,0xb2d2fc63d
4512433.74,6.0,12,4,4,3,11,0xb2d9c35f
260092.92,7.0,4,3,4,4,11,0xb2d8e1b5d
1079938.22,4.0,6,4,4,3,11,0xb2d3317dd
361498.02,9.0,2,4,4,4,12,0xb2d5e52ad
2.8,1.0,57,1,2,2,5,0xb2d4227b
8741.04,1.0,4,2,2,4,8,0xb2da07f6
1543.68,1.0,92,1,2,1,4,0xb2d37bb3d
50048.26,2.0,74,2,3,1,6,0xb2d5fe17d
1364311.49,15.0,4,4,4,4,12,0xb2d1caf0
238765.99,4.0,6,3,4,3,10,0xb2d5254ed
39718.0,1.0,292,2,2,1,5,0xb2d69a19d
5695014.25,11.0,16,4,4,2,10,0xb2d0885bd
501776.32,2.0,55,4,3,2,9,0xb2d9cc50
290009.69,9.0,6,3,4,3,10,0xb2d14f9cd
200010.44,2.0,15,3,3,3,9,0xb2d9dd3f
60022.8,1.0,46,3,2,2,7,0xb2d9e672
523441.24,2.0,15,4,3,3,10,0xb2d347abd
116252.47,2.0,0,3,3,4,10,0xb2d9e60f
220.92,1.0,75,1,2,1,4,0xb2d6f8b2d
150007.44,2.0,10,3,3,3,9,0xb2d5ae21d
142977.67,1.0,0,3,2,4,9,0xb2d21356
4423.68,1.0,184,2,2,1,5,0xb2d262d0d
4509.17,1.0,159,2,2,1,5,0xb2d369fc
385637.24,6.0,83,4,4,1,9,0xb2d57704d
529013.62,4.0,140,4,4,1,9,0xb2d23ee2d
400008.44,2.0,32,4,3,2,9,0xb2d9ffef
200710.42,2.0,32,3,3,2,8,0xb2da0856
3389.93,1.0,12,2,2,3,7,0xb2d71756
112723.52,4.0,21,3,4,2,9,0xb2d101a0d
419248.44,3.0,24,4,4,2,10,0xb2d68295d
15638.52,1.0,0,2,2,4,8,0xb2d6ac88
6.55,1.0,5,1,2,3,6,0xb2d8a977
38374.89,1.0,14,2,2,3,7,0xb2d298a0d
203969.61,3.0,13,3,4,3,10,0xb2d65a6bd
3628.87,1.0,8,2,2,3,7,0xb2d5dc1a
411883.93,8.0,18,4,4,2,10,0xb2d1ffd7d
80988.51,3.0,0,3,4,4,11,0xb2d15350
50001.06,2.0,53,2,3,2,7,0xb2d9cdf7
325257.81,9.0,18,4,4,2,10,0xb2d43a42d
166462.14,3.0,77,3,4,1,8,0xb2d2d912d
348712.79,6.0,4,4,4,4,12,0xb2d0d1fad
360000.7,3.0,4,4,4,4,12,0xb2d1e32cd
741010.96,7.0,55,4,4,2,10,0xb2d3b60cd
905010.8,4.0,15,4,4,3,11,0xb2d773d6d
203556.56,9.0,0,3,4,4,11,0x3b9b45ab
14722.73,1.0,3,2,2,4,8,0xb2d6a1f3d
0.63,1.0,4,1,2,4,7,0xb2d9cac4
200014.02,12.0,0,3,4,4,11,0xb2d1aaabd
4.44,1.0,55,1,2,2,5,0xb2d25a1bd
114.68,2.0,223,1,3,1,5,0x3b9b2dc9d
220210.52,2.0,37,3,3,2,8,0xb2d9e6b1
2656.03,1.0,4,1,2,4,7,0xb2d8f355d
4630.2,3.0,92,2,4,1,7,0x3b9add0e
40894.68,3.0,5,2,4,3,9,0xb2d56999
428190.0,2.0,8,4,3,3,10,0xb2d304d9d
941424.4,7.0,0,4,4,4,12,0xb2d0b5a1d
400006.33,3.0,5,4,4,3,11,0xb2d9c91a
11355.98,4.0,0,2,4,4,10,0xb2d64ff5d
90080.06,2.0,75,3,3,1,7,0xb2d148ebd
67022.67,3.0,83,3,4,1,8,0xb2d6235ed
40063.27,2.0,174,2,3,1,6,0xb2d51de2d
166.06,1.0,15,1,2,3,6,0xb2d6e628d
1089.09,1.0,18,1,2,2,5,0xb2d2925ed
501507.61,3.0,1,4,4,4,12,0xb2d651ce
33044.49,2.0,46,2,3,2,7,0xb2d9c4bb
1000010.56,2.0,28,4,3,2,9,0xb2da07b7
502746.14,2.0,19,4,3,2,9,0xb2da001f
10671.48,2.0,20,2,3,2,7,0xb2d9eb5b
1042479.74,3.0,6,4,4,3,11,0xb2d11f8dd
505020.49,5.0,39,4,4,2,10,0xb2d22785d
177007.64,2.0,108,3,3,1,7,0xb2d08b76d
340326.79,4.0,1,4,4,4,12,0xb2d241bf
180750.17,1.0,0,3,2,4,9,0xb2d9e048
1387.06,1.0,92,1,2,1,4,0xb2d47bb6d
300265.69,2.0,22,4,3,2,9,0xb2d9cc3b
60000.38,3.0,0,3,4,4,11,0xb2d25db8
201431.72,2.0,41,3,3,2,8,0xb2d8346cd
2087.78,1.0,92,1,2,1,4,0xb2d0d28fd
993.18,3.0,0,1,4,4,9,0x3b9b3ff4
11.6,1.0,27,1,2,2,5,0xb2d378fb
208083.17,3.0,20,3,4,2,9,0xb2d4f017d
139066.93,2.0,0,3,3,4,10,0xb2d5ddf2d
3024.84,1.0,92,2,2,1,5,0xb2d2c68bd
67443.91,6.0,3,3,4,4,11,0xb2d68a3fd
50000.53,2.0,35,2,3,2,7,0xb2d9fa37
25.33,1.0,31,1,2,2,5,0xb2d9c71f
310333.79,3.0,0,4,4,4,12,0xb2da0235
300012.67,2.0,28,3,3,2,8,0xb2da05f5
17683.05,1.0,0,2,2,4,8,0xb2d4fb8cd
1074.56,1.0,92,1,2,1,4,0x3b9b177fd
6.81,1.0,15,1,2,3,6,0xb2d7c385
300065.65,2.0,25,3,3,2,8,0xb2d9ca59
313351.6,8.0,4,4,4,4,12,0xb2d57f21d
115286.87,6.0,1,3,4,4,11,0xb2d06978d
4320.09,1.0,0,2,2,4,8,0xb2d68cb1d
2761.66,1.0,3,1,2,4,7,0xb2da07e2
22988.48,1.0,18,2,2,2,6,0xb2d5d2dbd
9.12,1.0,65,1,2,2,5,0xb2d8c760d
607000.3,8.0,3,4,4,4,12,0xb2d17da7
300444.1,3.0,4,4,4,4,12,0xb2d78809d
205010.26,2.0,39,3,3,2,8,0xb2d9eba1
70434.25,1.0,3,3,2,4,9,0xb2d8cc4bd
250041.26,2.0,172,3,3,1,7,0xb2d59ba0
51001.94,4.0,39,2,4,2,8,0xb2d69744
280040.96,4.0,59,3,4,2,9,0xb2d29e16d
105045.94,2.0,210,3,3,1,7,0xb2d4148fd
1050000.14,2.0,80,4,3,1,8,0xb2d415a1d
15000.32,2.0,53,2,3,2,7,0xb2d9cc99
29045.98,1.0,2,2,2,4,8,0xb2d22a03d
10001.03,2.0,221,2,3,1,6,0xb2d643ce
251.82,1.0,12,1,2,3,6,0xb2d6ea63d
50001.06,2.0,46,2,3,2,7,0xb2d9dfad
3078.32,1.0,10,2,2,3,7,0xb2d3bbacd
10189.82,1.0,299,2,2,1,5,0xb2d5c1c2d
12621.46,1.0,10,2,2,3,7,0xb2d414e4
850440.79,4.0,0,4,4,4,12,0xb2d9f87f
142161.96,4.0,49,3,4,2,9,0xb2d412b0d
1131466.82,12.0,3,4,4,4,12,0xb2d30c2cd
300000.13,4.0,1,3,4,4,11,0xb2d5d221
510000.17,9.0,1,4,4,4,12,0xb2d6d7d9d
400958.01,3.0,41,4,4,2,10,0xb2d1cadcd
50002.21,2.0,97,2,3,1,6,0xb2d58aa0
1240.37,1.0,189,1,2,1,4,0xb2d6189bd
23606.19,3.0,0,2,4,4,10,0xb2d2127ad
120047.06,2.0,164,3,3,1,7,0xb2d43711d
2129.6,2.0,92,1,3,1,5,0xb2d095d1d
10119.62,1.0,138,2,2,1,5,0xb2d15bc0
1908721.07,7.0,2,4,4,4,12,0xb2d5ac1c
550085.06,4.0,1,4,4,4,12,0xb2d9ec0d
2007.17,1.0,92,1,2,1,4,0xb2d48aedd
130.88,1.0,21,1,2,2,5,0xb2d6e746d
34042.14,2.0,0,2,3,4,9,0xb2d6981cd
40001.57,12.0,11,2,4,3,9,0xb2d2a23ed
24603.67,1.0,305,2,2,1,5,0xb2d2e96ad
50059.65,1.0,122,2,2,1,5,0xb2d6b39fd
1869621.86,3.0,3,4,4,4,12,0xb2d17311d
21698.07,1.0,42,2,2,2,6,0xb2d540b6d
256.49,1.0,3,1,2,4,7,0xb2d8d5de
105.11,1.0,0,1,2,4,7,0xb2d54bf3d
829.83,1.0,0,1,2,4,7,0xb2d2a86ed
210746.02,2.0,50,3,3,2,8,0xb2d9d5d8
200105.45,3.0,102,3,4,1,8,0xb2d8d146d
100014.22,2.0,28,3,3,2,8,0xb2da0614
10.5,1.0,46,1,2,2,5,0xb2d6dc5d
288.74,1.0,11,1,2,3,6,0xb2d9da13
25346.75,1.0,6,2,2,3,7,0xb2d18d64d
300834.83,3.0,19,4,4,2,10,0xb2d9db8d
76628.76,1.0,9,3,2,3,8,0xb2d8d483d
230039.0,7.0,0,3,4,4,11,0xb2d8c38cd
411379.08,2.0,37,4,3,2,9,0xb2d65063
306303.44,5.0,6,4,4,3,11,0xb2d24c2fd
7972.6,1.0,0,2,2,4,8,0xb2d9ccc0
4.36,1.0,2,1,2,4,7,0xb2d9c64b
103869.25,2.0,139,3,3,1,7,0xb2d5a874d
745.35,2.0,1,1,3,4,8,0x3b9b295bd
1100000.0,16.0,4,4,4,4,12,0xb2d217eb
278155.73,3.0,41,3,4,2,9,0xb2d2572cd
500048.08,7.0,10,4,4,3,11,0xb2d1a54ed
4344.44,1.0,0,2,2,4,8,0xb2d9ec6d
6550.97,1.0,218,2,2,1,5,0xb2d2a2cfd
379.43,1.0,9,1,2,3,6,0xb2d4d941
2080.21,1.0,97,1,2,1,4,0xb2d0d118d
1631.57,1.0,91,1,2,1,4,0xb2d6a013
302131.48,2.0,60,4,3,2,9,0xb2d9c2c7
18586.94,1.0,18,2,2,2,6,0xb2d5e460
1295.49,1.0,9,1,2,3,6,0xb2d6b128d
100003.17,2.0,39,3,3,2,8,0xb2d9e673
233931.87,3.0,55,3,4,2,9,0xb2d31187d
3072000.87,5.0,10,4,4,3,11,0xb2d6e297d
50001.8,4.0,28,2,4,2,8,0xb2d9e3c7
1005024.31,6.0,0,4,4,4,12,0xb2d1b281
0.69,1.0,74,1,2,1,4,0xb2d5eec2d
420710.96,3.0,6,4,4,3,11,0xb2d67ffed
2896.57,1.0,0,2,2,4,8,0xb2da067a
1.12,1.0,67,1,2,1,4,0xb2d5bc3a
161812.22,2.0,39,3,3,2,8,0xb2d2164ad
51955.37,1.0,71,2,2,1,5,0xb2d61be0d
5000.84,1.0,11,2,2,3,7,0xb2d9dd40
240087.37,3.0,3,3,4,4,11,0xb2d1501ad
415827.87,2.0,124,4,3,1,8,0xb2d766fcd
0.0,1.0,8,1,2,3,6,0xb2d9fb01
500784.05,2.0,11,4,3,3,10,0xb2d9f03c
7521.95,1.0,0,2,2,4,8,0xb2d33443d
4.96,1.0,0,1,2,4,7,0xb2d62eb0
50608.79,2.0,139,2,3,1,6,0xb2d6d8a8d
260003.37,4.0,1,3,4,4,11,0xb2d9dbf3
4834.72,3.0,0,2,4,4,10,0xb2d7775ad
500006.04,2.0,27,4,3,2,9,0xb2d9c66c
8827.21,1.0,1,2,2,4,8,0xb2d9c360
205763.95,2.0,246,3,3,1,7,0xb2d14916d
1480.5,1.0,0,1,2,4,7,0xb2d18052
417099.37,11.0,4,4,4,4,12,0x3b9af12ad
10363.05,1.0,5,2,2,3,7,0xb2d59b9fd
129.6,1.0,21,1,2,2,5,0xb2d3084ad
714.93,1.0,1,1,2,4,7,0xb2d29f72d
200000.01,2.0,15,3,3,3,9,0xb2d9e3ca
58716.99,1.0,31,3,2,2,7,0xb2d66950
682132.77,4.0,0,4,4,4,12,0xb2d06b24d
954869.65,9.0,29,4,4,2,10,0xb2d26ea0d
60124.66,2.0,77,3,3,1,7,0xb2d59c28d
17438.7,1.0,146,2,2,1,5,0xb2d53395
91.62,1.0,21,1,2,2,5,0xb2d9f966
60007.28,4.0,21,3,4,2,9,0xb2d36078d
1284.42,1.0,20,1,2,2,5,0xb2d06cf9d
4218.98,1.0,9,2,2,3,7,0xb2d5e6d2d
50002.11,2.0,42,2,3,2,7,0xb2d9e44b
501776.61,2.0,48,4,3,2,9,0xb2d9dafd
1668800.05,4.0,0,4,4,4,12,0xb2d22984d
390078.11,6.0,12,4,4,3,11,0xb2d633a4d
9307.24,1.0,14,2,2,3,7,0xb2d9e13c
500157.63,2.0,0,4,3,4,11,0xb2d6062bd
1991.82,1.0,184,1,2,1,4,0xb2d1f7d6d
150396.31,2.0,27,3,3,2,8,0xb2d331ced
250101.66,3.0,4,3,4,4,11,0xb2d9e44e
1626.72,1.0,0,1,2,4,7,0xb2d0c895d
240008.27,3.0,1,3,4,4,11,0xb2d22511d
352.14,1.0,10,1,2,3,6,0xb2d9daca
300000.0,3.0,1,3,4,4,11,0xb2d9e50b
0.22,1.0,68,1,2,1,4,0xb2d52daed
700783.87,4.0,0,4,4,4,12,0xb2d5aa7f
20000.0,1.0,7,2,2,3,7,0xb2d0edf3
7.73,1.0,8,1,2,3,6,0xb2d9ce13
1131.78,1.0,1,1,2,4,7,0xb2d9c47a
2116.22,1.0,20,1,2,2,5,0xb2d2490f
1130057.14,13.0,4,4,4,4,12,0xb2d5b31cd
2404.79,1.0,3,1,2,4,7,0xb2d1b734
1030047.68,3.0,1,4,4,4,12,0xb2d1dc52d
6700818.05,2.0,0,4,3,4,11,0x3b9b2fb7d
3.91,1.0,35,1,2,2,5,0xb2d33032
65179.58,2.0,63,3,3,2,8,0xb2d39e9d
3195.01,1.0,83,2,2,1,5,0xb2d3c7ead
500000.32,3.0,4,4,4,4,12,0xb2d9ff8a
1472286.55,5.0,4,4,4,4,12,0xb2d57cb9d
174.54,1.0,30,1,2,2,5,0xb2d9d3aa
300000.63,2.0,3,3,3,4,10,0xb2da0554
8002.57,1.0,1,2,2,4,8,0xb2d699e9
1112.52,1.0,1,1,2,4,7,0xb2d2b454d
1002139.69,3.0,32,4,4,2,10,0xb2da002c
1233677.64,7.0,14,4,4,3,11,0xb2d8dfb6d
365292.99,2.0,42,4,3,2,9,0xb2d9e83b
147000.86,3.0,3,3,4,4,11,0xb2d8d392d
832736.25,3.0,1,4,4,4,12,0xb2d41430d
4105.13,1.0,95,2,2,1,5,0xb2d51d00d
422045.66,15.0,0,4,4,4,12,0x3b9b30bdd
200005.98,3.0,31,3,4,2,9,0xb2d60101d
18749.15,2.0,110,2,3,1,6,0x3b9b34bf
414.07,1.0,9,1,2,3,6,0xb2d6ab3b
254000.39,2.0,36,3,3,2,8,0xb2d700da
312305.51,4.0,0,4,4,4,12,0xb2d0b689d
3794.51,2.0,184,2,3,1,6,0x3b9b1029d
6088.12,1.0,184,2,2,1,5,0xb2d24711d
17160.48,1.0,6,2,2,3,7,0xb2d3581cd
2700.28,1.0,184,1,2,1,4,0xb2d52cdad
450101.46,3.0,19,4,4,2,10,0xb2d6d032d
60087.72,2.0,18,3,3,2,8,0xb2d624e9d
2336.31,1.0,184,1,2,1,4,0xb2d42beed
634.56,1.0,10,1,2,3,6,0xb2d9cc3c
184178.32,3.0,1,3,4,4,11,0xb2d17e7ed
8.26,1.0,32,1,2,2,5,0xb2d4ffa6d
25360.12,6.0,3,2,4,4,10,0x3b9b13b9
192.19,1.0,10,1,2,3,6,0xb2d5b2ef
40000.97,2.0,206,2,3,1,6,0xb2d68a82d
300000.08,2.0,24,3,3,2,8,0xb2d9d09b
9.87,1.0,17,1,2,2,5,0xb2d9c82b
914614.73,3.0,18,4,4,2,10,0xb2d6d746
57.87,1.0,2,1,2,4,7,0xb2d69721
10440.14,3.0,14,2,4,3,9,0xb2d597e0
45.1,1.0,9,1,2,3,6,0xb2d9d1d0
14530.55,1.0,9,2,2,3,7,0xb2d52268d
60685.6,1.0,0,3,2,4,9,0xb2d35149d
14000.28,2.0,174,2,3,1,6,0xb2d63d2e
5.09,1.0,24,1,2,2,5,0xb2d37bf8
380000.0,2.0,9,4,3,3,10,0xb2d9f555
1721.39,1.0,186,1,2,1,4,0xb2d0eca6d
1812.31,1.0,184,1,2,1,4,0xb2d28d36d
611516.07,4.0,39,4,4,2,10,0xb2d5c0dcd
20924.37,1.0,34,2,2,2,6,0xb2d5cea9d
477000.01,29.0,0,4,4,4,12,0xb2d160eed
499957.53,4.0,101,4,4,1,9,0xb2d1a110d
29.99,1.0,10,1,2,3,6,0xb2d2648fd
50011.08,2.0,83,2,3,1,6,0xb2d7fc55
2100.64,1.0,184,1,2,1,4,0xb2d347bbd
8.11,2.0,20,1,3,2,6,0x3b9b2ab7
171006.13,4.0,11,3,4,3,10,0xb2d69501d
1822.09,1.0,92,1,2,1,4,0xb2d21ef0d
500000.06,2.0,12,4,3,3,10,0xb2d9e6df
19521.33,1.0,20,2,2,2,6,0xb2d43364
63298.63,1.0,0,3,2,4,9,0xb2d62f33d
409440.92,4.0,27,4,4,2,10,0xb2d50fa5d
1003559.72,2.0,42,4,3,2,9,0xb2d1d6e8d
150007.33,2.0,31,3,3,2,8,0xb2d2b409d
52.11,1.0,52,1,2,2,5,0xb2d5d076
1301030.07,11.0,0,4,4,4,12,0xb2d9c7bf
4.46,1.0,40,1,2,2,5,0xb2d6212e
142.6,1.0,18,1,2,2,5,0xb2d24e66d
2727.01,1.0,0,1,2,4,7,0xb2d4972ed
2797.08,1.0,13,1,2,3,6,0xb2d48c35
350043.25,2.0,22,4,3,2,9,0xb2d9d452
6.3,1.0,11,1,2,3,6,0xb2d5b898d
500000.04,2.0,8,4,3,3,10,0xb2d9f5c1
1520.27,1.0,184,1,2,1,4,0xb2d222aed
21.11,1.0,40,1,2,2,5,0xb2d9d6cb
223398.83,3.0,120,3,4,1,8,0xb2d5065ed
5197.89,1.0,0,2,2,4,8,0xb2d53e0fd
181226.08,8.0,3,3,4,4,11,0x3b9b1859d
29.42,1.0,10,1,2,3,6,0xb2d9d01a
2546.54,1.0,138,1,2,1,4,0xb2d1fa0dd
21279.13,1.0,108,2,2,1,5,0xb2d3ff2c
84713.43,2.0,2,3,3,4,10,0xb2d212d8d
2000.0,1.0,3,1,2,4,7,0xb2d6c64dd
3085.98,1.0,4,2,2,4,8,0xb2d6cf2ed
85002.95,3.0,3,3,4,4,11,0xb2d4a17ad
2641.05,1.0,0,1,2,4,7,0xb2d26fb1
221.07,1.0,8,1,2,3,6,0xb2d6090ed
131019.79,2.0,90,3,3,1,7,0xb2d261e9d
208009.58,2.0,99,3,3,1,7,0xb2d2765ed
22.99,1.0,0,1,2,4,7,0xb2d4f5dbd
2001.09,1.0,10,1,2,3,6,0xb2d6acd3d
210145.82,3.0,19,3,4,2,9,0xb2d45a2bd
5471.85,1.0,15,2,2,3,7,0xb2d9c3e4
380914.79,5.0,10,4,4,3,11,0xb2d79058d
100022.67,3.0,58,3,4,2,9,0xb2d78250d
4620.61,1.0,0,2,2,4,8,0xb2d59a0b
0.0,1.0,0,1,2,4,7,0xb2d21276
52942.5,3.0,1,3,4,4,11,0xb2d5e755d
5137077.41,9.0,0,4,4,4,12,0xb2d2799ed
5671.99,3.0,18,2,4,2,8,0x3b9af1d2
180123.63,3.0,1,3,4,4,11,0xb2d9ef74
167800.24,2.0,0,3,3,4,10,0xb2d12cddd
213568.48,4.0,74,3,4,1,8,0xb2d56a02d
3032595.86,1.0,0,4,2,4,10,0xb2d2a476
353228.28,3.0,4,4,4,4,12,0xb2d6aac1d
402005.44,4.0,4,4,4,4,12,0xb2d67b35d
3431.72,1.0,163,2,2,1,5,0xb2d6f2ebd
9585.89,1.0,28,2,2,2,6,0xb2d0d992
2611.08,1.0,0,1,2,4,7,0xb2d16ecfd
12578.89,1.0,0,2,2,4,8,0xb2d8e9eed
594099.87,14.0,4,4,4,4,12,0xb2d558bdd
645012.19,4.0,12,4,4,3,11,0xb2d4850cd
330001.83,4.0,14,4,4,3,11,0xb2d69d34d
51094.77,1.0,5,2,2,3,7,0xb2d6a884d
18098.36,2.0,1,2,3,4,9,0x3b9af27fd
150006.33,2.0,14,3,3,3,9,0xb2d9e428
100012.91,2.0,25,3,3,2,8,0xb2d567a7
1320003.43,4.0,24,4,4,2,10,0xb2d28aeb
716797.21,6.0,49,4,4,2,10,0xb2d23af0d
33849.93,1.0,21,2,2,2,6,0xb2d43bc5d
493943.3,6.0,28,4,4,2,10,0xb2d61f04d
200008.44,2.0,42,3,3,2,8,0xb2d9e503
286974.06,5.0,1,3,4,4,11,0xb2d220d3d
60381.07,4.0,60,3,4,2,9,0xb2d6890d
7146.19,1.0,6,2,2,3,7,0xb2d6f5d5d
2010.38,2.0,8,1,3,3,7,0xb2d5f3fdd
703517.96,3.0,3,4,4,4,12,0xb2d2326dd
53.28,1.0,25,1,2,2,5,0xb2d537c2d
80.59,1.0,10,1,2,3,6,0xb2da0279
2073.46,1.0,5,1,2,3,6,0xb2d69a2f
10002.27,2.0,34,2,3,2,7,0xb2d530c9d
60191.33,1.0,4,3,2,4,9,0xb2d60797d
953019.42,2.0,0,4,3,4,11,0xb2d9e56c
658384.84,6.0,3,4,4,4,12,0xb2d6122c
401458.87,3.0,32,4,4,2,10,0xb2d9e7fd
400016.25,3.0,92,4,4,1,9,0xb2d2b58b
47796.52,1.0,10,2,2,3,7,0xb2d3034d
240000.0,1.0,0,3,2,4,9,0xb2d33f90d
100341.07,3.0,14,3,4,3,10,0xb2d9f232
30688.92,2.0,28,2,3,2,7,0xb2d0bb9dd
589184.96,2.0,28,4,3,2,9,0xb2d41180d
2350012.63,7.0,7,4,4,3,11,0xb2d3c4f5
30788.17,3.0,184,2,4,1,7,0xb2d0907ed
2.2,1.0,55,1,2,2,5,0xb2d6ec48d
0.0,1.0,4,1,2,4,7,0xb2d61fd0
53710.67,1.0,2,3,2,4,9,0xb2d2ed39
17.11,1.0,10,1,2,3,6,0xb2d9f778
10000.11,2.0,80,2,3,1,6,0xb2d8d820d
200710.43,2.0,41,3,3,2,8,0xb2d9ef3b
211.47,1.0,13,1,2,3,6,0xb2d9d327
13633.2,1.0,0,2,2,4,8,0xb2d56c0ed
1174385.33,3.0,19,4,4,2,10,0xb2d21dafd
4.54,1.0,40,1,2,2,5,0xb2d2adaad
52.9,1.0,80,1,2,1,4,0xb2d2b06a
396.71,1.0,2,1,2,4,7,0xb2d77dbf
2312.68,1.0,43,1,2,2,5,0xb2d9e296
50000.1,7.0,5,2,4,3,9,0xb2d10b6bd
80011.82,2.0,53,3,3,2,8,0xb2d9c781
4581.13,1.0,21,2,2,2,6,0xb2d9c6e5
5556.87,1.0,46,2,2,2,6,0xb2d2822ed
135052.23,2.0,80,3,3,1,7,0xb2d5bcbed
290.0,1.0,18,1,2,2,5,0xb2d4855a
21000.99,2.0,49,2,3,2,7,0xb2d55ea5d
1000010.57,8.0,139,4,4,1,9,0xb2d17702d
572024.86,2.0,48,4,3,2,9,0xb2d9dd9b
50027.59,2.0,256,2,3,1,6,0xb2d48b7fd
974210.05,3.0,0,4,4,4,12,0xb2d632a7d
30069.32,6.0,35,2,4,2,8,0xb2d9e425
2500079.17,2.0,53,4,3,2,9,0xb2d9c5e0
50002.16,2.0,21,2,3,2,7,0xb2d9f022
0.0,3.0,3,1,4,4,9,0xb2d06928
1243467.53,5.0,18,4,4,2,10,0xb2d07925d
50007.46,2.0,53,2,3,2,7,0xb2d68882
5964.17,4.0,0,2,4,4,10,0x3b9ae812d
80002.64,2.0,4,3,3,4,10,0xb2da0891
1168.09,1.0,4,1,2,4,7,0xb2d560e7
50076.55,1.0,154,2,2,1,5,0xb2d6de25d
828039.49,3.0,27,4,4,2,10,0xb2d6f770d
80003.65,4.0,45,3,4,2,9,0xb2d63d10
500000.0,1.0,6,4,2,3,9,0xb2d9c3e2
411623.54,2.0,9,4,3,3,10,0xb2da069c
200008.44,2.0,42,3,3,2,8,0xb2d9e47f
220781.48,2.0,43,3,3,2,8,0xb2d9e929
4.51,1.0,15,1,2,3,6,0xb2d49175d
50001.58,2.0,53,2,3,2,7,0xb2d9cb14
880.97,1.0,1,1,2,4,7,0xb2d6b1df
1.85,1.0,92,1,2,1,4,0xb2d39518d
590879.42,17.0,11,4,4,3,11,0xb2d451f4d
50065.24,2.0,231,2,3,1,6,0xb2d23498d
430907.06,7.0,10,4,4,3,11,0xb2d5f8dad
353.77,1.0,7,1,2,3,6,0xb2d9e098
863055.14,5.0,14,4,4,3,11,0xb2d225c0d
2.74,1.0,32,1,2,2,5,0xb2d249bdd
435548.19,3.0,43,4,4,2,10,0xb2d5f897
6030.87,1.0,0,2,2,4,8,0xb2d769ead
70004.54,7.0,1,3,4,4,11,0xb2d9c9ca
2719646.54,5.0,14,4,4,3,11,0xb2d319d5d
500160.52,3.0,38,4,4,2,10,0xb2d54cb0d
100001.06,2.0,39,3,3,2,8,0xb2d9f208
200718.31,2.0,37,3,3,2,8,0xb2d648cc
28.05,1.0,41,1,2,2,5,0xb2d17c53d
530000.0,2.0,6,4,3,3,10,0xb2da04bf
7938.74,1.0,92,2,2,1,5,0xb2d1ae19d
9.22,1.0,10,1,2,3,6,0xb2d9e182
3639.37,1.0,184,2,2,1,5,0xb2d2ed24d
20064.08,2.0,80,2,3,1,6,0xb2d5eb51
20001.1,2.0,28,2,3,2,7,0xb2d9eb45
13639.33,1.0,0,2,2,4,8,0xb2d2687ad
23.49,1.0,33,1,2,2,5,0xb2d8f9c0d
450009.5,2.0,32,4,3,2,9,0xb2da0261
200008.44,2.0,97,3,3,1,7,0xb2d83a1cd
10.62,1.0,12,1,2,3,6,0xb2d3b6d5
100001.06,2.0,42,3,3,2,8,0xb2d9e7dc
1501.64,1.0,50,1,2,2,5,0xb2d801e0
4818.59,1.0,19,2,2,2,6,0xb2d9da0b
100005.28,2.0,41,3,3,2,8,0xb2d9e4a3
203515.74,1.0,10,3,2,3,8,0xb2d703ced
48.55,1.0,10,1,2,3,6,0xb2d68f72
1236.04,1.0,9,1,2,3,6,0xb2d8c653
501776.04,2.0,40,4,3,2,9,0xb2d9f460
799164.36,9.0,1,4,4,4,12,0x3b9b443bd
1056738.11,3.0,21,4,4,2,10,0xb2d46e83d
103003.37,2.0,38,3,3,2,8,0xb2d56209d
351243.45,2.0,57,4,3,2,9,0xb2d9c628
7399.24,1.0,23,2,2,2,6,0xb2d56678
40.26,1.0,231,1,2,1,4,0xb2d61562d
26.78,1.0,75,1,2,1,4,0xb2d1abc1
111531.0,2.0,20,3,3,2,8,0xb2d36c3ad
100443.47,6.0,0,3,4,4,11,0xb2d31d6cd
244.7,1.0,93,1,2,1,4,0xb2d16fb6d
500005.28,2.0,39,4,3,2,9,0xb2d9f1cf
1872.86,1.0,112,1,2,1,4,0xb2d6bb97d
85712.6,3.0,0,3,4,4,11,0xb2d588fbd
79.82,1.0,16,1,2,2,5,0xb2d4b99e
345.19,1.0,9,1,2,3,6,0xb2d4132dd
2.01,1.0,50,1,2,2,5,0xb2d1f4b7
130125.68,2.0,1,3,3,4,10,0xb2d26bd4d
1073.22,10.0,184,1,4,1,6,0xb2d1e471d
0.14,1.0,1,1,2,4,7,0xb2d68621
250005.9,3.0,169,3,4,1,8,0xb2d0a93bd
100002.12,3.0,6,3,4,3,10,0xb2d9ca54
60564.48,2.0,0,3,3,4,10,0xb2d755add
2509.54,1.0,69,1,2,1,4,0xb2d43b73
300006.87,3.0,27,3,4,2,9,0xb2d68090d
2553.21,1.0,0,1,2,4,7,0xb2d2c65ad
277418.55,23.0,48,3,4,2,9,0xb2d0ff41d
500015.83,2.0,46,4,3,2,9,0xb2d9dafe
100868.95,2.0,0,3,3,4,10,0xb2d12b42d
5933.4,1.0,12,2,2,3,7,0xb2d6c43d
1000000.0,2.0,20,4,3,2,9,0xb2d9d6f6
198220.43,2.0,87,3,3,1,7,0xb2d3be30d
27.14,1.0,38,1,2,2,5,0xb2d6383dd
850002.0,9.0,3,4,4,4,12,0xb2d9e1ee
8.99,1.0,32,1,2,2,5,0xb2d1fbecd
5002.88,2.0,12,2,3,3,8,0xb2da00a8
64002.84,4.0,20,3,4,2,9,0xb2d646fed
254346.51,3.0,0,3,4,4,11,0xb2d25769d
180027.68,3.0,171,3,4,1,8,0xb2d4eca3d
92.5,1.0,6,1,2,3,6,0xb2d5a910d
50002.64,2.0,41,2,3,2,7,0xb2d9e479
1261013.97,3.0,11,4,4,3,11,0xb2d37f15d
1.98,1.0,29,1,2,2,5,0xb2d0fbedd
341.25,1.0,9,1,2,3,6,0xb2d6d6cc
406.6,1.0,47,1,2,2,5,0xb2d9ca81
589740.67,10.0,1,4,4,4,12,0xb2d5191ed
200008.46,2.0,92,3,3,1,7,0xb2d65c29d
300040.9,3.0,3,3,4,4,11,0xb2d6e075d
163.24,1.0,8,1,2,3,6,0xb2d6f43b
5254.6,1.0,1,2,2,4,8,0xb2d74537d
1424.86,1.0,0,1,2,4,7,0xb2d6f3ddd
200010.42,2.0,12,3,3,3,9,0xb2d9ecda
6.0,1.0,33,1,2,2,5,0xb2d43b82
4727.36,2.0,10,2,3,3,8,0xb2d42c47d
1813.52,1.0,184,1,2,1,4,0xb2d3e8e6d
236.63,1.0,9,1,2,3,6,0xb2d9c33d
370076.79,3.0,27,4,4,2,10,0xb2d58ef5d
29607.05,1.0,30,2,2,2,6,0xb2d32840d
1713.71,1.0,230,1,2,1,4,0xb2d62b4fd
233450.22,4.0,0,3,4,4,11,0xb2d5edb3d
30.52,1.0,0,1,2,4,7,0xb2d6505dd
52686.67,2.0,87,3,3,1,7,0xb2d29450d
28.73,1.0,11,1,2,3,6,0xb2d6a643
182656.34,4.0,74,3,4,1,8,0xb2d651f9d
1155366.95,8.0,14,4,4,3,11,0xb2d22979d
345130.58,4.0,6,4,4,3,11,0xb2d3cbded
366815.99,4.0,0,4,4,4,12,0x3b9af2b1d
484672.24,3.0,25,4,4,2,10,0xb2d1e8ccd
10013.66,2.0,13,2,3,3,8,0xb2d9c36a
27000.67,1.0,4,2,2,4,8,0xb2da0231
20116.56,1.0,122,2,2,1,5,0xb2d2af9cd
74.2,1.0,59,1,2,2,5,0xb2d2f171
9000.0,1.0,2,2,2,4,8,0xb2d9f2f2
20400.99,1.0,1,2,2,4,8,0xb2da0864
301065.63,2.0,36,4,3,2,9,0xb2d9f556
3293.53,1.0,92,2,2,1,5,0x3b9b2f9cd
22246.83,1.0,1,2,2,4,8,0xb2d3ef3fd
762281.63,10.0,18,4,4,2,10,0xb2d50d34d
200710.49,2.0,50,3,3,2,8,0xb2d9d5f7
78104.02,2.0,11,3,3,3,9,0xb2d9f59e
268961.9,4.0,0,3,4,4,11,0xb2d43cffd
956000.0,12.0,2,4,4,4,12,0xb2d629ded
464.4,1.0,1,1,2,4,7,0xb2d0aa87
340000.4,4.0,4,4,4,4,12,0xb2d9d273
24553.77,1.0,17,2,2,2,6,0xb2d21103
8945.33,1.0,13,2,2,3,7,0xb2d9d0d8
5625.83,1.0,3,2,2,4,8,0xb2d82154
7577.31,1.0,184,2,2,1,5,0xb2d29069d
50007.92,1.0,0,2,2,4,8,0xb2da0366
1451.11,1.0,91,1,2,1,4,0xb2d2a067d
0.42,1.0,184,1,2,1,4,0xb2d34659d
420022.13,4.0,59,4,4,2,10,0xb2d6022fd
200000.0,2.0,7,3,3,3,9,0xb2d9eea2
5101.18,1.0,32,2,2,2,6,0xb2d9d402
1745062.63,5.0,18,4,4,2,10,0xb2d1c0afd
1135518.46,9.0,13,4,4,3,11,0xb2d622fbd
72.99,1.0,13,1,2,3,6,0xb2d4c9cd
20029.46,2.0,2,2,3,4,9,0xb2d68af8
21.07,1.0,19,1,2,2,5,0xb2d8d4d9
8.82,2.0,27,1,3,2,6,0xb2d1b243d
1000648.75,2.0,4,4,3,4,11,0xb2d5c1f0
10104.06,2.0,7,2,3,3,8,0xb2d6b54dd
200000.0,2.0,4,3,3,4,10,0xb2da59f8
4133150.92,5.0,0,4,4,4,12,0xb2d128b7d
500400.03,2.0,17,4,3,2,9,0xb2da35aa
200000.0,2.0,0,3,3,4,10,0xb2da6a39
110001.16,2.0,14,3,3,3,9,0xb2da3a93
0.0,1.0,8,1,2,3,6,0xb2d61bfed
150001.59,3.0,21,3,4,2,9,0xb2da15ac
41000.0,1.0,0,2,2,4,8,0xb2da5c1d
20000.0,2.0,1,2,3,4,9,0xb2da5cc2
600087.66,3.0,22,4,4,2,10,0xb2d68317d
184.09,1.0,7,1,2,3,6,0xb2d573e0
200004.3,2.0,14,3,3,3,9,0xb2da2b03
150306623.66,6.0,4,4,4,4,12,0xb2d40a9fd
15418.21,1.0,2,2,2,4,8,0xb2d0e012d
350104.93,2.0,7,4,3,3,10,0xb2da2218
1507000.0,4.0,5,4,4,3,11,0xb2d1c11ed
633.1,1.0,5,1,2,3,6,0xb2d3afc9d
390271.65,2.0,4,4,3,4,11,0xb2d3633cd
80030.04,5.0,31,3,4,2,9,0xb2d68a6ed
0.99,1.0,89,1,2,1,4,0xb2d3bb67d
103001.09,3.0,14,3,4,3,10,0xb2da0c16
11.44,1.0,13,1,2,3,6,0xb2d6223a
10225.22,1.0,4,2,2,4,8,0xb2d6e0fb
11800.93,1.0,0,2,2,4,8,0xb2d3438e
1316.03,1.0,92,1,2,1,4,0xb2d52c48d
74.26,1.0,17,1,2,2,5,0xb2d83387
2298.17,1.0,92,1,2,1,4,0xb2d27587
30008.0,2.0,6,2,3,3,8,0xb2da4f54
3543.05,1.0,7,2,2,3,7,0xb2d6aa7ad
360000.0,2.0,0,4,3,4,11,0xb2da6ae4
20178.88,2.0,0,2,3,4,9,0xb2d62c1cd
70090.08,2.0,70,3,3,1,7,0xb2d646b3d
1148.34,1.0,10,1,2,3,6,0xb2d67437
735141.39,2.0,85,4,3,1,8,0xb2d189c5d
203159.45,4.0,8,3,4,3,10,0x3b9b3e43d
80742.5,10.0,0,3,4,4,11,0x3b9af29e
65004.86,2.0,2,3,3,4,10,0xb2da3310
1440644.68,16.0,12,4,4,3,11,0xb2d084fb
1010.38,1.0,0,1,2,4,7,0xb2d8eb29d
13275.1,2.0,27,2,3,2,7,0xb2d5edddd
60086.75,2.0,129,3,3,1,7,0xb2d265f7
7200000.0,2.0,0,4,3,4,11,0xb2da6604
95902.67,2.0,12,3,3,3,9,0xb2d36b16d
17.17,1.0,39,1,2,2,5,0xb2d1510ed
510023.95,11.0,0,4,4,4,12,0xb2d5676a
500037.12,2.0,14,4,3,3,10,0xb2d64536
8472.1,1.0,3,2,2,4,8,0xb2d8d100d
500000.0,2.0,5,4,3,3,10,0xb2da5d25
30000.32,2.0,14,2,3,3,8,0xb2da377b
1000.0,2.0,9,1,3,3,7,0xb2d44b46d
10095.95,1.0,184,2,2,1,5,0xb2d2efd9d
321878.71,3.0,147,4,4,1,9,0xb2d0ea8ad
153842.57,3.0,33,3,4,2,9,0xb2d4fe62d
150329.26,2.0,24,3,3,2,8,0xb2d266f8d
100009.96,3.0,27,3,4,2,9,0xb2d24dacd
11383.66,1.0,92,2,2,1,5,0xb2d3b8b7d
300061.25,2.0,5,3,3,3,9,0xb2d62a90d
50727.06,2.0,172,2,3,1,6,0xb2d69047d
50001.06,2.0,6,2,3,3,8,0xb2da475f
10000.53,2.0,13,2,3,3,8,0xb2da3340
242964.23,3.0,231,3,4,1,8,0xb2d06acdd
400000.0,2.0,6,4,3,3,10,0xb2da5a22
10.13,1.0,20,1,2,2,5,0xb2da20b9
3603.84,1.0,26,2,2,2,6,0xb2d07623
87507.69,1.0,1,3,2,4,9,0xb2d539de
8685.63,1.0,0,2,2,4,8,0xb2d6b7ec
570.88,1.0,0,1,2,4,7,0xb2d3aac6
3069.28,1.0,9,2,2,3,7,0xb2d5b897d
20025.74,2.0,123,2,3,1,6,0xb2d5fc52d
214064.14,3.0,32,3,4,2,9,0xb2d64af7d
22404.56,3.0,0,2,4,4,10,0xb2d06a19d
754.44,1.0,4,1,2,4,7,0xb2da2839
6552.38,1.0,0,2,2,4,8,0xb2d3f2e5d
648.68,1.0,0,1,2,4,7,0xb2d1e72c
1108.18,1.0,237,1,2,1,4,0xb2d23a41d
137.76,1.0,13,1,2,3,6,0xb2d2268ed
600000.0,2.0,20,4,3,2,9,0xb2da2caa
1858522.75,16.0,14,4,4,3,11,0x3b9adbddd
26.83,1.0,26,1,2,2,5,0xb2d5b3c1d
11028.11,1.0,92,2,2,1,5,0xb2d1d92cd
467450.93,7.0,12,4,4,3,11,0xb2d24fd7d
2008.04,1.0,92,1,2,1,4,0xb2d22562d
4.92,1.0,43,1,2,2,5,0xb2d6dc8b
67512.29,2.0,92,3,3,1,7,0xb2d3e1b3d
200000.0,2.0,22,3,3,2,8,0xb2da2122
37690.56,1.0,92,2,2,1,5,0xb2d29acbd
202916.03,2.0,10,3,3,3,9,0xb2d6f7dcd
100101.06,2.0,12,3,3,3,9,0xb2da0bf8
1067813.32,6.0,75,4,4,1,9,0xb2d3669ed
191249.17,4.0,0,3,4,4,11,0xb2d35006d
199.32,1.0,23,1,2,2,5,0xb2d1d239
425186.43,3.0,42,4,4,2,10,0xb2d5c613d
174999.18,3.0,4,3,4,4,11,0xb2d65576d
32840.79,1.0,3,2,2,4,8,0xb2d3fbd4d
660337.95,4.0,19,4,4,2,10,0xb2d6f2fcd
296071.81,6.0,18,3,4,2,9,0xb2d0f87bd
5334.57,1.0,184,2,2,1,5,0xb2d52b00d
49756.35,1.0,14,2,2,3,7,0xb2d627b3d
815.54,1.0,0,1,2,4,7,0xb2d1c47bd
890899.38,13.0,0,4,4,4,12,0xb2d069f6d
500000.0,2.0,18,4,3,2,9,0xb2da33c4
500000.0,2.0,25,4,3,2,9,0xb2da1c2a
1137.47,1.0,22,1,2,2,5,0xb2d3e5d1d
230065.04,3.0,52,3,4,2,9,0xb2d5ec66d
19.13,1.0,60,1,2,2,5,0xb2d8fd3fd
100003.06,4.0,73,3,4,1,8,0xb2d6fb17d
400000.0,3.0,2,4,4,4,12,0xb2d09a4c
10000.32,2.0,221,2,3,1,6,0xb2d6fd88
3.54,2.0,4,1,3,4,8,0xb2d40dd9d
1802.74,1.0,123,1,2,1,4,0xb2d70221d
295431.92,5.0,3,3,4,4,11,0xb2d350bfd
13.47,1.0,139,1,2,1,4,0xb2d5b984
121.45,1.0,0,1,2,4,7,0xb2d6add9
130063.8,2.0,20,3,3,2,8,0xb2d364e4
225101.02,2.0,0,3,3,4,10,0xb2d5bb05d
100002.11,2.0,25,3,3,2,8,0xb2da12cd
3429.92,1.0,23,2,2,2,6,0xb2d29357d
4420757.28,15.0,0,4,4,4,12,0x3b9b35a2d
530016.78,2.0,80,4,3,1,8,0xb2d629c1
4559.68,1.0,0,2,2,4,8,0xb2d4231ad
976.52,1.0,0,1,2,4,7,0xb2d557a1
20028.25,5.0,19,2,4,2,8,0xb2d186f8d
200000.0,1.0,5,3,2,3,8,0xb2da5df1
221175.19,7.0,0,3,4,4,11,0xb2d2d325d
521437.1,1.0,8,4,2,3,9,0xb2d62691d
1221312.03,2.0,0,4,3,4,11,0xb2d0c4d5
363027.15,3.0,97,4,4,1,9,0xb2d17785d
174637.54,3.0,49,3,4,2,9,0xb2d38844
0.0,1.0,6,1,2,3,6,0xb2da2095
50001.58,2.0,25,2,3,2,7,0xb2da0e92
1490002.0,10.0,3,4,4,4,12,0x3b9b0fa0d
100000.0,1.0,1,3,2,4,9,0xb2da675a
935.31,1.0,3,1,2,4,7,0xb2d6ee91d
400002.53,3.0,13,4,4,3,11,0xb2da33a3
4822.91,1.0,5,2,2,3,7,0xb2d3a84ad
5256.4,1.0,0,2,2,4,8,0xb2d6fd85d
174.18,1.0,1,1,2,4,7,0xb2d398bad
331.51,1.0,2,1,2,4,7,0xb2d78ce6
140014.97,3.0,118,3,4,1,8,0xb2d18cf4d
448.97,1.0,0,1,2,4,7,0xb2da21a6
50001.58,2.0,11,2,3,3,8,0xb2da3ca3
500000.0,2.0,8,4,3,3,10,0xb2da4117
50030.96,2.0,10,2,3,3,8,0xb2d6ad27d
130034.39,1.0,24,3,2,2,7,0xb2da17b6
27310.79,1.0,92,2,2,1,5,0x3b9adc87d
500000.0,3.0,4,4,4,4,12,0xb2da25a5
1031.4,1.0,184,1,2,1,4,0xb2d0b567d
52.25,1.0,13,1,2,3,6,0xb2da35dd
210006.21,4.0,0,3,4,4,11,0xb2d48314d
1853801.59,3.0,1,4,4,4,12,0xb2d37902d
639889.64,2.0,3,4,3,4,11,0xb2d35e6fd
466877.78,9.0,13,4,4,3,11,0x3b9b32fb
2200001.0,2.0,1,4,3,4,11,0xb2da66d6
340000.0,2.0,13,4,3,3,10,0xb2da4171
1972.96,1.0,39,1,2,2,5,0xb2d64835
5548.2,1.0,3,2,2,4,8,0xb2d31082d
713902.36,3.0,4,4,4,4,12,0xb2d21d4cd
1100027.47,7.0,67,4,4,1,9,0xb2d636b4d
363650.32,3.0,203,4,4,1,9,0xb2d4fb26d
300000.0,2.0,27,3,3,2,8,0xb2da1252
500040.0,2.0,13,4,3,3,10,0xb2da4372
2538.5,1.0,10,1,2,3,6,0xb2d2eb67
50000.0,2.0,4,2,3,4,9,0xb2da534d
30011.82,3.0,6,2,4,3,9,0xb2d7774ad
1338.36,1.0,92,1,2,1,4,0xb2d42db8d
26286.27,1.0,1,2,2,4,8,0xb2d6cc45
2050350.19,4.0,19,4,4,2,10,0xb2d0bfb3d
51988.81,2.0,63,2,3,2,7,0xb2d5db7bd
500.86,1.0,38,1,2,2,5,0xb2d63a70
23049.09,1.0,33,2,2,2,6,0xb2d125e9
500716.28,4.0,17,4,4,2,10,0x3b9af458
305645.12,4.0,70,4,4,1,9,0xb2d33a31
50000.53,2.0,18,2,3,2,7,0xb2da2f35
468.83,1.0,59,1,2,2,5,0xb2d695c7d
663232.97,1.0,215,4,2,1,7,0xb2d772f5d
120011.82,3.0,4,3,4,4,11,0xb2d7a781d
150244.21,2.0,94,3,3,1,7,0xb2d5c023d
1.66,1.0,54,1,2,2,5,0xb2d5a7dfd
250006.34,4.0,11,3,4,3,10,0xb2da1e94
159156.02,2.0,87,3,3,1,7,0xb2d2a53ed
4323.35,1.0,144,2,2,1,5,0xb2d2813e
500000.0,2.0,5,4,3,3,10,0xb2da5c05
30011.12,2.0,48,2,3,2,7,0xb2d30b8e
711432.95,3.0,8,4,4,3,11,0xb2d26d3ed
57728.86,2.0,59,3,3,2,8,0xb2d17dd1d
42620.22,2.0,0,2,3,4,9,0xb2d54fa1d
100009.65,3.0,55,3,4,2,9,0xb2d6c079d
2.39,1.0,54,1,2,2,5,0xb2d27040
3095.18,1.0,1,2,2,4,8,0xb2d5d28cd
200099.0,2.0,5,3,3,3,9,0xb2da5f2d
0.0,1.0,0,1,2,4,7,0xb2d142bb
1308135.73,1.0,0,4,2,4,10,0xb2d2f94ad
317542.06,7.0,25,4,4,2,10,0xb2d3fa2a
35000.74,2.0,92,2,3,1,6,0xb2d67d99d
1829994.54,7.0,69,4,4,1,9,0xb2d080f6d
50010.0,2.0,6,2,3,3,8,0xb2da51dd
200000.0,2.0,1,3,3,4,10,0xb2da6641
200000.0,2.0,27,3,3,2,8,0xb2da11bd
0.0,1.0,4,1,2,4,7,0xb2d78dcc
404244.84,3.0,39,4,4,2,10,0xb2d60ee4d
830710.68,5.0,10,4,4,3,11,0xb2d56a29
0.0,1.0,91,1,2,1,4,0xb2d57fcb
102173.87,6.0,0,3,4,4,11,0xb2d16858d
6092.89,1.0,0,2,2,4,8,0xb2d60ca0
11622.44,1.0,9,2,2,3,7,0xb2d35764d
313.15,1.0,0,1,2,4,7,0xb2d6b24f
202920.85,3.0,92,3,4,1,8,0xb2d11fd1d
179062.09,3.0,27,3,4,2,9,0xb2d30857
221420.98,2.0,0,3,3,4,10,0xb2d3b15f
200000.0,2.0,8,3,3,3,9,0xb2da175a
20727.77,1.0,0,2,2,4,8,0xb2d34cb7d
176.13,1.0,18,1,2,2,5,0xb2d3234ad
270081.76,2.0,38,3,3,2,8,0xb2d0a054d
4923.24,1.0,1,2,2,4,8,0xb2d8d2b1d
4093.93,1.0,92,2,2,1,5,0xb2d2a2f8d
89.37,1.0,59,1,2,2,5,0xb2d2e3df
215974.49,2.0,258,3,3,1,7,0xb2d6c9afd
200058.76,2.0,1,3,3,4,10,0xb2d6dd35d
1638.85,1.0,10,1,2,3,6,0xb2d6f61d
624012.77,10.0,70,4,4,1,9,0xb2d08338
52003.64,2.0,13,2,3,3,8,0xb2da2b58
10000.21,2.0,11,2,3,3,8,0xb2da3fa4
74232.34,1.0,70,3,2,1,6,0xb2d609e9d
433123.3,3.0,9,4,4,3,11,0xb2d6841ad
49101.02,5.0,0,2,4,4,10,0xb2d2485c
442956.92,1.0,5,4,2,3,9,0xb2d4fee9d
3.17,1.0,75,1,2,1,4,0xb2d8d7b2d
55931.78,3.0,1,3,4,4,11,0xb2d5510fd
21889.61,1.0,177,2,2,1,5,0xb2d5ca4d
50001.06,2.0,18,2,3,2,7,0xb2da2ae0
13089.09,1.0,3,2,2,4,8,0xb2d18052d
1092.0,1.0,92,1,2,1,4,0xb2d36890d
990.71,1.0,0,1,2,4,7,0xb2d2e4b6
50000.0,2.0,6,2,3,3,8,0xb2da28ac
401.94,1.0,10,1,2,3,6,0xb2d25337
254579.53,17.0,0,3,4,4,11,0x3b9af13ed
1675.82,2.0,184,1,3,1,5,0xb2d6585dd
200041.84,8.0,47,3,4,2,9,0xb2d06a4cd
92308.69,1.0,0,3,2,4,9,0xb2d20fbfd
446887.12,5.0,1,4,4,4,12,0xb2d59a55d
2623.89,1.0,2,1,2,4,7,0xb2d23848d
40002.11,2.0,189,2,3,1,6,0xb2d82784d
5775.47,1.0,12,2,2,3,7,0xb2d4a53dd
200087.56,3.0,19,3,4,2,9,0xb2d38ee8d
335031.02,8.0,8,4,4,3,11,0xb2d30e32d
170045.12,3.0,165,3,4,1,8,0xb2d2e393d
8628.64,1.0,13,2,2,3,7,0xb2da12e3
85397.12,1.0,117,3,2,1,6,0xb2d4aa55d
455089.85,4.0,18,4,4,2,10,0xb2d53669d
20000.84,2.0,90,2,3,1,6,0xb2d8a65cd
10000.53,2.0,21,2,3,2,7,0xb2da1634
500000.0,3.0,19,4,4,2,10,0xb2da0c7a
450088.12,3.0,5,4,4,3,11,0xb2d20ca7d
30000.32,2.0,216,2,3,1,6,0xb2d682bad
800085.84,2.0,82,4,3,1,8,0xb2d5809fd
1.94,1.0,19,1,2,2,5,0xb2d7e14c
2650440.94,12.0,1,4,4,4,12,0xb2d509b3
200761.75,2.0,122,3,3,1,7,0xb2d665d4d
1875.69,1.0,0,1,2,4,7,0xb2d4f970d
250112.96,3.0,80,3,4,1,8,0xb2d26264d
2000.84,1.0,0,1,2,4,7,0xb2d700ab
61510.85,2.0,24,3,3,2,8,0xb2d405f8d
4498.46,1.0,0,2,2,4,8,0xb2d2a28fd
74.82,1.0,10,1,2,3,6,0xb2d4a97ad
600011.83,1.0,4,4,2,4,10,0xb2da4c6d
2114.44,2.0,2,1,3,4,8,0xb2d8cd62d
3.05,1.0,73,1,2,1,4,0xb2d37c58d
753.1,1.0,8,1,2,3,6,0xb2d1c9f6d
1023.29,1.0,92,1,2,1,4,0xb2d138afd
450010.9,7.0,3,4,4,4,12,0xb2d598afd
30.61,1.0,39,1,2,2,5,0xb2d5d899d
8067.64,1.0,15,2,2,3,7,0xb2d33af0
4017.61,3.0,4,2,4,4,10,0xb2d0c428d
40001.26,3.0,83,2,4,1,7,0xb2d84764
5049.74,1.0,184,2,2,1,5,0xb2d2df50d
716.97,1.0,69,1,2,1,4,0xb2d091a0
13.51,1.0,7,1,2,3,6,0xb2d5f3fb
0.53,1.0,5,1,2,3,6,0xb2da0a22
20.88,1.0,53,1,2,2,5,0xb2d3503f
1430.13,1.0,65,1,2,2,5,0xb2d4cab6
7458.85,1.0,0,2,2,4,8,0xb2d6bb69d
113.89,3.0,14,1,4,3,8,0xb2d3b09ed
501000.0,2.0,5,4,3,3,10,0xb2da5bfa
48576.85,5.0,0,2,4,4,10,0xb2d55106d
150004.75,3.0,20,3,4,2,9,0xb2d56f81d
318564.58,3.0,136,4,4,1,9,0xb2d2bc4cd
184.72,2.0,0,1,3,4,8,0xb2da5726
102122.16,2.0,32,3,3,2,8,0xb2d38aafd
3610.75,1.0,1,2,2,4,8,0xb2d6e8a9
68063.8,9.0,8,3,4,3,10,0xb2d0c386
257185.7,8.0,97,3,4,1,8,0xb2d5687ed
501077.4,4.0,34,4,4,2,10,0xb2d54ac1d
37.7,1.0,7,1,2,3,6,0xb2d6d3b1
369195.05,2.0,38,4,3,2,9,0xb2d8d401d
17.3,1.0,18,1,2,2,5,0xb2d5ceb7d
198585.63,4.0,34,3,4,2,9,0xb2d12a2e
21000.22,2.0,80,2,3,1,6,0xb2d189b5
200686.37,6.0,76,3,4,1,8,0xb2d07573d
108.76,6.0,58,1,4,2,7,0xb2d40bc4
178072.1,2.0,77,3,3,1,7,0xb2d18f71d
50000.53,2.0,25,2,3,2,7,0xb2da145d
660025.27,6.0,144,4,4,1,9,0xb2d191f0
24693.75,1.0,13,2,2,3,7,0xb2d6a072d
724.84,1.0,15,1,2,3,6,0xb2d2df46d
1.58,1.0,154,1,2,1,4,0xb2d8e0dcd
110153.45,3.0,3,3,4,4,11,0xb2d5cfa8d
4476.17,1.0,184,2,2,1,5,0xb2d62005d
20014.28,1.0,1,2,2,4,8,0xb2d655eb
200145.75,2.0,144,3,3,1,7,0xb2d10f39
1340000.01,16.0,0,4,4,4,12,0xb2d221cb
200005.91,3.0,14,3,4,3,10,0xb2da2b40
33.28,1.0,110,1,2,1,4,0xb2d16bcad
172.03,1.0,10,1,2,3,6,0xb2d69fa9
110037.89,3.0,75,3,4,1,8,0xb2d1d51cd
264193.17,2.0,48,3,3,2,8,0xb2d6423ad
1713068.78,7.0,0,4,4,4,12,0xb2d1c26ed
1220000.43,10.0,0,4,4,4,12,0xb2d8ef4cd
2018.99,1.0,219,1,2,1,4,0xb2d0d3a6d
11.49,1.0,47,1,2,2,5,0xb2d5c617d
1390.69,1.0,31,1,2,2,5,0xb2d65c42d
431303.03,6.0,63,4,4,2,10,0xb2d59deed
170038.01,4.0,39,3,4,2,9,0xb2d2e38bd
290000.0,1.0,5,3,2,3,8,0xb2da6053
69603.01,2.0,20,3,3,2,8,0xb2d1b898d
1021.66,1.0,145,1,2,1,4,0xb2d6d1f3d
28.97,1.0,60,1,2,2,5,0xb2d1b8f0
20001.35,2.0,228,2,3,1,6,0xb2d635f5
5003.54,1.0,76,2,2,1,5,0xb2d8e048
50001.58,2.0,18,2,3,2,7,0xb2da2591
400000.0,3.0,11,4,4,3,11,0xb2da0df1
200000.0,1.0,0,3,2,4,9,0xb2da6a55
208540.42,2.0,13,3,3,3,9,0xb2d5890cd
257009.27,3.0,102,3,4,1,8,0xb2d39227d
1304671.35,8.0,19,4,4,2,10,0xb2d65921d
500000.0,3.0,7,4,4,3,11,0xb2da4f64
10106.66,1.0,184,2,2,1,5,0xb2d63868d
40508.0,2.0,28,2,3,2,7,0xb2d0c3f4d
10075.67,2.0,0,2,3,4,9,0xb2da2d8f
1371.77,1.0,0,1,2,4,7,0xb2d1d88ed
110761.64,2.0,153,3,3,1,7,0xb2d2920fd
364014.33,16.0,8,4,4,3,11,0xb2d279b5d
20589.58,1.0,0,2,2,4,8,0xb2d62f3bd
2050226.36,4.0,19,4,4,2,10,0xb2d6e7d3
1111.32,1.0,13,1,2,3,6,0xb2d5a740d
1604263.78,5.0,12,4,4,3,11,0xb2d70054d
156006.38,4.0,4,3,4,4,11,0x3b9b0fdad
60417.24,4.0,19,3,4,2,9,0xb2d1eee3
0.0,1.0,103,1,2,1,4,0xb2d3a154d
26.39,1.0,21,1,2,2,5,0xb2da2378
50001.06,2.0,11,2,3,3,8,0xb2da4376
1500000.0,1.0,1,4,2,4,10,0xb2da693e
6997.61,1.0,0,2,2,4,8,0xb2d6970cd
150013.64,3.0,0,3,4,4,11,0xb2da4799
6112.69,1.0,27,2,2,2,6,0xb2d2eb6d
12685.71,1.0,0,2,2,4,8,0xb2d6c301
280467.45,3.0,60,3,4,2,9,0xb2d08995d
360000.0,2.0,12,4,3,3,10,0xb2da37a3
321295.55,7.0,10,4,4,3,11,0xb2d3ff59
445026.19,4.0,6,4,4,3,11,0xb2d1b4d3
300003.0,2.0,24,3,3,2,8,0xb2da0c5c
10017.15,2.0,14,2,3,3,8,0xb2da2ec1
294531.35,2.0,67,3,3,1,7,0x3b9b24aad
4005.28,1.0,0,2,2,4,8,0xb2d3a1aad
35000.74,2.0,165,2,3,1,6,0xb2d6274cd
3170.19,1.0,74,2,2,1,5,0xb2d42437d
700000.0,1.0,10,4,2,3,9,0xb2da397d
60047.93,3.0,20,3,4,2,9,0xb2d27d55d
22722.84,1.0,9,2,2,3,7,0xb2d2d172
50001.06,2.0,18,2,3,2,7,0xb2da2bcd
15000.16,2.0,18,2,3,2,7,0xb2da2ee8
100006.38,2.0,92,3,3,1,7,0xb2d0c8ffd
5091.3,1.0,184,2,2,1,5,0xb2d0ed25d
260002.53,3.0,21,3,4,2,9,0xb2da1649
200004.22,2.0,18,3,3,2,8,0xb2da2a1d
206403.95,3.0,101,3,4,1,8,0x3b9adbabd
450047.02,2.0,1,4,3,4,11,0xb2d299c8d
119973.0,3.0,0,3,4,4,11,0xb2da636c
390111.19,5.0,6,4,4,3,11,0xb2d57f8ed
50001.06,2.0,18,2,3,2,7,0xb2da2c61
24.19,1.0,116,1,2,1,4,0xb2d4af81d
15123.48,1.0,0,2,2,4,8,0xb2d7bd4e
62.99,1.0,0,1,2,4,7,0xb2d4bb02
242939.94,2.0,269,3,3,1,7,0xb2d16216d
224202.48,1.0,14,3,2,3,8,0xb2d1a198
627406.38,6.0,4,4,4,4,12,0xb2d0cdc1d
41628.66,2.0,75,2,3,1,6,0xb2d56999d
20028.04,2.0,67,2,3,1,6,0xb2d2b58bd
40005.84,2.0,5,2,3,3,8,0xb2d26d08d
1211.51,1.0,184,1,2,1,4,0xb2d19b7ad
30028.25,2.0,3,2,3,4,9,0xb2d1bc08
1106.39,1.0,92,1,2,1,4,0xb2d42451d
20206.05,1.0,21,2,2,2,6,0xb2d547edd
80462.26,2.0,200,3,3,1,7,0xb2d5099ed
184.81,1.0,11,1,2,3,6,0xb2da3fdb
625021.85,10.0,60,4,4,2,10,0xb2d19828d
5476.63,1.0,5,2,2,3,7,0xb2d1f414
29074.85,2.0,0,2,3,4,9,0xb2d609c7d
665.94,1.0,10,1,2,3,6,0xb2d5311c
170914.99,2.0,11,3,3,3,9,0xb2d6126ad
67644.15,1.0,184,3,2,1,6,0xb2d2d010d
87014.64,2.0,137,3,3,1,7,0xb2d54811d
40000.11,2.0,0,2,3,4,9,0xb2da2310
50328.78,1.0,184,2,2,1,5,0xb2d45f77d
150041.93,2.0,48,3,3,2,8,0xb2d5873f
100020.06,1.0,29,3,2,2,7,0xb2da0a35
592320.63,1.0,0,4,2,4,10,0xb2d8c879
30000.95,2.0,192,2,3,1,6,0xb2d6a0f4d
57.33,1.0,6,1,2,3,6,0xb2d63f31d
2214.12,1.0,5,1,2,3,6,0xb2d643ffd
7000.01,2.0,8,2,3,3,8,0xb2da4c4d
200000.0,1.0,0,3,2,4,9,0xb2da6c60
47215.46,1.0,0,2,2,4,8,0xb2da11c7
205061.35,2.0,228,3,3,1,7,0xb2d552c7d
2228.19,1.0,6,1,2,3,6,0xb2d5c89fd
50001.06,2.0,18,2,3,2,7,0xb2da2a81
224844.11,3.0,87,3,4,1,8,0xb2d67de4d
180551.5,6.0,15,3,4,3,10,0xb2d4dc08d
754.25,1.0,12,1,2,3,6,0xb2d39d51
400000.0,2.0,15,4,3,3,10,0xb2da385b
11.28,1.0,14,1,2,3,6,0xb2d47f0f
9448.8,1.0,10,2,2,3,7,0xb2d78bb4d
4260.11,1.0,5,2,2,3,7,0xb2d4f154d
13868.98,2.0,0,2,3,4,9,0xb2d31d68d
5000000.0,2.0,8,4,3,3,10,0xb2da51fc
200000.0,2.0,12,3,3,3,9,0xb2da451e
2319.59,2.0,8,1,3,3,7,0xb2d0dc9dd
0.0,1.0,7,1,2,3,6,0xb2d1756d
688996.61,5.0,8,4,4,3,11,0x3b9b3ea2d
805007.47,8.0,0,4,4,4,12,0xb2d62f15d
500001.58,2.0,13,4,3,3,10,0xb2da3d4d
705019.08,9.0,4,4,4,4,12,0xb2d17da7d
50001.59,2.0,11,2,3,3,8,0xb2da2c76
154.06,2.0,55,1,3,2,6,0xb2d0f5ced
6532.35,1.0,4,2,2,4,8,0xb2d1bf91
66438.63,2.0,42,3,3,2,8,0xb2d0fd2dd
302131.52,2.0,33,4,3,2,9,0xb2d8f75ed
2.16,1.0,82,1,2,1,4,0xb2d8cf02
300000.0,2.0,4,3,3,4,10,0xb2da623a
10006.14,2.0,11,2,3,3,8,0xb2da41ca
169.73,1.0,7,1,2,3,6,0xb2da3069
40000.43,2.0,14,2,3,3,8,0xb2da0c69
101184.58,2.0,47,3,3,2,8,0xb2d3ebbed
3613.85,1.0,92,2,2,1,5,0xb2d220a2d
500021.11,2.0,14,4,3,3,10,0xb2da32fa
2211.36,1.0,0,1,2,4,7,0xb2d6c1dc
10024.0,1.0,179,2,2,1,5,0xb2d2c152
33021.68,3.0,3,2,4,4,10,0xb2d38a86
19040.9,1.0,184,2,2,1,5,0xb2d62407d
385016.26,1.0,14,4,2,3,9,0xb2da3786
100010.28,2.0,13,3,3,3,9,0xb2da3357
1142.17,1.0,184,1,2,1,4,0x3b9b19a7d
92.04,3.0,2,1,4,4,9,0xb2da4e81
213.46,1.0,17,1,2,2,5,0xb2d334ff
761.05,1.0,0,1,2,4,7,0xb2d31516
309331.5,3.0,100,4,4,1,9,0xb2d61be5d
146564.84,4.0,18,3,4,2,9,0xb2d079ead
571472.91,4.0,30,4,4,2,10,0xb2d10e34d
19.92,1.0,13,1,2,3,6,0xb2d0f55cd
91.07,1.0,40,1,2,2,5,0xb2d5ac5fd
300017.4,2.0,32,3,3,2,8,0xb2d5578fd
9032.04,1.0,45,2,2,2,6,0xb2d4f193
795.16,1.0,0,1,2,4,7,0xb2da5736
39901.72,10.0,0,2,4,4,10,0xb2d234b3d
200002.11,2.0,21,3,3,2,8,0xb2da1f6b
6073.35,1.0,144,2,2,1,5,0xb2d4e710d
330079.36,11.0,10,4,4,3,11,0xb2d5f1cdd
500005.28,2.0,8,4,3,3,10,0xb2da4cad
180000.0,2.0,4,3,3,4,10,0xb2da54e7
603636.59,2.0,1,4,3,4,11,0xb2d1d617
50001.58,2.0,11,2,3,3,8,0xb2da3dc8
3007.23,1.0,238,2,2,1,5,0xb2d6924dd
5023.79,1.0,184,2,2,1,5,0xb2d59a2cd
1516008.79,1.0,0,4,2,4,10,0xb2d40334d
6526.62,2.0,78,2,3,1,6,0xb2d08c98d
400090.54,3.0,11,4,4,3,11,0xb2da0ace
57716.19,1.0,8,3,2,3,8,0xb2d2be56
7489.85,1.0,18,2,2,2,6,0xb2d6bd23
200000.0,2.0,5,3,3,3,9,0xb2da5f0a
360000.0,2.0,26,4,3,2,9,0xb2da14be
900.05,1.0,12,1,2,3,6,0xb2d1ae0a
718552.92,1.0,12,4,2,3,9,0xb2d4c0d0d
6364.77,1.0,6,2,2,3,7,0xb2d3c0cb
500000.0,2.0,18,4,3,2,9,0xb2da3510
4879.56,1.0,1,2,2,4,8,0xb2d70016d
21.37,1.0,13,1,2,3,6,0xb2d55d74d
0.0,1.0,4,1,2,4,7,0xb2da58ce
50000.0,1.0,5,2,2,3,7,0xb2da5e89
200000.0,2.0,15,3,3,3,9,0xb2da3a3b
860089.51,7.0,77,4,4,1,9,0xb2d28b44d
20000.63,2.0,11,2,3,3,8,0xb2da3cd2
1091082.16,7.0,1,4,4,4,12,0xb2d682d9d
13062.1,2.0,10,2,3,3,8,0xb2d55b0ed
70002.22,2.0,224,3,3,1,7,0xb2d6fa6d
236550.4,1.0,1,3,2,4,9,0xb2d3b6a7d
172.27,1.0,0,1,2,4,7,0xb2d6c1ab
13708.45,1.0,201,2,2,1,5,0xb2d67d86d
300000.0,2.0,21,3,3,2,8,0xb2da2862
190021.96,2.0,48,3,3,2,8,0xb2d31735
4173.21,2.0,131,2,3,1,6,0xb2d425e1d
334049.47,6.0,0,4,4,4,12,0xb2d07892d
749.37,1.0,16,1,2,2,5,0xb2d2b5b2
263.58,1.0,9,1,2,3,6,0xb2d60fe5d
9861.17,1.0,0,2,2,4,8,0xb2d60a51d
50001.59,2.0,11,2,3,3,8,0xb2da2355
301194.32,2.0,42,4,3,2,9,0xb2d69ff2
51000.54,2.0,8,2,3,3,8,0xb2da4b03
6623.95,1.0,92,2,2,1,5,0xb2d48e08d
161181.06,2.0,40,3,3,2,8,0xb2d634d5d
7.32,1.0,16,1,2,2,5,0xb2d69ed2
13054.53,1.0,20,2,2,2,6,0xb2d60a46d
50000.53,2.0,8,2,3,3,8,0xb2da4ae5
10000.53,2.0,21,2,3,2,7,0xb2da161d
1138.04,1.0,184,1,2,1,4,0xb2d2e1b6d
89.34,1.0,10,1,2,3,6,0xb2d59194
133439.08,9.0,13,3,4,3,10,0xb2d6824cd
359011.37,2.0,11,4,3,3,10,0xb2da3d77
280000.0,2.0,3,3,3,4,10,0xb2da5c01
50115.6,1.0,179,2,2,1,5,0xb2d2c04d
630000.0,1.0,4,4,2,4,10,0xb2da51d2
33037.56,3.0,0,2,4,4,10,0xb2d5cc17d
205098.84,2.0,132,3,3,1,7,0xb2d2b097d
3325.81,1.0,4,2,2,4,8,0xb2d6bee8
65749.15,2.0,39,3,3,2,8,0xb2d2e057
50001.58,2.0,108,2,3,1,6,0xb2d62617d
30170.45,1.0,0,2,2,4,8,0xb2d3a013d
384829.39,3.0,35,4,4,2,10,0xb2d383ffd
10043.21,2.0,14,2,3,3,8,0xb2da208b
1006.48,1.0,184,1,2,1,4,0xb2d2e430d
3803.26,1.0,184,2,2,1,5,0xb2d3c233d
1553.63,2.0,92,1,3,1,5,0xb2d0f985
300000.0,2.0,25,3,3,2,8,0xb2da1aa0
24.74,5.0,8,1,4,3,8,0xb2d52279d
180010.13,2.0,63,3,3,2,8,0xb2d647a1d
130145.38,2.0,36,3,3,2,8,0xb2d1b3a1d
25075.3,1.0,159,2,2,1,5,0xb2d5de87d
50001.58,2.0,206,2,3,1,6,0xb2d68ba0d
44320.62,1.0,19,2,2,2,6,0xb2d6b8b5d
1.41,1.0,187,1,2,1,4,0xb2d1130e
0.0,1.0,4,1,2,4,7,0xb2da51c0
284032.83,4.0,1,3,4,4,11,0xb2d3c4bed
150012.79,2.0,192,3,3,1,7,0xb2d41252d
312087.3,2.0,26,4,3,2,9,0xb2da0e2e
500000.0,2.0,21,4,3,2,9,0xb2da277b
684.23,1.0,21,1,2,2,5,0xb2d15a61d
140005.91,2.0,14,3,3,3,9,0xb2da33cf
251159.92,11.0,10,3,4,3,10,0xb2d65021d
30000.63,2.0,8,2,3,3,8,0xb2da4923
2774.17,1.0,24,1,2,2,5,0xb2d38cf9d
200000.0,2.0,1,3,3,4,10,0xb2da671d
1180012.49,3.0,28,4,4,2,10,0xb2d6b23c
560024.33,2.0,11,4,3,3,10,0xb2d565d8
1929.14,2.0,92,1,3,1,5,0xb2d08bf4d
500000.2,3.0,22,4,4,2,10,0xb2d6904ad
738.27,1.0,26,1,2,2,5,0xb2d28a30
319.59,1.0,24,1,2,2,5,0xb2d3fcd4d
9680.19,1.0,10,2,2,3,7,0xb2da202e
135005.6,3.0,11,3,4,3,10,0xb2da0ce1
30514.19,1.0,185,2,2,1,5,0xb2d33928d
1533.52,1.0,105,1,2,1,4,0xb2d688ff
3240089.82,5.0,0,4,4,4,12,0xb2d616bdd
53.41,1.0,18,1,2,2,5,0xb2d59d0a
79.88,1.0,31,1,2,2,5,0xb2d5f708d
64294.9,2.0,228,3,3,1,7,0xb2d3d20ad
366.87,1.0,75,1,2,1,4,0xb2d43fbad
310188.4,3.0,11,4,4,3,11,0xb2d4b2ea
1252.17,4.0,0,1,4,4,9,0x3b9b4872d
2222019.32,6.0,14,4,4,3,11,0xb2d1ad7ad
24711.16,1.0,181,2,2,1,5,0xb2d2ce13
2.75,1.0,23,1,2,2,5,0xb2d8d5c8
64146.38,2.0,60,3,3,2,8,0xb2d36341d
74509.51,1.0,92,3,2,1,6,0xb2d29cb6d
2210.28,1.0,92,1,2,1,4,0xb2d28b7f
702021.86,7.0,20,4,4,2,10,0xb2d19687d
101185.99,2.0,158,3,3,1,7,0xb2d6c5ded
120001.27,2.0,14,3,3,3,9,0xb2da3993
90052.06,3.0,97,3,4,1,8,0xb2d0fccdd
3173.75,1.0,101,2,2,1,5,0xb2d1461bd
13.0,2.0,76,1,3,1,5,0xb2d371aa
1117.92,1.0,1,1,2,4,7,0xb2d16615d
160525.91,4.0,11,3,4,3,10,0xb2d6deadd
117.41,1.0,58,1,2,2,5,0xb2d0e58ad
80096.15,3.0,6,3,4,3,10,0xb2d5f03bd
560108.1,2.0,221,4,3,1,8,0xb2d574c0d
104047.23,1.0,1,3,2,4,9,0xb2d4d24cd
542133.68,7.0,6,4,4,3,11,0xb2d153bed
6221.61,1.0,14,2,2,3,7,0xb2d1ee7a
165209.83,3.0,139,3,4,1,8,0xb2d248f2d
183536.47,3.0,18,3,4,2,9,0xb2d1b551d
1.56,1.0,3,1,2,4,7,0xb2d23e18
590214.82,3.0,21,4,4,2,10,0xb2d0a141d
612432.02,2.0,0,4,3,4,11,0xb2d0d961d
10227.65,2.0,80,2,3,1,6,0xb2d6e0fbd
3242.63,1.0,0,2,2,4,8,0xb2d599d7
176005.56,10.0,18,3,4,2,9,0xb2d5e4b3d
64063.82,1.0,0,3,2,4,9,0xb2d77452
40003.84,2.0,20,2,3,2,7,0xb2d13f6dd
210440.18,4.0,87,3,4,1,8,0xb2d39ab2
2810.74,1.0,184,1,2,1,4,0xb2d24779d
3331.82,1.0,10,2,2,3,7,0xb2d88c67d
4.0,1.0,10,1,2,3,6,0xb2d8d536
65.33,1.0,18,1,2,2,5,0xb2d3135a
17169.7,1.0,10,2,2,3,7,0xb2d42f0dd
1824951.53,7.0,2,4,4,4,12,0xb2d0b8b2d
4777.71,1.0,23,2,2,2,6,0xb2d27e41d
53867.21,2.0,154,3,3,1,7,0xb2d3802ad
8.12,2.0,112,1,3,1,5,0x3b9b2ab7d
25229.96,1.0,33,2,2,2,6,0xb2d643e8d
112754.7,2.0,116,3,3,1,7,0x3b9b4a15d
80075.18,1.0,1,3,2,4,9,0xb2d8f81fd
4828.02,1.0,165,2,2,1,5,0xb2d6a8d9d
34320.67,1.0,9,2,2,3,7,0xb2d30551d
289607.12,5.0,26,3,4,2,9,0xb2d581d7
1279548.51,13.0,52,4,4,2,10,0xb2d3fd8ed
11167.12,1.0,92,2,2,1,5,0xb2d3af2dd
70000.31,6.0,1,3,4,4,11,0xb2d3f488d
94625.91,1.0,39,3,2,2,7,0xb2d5cad6d
150009.77,2.0,92,3,3,1,7,0xb2d3c5c6d
324720.55,3.0,24,4,4,2,10,0xb2d197aed
398.48,2.0,92,1,3,1,5,0x3b9acf10
447.41,1.0,9,1,2,3,6,0xb2d6df6dd
13.92,1.0,2,1,2,4,7,0xb2d566d8
1010.32,1.0,0,1,2,4,7,0xb2d2b5f8d
714638.38,4.0,8,4,4,3,11,0xb2d69ca6d
470097.36,3.0,4,4,4,4,12,0xb2d233a1d
33402.83,1.0,20,2,2,2,6,0xb2d6b975d
16161.68,1.0,92,2,2,1,5,0xb2d28642d
339031.25,4.0,144,4,4,1,9,0xb2d13892d
11.15,1.0,20,1,2,2,5,0xb2d2a6c2d
170053.88,4.0,6,3,4,3,10,0xb2d25bc7
440.22,1.0,10,1,2,3,6,0xb2d8f024d
2280.94,1.0,92,1,2,1,4,0xb2d39194d
220507.36,2.0,63,3,3,2,8,0xb2d250afd
62599.0,4.0,1,3,4,4,11,0xb2d0658dd
741738.41,3.0,1,4,4,4,12,0xb2d62747d
32305.24,4.0,14,2,4,3,9,0xb2d659b4
283255.82,2.0,84,3,3,1,7,0xb2d6fecfd
100103.2,2.0,193,3,3,1,7,0xb2d649d0d
71701.41,2.0,11,3,3,3,9,0xb2d41a41
520650.2,3.0,26,4,4,2,10,0xb2d5cba6d
70068.2,2.0,10,3,3,3,9,0xb2d526f1d
5653.13,3.0,20,2,4,2,8,0x3b9af1d2d
281107.2,2.0,11,3,3,3,9,0xb2d629fbd
70034.97,2.0,249,3,3,1,7,0xb2d2872dd
20099.71,1.0,184,2,2,1,5,0xb2d5b6ead
65002.06,2.0,92,3,3,1,7,0xb2d67b3ad
79014.75,2.0,10,3,3,3,9,0xb2d1d974d
941307.8,6.0,1,4,4,4,12,0xb2d469c3d
6087.08,1.0,53,2,2,2,6,0xb2d52775d
105901.81,1.0,3,3,2,4,9,0xb2d6cbefd
60007.59,2.0,216,3,3,1,7,0xb2d5039cd
11390.01,1.0,4,2,2,4,8,0xb2d5c953d
7214.66,1.0,123,2,2,1,5,0xb2d42937d
443.53,1.0,6,1,2,3,6,0xb2d3265cd
580022.93,3.0,0,4,4,4,12,0xb2d25b46d
275.45,1.0,44,1,2,2,5,0xb2d34bd3
129.11,1.0,53,1,2,2,5,0xb2d6eb30d
287.57,3.0,28,1,4,2,7,0xb2d65fd1
137858.28,3.0,125,3,4,1,8,0xb2d5cf3cd
166010.6,2.0,136,3,3,1,7,0xb2d4517cd
167187.54,4.0,27,3,4,2,9,0xb2d4f382d
757.71,1.0,0,1,2,4,7,0xb2d6ca67
152065.89,2.0,24,3,3,2,8,0xb2d68420d
228042.8,2.0,145,3,3,1,7,0xb2d194c0
1808074.36,6.0,6,4,4,3,11,0xb2d62533d
309.86,1.0,2,1,2,4,7,0xb2d1fdf6d
51208.7,1.0,6,2,2,3,7,0xb2d47c89d
705011.75,3.0,4,4,4,4,12,0xb2d654bf
4080.06,1.0,15,2,2,3,7,0xb2d31916
715033.94,6.0,4,4,4,4,12,0xb2d6122cd
453290.12,3.0,69,4,4,1,9,0xb2d69bb9d
162295.15,5.0,3,3,4,4,11,0xb2d34228d
2650.31,1.0,143,1,2,1,4,0xb2d53b00d
182352.98,3.0,200,3,4,1,8,0xb2d16c40d
211192.71,5.0,13,3,4,3,10,0xb2d204cdd
26.15,1.0,0,1,2,4,7,0xb2d74b3a
125442.9,5.0,0,3,4,4,11,0xb2d067d9
656009.13,5.0,4,4,4,4,12,0xb2d5da36d
762.12,1.0,3,1,2,4,7,0xb2d2ed39d
22017.61,2.0,179,2,3,1,6,0xb2d563bad
30001.29,4.0,28,2,4,2,8,0xb2d60f7cd
51943.98,2.0,228,2,3,1,6,0xb2d5cbe8d
7928.86,1.0,0,2,2,4,8,0xb2d4f97fd
1787.24,1.0,0,1,2,4,7,0xb2d6c058d
64751.66,2.0,116,3,3,1,7,0xb2d58da1d
170020.88,2.0,228,3,3,1,7,0xb2d6821cd
29.41,1.0,7,1,2,3,6,0xb2d37c66
226.5,1.0,1,1,2,4,7,0xb2d5f2a6
322234.75,2.0,167,4,3,1,8,0xb2d4112bd
73014.35,3.0,47,3,4,2,9,0xb2d37883
7809.32,2.0,13,2,3,3,8,0xb2d0c4d5d
180543.0,6.0,12,3,4,3,10,0xb2d5ee1fd
502976.96,5.0,83,4,4,1,9,0xb2d2c960d
690064.22,7.0,14,4,4,3,11,0xb2d22526d
1763955.24,6.0,52,4,4,2,10,0xb2d0eabf
145.02,1.0,0,1,2,4,7,0xb2d8ce6f
750000.0,4.0,2,4,4,4,12,0xb2d1a8c1d
100003.72,3.0,87,3,4,1,8,0xb2d58267d
609134.16,3.0,0,4,4,4,12,0xb2d62372d
230003.79,3.0,12,3,4,3,10,0xb2d81089d
2499.21,1.0,182,1,2,1,4,0xb2d3d816d
220666.46,3.0,0,3,4,4,11,0xb2d2448a
48218.73,1.0,0,2,2,4,8,0xb2d59227d
28228.94,1.0,302,2,2,1,5,0xb2d34984d
6114.05,1.0,0,2,2,4,8,0xb2d83504d
100002.07,2.0,6,3,3,3,9,0xb2d30d61d
6114.25,1.0,92,2,2,1,5,0xb2d443d7d
9391.72,1.0,173,2,2,1,5,0xb2d2fa92d
80003.65,4.0,137,3,4,1,8,0xb2d63d10d
296.71,1.0,10,1,2,3,6,0xb2d60c0ad
207092.11,2.0,151,3,3,1,7,0xb2d58ba9d
3578610.15,9.0,1,4,4,4,12,0xb2d243c5d
410292.7,2.0,239,4,3,1,8,0xb2d6054dd
20342.02,2.0,190,2,3,1,6,0xb2d58430d
1066467.02,14.0,0,4,4,4,12,0xb2d5e670d
50215.83,2.0,206,2,3,1,6,0xb2d2550e
452190.59,4.0,76,4,4,1,9,0xb2d3adf6d
61205.74,4.0,0,3,4,4,11,0xb2d60848d
1687.68,1.0,158,1,2,1,4,0xb2d5b714
212884.31,2.0,132,3,3,1,7,0xb2d411b5
115956.28,1.0,5,3,2,3,8,0xb2d516ecd
507.07,1.0,10,1,2,3,6,0xb2d60b5cd
250818.45,3.0,9,3,4,3,10,0xb2d248efd
174563.97,3.0,9,3,4,3,10,0xb2d24209
871539.88,3.0,98,4,4,1,9,0xb2d38fd1d
1910028.18,6.0,4,4,4,4,12,0xb2d314ad
334370.58,2.0,126,4,3,1,8,0xb2d6af8bd
371013.85,6.0,24,4,4,2,10,0xb2d1b9b8
1020.91,1.0,184,1,2,1,4,0xb2d2a169d
5709.58,1.0,18,2,2,2,6,0xb2d6c274
103087.39,2.0,122,3,3,1,7,0xb2d100acd
8.74,1.0,62,1,2,2,5,0xb2d6837ad
1464.67,1.0,281,1,2,1,4,0xb2d5d48ad
230219.5,3.0,12,3,4,3,10,0xb2d8ea29d
1653.48,1.0,19,1,2,2,5,0xb2d31ed6
1061500.12,3.0,53,4,4,2,10,0xb2d23215d
367140.79,4.0,3,4,4,4,12,0xb2d07c85d
9522.04,2.0,73,2,3,1,6,0xb2d8d4b4
4195.42,6.0,184,2,4,1,7,0xb2d089a4d
4327.5,1.0,236,2,2,1,5,0xb2d2813ed
300183.59,4.0,13,4,4,3,11,0xb2d5f884d
87464.1,3.0,41,3,4,2,9,0xb2d57af0d
30063.57,2.0,97,2,3,1,6,0xb2d56e6fd
5087.08,1.0,92,2,2,1,5,0xb2d10933d
65740.52,1.0,0,3,2,4,9,0xb2d35113
63762.43,1.0,14,3,2,3,8,0xb2d2cddd
81983.27,1.0,18,3,2,2,7,0xb2d20584
120921.79,9.0,0,3,4,4,11,0xb2d1a119d
120005.37,2.0,74,3,3,1,7,0xb2d56794d
440486.04,8.0,0,4,4,4,12,0xb2d6c9acd
100004.42,2.0,27,3,3,2,8,0xb2d0b767d
351.22,2.0,12,1,3,3,7,0xb2d36abed
717147.79,2.0,76,4,3,1,8,0xb2d61c94d
64996.4,1.0,92,3,2,1,6,0xb2d1bb9ed
50027.33,2.0,14,2,3,3,8,0xb2d1abc1d
65.16,1.0,4,1,2,4,7,0xb2d3f2a2
110006.54,2.0,83,3,3,1,7,0xb2d44c3cd
156471.67,4.0,62,3,4,2,9,0xb2d5ba1dd
260161.94,3.0,4,3,4,4,11,0xb2d17fc9d
9130.43,1.0,0,2,2,4,8,0xb2d5ed54
15000.0,2.0,10,2,3,3,8,0xb2d5e913d
0.0,1.0,1,1,2,4,7,0xb2d2bd21
411602.66,6.0,0,4,4,4,12,0xb2d0f9ddd
169483.44,1.0,34,3,2,2,7,0xb2d2b757d
6.98,1.0,0,1,2,4,7,0xb2d4851dd
250483.09,5.0,4,3,4,4,11,0xb2d09db8d
9332.32,6.0,0,2,4,4,10,0xb2d0787cd
750001.34,3.0,15,4,4,3,11,0xb2d6e8d3d
1178565.93,4.0,125,4,4,1,9,0xb2d44693d
9387.31,1.0,8,2,2,3,7,0xb2d5ec60d
1911144.69,6.0,17,4,4,2,10,0xb2d598e7d
2821588.85,3.0,4,4,4,4,12,0x3b9b1008d
239693.16,4.0,63,3,4,2,9,0xb2d8dc5b
490047.2,3.0,130,4,4,1,9,0xb2d1be27d
22768.17,1.0,1,2,2,4,8,0xb2d34159d
115743.25,1.0,29,3,2,2,7,0xb2d1fb44
53105.07,1.0,9,3,2,3,8,0xb2d3266f
810098.31,3.0,10,4,4,3,11,0xb2d15034d
141076.1,5.0,0,3,4,4,11,0x3b9b3b61
267.47,1.0,89,1,2,1,4,0xb2d5001ad
1773.24,1.0,0,1,2,4,7,0xb2d22630d
20701.72,1.0,8,2,2,3,7,0xb2d1dfe9
264.19,1.0,25,1,2,2,5,0xb2d5ee2b
517125.21,8.0,4,4,4,4,12,0xb2d1059bd
10015.85,2.0,10,2,3,3,8,0xb2d5d214d
5196.78,1.0,8,2,2,3,7,0xb2d5ec6cd
62257.9,1.0,184,3,2,1,6,0xb2d590c9d
226066.78,11.0,14,3,4,3,10,0xb2d51de5d
60729.13,2.0,27,3,3,2,8,0xb2d4f5d9d
36.08,1.0,29,1,2,2,5,0xb2d39c59d
6950.31,2.0,92,2,3,1,6,0xb2d0ec02d
5.87,1.0,27,1,2,2,5,0xb2d351b9
50707.63,2.0,10,2,3,3,8,0xb2d314edd
14758.39,1.0,92,2,2,1,5,0xb2d428f9d
850.14,1.0,157,1,2,1,4,0xb2d43747d
0.65,1.0,5,1,2,3,6,0xb2d34c31
200083.67,2.0,4,3,3,4,10,0xb2d5ab5d
506007.03,3.0,3,4,4,4,12,0xb2d16b88
40.95,1.0,57,1,2,2,5,0xb2d2ec3dd
2088670.13,5.0,26,4,4,2,10,0xb2d5d097d
3676.93,1.0,0,2,2,4,8,0xb2d36eddd
46045.46,3.0,11,2,4,3,9,0xb2d24367
2130.26,1.0,184,1,2,1,4,0xb2d2b3c1d
100003.72,2.0,29,3,3,2,8,0xb2d86aa1d
397257.7,5.0,67,4,4,1,9,0xb2d1708fd
65078.46,3.0,6,3,4,3,10,0xb2d61ce8d
50815.11,1.0,46,2,2,2,6,0xb2d515d8d
5946.96,1.0,5,2,2,3,7,0xb2d2d3bc
15000.0,1.0,194,2,2,1,5,0xb2d6a3ee
400035.56,3.0,16,4,4,2,10,0xb2d6c5cfd
410000.08,3.0,16,4,4,2,10,0xb2d6bbcdd
9824.6,1.0,92,2,2,1,5,0xb2d24d22d
10380.74,2.0,1,2,3,4,9,0xb2d5129f
229387.38,2.0,92,3,3,1,7,0xb2d222cd
1194.57,1.0,293,1,2,1,4,0xb2d696c1d
57001.51,2.0,32,3,3,2,8,0xb2d1c17e
342415.69,2.0,61,4,3,2,9,0xb2d8fc96
13.49,1.0,67,1,2,1,4,0xb2d685ca
462787.93,4.0,1,4,4,4,12,0xb2d21811d
250006.32,2.0,14,3,3,3,9,0xb2d6593cd
8632.33,1.0,0,2,2,4,8,0xb2d39d73
1282.98,1.0,10,1,2,3,6,0xb2d2a42d
3692.25,1.0,1,2,2,4,8,0xb2d5780ed
201561.9,2.0,47,3,3,2,8,0xb2d52c84d
2913.63,1.0,5,2,2,3,7,0xb2d6c4b1d
320021.7,5.0,0,4,4,4,12,0xb2d13bc8d
760155.03,11.0,13,4,4,3,11,0xb2d6c3dfd
100225.02,2.0,3,3,3,4,10,0xb2d60da2d
224417.83,2.0,129,3,3,1,7,0xb2d49f13
600002.6,3.0,18,4,4,2,10,0xb2d69700
630102.0,4.0,92,4,4,1,9,0xb2d1d194d
345102.86,4.0,55,4,4,2,10,0xb2d0f8ae
225533.2,4.0,52,3,4,2,9,0xb2d182a8d
85006.66,3.0,24,3,4,2,9,0xb2d5cb78d
501776.27,2.0,29,4,3,2,9,0xb2d6abb9d
100000.0,1.0,0,3,2,4,9,0xb2d426c8d
27654.35,1.0,7,2,2,3,7,0xb2d34822d
16042.06,1.0,9,2,2,3,7,0xb2d8d110d
1200075.38,3.0,2,4,4,4,12,0xb2d68ef1d
50094.51,2.0,18,2,3,2,7,0xb2d13259d
509856.66,4.0,8,4,4,3,11,0xb2d42e0ed
106874.1,4.0,26,3,4,2,9,0xb2d5df74d
498004.55,3.0,1,4,4,4,12,0xb2d27d30d
76.3,1.0,3,1,2,4,7,0xb2d29401
1015.91,1.0,92,1,2,1,4,0xb2d0d0d3d
194001.7,3.0,0,3,4,4,11,0xb2d09751d
2564.39,1.0,9,1,2,3,6,0xb2d1ec0ad
4.44,1.0,41,1,2,2,5,0xb2d6d36cd
681678.99,5.0,5,4,4,3,11,0xb2d238bad
2300.38,1.0,184,1,2,1,4,0xb2d27587d
8690.4,1.0,95,2,2,1,5,0xb2d17863
100059.22,2.0,63,3,3,2,8,0xb2d304c4d
3132.56,1.0,0,2,2,4,8,0xb2d2c52d
56002.37,2.0,45,3,3,2,8,0xb2d5dee1
75601.59,3.0,0,3,4,4,11,0x3b9b45cfd
1118.39,1.0,117,1,2,1,4,0xb2d69f44
473.56,1.0,66,1,2,2,5,0xb2d4ce1cd
87363.4,1.0,0,3,2,4,9,0xb2d16d2fd
2151087.45,4.0,10,4,4,3,11,0xb2d5f068d
20039.45,2.0,70,2,3,1,6,0xb2d5f29dd
52364.25,2.0,83,3,3,1,7,0xb2d59f9ed
5159.65,1.0,0,2,2,4,8,0xb2d68ebad
211169.78,4.0,3,3,4,4,11,0xb2d3b8f1
438.74,2.0,21,1,3,2,6,0xb2d6d6e7
385786.32,3.0,0,4,4,4,12,0xb2d0f5a4d
5008.35,1.0,168,2,2,1,5,0xb2d8e048d
2026.76,1.0,92,1,2,1,4,0xb2d46477d
9255.81,1.0,92,2,2,1,5,0xb2d50b3c
6.72,1.0,32,1,2,2,5,0xb2d430d2
679.65,1.0,1,1,2,4,7,0xb2d55d48
241742.16,2.0,15,3,3,3,9,0xb2d4df56d
180850.91,4.0,11,3,4,3,10,0xb2d3cc4c
4637.91,1.0,9,2,2,3,7,0xb2d5875fd
793.86,1.0,0,1,2,4,7,0xb2d12980
20852.92,1.0,184,2,2,1,5,0xb2d1a039d
1712.49,1.0,9,1,2,3,6,0xb2d2f2f3d
1010.09,1.0,92,1,2,1,4,0xb2d1711a
15992.86,1.0,1,2,2,4,8,0xb2d6cd13
1098.69,1.0,92,1,2,1,4,0xb2d22ef1d
13891.87,1.0,13,2,2,3,7,0xb2d5dd5ad
671150.28,7.0,3,4,4,4,12,0xb2d3a49ed
133002.86,5.0,11,3,4,3,10,0xb2d565e7d
80.07,1.0,9,1,2,3,6,0xb2d609bb
111181.44,3.0,31,3,4,2,9,0xb2d63edbd
15788.54,1.0,18,2,2,2,6,0xb2d2eb6dd
60047.64,2.0,0,3,3,4,10,0xb2d61ca3d
53914.86,1.0,125,3,2,1,6,0xb2d3414dd
116043.79,5.0,69,3,4,1,8,0xb2d55a3ed
51.73,1.0,30,1,2,2,5,0xb2d8fe78
20142.07,1.0,92,2,2,1,5,0xb2d6143b
2915297.82,2.0,0,4,3,4,11,0xb2d18494d
26.69,1.0,60,1,2,2,5,0xb2d10cc4d
40109.16,1.0,1,2,2,4,8,0xb2d603d4
50000.85,4.0,59,2,4,2,8,0xb2d6e9f0d
517486.98,4.0,1,4,4,4,12,0xb2d18239d
270018.19,3.0,12,3,4,3,10,0xb2d0e35dd
51077.36,2.0,206,2,3,1,6,0xb2d588e9d
1382.15,1.0,10,1,2,3,6,0xb2d2d172d
536769.95,5.0,0,4,4,4,12,0xb2d15154d
7926.2,1.0,0,2,2,4,8,0xb2d3f32f
110003.48,4.0,98,3,4,1,8,0xb2d6e6b0d
103513.39,2.0,256,3,3,1,7,0xb2d18319d
26076.49,1.0,27,2,2,2,6,0xb2d22b86
1666.74,1.0,69,1,2,1,4,0xb2d5114ed
93.12,1.0,48,1,2,2,5,0xb2d271b1d
644519.97,7.0,48,4,4,2,10,0xb2d4a401d
3877.04,1.0,11,2,2,3,7,0xb2d218c5
62755.61,1.0,0,3,2,4,9,0xb2d62f5d
370000.15,2.0,144,4,3,1,8,0xb2d5d2b9d
290011.91,3.0,95,3,4,1,8,0xb2d287c8
582.79,1.0,13,1,2,3,6,0xb2d2b45ad
1112.13,1.0,184,1,2,1,4,0xb2d2bcf6d
24.95,1.0,2,1,2,4,7,0xb2d2933e
1396.53,1.0,184,1,2,1,4,0xb2d574ccd
1082117.59,6.0,3,4,4,4,12,0xb2d2a616d
205.03,1.0,16,1,2,2,5,0xb2d21fc2
941783.0,6.0,83,4,4,1,9,0xb2d1f996d
200716.86,2.0,55,3,3,2,8,0xb2d642b8
1031080.17,13.0,0,4,4,4,12,0xb2d1b67cd
1700.84,1.0,1,1,2,4,7,0xb2d455a1d
295981.48,1.0,106,3,2,1,6,0xb2d444d0d
851087.85,5.0,11,4,4,3,11,0xb2d14c9cd
643.0,1.0,0,1,2,4,7,0xb2d4cbdcd
232254.45,3.0,18,3,4,2,9,0xb2d138a0
800000.0,16.0,0,4,4,4,12,0xb2d28871d
1000265.27,4.0,10,4,4,3,11,0xb2d224a5d
2234.2,1.0,0,1,2,4,7,0xb2d33e39
61.63,1.0,84,1,2,1,4,0xb2d5f02ad
357465.58,2.0,43,4,3,2,9,0xb2d6a021d
10021.6,1.0,205,2,2,1,5,0xb2d78b14d
30002.32,3.0,80,2,4,1,7,0xb2d8809d
140442.87,3.0,34,3,4,2,9,0xb2d24afad
2876.77,1.0,10,1,2,3,6,0xb2d31d0f
1038831.64,1.0,0,4,2,4,10,0xb2d5eb2bd
60750.7,1.0,196,3,2,1,6,0xb2d3c59fd
102760.4,3.0,0,3,4,4,11,0xb2d2f702d
730021.03,3.0,8,4,4,3,11,0xb2d63a72d
4537.64,1.0,95,2,2,1,5,0xb2d6e47fd
190.49,1.0,46,1,2,2,5,0xb2d60c91
33546.75,1.0,14,2,2,3,7,0xb2d6c035d
510037.61,3.0,4,4,4,4,12,0xb2d62b70d
50605.79,2.0,147,2,3,1,6,0xb2d5ceeed
3542.6,4.0,7,2,4,3,9,0xb2d06a8e
7.11,1.0,4,1,2,4,7,0xb2d5dd1f
520015.82,4.0,25,4,4,2,10,0xb2d629c5d
313389.44,3.0,43,4,4,2,10,0xb2d52262d
9776.52,1.0,0,2,2,4,8,0xb2d2ccf2
745.99,1.0,1,1,2,4,7,0xb2d6b7ce
11103.55,1.0,6,2,2,3,7,0xb2d2500fd
147.88,1.0,64,1,2,2,5,0xb2d7a7ddd
300000.0,3.0,1,3,4,4,11,0xb2d71765d
27882.17,2.0,35,2,3,2,7,0xb2d51832d
91107.95,2.0,60,3,3,2,8,0xb2d2ef66d
100002.65,2.0,92,3,3,1,7,0xb2d67d29d
128046.21,3.0,32,3,4,2,9,0xb2d444d7d
236.27,1.0,9,1,2,3,6,0xb2d63004d
300020.36,2.0,203,3,3,1,7,0xb2d2a074d
19183.99,1.0,0,2,2,4,8,0xb2d3163ad
220873.35,2.0,92,3,3,1,7,0xb2d3bbd0d
5605.31,1.0,14,2,2,3,7,0xb2d6bfb3
788323.47,6.0,108,4,4,1,9,0xb2d59a7dd
550001.58,3.0,18,4,4,2,10,0xb2d8db18d
7547.27,1.0,42,2,2,2,6,0xb2d315fad
700.09,1.0,6,1,2,3,6,0xb2d68554
0.11,1.0,3,1,2,4,7,0xb2d632e0
123.32,1.0,54,1,2,2,5,0xb2d85b4d
80026.52,2.0,147,3,3,1,7,0xb2d41dc8
102393.2,2.0,102,3,3,1,7,0xb2d18034d
4766.31,1.0,9,2,2,3,7,0xb2d6c986d
45000.48,3.0,62,2,4,2,8,0xb2d8f836
943024.29,2.0,0,4,3,4,11,0xb2d5f468d
7.29,1.0,32,1,2,2,5,0xb2d6c2f2
10.4,1.0,89,1,2,1,4,0xb2d563aed
232059.22,4.0,39,3,4,2,9,0xb2d173dbd
219.96,1.0,3,1,2,4,7,0xb2d2ff2a
388572.79,2.0,4,4,3,4,11,0xb2d23d16d
1703.43,1.0,0,1,2,4,7,0xb2d0d7c9d
1.93,1.0,47,1,2,2,5,0xb2d321d4
5.38,1.0,69,1,2,1,4,0xb2d2e6ae
550076.96,6.0,0,4,4,4,12,0xb2d140b1d
4501.9,1.0,0,2,2,4,8,0xb2d6c152
427539.85,4.0,32,4,4,2,10,0xb2d1e724d
0.01,1.0,92,1,2,1,4,0xb2d29ef3d
40000.74,3.0,47,2,4,2,8,0xb2d8c36cd
4438.41,1.0,10,2,2,3,7,0xb2d4582dd
6429.8,1.0,11,2,2,3,7,0xb2d38de8d
401.97,1.0,9,1,2,3,6,0xb2d6d322d
316.89,1.0,12,1,2,3,6,0xb2d40da7
17496.02,1.0,92,2,2,1,5,0xb2d2c3cfd
5567.63,1.0,28,2,2,2,6,0xb2d1f405d
7339.11,2.0,92,2,3,1,6,0x3b9b292dd
259.05,1.0,82,1,2,1,4,0xb2d74d88d
631245.73,5.0,63,4,4,2,10,0xb2d11ff2d
2401.01,1.0,0,1,2,4,7,0xb2d70156
2060401.24,14.0,3,4,4,4,12,0xb2d3563cd
10016.13,1.0,68,2,2,1,5,0xb2d58445
374103.19,11.0,5,4,4,3,11,0x3b9b4758d
420725.19,3.0,21,4,4,2,10,0xb2d56a29d
20024.14,2.0,20,2,3,2,7,0xb2d23963
354068.57,3.0,0,4,4,4,12,0xb2d5b4d5d
3594.35,1.0,0,2,2,4,8,0xb2d42e6cd
674.11,1.0,54,1,2,2,5,0xb2d277ae
2.66,1.0,42,1,2,2,5,0xb2d5cb5dd
241209.73,6.0,0,3,4,4,11,0xb2d346b8d
3237.59,5.0,0,2,4,4,10,0xb2d21137d
1739457.81,4.0,76,4,4,1,9,0xb2d17a22d
27688.11,1.0,0,2,2,4,8,0xb2d5911d
640764.68,5.0,8,4,4,3,11,0xb2d3b357d
2401.01,1.0,0,1,2,4,7,0xb2d700f3d
9176.35,2.0,184,2,3,1,6,0xb2d28a81d
394982.94,6.0,60,4,4,2,10,0xb2d4291ad
7163.21,1.0,30,2,2,2,6,0xb2d38290d
79.46,1.0,40,1,2,2,5,0xb2d39022
49312.11,1.0,22,2,2,2,6,0xb2d17ef7d
260.68,1.0,19,1,2,2,5,0xb2d19b0bd
154267.52,1.0,1,3,2,4,9,0xb2d2e3dfd
5.36,1.0,53,1,2,2,5,0xb2d293f2
310038.86,5.0,11,4,4,3,11,0xb2d6d295d
20772.41,2.0,116,2,3,1,6,0xb2d56e4bd
51459.37,2.0,143,2,3,1,6,0xb2d444a6d
600.0,1.0,0,1,2,4,7,0xb2d312d7d
12033.45,1.0,0,2,2,4,8,0xb2d622eed
19652.0,1.0,0,2,2,4,8,0xb2d6bd4cd
17099.71,1.0,19,2,2,2,6,0xb2d34615d
356627.25,4.0,1,4,4,4,12,0xb2d19c9c
100022.47,2.0,130,3,3,1,7,0xb2d40a3e
6.33,1.0,56,1,2,2,5,0xb2d8fd34
8142.71,1.0,0,2,2,4,8,0xb2d394b4d
18832.62,1.0,0,2,2,4,8,0xb2d21539d
5537.21,1.0,41,2,2,2,6,0xb2d463f3d
0.0,1.0,3,1,2,4,7,0xb2d33d94
11162.17,1.0,184,2,2,1,5,0x3b9b171cd
24386.99,2.0,139,2,3,1,6,0xb2d56c56d
21162.87,1.0,179,2,2,1,5,0xb2d51fc1d
130002.54,5.0,93,3,4,1,8,0x3b9b4811
10954.52,1.0,184,2,2,1,5,0xb2d21c67d
2005265.15,2.0,0,4,3,4,11,0xb2d521f3d
2456.78,1.0,11,1,2,3,6,0xb2d8cc69
360094.88,3.0,165,4,4,1,9,0xb2d5e96fd
1107.59,1.0,2,1,2,4,7,0xb2d68e46
32164.56,1.0,168,2,2,1,5,0xb2d30f88d
694.23,1.0,6,1,2,3,6,0xb2d40174d
147100.01,1.0,4,3,2,4,9,0xb2d1c8b6d
405629.22,5.0,123,4,4,1,9,0x3b9b311cd
7474.1,1.0,92,2,2,1,5,0xb2d1d3f9d
103895.58,2.0,76,3,3,1,7,0xb2d1af18d
376.91,1.0,18,1,2,2,5,0xb2d4706e
2310.32,1.0,1,1,2,4,7,0xb2d553c3d
14454.05,1.0,10,2,2,3,7,0xb2d2ac35d
100004.29,2.0,8,3,3,3,9,0xb2d5d56bd
1555.12,2.0,184,1,3,1,5,0xb2d0f985d
200850.36,3.0,174,3,4,1,8,0xb2d364c0
59.1,1.0,16,1,2,2,5,0xb2d6bb2d
2659.65,1.0,184,1,2,1,4,0xb2d2af9dd
0.65,1.0,19,1,2,2,5,0xb2d78172
4386484.52,5.0,0,4,4,4,12,0xb2d0a1bdd
24816.96,2.0,46,2,3,2,7,0xb2d5ccded
14588.44,1.0,0,2,2,4,8,0xb2d6a7a4d
338783.12,5.0,17,4,4,2,10,0xb2d3be0dd
6.78,2.0,57,1,3,2,6,0xb2d52e97d
337024.93,2.0,94,4,3,1,8,0xb2d58f81d
1.41,1.0,279,1,2,1,4,0xb2d1130ed
0.0,1.0,2,1,2,4,7,0xb2d8f2f0d
5679.8,1.0,6,2,2,3,7,0xb2d61ee9d
203725.49,4.0,122,3,4,1,8,0xb2d56275d
10044.53,1.0,184,2,2,1,5,0xb2d4937bd
1685146.91,17.0,3,4,4,4,12,0xb2d20cb4
49093.01,5.0,0,2,4,4,10,0xb2d6891d
23.92,1.0,58,1,2,2,5,0xb2d6c0ddd
212013.36,3.0,104,3,4,1,8,0xb2d59e4f
5138748.01,6.0,0,4,4,4,12,0x3b9b1259d
305364.69,2.0,26,4,3,2,9,0xb2d45229
1291.94,1.0,184,1,2,1,4,0xb2d13514d
450010.03,4.0,66,4,4,2,10,0xb2d788e6
518282.44,3.0,16,4,4,2,10,0xb2d5c485d
222005.61,4.0,4,3,4,4,11,0xb2d5a85cd
90309.8,5.0,32,3,4,2,9,0xb2d84764d
603934.39,9.0,10,4,4,3,11,0xb2d357e3d
70357.84,2.0,43,3,3,2,8,0xb2d3f461d
50106.03,2.0,13,2,3,3,8,0xb2d59d0ad
4036.93,1.0,92,2,2,1,5,0xb2d2ce42d
1356027.63,9.0,25,4,4,2,10,0xb2d13a1ed
100063.39,2.0,102,3,3,1,7,0xb2d5fcc9d
50001.58,2.0,92,2,3,1,6,0xb2d67cb1d
70029.8,3.0,10,3,4,3,10,0xb2d5ab7d
341006.79,3.0,81,4,4,1,9,0xb2d4365bd
1161823.8,10.0,28,4,4,2,10,0xb2d1ea12d
2533953.46,1.0,3,4,2,4,10,0xb2d1dfb4
421890.05,7.0,1,4,4,4,12,0xb2d3132ad
2212.4,1.0,184,1,2,1,4,0xb2d28b7fd
41422.62,2.0,110,2,3,1,6,0xb2d5e0abd
500081.27,3.0,11,4,4,3,11,0xb2d6cbbfd
2870095.49,5.0,5,4,4,3,11,0xb2d5ee29d
170400.88,2.0,92,3,3,1,7,0xb2d38d95d
13000.41,2.0,92,2,3,1,6,0xb2d65a4ad
2778.09,1.0,1,1,2,4,7,0xb2d3d639d
208361.85,2.0,80,3,3,1,7,0xb2d57479d
422138.06,7.0,7,4,4,3,11,0xb2d16de3d
1944.88,1.0,184,1,2,1,4,0xb2d3a59dd
5.05,1.0,49,1,2,2,5,0xb2d2f0e9d
6.12,1.0,3,1,2,4,7,0xb2d4c211
12.65,1.0,18,1,2,2,5,0xb2d0fe2c
47464.46,1.0,9,2,2,3,7,0xb2d8fca4d
503086.02,2.0,1,4,3,4,11,0xb2d6bcb9d
1942.57,1.0,272,1,2,1,4,0xb2d1fc00d
745.23,3.0,0,1,4,4,9,0x3b9af226d
330971.69,2.0,188,4,3,1,8,0xb2d1f8c2
69.79,1.0,66,1,2,2,5,0xb2d24dbdd
6.39,1.0,6,1,2,3,6,0xb2d6a7ea
30831.32,1.0,0,2,2,4,8,0xb2d244d0
13525.87,1.0,46,2,2,2,6,0xb2d39d93
1512.5,1.0,184,1,2,1,4,0xb2d5f01ed
80002.03,2.0,6,3,3,3,9,0xb2d102e8d
2589.37,1.0,10,1,2,3,6,0xb2d8e8b3
145639.52,6.0,0,3,4,4,11,0xb2d211bdd
280040.62,2.0,0,3,3,4,10,0xb2d40579d
169162.58,4.0,7,3,4,3,10,0xb2d581d7d
213.36,1.0,27,1,2,2,5,0xb2d643c4
150043.82,4.0,47,3,4,2,9,0xb2d6904fd
150000.0,4.0,3,3,4,4,11,0xb2d17242d
60548.63,5.0,3,3,4,4,11,0xb2d13d60
0.49,1.0,2,1,2,4,7,0xb2d68663d
1107971.49,2.0,21,4,3,2,9,0xb2d53486
36458.63,2.0,7,2,3,3,8,0xb2d444f5d
1021327.2,9.0,3,4,4,4,12,0xb2d1a8afd
30118.54,4.0,1,2,4,4,10,0xb2d8e166d
690255.25,4.0,94,4,4,1,9,0xb2d10124d
5979.12,1.0,34,2,2,2,6,0xb2d4115f
40.43,1.0,11,1,2,3,6,0xb2d17261
383751.88,7.0,0,4,4,4,12,0xb2d1812ad
625281.29,18.0,0,4,4,4,12,0xb2d1ae57d
50058.04,3.0,235,2,4,1,7,0x3b9b452ad
2236.71,1.0,10,1,2,3,6,0xb2d8d6e9
3380.21,1.0,53,2,2,2,6,0xb2d380cc
164.31,1.0,5,1,2,3,6,0xb2d8ea8a
790610.77,4.0,0,4,4,4,12,0xb2d15b42
460104.12,6.0,24,4,4,2,10,0xb2d749bf
100131.74,2.0,11,3,3,3,9,0xb2d5e504d
1037714.82,2.0,43,4,3,2,9,0xb2d5025e
818.95,1.0,10,1,2,3,6,0xb2d24040
7184910.05,1.0,0,4,2,4,10,0xb2d6e6b9
200007.94,2.0,20,3,3,2,8,0xb2d68dbfd
464.79,1.0,75,1,2,1,4,0xb2d53a4ad
372722.9,3.0,48,4,4,2,10,0xb2d13d86d
230000.54,3.0,13,3,4,3,10,0xb2d6422c
6464.69,1.0,184,2,2,1,5,0xb2d2a57dd
21.35,1.0,0,1,2,4,7,0xb2d31d57
100056.27,2.0,95,3,3,1,7,0xb2d4e407d
93910.47,2.0,27,3,3,2,8,0xb2d612d9
115107.3,2.0,139,3,3,1,7,0xb2d1abc9
3407045.52,38.0,4,4,4,4,12,0xb2d5ce1bd
3559.64,1.0,0,2,2,4,8,0xb2d8e981
1013.29,1.0,92,1,2,1,4,0xb2d37787d
330051.16,5.0,11,4,4,3,11,0xb2d58b59d
4586.26,1.0,0,2,2,4,8,0xb2d2d641
1492.06,1.0,25,1,2,2,5,0xb2d3c835d
10355.2,7.0,92,2,4,1,7,0xb2d09cf4
104.65,1.0,9,1,2,3,6,0xb2d6a283d
8889.15,1.0,0,2,2,4,8,0xb2d5401cd
6339.41,1.0,92,2,2,1,5,0xb2d3afded
90031.84,2.0,34,3,3,2,8,0xb2d6dd99d
63011.34,2.0,4,3,3,4,10,0xb2d3c5efd
15760.89,1.0,224,2,2,1,5,0xb2d316c1d
2113.32,1.0,25,1,2,2,5,0xb2d25238
1021.56,1.0,16,1,2,2,5,0xb2d30a5dd
557851.15,3.0,15,4,4,3,11,0xb2d177b2d
1.62,1.0,11,1,2,3,6,0xb2d56410
360469.09,2.0,83,4,3,1,8,0xb2d4e923d
30029.23,2.0,95,2,3,1,6,0xb2d1bc08d
659.9,1.0,0,1,2,4,7,0xb2d8ea1dd
1656311.15,5.0,11,4,4,3,11,0xb2d575f0d
614.04,1.0,0,1,2,4,7,0xb2d51a4bd
1008.47,1.0,92,1,2,1,4,0xb2d30e42d
94.97,1.0,0,1,2,4,7,0xb2d651e6
536.56,1.0,15,1,2,3,6,0xb2d6eddd
311894.82,3.0,11,4,4,3,11,0xb2d1a0aad
58819.77,3.0,28,3,4,2,9,0xb2d1a533d
1274.06,1.0,184,1,2,1,4,0xb2d273e2d
186.01,1.0,75,1,2,1,4,0xb2d5edef
410585.72,3.0,1,4,4,4,12,0xb2d2f86a
1043.59,3.0,1,1,4,4,9,0xb2d08d6d
900061.87,2.0,203,4,3,1,8,0xb2d6e1f4d
163271.07,6.0,14,3,4,3,10,0xb2d6016dd
5.53,1.0,18,1,2,2,5,0xb2d1b0d9
155074.64,2.0,25,3,3,2,8,0xb2d86d9ed
10035.37,1.0,92,2,2,1,5,0xb2d5b610d
152897.48,2.0,8,3,3,3,9,0xb2d2d96ed
2.99,4.0,40,1,4,2,7,0xb2d1c918
535688.7,4.0,4,4,4,4,12,0xb2d0881bd
367882.62,3.0,20,4,4,2,10,0xb2d0d988d
4.62,1.0,74,1,2,1,4,0xb2d57ed5d
492262.26,4.0,0,4,4,4,12,0xb2d0ef03d
1689.3,1.0,250,1,2,1,4,0xb2d5b714d
212887.08,2.0,224,3,3,1,7,0xb2d411b5d
327013.46,4.0,22,4,4,2,10,0xb2d31a0ed
500.27,2.0,60,1,3,2,6,0xb2d8fbc1
471017.04,7.0,53,4,4,2,10,0xb2d1b9b8d
2.1,1.0,0,1,2,4,7,0xb2d34b10
945487.14,3.0,0,4,4,4,12,0xb2d1baa8d
25218.1,2.0,80,2,3,1,6,0xb2d5f134d
455.66,1.0,81,1,2,1,4,0xb2d62998d
234094.12,2.0,19,3,3,2,8,0xb2d6b866d
480014.55,9.0,4,4,4,4,12,0xb2d5796dd
4674426.72,1.0,8,4,2,3,9,0xb2d5dc1d
76675.01,4.0,6,3,4,3,10,0xb2d56833
5744.09,1.0,3,2,2,4,8,0xb2d4830e
182461.78,3.0,27,3,4,2,9,0xb2d09836d
30796.08,2.0,62,2,3,2,7,0xb2d5ce60d
131499.37,4.0,20,3,4,2,9,0xb2d6a501d
344045.26,4.0,136,4,4,1,9,0xb2d105b2
5154.46,1.0,10,2,2,3,7,0xb2d51682
1488.29,1.0,0,1,2,4,7,0xb2d38a86d
903259.51,3.0,58,4,4,2,10,0xb2d5ac10d
8159.99,1.0,19,2,2,2,6,0xb2d857ef
1211024.43,7.0,28,4,4,2,10,0xb2d52909d
966518.96,2.0,38,4,3,2,9,0xb2d45bbfd
173153.9,3.0,0,3,4,4,11,0xb2d06ad5d
30312.6,4.0,29,2,4,2,8,0xb2d1408f
786.83,1.0,9,1,2,3,6,0xb2d8ef25d
45.5,1.0,57,1,2,2,5,0xb2d7fdfb
2156019.94,9.0,0,4,4,4,12,0xb2d5d87ad
300040.82,2.0,0,3,3,4,10,0xb2d6b986d
16873.69,1.0,17,2,2,2,6,0xb2d4f525
21139.78,2.0,0,2,3,4,9,0xb2d5a317
2531.73,1.0,92,1,2,1,4,0xb2d28df5
20000.21,2.0,97,2,3,1,6,0xb2d857a7d
1196.96,1.0,92,1,2,1,4,0xb2d082c7
53045.0,2.0,92,3,3,1,7,0xb2d267b2d
33021.42,1.0,0,2,2,4,8,0xb2d2392fd
229011.49,4.0,20,3,4,2,9,0xb2d8fdd9d
15862.19,1.0,0,2,2,4,8,0xb2d6b4d1d
889032.2,4.0,11,4,4,3,11,0xb2d54857d
505021.36,2.0,195,4,3,1,8,0xb2d69c41d
18.04,1.0,13,1,2,3,6,0xb2d69da6
1.51,4.0,31,1,4,2,7,0xb2d22dc5
19495.36,20.0,0,2,4,4,10,0x3b9b3b03d
2990.61,1.0,92,2,2,1,5,0xb2d143b4d
1880.12,1.0,92,1,2,1,4,0xb2d3c1ebd
352126.21,4.0,216,4,4,1,9,0xb2d0a7efd
19972.74,1.0,18,2,2,2,6,0xb2d5d5b4d
100761.03,4.0,208,3,4,1,8,0xb2d67ff6d
2.98,1.0,5,1,2,3,6,0xb2d6fe7ed
594162.9,13.0,5,4,4,3,11,0x3b9b2f0cd
250003.48,3.0,7,3,4,3,10,0xb2d64d9ed
1328208.16,3.0,86,4,4,1,9,0xb2d2cbc1d
633.85,1.0,0,1,2,4,7,0xb2d4275d
1616.91,1.0,0,1,2,4,7,0xb2d3ba26d
616081.13,1.0,2,4,2,4,10,0xb2d6313ad
23.09,1.0,55,1,2,2,5,0xb2d40d65
7.13,1.0,88,1,2,1,4,0xb2d537a7
1034.41,1.0,26,1,2,2,5,0xb2d1ff2ad
589895.62,3.0,83,4,4,1,9,0xb2d0ee15d
158598.43,3.0,116,3,4,1,8,0xb2d2781ad
524.95,1.0,8,1,2,3,6,0xb2d4a933d
1.38,1.0,19,1,2,2,5,0xb2d330bbd
181.92,1.0,31,1,2,2,5,0xb2d649dfd
506021.06,3.0,95,4,4,1,9,0xb2d16b88d
4049.81,1.0,108,2,2,1,5,0xb2d23987d
934789.46,9.0,0,4,4,4,12,0xb2d563b1d
20274.5,1.0,259,2,2,1,5,0xb2d1ca9bd
0.78,1.0,1,1,2,4,7,0xb2d1a753
1787.3,1.0,0,1,2,4,7,0xb2d488cb
1488727.68,2.0,6,4,3,3,10,0xb2d19bd4
937.9,1.0,0,1,2,4,7,0xb2d2fb75d
90154.01,1.0,7,3,2,3,8,0xb2d6eed3
25962.09,1.0,13,2,2,3,7,0xb2d2fc6cd
2842809.33,12.0,20,4,4,2,10,0xb2d20fded
119.85,1.0,9,1,2,3,6,0xb2d2c026d
70002.04,3.0,76,3,4,1,8,0xb2d12c32d
1608.63,1.0,184,1,2,1,4,0xb2d25522d
20199.13,1.0,92,2,2,1,5,0xb2d29576d
18002.73,2.0,49,2,3,2,7,0xb2d5efeed
76821.19,7.0,0,3,4,4,11,0x3b9b3b6fd
1276290.42,1.0,7,4,2,3,9,0xb2d4e002d
7591.5,1.0,13,2,2,3,7,0xb2d63f4fd
2466.43,1.0,0,1,2,4,7,0xb2d5b408
900308.72,4.0,8,4,4,3,11,0xb2d6ff70d
14698.16,1.0,10,2,2,3,7,0xb2d4b3b5
52918.68,1.0,0,3,2,4,9,0xb2d3c3c1
8976.45,1.0,4,2,2,4,8,0xb2d6805f
824185.83,5.0,19,4,4,2,10,0xb2d62245d
119071.03,3.0,62,3,4,2,9,0xb2d1cabf
316721.38,4.0,32,4,4,2,10,0xb2d1832fd
356638.61,3.0,21,4,4,2,10,0xb2d62c5d
51182.46,2.0,53,2,3,2,7,0xb2d6c14fd
1512660.14,4.0,89,4,4,1,9,0xb2d7aa59
1521995.61,2.0,0,4,3,4,11,0xb2d103f0d
152634.39,5.0,6,3,4,3,10,0x3b9b18ce
700915.17,2.0,1,4,3,4,11,0xb2d8e730d
91495.77,1.0,32,3,2,2,7,0xb2d29b3dd
104893.33,1.0,11,3,2,3,8,0xb2d62be8d
65607.44,2.0,81,3,3,1,7,0xb2d438b2d
180054.87,2.0,14,3,3,3,9,0xb2d3a8b3d
2038.21,1.0,0,1,2,4,7,0xb2d1d377
465.44,1.0,0,1,2,4,7,0xb2d34abf
130282.38,2.0,1,3,3,4,10,0xb2d43a6ed
490343.28,85.0,0,4,4,4,12,0xb2d4a6bcd
264.38,1.0,10,1,2,3,6,0xb2d55f48d
125554.37,1.0,63,3,2,2,7,0xb2d2ce13d
190391.35,3.0,66,3,4,2,9,0xb2d3a559
578016.16,8.0,1,4,4,4,12,0xb2d5bb1ad
762699.75,4.0,34,4,4,2,10,0xb2d5bdf9d
149.97,1.0,4,1,2,4,7,0xb2d3ab4c
101236.23,2.0,6,3,3,3,9,0xb2d652f3d
328170.65,7.0,0,4,4,4,12,0xb2d5b6f7
300102.34,2.0,41,4,3,2,9,0xb2d121c7
40.27,1.0,67,1,2,1,4,0xb2d6d460d
80046.63,2.0,228,3,3,1,7,0xb2d61b25d
330214.33,2.0,229,4,3,1,8,0xb2d2455ad
201991.93,2.0,28,3,3,2,8,0xb2d6da9fd
10001.03,3.0,15,2,4,3,9,0xb2d0a205d
101199.93,1.0,0,3,2,4,9,0xb2d4204f
370052.15,6.0,106,4,4,1,9,0x3b9b4169
50000.63,2.0,45,2,3,2,7,0xb2d4c0e4
6066.26,1.0,184,2,2,1,5,0xb2d1303dd
100034.63,2.0,19,3,3,2,8,0xb2d107d4d
179292.29,4.0,3,3,4,4,11,0xb2d4a5a6d
30479.78,3.0,70,2,4,1,7,0xb2d61e0a
126005.9,4.0,3,3,4,4,11,0xb2d59e22d
482954.66,6.0,7,4,4,3,11,0xb2d6231ad
63252.07,2.0,0,3,3,4,10,0x3b9b184ed
51041.34,2.0,174,2,3,1,6,0xb2d5dbcbd
240003.66,4.0,1,3,4,4,11,0xb2d52b0ad
1271.34,1.0,135,1,2,1,4,0xb2d3e4e6
100039.09,7.0,83,3,4,1,8,0xb2d5419fd
80050.21,2.0,0,3,3,4,10,0xb2d62e27d
200173.08,2.0,157,3,3,1,7,0xb2d30c0bd
15001.9,1.0,22,2,2,2,6,0xb2d229eb
4626.7,1.0,2,2,2,4,8,0xb2d23479d
11971.13,2.0,0,2,3,4,9,0xb2d51ee3
120005.07,2.0,21,3,3,2,8,0xb2d635b4
136441.55,9.0,1,3,4,4,11,0xb2d06727d
7.74,1.0,3,1,2,4,7,0xb2d23692
16178.48,2.0,11,2,3,3,8,0xb2d06a6ad
500095.69,2.0,10,4,3,3,10,0xb2d0b435d
5047.7,2.0,184,2,3,1,6,0x3b9b2729d
106001.41,5.0,38,3,4,2,9,0xb2d3bd83d
32296.65,1.0,92,2,2,1,5,0xb2d0df25d
10034.61,2.0,90,2,3,1,6,0xb2d657fe
828428.17,3.0,17,4,4,2,10,0xb2d5570cd
1287.3,3.0,9,1,4,3,8,0xb2d30f28
821636.0,4.0,18,4,4,2,10,0xb2d6fc64d
490203.75,2.0,8,4,3,3,10,0xb2d8e9c6d
2931095.4,7.0,5,4,4,3,11,0xb2d16966d
50.29,1.0,11,1,2,3,6,0xb2d345a0
646000.0,4.0,24,4,4,2,10,0xb2d24431
238711.58,1.0,10,3,2,3,8,0xb2d32b79d
13.72,1.0,62,1,2,2,5,0xb2d8ec76
20150.86,2.0,60,2,3,2,7,0xb2d6143bd
1979.21,1.0,24,1,2,2,5,0xb2d1d3e4
295.59,1.0,42,1,2,2,5,0xb2d20ee7d
564134.91,4.0,19,4,4,2,10,0xb2d60058d
250096.47,2.0,13,3,3,3,9,0xb2d69e8ad
1319991.15,1.0,1,4,2,4,10,0xb2d25102
111751.48,1.0,7,3,2,3,8,0xb2d55ac2d
0.0,1.0,5,1,2,3,6,0xb2d53d61
1243.71,1.0,0,1,2,4,7,0xb2d42433
300120.44,8.0,18,4,4,2,10,0x3b9b3a97d
1160.29,3.0,0,1,4,4,9,0x3b9b30cbd
120005.07,2.0,94,3,3,1,7,0xb2d85777d
12153.5,2.0,184,2,3,1,6,0xb2d2c426d
530034.12,2.0,0,4,3,4,11,0xb2d55f4b
5730.26,1.0,6,2,2,3,7,0xb2d2c800d
403553.66,3.0,11,4,4,3,11,0xb2d6fb53d
130.15,1.0,47,1,2,2,5,0xb2d8f6ef
120076.45,2.0,62,3,3,2,8,0xb2d0ee6a
460106.16,3.0,40,4,4,2,10,0xb2d0df03d
6.47,1.0,33,1,2,2,5,0xb2d4c0b4d
1140604.26,6.0,5,4,4,3,11,0xb2d27a4bd
2861.76,13.0,37,1,4,2,7,0xb2d06893d
185497.57,1.0,1,3,2,4,9,0xb2d89033d
190058.39,5.0,8,3,4,3,10,0xb2d4ce5bd
1120140.52,3.0,97,4,4,1,9,0xb2d440e1
404837.84,3.0,0,4,4,4,12,0xb2d642b8d
252759.64,4.0,164,3,4,1,8,0xb2d5f204d
1383150.18,9.0,8,4,4,3,11,0xb2d07157
191386.3,7.0,1,3,4,4,11,0x3b9b31a3
30284.73,2.0,175,2,3,1,6,0xb2d24590
6411.97,1.0,9,2,2,3,7,0xb2d8b14a
4586339.27,6.0,0,4,4,4,12,0xb2d1b72ed
27627.49,3.0,9,2,4,3,9,0x3b9b1a40
2647.73,1.0,0,1,2,4,7,0xb2d69b8d
2568774.12,4.0,0,4,4,4,12,0xb2d089a7d
451003.35,8.0,11,4,4,3,11,0xb2d0a98ed
227421.95,3.0,102,3,4,1,8,0xb2d112c9d
6248.7,1.0,12,2,2,3,7,0xb2d1dc72d
600001.3,3.0,29,4,4,2,10,0xb2d6b3d2d
167709.61,2.0,143,3,3,1,7,0xb2d4be54
44.5,1.0,31,1,2,2,5,0xb2d6ba43
75091.46,3.0,80,3,4,1,8,0xb2d8c86dd
558044.53,7.0,0,4,4,4,12,0xb2d49154d
73014.36,3.0,139,3,4,1,8,0xb2d37883d
635000.17,4.0,1,4,4,4,12,0xb2d69bb4
1455.58,1.0,92,1,2,1,4,0x3b9b2da5d
281255.04,8.0,0,3,4,4,11,0xb2d7fc07d
129547.12,1.0,82,3,2,1,6,0xb2d3e2cad
0.0,1.0,5,1,2,3,6,0xb2d5856dd
18691.15,1.0,20,2,2,2,6,0xb2d3769dd
223189.86,2.0,25,3,3,2,8,0xb2d1874fd
393031.51,3.0,121,4,4,1,9,0xb2d1116bd
55972.96,9.0,0,3,4,4,11,0xb2d1b436
150.78,1.0,1,1,2,4,7,0xb2d5a1a6
356671.0,3.0,83,4,4,1,9,0xb2d5250bd
607267.48,5.0,36,4,4,2,10,0xb2d4fe4cd
525004.46,3.0,4,4,4,4,12,0xb2d716ec
474.64,1.0,101,1,2,1,4,0xb2d5e6fa
100004.27,2.0,185,3,3,1,7,0xb2d5e6f4
29403941.46,9.0,0,4,4,4,12,0x3b9b355d
203015.64,2.0,141,3,3,1,7,0xb2d6c2efd
54462.99,5.0,52,3,4,2,9,0xb2d1ce2fd
52243.71,1.0,8,3,2,3,8,0xb2d2b5e5
100056.84,1.0,0,3,2,4,9,0xb2d10231d
7.14,1.0,24,1,2,2,5,0xb2d632e0d
30411.16,1.0,77,2,2,1,5,0xb2d1271cd
21.3,1.0,65,1,2,2,5,0xb2d68630
132986.85,2.0,104,3,3,1,7,0xb2d1c4e9d
3000.0,1.0,0,2,2,4,8,0xb2d31486d
234.75,1.0,56,1,2,2,5,0xb2d8fcad
4034.67,1.0,3,2,2,4,8,0xb2d5d124d
140070.68,3.0,40,3,4,2,9,0xb2d6dfa2d
5471.41,1.0,14,2,2,3,7,0xb2d5b78cd
681066.38,3.0,25,4,4,2,10,0xb2d8fa89d
1395.43,1.0,39,1,2,2,5,0xb2d625a0d
8245.06,1.0,184,2,2,1,5,0xb2d21d6ad
13581.88,1.0,2,2,2,4,8,0xb2d135dd
220200.84,3.0,14,3,4,3,10,0xb2d80539
204265.69,2.0,126,3,3,1,7,0xb2d879f8d
1660000.19,11.0,5,4,4,3,11,0xb2d249e5d
38.05,1.0,10,1,2,3,6,0xb2d30b75
706077.02,2.0,14,4,3,3,10,0xb2d3c437d
1600012.01,1.0,0,4,2,4,10,0xb2d5ab9b
974288.18,3.0,48,4,4,2,10,0xb2d0c518d
997248.29,18.0,0,4,4,4,12,0x3b9af247d
3741.27,1.0,129,2,2,1,5,0xb2d55a08d
373.32,1.0,29,1,2,2,5,0xb2d35897
50594.96,2.0,3,2,3,4,9,0xb2d3666b
4608.78,1.0,10,2,2,3,7,0xb2d479b9
2463.96,1.0,10,1,2,3,6,0xb2d8ce1fd
1727002.08,6.0,1,4,4,4,12,0xb2d57d1cd
656015.06,6.0,0,4,4,4,12,0xb2d23b28d
25.74,1.0,75,1,2,1,4,0xb2d1b350d
702081.24,2.0,7,4,3,3,10,0xb2d1e634d
1849784.39,3.0,87,4,4,1,9,0xb2d45358d
41305.85,1.0,19,2,2,2,6,0xb2d5c7fdd
53257.94,2.0,97,3,3,1,7,0xb2d4256fd
10.03,1.0,14,1,2,3,6,0xb2d5d1f4d
779594.85,6.0,1,4,4,4,12,0xb2d14506d
20324.91,1.0,12,2,2,3,7,0xb2d40efad
304843.2,5.0,10,4,4,3,11,0xb2d50f6e
160275.68,19.0,0,3,4,4,11,0xb2d12b11d
6448.09,1.0,12,2,2,3,7,0xb2d55db1d
3575.25,1.0,9,2,2,3,7,0xb2d5b9f0d
409008.56,4.0,70,4,4,1,9,0xb2d5d14ed
2067.07,1.0,184,1,2,1,4,0x3b9b3713d
71367.38,2.0,23,3,3,2,8,0xb2d5afcbd
0.43,1.0,1,1,2,4,7,0xb2d2f4d0d
61241.01,4.0,102,3,4,1,8,0xb2d63337d
10356.4,2.0,67,2,3,1,6,0xb2d644ded
6490971.88,8.0,1,4,4,4,12,0xb2d3843ed
420368.79,3.0,9,4,4,3,11,0xb2d52c4b
5172.88,1.0,2,2,2,4,8,0xb2d8f1ce
51997.6,1.0,5,2,2,3,7,0xb2d3285a
513522.44,4.0,83,4,4,1,9,0xb2d4e967d
3.78,1.0,2,1,2,4,7,0xb2d6b494
6124.71,5.0,92,2,4,1,7,0x3b9adb01
1645.46,2.0,184,1,3,1,5,0xb2d392cfd
400047.44,2.0,125,4,3,1,8,0xb2d2a556
1025234.23,5.0,0,4,4,4,12,0xb2d5853b
3447.44,1.0,20,2,2,2,6,0xb2d8dec0
14493.55,1.0,10,2,2,3,7,0xb2d3266fd
780038.69,3.0,5,4,4,3,11,0xb2d5ff92d
17842.39,1.0,1,2,2,4,8,0xb2d1ac8c
80301.29,2.0,0,3,3,4,10,0xb2d7becfd
108823.94,6.0,0,3,4,4,11,0x3b9b3b61d
2854.14,1.0,184,1,2,1,4,0xb2d1a324d
8415.46,1.0,0,2,2,4,8,0xb2d21ffb
977.72,1.0,1,1,2,4,7,0xb2d3f395
4873.48,1.0,9,2,2,3,7,0xb2d3c079d
2381718.95,4.0,26,4,4,2,10,0xb2d110b1d
50004.23,2.0,104,2,3,1,6,0xb2d79009d
50309.02,1.0,0,2,2,4,8,0xb2d8cc42d
1071065.17,2.0,21,4,3,2,9,0xb2d54de7d
112332.37,2.0,8,3,3,3,9,0xb2d2c6d7
355576.88,4.0,81,4,4,1,9,0xb2d19c9cd
27197.83,2.0,0,2,3,4,9,0xb2d623fed
194335.7,3.0,28,3,4,2,9,0xb2d13de6d
45020.54,2.0,95,2,3,1,6,0xb2d62191
21819.08,1.0,0,2,2,4,8,0xb2d2b5cdd
1220309.96,6.0,0,4,4,4,12,0xb2d1df2dd
300126.64,2.0,1,4,3,4,11,0xb2d64d14
3883689.14,4.0,3,4,4,4,12,0xb2d3b786d
110185.85,2.0,0,3,3,4,10,0xb2d210a6d
402414.34,2.0,3,4,3,4,11,0xb2d2d3b2
470073.11,2.0,143,4,3,1,8,0xb2d58f37d
0.0,2.0,3,1,3,4,8,0x3b9b38c9
300056.28,2.0,7,3,3,3,9,0xb2d8f0edd
200002.52,2.0,18,3,3,2,8,0xb2d792b2d
48008.42,2.0,118,2,3,1,6,0xb2d6dde0d
2738.29,1.0,11,1,2,3,6,0xb2d2fd88d
253151.26,1.0,3,3,2,4,9,0xb2d143dd
530014.25,7.0,31,4,4,2,10,0xb2d20980d
1349.09,1.0,158,1,2,1,4,0xb2d3ef8dd
1159193.78,7.0,0,4,4,4,12,0xb2d07939d
26372.02,3.0,0,2,4,4,10,0xb2d6891dd
411187.52,3.0,0,4,4,4,12,0xb2d445dbd
2.45,1.0,19,1,2,2,5,0xb2d6d60c
27005.73,1.0,20,2,2,2,6,0xb2d6ab20d
25180.31,4.0,26,2,4,2,8,0xb2d6a3eed
262.21,1.0,7,1,2,3,6,0xb2d6c5edd
240088.98,5.0,8,3,4,3,10,0xb2d57101d
290106.92,4.0,100,3,4,1,8,0xb2d6340ad
10022.49,1.0,92,2,2,1,5,0xb2d67d51d
1111467.54,4.0,18,4,4,2,10,0xb2d28342
111032.19,6.0,18,3,4,2,9,0xb2d41c77d
103253.11,1.0,1,3,2,4,9,0xb2d6ac75d
50000.0,2.0,1,2,3,4,9,0xb2d78af6d
419061.43,2.0,27,4,3,2,9,0xb2d12755
101615.14,2.0,10,3,3,3,9,0xb2d39632d
106.43,1.0,3,1,2,4,7,0xb2d4dce6d
175.94,1.0,0,1,2,4,7,0xb2d56ac5d
9027.59,1.0,3,2,2,4,8,0xb2d2c824
332705.64,5.0,9,4,4,3,11,0xb2d59963d
6.85,1.0,64,1,2,2,5,0xb2d3af43d
346657.83,3.0,49,4,4,2,10,0xb2d0f8aed
659171.43,7.0,5,4,4,3,11,0xb2d0c680
117.81,1.0,6,1,2,3,6,0xb2d22f1e
2359.95,1.0,48,1,2,2,5,0xb2d8e018
1110203.33,9.0,28,4,4,2,10,0xb2d13e34d
500006.34,2.0,181,4,3,1,8,0xb2d550f1
19.55,1.0,13,1,2,3,6,0xb2d2af56
265368.83,2.0,28,3,3,2,8,0xb2d522acd
133405.61,3.0,4,3,4,4,11,0xb2d426d1d
712131.55,11.0,1,4,4,4,12,0xb2d5fdcbd
0.0,1.0,3,1,2,4,7,0xb2d2eacbd
15.7,1.0,46,1,2,2,5,0xb2d5d5e9d
266596.9,9.0,8,3,4,3,10,0xb2d5c546d
46254.63,1.0,198,2,2,1,5,0xb2d19bddd
200039.53,2.0,16,3,3,2,8,0xb2d1a8b1d
10488.05,1.0,0,2,2,4,8,0xb2d3e870
208653.14,6.0,5,3,4,3,10,0x3b9af1c3d
753619.25,5.0,60,4,4,2,10,0xb2d1cf67d
10329.23,1.0,5,2,2,3,7,0xb2d5bc25
747315.67,1.0,0,4,2,4,10,0xb2d3a6dcd
6.94,1.0,92,1,2,1,4,0xb2d2a5f8d
829055.11,5.0,41,4,4,2,10,0xb2d63637d
16943.36,1.0,25,2,2,2,6,0xb2d6c2b3d
716.96,1.0,9,1,2,3,6,0xb2d6a9f9
3611.97,1.0,9,2,2,3,7,0xb2d4db3c
160086.07,3.0,18,3,4,2,9,0xb2d2d944d
461.97,1.0,22,1,2,2,5,0xb2d2d467
625059.1,13.0,3,4,4,4,12,0xb2d1a357
1050094.59,2.0,111,4,3,1,8,0xb2d4fb49
421655.1,3.0,129,4,4,1,9,0xb2d2b57ad
1051.33,1.0,18,1,2,2,5,0xb2d3138b
3062.65,1.0,0,2,2,4,8,0xb2d8c3c6
7.61,1.0,5,1,2,3,6,0xb2d0af30d
504050.82,2.0,37,4,3,2,9,0xb2d8f1a9d
2857.85,1.0,107,1,2,1,4,0xb2d3a0a2
5556.6,1.0,92,2,2,1,5,0xb2d3fb4ad
64929.47,1.0,12,3,2,3,8,0xb2d63166d
1650.7,1.0,0,1,2,4,7,0xb2d425ccd
1444.4,1.0,14,1,2,3,6,0xb2d12ee3
102227.64,1.0,2,3,2,4,9,0xb2d3516bd
178026.6,3.0,41,3,4,2,9,0xb2d64acfd
50579.82,1.0,92,2,2,1,5,0xb2d19b02d
2538.71,2.0,92,1,3,1,5,0xb2d09ac4d
1011.06,1.0,184,1,2,1,4,0xb2d1711ad
3806.36,1.0,10,2,2,3,7,0xb2d349d8d
1007.33,1.0,184,1,2,1,4,0xb2d6217fd
704113.79,6.0,32,4,4,2,10,0xb2d3f78dd
9940.05,1.0,1,2,2,4,8,0xb2d1b422
50616.79,2.0,40,2,3,2,7,0xb2d6e08dd
206406.68,3.0,13,3,4,3,10,0xb2d61c01d
110002.32,2.0,164,3,3,1,7,0xb2d6cb3cd
20006.88,2.0,136,2,3,1,6,0xb2d5481dd
2022.92,1.0,135,1,2,1,4,0xb2d54b1e
1783.05,1.0,91,1,2,1,4,0xb2d23fa2d
226892.53,3.0,73,3,4,1,8,0xb2d61952d
8441.83,1.0,184,2,2,1,5,0xb2d32528d
22125.62,1.0,0,2,2,4,8,0xb2d0f39e
200910.45,1.0,92,3,2,1,6,0xb2d5003bd
100781.22,3.0,125,3,4,1,8,0xb2d17e06d
52242.36,1.0,25,3,2,2,7,0xb2d66961
52474.59,2.0,27,3,3,2,8,0xb2d1f58bd
6649.16,1.0,1,2,2,4,8,0xb2d307c4d
1336.49,2.0,92,1,3,1,5,0x3b9b0f62d
180003.58,2.0,3,3,3,4,10,0xb2d53ccbd
7297.08,1.0,184,2,2,1,5,0xb2d10ea9d
6194.07,1.0,92,2,2,1,5,0xb2d415fd
300002.83,2.0,5,3,3,3,9,0xb2d5cdf4d
241498.89,7.0,70,3,4,1,8,0xb2d66062d
97.55,1.0,1,1,2,4,7,0xb2d5f98d
1594.21,1.0,15,1,2,3,6,0xb2d8700d
2098039.82,2.0,70,4,3,1,8,0xb2d4f5d3d
30987.12,1.0,76,2,2,1,5,0xb2d60f16
5516.04,1.0,291,2,2,1,5,0xb2d2691ed
556038.3,5.0,0,4,4,4,12,0xb2d5bf28d
56.18,1.0,1,1,2,4,7,0xb2d29bcdd
10628.27,1.0,21,2,2,2,6,0xb2d52e08d
297419.89,4.0,2,3,4,4,11,0xb2d31d53
10000.21,2.0,92,2,3,1,6,0xb2d644e3
2.17,1.0,76,1,2,1,4,0xb2d12809
262726.92,2.0,1,3,3,4,10,0xb2d2d250
6216.7,1.0,92,2,2,1,5,0xb2d28e32d
711793.46,6.0,0,4,4,4,12,0xb2d56a4a
25199.38,1.0,38,2,2,2,6,0xb2d282e6d
138.39,1.0,14,1,2,3,6,0xb2d2f147d
15114.14,1.0,10,2,2,3,7,0xb2d41b9cd
6219.31,1.0,92,2,2,1,5,0xb2d2d454
2680054.96,6.0,63,4,4,2,10,0xb2d5ff2dd
301011.27,3.0,87,4,4,1,9,0x3b9b3c5cd
40008.58,3.0,63,2,4,2,8,0xb2d69a0cd
7824.22,1.0,2,2,2,4,8,0xb2d6b7ced
4722.13,1.0,5,2,2,3,7,0xb2d8f741
7624.48,1.0,5,2,2,3,7,0xb2d53264d
120165.15,2.0,104,3,3,1,7,0xb2d0e1c1d
2957.68,1.0,92,2,2,1,5,0x3b9af62ed
99799.1,6.0,14,3,4,3,10,0xb2d56833d
36.64,1.0,4,1,2,4,7,0xb2d4bd6cd
0.0,1.0,7,1,2,3,6,0xb2d563a7d
505595.03,5.0,0,4,4,4,12,0xb2d12242
100028.64,2.0,34,3,3,2,8,0xb2d5f28d
8001.74,1.0,13,2,2,3,7,0xb2d8fc78d
195173.02,4.0,52,3,4,2,9,0xb2d2a02cd
344045.3,4.0,228,4,4,1,9,0xb2d105b2d
0.79,1.0,27,1,2,2,5,0xb2d5b7e0d
7924.89,1.0,41,2,2,2,6,0xb2d31e91d
2.59,1.0,33,1,2,2,5,0xb2d0c947
19676.76,1.0,263,2,2,1,5,0xb2d2e41bd
1002.77,1.0,92,1,2,1,4,0xb2d5abefd
20003.8,2.0,11,2,3,3,8,0xb2d5f43d
150015.66,4.0,137,3,4,1,8,0xb2d15c82d
12574.77,4.0,1,2,4,4,10,0xb2d37702
690832.94,11.0,13,4,4,3,11,0x3b9b32bdd
1063.97,1.0,0,1,2,4,7,0xb2d7c030
96007.78,4.0,13,3,4,3,10,0xb2d0ab76d
615000.89,17.0,4,4,4,4,12,0xb2d5fb70d
400000.0,2.0,5,4,3,3,10,0xb2d68b0ad
1210401.52,3.0,39,4,4,2,10,0xb2d1c067d
75607.21,2.0,3,3,3,4,10,0x3b9af15ad
8389.54,1.0,0,2,2,4,8,0xb2d68ae5d
420076.05,7.0,3,4,4,4,12,0xb2d1b3d6d
270064.91,5.0,4,3,4,4,11,0xb2d63e96d
339556.2,3.0,82,4,4,1,9,0xb2d7825fd
118187.71,2.0,13,3,3,3,9,0xb2d12200d
2262.61,1.0,85,1,2,1,4,0xb2d4c9a2d
32012.39,2.0,5,2,3,3,8,0xb2d692c6d
5891.62,1.0,41,2,2,2,6,0xb2d45740d
10162.63,2.0,14,2,3,3,8,0xb2d63695d
600000.0,4.0,0,4,4,4,12,0xb2d6a96ad
2536.19,1.0,12,1,2,3,6,0xb2d1780c
1.07,1.0,60,1,2,2,5,0xb2d8f497d
347.3,1.0,92,1,2,1,4,0xb2d249f2d
112002.68,14.0,6,3,4,3,10,0xb2d646e4
48313.7,1.0,0,2,2,4,8,0xb2d5606b
443207.83,2.0,49,4,3,2,9,0xb2d6cfdc
18021.88,1.0,2,2,2,4,8,0xb2d7ed4fd
520090.52,4.0,6,4,4,3,11,0xb2d627a9
807011.58,12.0,0,4,4,4,12,0xb2d1bfced
401547.66,2.0,20,4,3,2,9,0xb2d68764d
465023.1,6.0,1,4,4,4,12,0xb2d1779bd
13253.8,1.0,3,2,2,4,8,0xb2d415ab
3542.69,1.0,92,2,2,1,5,0xb2d1e025d
1.52,1.0,18,1,2,2,5,0xb2d56939
201045.52,3.0,52,3,4,2,9,0xb2d1284a
319397.33,13.0,1,4,4,4,12,0xb2d4f4ddd
25.79,1.0,68,1,2,1,4,0xb2d0bef3
80698.49,2.0,92,3,3,1,7,0xb2d2706bd
180026.64,2.0,143,3,3,1,7,0xb2d6d48a
4266.31,1.0,0,2,2,4,8,0xb2d68732
3682.66,1.0,0,2,2,4,8,0xb2d5aec8d
222105.52,2.0,24,3,3,2,8,0xb2d335a5d
60.51,1.0,9,1,2,3,6,0xb2d69215d
90047.16,4.0,26,3,4,2,9,0xb2d61dffd
360299.88,7.0,18,4,4,2,10,0xb2d0b645d
31155.98,2.0,87,2,3,1,6,0xb2d5969cd
9973.03,1.0,184,2,2,1,5,0xb2d1ef6bd
62009.59,5.0,45,3,4,2,9,0xb2d45482
12950.73,1.0,0,2,2,4,8,0xb2d0f359d
145006.95,3.0,1,3,4,4,11,0xb2d68740
5403.13,3.0,8,2,4,3,9,0xb2d40fabd
440008.82,4.0,4,4,4,4,12,0xb2d4f186d
4005.75,1.0,184,2,2,1,5,0x3b9b0e54d
622378.32,2.0,38,4,3,2,9,0xb2d51b0ed
140203.54,4.0,0,3,4,4,11,0xb2d18ae1d
667182.32,1.0,3,4,2,4,10,0xb2d35e75d
2149.38,1.0,0,1,2,4,7,0xb2d858c8d
550905.43,2.0,0,4,3,4,11,0xb2d41734
407929.41,3.0,30,4,4,2,10,0xb2d6aa15
16526.96,1.0,184,2,2,1,5,0xb2d282eed
406010.25,6.0,77,4,4,1,9,0xb2d5571b
1217727.44,10.0,9,4,4,3,11,0xb2d6d2dfd
680038.33,5.0,6,4,4,3,11,0xb2d8f300d
946.87,4.0,0,1,4,4,9,0x3b9b1827
184301.91,2.0,0,3,3,4,10,0xb2d61859
167001.25,4.0,123,3,4,1,8,0xb2d5e7a2
909909.08,10.0,0,4,4,4,12,0xb2d145acd
180000.0,5.0,6,3,4,3,10,0xb2d1a828d
123.14,1.0,42,1,2,2,5,0xb2d2dd5bd
228002.41,4.0,0,3,4,4,11,0xb2d485d4d
20038.71,2.0,117,2,3,1,6,0xb2d5ed98d
1010664.97,6.0,103,4,4,1,9,0xb2d5e35dd
532.79,2.0,60,1,3,2,6,0xb2d8fd3d
161461.68,2.0,34,3,3,2,8,0xb2d68695d
1021.48,1.0,184,1,2,1,4,0xb2d23507d
12338.27,1.0,16,2,2,2,6,0xb2d234add
82005.56,2.0,76,3,3,1,7,0xb2d1b194d
204089.28,3.0,34,3,4,2,9,0xb2d5b74bd
1222.7,1.0,0,1,2,4,7,0xb2d55153
313.37,1.0,13,1,2,3,6,0xb2d30a9fd
1932325.14,6.0,1,4,4,4,12,0xb2d649e4d
3.68,1.0,40,1,2,2,5,0xb2d6a414d
716.5,1.0,19,1,2,2,5,0xb2d2b88c
565191.12,6.0,14,4,4,3,11,0xb2d53905d
60740.73,1.0,12,3,2,3,8,0xb2d2a21bd
501193.8,3.0,2,4,4,4,12,0xb2d748f4d
11659.82,1.0,1,2,2,4,8,0xb2d17b9d
194.11,1.0,8,1,2,3,6,0xb2d24d73
51321.03,2.0,32,2,3,2,7,0xb2d6b339d
590.68,1.0,75,1,2,1,4,0xb2d5c494
601137.79,2.0,36,4,3,2,9,0xb2d57a54
1115.04,1.0,184,1,2,1,4,0xb2d30f31d
22338.72,4.0,20,2,4,2,8,0x3b9af2cdd
575.26,4.0,1,1,4,4,9,0xb2d13d60d
484170.97,4.0,147,4,4,1,9,0xb2d3bee4d
8673.01,1.0,7,2,2,3,7,0xb2d382dc
9752.61,1.0,184,2,2,1,5,0xb2d5a868d
802.3,1.0,20,1,2,2,5,0xb2d57e7b
1503799.05,3.0,6,4,4,3,11,0xb2d110dbd
500998.38,4.0,14,4,4,3,11,0xb2d2840fd
241079.64,5.0,11,3,4,3,10,0xb2d6a037d
35627.04,1.0,15,2,2,3,7,0xb2d177cbd
511691.64,8.0,0,4,4,4,12,0xb2d18256d
150006.48,3.0,95,3,4,1,8,0xb2d57e38
256392.79,3.0,7,3,4,3,10,0xb2d631d6d
4279.19,1.0,92,2,2,1,5,0xb2d35c3e
304011.79,6.0,39,4,4,2,10,0xb2d258f4d
761591.67,5.0,25,4,4,2,10,0xb2d5c369d
250057.36,2.0,73,3,3,1,7,0xb2d36953d
164008.88,2.0,80,3,3,1,7,0xb2d23122d
406434.1,3.0,29,4,4,2,10,0xb2d6acc7d
1163.93,1.0,184,1,2,1,4,0xb2d26a92d
804.77,1.0,21,1,2,2,5,0xb2d2ab9ed
9585.4,1.0,8,2,2,3,7,0xb2d55ce1
503583.91,2.0,67,4,3,1,8,0xb2d4950a
150024.95,2.0,6,3,3,3,9,0xb2d8f6ecd
1133286.45,17.0,2,4,4,4,12,0xb2d34f06d
12122.99,1.0,184,2,2,1,5,0xb2d24785d
4356.97,1.0,9,2,2,3,7,0xb2d21947d
183666.96,2.0,14,3,3,3,9,0xb2d60ccdd
132295.2,2.0,6,3,3,3,9,0xb2d6bb12d
9218.76,1.0,86,2,2,1,5,0xb2d5d152d
115321.45,4.0,0,3,4,4,11,0xb2d68dd6d
155083.17,3.0,193,3,4,1,8,0xb2d229c1d
329104.77,2.0,200,4,3,1,8,0xb2d3f27bd
1022.86,2.0,271,1,3,1,5,0x3b9b298ed
96197.73,2.0,104,3,3,1,7,0xb2d685e2d
3913.39,1.0,10,2,2,3,7,0xb2d41d74
17514.37,1.0,184,2,2,1,5,0xb2d14ad0d
406836.3,1.0,0,4,2,4,10,0xb2d8fb8e
81481.52,1.0,0,3,2,4,9,0xb2d609a6
455825.48,5.0,0,4,4,4,12,0xb2d6cbaa
42793.17,1.0,11,2,2,3,7,0xb2d2da0ad
80362.05,3.0,32,3,4,2,9,0xb2d625fad
50858.64,2.0,153,2,3,1,6,0xb2d61a1ad
3000518.1,3.0,0,4,4,4,12,0xb2d8f1d1d
215753.24,2.0,129,3,3,1,7,0xb2d364fdd
1533.82,1.0,92,1,2,1,4,0x3b9b22f2d
548.76,1.0,2,1,2,4,7,0xb2d3ee4e
1001.59,1.0,161,1,2,1,4,0xb2d8edfb
417834.23,3.0,80,4,4,1,9,0xb2d364b5d
185981.6,4.0,3,3,4,4,11,0xb2d42383d
60.17,1.0,28,1,2,2,5,0xb2d8c4b0
10148.24,1.0,184,2,2,1,5,0xb2d5e7aad
103002.54,1.0,1,3,2,4,9,0xb2d6a59dd
840609.32,12.0,1,4,4,4,12,0xb2d6440cd
4002.27,1.0,19,2,2,2,6,0xb2d6d4ead
53995.63,1.0,14,3,2,3,8,0xb2d4f8d9d
10805.56,1.0,6,2,2,3,7,0xb2d39cfd
10896.75,1.0,14,2,2,3,7,0xb2d8cd28d
5771.35,1.0,1,2,2,4,8,0xb2d23ff0
190191.57,3.0,52,3,4,2,9,0xb2d6babed
90125.68,3.0,139,3,4,1,8,0xb2d62902d
110004.57,3.0,62,3,4,2,9,0xb2d5a086
1280576.79,2.0,0,4,3,4,11,0xb2d626b6
12604.36,1.0,175,2,2,1,5,0xb2d56369d
100090.81,2.0,70,3,3,1,7,0xb2d3b9d2d
10001.06,2.0,132,2,3,1,6,0xb2d2c293d
84.23,1.0,0,1,2,4,7,0xb2d387ef
1328923.05,4.0,52,4,4,2,10,0xb2d104cbd
9.37,2.0,21,1,3,2,6,0xb2d566e1
6455.01,1.0,11,2,2,3,7,0xb2d2d3c7d
5126.55,3.0,3,2,4,4,10,0xb2d0df8bd
130694.12,3.0,34,3,4,2,9,0xb2d6fd3ad
32991.76,3.0,8,2,4,3,9,0xb2d1529f
34933.53,1.0,21,2,2,2,6,0xb2d3b54ed
525.74,1.0,1,1,2,4,7,0xb2d3192a
559012.79,5.0,10,4,4,3,11,0xb2d632dad
221.61,1.0,4,1,2,4,7,0xb2d57161
65001.54,3.0,136,3,4,1,8,0xb2d6adcbd
20709.35,2.0,25,2,3,2,7,0xb2d60872d
2297.0,1.0,20,1,2,2,5,0xb2d7fe65
207521.72,4.0,37,3,4,2,9,0xb2d8f369d
1.61,1.0,4,1,2,4,7,0xb2d6d7efd
161733.35,7.0,18,3,4,2,9,0xb2d5c5ebd
722498.7,13.0,18,4,4,2,10,0xb2d0da1bd
17496.99,1.0,14,2,2,3,7,0xb2d342e5d
35759.36,1.0,0,2,2,4,8,0xb2d21ac1
1652.88,1.0,4,1,2,4,7,0xb2d2d1c4d
218292.3,2.0,92,3,3,1,7,0xb2d22544d
8835.84,1.0,3,2,2,4,8,0xb2d2f2f7d
160227.56,2.0,73,3,3,1,7,0xb2d1dab9d
50065.68,2.0,28,2,3,2,7,0xb2d57df4d
279.8,1.0,82,1,2,1,4,0xb2d496a0d
910.35,2.0,0,1,3,4,8,0xb2d064d2d
33086.41,1.0,92,2,2,1,5,0xb2d61621d
10043.23,1.0,92,2,2,1,5,0xb2d539ddd
1120.06,1.0,92,1,2,1,4,0xb2d0d3f6d
986.08,1.0,1,1,2,4,7,0xb2d51880d
15156.37,1.0,184,2,2,1,5,0xb2d2bf3dd
657113.8,7.0,2,4,4,4,12,0xb2d31198d
76332.14,2.0,19,3,3,2,8,0xb2d62e2b
2357.48,1.0,1,1,2,4,7,0xb2d3546e
25256.93,1.0,41,2,2,2,6,0xb2d63d5d
1226.91,1.0,192,1,2,1,4,0xb2d5e183d
793.02,1.0,56,1,2,2,5,0xb2d2d5e4d
852.33,2.0,0,1,3,4,8,0xb2d0bf9c
331.6,1.0,18,1,2,2,5,0xb2d35926d
22212.34,1.0,4,2,2,4,8,0xb2d30ac3d
8498.64,1.0,0,2,2,4,8,0xb2d5c368d
98.83,1.0,74,1,2,1,4,0xb2d8c6cfd
85391.11,1.0,6,3,2,3,8,0xb2d2b02e
2708.99,1.0,91,1,2,1,4,0xb2d266aed
56655.91,1.0,9,3,2,3,8,0xb2d425ec
0.0,1.0,2,1,2,4,7,0xb2d28e8b
203520.05,3.0,11,3,4,3,10,0xb2d5f3f5d
290.77,1.0,6,1,2,3,6,0xb2d4776e
510.74,1.0,0,1,2,4,7,0xb2d34ab1d
2910.15,1.0,92,2,2,1,5,0xb2d2bd26d
447027.49,9.0,0,4,4,4,12,0xb2d40b68d
5.07,1.0,67,1,2,1,4,0xb2d8dbad
200464.7,1.0,155,3,2,1,6,0xb2d784c0
80001.9,3.0,0,3,4,4,11,0xb2d57f3ad
1310056.0,3.0,0,4,4,4,12,0xb2d28c9a
200017.0,2.0,15,3,3,3,9,0xb2d3315bd
37.35,1.0,55,1,2,2,5,0xb2d2b62bd
1193.93,1.0,183,1,2,1,4,0xb2d69c07
240023.86,5.0,7,3,4,3,10,0xb2d13796
468091.04,4.0,27,4,4,2,10,0xb2d657b8d
50033.4,2.0,74,2,3,1,6,0xb2d0fae2
500010.86,6.0,18,4,4,2,10,0x3b9b3b27d
23.76,2.0,35,1,3,2,6,0xb2d0746e
50407.46,1.0,31,2,2,2,6,0xb2d62e67d
99.39,1.0,11,1,2,3,6,0xb2d2b2b9
125585.78,3.0,3,3,4,4,11,0xb2d07b8ed
750129.28,3.0,14,4,4,3,11,0xb2d17323d
4233.92,1.0,0,2,2,4,8,0xb2d6ba14
2.65,1.0,55,1,2,2,5,0xb2d40fc7d
4.4,1.0,2,1,2,4,7,0xb2d7eeae
10561.49,1.0,8,2,2,3,7,0xb2d26fc6d
368824.49,5.0,3,4,4,4,12,0xb2d08da4d
200086.06,4.0,14,3,4,3,10,0xb2d6d922
100064.92,2.0,119,3,3,1,7,0xb2d53cf5d
1015.42,1.0,7,1,2,3,6,0xb2d58285d
10358888.13,10.0,3,4,4,4,12,0xb2d0ececd
209868.06,3.0,41,3,4,2,9,0xb2d6f38fd
320036.72,4.0,20,4,4,2,10,0xb2d5af47
732753.62,7.0,19,4,4,2,10,0xb2d22bc5d
501781.62,2.0,7,4,3,3,10,0xb2d45592
60067.79,2.0,157,3,3,1,7,0xb2d48524
600194.45,4.0,15,4,4,3,11,0xb2d57fd4d
95010.56,5.0,4,3,4,4,11,0xb2d63eadd
402849.8,3.0,43,4,4,2,10,0xb2d8384f
6013.19,1.0,92,2,2,1,5,0xb2d3e62ad
660166.91,11.0,1,4,4,4,12,0xb2d145f3
93011.65,2.0,168,3,3,1,7,0xb2d2fbf6d
0.0,1.0,0,1,2,4,7,0xb2d652d6
320014.87,3.0,118,4,4,1,9,0xb2d3a874
121296.57,8.0,69,3,4,1,8,0xb2d651b9d
1134273.0,9.0,0,4,4,4,12,0xb2d78155d
1521533.73,3.0,101,4,4,1,9,0xb2d5c075d
15260201.19,2.0,0,4,3,4,11,0xb2d6857fd
118415.75,6.0,0,3,4,4,11,0x3b9b45a5d
1101956.19,3.0,0,4,4,4,12,0xb2d4d053
2.29,1.0,77,1,2,1,4,0xb2d82271d
25.44,1.0,4,1,2,4,7,0xb2d3c74f
770.0,1.0,101,1,2,1,4,0xb2d222c4d
51655.36,1.0,15,2,2,3,7,0xb2d0cd57d
45.14,1.0,25,1,2,2,5,0xb2d5aabbd
1001.07,2.0,8,1,3,3,7,0xb2d6e3c5
96.54,1.0,0,1,2,4,7,0xb2d31b0e
400041.68,2.0,8,4,3,3,10,0xb2d7bd42
10715.54,1.0,5,2,2,3,7,0xb2d40d0f
843.03,1.0,1,1,2,4,7,0xb2d2c4fbd
1016986.15,6.0,87,4,4,1,9,0xb2d23a71
420002.52,4.0,8,4,4,3,11,0xb2d6dbc7d
1005255.47,2.0,0,4,3,4,11,0xb2d356bfd
210091.97,2.0,82,3,3,1,7,0xb2d1ab07d
7029.48,1.0,0,2,2,4,8,0xb2d22373d
1113.97,1.0,0,1,2,4,7,0xb2d6cf34d
363.84,1.0,35,1,2,2,5,0xb2d2590fd
435063.35,4.0,6,4,4,3,11,0xb2d6c9ced
155266.15,4.0,2,3,4,4,11,0xb2d4ead8d
186282.33,1.0,0,3,2,4,9,0xb2d41e9a
253006.48,13.0,0,3,4,4,11,0xb2d0cee4d
148922.77,1.0,5,3,2,3,8,0xb2d2ce4ed
49.24,1.0,47,1,2,2,5,0xb2d5cba0d
307093.67,2.0,7,4,3,3,10,0xb2d19bd4d
200001.07,3.0,40,3,4,2,9,0xb2d204e0d
735.5,1.0,19,1,2,2,5,0xb2d268d8d
20046.96,2.0,0,2,3,4,9,0xb2d5ff41d
90392.02,1.0,2,3,2,4,9,0xb2d6eed3d
30940.54,1.0,22,2,2,2,6,0xb2d4703cd
1.66,1.0,32,1,2,2,5,0xb2d5b02a
685032.73,4.0,0,4,4,4,12,0xb2d5ee4d
60046.43,2.0,47,3,3,2,8,0xb2d250cdd
900045.19,5.0,7,4,4,3,11,0xb2d5869d
6162.92,1.0,18,2,2,2,6,0xb2d2c43bd
0.34,1.0,0,1,2,4,7,0xb2d8f1da
28475.58,1.0,18,2,2,2,6,0xb2d8eabfd
11514.24,1.0,10,2,2,3,7,0xb2d521cfd
77207.87,1.0,18,3,2,2,7,0xb2d34393d
10831.32,1.0,28,2,2,2,6,0xb2d6d316d
114327.86,3.0,116,3,4,1,8,0xb2d4f510d
102000.0,2.0,0,3,3,4,10,0xb2d4eb74
1.86,1.0,84,1,2,1,4,0xb2d29f6e
52007.9,1.0,5,2,2,3,7,0xb2d64b0ed
33970.93,1.0,1,2,2,4,8,0xb2d3379a
2072.55,1.0,92,1,2,1,4,0xb2d13598d
3747.08,1.0,92,2,2,1,5,0xb2d3bbaed
460.28,1.0,10,1,2,3,6,0xb2d2ed12d
508418.91,3.0,15,4,4,3,11,0xb2d2995ad
400001.99,3.0,19,4,4,2,10,0xb2d60c94d
0.1,1.0,184,1,2,1,4,0xb2d29fa1d
163814.41,3.0,3,3,4,4,11,0xb2d0d780d
414655.37,3.0,26,4,4,2,10,0xb2d60b60d
615.8,2.0,0,1,3,4,8,0xb2d31d29
143014.52,2.0,121,3,3,1,7,0xb2d6f67cd
6581.36,1.0,2,2,2,4,8,0xb2d6f27ed
5055.11,2.0,5,2,3,3,8,0xb2d22ce5d
2375.18,1.0,184,1,2,1,4,0xb2d0cb7bd
7985.13,1.0,0,2,2,4,8,0xb2d6910d
106194.53,1.0,92,3,2,1,6,0xb2d1a639d
35.91,1.0,92,1,2,1,4,0xb2d12880d
452206.36,8.0,2,4,4,4,12,0xb2d59cbcd
1630007.74,4.0,19,4,4,2,10,0xb2d5ce04
4125.41,1.0,11,2,2,3,7,0xb2d8a185d
518325.31,7.0,4,4,4,4,12,0xb2d568a5d
40117.56,4.0,0,2,4,4,10,0xb2d0f2efd
102624.08,2.0,0,3,3,4,10,0x3b9b0f8a
230012.52,5.0,74,3,4,1,8,0xb2d2297bd
7000.16,1.0,9,2,2,3,7,0xb2d8db4ad
794122.89,5.0,45,4,4,2,10,0xb2d54bb0d
2032797.1,5.0,0,4,4,4,12,0xb2d3ea89d
52128.81,2.0,98,2,3,1,6,0xb2d615ddd
101009.51,3.0,101,3,4,1,8,0xb2d57fbcd
300102.44,2.0,133,4,3,1,8,0xb2d121c7d
2135.73,2.0,184,1,3,1,5,0xb2d07d3fd
20000.5,3.0,70,2,4,1,7,0xb2d8f04ed
10000.11,2.0,90,2,3,1,6,0xb2d8c365
10026.53,2.0,10,2,3,3,8,0xb2d59a82d
135607.43,3.0,0,3,4,4,11,0xb2d12340d
232693.43,1.0,28,3,2,2,7,0xb2d0f22fd
9448.72,1.0,1,2,2,4,8,0xb2d3f61c
3317.95,1.0,0,2,2,4,8,0xb2d1d14dd
2130128.88,3.0,60,4,4,2,10,0xb2d4fb49d
11407.87,1.0,9,2,2,3,7,0xb2d2fdb8d
90057.63,2.0,90,3,3,1,7,0xb2d62f1dd
380.1,3.0,0,1,4,4,9,0xb2d210c7d
70004.24,2.0,62,3,3,2,8,0xb2d43e10d
2463.91,1.0,92,1,2,1,4,0xb2d5420bd
152009.98,4.0,20,3,4,2,9,0xb2d5e53dd
2203.78,1.0,183,1,2,1,4,0xb2d68bbed
2.64,1.0,167,1,2,1,4,0xb2d8d9a1d
72272.7,3.0,189,3,4,1,8,0xb2d56bffd
52411.53,2.0,97,3,3,1,7,0xb2d513d6
8273.48,1.0,1,2,2,4,8,0xb2d60efc
5046.43,1.0,184,2,2,1,5,0xb2d2f1a7d
1114.78,1.0,92,1,2,1,4,0xb2d3db59d
469358.21,11.0,4,4,4,4,12,0xb2d55d96d
190170.16,4.0,8,3,4,3,10,0xb2d6a89d
387997.86,5.0,11,4,4,3,11,0xb2d60ec5d
0.0,2.0,7,1,3,3,7,0xb2d0d511
5074.15,1.0,9,2,2,3,7,0xb2d44842
10034.64,2.0,182,2,3,1,6,0xb2d657fed
15653.19,1.0,3,2,2,4,8,0xb2d2a78dd
1047262.21,17.0,4,4,4,4,12,0xb2d691fad
34248.21,1.0,22,2,2,2,6,0xb2d5c61bd
1607.01,1.0,10,1,2,3,6,0xb2d2231c
706971.13,5.0,0,4,4,4,12,0xb2d0982ad
360823.68,2.0,13,4,3,3,10,0xb2d37061d
210721.33,2.0,92,3,3,1,7,0xb2d3ae97d
2308.8,1.0,92,1,2,1,4,0xb2d3c5c3d
19033.15,1.0,9,2,2,3,7,0xb2d2bd06d
1482534.68,5.0,6,4,4,3,11,0xb2d260f9d
7.42,1.0,42,1,2,2,5,0xb2d54f2f
156267.09,2.0,209,3,3,1,7,0xb2d1366cd
6690.64,1.0,0,2,2,4,8,0xb2d5be49d
186852.13,3.0,1,3,4,4,11,0xb2d4ee48
12.78,1.0,12,1,2,3,6,0xb2d21a4b
310373.8,3.0,28,4,4,2,10,0xb2d51a40d
220385.79,3.0,8,3,4,3,10,0xb2d396fad
201.16,1.0,10,1,2,3,6,0xb2d2aeda
370492.33,4.0,0,4,4,4,12,0x3b9b184dd
6870.73,24.0,0,2,4,4,10,0xb2d27796
4907.38,1.0,2,2,2,4,8,0xb2d69a60
721155.34,3.0,16,4,4,2,10,0xb2d6381dd
1030600.64,4.0,40,4,4,2,10,0xb2d1ae04d
450940.4,4.0,8,4,4,3,11,0xb2d63baed
44155.7,1.0,92,2,2,1,5,0xb2d09331d
888000.04,5.0,1,4,4,4,12,0xb2d5ad64d
401081.38,3.0,20,4,4,2,10,0xb2d56572d
1.9,1.0,49,1,2,2,5,0xb2d16e85
710013.44,6.0,66,4,4,2,10,0xb2d57abed
1459.33,1.0,48,1,2,2,5,0xb2d0ee6ad
260.17,2.0,1,1,3,4,8,0xb2d1ece3
848.97,1.0,64,1,2,2,5,0xb2d16ea9d
506134.96,2.0,34,4,3,2,9,0xb2d6db04d
51618.09,2.0,4,2,3,4,9,0xb2d69d91d
4442.18,1.0,184,2,2,1,5,0xb2d1b1dfd
1120140.65,3.0,189,4,4,1,9,0xb2d440e1d
80039.48,2.0,38,3,3,2,8,0xb2d6e6f6
14697.36,1.0,148,2,2,1,5,0xb2d37522d
70743.98,1.0,47,3,2,2,7,0xb2d5998dd
450775.29,5.0,56,4,4,2,10,0xb2d13c9c
5.96,1.0,41,1,2,2,5,0xb2d63a6c
688190.63,5.0,63,4,4,2,10,0xb2d63773d
504507.27,1.0,9,4,2,3,9,0xb2d5ee86d
1505419.73,1.0,0,4,2,4,10,0xb2d2d250d
420051.79,8.0,4,4,4,4,12,0xb2d5dd54d
4642.43,1.0,3,2,2,4,8,0xb2d5d5da
7007.28,1.0,18,2,2,2,6,0xb2d6b716d
440096.95,7.0,27,4,4,2,10,0xb2d44243
167710.29,2.0,235,3,3,1,7,0xb2d4be54d
1714.08,1.0,159,1,2,1,4,0xb2d1ffaed
6225.28,1.0,184,2,2,1,5,0xb2d2d454d
50008.96,3.0,98,2,4,1,7,0xb2d78ff8
460007.95,6.0,0,4,4,4,12,0xb2d4e7f9d
5008.18,1.0,7,2,2,3,7,0xb2d85bbcd
12008.84,2.0,18,2,3,2,7,0xb2d21110
2919.26,1.0,184,2,2,1,5,0xb2d06475d
599681.29,4.0,5,4,4,3,11,0xb2d1d6e0
1371982.22,19.0,6,4,4,3,11,0x3b9af14e
0.0,1.0,0,1,2,4,7,0xb2d17657
520048.5,12.0,55,4,4,2,10,0xb2d3e9c9
510121.44,6.0,15,4,4,3,11,0xb2d09c2bd
55110.61,2.0,18,3,3,2,8,0xb2d10ec8d
251376.2,4.0,19,3,4,2,9,0xb2d8d788d
23576.98,1.0,12,2,2,3,7,0xb2d19429d
460038.2,3.0,62,4,4,2,10,0xb2d2611c
751339.47,5.0,24,4,4,2,10,0xb2d78158d
41048.52,3.0,0,2,4,4,10,0xb2d75740d
209081.63,4.0,97,3,4,1,8,0xb2d3c9e3d
4233.7,2.0,29,2,3,2,7,0xb2d369ecd
4648.06,1.0,92,2,2,1,5,0x3b9b1a0c
579809.34,6.0,0,4,4,4,12,0x3b9af217d
691.25,1.0,0,1,2,4,7,0xb2d1662b
5656.27,1.0,7,2,2,3,7,0xb2d1d018d
4.25,1.0,32,1,2,2,5,0xb2d7c030d
9810.65,1.0,57,2,2,2,6,0xb2d65102d
45754.89,38.0,0,2,4,4,10,0x3b9af28cd
40047.19,2.0,28,2,3,2,7,0xb2d6a4b0d
2952.44,1.0,33,2,2,2,6,0xb2d5f573d
300000.82,2.0,16,3,3,2,8,0xb2d58fbbd
2.27,1.0,0,1,2,4,7,0xb2d81d07
771446.74,4.0,10,4,4,3,11,0xb2d0d8cbd
311003.92,4.0,39,4,4,2,10,0xb2d0d4a8d
426196.0,12.0,34,4,4,2,10,0xb2d11155d
1494859.68,9.0,11,4,4,3,11,0xb2d1b5a4d
256077.06,2.0,27,3,3,2,8,0xb2d5ab24d
166027.98,6.0,1,3,4,4,11,0xb2d0ea8fd
300006.34,2.0,130,3,3,1,7,0xb2d43141d
1682.37,1.0,14,1,2,3,6,0xb2d63d46
407026.0,5.0,35,4,4,2,10,0xb2d43c8bd
4034.43,1.0,232,2,2,1,5,0xb2d3a526d
15242.37,1.0,118,2,2,1,5,0xb2d3d138d
31295.25,2.0,27,2,3,2,7,0xb2d52c96d
72940.71,3.0,35,3,4,2,9,0xb2d59bc6d
1446502.83,6.0,11,4,4,3,11,0xb2d6d279d
14.33,1.0,88,1,2,1,4,0xb2d41fd7
2.48,1.0,0,1,2,4,7,0xb2d78fee
3405308.89,33.0,18,4,4,2,10,0x3b9adbd3d
1.61,1.0,16,1,2,2,5,0xb2d781a2
583023.5,36.0,1,4,4,4,12,0xb2d646e4d
300270.68,2.0,129,4,3,1,8,0xb2d86851d
10115.16,1.0,4,2,2,4,8,0xb2d48a22
70241.61,7.0,10,3,4,3,10,0x3b9b37a0d
85.49,1.0,10,1,2,3,6,0xb2d6af36
33749.6,1.0,49,2,2,2,6,0xb2d696fbd
3528.84,1.0,10,2,2,3,7,0xb2d8ea3cd
1519.91,1.0,92,1,2,1,4,0xb2d1aff5d
1111856.34,3.0,18,4,4,2,10,0xb2d2dd72d
44190.93,5.0,0,2,4,4,10,0x3b9af2c7d
12840.22,1.0,10,2,2,3,7,0xb2d89365
345.19,1.0,0,1,2,4,7,0xb2d627a1d
1376.28,1.0,92,1,2,1,4,0xb2d22499d
310056.44,3.0,75,4,4,1,9,0xb2d28d38
274537.45,4.0,13,3,4,3,10,0xb2d25216d
349671.98,2.0,34,4,3,2,9,0xb2d651ca
872.07,1.0,0,1,2,4,7,0xb2d16154
23000.51,2.0,49,2,3,2,7,0xb2d5f6d4
75025.68,2.0,159,3,3,1,7,0xb2d4134dd
32.75,4.0,2,1,4,4,9,0x3b9af0eb
50038.62,2.0,8,2,3,3,8,0xb2d1b982
4299.76,1.0,7,2,2,3,7,0xb2d78e0fd
11264.74,2.0,184,2,3,1,6,0x3b9b2e0bd
200103.32,1.0,1,3,2,4,9,0xb2d3a8bbd
101279.54,2.0,38,3,3,2,8,0xb2d0c27bd
0.0,1.0,8,1,2,3,6,0xb2d21562
10147.7,1.0,184,2,2,1,5,0xb2d115f7d
100001.06,2.0,20,3,3,2,8,0xb2d59bebd
694059.94,3.0,0,4,4,4,12,0xb2d34613d
101742.63,1.0,0,3,2,4,9,0xb2d6de37d
1000064.77,3.0,24,4,4,2,10,0xb2d6e3ded
33318.19,2.0,21,2,3,2,7,0xb2d32ddc
402842.39,2.0,19,4,3,2,9,0xb2d8dac7
627883.44,8.0,52,4,4,2,10,0xb2d074b1
340024.03,2.0,0,4,3,4,11,0x3b9b4295
111064.47,2.0,228,3,3,1,7,0xb2d5c470d
3154.6,3.0,92,2,4,1,7,0xb2d114b0d
1732221.31,3.0,15,4,4,3,11,0xb2d8dfcad
443459.43,4.0,0,4,4,4,12,0xb2d451fad
5897.83,1.0,10,2,2,3,7,0xb2d5e2d0d
100053.97,2.0,151,3,3,1,7,0xb2d44789d
10.66,1.0,6,1,2,3,6,0xb2d20bee
16321.95,1.0,92,2,2,1,5,0xb2d578ecd
280.65,1.0,12,1,2,3,6,0xb2d5f035
400007.7,3.0,27,4,4,2,10,0xb2d8c6d2d
19540.09,1.0,15,2,2,3,7,0xb2d3fcbed
0.87,1.0,0,1,2,4,7,0xb2d629dad
276106.78,5.0,38,3,4,2,9,0xb2d4232cd
291093.98,4.0,27,3,4,2,9,0xb2d68a8bd
891.5,1.0,3,1,2,4,7,0xb2d2008ad
494181.82,5.0,0,4,4,4,12,0xb2d21289
1460068.14,11.0,3,4,4,4,12,0xb2d06827d
462005.98,7.0,21,4,4,2,10,0xb2d5c05ad
100874.77,3.0,116,3,4,1,8,0xb2d5f09cd
105020.39,3.0,119,3,4,1,8,0xb2d6f016d
80103.82,2.0,92,3,3,1,7,0xb2d20867
1572.64,1.0,10,1,2,3,6,0xb2d6c119d
441615.57,3.0,36,4,4,2,10,0xb2d8e762d
150625.61,2.0,10,3,3,3,9,0xb2d1c250
580021.87,6.0,25,4,4,2,10,0xb2d0972ed
690016.31,5.0,34,4,4,2,10,0xb2d12b06
944.09,1.0,1,1,2,4,7,0xb2d631e1
8573.26,1.0,92,2,2,1,5,0xb2d1b42bd
560056.62,6.0,6,4,4,3,11,0xb2d328f7
600008.86,4.0,56,4,4,2,10,0xb2d620e1d
414301.21,3.0,7,4,4,3,11,0x3b9b37bed
100133.85,4.0,1,3,4,4,11,0xb2d0da5cd
1424394.39,5.0,15,4,4,3,11,0xb2d5cbfdd
440013.66,2.0,186,4,3,1,8,0xb2d88c18d
210990.59,1.0,10,3,2,3,8,0xb2d58897
210136.65,2.0,158,3,3,1,7,0xb2d7f4c6
213135.77,3.0,60,3,4,2,9,0xb2d8e4b7d
726970.62,6.0,0,4,4,4,12,0xb2d0b263
26.49,1.0,82,1,2,1,4,0xb2d8cd5cd
1003837.5,2.0,0,4,3,4,11,0xb2d31196d
70069.0,2.0,34,3,3,2,8,0xb2d6dd74d
500011.16,2.0,172,4,3,1,8,0xb2d5a1ea
50000.72,2.0,0,2,3,4,9,0xb2d626dad
700070.25,3.0,12,4,4,3,11,0xb2d683f2d
42756.54,1.0,141,2,2,1,5,0xb2d37caed
1250000.0,9.0,3,4,4,4,12,0xb2d262c6d
151446.09,1.0,184,3,2,1,6,0xb2d518fcd
580020.36,7.0,31,4,4,2,10,0xb2d28b11d
302209.88,6.0,14,4,4,3,11,0xb2d3939dd
40570.89,1.0,9,2,2,3,7,0xb2d38092
350122.7,3.0,11,4,4,3,11,0xb2d12350d
43873.91,1.0,0,2,2,4,8,0xb2d65041d
1900018.86,4.0,20,4,4,2,10,0xb2d6b0ded
1088.3,1.0,92,1,2,1,4,0xb2d29056
120113.53,2.0,22,3,3,2,8,0xb2d60607d
716.63,1.0,15,1,2,3,6,0xb2d1f361d
15243.88,1.0,23,2,2,2,6,0xb2d59d46d
1731.29,1.0,0,1,2,4,7,0xb2d88a72d
172195.29,4.0,0,3,4,4,11,0xb2d2ff1ad
117014.02,2.0,98,3,3,1,7,0xb2d1b1b7d
51841.46,2.0,42,2,3,2,7,0xb2d6afd8d
50371.91,2.0,3,2,3,4,9,0xb2d64d3bd
608414.95,7.0,74,4,4,1,9,0xb2d1a46ad
7303.29,1.0,2,2,2,4,8,0xb2d107f6
4283.3,1.0,184,2,2,1,5,0xb2d35c3ed
500091.91,2.0,35,4,3,2,9,0xb2d512e0
0.0,1.0,6,1,2,3,6,0xb2d6e1c7
2079.04,1.0,92,1,2,1,4,0xb2d3a4ccd
16.95,1.0,45,1,2,2,5,0xb2d37d14
367009.66,11.0,4,4,4,4,12,0xb2d321ecd
204968.55,2.0,105,3,3,1,7,0xb2d5edf5d
435010.89,12.0,0,4,4,4,12,0x3b9b3e94d
1591.99,1.0,10,1,2,3,6,0xb2d345b2
27780.49,1.0,0,2,2,4,8,0xb2d180c8d
485153.59,3.0,25,4,4,2,10,0xb2d615a1d
10039.57,2.0,122,2,3,1,6,0xb2d5f12cd
580.14,1.0,8,1,2,3,6,0xb2d5ea4dd
1492115.9,1.0,0,4,2,4,10,0xb2d0beacd
1081.41,1.0,15,1,2,3,6,0xb2d406edd
927073.77,5.0,1,4,4,4,12,0xb2d122c0d
42915.18,1.0,5,2,2,3,7,0xb2d29da3
13.81,1.0,26,1,2,2,5,0xb2d161ae
5470.32,1.0,0,2,2,4,8,0xb2d8c3c6d
72906.47,3.0,24,3,4,2,9,0xb2d4f75cd
699169.59,3.0,87,4,4,1,9,0xb2d5f75ed
100129.41,2.0,19,3,3,2,8,0xb2d45d31
207415.14,2.0,76,3,3,1,7,0xb2d1a546d
85089.36,2.0,83,3,3,1,7,0xb2d609a6d
4208000.37,10.0,2,4,4,4,12,0xb2d56ce3d
449650.02,11.0,0,4,4,4,12,0x3b9b3932d
11.87,1.0,11,1,2,3,6,0xb2d6c6c2
153.75,2.0,2,1,3,4,8,0xb2d177c7d
2122216.37,9.0,0,4,4,4,12,0xb2d47e2d
2325.05,1.0,1,1,2,4,7,0xb2d5d766d
546613.73,6.0,89,4,4,1,9,0xb2d41235d
40767.24,1.0,11,2,2,3,7,0xb2d2fac2d
50001.27,3.0,6,2,4,3,9,0xb2d55123
45657.44,2.0,8,2,3,3,8,0xb2d402afd
1174.14,1.0,4,1,2,4,7,0xb2d61ff7d
73037.36,2.0,7,3,3,3,9,0xb2d64866d
20000.21,2.0,182,2,3,1,6,0xb2d8c393d
233336.77,3.0,0,3,4,4,11,0xb2d6b0d1d
1884808.56,4.0,18,4,4,2,10,0xb2d14cf4d
1361000.0,10.0,5,4,4,3,11,0xb2d6fedd
0.0,1.0,4,1,2,4,7,0xb2d59e7c
2957.89,1.0,0,2,2,4,8,0xb2d5c05fd
301108.75,2.0,43,4,3,2,9,0xb2d5e23d
491089.41,5.0,14,4,4,3,11,0xb2d1d989d
510000.0,11.0,0,4,4,4,12,0xb2d39c33d
70863.11,3.0,5,3,4,3,10,0xb2d2c806
490057.95,4.0,63,4,4,2,10,0xb2d27af1d
6200.02,1.0,184,2,2,1,5,0xb2d415fdd
1228.53,1.0,10,1,2,3,6,0xb2d6a588
648055.89,7.0,8,4,4,3,11,0xb2d63765d
569277.33,12.0,4,4,4,4,12,0xb2d1bfc1d
426012.79,4.0,18,4,4,2,10,0xb2d1182dd
18.7,1.0,45,1,2,2,5,0xb2d37d0a
336138.42,2.0,239,4,3,1,8,0xb2d489fed
921685.26,5.0,0,4,4,4,12,0xb2d249c6d
47125.9,3.0,8,2,4,3,9,0xb2d63481d
582.63,1.0,0,1,2,4,7,0xb2d60a40d
10293.51,1.0,117,2,2,1,5,0xb2d688fe
1365.47,1.0,184,1,2,1,4,0xb2d16b46d
321859.93,2.0,1,4,3,4,11,0xb2d40cdf
1524.34,1.0,9,1,2,3,6,0xb2d4b40fd
482365.81,4.0,70,4,4,1,9,0x3b9b3b2bd
656.49,1.0,1,1,2,4,7,0xb2d53463
361812.71,5.0,0,4,4,4,12,0xb2d641cad
3325.3,1.0,92,2,2,1,5,0x3b9af413d
2050304.34,5.0,39,4,4,2,10,0xb2d5769dd
350114.75,3.0,24,4,4,2,10,0xb2d6e002d
79.43,2.0,3,1,3,4,8,0xb2d3033bd
2337922.95,5.0,8,4,4,3,11,0xb2d6d2a0d
851.45,1.0,31,1,2,2,5,0xb2d1aeb7
2597.61,1.0,13,1,2,3,6,0xb2d272d4d
2986.04,1.0,7,2,2,3,7,0xb2d17fb6d
492439.16,4.0,9,4,4,3,11,0xb2d0d348d
200052.92,2.0,7,3,3,3,9,0xb2d69ecb
227018.73,3.0,18,3,4,2,9,0x3b9b3ce1d
1245886.65,5.0,0,4,4,4,12,0xb2d168acd
1393.01,1.0,1,1,2,4,7,0xb2d342dc
300048.29,2.0,12,3,3,3,9,0xb2d4bc6d
133090.42,4.0,21,3,4,2,9,0xb2d1a91dd
601443.59,7.0,0,4,4,4,12,0xb2d376cc
9481.79,1.0,199,2,2,1,5,0xb2d6ddf2d
2.69,1.0,70,1,2,1,4,0xb2d6a917
85374.75,1.0,1,3,2,4,9,0xb2d2d78d
21567.48,1.0,9,2,2,3,7,0xb2d55708d
10042.92,1.0,184,2,2,1,5,0xb2d5e07fd
9780.74,1.0,0,2,2,4,8,0xb2d376e4d
2740.67,1.0,44,1,2,2,5,0xb2d8dc5ed
9387.44,1.0,3,2,2,4,8,0xb2d24632d
252.21,1.0,12,1,2,3,6,0xb2d27d56
81394.13,1.0,13,3,2,3,8,0xb2d29b9bd
150520.27,3.0,69,3,4,1,8,0xb2d5582dd
209819.68,5.0,0,3,4,4,11,0x3b9b3299d
5.23,1.0,4,1,2,4,7,0xb2d55bd0
50310.52,2.0,4,2,3,4,9,0xb2d2cb4b
291570.74,10.0,1,3,4,4,11,0x3b9af167d
177357.77,2.0,59,3,3,2,8,0xb2d4d928d
392499.82,7.0,11,4,4,3,11,0xb2d616dcd
8756.7,1.0,6,2,2,3,7,0xb2d2f209d
10065.53,1.0,184,2,2,1,5,0xb2d43a4ad
438244.78,4.0,11,4,4,3,11,0xb2d1d5a7d
1760.43,1.0,4,1,2,4,7,0xb2d37cc6
29213.28,1.0,15,2,2,3,7,0xb2d70700d
8.44,1.0,5,1,2,3,6,0xb2d655f4
2037.75,1.0,2,1,2,4,7,0xb2d40684
1376.56,1.0,0,1,2,4,7,0xb2d6220f
4687.06,1.0,93,2,2,1,5,0xb2d36878d
40.26,1.0,52,1,2,2,5,0xb2d18e4a
99.6,1.0,21,1,2,2,5,0xb2d627bd
403077.84,5.0,4,4,4,4,12,0xb2d534c2
404.28,1.0,0,1,2,4,7,0xb2d5304dd
234.37,1.0,65,1,2,2,5,0xb2d716b2
3855.62,2.0,0,2,3,4,9,0xb2d20aa6d
0.47,1.0,1,1,2,4,7,0xb2d630f4d
207007.18,3.0,195,3,4,1,8,0xb2d681f0d
1066230.69,4.0,95,4,4,1,9,0xb2d10f52d
200076.49,2.0,5,3,3,3,9,0xb2d24fc9d
233643.29,1.0,23,3,2,2,7,0xb2d3839e
21384.27,3.0,1,2,4,4,10,0xb2d54b94d
9333.96,1.0,4,2,2,4,8,0xb2d6c427
202269.1,3.0,0,3,4,4,11,0xb2d2e5efd
3001.26,1.0,18,2,2,2,6,0xb2d708e4d
85430.14,1.0,13,3,2,3,8,0xb2d55a23d
1050008.95,9.0,13,4,4,3,11,0xb2d78e6ad
501826.9,2.0,37,4,3,2,9,0xb2d152a2
1003232.77,5.0,30,4,4,2,10,0xb2d118f3d
801009.07,14.0,0,4,4,4,12,0xb2d48bdf
153082.92,5.0,11,3,4,3,10,0xb2d683d0d
602981.04,7.0,4,4,4,4,12,0xb2d40a0bd
170032.63,2.0,0,3,3,4,10,0xb2d11105d
557916.16,6.0,14,4,4,3,11,0x3b9b181dd
8772.17,1.0,20,2,2,2,6,0xb2d8e9aed
17813.69,1.0,1,2,2,4,8,0xb2d57b8cd
310008.27,2.0,15,4,3,3,10,0xb2d56581d
51393.87,3.0,11,2,4,3,9,0xb2d55c11d
280002.96,3.0,73,3,4,1,8,0xb2d8e582
909.28,1.0,4,1,2,4,7,0xb2d29536d
302.23,2.0,80,1,3,1,5,0xb2d638c3d
185394.3,5.0,14,3,4,3,10,0xb2d15995d
11422.99,6.0,22,2,4,2,8,0x3b9af3fcd
270041.8,2.0,175,3,3,1,7,0xb2d3ffdfd
3007.75,1.0,67,2,2,1,5,0xb2d670e0d
592.92,1.0,5,1,2,3,6,0xb2d6a672
1171.59,1.0,22,1,2,2,5,0xb2d25525
887.51,1.0,7,1,2,3,6,0xb2d32e93
20003.79,4.0,92,2,4,1,7,0xb2d093d6
300445.58,4.0,31,4,4,2,10,0x3b9b40aed
10683.18,1.0,0,2,2,4,8,0xb2d1779d
1020.71,1.0,92,1,2,1,4,0xb2d2a678d
112456.12,1.0,19,3,2,2,7,0x3b9b4227d
24027.65,1.0,182,2,2,1,5,0xb2d67cf5
339.34,1.0,2,1,2,4,7,0xb2d48305
37732.91,3.0,7,2,4,3,9,0xb2d58765d
144016.18,3.0,28,3,4,2,9,0xb2d614db
1083123.81,3.0,12,4,4,3,11,0xb2d5dd27d
3501361.55,8.0,8,4,4,3,11,0xb2d6991dd
2857.13,1.0,12,1,2,3,6,0xb2d3129dd
100000.04,1.0,6,3,2,3,8,0xb2d334b3
300000.43,2.0,45,3,3,2,8,0xb2d177b9
4019.36,1.0,193,2,2,1,5,0xb2d2b633d
862004.8,7.0,4,4,4,4,12,0xb2d25c73d
37114.28,1.0,0,2,2,4,8,0xb2d2b030d
5.83,1.0,80,1,2,1,4,0xb2d6b44e
620558.58,9.0,0,4,4,4,12,0x3b9ad2a8
306196.16,4.0,3,4,4,4,12,0xb2d5fc3e
7.57,1.0,1,1,2,4,7,0xb2d3c3c0d
330017.48,4.0,20,4,4,2,10,0xb2d4ff14d
390000.0,13.0,1,4,4,4,12,0xb2d6a0edd
1962046.17,14.0,6,4,4,3,11,0xb2d29361d
54013.87,4.0,12,3,4,3,10,0xb2d6cf93d
674.38,4.0,0,1,4,4,9,0x3b9b1827d
90048.37,6.0,46,3,4,2,9,0xb2d5ee8bd
3474.47,1.0,21,2,2,2,6,0xb2d2f755
71318.01,2.0,1,3,3,4,10,0xb2d5aea9d
34302.44,1.0,20,2,2,2,6,0xb2d376f9d
56340.09,1.0,277,3,2,1,6,0xb2d10c1fd
271000.0,9.0,5,3,4,3,10,0xb2d3099fd
106075.21,35.0,12,3,4,3,10,0x3b9b4256d
20468.38,2.0,62,2,3,2,7,0xb2d5dc4c
2656.69,1.0,11,1,2,3,6,0xb2d0bb2dd
101000.01,3.0,4,3,4,4,11,0xb2d37fe1d
240044.92,6.0,11,3,4,3,10,0xb2d24a87d
1063.39,1.0,184,1,2,1,4,0xb2d2d490d
260000.84,3.0,5,3,4,3,10,0xb2d17e91d
6647.83,4.0,0,2,4,4,10,0xb2d58e4ed
5520.13,1.0,0,2,2,4,8,0xb2d538e1
322005.51,8.0,14,4,4,3,11,0xb2d85853d
1054843.8,4.0,35,4,4,2,10,0xb2d7901ed
100005.42,2.0,143,3,3,1,7,0xb2d1c345d
120004.05,2.0,46,3,3,2,8,0xb2d0ace5
150.18,1.0,61,1,2,2,5,0xb2d69f5b
22.43,1.0,60,1,2,2,5,0xb2d24d5dd
2341.61,2.0,9,1,3,3,7,0xb2d261e7d
842225.33,4.0,80,4,4,1,9,0xb2d44f01d
52411.93,2.0,189,3,3,1,7,0xb2d513d6d
22874.42,1.0,92,2,2,1,5,0xb2d290e3d
640017.84,4.0,20,4,4,2,10,0xb2d2a8ac
7334.0,1.0,12,2,2,3,7,0xb2d3f687d
388.25,2.0,20,1,3,2,6,0xb2d18f49
9764.73,2.0,92,2,3,1,6,0x3b9adc7f
1427444.92,4.0,15,4,4,3,11,0xb2d5e3f0d
3000.45,1.0,14,2,2,3,7,0xb2d57892
203019.79,2.0,259,3,3,1,7,0xb2d2c93bd
55395.96,2.0,34,3,3,2,8,0xb2d14e1ad
400712.07,3.0,22,4,4,2,10,0xb2d07a3bd
851791.11,5.0,5,4,4,3,11,0xb2d30e41d
4032.51,1.0,179,2,2,1,5,0xb2d3c93c
14006.84,1.0,19,2,2,2,6,0xb2d3b7ffd
1.62,1.0,2,1,2,4,7,0xb2d1efe2
2003.43,1.0,7,1,2,3,6,0xb2d3e831
53479.58,2.0,203,3,3,1,7,0xb2d40b9ed
964320.31,5.0,8,4,4,3,11,0xb2d430b7d
263015.39,2.0,24,3,3,2,8,0xb2d75478d
121204.5,2.0,6,3,3,3,9,0xb2d170d5d
10027.03,2.0,4,2,3,4,9,0xb2d5e528d
30648.34,2.0,154,2,3,1,6,0xb2d60979d
61180.2,2.0,24,3,3,2,8,0xb2d41cd0d
1420001.09,10.0,8,4,4,3,11,0xb2d5bcd8d
24.78,1.0,68,1,2,1,4,0xb2d8e33cd
32.82,1.0,89,1,2,1,4,0xb2d4f88bd
248182.0,8.0,0,3,4,4,11,0x3b9b2600
1296547.0,8.0,19,4,4,2,10,0xb2d0bfaa
2.56,1.0,48,1,2,2,5,0xb2d145c5
14469.93,1.0,141,2,2,1,5,0xb2d6e2b1d
5206.03,1.0,184,2,2,1,5,0xb2d1c68ed
0.86,1.0,4,1,2,4,7,0xb2d4546c
653727.5,10.0,8,4,4,3,11,0xb2d0f846d
50129.35,2.0,0,2,3,4,9,0xb2d53671
237650.14,9.0,0,3,4,4,11,0xb2d4b88e
17664.07,1.0,17,2,2,2,6,0xb2d1c288d
120002.76,2.0,179,3,3,1,7,0xb2d28a5ad
1.56,1.0,0,1,2,4,7,0xb2d51f30d
11750751.55,38.0,0,4,4,4,12,0x3b9ae419
51.59,1.0,184,1,2,1,4,0xb2d2b38ad
238993.45,4.0,0,3,4,4,11,0xb2d23618
12077.83,1.0,0,2,2,4,8,0xb2d81e42
3930.13,1.0,6,2,2,3,7,0xb2d16a2dd
350103.13,7.0,26,4,4,2,10,0xb2d10aced
437571.76,5.0,27,4,4,2,10,0xb2d31773d
2801.17,1.0,0,1,2,4,7,0xb2d6fe6ad
400362.29,2.0,6,4,3,3,10,0xb2d2b427d
3006377.8,13.0,4,4,4,4,12,0xb2d131ffd
999.02,1.0,26,1,2,2,5,0xb2d79978d
711440.06,4.0,32,4,4,2,10,0xb2d86aa4d
18413.63,1.0,184,2,2,1,5,0xb2d620e6d
100095.41,2.0,19,3,3,2,8,0xb2d0c8f8d
1532695.51,9.0,0,4,4,4,12,0xb2d3e5b1d
420032.67,6.0,5,4,4,3,11,0xb2d0ad0a
201.45,1.0,47,1,2,2,5,0xb2d33271
1043.49,1.0,7,1,2,3,6,0xb2d68c0ed
471032.39,4.0,19,4,4,2,10,0x3b9af129d
12755.46,1.0,11,2,2,3,7,0xb2d698c4d
254999.23,4.0,37,3,4,2,9,0xb2d0eef6d
144263.81,8.0,0,3,4,4,11,0x3b9ae8c2d
190067.93,6.0,0,3,4,4,11,0xb2d3b471d
159008.95,8.0,6,3,4,3,10,0xb2d613c9d
7891.51,1.0,0,2,2,4,8,0xb2d6b12ad
52200.0,3.0,1,3,4,4,11,0xb2d6c200d
2674.81,3.0,92,1,4,1,6,0x3b9b15a0d
600442.06,2.0,165,4,3,1,8,0xb2d69ad0
60080.82,4.0,3,3,4,4,11,0xb2d09c72d
2.55,1.0,54,1,2,2,5,0xb2d6b3b9
10000.11,2.0,193,2,3,1,6,0xb2d8209f
547660.95,2.0,17,4,3,2,9,0xb2d535f7d
6658.22,3.0,5,2,4,3,9,0xb2d069d1d
120019.01,2.0,111,3,3,1,7,0xb2d8d9dfd
1075000.49,17.0,0,4,4,4,12,0x3b9b405fd
80034.93,5.0,5,3,4,3,10,0xb2d58a07
86143.76,3.0,80,3,4,1,8,0xb2d62fd7
1382.87,9.0,27,1,4,2,7,0x3b9b2345d
58.46,1.0,4,1,2,4,7,0xb2d6b7d3d
5313.4,1.0,0,2,2,4,8,0xb2d5d2ddd
50001.58,2.0,73,2,3,1,6,0xb2d8dfd6
100095.43,3.0,84,3,4,1,8,0x3b9b2874d
4652.52,1.0,184,2,2,1,5,0x3b9b1a0cd
300104.68,2.0,92,4,3,1,8,0xb2d4d9cbd
14857.05,1.0,0,2,2,4,8,0xb2d7444a
600.8,1.0,0,1,2,4,7,0xb2d18029
481.34,1.0,24,1,2,2,5,0xb2d2f380d
42003.35,2.0,127,2,3,1,6,0xb2d5d0b9
3383.46,1.0,7,2,2,3,7,0xb2d34324d
2090.21,1.0,0,1,2,4,7,0xb2d41ffb
1100962.82,3.0,11,4,4,3,11,0xb2d5ad21d
531441.95,3.0,0,4,4,4,12,0x3b9b3394d
50665.87,4.0,0,2,4,4,10,0x3b9af1e9
50005.6,2.0,136,2,3,1,6,0xb2d64bd5d
200000.0,2.0,17,3,3,2,8,0xb2d6f0d2
1928401.34,4.0,32,4,4,2,10,0xb2d5806dd
6076.77,1.0,10,2,2,3,7,0xb2d8a143
347.05,3.0,10,1,4,3,8,0x3b9b42dfd
10048.34,1.0,184,2,2,1,5,0xb2d57734d
2296.26,1.0,26,1,2,2,5,0xb2d24536
34019.59,1.0,29,2,2,2,6,0xb2d273b5d
100101.38,2.0,18,3,3,2,8,0xb2d5cf2ed
202850.02,2.0,122,3,3,1,7,0xb2d1ccead
659.68,1.0,6,1,2,3,6,0xb2d32126
3082.39,1.0,0,2,2,4,8,0xb2d4f56c
150015.35,2.0,228,3,3,1,7,0xb2d593e6d
474.22,1.0,27,1,2,2,5,0xb2d2e64ad
132128.37,3.0,101,3,4,1,8,0xb2d47298
37.87,2.0,42,1,3,2,6,0xb2d5d433
131549.41,2.0,66,3,3,2,8,0xb2d6c4f6d
362300.0,10.0,0,4,4,4,12,0xb2d08b19
508273.48,20.0,3,4,4,4,12,0xb2d1c434
25625.18,1.0,7,2,2,3,7,0xb2d56fa9d
213033.8,3.0,42,3,4,2,9,0xb2d62e2bd
6898.51,1.0,0,2,2,4,8,0xb2d560a4d
2271.47,1.0,3,1,2,4,7,0xb2d31eb5d
366318.41,4.0,1,4,4,4,12,0xb2d231c2d
726.31,1.0,0,1,2,4,7,0xb2d5328ed
20170.63,1.0,0,2,2,4,8,0xb2d6a7dfd
5054781.3,5.0,0,4,4,4,12,0xb2d3c80bd
345305.29,2.0,4,4,3,4,11,0xb2d651cad
190077.24,3.0,37,3,4,2,9,0xb2d5881dd
61152.25,2.0,47,3,3,2,8,0xb2d22ca3d
39.35,1.0,41,1,2,2,5,0xb2d5f95c
28381.51,1.0,0,2,2,4,8,0xb2d63c88d
261429.43,2.0,0,3,3,4,10,0x3b9b0e1e
164609.53,3.0,34,3,4,2,9,0xb2d6fce8d
500113.24,2.0,236,4,3,1,8,0xb2d4156dd
1503651.46,4.0,11,4,4,3,11,0xb2d643d1d
185086.43,1.0,0,3,2,4,9,0xb2d4e250
1128.48,1.0,1,1,2,4,7,0xb2d8f747d
1433.06,1.0,92,1,2,1,4,0xb2d34483d
261948.38,4.0,0,3,4,4,11,0x3b9af130d
648798.49,1.0,4,4,2,4,10,0xb2d5b18d
225207.68,5.0,90,3,4,1,8,0xb2d1ffb4d
85084.06,2.0,5,3,3,3,9,0xb2d34eb8
10782.74,1.0,92,2,2,1,5,0xb2d08ffdd
373010.79,10.0,60,4,4,2,10,0xb2d39e63d
142807.42,3.0,54,3,4,2,9,0xb2d1c1a4d
3559.89,1.0,1,2,2,4,8,0xb2d3ef17
425.16,1.0,0,1,2,4,7,0xb2d6a4da
355174.42,9.0,0,4,4,4,12,0xb2d38a9c
354645.64,2.0,0,4,3,4,11,0x3b9b4295d
1411110.37,8.0,39,4,4,2,10,0xb2d0fe15d
518079.45,2.0,32,4,3,2,9,0xb2d59c12d
137106.29,5.0,3,3,4,4,11,0xb2d60406d
201.06,1.0,20,1,2,2,5,0xb2d4208e
160081.64,3.0,11,3,4,3,10,0xb2d48524d
23277.11,1.0,0,2,2,4,8,0xb2d8c4fcd
517571.17,1.0,184,4,2,1,7,0xb2d079f1d
1298.01,1.0,92,1,2,1,4,0xb2d147cdd
313003.93,2.0,89,4,3,1,8,0xb2d58418d
80125.96,2.0,48,3,3,2,8,0xb2d0eaeed
350051.44,2.0,24,4,3,2,9,0xb2d4b874
28912.81,1.0,92,2,2,1,5,0x3b9ade5fd
1002343.96,2.0,2,4,3,4,11,0xb2d1168c
622822.1,9.0,10,4,4,3,11,0xb2d18447d
2561.67,1.0,184,1,2,1,4,0xb2d0d17bd
162136.75,2.0,53,3,3,2,8,0xb2d5d185d
654.6,1.0,3,1,2,4,7,0xb2d6107b
7636.67,1.0,184,2,2,1,5,0xb2d301e4d
61.12,1.0,61,1,2,2,5,0xb2d63c2cd
3364.08,2.0,9,2,3,3,8,0x3b9b2300
1817.0,1.0,6,1,2,3,6,0xb2d54fb2
82789.51,1.0,3,3,2,4,9,0xb2d632afd
18034.35,1.0,58,2,2,2,6,0xb2d1641fd
300000.0,2.0,22,3,3,2,8,0xb2d237e8
1023.66,1.0,119,1,2,1,4,0xb2d42b92
442468.04,14.0,0,4,4,4,12,0xb2d6d39b
1107.93,1.0,35,1,2,2,5,0xb2d2a657
692973.19,6.0,24,4,4,2,10,0xb2d3e437d
10.38,3.0,54,1,4,2,7,0xb2d404fcd
2262689.54,8.0,0,4,4,4,12,0xb2d5f3af
18.71,1.0,21,1,2,2,5,0xb2d324d3
426340.15,6.0,0,4,4,4,12,0xb2d62db8d
100008.52,3.0,42,3,4,2,9,0xb2d61991d
31662.5,2.0,92,2,3,1,6,0xb2d23bded
151612.46,2.0,19,3,3,2,8,0xb2d5be64
51001.25,4.0,24,2,4,2,8,0xb2d5bf27d
1424065.67,8.0,0,4,4,4,12,0xb2d13fadd
1063.65,1.0,92,1,2,1,4,0xb2d444bdd
38.21,1.0,88,1,2,1,4,0xb2d35f14
620088.16,7.0,6,4,4,3,11,0xb2d650ecd
485.43,1.0,5,1,2,3,6,0xb2d2b241
6864.95,1.0,5,2,2,3,7,0xb2d2ffc9
3.18,1.0,19,1,2,2,5,0xb2d39064
82849.67,2.0,18,3,3,2,8,0xb2d0d999d
5007.97,1.0,160,2,2,1,5,0xb2d6d380d
500005.62,2.0,6,4,3,3,10,0xb2d22db0
1785.85,1.0,0,1,2,4,7,0xb2d63a37
40647.09,1.0,10,2,2,3,7,0xb2d38092d
2451069.24,4.0,11,4,4,3,11,0xb2d0aaa1d
1089.35,1.0,184,1,2,1,4,0xb2d29056d
3233.65,1.0,0,2,2,4,8,0xb2d6efd0
55004.18,2.0,0,3,3,4,10,0xb2d282fa
1609832.95,10.0,1,4,4,4,12,0xb2d508f7d
675467.82,3.0,21,4,4,2,10,0xb2d14fb4
21916.23,2.0,41,2,3,2,7,0xb2d08f0b
1170067.47,5.0,4,4,4,4,12,0xb2d574a2d
1144.96,1.0,184,1,2,1,4,0xb2d3ee63d
20000.6,2.0,49,2,3,2,7,0xb2d253c0
284.63,1.0,16,1,2,2,5,0xb2d26390d
1504.43,1.0,12,1,2,3,6,0xb2d638cad
457000.0,20.0,0,4,4,4,12,0xb2d53a2ad
38.97,1.0,0,1,2,4,7,0xb2d5f494
2389.45,1.0,17,1,2,2,5,0xb2d6910dd
33013.24,2.0,172,2,3,1,6,0xb2d5bd89
51714.03,2.0,143,2,3,1,6,0xb2d551e5d
50027.94,2.0,231,2,3,1,6,0xb2d622a2d
278744.35,4.0,28,3,4,2,9,0xb2d17897d
2263.56,1.0,3,1,2,4,7,0xb2d7908b
4470.57,1.0,9,2,2,3,7,0xb2d364f5d
7517.51,1.0,188,2,2,1,5,0xb2d4140cd
30.09,1.0,0,1,2,4,7,0xb2d32e25
19816.65,1.0,184,2,2,1,5,0xb2d2805bd
573634.17,6.0,25,4,4,2,10,0xb2d63cbcd
13.44,1.0,22,1,2,2,5,0xb2d2e711d
1935.94,1.0,152,1,2,1,4,0xb2d2ea52
228389.52,2.0,82,3,3,1,7,0xb2d6c27ed
200054.05,4.0,24,3,4,2,9,0xb2d317cdd
140058.94,2.0,147,3,3,1,7,0xb2d68820d
1354.03,1.0,6,1,2,3,6,0xb2d51ff3d
280084.53,3.0,20,3,4,2,9,0xb2d60b9cd
989.12,1.0,0,1,2,4,7,0xb2d59ebb
0.0,1.0,92,1,2,1,4,0xb2d35d60d
51031.73,2.0,179,2,3,1,6,0xb2d335d4
472061.23,6.0,46,4,4,2,10,0xb2d37501d
20.84,1.0,10,1,2,3,6,0xb2d6cba5
130042.76,6.0,0,3,4,4,11,0xb2d56562
100905.34,2.0,83,3,3,1,7,0xb2d317a2d
12.82,2.0,40,1,3,2,6,0xb2d5ad14d
2003.15,1.0,12,1,2,3,6,0xb2d6c050
1942.38,1.0,265,1,2,1,4,0xb2d5d703d
4940.57,1.0,9,2,2,3,7,0xb2d49d4c
123447.24,2.0,74,3,3,1,7,0xb2d65fe4d
150017.25,2.0,8,3,3,3,9,0xb2d81d34d
3459.47,1.0,1,2,2,4,8,0xb2d1a356
3180922.51,29.0,4,4,4,4,12,0xb2d24d50d
2902.47,1.0,153,2,2,1,5,0xb2d3fe8ed
97810.55,2.0,25,3,3,2,8,0xb2d5c452d
141507.07,1.0,3,3,2,4,9,0xb2d24dc9
3808.65,1.0,74,2,2,1,5,0xb2d6a3e7d
10056.14,2.0,98,2,3,1,6,0xb2d60ab2d
1149.83,1.0,92,1,2,1,4,0xb2d17c77d
228.9,1.0,9,1,2,3,6,0xb2d2fcdb
327.83,1.0,7,1,2,3,6,0xb2d50afcd
668612.09,8.0,0,4,4,4,12,0xb2d54b32d
12048.73,1.0,18,2,2,2,6,0xb2d132ebd
200.0,1.0,1,1,2,4,7,0xb2d38a5b
30730.42,1.0,38,2,2,2,6,0xb2d5a768d
200073.85,3.0,104,3,4,1,8,0xb2d5e39b
25279.52,1.0,0,2,2,4,8,0xb2d6bf96d
16760.12,2.0,0,2,3,4,9,0xb2d3119fd
55001.75,2.0,74,3,3,1,7,0xb2d2aaa6d
1402.16,1.0,9,1,2,3,6,0xb2d2e9b1d
3467.0,1.0,48,2,2,2,6,0xb2d6f18fd
40453.05,2.0,3,2,3,4,9,0xb2d61f0fd
1401.4,1.0,10,1,2,3,6,0xb2d68cb3d
51.52,1.0,18,1,2,2,5,0xb2d59b66
5889.6,1.0,0,2,2,4,8,0xb2d3948d
305332.2,2.0,22,4,3,2,9,0xb2d6ec50d
2054.95,1.0,1,1,2,4,7,0xb2d2bef3d
7173.52,1.0,0,2,2,4,8,0xb2d21105d
1115.92,1.0,92,1,2,1,4,0xb2d4866fd
188.15,1.0,60,1,2,2,5,0xb2d22369d
104033.39,2.0,14,3,3,3,9,0xb2d6541cd
402101.77,5.0,0,4,4,4,12,0xb2d6b5dad
213.46,1.0,12,1,2,3,6,0xb2d32c1ad
248500.32,2.0,46,3,3,2,8,0xb2d14c39d
16771.03,1.0,0,2,2,4,8,0xb2d2fb72
50002.11,2.0,92,2,3,1,6,0xb2d6332ad
6820.64,1.0,184,2,2,1,5,0xb2d2b126d
1886.84,1.0,47,1,2,2,5,0xb2d2fd99
1.53,1.0,21,1,2,2,5,0xb2d64261d
250888.12,2.0,30,3,3,2,8,0xb2d8c434d
4398.34,5.0,194,2,4,1,7,0x3b9b3e5dd
10015.22,2.0,53,2,3,2,7,0xb2d1943e
232011.07,5.0,18,3,4,2,9,0xb2d626e9d
377323.9,3.0,0,4,4,4,12,0xb2d0d75ed
37238.16,1.0,0,2,2,4,8,0xb2d6bdc7d
302552.95,6.0,0,4,4,4,12,0xb2d325d7d
0.0,1.0,21,1,2,2,5,0xb2d579fe
370017.73,3.0,77,4,4,1,9,0xb2d656e1
14.38,1.0,69,1,2,1,4,0xb2d85b97d
303658.34,2.0,4,4,3,4,11,0xb2d3ce26d
279.36,1.0,7,1,2,3,6,0xb2d59c8bd
275036.4,6.0,1,3,4,4,11,0xb2d51697d
61146.48,3.0,151,3,4,1,8,0xb2d33ed2d
1.11,1.0,39,1,2,2,5,0xb2d78ff8d
15197.01,1.0,0,2,2,4,8,0xb2d2aca6d
15063.43,1.0,92,2,2,1,5,0xb2d531b1d
1127.15,1.0,87,1,2,1,4,0xb2d3b9fbd
400000.07,3.0,10,4,4,3,11,0xb2d788fbd
642625.11,2.0,8,4,3,3,10,0xb2d3acccd
1010223.78,7.0,18,4,4,2,10,0xb2d2456bd
284.01,1.0,0,1,2,4,7,0xb2d79162
133628.28,17.0,0,3,4,4,11,0x3b9af1cbd
521335.83,9.0,1,4,4,4,12,0xb2d3e9c9d
1.53,1.0,11,1,2,3,6,0xb2d36d1e
1644.35,2.0,92,1,3,1,5,0xb2d3fb07d
10000.56,5.0,89,2,4,1,7,0xb2d1c716d
915520.11,3.0,0,4,4,4,12,0xb2d5264f
200002.1,2.0,7,3,3,3,9,0xb2d8eefdd
6394.43,1.0,0,2,2,4,8,0xb2d2df61d
33896.43,1.0,92,2,2,1,5,0xb2d3eee7
16.97,1.0,70,1,2,1,4,0xb2d625ffd
427.56,1.0,22,1,2,2,5,0xb2d5a178
4400.88,1.0,20,2,2,2,6,0xb2d6a24cd
1000175.88,2.0,101,4,3,1,8,0xb2d230bbd
260669.01,3.0,127,3,4,1,8,0xb2d4fc75
97.96,1.0,24,1,2,2,5,0xb2d6e179
769.84,1.0,5,1,2,3,6,0xb2d6ef83
22945.13,1.0,6,2,2,3,7,0xb2d5774f
1675.39,2.0,21,1,3,2,6,0x3b9b3920
7556.25,1.0,0,2,2,4,8,0xb2d2a9fcd
650106.24,9.0,4,4,4,4,12,0xb2d69407d
371046.75,10.0,0,4,4,4,12,0x3b9b26dcd
35874.67,1.0,42,2,2,2,6,0xb2d2c842d
135247.42,7.0,0,3,4,4,11,0x3b9b1817d
100003.24,2.0,48,3,3,2,8,0xb2d5b032
13.98,1.0,47,1,2,2,5,0xb2d253f3
828785.73,13.0,0,4,4,4,12,0x3b9af359d
20525.11,1.0,92,2,2,1,5,0xb2d1932ad
100054.77,2.0,143,3,3,1,7,0xb2d54abfd
1867057.41,9.0,6,4,4,3,11,0xb2d4bdc0d
99.94,1.0,4,1,2,4,7,0xb2d37cb1
10.58,1.0,18,1,2,2,5,0xb2d104d6
1005.33,1.0,184,1,2,1,4,0xb2d530b7d
426759.67,2.0,17,4,3,2,9,0xb2d37846d
55287.17,2.0,97,3,3,1,7,0xb2d2d004d
8465.08,1.0,295,2,2,1,5,0xb2d437f9d
13903.41,1.0,0,2,2,4,8,0xb2d517d7
1004.75,1.0,184,1,2,1,4,0xb2d24b81d
200057.01,2.0,1,3,3,4,10,0xb2d69c2ad
1367.73,1.0,0,1,2,4,7,0xb2d61b36d
700205.48,2.0,118,4,3,1,8,0xb2d0eafcd
8334.03,1.0,184,2,2,1,5,0xb2d37d47d
9.99,1.0,46,1,2,2,5,0xb2d41dfbd
259667.02,4.0,6,3,4,3,10,0xb2d35130d
396.28,1.0,70,1,2,1,4,0xb2d14f9ed
170020.43,5.0,8,3,4,3,10,0xb2d205abd
411.05,1.0,8,1,2,3,6,0xb2d4c8fa
12103.88,1.0,161,2,2,1,5,0xb2d2dfc1d
430714.96,3.0,34,4,4,2,10,0xb2d5fbe5d
505460.04,2.0,42,4,3,2,9,0xb2d6e3b9d
10166.12,2.0,0,2,3,4,9,0xb2d5fe03d
1522.46,1.0,27,1,2,2,5,0xb2d12ddf
1127.98,1.0,120,1,2,1,4,0xb2d340d2d
45.51,1.0,14,1,2,3,6,0xb2d6eb2dd
12040.85,1.0,92,2,2,1,5,0xb2d3f3cad
3657.97,1.0,15,2,2,3,7,0xb2d756bf
6237.36,1.0,0,2,2,4,8,0xb2d3fe38d
1022.55,1.0,223,1,2,1,4,0xb2d59f2ad
371045.96,5.0,0,4,4,4,12,0xb2d6571ad
4.9,1.0,29,1,2,2,5,0xb2d6bb0dd
60001.27,2.0,73,3,3,1,7,0xb2d8e1d7
3000.94,1.0,1,2,2,4,8,0xb2d5da0e
10033.58,1.0,165,2,2,1,5,0xb2d5867ed
187844.36,6.0,60,3,4,2,9,0xb2d07945d
93.87,1.0,11,1,2,3,6,0xb2d18f11
263.29,1.0,9,1,2,3,6,0xb2d082a4
629.98,1.0,16,1,2,2,5,0xb2d26a83
79.67,1.0,2,1,2,4,7,0xb2d594d9
205222.98,2.0,5,3,3,3,9,0xb2d6417ad
11200.09,2.0,140,2,3,1,6,0xb2d6ee2fd
289029.67,8.0,70,3,4,1,8,0xb2d580acd
18635.52,1.0,184,2,2,1,5,0xb2d35e07d
246387.96,3.0,85,3,4,1,8,0xb2d631c3d
105120.65,2.0,0,3,3,4,10,0xb2d32ddad
1429.9,1.0,184,1,2,1,4,0xb2d0f593d
500000.0,2.0,2,4,3,4,11,0xb2d6df2ad
10.83,1.0,3,1,2,4,7,0xb2d39e9ed
40155.18,1.0,92,2,2,1,5,0xb2d564b7d
258810.02,3.0,35,3,4,2,9,0xb2d65570d
430375.08,7.0,6,4,4,3,11,0xb2d39c88d
881153.57,5.0,0,4,4,4,12,0xb2d6f769
620118.41,3.0,209,4,4,1,9,0xb2d3ce18d
4758.96,1.0,184,2,2,1,5,0xb2d64bddd
2040.34,1.0,92,1,2,1,4,0xb2d155b8d
90000.95,4.0,6,3,4,3,10,0xb2d5c213d
7.68,1.0,4,1,2,4,7,0xb2d249c9
2008.06,2.0,1,1,3,4,8,0x3b9af429
2129.54,1.0,16,1,2,2,5,0xb2d78538d
200010.57,2.0,175,3,3,1,7,0xb2d0dbbcd
1928.22,2.0,92,1,3,1,5,0xb2d0fb76
0.01,1.0,30,1,2,2,5,0xb2d11788d
17333.37,1.0,0,2,2,4,8,0xb2d67ec4d
206190.49,2.0,235,3,3,1,7,0xb2d6dfcfd
200052.19,2.0,8,3,3,3,9,0xb2d6d026d
1490114.84,4.0,6,4,4,3,11,0xb2d41256d
64.06,1.0,47,1,2,2,5,0xb2d0d0e7d
316.74,1.0,10,1,2,3,6,0xb2d3ab8cd
354796.31,2.0,3,4,3,4,11,0xb2d65f91d
400097.46,6.0,77,4,4,1,9,0xb2d3ad84d
447208.32,2.0,25,4,3,2,9,0xb2d0ffc1d
257350.45,3.0,11,3,4,3,10,0xb2d24874d
10062.33,1.0,92,2,2,1,5,0xb2d362e2d
20468.83,2.0,154,2,3,1,6,0xb2d5dc4cd
18492.94,1.0,7,2,2,3,7,0xb2d3718cd
200012.22,2.0,14,3,3,3,9,0xb2d20867d
107528.46,3.0,20,3,4,2,9,0xb2d285d3d
2.98,1.0,89,1,2,1,4,0xb2d57883
1895.06,1.0,9,1,2,3,6,0xb2d342f3d
70044.99,6.0,1,3,4,4,11,0xb2d1065dd
9.67,1.0,0,1,2,4,7,0xb2d57485
15731.11,1.0,0,2,2,4,8,0xb2d16930
13453.25,2.0,0,2,3,4,9,0xb2d51ecb
8745.42,1.0,184,2,2,1,5,0xb2d42ccdd
40069.11,2.0,10,2,3,3,8,0xb2d6c2c2d
1765.91,1.0,31,1,2,2,5,0xb2d3b4c3d
103000.0,2.0,8,3,3,3,9,0xb2d2869cd
3720000.0,18.0,0,4,4,4,12,0xb2d176a7d
256.6,1.0,32,1,2,2,5,0xb2d6b111d
1003872.34,5.0,3,4,4,4,12,0xb2d2cbd8d
5883.07,1.0,184,2,2,1,5,0xb2d26f44d
1018.42,1.0,184,1,2,1,4,0xb2d09fa9d
423755.16,2.0,6,4,3,3,10,0xb2d3cbcbd
1.79,2.0,18,1,3,2,6,0xb2d8e9fd
7172.26,1.0,184,2,2,1,5,0xb2d2e882d
2000028.0,2.0,25,4,3,2,9,0xb2d68dfb
3.21,1.0,59,1,2,2,5,0xb2d23e3c
657.4,1.0,1,1,2,4,7,0xb2d6d8d6
715011.88,6.0,0,4,4,4,12,0xb2d2f245d
358435.06,7.0,5,4,4,3,11,0xb2d1c139
185033.16,5.0,18,3,4,2,9,0xb2d438eed
1931022.7,6.0,34,4,4,2,10,0xb2d482b5
19.9,1.0,33,1,2,2,5,0xb2d4527d
10000.11,2.0,76,2,3,1,6,0xb2d8ddc0
150025.17,4.0,42,3,4,2,9,0xb2d6424dd
1137168.66,6.0,1,4,4,4,12,0xb2d0dbc1d
550000.53,3.0,18,4,4,2,10,0xb2d6b44bd
42376.88,3.0,7,2,4,3,9,0xb2d3431bd
290229.77,2.0,0,3,3,4,10,0xb2d50cabd
530036.4,5.0,0,4,4,4,12,0xb2d10f5ed
1678105.75,65.0,0,4,4,4,12,0xb2d2d08fd
10000.53,4.0,13,2,4,3,9,0xb2d32806d
8.97,1.0,1,1,2,4,7,0xb2d31190d
61964.54,1.0,92,3,2,1,6,0xb2d58500d
1050889.63,9.0,74,4,4,1,9,0xb2d08f09d
405674.63,3.0,28,4,4,2,10,0xb2d65e27d
34.83,2.0,83,1,3,1,5,0xb2d87edc
501853.89,5.0,67,4,4,1,9,0xb2d14f32
10895.32,3.0,0,2,4,4,10,0x3b9b180fd
1011935.74,2.0,11,4,3,3,10,0xb2d6442bd
26805.61,1.0,21,2,2,2,6,0xb2d20a00d
46122.71,4.0,6,2,4,3,9,0xb2d4e417d
32.3,1.0,81,1,2,1,4,0xb2d789ea
1000000.02,2.0,155,4,3,1,8,0xb2d50591
35386.31,1.0,92,2,2,1,5,0xb2d281d7d
178764.42,2.0,0,3,3,4,10,0xb2d43254d
992518.05,16.0,11,4,4,3,11,0xb2d14615d
9.09,1.0,62,1,2,2,5,0xb2d60f6cd
426769.15,5.0,98,4,4,1,9,0xb2d22a71d
1285000.43,14.0,1,4,4,4,12,0xb2d5934ed
2248369.43,4.0,10,4,4,3,11,0xb2d4c0ae
1939.11,1.0,181,1,2,1,4,0xb2d54ef5d
9703.46,1.0,9,2,2,3,7,0xb2d2e9c0
282.4,1.0,9,1,2,3,6,0xb2d266fe
236.77,1.0,97,1,2,1,4,0xb2d28c08d
8.74,1.0,0,1,2,4,7,0xb2d27743
937045.02,8.0,165,4,4,1,9,0xb2d3160dd
22856.09,1.0,206,2,2,1,5,0xb2d64f4bd
110000.83,3.0,0,3,4,4,11,0xb2d5a7bbd
350102.48,7.0,55,4,4,2,10,0xb2d22c93d
319.37,1.0,0,1,2,4,7,0xb2d24c00
23118.52,1.0,2,2,2,4,8,0xb2d30a8cd
9176.35,2.0,184,2,3,1,6,0xb2d28a93d
4255.46,1.0,19,2,2,2,6,0xb2d5fd88d
40129.45,1.0,2,2,2,4,8,0xb2d32ed2d
180044.37,4.0,108,3,4,1,8,0xb2d1f7e6d
1338.79,2.0,4,1,3,4,8,0x3b9b17fbd
61.57,2.0,75,1,3,1,5,0xb2d102d3d
19497.5,1.0,0,2,2,4,8,0xb2d1bbc2
3.05,1.0,13,1,2,3,6,0xb2d3bb6e
2.12,1.0,20,1,2,2,5,0xb2d17bbdd
97708.63,1.0,4,3,2,4,9,0xb2d50a1fd
907.24,1.0,1,1,2,4,7,0xb2d2845cd
101497.58,3.0,77,3,4,1,8,0x3b9b48d9
2622.53,1.0,24,1,2,2,5,0xb2d2efe0
96212.74,3.0,15,3,4,3,10,0xb2d62fd7d
250000.0,6.0,0,3,4,4,11,0xb2d5fd5ed
150004.22,3.0,77,3,4,1,8,0xb2d5e248
693687.35,11.0,1,4,4,4,12,0xb2d603f1d
52026.99,1.0,12,2,2,3,7,0xb2d4fd61d
25513.8,1.0,10,2,2,3,7,0xb2d60ac6
317.81,1.0,51,1,2,2,5,0xb2d3046f
170000.0,6.0,1,3,4,4,11,0xb2d5a997d
706.24,1.0,18,1,2,2,5,0xb2d464d0
102202.72,1.0,12,3,2,3,8,0xb2d27ff6
242006.51,7.0,56,3,4,2,9,0xb2d244a4d
13174.73,1.0,184,2,2,1,5,0xb2d20338d
49.12,5.0,12,1,4,3,8,0xb2d3ce70
30000.95,2.0,74,2,3,1,6,0xb2d20e42
453140.94,4.0,11,4,4,3,11,0xb2d1c7a4d
20672.89,1.0,216,2,2,1,5,0xb2d06a9cd
4882.25,1.0,92,2,2,1,5,0xb2d16186d
160069.92,3.0,18,3,4,2,9,0xb2d6b6b3d
167104.56,2.0,0,3,3,4,10,0xb2d3c0dbd
202894.73,3.0,3,3,4,4,11,0xb2d3e5e0d
1689.02,2.0,0,1,3,4,8,0x3b9b0e3fd
206363.38,6.0,50,3,4,2,9,0xb2d45f2bd
607.05,1.0,92,1,2,1,4,0xb2d2aebed
726188.76,7.0,11,4,4,3,11,0xb2d42751d
896.45,1.0,92,1,2,1,4,0xb2d2a810d
11.52,1.0,2,1,2,4,7,0xb2d2e918
12548.37,1.0,12,2,2,3,7,0xb2d75a92d
62002.29,2.0,87,3,3,1,7,0xb2d0a66b
903711.03,6.0,18,4,4,2,10,0xb2d6f48f
171216.19,3.0,139,3,4,1,8,0xb2d28be1d
12370.91,1.0,16,2,2,2,6,0xb2d47769d
23080.59,1.0,7,2,2,3,7,0xb2d18694d
246.51,1.0,0,1,2,4,7,0xb2d5ac99d
420890.66,3.0,0,4,4,4,12,0xb2d4257dd
2002.7,1.0,137,1,2,1,4,0xb2d6f74dd
445576.03,7.0,1,4,4,4,12,0x3b9b0fd7d
170000.26,3.0,7,3,4,3,10,0xb2d16e22d
580446.19,3.0,0,4,4,4,12,0x3b9b0e1ed
90262.47,1.0,10,3,2,3,8,0xb2d41f2cd
1710000.0,8.0,0,4,4,4,12,0xb2d502dad
630297.42,6.0,8,4,4,3,11,0xb2d62106d
36614.88,1.0,184,2,2,1,5,0x3b9b3f1ad
1928.35,1.0,19,1,2,2,5,0xb2d57f72
130005.36,2.0,78,3,3,1,7,0xb2d343abd
26.0,1.0,138,1,2,1,4,0xb2d6de61d
100060.44,2.0,14,3,3,3,9,0xb2d6e641
5378.76,1.0,0,2,2,4,8,0xb2d55f5fd
104004.62,2.0,38,3,3,2,8,0xb2d5025cd
63831.78,1.0,18,3,2,2,7,0xb2d2aa4a
52033.35,2.0,179,2,3,1,6,0xb2d593f8d
3059.37,16.0,1,2,4,4,10,0x3b9b2de9d
18686.66,1.0,20,2,2,2,6,0xb2d60aa1d
383738.3,1.0,55,4,2,2,8,0xb2d0d8e8d
1493.26,1.0,92,1,2,1,4,0xb2d136b7d
249077.97,4.0,55,3,4,2,9,0xb2d21a29d
2110018.32,7.0,24,4,4,2,10,0xb2d217c6d
1220.94,1.0,184,1,2,1,4,0xb2d0b9a0d
51814.75,1.0,10,2,2,3,7,0xb2d6b391d
5373.34,1.0,1,2,2,4,8,0xb2d6b155d
267010.41,4.0,75,3,4,1,8,0xb2d3d22ad
211145.26,27.0,3,3,4,4,11,0xb2d06526d
516004.91,2.0,126,4,3,1,8,0xb2d6b049d
1311.18,1.0,1,1,2,4,7,0xb2d2868ad
200008.45,2.0,158,3,3,1,7,0xb2d6835ed
101038.48,2.0,67,3,3,1,7,0xb2d63b7fd
1686079.94,6.0,4,4,4,4,12,0xb2d0eecbd
0.81,1.0,38,1,2,2,5,0xb2d5e8de
71940.78,2.0,122,3,3,1,7,0xb2d567c0d
441470.97,4.0,0,4,4,4,12,0x3b9b33cad
434113.87,5.0,2,4,4,4,12,0xb2d38eaad
1579.42,3.0,30,1,4,2,7,0xb2d2440fd
30280.7,1.0,10,2,2,3,7,0xb2d419a6d
103204.74,2.0,39,3,3,2,8,0xb2d2bb85d
614.58,1.0,51,1,2,2,5,0xb2d37c5cd
131032.99,2.0,125,3,3,1,7,0xb2d69e88d
401424.2,3.0,34,4,4,2,10,0xb2d4a971d
40009.25,1.0,3,2,2,4,8,0xb2d6e3ddd
63583.87,3.0,5,3,4,3,10,0xb2d548ced
723331.21,5.0,53,4,4,2,10,0xb2d270c0d
1611.74,1.0,71,1,2,1,4,0xb2d0c7f6
94184.31,1.0,0,3,2,4,9,0xb2d6447ad
772.98,1.0,0,1,2,4,7,0xb2d8ea10
20165.02,2.0,196,2,3,1,6,0xb2d63742d
3738.72,1.0,5,2,2,3,7,0xb2d6faddd
30001.43,3.0,41,2,4,2,8,0xb2d5c764
3127.04,1.0,0,2,2,4,8,0xb2d85b1b
1368.72,1.0,210,1,2,1,4,0xb2d32f8c
1018292.13,2.0,163,4,3,1,8,0xb2d604e0d
1.45,1.0,74,1,2,1,4,0xb2d56f62d
15.96,1.0,9,1,2,3,6,0xb2d6f1a4d
200063.23,2.0,22,3,3,2,8,0xb2d6e824d
392394.79,3.0,1,4,4,4,12,0xb2d6363f
380004.01,2.0,90,4,3,1,8,0xb2d8c3c4
24050.73,1.0,274,2,2,1,5,0xb2d67cf5d
1011682.76,1.0,9,4,2,3,9,0xb2d2bc9bd
104126.39,5.0,1,3,4,4,11,0xb2d58066d
51021.77,3.0,7,2,4,3,9,0xb2d8d781d
10945.74,1.0,4,2,2,4,8,0xb2d3c3a9d
255.99,1.0,15,1,2,3,6,0xb2d25ba9
131533.4,14.0,0,3,4,4,11,0x3b9b3275
128142.22,4.0,1,3,4,4,11,0xb2d21024
196001.48,4.0,10,3,4,3,10,0xb2d2b1f2
50382.06,1.0,184,2,2,1,5,0xb2d400ffd
79941.06,6.0,0,3,4,4,11,0xb2d594b8d
350085.71,2.0,4,4,3,4,11,0xb2d1a541
50052.68,2.0,4,2,3,4,9,0xb2d6aba5d
2857.93,1.0,15,1,2,3,6,0xb2d8e53cd
355451.3,5.0,39,4,4,2,10,0xb2d067d8d
5066.83,1.0,3,2,2,4,8,0xb2d1fb31d
950457.17,7.0,4,4,4,4,12,0xb2d68de2d
61015.1,2.0,97,3,3,1,7,0xb2d5cf64d
94.92,1.0,0,1,2,4,7,0xb2d35806d
252944.4,3.0,122,3,4,1,8,0xb2d25a5bd
1000022.99,2.0,52,4,3,2,9,0xb2d1ce06
73192.73,1.0,1,3,2,4,9,0xb2d5c8f2d
11151.23,1.0,26,2,2,2,6,0xb2d68911d
1015.94,1.0,184,1,2,1,4,0xb2d12240d
18063.13,2.0,5,2,3,3,8,0xb2d4327cd
115.19,1.0,9,1,2,3,6,0xb2d49509
18867.6,10.0,0,2,4,4,10,0x3b9b172ad
6.34,1.0,65,1,2,2,5,0xb2d445e1
73733.36,3.0,31,3,4,2,9,0xb2d37d5bd
100041.31,4.0,4,3,4,4,11,0xb2d5ce26
22574.88,3.0,0,2,4,4,10,0xb2d240f1d
408867.8,2.0,5,4,3,3,10,0xb2d650a0d
2461.07,1.0,109,1,2,1,4,0xb2d6476bd
65327.96,3.0,24,3,4,2,9,0xb2d0e16a
12.4,1.0,42,1,2,2,5,0xb2d20e92
440023.02,4.0,21,4,4,2,10,0xb2d16177d
3698.87,1.0,0,2,2,4,8,0xb2d6bdfc
3.81,1.0,73,1,2,1,4,0xb2d4e8b9
28.02,1.0,2,1,2,4,7,0xb2d50992d
7651.77,1.0,92,2,2,1,5,0xb2d2289f
5.11,1.0,12,1,2,3,6,0xb2d78903
2340.6,2.0,124,1,3,1,5,0xb2d6882ad
35.46,1.0,3,1,2,4,7,0xb2d3eab2
207826.97,2.0,184,3,3,1,7,0xb2d62f20d
508885.9,2.0,9,4,3,3,10,0xb2d6ce89d
360.85,1.0,89,1,2,1,4,0xb2d1cb70d
70179.95,2.0,102,3,3,1,7,0xb2d627b2d
400000.0,3.0,7,4,4,3,11,0xb2d0e9aad
290147.04,7.0,3,3,4,4,11,0xb2d20c6ad
101104.4,1.0,124,3,2,1,6,0xb2d8ee0d
505.4,1.0,131,1,2,1,4,0xb2d240abd
78.89,1.0,30,1,2,2,5,0xb2d12262
1700.29,2.0,1,1,3,4,8,0xb2d0d4a3
2257.25,1.0,3,1,2,4,7,0xb2d3404ed
1052.65,1.0,184,1,2,1,4,0xb2d137dcd
53.75,1.0,18,1,2,2,5,0xb2d2e716
1680030.5,4.0,14,4,4,3,11,0xb2d8ec87
60650.54,1.0,70,3,2,1,6,0xb2d566add
160884.15,4.0,5,3,4,3,10,0xb2d092f8d
650032.25,5.0,11,4,4,3,11,0xb2d5ee6fd
80.97,1.0,2,1,2,4,7,0xb2d2aa05
1325.09,1.0,0,1,2,4,7,0xb2d2b5e4d
151406.53,2.0,70,3,3,1,7,0xb2d256a1
4031.92,2.0,17,2,3,2,7,0xb2d113d4d
60943.08,2.0,41,3,3,2,8,0xb2d25266
96.41,1.0,9,1,2,3,6,0xb2d263fdd
20.7,1.0,41,1,2,2,5,0xb2d6d135d
561440.56,5.0,8,4,4,3,11,0xb2d2252ad
500006.05,3.0,0,4,4,4,12,0xb2d57609d
1675.0,1.0,5,1,2,3,6,0xb2d690f6
50000.95,3.0,216,2,4,1,7,0xb2d63778d
69.09,1.0,70,1,2,1,4,0xb2d0ebfc
303197.87,2.0,98,4,3,1,8,0xb2d857fed
3094.77,2.0,158,2,3,1,6,0xb2d45996d
1572061.85,5.0,53,4,4,2,10,0xb2d22068d
692499.74,10.0,0,4,4,4,12,0xb2d316a8d
580877.72,4.0,105,4,4,1,9,0xb2d533df
186013.46,7.0,1,3,4,4,11,0xb2d218f2
50006.71,2.0,136,2,3,1,6,0xb2d62644d
32440.72,4.0,92,2,4,1,7,0x3b9acca4d
6303.99,1.0,20,2,2,2,6,0xb2d60a20
169066.81,1.0,9,3,2,3,8,0xb2d35439
101868.83,2.0,1,3,3,4,10,0xb2d5f002d
150417.17,3.0,139,3,4,1,8,0xb2d6e9bbd
450000.0,2.0,21,4,3,2,9,0xb2d615a6
4.75,1.0,133,1,2,1,4,0xb2d41fa1
210010.9,3.0,17,3,4,2,9,0xb2d5da7dd
304404.37,7.0,0,4,4,4,12,0xb2d175ffd
1702651.66,5.0,24,4,4,2,10,0xb2d5c5a1d
1134.14,1.0,121,1,2,1,4,0xb2d7f3c2
52589.44,3.0,0,3,4,4,11,0xb2d09c61
1010509.77,2.0,0,4,3,4,11,0xb2d4cb82
1862.8,1.0,92,1,2,1,4,0xb2d27298d
63028.14,2.0,11,3,3,3,9,0xb2d53cd1d
8.19,1.0,61,1,2,2,5,0xb2d34caed
860065.5,3.0,8,4,4,3,11,0xb2d6b59ed
75011.64,2.0,1,3,3,4,10,0xb2d54af9d
402871.0,3.0,62,4,4,2,10,0xb2d63d1dd
560013.81,11.0,38,4,4,2,10,0xb2d5354a
10001.81,2.0,181,2,3,1,6,0xb2d629cbd
14118.67,1.0,16,2,2,2,6,0xb2d22401d
1198029.24,7.0,1,4,4,4,12,0xb2d27738
500053.48,2.0,13,4,3,3,10,0xb2d6b3dfd
260070.94,3.0,66,3,4,2,9,0xb2d12a8dd
326455.0,3.0,97,4,4,1,9,0xb2d5f90bd
19195.6,1.0,0,2,2,4,8,0xb2d0be20
117134.89,4.0,0,3,4,4,11,0xb2d52e4cd
50005.86,2.0,147,2,3,1,6,0xb2d6d08a
50079.48,2.0,139,2,3,1,6,0x3b9b3d49
500015.83,2.0,87,4,3,1,8,0xb2d8c6fbd
383739.89,10.0,0,4,4,4,12,0x3b9b18d6d
875.23,1.0,50,1,2,2,5,0xb2d6f946
189.55,1.0,0,1,2,4,7,0xb2d49a53
3.41,1.0,5,1,2,3,6,0xb2d1656dd
11108.42,1.0,17,2,2,2,6,0xb2d43e9dd
5.62,1.0,21,1,2,2,5,0xb2d32730
0.5,1.0,5,1,2,3,6,0xb2d2c686
562017.72,2.0,24,4,3,2,9,0xb2d28d3dd
3889.56,1.0,0,2,2,4,8,0xb2d5d5add
33928.99,1.0,184,2,2,1,5,0xb2d3eee7d
260035.32,3.0,87,3,4,1,8,0xb2d3bafdd
140309.03,3.0,34,3,4,2,9,0xb2d238ae
1285.4,1.0,22,1,2,2,5,0xb2d24246d
4327.31,1.0,169,2,2,1,5,0xb2d68391d
356269.88,4.0,28,4,4,2,10,0xb2d3b12b
96105.89,1.0,196,3,2,1,6,0xb2d081b4d
4874.84,9.0,92,2,4,1,7,0xb2d22f26d
1014329.52,3.0,30,4,4,2,10,0xb2d2778fd
9572.2,1.0,14,2,2,3,7,0xb2d1ba86
2160.54,1.0,189,1,2,1,4,0xb2d54ff1d
548639.43,2.0,168,4,3,1,8,0xb2d17626d
220093.84,2.0,38,3,3,2,8,0xb2d1a33bd
10073.36,1.0,3,2,2,4,8,0xb2d34cffd
102168.97,3.0,70,3,4,1,8,0xb2d67edbd
170006.2,5.0,38,3,4,2,9,0xb2d6445f
300009.36,8.0,0,3,4,4,11,0xb2d517c0d
1912.99,1.0,214,1,2,1,4,0xb2d48484d
4352.92,1.0,0,2,2,4,8,0xb2d2f7ded
253.94,1.0,25,1,2,2,5,0xb2d4f7a9d
390218.54,2.0,98,4,3,1,8,0xb2d0e700d
202532.52,4.0,1,3,4,4,11,0xb2d6a4f5d
1056.22,1.0,1,1,2,4,7,0xb2d3906d
200000.0,2.0,18,3,3,2,8,0xb2d6f0d2d
300012.68,2.0,125,3,3,1,7,0xb2d716a9
4934.53,1.0,0,2,2,4,8,0xb2d59986
50000.53,2.0,164,2,3,1,6,0xb2d6cb9ed
4782.8,1.0,190,2,2,1,5,0xb2d49e55d
100101.76,2.0,80,3,3,1,7,0xb2d472bfd
490322.95,8.0,106,4,4,1,9,0xb2d425f1d
87.48,1.0,47,1,2,2,5,0xb2d3ead0
400570.03,1.0,0,4,2,4,10,0xb2d6fe23d
3130.53,1.0,92,2,2,1,5,0xb2d07e04d
60316.97,5.0,0,3,4,4,11,0x3b9b3a82d
21.85,1.0,93,1,2,1,4,0xb2d1ac64d
660972.31,6.0,4,4,4,4,12,0x3b9b1c2e
400035.59,3.0,10,4,4,3,11,0xb2d65d78
50002.11,2.0,97,2,3,1,6,0xb2d57a1e
132130.41,3.0,193,3,4,1,8,0xb2d47298d
440277.1,4.0,59,4,4,2,10,0xb2d6598cd
50243.77,2.0,92,2,3,1,6,0xb2d6023a
272013.57,4.0,0,3,4,4,11,0xb2d5bcb1d
3039.74,1.0,120,2,2,1,5,0xb2d2ba1fd
3346.26,2.0,93,2,3,1,6,0xb2d174f1d
402254.97,2.0,48,4,3,2,9,0xb2d13c84d
505060.72,3.0,9,4,4,3,11,0xb2d78300d
3.5,1.0,32,1,2,2,5,0xb2d8dfead
251990.57,2.0,122,3,3,1,7,0xb2d6a170d
435237.49,1.0,7,4,2,3,9,0xb2d1d656d
2068.89,1.0,161,1,2,1,4,0xb2d52264
248.81,1.0,1,1,2,4,7,0xb2d7807f
2000024.6,2.0,0,4,3,4,11,0xb2d6092ed
170050.78,6.0,33,3,4,2,9,0xb2d43021d
60.77,1.0,6,1,2,3,6,0xb2d14157d
50176.99,3.0,188,2,4,1,7,0xb2d5dbb6d
122153.02,2.0,181,3,3,1,7,0xb2d5cbead
1241192.84,6.0,5,4,4,3,11,0xb2d1719ad
2132.13,1.0,1,1,2,4,7,0xb2d6a0bcd
5489.89,1.0,184,2,2,1,5,0x3b9b2752d
0.0,1.0,4,1,2,4,7,0xb2d31e8e
39904.81,2.0,50,2,3,2,7,0xb2d8c814d
2273.24,1.0,92,1,2,1,4,0xb2d30c34d
10027.3,2.0,165,2,3,1,6,0xb2d5cccd
230056.74,2.0,108,3,3,1,7,0xb2d6f6d0d
3459.81,1.0,14,2,2,3,7,0xb2d5cfe2
80003.39,2.0,186,3,3,1,7,0xb2d655ffd
1161092.0,7.0,0,4,4,4,12,0xb2d6e215d
109122.7,2.0,70,3,3,1,7,0xb2d81540d
338008.4,2.0,165,4,3,1,8,0xb2d17884d
1849.26,1.0,1,1,2,4,7,0xb2d5cf92d
360245.54,9.0,55,4,4,2,10,0xb2d38a9cd
121.26,2.0,8,1,3,3,7,0x3b9b3e11d
133893.73,1.0,10,3,2,3,8,0xb2d8d6c3d
11440.43,1.0,22,2,2,2,6,0xb2d15a7bd
65.79,1.0,56,1,2,2,5,0xb2d0be06d
1661.93,1.0,13,1,2,3,6,0xb2d8d678
821.68,2.0,184,1,3,1,5,0xb2d18ad4d
200.0,1.0,0,1,2,4,7,0xb2d516b1
4176.74,1.0,0,2,2,4,8,0xb2d579bb
1110452.93,7.0,4,4,4,4,12,0xb2d1bb0ed
62504.79,1.0,0,3,2,4,9,0xb2d0d690
652851.63,2.0,0,4,3,4,11,0xb2d25fa4d
33208.71,1.0,241,2,2,1,5,0xb2d6d404d
202138.55,2.0,105,3,3,1,7,0xb2d61b3ad
2030090.01,5.0,0,4,4,4,12,0xb2d64825d
1911.42,1.0,7,1,2,3,6,0xb2d2c0ecd
1366.11,1.0,0,1,2,4,7,0xb2d8d2d7d
413.63,2.0,21,1,3,2,6,0xb2d0f697
389078.47,5.0,6,4,4,3,11,0xb2d4b429
210288.3,4.0,3,3,4,4,11,0xb2d61f15d
2511.25,1.0,6,1,2,3,6,0xb2d22461
1986.47,1.0,92,1,2,1,4,0xb2d3abe5d
302801.79,3.0,21,4,4,2,10,0xb2d5e17c
1478.95,1.0,16,1,2,2,5,0xb2d62d5e
16727.6,1.0,10,2,2,3,7,0xb2d57504d
555098.77,2.0,0,4,3,4,11,0xb2d539e6d
37410.68,1.0,2,2,2,4,8,0xb2d33fcdd
24961.06,5.0,1,2,4,4,10,0xb2d0bf44d
170173.55,2.0,52,3,3,2,8,0xb2d51616d
2977.63,1.0,2,2,2,4,8,0xb2d6a92d
12502.39,1.0,0,2,2,4,8,0xb2d2d2e6d
37487.38,2.0,2,2,3,4,9,0xb2d20f91
552014.0,1.0,0,4,2,4,10,0xb2d59cac
400078.81,1.0,0,4,2,4,10,0xb2d5f3afd
3056.36,1.0,110,2,2,1,5,0xb2d405bad
1021380.47,2.0,124,4,3,1,8,0xb2d776ecd
3.18,2.0,89,1,3,1,5,0x3b9b2e30d
326022.67,11.0,16,4,4,2,10,0xb2d16c8fd
320757.23,2.0,34,4,3,2,9,0xb2d24e9dd
695213.09,5.0,4,4,4,4,12,0xb2d66300d
450095.98,3.0,3,4,4,4,12,0xb2d3c352d
192112.18,6.0,10,3,4,3,10,0xb2d5f78bd
0.07,1.0,184,1,2,1,4,0xb2d0e79fd
1393.88,1.0,22,1,2,2,5,0xb2d2a390d
1122493.35,1.0,1,4,2,4,10,0xb2d2f028
1785.44,1.0,96,1,2,1,4,0xb2d2e0de
4306.09,1.0,143,2,2,1,5,0xb2d6c594d
1008.73,1.0,92,1,2,1,4,0xb2d2b1ddd
513003.48,5.0,14,4,4,3,11,0xb2d6a0c0d
564098.43,3.0,2,4,4,4,12,0xb2d45ab7d
2524000.87,18.0,0,4,4,4,12,0xb2d15552d
55107.54,15.0,1,3,4,4,11,0x3b9af207d
19.12,1.0,10,1,2,3,6,0xb2d56317
6.62,1.0,15,1,2,3,6,0xb2d8d201
206086.87,2.0,11,3,3,3,9,0xb2d5f2c3d
194.77,1.0,9,1,2,3,6,0xb2d45ac0
429513.6,3.0,235,4,4,1,9,0xb2d3a575d
1580976.44,9.0,0,4,4,4,12,0xb2d775ffd
616411.26,4.0,74,4,4,1,9,0xb2d64992d
48622.62,1.0,60,2,2,2,6,0xb2d4015ed
1819458.29,9.0,22,4,4,2,10,0xb2d6e6d6d
63122.99,1.0,5,3,2,3,8,0xb2d473add
32.46,1.0,48,1,2,2,5,0xb2d56da6
12099.94,1.0,0,2,2,4,8,0xb2d408bdd
497336.98,4.0,31,4,4,2,10,0xb2d2548ed
251437.63,3.0,36,3,4,2,9,0xb2d13f86
933.37,1.0,77,1,2,1,4,0xb2d35473
48412.18,5.0,1,2,4,4,10,0x3b9af3ded
545.44,1.0,75,1,2,1,4,0xb2d8dcdbd
12740.39,1.0,184,2,2,1,5,0xb2d1a7c9d
3029.0,2.0,184,2,3,1,6,0xb2d10564d
38190.97,1.0,5,2,2,3,7,0xb2d6d74cd
423711.45,3.0,20,4,4,2,10,0xb2d22d3b
210000.88,2.0,17,3,3,2,8,0xb2d3c252
11389.74,1.0,2,2,2,4,8,0xb2d6a2e4
20088.4,1.0,184,2,2,1,5,0xb2d5cc50d
1937.8,1.0,244,1,2,1,4,0xb2d2ea52d
2192.78,1.0,191,1,2,1,4,0xb2d27876d
217.97,1.0,19,1,2,2,5,0xb2d5dd11
150869.92,3.0,53,3,4,2,9,0xb2d46e49d
7598.68,1.0,53,2,2,2,6,0xb2d39cea
101106.35,3.0,0,3,4,4,11,0xb2d6a504
220215.3,4.0,0,3,4,4,11,0xb2d326dfd
496.48,1.0,110,1,2,1,4,0xb2d1779fd
546.74,1.0,18,1,2,2,5,0xb2d586e9
15466.57,3.0,184,2,4,1,7,0xb2d172cfd
450.38,1.0,35,1,2,2,5,0xb2d259ecd
8424.06,2.0,9,2,3,3,8,0xb2d3b9a6d
508887.12,2.0,24,4,3,2,9,0xb2d8d0d3d
14691.93,1.0,5,2,2,3,7,0xb2d266fed
2.0,1.0,28,1,2,2,5,0xb2d6aa47
140042.75,7.0,8,3,4,3,10,0xb2d56562d
445106.67,3.0,9,4,4,3,11,0xb2d59a24d
122435.44,1.0,10,3,2,3,8,0xb2d309af
0.62,1.0,7,1,2,3,6,0xb2d5b273d
336502.89,4.0,104,4,4,1,9,0xb2d23911d
21084.03,2.0,92,2,3,1,6,0xb2d0bf04d
150029.26,2.0,11,3,3,3,9,0xb2d0d597
2.06,2.0,89,1,3,1,5,0xb2d4c3ffd
236.33,1.0,18,1,2,2,5,0xb2d65382
1014.51,1.0,92,1,2,1,4,0xb2d14c1a
400104.52,3.0,6,4,4,3,11,0xb2d85d01d
208129.39,2.0,41,3,3,2,8,0xb2d20782d
3124.49,2.0,1,2,3,4,9,0x3b9b3b05
29177.03,1.0,8,2,2,3,7,0xb2d5c065d
9.3,1.0,52,1,2,2,5,0xb2d3b950d
4203.71,1.0,1,2,2,4,8,0xb2d70210d
1217.09,1.0,207,1,2,1,4,0xb2d6f34ed
1457.63,1.0,92,1,2,1,4,0xb2d2a130d
316.23,1.0,14,1,2,3,6,0xb2d1cb55d
2334.33,1.0,184,1,2,1,4,0xb2d2f34fd
205966.1,2.0,136,3,3,1,7,0xb2d283d7d
400024.92,2.0,18,4,3,2,9,0xb2d78fc3d
130769.67,3.0,50,3,4,2,9,0xb2d5d273
1799.26,1.0,0,1,2,4,7,0xb2d5bdebd
9278.37,1.0,14,2,2,3,7,0xb2d5eeeb
20179.55,2.0,101,2,3,1,6,0xb2d58224d
311254.03,3.0,21,4,4,2,10,0xb2d6b3bfd
2156.04,3.0,11,1,4,3,8,0x3b9b29a1
638.49,1.0,18,1,2,2,5,0xb2d276e4d
5339543.38,16.0,0,4,4,4,12,0xb2d06f4bd
10000.11,2.0,111,2,3,1,6,0xb2d459c4d
185.09,1.0,2,1,2,4,7,0xb2d6f384d
47.03,1.0,34,1,2,2,5,0xb2d2f02cd
230060.06,3.0,12,3,4,3,10,0xb2d62c5ed
4553.51,3.0,2,2,4,4,10,0xb2d78ec2d
100301.14,1.0,92,3,2,1,6,0xb2d3055bd
1009.05,2.0,184,1,3,1,5,0xb2d14703d
476016.77,5.0,18,4,4,2,10,0xb2d0bbe3
145429.37,3.0,5,3,4,3,10,0xb2d1abf3
0.8,1.0,0,1,2,4,7,0xb2d6f2cdd
1357464.93,8.0,67,4,4,1,9,0xb2d3e5c2d
8415.07,1.0,5,2,2,3,7,0xb2d2a51d
1495278.55,34.0,7,4,4,3,11,0xb2d15a08d
94579.44,1.0,8,3,2,3,8,0xb2d1570cd
193108.05,3.0,7,3,4,3,10,0xb2d07d92d
512443.27,2.0,124,4,3,1,8,0xb2d77275d
1496.75,1.0,132,1,2,1,4,0xb2d1bfe7
79.56,1.0,34,1,2,2,5,0xb2d802c5
4427.37,7.0,189,2,4,1,7,0x3b9ada67
2905.77,1.0,0,2,2,4,8,0xb2d6bcfdd
2743.67,1.0,136,1,2,1,4,0xb2d8dc60d
4297.68,1.0,46,2,2,2,6,0xb2d8349cd
23.91,1.0,63,1,2,2,5,0xb2d42b0bd
581201.89,8.0,10,4,4,3,11,0x3b9b338e
0.53,1.0,131,1,2,1,4,0xb2d6f895d
1622.88,1.0,10,1,2,3,6,0xb2d342e8d
770.7,1.0,34,1,2,2,5,0xb2d166ced
4677.94,1.0,9,2,2,3,7,0xb2d4a9fd
2.5,1.0,17,1,2,2,5,0xb2d6bba4
18331.77,1.0,2,2,2,4,8,0xb2d62338
566.14,1.0,4,1,2,4,7,0xb2d42d81d
270045.59,3.0,25,3,4,2,9,0xb2d37741d
40003.47,2.0,266,2,3,1,6,0xb2d6362d
136068.51,6.0,87,3,4,1,8,0xb2d5c646d
1163001.49,2.0,1,4,3,4,11,0xb2d1b3f1d
348444.15,1.0,39,4,2,2,8,0xb2d10546d
2250036.1,4.0,175,4,4,1,9,0xb2d4e86ad
50025.92,2.0,92,2,3,1,6,0xb2d59586
200071.51,2.0,11,3,3,3,9,0xb2d5afc3d
323.5,2.0,12,1,3,3,7,0xb2d5dcc4d
3701.08,1.0,9,2,2,3,7,0xb2d33697
1000122.56,2.0,70,4,3,1,8,0xb2d2042bd
10167.23,1.0,82,2,2,1,5,0xb2d632c5d
35930.64,2.0,0,2,3,4,9,0xb2d5e837
40011.74,1.0,35,2,2,2,6,0xb2d581cbd
70042.19,6.0,10,3,4,3,10,0xb2d53d0fd
118.16,1.0,9,1,2,3,6,0xb2d4b898
20.78,1.0,1,1,2,4,7,0xb2d20a27
37185.53,1.0,0,2,2,4,8,0xb2d52468d
123069.92,3.0,66,3,4,2,9,0xb2d5552dd
8973.65,1.0,0,2,2,4,8,0xb2d8eb4ed
1362.66,2.0,9,1,3,3,7,0xb2d0af7ad
7364.52,1.0,3,2,2,4,8,0xb2d54b9b
215878.21,2.0,16,3,3,2,8,0xb2d3fa6bd
536923.26,4.0,7,4,4,3,11,0xb2d20808d
1000.0,1.0,0,1,2,4,7,0xb2d31426
44.78,1.0,42,1,2,2,5,0xb2d8f4dc
360758.67,6.0,0,4,4,4,12,0xb2d63147d
278022.73,3.0,111,3,4,1,8,0xb2d171e7d
1710000.0,5.0,0,4,4,4,12,0xb2d645a6d
200031.85,2.0,217,3,3,1,7,0xb2d189c6d
90927.13,2.0,0,3,3,4,10,0xb2d68dfcd
200005.35,3.0,11,3,4,3,10,0xb2d5b032d
283077.95,2.0,0,3,3,4,10,0xb2d5b5e8
4366.43,1.0,3,2,2,4,8,0xb2d6bb5a
50033.87,3.0,55,2,4,2,8,0xb2d08962
200583.58,3.0,11,3,4,3,10,0xb2d64d2c
68.7,1.0,5,1,2,3,6,0xb2d6f268
291534.88,3.0,7,3,4,3,10,0x3b9b100ad
216636.08,4.0,0,3,4,4,11,0xb2d1199a
865415.79,9.0,4,4,4,4,12,0xb2d59a5ed
3017.34,1.0,6,2,2,3,7,0xb2d6f013d
241388.5,5.0,14,3,4,3,10,0xb2d1ac4d
123013.81,4.0,59,3,4,2,9,0xb2d59146d
7936.67,1.0,14,2,2,3,7,0xb2d6e304d
1807.81,1.0,184,1,2,1,4,0x3b9b16e5d
58126.83,5.0,3,3,4,4,11,0xb2d5303bd
29.84,1.0,11,1,2,3,6,0xb2d1ea1d
14001.37,3.0,75,2,4,1,7,0xb2d12990d
1045.55,1.0,127,1,2,1,4,0xb2d0c91bd
1504314.51,7.0,11,4,4,3,11,0xb2d7e090d
28.74,1.0,60,1,2,2,5,0xb2d57cd9
24.82,1.0,92,1,2,1,4,0xb2d3a6e4d
1370.03,1.0,302,1,2,1,4,0xb2d32f8cd
635000.4,3.0,3,4,4,4,12,0xb2d29a13
836.4,9.0,19,1,4,2,7,0xb2d3504f
51.27,1.0,6,1,2,3,6,0xb2d27c39
5190.07,1.0,13,2,2,3,7,0xb2d8c398d
523.44,1.0,15,1,2,3,6,0xb2d400dbd
55015.76,2.0,15,3,3,3,9,0xb2d0eb3c
2346.69,1.0,82,1,2,1,4,0xb2d0ec4c
70004.01,3.0,97,3,4,1,8,0xb2d65871d
3090.26,1.0,113,2,2,1,5,0xb2d40563
5884.39,1.0,0,2,2,4,8,0xb2d0b490d
362305.61,3.0,64,4,4,2,10,0xb2d68916d
561283.25,6.0,31,4,4,2,10,0xb2d5c5fed
17919.98,1.0,0,2,2,4,8,0xb2d68cdd
200101.34,4.0,62,3,4,2,9,0xb2d3bb09d
567357.45,1.0,0,4,2,4,10,0xb2d3ed3cd
75072.12,2.0,235,3,3,1,7,0xb2d24cb8d
597462.4,7.0,4,4,4,4,12,0xb2d1228bd
87917.89,1.0,1,3,2,4,9,0xb2d327eed
5.48,1.0,0,1,2,4,7,0xb2d2f4b1
2097.37,1.0,0,1,2,4,7,0xb2d8cb1dd
110112.84,2.0,80,3,3,1,7,0xb2d0f5b5d
250002.64,3.0,31,3,4,2,9,0xb2d6ef32d
145406.39,16.0,0,3,4,4,11,0x3b9b3275d
251071.35,3.0,0,3,4,4,11,0xb2d45796d
302.72,1.0,92,1,2,1,4,0xb2d3a182d
159984.88,1.0,0,3,2,4,9,0xb2d21126d
6615.01,1.0,12,2,2,3,7,0xb2d6ff6ad
1416.04,1.0,10,1,2,3,6,0xb2d3e832
156525.46,3.0,231,3,4,1,8,0xb2d3ec28d
212437.59,3.0,101,3,4,1,8,0xb2d0fed0d
338124.09,6.0,0,4,4,4,12,0x3b9b45e8d
57993.18,1.0,3,3,2,4,9,0xb2d55c3fd
1388.67,1.0,10,1,2,3,6,0xb2d78b7dd
9091.98,1.0,92,2,2,1,5,0xb2d2754cd
10094744.81,2.0,1,4,3,4,11,0xb2d4f1a9d
80004.65,2.0,92,3,3,1,7,0xb2d6003fd
36696.0,2.0,9,2,3,3,8,0xb2d8256ad
1930.07,2.0,184,1,3,1,5,0xb2d0fb76d
80435.85,4.0,6,3,4,3,10,0xb2d53605d
329066.59,13.0,18,4,4,2,10,0xb2d62e3fd
33632.75,1.0,45,2,2,2,6,0xb2d33a2dd
500000.04,2.0,11,4,3,3,10,0xb2d8e65d
200436.39,1.0,81,3,2,1,6,0xb2d6d459
29573.56,1.0,76,2,2,1,5,0xb2d4698ad
242006.69,5.0,90,3,4,1,8,0xb2d600e8d
100467.96,3.0,6,3,4,3,10,0xb2d15abdd
70763.99,4.0,22,3,4,2,9,0xb2d0e16ad
5658.6,3.0,0,2,4,4,10,0xb2d2766dd
280567.33,4.0,74,3,4,1,8,0xb2d075d0d
1204653.42,50.0,3,4,4,4,12,0x3b9b0fa1d
4546870.73,7.0,65,4,4,2,10,0xb2d8dcbbd
110376.54,4.0,0,3,4,4,11,0xb2d0d6f9d
222205.65,4.0,3,3,4,4,11,0xb2d38004
940109.87,3.0,2,4,4,4,12,0xb2d14a13d
1093.88,1.0,1,1,2,4,7,0xb2d704a0
501781.17,6.0,38,4,4,2,10,0xb2d62b45d
31127.44,1.0,20,2,2,2,6,0xb2d6bdd2d
27404.89,1.0,0,2,2,4,8,0xb2d1fe07d
144.14,1.0,21,1,2,2,5,0xb2d5d8add
250086.87,5.0,5,3,4,3,10,0xb2d2204ed
40447.18,1.0,0,2,2,4,8,0xb2d1db2a
40873.15,3.0,62,2,4,2,8,0xb2d5c772d
2523.23,1.0,92,1,2,1,4,0xb2d37152d
165016.9,4.0,56,3,4,2,9,0xb2d6536dd
51045.72,2.0,185,2,3,1,6,0xb2d61fbdd
105231.83,1.0,92,3,2,1,6,0xb2d167d6d
135045.02,5.0,97,3,4,1,8,0xb2d1083fd
301065.63,2.0,32,4,3,2,9,0xb2d5c7a6d
15481.68,1.0,92,2,2,1,5,0xb2d402c6d
395.41,1.0,13,1,2,3,6,0xb2d8fab5
926.86,1.0,0,1,2,4,7,0xb2d437f2d
3208.68,1.0,34,2,2,2,6,0xb2d10467
136.31,1.0,7,1,2,3,6,0xb2d3ab40d
7438.65,1.0,92,2,2,1,5,0xb2d321cc
0.0,1.0,4,1,2,4,7,0xb2d658b0
2856.29,1.0,0,1,2,4,7,0xb2d8236cd
52186.21,1.0,18,3,2,2,7,0xb2d4da87d
48941.46,1.0,149,2,2,1,5,0xb2d695c2
53229.06,2.0,0,3,3,4,10,0xb2d35161d
3566.97,1.0,189,2,2,1,5,0xb2d1ddacd
2687876.13,6.0,4,4,4,4,12,0x3b9b32b3d
210844.94,2.0,1,3,3,4,10,0xb2d3a5afd
330002.51,2.0,10,4,3,3,10,0xb2d1a2aed
1977021.47,6.0,19,4,4,2,10,0xb2d482b5d
12990.59,2.0,0,2,3,4,9,0xb2d5c227d
81.58,1.0,95,1,2,1,4,0xb2d2cecc
1923.66,1.0,17,1,2,2,5,0xb2d1a8e0
125438.84,4.0,0,3,4,4,11,0xb2d3b9e6d
82800.29,2.0,0,3,3,4,10,0xb2d43a40d
2144808.64,1.0,0,4,2,4,10,0xb2d12357d
452466.12,14.0,6,4,4,3,11,0xb2d30730d
600058.29,2.0,67,4,3,1,8,0xb2d24e64d
2.64,1.0,39,1,2,2,5,0xb2d112cf
41755.58,1.0,7,2,2,3,7,0xb2d2d16cd
2590.88,1.0,1,1,2,4,7,0xb2d33d8f
20059.37,1.0,8,2,2,3,7,0xb2d37f17
153880.77,1.0,0,3,2,4,9,0xb2d78334d
842404.74,13.0,47,4,4,2,10,0xb2d10242d
2137.21,1.0,184,1,2,1,4,0xb2d23ed8d
55152.63,2.0,184,3,3,1,7,0x3b9b3ad9d
3937.95,1.0,14,2,2,3,7,0xb2d685a4d
72264.0,1.0,41,3,2,2,7,0xb2d5faead
845043.1,10.0,33,4,4,2,10,0xb2d419c2d
1002.0,1.0,0,1,2,4,7,0xb2d12c75
70003.73,2.0,63,3,3,2,8,0xb2d2a1cc
50061.7,2.0,196,2,3,1,6,0xb2d60c28d
390029.08,3.0,13,4,4,3,11,0xb2d219acd
402408.42,4.0,184,4,4,1,9,0xb2d0b368d
0.0,1.0,8,1,2,3,6,0xb2d460e1
201795.23,3.0,4,3,4,4,11,0xb2d3342dd
11868.14,1.0,291,2,2,1,5,0xb2d6075dd
661150.74,4.0,18,4,4,2,10,0xb2d1b5d9d
457.95,1.0,3,1,2,4,7,0xb2d39b83d
462274.77,3.0,4,4,4,4,12,0xb2d1a2abd
1125480.67,17.0,0,4,4,4,12,0xb2d0d59fd
332.95,1.0,25,1,2,2,5,0xb2d2efe0d
876606.72,3.0,14,4,4,3,11,0xb2d1bb4dd
345866.34,3.0,5,4,4,3,11,0xb2d0e8e9
10991.33,1.0,0,2,2,4,8,0xb2d51544d
134909.88,2.0,0,3,3,4,10,0xb2d21352d
246.63,3.0,15,1,4,3,8,0xb2d37834
1013.75,1.0,92,1,2,1,4,0xb2d0dd02d
200523.08,6.0,4,3,4,4,11,0xb2d39ccdd
27001.42,2.0,4,2,3,4,9,0xb2d41106
624845.61,4.0,25,4,4,2,10,0xb2d0737e
150099.51,4.0,0,3,4,4,11,0xb2d4413ad
200010.78,2.0,17,3,3,2,8,0xb2d15b8ed
214038.66,4.0,18,3,4,2,9,0xb2d0b961d
508903.06,2.0,13,4,3,3,10,0xb2d62c55d
2508.83,2.0,0,1,3,4,8,0xb2d59986d
3021314.93,3.0,61,4,4,2,10,0xb2d43764
2869.82,1.0,0,1,2,4,7,0xb2d7828b
213038.75,2.0,0,3,3,4,10,0xb2d4c963d
5771.12,1.0,184,2,2,1,5,0xb2d20848d
260019.85,2.0,13,3,3,3,9,0xb2d5a16fd
449039.07,2.0,125,4,3,1,8,0xb2d254cbd
2375694.73,8.0,0,4,4,4,12,0xb2d40a01d
6041.64,1.0,92,2,2,1,5,0xb2d20ed1d
850667.79,6.0,0,4,4,4,12,0x3b9b1c2ed
2.42,1.0,65,1,2,2,5,0xb2d64987d
559374.51,8.0,48,4,4,2,10,0xb2d16c7ad
174215.08,4.0,66,3,4,2,9,0xb2d075a8d
4349.83,1.0,184,2,2,1,5,0xb2d1a4b1d
1526.42,1.0,92,1,2,1,4,0xb2d0d06f
400000.0,3.0,2,4,4,4,12,0xb2d58c66
663000.45,12.0,0,4,4,4,12,0xb2d6596bd
240196.68,3.0,0,3,4,4,11,0xb2d0d665d
2020.75,1.0,1,1,2,4,7,0xb2d7a853
109319.42,1.0,92,3,2,1,6,0xb2d18b5bd
150006.12,3.0,25,3,4,2,9,0xb2d50c0b
2682.45,1.0,2,1,2,4,7,0xb2d2189b
71.17,1.0,0,1,2,4,7,0xb2d6950a
407113.83,2.0,84,4,3,1,8,0xb2d8cd4bd
37703.9,1.0,307,2,2,1,5,0xb2d141a3d
101713.0,2.0,63,3,3,2,8,0xb2d61e6cd
9875.42,1.0,92,2,2,1,5,0xb2d21385d
701882.42,5.0,16,4,4,2,10,0xb2d6c435d
150415.14,8.0,6,3,4,3,10,0xb2d52e1fd
113269.78,3.0,98,3,4,1,8,0xb2d219bbd
200056.78,2.0,3,3,3,4,10,0xb2d8ea6ed
74300.22,1.0,5,3,2,3,8,0xb2d18d4bd
5.95,1.0,18,1,2,2,5,0xb2d1115dd
1215586.91,1.0,105,4,2,1,7,0xb2d300bad
233894.86,2.0,92,3,3,1,7,0xb2d09fe2d
64732.39,1.0,18,3,2,2,7,0xb2d579fad
4414.33,3.0,0,2,4,4,10,0xb2d06c67d
15.31,1.0,21,1,2,2,5,0xb2d58caed
31061.8,2.0,4,2,3,4,9,0xb2d5ce4e
200980.92,5.0,24,3,4,2,9,0xb2d584f8d
18715.53,1.0,3,2,2,4,8,0xb2d268b6
3355.77,1.0,0,2,2,4,8,0xb2d4ac67d
170005.22,2.0,136,3,3,1,7,0xb2d61600d
131.34,1.0,12,1,2,3,6,0xb2d79014
1503.26,1.0,184,1,2,1,4,0x3b9af4e6d
66582.27,9.0,53,3,4,2,9,0xb2d0b163d
500000.0,3.0,2,4,4,4,12,0xb2d2616a
282.81,1.0,34,1,2,2,5,0xb2d3e86fd
638.94,8.0,11,1,4,3,8,0x3b9b264ad
26246.62,2.0,0,2,3,4,9,0xb2d311b2d
411182.38,4.0,60,4,4,2,10,0xb2d24768d
3.01,1.0,49,1,2,2,5,0xb2d69d36
10000.01,2.0,0,2,3,4,9,0xb2d59f1dd
47114.13,2.0,0,2,3,4,9,0xb2d563efd
845953.99,8.0,10,4,4,3,11,0xb2d64276d
788.86,1.0,32,1,2,2,5,0xb2d185e8d
306348.3,3.0,18,4,4,2,10,0xb2d2897bd
128877.89,4.0,1,3,4,4,11,0xb2d0a995
700038.12,3.0,1,4,4,4,12,0xb2d0a5cf
70096.7,2.0,74,3,3,1,7,0xb2d5c1bdd
1967993.71,1.0,184,4,2,1,7,0xb2d4ffecd
11015.37,4.0,2,2,4,4,10,0x3b9af2afd
21339.62,2.0,76,2,3,1,6,0xb2d3c522d
84146.82,2.0,106,3,3,1,7,0xb2d586c2
3651.84,1.0,10,2,2,3,7,0xb2d319ba
700978.18,6.0,35,4,4,2,10,0xb2d5b4fad
221021.1,2.0,20,3,3,2,8,0xb2d27417d
130087.72,9.0,12,3,4,3,10,0xb2d67e1bd
460000.71,3.0,0,4,4,4,12,0xb2d59b74d
905.86,1.0,72,1,2,1,4,0xb2d5c52ad
52414.82,2.0,228,3,3,1,7,0xb2d4be40d
27504.03,3.0,0,2,4,4,10,0xb2d3b581d
79.53,1.0,1,1,2,4,7,0xb2d69ec8
236842.03,1.0,105,3,2,1,6,0xb2d150a6d
232378.07,4.0,14,3,4,3,10,0xb2d68dc3d
95026.27,2.0,228,3,3,1,7,0xb2d29878d
228459.98,1.0,182,3,2,1,6,0xb2d406fcd
10002.41,2.0,14,2,3,3,8,0xb2d8ce78d
500888.99,3.0,10,4,4,3,11,0xb2d6d80a
370005.77,11.0,15,4,4,3,11,0xb2d5ed2e
300712.1,3.0,96,4,4,1,9,0xb2d292c9d
1787.22,1.0,12,1,2,3,6,0xb2d40062d
580901.82,4.0,0,4,4,4,12,0xb2d576b1d
75454.14,4.0,0,3,4,4,11,0xb2d2b1a1d
18285.74,1.0,184,2,2,1,5,0xb2d24dd2d
12200.92,20.0,11,2,4,3,9,0xb2d0f855d
70193.02,1.0,92,3,2,1,6,0xb2d5f373d
228.26,1.0,0,1,2,4,7,0xb2d6f32b
15000.16,2.0,66,2,3,2,7,0xb2d8f1bed
1149.01,2.0,92,1,3,1,5,0xb2d38e4e
500099.37,4.0,21,4,4,2,10,0xb2d137fd
300007.7,3.0,0,3,4,4,11,0xb2d1eeb6d
75716.66,2.0,18,3,3,2,8,0xb2d649efd
4455.81,1.0,0,2,2,4,8,0xb2d78b9ad
2.34,1.0,22,1,2,2,5,0xb2d78208
50278.88,2.0,18,2,3,2,7,0xb2d56f94d
38001.6,2.0,195,2,3,1,6,0xb2d5d3d2d
108.77,1.0,21,1,2,2,5,0xb2d4a454
4.44,2.0,67,1,3,1,5,0xb2d6c294
51512.78,1.0,10,2,2,3,7,0xb2d3454b
640001.36,3.0,5,4,4,3,11,0xb2d1026a
409527.32,3.0,7,4,4,3,11,0xb2d65335d
16255.78,1.0,0,2,2,4,8,0xb2d390d9
113350.96,2.0,7,3,3,3,9,0xb2d2c754d
763658.76,2.0,0,4,3,4,11,0xb2d40294d
51028.34,2.0,165,2,3,1,6,0xb2d5b027d
11.54,1.0,85,1,2,1,4,0xb2d7c272d
185.51,1.0,84,1,2,1,4,0xb2d58e15d
0.0,1.0,3,1,2,4,7,0xb2d86c26
863255.83,11.0,10,4,4,3,11,0xb2d36267
20414.88,1.0,274,2,2,1,5,0xb2d5efd1d
37782.09,1.0,10,2,2,3,7,0xb2d5cfd9
3197.63,1.0,184,2,2,1,5,0xb2d15ddbd
2746.54,1.0,92,1,2,1,4,0xb2d3a81cd
203003.92,2.0,37,3,3,2,8,0xb2d68dd9d
51081.85,1.0,19,2,2,2,6,0xb2d7fcff
300005.28,3.0,38,3,4,2,9,0xb2d78271
1015678.62,3.0,18,4,4,2,10,0xb2d41673d
700351.17,2.0,181,4,3,1,8,0xb2d220bfd
103552.17,1.0,7,3,2,3,8,0xb2d628d8
377385.69,4.0,21,4,4,2,10,0xb2d245b2d
5964325.75,6.0,0,4,4,4,12,0xb2d15c67d
51627.62,1.0,1,2,2,4,8,0xb2d0ead3
299020.24,4.0,12,3,4,3,10,0xb2d6dbb4d
4.59,1.0,16,1,2,2,5,0xb2d59416
100409.67,3.0,167,3,4,1,8,0xb2d5cb47d
500015.85,2.0,186,4,3,1,8,0xb2d86d25d
530695.69,2.0,6,4,3,3,10,0xb2d56eead
680194.33,3.0,14,4,4,3,11,0xb2d26262
17780.59,1.0,0,2,2,4,8,0xb2d2d7b4d
10403.73,1.0,0,2,2,4,8,0xb2d59a15d
1488.72,1.0,184,1,2,1,4,0xb2d20f40d
207882.13,2.0,17,3,3,2,8,0xb2d62436d
312007.26,5.0,83,4,4,1,9,0xb2d085c5d
279.8,3.0,92,1,4,1,6,0xb2d0a441
1340718.2,7.0,20,4,4,2,10,0xb2d122b9d
100035.92,2.0,153,3,3,1,7,0xb2d17b98d
109678.23,5.0,3,3,4,4,11,0xb2d3fcafd
2924.8,9.0,0,2,4,4,10,0xb2d068be
271665.64,2.0,186,3,3,1,7,0x3b9b3167d
67321.27,1.0,287,3,2,1,6,0xb2d1b540d
25.64,1.0,12,1,2,3,6,0xb2d346f5
1015.48,1.0,184,1,2,1,4,0xb2d14c1ad
7659.12,1.0,184,2,2,1,5,0xb2d2289fd
29644.9,2.0,1,2,3,4,9,0xb2d08385d
81.97,2.0,5,1,3,3,7,0xb2d2dbb2
51531.03,1.0,308,2,2,1,5,0xb2d40710d
2152.21,1.0,2,1,2,4,7,0xb2d44de8
258227.11,2.0,30,3,3,2,8,0xb2d6eec3d
5.86,1.0,1,1,2,4,7,0xb2d5a9f7
1133043.16,4.0,3,4,4,4,12,0xb2d3b008d
0.32,1.0,0,1,2,4,7,0xb2d68097
1992.48,1.0,0,1,2,4,7,0xb2d6bff4d
7461.56,1.0,15,2,2,3,7,0xb2d8cff5d
1005192.71,8.0,1,4,4,4,12,0xb2d1a847d
12804.92,1.0,92,2,2,1,5,0xb2d39d15d
570064.35,4.0,2,4,4,4,12,0xb2d8f79cd
1100143.88,6.0,5,4,4,3,11,0xb2d649e7d
180446.52,3.0,13,3,4,3,10,0x3b9b2d71d
50040.83,2.0,167,2,3,1,6,0xb2d43833d
1020021.91,5.0,12,4,4,3,11,0xb2d5b6c9d
107623.4,2.0,1,3,3,4,10,0xb2d28cddd
1854066.54,6.0,20,4,4,2,10,0xb2d17c79d
118086.56,6.0,42,3,4,2,9,0xb2d11c7c
10638.03,1.0,0,2,2,4,8,0xb2d47e84
520025.06,6.0,6,4,4,3,11,0xb2d56337d
766000.11,6.0,13,4,4,3,11,0xb2d2e219d
200402.71,1.0,0,3,2,4,9,0xb2d21a4dd
300049.49,3.0,12,3,4,3,10,0xb2d12514
250162.92,2.0,92,3,3,1,7,0xb2d63766d
6160.48,1.0,21,2,2,2,6,0xb2d60a20d
20000.0,2.0,3,2,3,4,9,0xb2d5c22fd
541.44,1.0,21,1,2,2,5,0xb2d1e684
457.71,1.0,4,1,2,4,7,0xb2d2a7d1
250091.95,3.0,11,3,4,3,10,0xb2d3a690
270019.17,3.0,11,3,4,3,10,0xb2d3fe1a
1082702.69,1.0,1,4,2,4,10,0xb2d1b879d
16.12,1.0,70,1,2,1,4,0xb2d6b51b
120011.9,2.0,46,3,3,2,8,0xb2d5eba2
4062.28,3.0,12,2,4,3,9,0xb2d2d7e6d
245108.18,2.0,48,3,3,2,8,0xb2d60a6ed
1323.96,3.0,0,1,4,4,9,0x3b9b12a6d
351881.52,4.0,74,4,4,1,9,0xb2d21058d
118018.27,3.0,0,3,4,4,11,0xb2d3cbf5d
660.59,1.0,71,1,2,1,4,0xb2d32e83d
228789.65,2.0,196,3,3,1,7,0xb2d5d388d
34.31,1.0,24,1,2,2,5,0xb2d86994
58902.14,1.0,4,3,2,4,9,0xb2d38361
6.42,1.0,12,1,2,3,6,0xb2d50ce3d
3141.05,1.0,113,2,2,1,5,0xb2d4a320d
250108.32,2.0,129,3,3,1,7,0xb2d1bb4cd
22685.65,1.0,1,2,2,4,8,0xb2d6cc4c
650000.0,11.0,0,4,4,4,12,0xb2d5354ad
457000.0,17.0,0,4,4,4,12,0xb2d0984cd
100006.11,2.0,25,3,3,2,8,0xb2d1422d
3606.36,2.0,13,2,3,3,8,0xb2d078bad
590010.93,5.0,11,4,4,3,11,0xb2d43050d
200069.35,2.0,69,3,3,1,7,0xb2d236b9d
10000.0,1.0,0,2,2,4,8,0xb2d0e83fd
90291.32,7.0,0,3,4,4,11,0xb2d57c51
594517.28,2.0,0,4,3,4,11,0xb2d3ba0cd
1059.17,2.0,236,1,3,1,5,0x3b9b4a27d
104.66,1.0,13,1,2,3,6,0xb2d30a45d
270051.29,3.0,52,3,4,2,9,0xb2d1e71ed
200381.81,3.0,7,3,4,3,10,0xb2d88fc2d
5761.64,1.0,3,2,2,4,8,0xb2d2e5f4
39918.15,1.0,15,2,2,3,7,0xb2d53829d
1243.73,1.0,92,1,2,1,4,0xb2d2c8efd
453723.19,6.0,0,4,4,4,12,0xb2d311cad
65500.4,1.0,10,3,2,3,8,0xb2d78d50d
100085.67,3.0,97,3,4,1,8,0xb2d0681dd
10064.14,1.0,184,2,2,1,5,0xb2d562bfd
191332.45,2.0,83,3,3,1,7,0xb2d5e5c1d
10190.49,2.0,101,2,3,1,6,0xb2d64a80d
2003.57,2.0,144,1,3,1,5,0xb2d25263
780087.47,7.0,1,4,4,4,12,0xb2d16c81
422863.07,4.0,0,4,4,4,12,0xb2d40f6fd
286562.79,4.0,11,3,4,3,10,0xb2d24397d
51893.01,2.0,101,2,3,1,6,0xb2d58641d
140718.49,4.0,1,3,4,4,11,0xb2d57cd0d
133094.49,3.0,80,3,4,1,8,0xb2d24f90
579000.86,6.0,2,4,4,4,12,0xb2d0db90d
300045.43,3.0,4,3,4,4,11,0xb2d54ac8d
125130.35,2.0,224,3,3,1,7,0xb2d4fe58d
3578.88,1.0,184,2,2,1,5,0xb2d22024d
10.07,1.0,4,1,2,4,7,0xb2d6c5e3d
335085.33,4.0,101,4,4,1,9,0xb2d16e87d
300589.46,4.0,101,4,4,1,9,0xb2d6415c
103.3,7.0,39,1,4,2,7,0xb2d43932d
1602.72,1.0,9,1,2,3,6,0xb2d8d123
600022.22,4.0,7,4,4,3,11,0xb2d11266d
2763.59,1.0,10,1,2,3,6,0xb2d701bb
1331.83,2.0,2,1,3,4,8,0xb2d07785
214624.04,4.0,93,3,4,1,8,0x3b9b3e98d
1035.33,1.0,9,1,2,3,6,0xb2d4aad8
3120.84,1.0,138,2,2,1,5,0xb2d3bf73
111111.57,3.0,2,3,4,4,11,0xb2d23bc9d
3296.27,1.0,127,2,2,1,5,0xb2d534c9
23.99,1.0,24,1,2,2,5,0xb2d630be
21264.27,1.0,0,2,2,4,8,0xb2d54fa0d
80662.6,2.0,201,3,3,1,7,0xb2d64d82d
7809.48,1.0,25,2,2,2,6,0xb2d3139cd
16393.44,1.0,0,2,2,4,8,0xb2d58f44d
892105.76,2.0,0,4,3,4,11,0xb2d8240d
80577.91,2.0,12,3,3,3,9,0xb2d3b1aed
5697.94,1.0,1,2,2,4,8,0xb2d5c514d
414878.24,7.0,0,4,4,4,12,0xb2d620d3d
1367.37,1.0,14,1,2,3,6,0xb2d2e075d
103182.53,2.0,92,3,3,1,7,0xb2d3c1f0d
345.66,1.0,157,1,2,1,4,0xb2d65a5ed
5667.53,1.0,16,2,2,2,6,0xb2d16c0b
11575.14,1.0,0,2,2,4,8,0xb2d69fb5d
1.97,1.0,70,1,2,1,4,0xb2d5edcbd
22256.05,1.0,0,2,2,4,8,0xb2d31645d
2307.74,1.0,16,1,2,2,5,0xb2d39e0dd
6351.97,1.0,92,2,2,1,5,0xb2d1a373d
1588.86,1.0,0,1,2,4,7,0xb2d54f52
56890.94,1.0,39,3,2,2,7,0xb2d1b33f
80577.19,2.0,158,3,3,1,7,0xb2d6c7c9d
1205790.78,9.0,3,4,4,4,12,0xb2d37527d
50002.88,2.0,52,2,3,2,7,0xb2d6d1fad
37828.68,2.0,20,2,3,2,7,0xb2d231d5
16007.79,1.0,2,2,2,4,8,0xb2d846f3
0.0,1.0,0,1,2,4,7,0xb2d5d5b5
10115.91,2.0,151,2,3,1,6,0xb2d6cca2d
939914.1,1.0,1,4,2,4,10,0xb2d33e4f
455.81,1.0,1,1,2,4,7,0xb2d33b31d
7769.71,1.0,29,2,2,2,6,0xb2d6c62b
1728.05,1.0,205,1,2,1,4,0xb2d5a721d
5216.56,1.0,4,2,2,4,8,0xb2d23f0e
100.0,1.0,0,1,2,4,7,0xb2d327fad
215222.72,2.0,14,3,3,3,9,0xb2d1db5fd
320000.0,4.0,4,4,4,4,12,0xb2d11560d
25743.69,1.0,7,2,2,3,7,0xb2d68eded
122508.44,4.0,45,3,4,2,9,0xb2d77569
261696.67,1.0,154,3,2,1,6,0xb2d1a496d
56011.6,2.0,14,3,3,3,9,0xb2d57f97
644.99,1.0,10,1,2,3,6,0xb2d8c55fd
2054757.83,1.0,0,4,2,4,10,0xb2d26aedd
295153.5,2.0,33,3,3,2,8,0xb2d6de1fd
1704.5,1.0,4,1,2,4,7,0xb2d441b1d
641172.04,3.0,6,4,4,3,11,0xb2d155a7d
14986.02,1.0,92,2,2,1,5,0xb2d3afc6d
175.12,1.0,10,1,2,3,6,0xb2d8ca69d
59323.13,1.0,92,3,2,1,6,0xb2d266efd
18765.92,1.0,5,2,2,3,7,0xb2d5d7d5d
500005.28,2.0,62,4,3,2,9,0xb2d8f34a
100601.17,2.0,56,3,3,2,8,0xb2d36c81d
64.66,1.0,11,1,2,3,6,0xb2d2d88f
389046.59,5.0,4,4,4,4,12,0xb2d4b429d
400011.39,3.0,13,4,4,3,11,0xb2d62dd9d
871087.53,8.0,0,4,4,4,12,0xb2d21177d
1485.29,1.0,10,1,2,3,6,0xb2d27541d
4072.89,1.0,92,2,2,1,5,0xb2d27f67
707628.2,5.0,19,4,4,2,10,0xb2d4a24a
0.66,1.0,47,1,2,2,5,0xb2d64a23d
2499.16,3.0,184,1,4,1,6,0xb2d223e0d
20746.45,1.0,103,2,2,1,5,0xb2d614cdd
61017.18,3.0,39,3,4,2,9,0xb2d18df8
400002.92,3.0,13,4,4,3,11,0xb2d5d3ccd
6178.59,1.0,18,2,2,2,6,0xb2d2084e
8070.97,1.0,19,2,2,2,6,0xb2d35c76d
224040.57,3.0,122,3,4,1,8,0xb2d6d7bbd
80005.48,8.0,20,3,4,2,9,0xb2d576f0d
328243.23,4.0,49,4,4,2,10,0xb2d14a75d
40000.97,2.0,179,2,3,1,6,0xb2d5f557d
50150.77,1.0,106,2,2,1,5,0xb2d5e77fd
1510827.69,8.0,3,4,4,4,12,0xb2d17a03d
100048.49,4.0,4,3,4,4,11,0xb2d1c144
151697.76,1.0,10,3,2,3,8,0xb2d792d2
1813200.92,14.0,21,4,4,2,10,0xb2d44100d
200711.72,2.0,31,3,3,2,8,0xb2d6860ad
9920.81,1.0,32,2,2,2,6,0xb2d2e6bfd
465004.34,4.0,35,4,4,2,10,0xb2d2bac2d
1559.94,1.0,184,1,2,1,4,0xb2d1013bd
58.9,1.0,89,1,2,1,4,0xb2d5f341d
209022.06,4.0,37,3,4,2,9,0xb2d06505d
246132.69,5.0,8,3,4,3,10,0xb2d42e31d
85.22,2.0,78,1,3,1,5,0xb2d1a1e5d
5053.59,1.0,40,2,2,2,6,0xb2d6f01ed
706669.61,7.0,1,4,4,4,12,0xb2d51df9d
326324.77,5.0,0,4,4,4,12,0xb2d1617ad
14396.53,1.0,117,2,2,1,5,0xb2d19299
103437.39,2.0,1,3,3,4,10,0xb2d5a5e3
1364841.18,9.0,14,4,4,3,11,0xb2d5ec39d
583756.87,5.0,60,4,4,2,10,0xb2d48c31d
9913.81,1.0,1,2,2,4,8,0xb2d690b4
11249.97,1.0,10,2,2,3,7,0xb2d39f3dd
601642.26,1.0,1,4,2,4,10,0xb2d69e1a
100006.95,3.0,33,3,4,2,9,0xb2d4348bd
55890.82,2.0,206,3,3,1,7,0xb2d5c5ce
1882.88,1.0,8,1,2,3,6,0xb2d25d79
150220.22,2.0,69,3,3,1,7,0xb2d7840bd
136071.3,2.0,69,3,3,1,7,0xb2d617a0d
872068.54,12.0,6,4,4,3,11,0xb2d107c2d
84920.48,3.0,0,3,4,4,11,0xb2d25fd4
4525.6,1.0,0,2,2,4,8,0xb2d52bf0d
4930.54,1.0,0,2,2,4,8,0xb2d29b39d
993140.97,4.0,76,4,4,1,9,0xb2d42b05d
110155.12,4.0,3,3,4,4,11,0xb2d15eddd
244665.73,2.0,11,3,3,3,9,0xb2d71886d
38.26,1.0,18,1,2,2,5,0xb2d2c3b0d
588.05,1.0,18,1,2,2,5,0xb2d2e818d
57296.04,1.0,140,3,2,1,6,0xb2d11508d
79883.92,4.0,0,3,4,4,11,0x3b9b18d9d
20000.74,2.0,5,2,3,3,8,0xb2d8a007d
240016.38,3.0,3,3,4,4,11,0xb2d3c252d
28221.84,1.0,11,2,2,3,7,0xb2d68049
79.6,1.0,45,1,2,2,5,0xb2d8c51bd
100.78,1.0,21,1,2,2,5,0xb2d57786d
1421.36,1.0,11,1,2,3,6,0xb2d45cd0
803531.52,3.0,13,4,4,3,11,0xb2d3bf3bd
180026.16,3.0,18,3,4,2,9,0xb2d13cde
2.53,1.0,208,1,2,1,4,0xb2d78454
55401.75,1.0,0,3,2,4,9,0xb2d4668dd
11769.89,1.0,1,2,2,4,8,0xb2d5b0b7
50003.86,2.0,1,2,3,4,9,0xb2d51f43d
446009.4,15.0,3,4,4,4,12,0xb2d646c3
600025.95,3.0,7,4,4,3,11,0xb2d5b7ac
154978.81,1.0,82,3,2,1,6,0xb2d5c5c9d
1187693.77,3.0,3,4,4,4,12,0xb2d1b636d
380799.13,3.0,4,4,4,4,12,0xb2d77893d
665531.5,5.0,242,4,4,1,9,0xb2d6d126d
172128.75,4.0,48,3,4,2,9,0xb2d2c722d
15402.58,1.0,8,2,2,3,7,0xb2d62df4
2.04,1.0,25,1,2,2,5,0xb2d6b5a7
1088.16,1.0,132,1,2,1,4,0xb2d78e8f
166061.12,2.0,47,3,3,2,8,0xb2d1626cd
503584.19,1.0,184,4,2,1,7,0xb2d405ccd
4.98,1.0,13,1,2,3,6,0xb2d636c4d
1217.89,1.0,248,1,2,1,4,0xb2d31fd4d
1551735.9,4.0,1,4,4,4,12,0xb2d3c10fd
9451721.86,7.0,13,4,4,3,11,0xb2d68a5d
330011.63,3.0,6,4,4,3,11,0xb2d1d59f
10008.31,3.0,109,2,4,1,7,0x3b9b3f7cd
2333.49,1.0,0,1,2,4,7,0xb2d1a830
300034.69,4.0,11,3,4,3,10,0xb2d6a34dd
36568.21,1.0,2,2,2,4,8,0xb2d6acb1d
51601.32,2.0,92,2,3,1,6,0xb2d45b25d
304232.73,5.0,6,4,4,3,11,0xb2d069c9d
450684.04,4.0,5,4,4,3,11,0xb2d4ac88d
102822.72,2.0,0,3,3,4,10,0x3b9b1a4ed
235543.46,4.0,4,3,4,4,11,0xb2d4f4f8d
5251.47,1.0,0,2,2,4,8,0xb2d43a01d
1451971.08,7.0,0,4,4,4,12,0xb2d56226d
2676888.52,4.0,4,4,4,4,12,0x3b9b4694d
120069.75,2.0,157,3,3,1,7,0xb2d33006
5111.54,1.0,18,2,2,2,6,0xb2d5d574
1527.89,1.0,184,1,2,1,4,0xb2d0d06fd
353394.38,2.0,13,4,3,3,10,0xb2d61620d
2552907.79,9.0,0,4,4,4,12,0xb2d35c23
440000.11,11.0,89,4,4,1,9,0xb2d1b79bd
370672.07,5.0,0,4,4,4,12,0xb2d54ea7d
3317.46,1.0,13,2,2,3,7,0xb2d6c1e1
9365.27,1.0,18,2,2,2,6,0xb2d560dcd
70000.74,2.0,62,3,3,2,8,0xb2d8f751
161661.64,4.0,0,3,4,4,11,0xb2d6019cd
16371.9,1.0,15,2,2,3,7,0xb2d2af3dd
3864699.74,7.0,0,4,4,4,12,0xb2d564bad
51464.53,6.0,0,2,4,4,10,0x3b9b263fd
100088.72,2.0,136,3,3,1,7,0xb2d0dfc5
100022.87,2.0,80,3,3,1,7,0xb2d2a9a6d
115475.74,2.0,1,3,3,4,10,0xb2d2af22d
1873468.35,10.0,0,4,4,4,12,0x3b9b0e56
5024.21,1.0,184,2,2,1,5,0xb2d58bd6d
50842.24,1.0,0,2,2,4,8,0xb2d2a81d
2361.88,1.0,13,1,2,3,6,0xb2d2fd93d
593875.98,4.0,3,4,4,4,12,0xb2d63fa3
105000.0,4.0,4,3,4,4,11,0xb2d15c34d
5072.71,1.0,1,2,2,4,8,0xb2d2bbab
1319.52,1.0,11,1,2,3,6,0xb2d31e93
230750.9,3.0,12,3,4,3,10,0xb2d7819ed
640000.96,6.0,6,4,4,3,11,0xb2d5f02bd
83978.94,1.0,5,3,2,3,8,0xb2d31e88d
110009.18,2.0,26,3,3,2,8,0xb2d8c77e
400140.14,7.0,21,4,4,2,10,0xb2d58747d
485.55,1.0,21,1,2,2,5,0xb2d24b3ed
100302.13,1.0,279,3,2,1,6,0xb2d34e2dd
126704.89,1.0,184,3,2,1,6,0xb2d3a38ad
10000.11,2.0,76,2,3,1,6,0xb2d8dcaf
1626.61,1.0,92,1,2,1,4,0xb2d23526d
873.57,1.0,6,1,2,3,6,0xb2d32b2cd
42262.03,1.0,95,2,2,1,5,0xb2d3b415d
20.14,1.0,9,1,2,3,6,0xb2d577ff
11237.58,3.0,0,2,4,4,10,0x3b9b36bc
469040.15,4.0,25,4,4,2,10,0xb2d3933cd
745.01,1.0,22,1,2,2,5,0xb2d5c907
8102.03,1.0,9,2,2,3,7,0xb2d5d964d
1310083.73,7.0,10,4,4,3,11,0xb2d1d901d
204708.36,3.0,28,3,4,2,9,0xb2d445b7d
111637.58,3.0,8,3,4,3,10,0xb2d12894d
833719.72,6.0,28,4,4,2,10,0xb2d5ff43d
100513.88,3.0,6,3,4,3,10,0xb2d610dad
1079.63,1.0,8,1,2,3,6,0xb2d77f9d
250094.44,5.0,11,3,4,3,10,0xb2d079ae
45812.6,1.0,32,2,2,2,6,0xb2d69eaad
551554.24,4.0,6,4,4,3,11,0xb2d599b9
870.31,2.0,1,1,3,4,8,0x3b9af2a3d
2737.64,1.0,92,1,2,1,4,0xb2d071c1d
5.45,1.0,3,1,2,4,7,0xb2d310fb
2099000.89,12.0,7,4,4,3,11,0xb2d5c085d
200675.9,3.0,0,3,4,4,11,0x3b9b19e5d
217987.0,2.0,4,3,3,4,10,0xb2d35d31d
614.57,1.0,19,1,2,2,5,0xb2d2f18bd
372.65,1.0,13,1,2,3,6,0xb2d30ff7
130000.0,9.0,1,3,4,4,11,0xb2d5df7ed
100003.17,2.0,92,3,3,1,7,0xb2d676ddd
131167.8,2.0,196,3,3,1,7,0xb2d5bc9fd
1609.87,1.0,10,1,2,3,6,0xb2d69ec8d
60030.07,1.0,10,3,2,3,8,0xb2d5d489d
150004.4,3.0,8,3,4,3,10,0xb2d34f81d
373058.2,4.0,97,4,4,1,9,0xb2d5f382
512000.08,5.0,6,4,4,3,11,0xb2d6a1e3d
1150634.88,12.0,0,4,4,4,12,0xb2d07c29d
2.59,1.0,0,1,2,4,7,0xb2d572b6
102910.07,2.0,2,3,3,4,10,0xb2d1490ed
6520.16,1.0,92,2,2,1,5,0xb2d0b0cad
1843.97,1.0,0,1,2,4,7,0xb2d5bde9
38566.99,1.0,0,2,2,4,8,0xb2d40a05
200003.97,2.0,19,3,3,2,8,0xb2d69271d
50000.53,2.0,221,2,3,1,6,0xb2d708b2
152031.38,9.0,0,3,4,4,11,0x3b9b0fbcd
13.2,1.0,25,1,2,2,5,0xb2d70801d
3573.68,1.0,92,2,2,1,5,0xb2d276d9d
3777.52,1.0,9,2,2,3,7,0xb2d2be06d
1711.72,1.0,21,1,2,2,5,0xb2d134e5
485892.19,10.0,1,4,4,4,12,0xb2d5b015d
1977133.24,2.0,0,4,3,4,11,0xb2d17857d
30127.0,1.0,1,2,2,4,8,0xb2d665e5
4375.02,1.0,154,2,2,1,5,0xb2d8eb10d
502.03,1.0,10,1,2,3,6,0xb2d8eb4b
14597.37,1.0,3,2,2,4,8,0xb2d53fa1d
270002.75,11.0,18,3,4,2,9,0xb2d36fd6d
1235.93,1.0,184,1,2,1,4,0xb2d07d47d
12.81,1.0,88,1,2,1,4,0xb2d1f74a
5502.95,1.0,8,2,2,3,7,0xb2d68ceed
5156.84,1.0,184,2,2,1,5,0xb2d28779d
411019.64,9.0,11,4,4,3,11,0xb2d3d0a8d
698626.98,7.0,6,4,4,3,11,0xb2d3c547d
2113973.22,2.0,39,4,3,2,9,0xb2d56f0bd
640963.08,3.0,7,4,4,3,11,0xb2d1026ad
122.13,1.0,5,1,2,3,6,0xb2d59bd7
745298.51,1.0,5,4,2,3,9,0xb2d2f197d
3375.65,1.0,16,2,2,2,6,0xb2d14881
300091.58,4.0,104,3,4,1,8,0xb2d251bbd
426145.88,3.0,12,4,4,3,11,0xb2d10179d
6632.15,1.0,54,2,2,2,6,0xb2d41914
83247.5,3.0,186,3,4,1,8,0xb2d2e55dd
148103.66,2.0,62,3,3,2,8,0xb2d28894d
902120.33,3.0,7,4,4,3,11,0xb2d6fdaed
95230.47,6.0,0,3,4,4,11,0xb2d07f11d
260058.17,2.0,193,3,3,1,7,0xb2d587f5d
1.53,1.0,14,1,2,3,6,0xb2d3d171d
2133.45,1.0,184,1,2,1,4,0xb2d32983d
82562.34,2.0,1,3,3,4,10,0xb2d0e4ead
103923.71,2.0,92,3,3,1,7,0xb2d38016
1180000.0,33.0,1,4,4,4,12,0xb2d5d586d
125360.91,2.0,0,3,3,4,10,0xb2d26136
50223.22,2.0,70,2,3,1,6,0xb2d65b3f
16099.52,1.0,20,2,2,2,6,0xb2d60a32
203285.42,2.0,41,3,3,2,8,0xb2d5c733d
1465.94,1.0,2,1,2,4,7,0xb2d3416d
807366.22,12.0,11,4,4,3,11,0xb2d3a0c3
1.0,1.0,68,1,2,1,4,0xb2d2176c
456056.66,6.0,0,4,4,4,12,0xb2d1263dd
6772.16,1.0,9,2,2,3,7,0xb2d8b1bed
590000.02,6.0,57,4,4,2,10,0xb2d27475d
40014.09,2.0,97,2,3,1,6,0xb2d58bd8d
2031.65,1.0,92,1,2,1,4,0xb2d17781d
78076.73,1.0,9,3,2,3,8,0xb2d6ca7bd
44769.56,1.0,19,2,2,2,6,0xb2d6116e
326175.62,3.0,184,4,4,1,9,0x3b9b1bb0d
944016.41,12.0,5,4,4,3,11,0xb2d61572d
30561.44,1.0,92,2,2,1,5,0x3b9b4612d
170095.49,2.0,147,3,3,1,7,0xb2d6ccbdd
190185.7,8.0,18,3,4,2,9,0xb2d5ce21d
3309.0,2.0,184,2,3,1,6,0xb2d3c574d
14188.05,2.0,10,2,3,3,8,0xb2d64716
1141630.73,10.0,49,4,4,2,10,0xb2d0d147d
268350.42,4.0,0,3,4,4,11,0xb2d3a8bed
639746.4,6.0,40,4,4,2,10,0xb2d4f221d
565.08,2.0,111,1,3,1,5,0xb2d07e3dd
2187.02,1.0,64,1,2,2,5,0xb2d478ced
25979.52,1.0,15,2,2,3,7,0xb2d32998
26513.11,2.0,0,2,3,4,9,0xb2d29107d
433.23,1.0,167,1,2,1,4,0xb2d2895ad
20960.17,1.0,110,2,2,1,5,0xb2d2bf96d
5386.16,1.0,0,2,2,4,8,0xb2d2b7b8
176420.26,6.0,1,3,4,4,11,0xb2d0db6a
868041.04,5.0,5,4,4,3,11,0xb2d3d986d
4908.22,1.0,12,2,2,3,7,0xb2d69edf
1551.27,1.0,0,1,2,4,7,0xb2d68c5cd
876.56,1.0,9,1,2,3,6,0xb2d4ba9fd
150027.62,4.0,25,3,4,2,9,0xb2d2afb7d
850017.51,8.0,13,4,4,3,11,0xb2d5b10bd
355.35,2.0,19,1,3,2,6,0xb2d1bae4d
917349.52,8.0,17,4,4,2,10,0xb2d101f8
1244723.94,15.0,3,4,4,4,12,0xb2d17c0dd
614.15,1.0,1,1,2,4,7,0xb2d1f70e
81565.01,2.0,81,3,3,1,7,0xb2d5dd99d
100673.13,2.0,27,3,3,2,8,0xb2d657c7d
2503.09,1.0,126,1,2,1,4,0xb2d748c8d
1068971.79,1.0,0,4,2,4,10,0xb2d53ebf
10348.69,1.0,3,2,2,4,8,0xb2d632b2
127121.82,1.0,0,3,2,4,9,0xb2d1f242d
7445.8,1.0,184,2,2,1,5,0xb2d321ccd
1155.71,1.0,20,1,2,2,5,0xb2d3e821d
40171.0,2.0,263,2,3,1,6,0xb2d68652d
6129.99,1.0,15,2,2,3,7,0x3b9b320bd
4696.83,1.0,33,2,2,2,6,0xb2d4a73fd
2950124.56,2.0,70,4,3,1,8,0xb2d09108
10201.64,1.0,202,2,2,1,5,0xb2d5cf7fd
572.05,1.0,9,1,2,3,6,0xb2d214b4d
286.83,1.0,73,1,2,1,4,0xb2d67cb0d
140605.52,1.0,26,3,2,2,7,0xb2d5a9f6d
4398.56,1.0,180,2,2,1,5,0xb2d2b0f0d
505017.03,11.0,8,4,4,3,11,0xb2d68251d
200094.36,2.0,3,3,3,4,10,0xb2d2e9e9d
6.53,1.0,3,1,2,4,7,0xb2d3f2e9d
4080.02,1.0,0,2,2,4,8,0xb2d4fcfbd
122199.21,5.0,50,3,4,2,9,0xb2d3fc63
5501.84,1.0,18,2,2,2,6,0xb2d4da9c
115154.09,2.0,94,3,3,1,7,0xb2d4d1f0d
181579.44,1.0,3,3,2,4,9,0xb2d3b703d
10610.78,1.0,12,2,2,3,7,0xb2d559a2d
134784.88,1.0,94,3,2,1,6,0xb2d5b9f3d
1077.56,1.0,27,1,2,2,5,0xb2d386fd
251610.0,4.0,30,3,4,2,9,0xb2d62889d
2996.01,1.0,0,2,2,4,8,0xb2d6b0ce
10024.93,2.0,49,2,3,2,7,0xb2d42250d
4687.22,1.0,2,2,2,4,8,0xb2d55d3dd
30604.29,4.0,0,2,4,4,10,0xb2d40170d
200002.94,2.0,16,3,3,2,8,0xb2d6f484d
583542.42,3.0,1,4,4,4,12,0xb2d30679d
100099.4,2.0,123,3,3,1,7,0xb2d1f408d
100413.22,2.0,11,3,3,3,9,0xb2d3eaebd
433690.85,6.0,15,4,4,3,11,0xb2d44dafd
1260.68,1.0,12,1,2,3,6,0xb2d1aa8d
103541.91,1.0,92,3,2,1,6,0xb2d17917d
553047.88,4.0,3,4,4,4,12,0xb2d5b0e3d
22566.55,1.0,3,2,2,4,8,0xb2d1fe30d
64258.07,1.0,5,3,2,3,8,0xb2d418ded
10493.99,2.0,188,2,3,1,6,0xb2d2dccdd
758442.8,2.0,0,4,3,4,11,0xb2d219a2d
54938.34,4.0,75,3,4,1,8,0xb2d097cfd
824725.34,5.0,11,4,4,3,11,0xb2d15259d
260719.49,5.0,69,3,4,1,8,0xb2d1e28bd
2878.71,1.0,53,1,2,2,5,0xb2d5e7cdd
10625.88,2.0,82,2,3,1,6,0xb2d1364bd
10120.85,1.0,184,2,2,1,5,0xb2d28c66d
22765.42,2.0,3,2,3,4,9,0xb2d40e5a
354003.13,4.0,18,4,4,2,10,0xb2d88b45d
5053.95,1.0,92,2,2,1,5,0xb2d287a6d
862.67,1.0,21,1,2,2,5,0xb2d1e1ab
380352.78,2.0,16,4,3,2,9,0xb2d8db9ad
6586.96,1.0,184,2,2,1,5,0xb2d386a4d
11.31,1.0,0,1,2,4,7,0xb2d41106d
138246.79,3.0,179,3,4,1,8,0xb2d4fe2ad
10519.58,1.0,20,2,2,2,6,0xb2d77f50d
26805.18,1.0,0,2,2,4,8,0xb2d682de
175784.69,1.0,9,3,2,3,8,0xb2d8c128d
148456.26,1.0,1,3,2,4,9,0xb2d781cb
485156.54,6.0,7,4,4,3,11,0xb2d0ef37d
220000.0,4.0,97,3,4,1,8,0xb2d23a55d
878000.08,7.0,2,4,4,4,12,0xb2d57961
250.9,1.0,208,1,2,1,4,0xb2d4c066d
419795.11,7.0,70,4,4,1,9,0xb2d2154cd
204977.99,2.0,92,3,3,1,7,0xb2d66274d
246704.05,2.0,172,3,3,1,7,0xb2d5ac49d
1965860.59,6.0,21,4,4,2,10,0xb2d2d466d
20010.29,1.0,16,2,2,2,6,0xb2d81186d
197524.34,32.0,34,3,4,2,9,0x3b9af10ed
500003.31,4.0,6,4,4,3,11,0xb2d5d096
151049.59,7.0,62,3,4,2,9,0xb2d12f5b
4000000.0,4.0,4,4,4,4,12,0x3b9b33e9
19.14,1.0,32,1,2,2,5,0xb2d5eeae
181240.94,3.0,3,3,4,4,11,0xb2d5c8f3d
205689.96,2.0,92,3,3,1,7,0xb2d631abd
303482.79,4.0,67,4,4,1,9,0xb2d14622d
1443.33,1.0,10,1,2,3,6,0xb2d5522d
7618.3,1.0,5,2,2,3,7,0xb2d48919d
40971.09,3.0,139,2,4,1,7,0xb2d635a7d
60567.65,2.0,69,3,3,1,7,0xb2d40a7c
5697.51,1.0,103,2,2,1,5,0xb2d31f93
2223508.16,3.0,76,4,4,1,9,0xb2d11329d
1280059.5,5.0,67,4,4,1,9,0xb2d14b15d
307616.81,3.0,0,4,4,4,12,0xb2d0e652d
7.53,1.0,11,1,2,3,6,0xb2d4162b
2356.66,1.0,9,1,2,3,6,0xb2d5abdcd
465453.89,7.0,1,4,4,4,12,0xb2d22bb1d
215165.08,4.0,0,3,4,4,11,0xb2d62a33
200744.12,2.0,29,3,3,2,8,0xb2d6fa9cd
250001.19,4.0,1,3,4,4,11,0xb2d1146fd
1157442.03,4.0,34,4,4,2,10,0xb2d2399ed
22000.45,3.0,24,2,4,2,8,0xb2d694c8d
79.73,1.0,1,1,2,4,7,0xb2d30efdd
215027.76,2.0,11,3,3,3,9,0xb2d8db11
38446.55,1.0,4,2,2,4,8,0xb2d3700c
869.41,1.0,62,1,2,2,5,0xb2d3a0ab
170004.45,8.0,18,3,4,2,9,0xb2d1543bd
8.59,1.0,92,1,2,1,4,0xb2d15a4dd
5720.05,1.0,200,2,2,1,5,0xb2d39b9dd
200217.55,2.0,8,3,3,3,9,0xb2d617dc
1.09,1.0,18,1,2,2,5,0xb2d21f87
241020.53,2.0,70,3,3,1,7,0xb2d64041d
11038.33,3.0,4,2,4,4,10,0xb2d09d75d
142508.56,5.0,67,3,4,1,8,0xb2d77569d
491272.42,6.0,9,4,4,3,11,0xb2d560cdd
122307.53,2.0,0,3,3,4,10,0xb2d0dfd5d
110068.27,4.0,38,3,4,2,9,0xb2d64adfd
2891.75,8.0,134,2,4,1,7,0xb2d16405d
565148.67,4.0,20,4,4,2,10,0xb2d41796d
16227.26,1.0,0,2,2,4,8,0xb2d4518cd
5005.55,1.0,20,2,2,2,6,0xb2d28636
18698.52,1.0,2,2,2,4,8,0xb2d4b8c4d
1050043.51,2.0,132,4,3,1,8,0xb2d4fc74d
361.47,1.0,28,1,2,2,5,0xb2d560b2d
435477.41,2.0,92,4,3,1,8,0xb2d4b8bbd
99.24,1.0,77,1,2,1,4,0xb2d62a16
1265.41,1.0,184,1,2,1,4,0xb2d1011ad
17696.46,1.0,6,2,2,3,7,0xb2d18d6f
60004.82,3.0,92,3,4,1,8,0xb2d08682d
1190898.45,1.0,0,4,2,4,10,0xb2d59db4d
7398.13,1.0,0,2,2,4,8,0xb2d6b17f
65734.07,2.0,55,3,3,2,8,0xb2d693fdd
4176.88,1.0,85,2,2,1,5,0xb2d27f67d
7999.01,1.0,18,2,2,2,6,0xb2d464e9
1717.06,1.0,0,1,2,4,7,0xb2d18c1ed
286084.82,3.0,257,3,4,1,8,0xb2d10d40d
10091.24,1.0,184,2,2,1,5,0xb2d31354d
106007.51,2.0,139,3,3,1,7,0xb2d28f59d
500.38,1.0,7,1,2,3,6,0xb2d59a4e
73.25,1.0,13,1,2,3,6,0xb2d22074
270075.96,2.0,53,3,3,2,8,0xb2d0c441d
500060.49,2.0,25,4,3,2,9,0xb2d6b93ed
6562.26,1.0,0,2,2,4,8,0xb2d6bbb7d
3172.85,2.0,92,2,3,1,6,0xb2d55401d
52593.18,1.0,92,3,2,1,6,0xb2d231eed
301500.72,3.0,32,4,4,2,10,0xb2d699b8d
10164.53,2.0,228,2,3,1,6,0xb2d62fa6d
0.0,1.0,0,1,2,4,7,0xb2d445ced
4.8,1.0,60,1,2,2,5,0xb2d8e126d
1742837.85,16.0,0,4,4,4,12,0xb2d18e61d
508688.11,2.0,22,4,3,2,9,0xb2d7009b
1392.26,1.0,70,1,2,1,4,0xb2d34534d
35000.69,3.0,5,2,4,3,9,0xb2d6fcfad
1000105.87,3.0,46,4,4,2,10,0xb2d42d2a
200000.0,2.0,0,3,3,4,10,0xb2d8e351d
93017.83,4.0,1,3,4,4,11,0xb2d6971a
6020.28,1.0,3,2,2,4,8,0xb2d8eb7cd
260000.0,2.0,4,3,3,4,10,0xb2d5b62dd
16.0,1.0,47,1,2,2,5,0xb2d781d7
61817.69,2.0,31,3,3,2,8,0xb2d5efadd
32.51,1.0,35,1,2,2,5,0xb2d2e3f0d
18330.55,1.0,9,2,2,3,7,0xb2d559ad
107002.26,2.0,116,3,3,1,7,0xb2d78427d
66982.94,2.0,5,3,3,3,9,0xb2d144abd
2064.01,1.0,77,1,2,1,4,0xb2d5c46cd
420062.13,2.0,87,4,3,1,8,0xb2d35076d
15492.83,1.0,186,2,2,1,5,0xb2d59cb9d
2084.73,1.0,139,1,2,1,4,0xb2d3904bd
250345.37,4.0,48,3,4,2,9,0x3b9b3431
2019.12,1.0,11,1,2,3,6,0xb2d44bf6d
219004.86,4.0,14,3,4,3,10,0xb2d56e4ad
2.02,1.0,15,1,2,3,6,0xb2d6b71e
172754.73,3.0,14,3,4,3,10,0xb2d59511d
2180000.41,27.0,0,4,4,4,12,0xb2d24c94
12.36,1.0,14,1,2,3,6,0xb2d786be
1690.73,1.0,25,1,2,2,5,0xb2d38b36
8708.2,1.0,18,2,2,2,6,0xb2d2756ad
80572.82,2.0,1,3,3,4,10,0xb2d4520d
112043.78,3.0,45,3,4,2,9,0xb2d6fdd5
1057.82,1.0,92,1,2,1,4,0xb2d34414d
56.2,1.0,6,1,2,3,6,0xb2d63a7a
21244.54,61.0,3,2,4,4,10,0xb2d16ca5
2036882.95,4.0,18,4,4,2,10,0xb2d65205
251461.1,2.0,10,3,3,3,9,0xb2d694aad
59042.48,1.0,0,3,2,4,9,0xb2d7814e
2646.74,2.0,92,1,3,1,5,0x3b9b2eebd
702.69,1.0,10,1,2,3,6,0xb2d8fddc
43771.33,3.0,27,2,4,2,8,0xb2d588c9
100089.44,2.0,92,3,3,1,7,0xb2d3cbe5d
280706.29,4.0,10,3,4,3,10,0xb2d3b470d
868644.34,11.0,11,4,4,3,11,0xb2d36267d
61.72,2.0,21,1,3,2,6,0xb2d6d801
10500.11,1.0,11,2,2,3,7,0xb2d64e7c
201405.22,2.0,55,3,3,2,8,0xb2d68479
80078.36,3.0,55,3,4,2,9,0xb2d57358d
8750.94,1.0,92,2,2,1,5,0xb2d215aad
253194.3,3.0,42,3,4,2,9,0xb2d179ddd
900194.46,5.0,1,4,4,4,12,0xb2d61fd8d
333454.16,3.0,20,4,4,2,10,0xb2d627acd
2.64,1.0,8,1,2,3,6,0xb2d8d4f0d
330008.28,2.0,59,4,3,2,9,0xb2d6a476d
40334.67,3.0,80,2,4,1,7,0xb2d8d0f0d
400012.68,4.0,60,4,4,2,10,0xb2d6faead
20000.63,2.0,73,2,3,1,6,0xb2d8e09ed
404031.43,6.0,5,4,4,3,11,0xb2d1be44d
300482.97,2.0,48,4,3,2,9,0xb2d3873cd
640015.98,14.0,0,4,4,4,12,0x3b9b1828d
95.6,1.0,1,1,2,4,7,0xb2d1c395d
550378.01,5.0,27,4,4,2,10,0xb2d20b47d
1421.61,1.0,10,1,2,3,6,0xb2d54c55
70.32,3.0,4,1,4,4,9,0xb2d8f946
27457.85,2.0,0,2,3,4,9,0xb2d530a1
490087.7,5.0,15,4,4,3,11,0xb2d8d2e3d
43550.63,1.0,0,2,2,4,8,0xb2d87e0dd
204977.78,2.0,41,3,3,2,8,0xb2d29704d
188765.23,3.0,0,3,4,4,11,0xb2d28983d
3011.91,1.0,184,2,2,1,5,0xb2d58806d
26920.85,1.0,10,2,2,3,7,0xb2d62df4d
481.56,1.0,1,1,2,4,7,0xb2d3b07c
661811.96,6.0,6,4,4,3,11,0x3b9b33c8d
589987.39,7.0,0,4,4,4,12,0xb2d44271d
21.27,1.0,39,1,2,2,5,0xb2d3e7d3
155003.44,4.0,45,3,4,2,9,0xb2d8c838d
250502.15,3.0,160,3,4,1,8,0xb2d416a7d
58.89,1.0,0,1,2,4,7,0xb2d23083d
4865.25,1.0,92,2,2,1,5,0xb2d0e151
1053.66,1.0,2,1,2,4,7,0xb2d62b56
500084.18,2.0,6,4,3,3,10,0xb2d8d33cd
69168.39,1.0,0,3,2,4,9,0xb2d2977e
200711.42,2.0,29,3,3,2,8,0xb2d7455f
20.21,1.0,74,1,2,1,4,0xb2d4e840d
251499.7,6.0,1,3,4,4,11,0xb2d0d2a2d
2821.15,1.0,10,1,2,3,6,0xb2d3389e
480072.75,4.0,2,4,4,4,12,0xb2d60bacd
12245.13,1.0,2,2,2,4,8,0xb2d356a1
155502.06,4.0,67,3,4,1,8,0xb2d39a3ed
1329.26,1.0,174,1,2,1,4,0xb2d52188
455741.02,6.0,45,4,4,2,10,0xb2d213cd
254149.66,2.0,22,3,3,2,8,0xb2d2e7eb
155117.22,4.0,0,3,4,4,11,0xb2d3bd79d
210011.02,4.0,18,3,4,2,9,0xb2d3c64cd
201489.11,2.0,49,3,3,2,8,0xb2d3893b
141.46,1.0,7,1,2,3,6,0xb2d42285
777208.84,4.0,4,4,4,4,12,0xb2d21462d
400517.11,2.0,97,4,3,1,8,0xb2d20677d
617958.79,3.0,7,4,4,3,11,0x3b9b1240d
1016.09,1.0,184,1,2,1,4,0xb2d5adefd
1022.16,1.0,2,1,2,4,7,0xb2d32c4f
2580394.93,7.0,1,4,4,4,12,0xb2d35c23d
3.32,2.0,81,1,3,1,5,0xb2d49042d
125015.54,11.0,6,3,4,3,10,0xb2d3c64fd
50010.03,1.0,8,2,2,3,7,0xb2d6c97b
1406215.68,8.0,6,4,4,3,11,0xb2d31813d
311520.02,3.0,4,4,4,4,12,0xb2d1adc1d
90829.55,2.0,10,3,3,3,9,0xb2d8d421d
976.06,1.0,5,1,2,3,6,0xb2d3c28bd
6823.59,1.0,92,2,2,1,5,0xb2d2999d
616.19,1.0,0,1,2,4,7,0xb2d1b5fa
5071.81,1.0,0,2,2,4,8,0xb2d5f23e
1201776.56,4.0,6,4,4,3,11,0xb2d8f11c
50003.46,5.0,11,2,4,3,9,0xb2d5c805d
1201227.6,7.0,0,4,4,4,12,0xb2d11afad
36.95,1.0,16,1,2,2,5,0xb2d6bd21
0.43,1.0,63,1,2,2,5,0xb2d68379d
1213.71,1.0,92,1,2,1,4,0xb2d4ec4cd
58548.71,2.0,101,3,3,1,7,0xb2d6b151d
440703.7,2.0,86,4,3,1,8,0xb2d6e6f7d
100003.17,2.0,200,3,3,1,7,0xb2d78f36
10200.01,3.0,0,2,4,4,10,0x3b9b181c
330079.44,5.0,83,4,4,1,9,0xb2d2ae85d
1417.41,1.0,3,1,2,4,7,0xb2d3aadfd
0.0,1.0,82,1,2,1,4,0xb2d84433d
52992.04,2.0,18,3,3,2,8,0xb2d44997d
1395919.08,7.0,168,4,4,1,9,0x3b9b3b7dd
13830.42,1.0,18,2,2,2,6,0xb2d704bbd
60001.91,4.0,63,3,4,2,9,0xb2d8dcafd
12820.79,1.0,67,2,2,1,5,0xb2d1edaad
1578626.89,4.0,0,4,4,4,12,0xb2d20cb0d
1109708.28,4.0,3,4,4,4,12,0x3b9af3b6d
20362.29,1.0,6,2,2,3,7,0xb2d184ecd
317293.43,5.0,92,4,4,1,9,0xb2d0e65cd
12.43,1.0,71,1,2,1,4,0xb2d30f4fd
5103.26,1.0,7,2,2,3,7,0xb2d25c41
48874.34,1.0,17,2,2,2,6,0xb2d26ed4
12667.94,1.0,20,2,2,2,6,0xb2d29fe0
1357960.33,5.0,10,4,4,3,11,0xb2d56ee9d
12977.18,1.0,0,2,2,4,8,0xb2d502a2
611077.99,6.0,4,4,4,4,12,0xb2d079aed
86.8,1.0,20,1,2,2,5,0xb2d86994d
22.89,1.0,1,1,2,4,7,0xb2d8c49ad
95920.06,2.0,33,3,3,2,8,0xb2d43da9d
158014.0,3.0,25,3,4,2,9,0xb2d5ccafd
4119516.83,11.0,0,4,4,4,12,0x3b9af147d
0.0,2.0,0,1,3,4,8,0xb2d065cdd
2127.86,1.0,215,1,2,1,4,0xb2d2e348d
320762.09,6.0,139,4,4,1,9,0xb2d24115d
370033.88,8.0,27,4,4,2,10,0xb2d12478d
11206.17,1.0,46,2,2,2,6,0xb2d37cb9d
161000.0,12.0,1,3,4,4,11,0xb2d57c51d
349.91,1.0,208,1,2,1,4,0xb2d07b66d
2158.82,1.0,6,1,2,3,6,0xb2d6bdd0
20362.94,3.0,32,2,4,2,8,0xb2d087c3d
31091.54,2.0,119,2,3,1,6,0xb2d5f0fbd
500141.15,4.0,15,4,4,3,11,0xb2d60a2cd
288.68,1.0,10,1,2,3,6,0xb2d68c76d
11387.95,1.0,4,2,2,4,8,0xb2d69a98d
239.14,1.0,0,1,2,4,7,0xb2d68e47
1865.58,1.0,9,1,2,3,6,0xb2d496d2d
90004.8,3.0,129,3,4,1,8,0xb2d639c3d
450000.0,2.0,1,4,3,4,11,0xb2d5dd89d
2200108.21,9.0,6,4,4,3,11,0xb2d177c1
27.79,1.0,26,1,2,2,5,0xb2d548bf
590063.58,3.0,16,4,4,2,10,0xb2d835d1d
1015.27,1.0,92,1,2,1,4,0xb2d107e2d
2005.49,2.0,236,1,3,1,5,0xb2d25263d
0.0,2.0,53,1,3,2,6,0xb2d4eced
19965.8,1.0,4,2,2,4,8,0xb2d0f33fd
100003.17,2.0,92,3,3,1,7,0xb2d65a6fd
2032.26,2.0,0,1,3,4,8,0xb2d30852d
235061.51,3.0,13,3,4,3,10,0xb2d0c424
5074.09,3.0,184,2,4,1,7,0xb2d26835d
66024.22,2.0,0,3,3,4,10,0xb2d34929d
77.97,1.0,12,1,2,3,6,0xb2d25efd
231594.54,2.0,27,3,3,2,8,0xb2d13a8ed
7218.87,1.0,74,2,2,1,5,0xb2d804f9
317.08,1.0,4,1,2,4,7,0xb2d2be6f
146003.13,3.0,11,3,4,3,10,0xb2d4091ed
1153578.93,12.0,0,4,4,4,12,0xb2d19d25d
607003.2,3.0,16,4,4,2,10,0xb2d56608d
56922.35,2.0,256,3,3,1,7,0xb2d1b74ed
646.23,1.0,15,1,2,3,6,0xb2d33924
7788.63,1.0,10,2,2,3,7,0xb2d8e77d
255615.84,2.0,0,3,3,4,10,0xb2d657cfd
690247.84,5.0,3,4,4,4,12,0xb2d13860d
10161.5,2.0,18,2,3,2,7,0xb2d6bc8cd
250028.5,4.0,2,3,4,4,11,0xb2d1fb15
2.53,2.0,92,1,3,1,5,0xb2d374d6d
4860.25,1.0,9,2,2,3,7,0xb2d6f15ad
2.31,1.0,89,1,2,1,4,0xb2d2e968
122312.05,2.0,0,3,3,4,10,0xb2d6a4f4d
225156.66,2.0,76,3,3,1,7,0xb2d1a632d
580237.72,3.0,53,4,4,2,10,0xb2d1c0ced
3514.14,1.0,5,2,2,3,7,0xb2d5a867
4412.14,3.0,92,2,4,1,7,0xb2d094dd
100039.07,8.0,11,3,4,3,10,0xb2d5903dd
29632.95,1.0,21,2,2,2,6,0xb2d30826d
74.36,1.0,10,1,2,3,6,0xb2d8d0f3
298719.89,4.0,4,3,4,4,11,0xb2d24dd5d
6793.75,1.0,12,2,2,3,7,0xb2d6c2be
2457721.41,3.0,10,4,4,3,11,0xb2d57dc5d
25175.32,2.0,263,2,3,1,6,0xb2d5fa85d
1371.82,1.0,0,1,2,4,7,0xb2d5381ed
60105.52,2.0,97,3,3,1,7,0xb2d3e979d
39094.11,1.0,7,2,2,3,7,0xb2d2bb04d
170384.71,2.0,63,3,3,2,8,0xb2d171d6d
1000066.93,2.0,14,4,3,3,10,0xb2d6f450
70000.0,9.0,4,3,4,4,11,0xb2d06b5b
1011.96,1.0,92,1,2,1,4,0xb2d20c52d
5751.56,1.0,9,2,2,3,7,0xb2d36ece
0.0,1.0,92,1,2,1,4,0xb2d4110ad
1000019.0,1.0,0,4,2,4,10,0xb2d8be6d
205058.17,2.0,24,3,3,2,8,0xb2d2b347d
5224.53,1.0,0,2,2,4,8,0xb2d5e710d
620892.66,6.0,41,4,4,2,10,0xb2d103cfd
335047.25,8.0,74,4,4,1,9,0xb2d4461fd
73891.85,5.0,0,3,4,4,11,0xb2d54e08d
132964.64,4.0,18,3,4,2,9,0xb2d43df5d
10488.04,1.0,0,2,2,4,8,0xb2d6beedd
7787.4,1.0,9,2,2,3,7,0xb2d257f7d
700.33,1.0,55,1,2,2,5,0xb2d2ee1cd
5000544.56,3.0,53,4,4,2,10,0xb2d5b5a0
3659.74,1.0,184,2,2,1,5,0xb2d3fc7ed
2009.09,1.0,11,1,2,3,6,0xb2d6bda0d
50400.16,1.0,0,2,2,4,8,0xb2d320df
3076.07,1.0,13,2,2,3,7,0xb2d6a7fd
5638281.61,4.0,1,4,4,4,12,0xb2d10debd
1670.74,1.0,1,1,2,4,7,0xb2d0bda2
2005220.85,2.0,8,4,3,3,10,0xb2d652e0d
50095.81,1.0,119,2,2,1,5,0xb2d35694d
501776.22,12.0,29,4,4,2,10,0xb2d13f3b
100088.04,8.0,111,3,4,1,8,0xb2d1bbecd
1040111.02,5.0,40,4,4,2,10,0xb2d60682
400122.07,3.0,2,4,4,4,12,0xb2d5f238d
184.06,1.0,6,1,2,3,6,0xb2d243d6d
140006.57,3.0,56,3,4,2,9,0xb2d56965d
1183.84,1.0,14,1,2,3,6,0xb2d430fb
114.48,1.0,77,1,2,1,4,0xb2d5adbad
50031.88,2.0,41,2,3,2,7,0xb2d5eaddd
34097.69,9.0,0,2,4,4,10,0x3b9add82
72277.21,3.0,11,3,4,3,10,0xb2d540abd
867.63,1.0,19,1,2,2,5,0xb2d5f929d
100023.35,2.0,31,3,3,2,8,0xb2d145ecd
628902.62,3.0,147,4,4,1,9,0xb2d0e67ad
8713.14,1.0,0,2,2,4,8,0xb2d5cefe
2534.51,1.0,3,1,2,4,7,0xb2d616f6
15067.62,1.0,11,2,2,3,7,0xb2d66afb
404443.44,3.0,54,4,4,2,10,0xb2d6e212d
10143.29,1.0,2,2,2,4,8,0xb2d5dbdc
2991.0,1.0,0,2,2,4,8,0xb2d12f04d
57207.42,4.0,70,3,4,1,8,0xb2d6c615d
280.47,1.0,26,1,2,2,5,0xb2d31651d
27191.68,1.0,80,2,2,1,5,0xb2d22bb7d
213.39,1.0,25,1,2,2,5,0xb2d28c92
111.26,1.0,11,1,2,3,6,0xb2d29f44d
150051.59,2.0,1,3,3,4,10,0xb2d517e3d
142089.41,3.0,24,3,4,2,9,0xb2d551a0d
400001.33,2.0,5,4,3,3,10,0xb2d62c43d
6606.98,1.0,0,2,2,4,8,0xb2d6bf62d
22139.17,1.0,21,2,2,2,6,0xb2d60a48d
4260.17,1.0,0,2,2,4,8,0xb2d16687d
762286.58,7.0,10,4,4,3,11,0xb2d3f459d
100005.72,2.0,188,3,3,1,7,0xb2d1afbcd
7.43,1.0,15,1,2,3,6,0xb2d8fbbc
684201.96,2.0,7,4,3,3,10,0xb2d4f198
50004.21,2.0,56,2,3,2,7,0xb2d4101dd
150539.13,3.0,35,3,4,2,9,0xb2d792d2d
637.51,15.0,0,1,4,4,9,0x3b9b18e9d
210036.33,3.0,35,3,4,2,9,0xb2d26eead
20076.25,2.0,9,2,3,3,8,0xb2d8a24dd
7986.5,1.0,177,2,2,1,5,0xb2d50fc1
5008.81,1.0,2,2,2,4,8,0xb2d7d2e7d
270282.07,2.0,0,3,3,4,10,0xb2d4a929d
226831.82,8.0,0,3,4,4,11,0xb2d3d84c
30416.28,1.0,1,2,2,4,8,0xb2d19299d
10269.76,1.0,10,2,2,3,7,0xb2d6e87ad
51089.46,2.0,89,2,3,1,6,0xb2d070a5d
315611.7,2.0,199,4,3,1,8,0xb2d5d42cd
4183.4,1.0,21,2,2,2,6,0xb2d6f15dd
149.81,1.0,0,1,2,4,7,0xb2d2b29fd
9303.05,1.0,11,2,2,3,7,0xb2d8f059d
77672.04,2.0,18,3,3,2,8,0xb2d5c5ced
13717.49,1.0,5,2,2,3,7,0xb2d397efd
111003.83,2.0,6,3,3,3,9,0xb2d6f961d
90716.24,3.0,206,3,4,1,8,0xb2d424abd
53418.31,1.0,2,3,2,4,9,0xb2d8ce6bd
1710095.25,7.0,25,4,4,2,10,0xb2d28e79d
110055.59,2.0,18,3,3,2,8,0xb2d644efd
530000.0,4.0,1,4,4,4,12,0xb2d0e707d
1000061.81,2.0,4,4,3,4,11,0xb2d51e85d
110.04,1.0,9,1,2,3,6,0xb2d4127a
3923.46,1.0,19,2,2,2,6,0xb2d2cb36
42.32,1.0,62,1,2,2,5,0xb2d4363b
2053.44,1.0,0,1,2,4,7,0xb2d615f7d
700269.39,20.0,0,4,4,4,12,0x3b9b28b1
63.03,1.0,4,1,2,4,7,0xb2d2385c
1415906.7,15.0,3,4,4,4,12,0xb2d31b9cd
260020.12,3.0,39,3,4,2,9,0xb2d6b149
50003.23,2.0,1,2,3,4,9,0xb2d28870d
20000.63,2.0,59,2,3,2,7,0xb2d8fb83d
1384.7,1.0,184,1,2,1,4,0xb2d2cfbed
3.17,1.0,98,1,2,1,4,0xb2d846aed
800020.07,4.0,40,4,4,2,10,0xb2d6ef37d
710350.66,4.0,175,4,4,1,9,0xb2d3ebd1d
463418.36,19.0,12,4,4,3,11,0xb2d22afad
215069.07,4.0,0,3,4,4,11,0xb2d5ee81d
44.45,1.0,0,1,2,4,7,0xb2d4c131
103387.26,1.0,8,3,2,3,8,0xb2d3ab7bd
45369.02,3.0,13,2,4,3,9,0xb2d4247bd
346000.64,5.0,3,4,4,4,12,0xb2d6272bd
15116.3,2.0,139,2,3,1,6,0xb2d14f7dd
100005.61,2.0,55,3,3,2,8,0xb2d5c77bd
1190647.77,7.0,0,4,4,4,12,0xb2d27583d
1296.34,1.0,184,1,2,1,4,0xb2d0a132d
50523.64,2.0,38,2,3,2,7,0xb2d6f777d
10666.94,1.0,20,2,2,2,6,0xb2d60a71d
50577.09,2.0,25,2,3,2,7,0xb2d11d6fd
533683.09,1.0,12,4,2,3,9,0xb2d3316bd
23060.54,1.0,127,2,2,1,5,0xb2d0c3ca
70001.48,2.0,92,3,3,1,7,0xb2d645e7d
1340088.65,8.0,13,4,4,3,11,0xb2d5c719
2216.68,1.0,17,1,2,2,5,0xb2d29a0d
5213844.55,10.0,0,4,4,4,12,0x3b9b17ec
120062.97,3.0,19,3,4,2,9,0xb2d1cf11d
557147.01,4.0,186,4,4,1,9,0xb2d0bcefd
20000.21,2.0,92,2,3,1,6,0xb2d636e4
210024.35,3.0,179,3,4,1,8,0xb2d126a2d
4230.6,1.0,73,2,2,1,5,0xb2d6af99d
66960.06,1.0,165,3,2,1,6,0xb2d36cffd
2020.66,1.0,92,1,2,1,4,0xb2d25ed3d
650000.89,7.0,1,4,4,4,12,0xb2d62458d
7.84,1.0,10,1,2,3,6,0x3b9b2eca
651.88,1.0,23,1,2,2,5,0xb2d24336d
12452.61,1.0,120,2,2,1,5,0xb2d3cc1bd
100099.01,2.0,0,3,3,4,10,0xb2d1c24ed
1231.29,1.0,1,1,2,4,7,0xb2d30b14
100462.75,1.0,4,3,2,4,9,0xb2d62758d
963410.88,6.0,3,4,4,4,12,0xb2d48dabd
50327.01,2.0,175,2,3,1,6,0xb2d151e0d
489419.23,4.0,4,4,4,4,12,0xb2d43b6ad
128.87,1.0,14,1,2,3,6,0xb2d2a0d9
2294.7,1.0,0,1,2,4,7,0xb2d6a6e3
75029.2,1.0,20,3,2,2,7,0xb2d224ac
69764.17,1.0,9,3,2,3,8,0xb2d6c5a1d
11117.27,2.0,92,2,3,1,6,0x3b9b3a94d
75003.43,7.0,14,3,4,3,10,0xb2d2fb09d
403017.14,7.0,0,4,4,4,12,0xb2d0d137d
504974.8,6.0,7,4,4,3,11,0xb2d5b4f7d
114.08,1.0,15,1,2,3,6,0xb2d488acd
524536.39,1.0,1,4,2,4,10,0xb2d2d0bbd
140325.9,4.0,0,3,4,4,11,0xb2d32994d
1601024.28,3.0,228,4,4,1,9,0xb2d5b3d4d
300015.94,3.0,125,3,4,1,8,0xb2d1801fd
61.85,1.0,35,1,2,2,5,0xb2d2302c
1792.71,1.0,180,1,2,1,4,0xb2d4beaad
5.96,1.0,5,1,2,3,6,0xb2d8f653
113478.6,1.0,41,3,2,2,7,0xb2d25447d
34.79,1.0,0,1,2,4,7,0xb2d4ad8e
98414.27,2.0,20,3,3,2,8,0xb2d17044d
2342.3,1.0,2,1,2,4,7,0xb2d5beaed
67.45,1.0,4,1,2,4,7,0xb2d32eecd
200193.89,2.0,26,3,3,2,8,0xb2d6eb80d
750018.73,7.0,6,4,4,3,11,0xb2d3e52cd
801.46,1.0,15,1,2,3,6,0xb2d3ba60
9909.13,1.0,0,2,2,4,8,0xb2d6bd13d
30071.15,3.0,24,2,4,2,8,0xb2d5cb81d
35.97,1.0,4,1,2,4,7,0xb2d36973d
182.22,1.0,27,1,2,2,5,0xb2d3dca1
1256.35,1.0,92,1,2,1,4,0xb2d24804d
0.49,1.0,184,1,2,1,4,0xb2d5e6f3d
10030.54,1.0,299,2,2,1,5,0xb2d65304d
211298.17,3.0,92,3,4,1,8,0xb2d552f9d
22090.9,3.0,0,2,4,4,10,0xb2d51f3cd
165469.38,1.0,89,3,2,1,6,0xb2d0cbcbd
1938984.99,34.0,0,4,4,4,12,0xb2d069e5d
48.6,1.0,40,1,2,2,5,0xb2d1fb85
358139.42,3.0,109,4,4,1,9,0xb2d612c4d
8669.35,1.0,15,2,2,3,7,0xb2d6e929d
10291.31,1.0,3,2,2,4,8,0xb2d362ef
5406.2,1.0,7,2,2,3,7,0xb2d588c0d
2.15,1.0,226,1,2,1,4,0xb2d55824d
500403.53,2.0,25,4,3,2,9,0xb2d2016dd
5.53,1.0,15,1,2,3,6,0xb2d67eee
30.69,1.0,133,1,2,1,4,0xb2d179eb
500000.0,5.0,1,4,4,4,12,0xb2d18885d
103628.27,2.0,80,3,3,1,7,0xb2d1490a
460634.12,4.0,0,4,4,4,12,0xb2d64aadd
621978.06,7.0,12,4,4,3,11,0xb2d7904dd
40858.71,2.0,0,2,3,4,9,0xb2d29c62d
2251.23,1.0,92,1,2,1,4,0xb2d3280ed
30212.84,2.0,239,2,3,1,6,0xb2d6620dd
1126755.87,3.0,1,4,4,4,12,0xb2d0db7e
39358.27,1.0,49,2,2,2,6,0xb2d37cbcd
93776.44,4.0,0,3,4,4,11,0xb2d067ffd
2690.87,1.0,0,1,2,4,7,0xb2d0dc68d
16985.37,1.0,14,2,2,3,7,0xb2d39168
60.38,1.0,2,1,2,4,7,0xb2d6ab4f
50542.73,2.0,1,2,3,4,9,0xb2d27493d
34674.99,1.0,1,2,2,4,8,0xb2d1e18dd
617.27,1.0,0,1,2,4,7,0xb2d41416d
114170.24,1.0,186,3,2,1,6,0xb2d4dea8d
1068.88,1.0,160,1,2,1,4,0xb2d6abe2d
1191.29,2.0,0,1,3,4,8,0xb2d209e3d
282008.98,3.0,5,3,4,3,10,0xb2d54ad8d
17251.46,2.0,92,2,3,1,6,0xb2d11a84d
50699.38,3.0,4,2,4,4,10,0xb2d602cbd
221261.54,7.0,5,3,4,3,10,0xb2d3a6f0
310450.16,4.0,80,4,4,1,9,0xb2d514e3d
322.14,6.0,53,1,4,2,7,0xb2d0734b
13500.73,1.0,29,2,2,2,6,0xb2d390cc
592274.35,7.0,24,4,4,2,10,0xb2d80de7d
1079.18,1.0,4,1,2,4,7,0xb2d200c4d
59170.46,2.0,6,3,3,3,9,0xb2d1a4fc
1.53,1.0,83,1,2,1,4,0xb2d591c9
409209.18,10.0,14,4,4,3,11,0xb2d2e935d
125355.24,3.0,34,3,4,2,9,0xb2d2a460d
661.53,1.0,13,1,2,3,6,0xb2d7814ed
419229.12,5.0,48,4,4,2,10,0x3b9b2b85d
9746.6,1.0,1,2,2,4,8,0xb2d407f1d
3471.79,1.0,170,2,2,1,5,0xb2d3721c
166011.43,3.0,25,3,4,2,9,0xb2d26710d
20007.42,2.0,120,2,3,1,6,0xb2d6f22bd
1101000.18,51.0,0,4,4,4,12,0xb2d17965d
249954.37,5.0,0,3,4,4,11,0xb2d41b5ad
311000.87,4.0,6,4,4,3,11,0xb2d6a626
1700398.32,5.0,23,4,4,2,10,0xb2d16da7d
3998.22,1.0,18,2,2,2,6,0xb2d6c499d
4908.38,1.0,55,2,2,2,6,0xb2d53527d
8495.98,1.0,4,2,2,4,8,0xb2d32839d
8.74,1.0,23,1,2,2,5,0xb2d31771
309796.57,3.0,0,4,4,4,12,0xb2d558aed
7083.31,1.0,0,2,2,4,8,0xb2d6bb84
311830.17,3.0,3,4,4,4,12,0xb2d20ecbd
8079.39,1.0,92,2,2,1,5,0xb2d29778d
15312.23,1.0,40,2,2,2,6,0xb2d1f419d
29220.84,1.0,0,2,2,4,8,0xb2d530a1d
1802076.24,2.0,83,4,3,1,8,0xb2d3c592d
1000030.1,2.0,0,4,3,4,11,0xb2d3d50dd
548.37,1.0,39,1,2,2,5,0xb2d55981d
468259.6,3.0,5,4,4,3,11,0xb2d55c0b
11694.9,2.0,1,2,3,4,9,0xb2d5f88a
710000.0,5.0,3,4,4,4,12,0xb2d5adbdd
1352.59,1.0,13,1,2,3,6,0xb2d3912dd
60002.51,2.0,56,3,3,2,8,0xb2d6417dd
1001656.92,9.0,0,4,4,4,12,0xb2d58f45d
746025.39,16.0,2,4,4,4,12,0xb2d112a7
1991.52,1.0,1,1,2,4,7,0xb2d69480d
638.27,1.0,0,1,2,4,7,0xb2d178d8d
15903.77,1.0,23,2,2,2,6,0xb2d8f6bed
278009.7,3.0,24,3,4,2,9,0x3b9b3cd1d
10427.76,1.0,8,2,2,3,7,0xb2d3bf17d
100002.15,2.0,80,3,3,1,7,0xb2d3e66b
1860091.16,15.0,10,4,4,3,11,0xb2d16951d
3080.34,1.0,3,2,2,4,8,0xb2d356a1d
0.24,1.0,13,1,2,3,6,0xb2d598d8
79.61,2.0,7,1,3,3,7,0xb2d17c34d
200710.71,2.0,26,3,3,2,8,0xb2d65398d
1200000.08,5.0,18,4,4,2,10,0xb2d4e796d
2.14,1.0,11,1,2,3,6,0xb2d6838c
42466.78,1.0,0,2,2,4,8,0xb2d1dff7d
50054.42,2.0,92,2,3,1,6,0xb2d6870c
19590.2,1.0,148,2,2,1,5,0xb2d16de8d
355035.74,8.0,20,4,4,2,10,0xb2d1721ad
140006.97,4.0,35,3,4,2,9,0xb2d789f0d
89829.98,1.0,13,3,2,3,8,0xb2d1de8c
1900040.11,2.0,31,4,3,2,9,0xb2d937c7d
200000.01,2.0,28,3,3,2,8,0xb2d94049d
10000.42,2.0,20,2,3,2,7,0xb2d92a59d
90715.18,3.0,6,3,4,3,10,0xb2d6a96ed
1010042.64,2.0,41,4,3,2,9,0xb2d91226d
30045.68,1.0,1,2,2,4,8,0xb2d92402d
2946.7,1.0,10,2,2,3,7,0xb2d248fe
2027.37,1.0,9,1,2,3,6,0xb2d91808d
4182.25,1.0,5,2,2,3,7,0xb2d8cf8cd
6580.06,1.0,10,2,2,3,7,0xb2d918a4
10948.0,2.0,31,2,3,2,7,0xb2d92ec4
1220912.05,8.0,0,4,4,4,12,0xb2d23b80d
10877.01,1.0,184,2,2,1,5,0xb2d4ec2bd
30000.0,1.0,49,2,2,2,6,0xb2d9146c
28435.23,1.0,13,2,2,3,7,0xb2d92267
37812.58,1.0,7,2,2,3,7,0xb2d6b538d
20000.54,2.0,26,2,3,2,7,0xb2d10f42d
6185.47,1.0,15,2,2,3,7,0xb2d39d5d
10008.06,2.0,1,2,3,4,9,0xb2d631c8d
115.53,1.0,0,1,2,4,7,0xb2d912ecd
200007.96,2.0,103,3,3,1,7,0xb2d36e8bd
67.41,1.0,40,1,2,2,5,0xb2d226efd
8526.58,1.0,10,2,2,3,7,0xb2d4dac4
2114.26,1.0,15,1,2,3,6,0xb2d85c5c
202.94,1.0,3,1,2,4,7,0xb2d6e322d
1090072.06,4.0,59,4,4,2,10,0xb2d067ced
392650.13,3.0,92,4,4,1,9,0xb2d1fdc4d
501776.15,2.0,16,4,3,2,9,0xb2d91d0cd
500005.3,2.0,193,4,3,1,8,0xb2d81f04d
51011.39,1.0,0,2,2,4,8,0xb2d3b457d
20000.21,2.0,31,2,3,2,7,0xb2d93c14d
2146.07,1.0,0,1,2,4,7,0xb2d68499d
189913.05,2.0,7,3,3,3,9,0xb2d155d4d
14615.08,1.0,28,2,2,2,6,0xb2d3e6ad
635058.31,7.0,13,4,4,3,11,0xb2d2a02ad
220781.46,2.0,40,3,3,2,8,0xb2d91208d
387.94,1.0,10,1,2,3,6,0xb2d51781d
60001.9,2.0,45,3,3,2,8,0xb2d915b6d
700031.65,3.0,10,4,4,3,11,0xb2d5703cd
500010.56,2.0,28,4,3,2,9,0xb2d93f7ad
557000.0,15.0,1,4,4,4,12,0xb2d5f78dd
14.78,1.0,46,1,2,2,5,0xb2d90cc2d
347707.06,1.0,33,4,2,2,8,0xb2d93017d
28011.26,2.0,9,2,3,3,8,0xb2d9224cd
8204.96,1.0,11,2,2,3,7,0xb2d4a96bd
2141530.77,12.0,15,4,4,3,11,0xb2d66a7ad
300000.0,2.0,3,3,3,4,10,0xb2d903b3
500009.51,2.0,48,4,3,2,9,0xb2d9133dd
5013.71,1.0,172,2,2,1,5,0xb2d69dc8
62731.82,1.0,213,3,2,1,6,0xb2d5fb14d
1170.85,2.0,92,1,3,1,5,0xb2d1c8f0d
603.83,1.0,0,1,2,4,7,0xb2d68dcad
1245496.12,10.0,1,4,4,4,12,0xb2d1ff93d
10000.11,3.0,18,2,4,2,8,0xb2d0b0c4
1024.87,2.0,184,1,3,1,5,0xb2d06873d
200509.08,2.0,7,3,3,3,9,0xb2d9164fd
26571.59,1.0,2,2,2,4,8,0xb2d69fcad
51701.48,3.0,13,2,4,3,9,0xb2d93aeed
10000.11,2.0,45,2,3,2,7,0xb2d91d7e
162284.32,2.0,208,3,3,1,7,0xb2d12a93d
5597.93,1.0,2,2,2,4,8,0xb2d939b0
70958.95,1.0,4,3,2,4,9,0xb2d69c60
235531.48,2.0,44,3,3,2,8,0xb2d92132d
60002.96,2.0,31,3,3,2,8,0xb2d90fa4d
477096.32,4.0,1,4,4,4,12,0xb2d7008d
360.09,1.0,12,1,2,3,6,0xb2d5f5ced
20000.21,2.0,55,2,3,2,7,0xb2d904a0d
625.5,1.0,8,1,2,3,6,0xb2d23dc6d
24000000.0,5.0,0,4,4,4,12,0xb2d9259ad
1380359.69,7.0,80,4,4,1,9,0xb2d0bb2ad
422000.26,3.0,40,4,4,2,10,0xb2d0756fd
120069.14,3.0,48,3,4,2,9,0xb2d1031b
5.7,1.0,3,1,2,4,7,0xb2d936bc
20000.21,2.0,266,2,3,1,6,0xb2d6bad9
50003.17,2.0,47,2,3,2,7,0xb2d90bd5
80002.53,2.0,31,3,3,2,8,0xb2d9359c
200010.95,2.0,1,3,3,4,10,0xb2d92d05d
1025322.07,1.0,0,4,2,4,10,0xb2d32b39d
